ts,record_id,user_authority,user,partial,base_asset_value,base_asset_value_closed,liquidation_fee,fee_to_liquidator,fee_to_insurance_fund,liquidator,total_collateral,collateral,unrealized_pnl,margin_ratio
2022-05-08 22:51:55-04:00,19457,Hyh93pAbHGME7rUUFPXXPJVUba1cjgJK6Udw2D8yW4nf,A8VCG5wfCEQGgUbwtjq2xh47RKbwaV7RvVuuj3C9bKPu,False,23559217,23559217,921984,46099,875885,C4UnXuShCvjSMgBAgVNMy1oakxCNk1et27A82fywU112,921986,8124580,-7202594,391
2022-05-08 22:51:57-04:00,19458,2EcKNNHjAgZGnMhmRg98XGHFTAnM24gpAMsJA6FkdqHp,D6xW3oLCh9DP18E4wFNbVanbZyJUwhPVU3GsZEUEAjv3,False,23551059,23551059,922573,46128,876445,Hu94aiQWvce6THeGyCFqGRPM1pQrK3ihzkcXo1EpJcJL,922575,8133332,-7210757,391
2022-05-08 22:51:58-04:00,19459,EkKmfEnxTscSs2BDs1mg6SyHdStC8AYTy9zihw9VWP63,DW4ujEZj4H83B9CrSfbks2pkHEj3gh2d114eo1aDh4s9,True,62906040,15726510,47635,23817,23818,C4UnXuShCvjSMgBAgVNMy1oakxCNk1et27A82fywU112,1905435,19887677,-17982242,302
2022-05-08 22:51:58-04:00,19460,JE6YNDmKQsxj4zsURyr1eh5cJjNCR2CvLmawufXWMCKx,2ctukoNZQ4BwabFZBJfhK2ic67ChHnGSBJyiSnmiCpAW,False,25964926,25964926,730587,36529,694058,Hu94aiQWvce6THeGyCFqGRPM1pQrK3ihzkcXo1EpJcJL,730587,6157471,-5426884,281
2022-05-08 22:51:58-04:00,19461,B9WJfmrYEkVH3L1UWz4qqWpaexHydymbzvEfwNVtB9BV,6mQb4yzGq8jE1NbweKCKSbevnnYVhHYxyc6Gz2a5kJLn,False,33236549,33236549,958306,47915,910391,C4UnXuShCvjSMgBAgVNMy1oakxCNk1et27A82fywU112,958306,9016757,-8058451,288
2022-05-08 22:51:59-04:00,19462,BJUNK2orMVx6mYsD9pnQzmsEh95ZF2NWPm9KJ1ZM67Qn,FpxLa3DwWrspYvHVsScSDcscHB2eBHGxRrQ4gVvn4VW,True,120299553,30074888,89595,44797,44798,C4UnXuShCvjSMgBAgVNMy1oakxCNk1et27A82fywU112,3583830,37923943,-34340113,297
2022-05-08 22:52:14-04:00,19463,68gVM4kjmSYxT1uJW13rYSway8uVLUdcLa7sJuqHQaAf,DshroBQ3da7BcAiQpiFREsLKWbUDrBRmmZRw3Zu2Qfs9,True,167138259,41784564,126272,63136,63136,6L1WYrPiCMyi7XemPww4B4hvpKD1LQKD4RpiSKmrmgSC,5050888,43465957,-38415069,302
2022-05-08 22:52:20-04:00,19464,CvR57tmtnHbMmPivvJR6VenXivQaWue7z77N81WPpzfv,B4ASc8cUjrzuchv2SHwPrnjKvZgZpwvcLArsdYmMAqBQ,True,274267057,68566764,207755,103877,103878,8sEswn3kzEhnYjAZVvCQnHEUvYd7pFVvc2Xc2Kd1BpbC,8310215,74369205,-66058990,302
2022-05-08 22:52:22-04:00,19465,DvSVpLMQyz91ksMwhuwwFDiKMo53FC5FVG5XrQZYWurJ,5jL2cYHg1QQpWYRCF4f378jpeHnTfPMWXiiHuhLNbzq8,True,54833330,2799598,12116,6058,6058,6L1WYrPiCMyi7XemPww4B4hvpKD1LQKD4RpiSKmrmgSC,2373209,18289106,-15915897,432
2022-05-08 22:52:24-04:00,19466,GGcsY84pkqUn2xySuLYrUUg8gWMBWgfHaQ7rK42NoZaH,4EyjJvctL9WBQiauD2Eaf2Hus8htYzHxP5GR2HsUfuks,False,18020993,18020993,544634,27231,517403,3zqXX6kzhkbW3d4TwD2CNjMRwxTbREXySekvq37kfCNk,544635,9757417,-9212782,302
2022-05-08 22:52:35-04:00,19467,JCagxpXPs6wVRUWbNBPCZ4uLCkZsachnofN7SZEEwGwB,5uGj1TBCkc7FV4ffdBJg31yLcCxkQLxRExjcinnJUow9,True,48082597,4505165,13609,6804,6805,2a35JJeTUW1pm6M3e8DHCjp8qr4vbc2cRPhuzZWyFzYd,1452494,47484293,-46031799,302
2022-05-08 22:52:37-04:00,19468,BH36ueAULprzjj6WabTgvivEcrx3VdDn8DTxSoro8Zym,6yydJKEmtZjUwURrs9gQ7EGkB86nK28ZDJQqNMgbPosA,False,1584174,1584174,98616,4930,93686,8sEswn3kzEhnYjAZVvCQnHEUvYd7pFVvc2Xc2Kd1BpbC,98617,1582312,-1483695,622
2022-05-08 22:52:37-04:00,19469,AvvZT6q65qCaCdETtpR9XbCvY4Rv9RdpvbGuh6umEA9X,8dP2GJEjKTk9x7focRgCAYJauaGXENyxMU3EtgPA4gas,True,40637164,2008005,8355,4177,4178,8sEswn3kzEhnYjAZVvCQnHEUvYd7pFVvc2Xc2Kd1BpbC,1691041,12803946,-11112905,416
2022-05-08 22:52:38-04:00,19470,5rnSL1jkLDsAvWsKNrbxtBJEcavHbc41kSTWywUEmSaX,87ZzyZEPJAXq6UiTqQVNuChRQVSb7QcUJgV41saA8CFC,True,57716464,3855557,17866,8933,8933,8sEswn3kzEhnYjAZVvCQnHEUvYd7pFVvc2Xc2Kd1BpbC,2674624,19969936,-17295312,463
2022-05-08 22:52:38-04:00,19471,7tFD53kPTqrzjCu1Wji78gUqhoRtCUhsP1pM3DQKT7uG,BJvgPLYBDJrQJdQVowrsMwUGMurq4zTihoFwWoEokfu3,True,290127255,37184198,112181,56090,56091,6L1WYrPiCMyi7XemPww4B4hvpKD1LQKD4RpiSKmrmgSC,8752909,72103718,-63350809,301
2022-05-08 22:52:40-04:00,19472,BSDeCyJsPs6y1pbDVHNq5rs6tdxcrbY3NDjXPBxwRjHz,DjHD3jawBVikzjcQ5dXBRLdUmEeBHKt6JZLhvmjScDku,True,42962914,5138777,16762,8381,8381,C4UnXuShCvjSMgBAgVNMy1oakxCNk1et27A82fywU112,1401478,22043137,-20641659,326
2022-05-08 22:52:43-04:00,19473,Ai6G7vosJfmkRqtDAkqxRtbzELp6P5xe9r2RH3LYcLZt,8SUpKXakmhi4rYiFKnHYpgaAopomfDqEX6Efew9iM6nk,True,42727346,3941584,16518,8259,8259,68sueyVfmy5ToEGtLFGDkwebX47xAmzyXE29z8JrmcWv,1790631,26243641,-24453010,419
2022-05-08 22:52:47-04:00,19474,A6wyZoJuJa5iqpXwYHfTiRs1G3MMaXVroDxdED89EyJp,HBYgKE6Lt2zXyobSHEbUdNCWPoxkikEEJHae15C1xptu,True,28677769,1425580,5979,2989,2990,6L1WYrPiCMyi7XemPww4B4hvpKD1LQKD4RpiSKmrmgSC,1202814,9790769,-8587955,419
2022-05-08 22:52:48-04:00,19475,9NhqXUfbpn5skKsZzCpnyD5wPTeLgDeKCxYQHR9TY9ej,8H1trMp7ATvrK1fzENWLg3xdDF6a4LJnNSc2APyQLi24,True,28659853,1420476,5956,2978,2978,C4UnXuShCvjSMgBAgVNMy1oakxCNk1et27A82fywU112,1201896,9806868,-8604972,419
2022-05-08 22:53:05-04:00,19476,6pUtYz474QrpATEZnfb3iFbTKYA65pNyKAo4TQZAjtqe,8dipRUXvxJiDLdHEtCPkso4vErbVwshHQiRfvSngBS9J,True,601245399,30842381,113827,56913,56914,8sEswn3kzEhnYjAZVvCQnHEUvYd7pFVvc2Xc2Kd1BpbC,22189687,328349187,-306159500,369
2022-05-08 22:53:06-04:00,19477,fAJK1wrBhSW297AtFWX2U4rUBf2gkzfQ6UrQL9yHEYW,5pyTFpanSyUCHxeMhJMKtpdrcMSAWc8bFadbyM7q4q4B,True,390195353,97548838,294423,147211,147212,2xTUy2RS74GJMMDnmFaegMzFLn19RVfYG4CibhBmjP1i,11776924,31533413,-19756489,301
2022-05-08 22:53:08-04:00,19478,Bzp3ZUxzRWqW4QoLq9PtKN1HQeSaKXFQrX1G3a4ocrre,H12B3p4v1ZtZ9gaSgpxCJsKXmmEjiqaRZQzexjzAhevo,True,1438752809,193933654,873172,436586,436586,A9TwRM1BMxqb8DCC7YNAMV6zPenEJm3HTZBy7wJKK58U,64778868,755274434,-690495566,450
2022-05-08 22:53:10-04:00,19479,E6nDc3W2iqNJJASjkU8dj2JViZ5iDys3Qf6nGh4gjA9a,8YnGmR4CECAkHN7QRvxh2KKbrdCcq5gtsFV1rDyzvWG5,True,28654571,1420462,5940,2970,2970,Hu94aiQWvce6THeGyCFqGRPM1pQrK3ihzkcXo1EpJcJL,1198472,9809632,-8611160,418
2022-05-08 22:53:10-04:00,19480,EodTi1tG2TSFyYPtDVKAxc6cuufzeEB6hg66HiZ36FFQ,8x8z784KpUypCtdBnGbs7jmUAiH83yXnG3QwXAWo4AZX,True,28653818,1421130,5936,2968,2968,2a35JJeTUW1pm6M3e8DHCjp8qr4vbc2cRPhuzZWyFzYd,1197015,9808984,-8611969,417
2022-05-08 22:53:11-04:00,19481,GdUWbwTgHF1RRbpVXCahz36G7MqYrM6QaBgnjL2eLKxk,JDYxQpYMt38mmjzLrVjgi3ezpc3DQ8YJEtJTZbG6fCCq,True,54875521,2801486,12149,6074,6075,2a35JJeTUW1pm6M3e8DHCjp8qr4vbc2cRPhuzZWyFzYd,2379861,18254456,-15874595,433
2022-05-08 22:56:47-04:00,19482,3CTLVMSTYE6azjXhZyhPD5XiUe23aJ4pb456SQnUiohH,13q8wAZ1zte3bd3LdeKLEUY7ubu2suCNRZVrgMScpV3C,True,55153449,2915115,12534,6267,6267,8sEswn3kzEhnYjAZVvCQnHEUvYd7pFVvc2Xc2Kd1BpbC,2371585,17220164,-14848579,429
2022-05-08 22:56:49-04:00,19483,36C7WZ1ufgJ5vSBPMpPVRsv4EoS9AsGAp5wx5LiRTvjx,DRBttFFwyyqZwK8fn5W1xc59iHxV7JZkR76d1DDnEng3,False,23684506,23684506,956296,47814,908482,Hu94aiQWvce6THeGyCFqGRPM1pQrK3ihzkcXo1EpJcJL,956298,8033666,-7077368,403
2022-05-08 22:56:49-04:00,19484,BNEFSL7Mwtyq4ZbWaQB1UibDumKrqSbqkNVEYCJsMioH,GecT9hsySEeo6hHWed9UUkae2SYBjDCNGeC6R7UVK5Ds,True,28651430,1420093,5917,2958,2959,5HnvdJnCCcmRsm4GkXnYWd4q9RpwuvYDGEUMPkYR3Ts9,1193816,9808131,-8614315,416
2022-05-08 22:56:49-04:00,19485,CpeJ8BVz8Nd6SqnM3DYejnvAYnovDwu1taCqMEBD4RRi,GMmBgzDTtes62wJTENptaWPxNY2srWCrAdWErkj22Hzj,True,55091807,2904828,12372,6186,6186,3zqXX6kzhkbW3d4TwD2CNjMRwxTbREXySekvq37kfCNk,2346578,17254837,-14908259,425
2022-05-08 22:56:51-04:00,19486,7YCSi1xGHn5j65W5cZPkQ9RQzvpNgCGdrafAGGTLYkjE,BdVVPyQgd93sMf1SDCFFMvyugNsbdkrVNgaQCJEGjTLC,True,36142418,3187758,12947,6473,6474,8sEswn3kzEhnYjAZVvCQnHEUvYd7pFVvc2Xc2Kd1BpbC,1467996,12950683,-11482687,406
2022-05-08 22:56:52-04:00,19487,5jAGYgNPbxE171j6GLMhf2WjbGzm7vKMifg5tAPcUPc1,EWoKgDPerFZ2ExRi6wWK9xBSyT2xQptp46Rdh39jF7Kt,True,38469705,1632282,6627,3313,3314,C4UnXuShCvjSMgBAgVNMy1oakxCNk1et27A82fywU112,1561957,11904221,-10342264,406
2022-05-08 22:56:57-04:00,19488,6d6HN8LWikwW2HYdy3BABWuxKHt1sgv4DcneACR133sE,4eKvzmfFvX96XbujKBhUauAvWP4yQYwZH3pd7gXzbCvJ,True,121791650,30447912,92007,46003,46004,6L1WYrPiCMyi7XemPww4B4hvpKD1LQKD4RpiSKmrmgSC,3680308,33749769,-30069461,302
2022-05-09 01:49:56-04:00,19489,13GT6eaKWuaLe7wFcybCnUaYgd9DfyzYRN2FcXWgFwpC,CbwmJ7YpnvcqDyUw3L9b7dqXcA8Ju3rYrTdegeaJJbWC,True,23411822,5852955,36199,18099,18100,68sueyVfmy5ToEGtLFGDkwebX47xAmzyXE29z8JrmcWv,1447995,18121388,-16673393,618
2022-05-09 01:49:59-04:00,19490,31TiU5VAiR77Zec49S5x2Y9EqdyMqi8Gx5T2bLxAazhU,iZkdEaFdSoYXBFEp3GPVJZvg5ZbiVdjNvHaTEvXxUmp,True,133665230532,33416307633,100164017,50082008,50082009,2xTUy2RS74GJMMDnmFaegMzFLn19RVfYG4CibhBmjP1i,4006560698,8727029653,-4720468955,299
2022-05-09 01:50:03-04:00,19491,DRVtEzZs9u9ysrcANZLEjrvbuuGqYn77v2h4cDFKuNUx,Fv9qiMZhuSBL2cs9AWUYbDLQjB46W2ZwrhxaNXtPLDpC,True,37446745884,9361686471,28229689,14114844,14114845,C4UnXuShCvjSMgBAgVNMy1oakxCNk1et27A82fywU112,1129187563,1544536386,-415348823,301
2022-05-09 02:07:36-04:00,19492,F2AU2PjaSmHxWWhkz8XxMggkCMWbMVgawt89tSnYS6RL,ET9febRJiW197DYMaJbgk3kWsAeFv5f4peQ4vFCVppK6,True,1754392647,438598161,3130264,1565132,1565132,72XWPCtRYEDZbddP7d6dHtUBRRDLSJsB2xZTAfefoEVZ,125210567,183616863,-58406296,713
2022-05-09 02:08:40-04:00,19493,6wGzqSWYjB1nukhDwLdgXDzMNSeasuRur3FVZAkVF4pM,HTcJjvQNFJQEewRf8iCcsZgFcfHoUXzpbb7WscqdK4kS,True,147593762,36898440,230154,115077,115077,6L1WYrPiCMyi7XemPww4B4hvpKD1LQKD4RpiSKmrmgSC,9206176,33311828,-24105652,623
2022-05-09 02:10:35-04:00,19494,EVMrznfJS54BZiywDD2WhUtxzicDtbEpm2a5yLrtCgRF,CpzsMYVYvKg8ihrX1cKRw7TDEYwD3kAyiX92hsf2KiTz,True,907858888,60817875,277278,138639,138639,A9TwRM1BMxqb8DCC7YNAMV6zPenEJm3HTZBy7wJKK58U,41390746,566270055,-524879309,455
2022-05-09 02:10:51-04:00,19495,HT2SuCbePhjNZaar24uVwihYowCNvSjdvhJ8BRSVw9nX,98Ts4LCnapHVoCJ5PW3Armvh4jvDtpfs3SYRLRxiAgzZ,True,86652496,12386691,55991,27995,27996,6L1WYrPiCMyi7XemPww4B4hvpKD1LQKD4RpiSKmrmgSC,3916990,44182132,-40265142,452
2022-05-09 02:11:03-04:00,19496,5xkW7wHTcF5WadNtBBqKPKctVwyQtTqqscivAmxzseCk,7m31ZMZdCn5Gz2q5sETWA7uKA5LsKD7pJHBBqU3g7tCn,True,2219864995,554966248,1642303,821151,821152,6L1WYrPiCMyi7XemPww4B4hvpKD1LQKD4RpiSKmrmgSC,65692155,255122100,-189429945,295
2022-05-09 02:11:03-04:00,19497,C8EuUJigyRy2ojSuZtDSnc4JxmVqoe5XTr4xaPPmKsyV,6PrUiT94hGcBm2AvkmkrnRnjXkR8WxmtJcvSapde3J1P,True,136518758,34129689,100707,50353,50354,C4UnXuShCvjSMgBAgVNMy1oakxCNk1et27A82fywU112,4028289,293874407,-289846118,295
2022-05-09 02:11:05-04:00,19498,3zVmiyif8VbqUW7dAeEMYJYrg8r5pCeBfALsdgu6kgFJ,FwzrxNbJsiCQwqayaDhwkbm9TRG11bK6fWs5Dn75da9a,True,130782712,32695678,98801,49400,49401,C4UnXuShCvjSMgBAgVNMy1oakxCNk1et27A82fywU112,3952063,53693869,-49741806,302
2022-05-09 02:11:06-04:00,19499,3pRKRd4i6jepz5HPbSsSFj2YKwYBjgVAk2v7ZMBYZVNR,Fzf7Gx6KJam5A1eny5G49cRS2zZHFt7XMxCx8N1Ej2Jd,True,80147616,20036904,60025,30012,30013,6L1WYrPiCMyi7XemPww4B4hvpKD1LQKD4RpiSKmrmgSC,2401007,32985082,-30584075,299
2022-05-09 02:11:08-04:00,19500,H7rsFRRhZPe2jLex2NkbYYzVtLobvFiqnCd4BUyJVPBB,8bedwDRfSKLP9vUxoXcpHNJzWQemMaf4QGT2mtHFVJFb,True,159378197,39844549,118265,59132,59133,C4UnXuShCvjSMgBAgVNMy1oakxCNk1et27A82fywU112,4730636,10817659,-6087023,296
2022-05-09 02:11:08-04:00,19501,FuhTkUxSaJ7kvuu9LHZaPVfdbKAQSh9W8Zzso1XPKGZp,FLoqPzREreKfRCwqtXs3CJwpTSudmXrVYCRZadWvob7j,True,137629061,34407265,102220,51110,51110,3zqXX6kzhkbW3d4TwD2CNjMRwxTbREXySekvq37kfCNk,4088827,58954772,-54865945,297
2022-05-09 02:11:11-04:00,19502,dXBy1yuMFpCNtCLNfhPACRrcSJ9qZCwjgCjGWzHbNfX,3fh1g6fHkHeycwb9UAUCE8qXgiXdtjVp95GE9j39Kxsn,True,79770895,19942723,55986,27993,27993,C4UnXuShCvjSMgBAgVNMy1oakxCNk1et27A82fywU112,2239467,46407272,-44167805,280
2022-05-09 02:11:39-04:00,19503,648dg79UazWHnwQ9p4kxQdcRXPhc21377kEQnSPssvfz,3d12WWiYbtie5eEyJjqTiLfyR82oQPdaQV2HdVH5d4AK,True,40524645,10131161,62843,31421,31422,68sueyVfmy5ToEGtLFGDkwebX47xAmzyXE29z8JrmcWv,2513734,36989491,-34475757,620
2022-05-09 02:11:42-04:00,19504,HXQXfEQe7aCpr6WKh37XaDZsjZcuQPk5t8tWNFgEoK6U,5ufXkCEDwgiXwtyPye4wYVVA3oLW54JVzz4tnXFofto4,True,1501434843,375358710,1117099,558549,558550,gjBMZYVujDjD1ECG4i97M8Q3gV9ESnwwTSUGropkusj,44683996,624022374,-579338378,297
2022-05-09 02:11:42-04:00,19505,5zqXqEjg95BnghcVbHRhYkSTYnzZjUBichgccv1BpS3d,9SuqSxrKpHh9NcNePe4Q3jXvpCmhNnoQv8YAFih3CqMX,True,52638159,13159539,39693,19846,19847,6L1WYrPiCMyi7XemPww4B4hvpKD1LQKD4RpiSKmrmgSC,1587728,21799159,-20211431,301
2022-05-09 02:11:43-04:00,19506,BAkPsWHtpVcEGqUgKTKjwZ6d5aaUcaUhdgYxBnpSTDW2,BDwDmVaZnXh22sf8nsDtjVfgxMAswbM3PW3si3k4nbRK,True,331800235,82950058,246632,123316,123316,6L1WYrPiCMyi7XemPww4B4hvpKD1LQKD4RpiSKmrmgSC,9865307,130236754,-120371447,297
2022-05-09 02:11:44-04:00,19507,EVMrznfJS54BZiywDD2WhUtxzicDtbEpm2a5yLrtCgRF,CpzsMYVYvKg8ihrX1cKRw7TDEYwD3kAyiX92hsf2KiTz,True,842819358,117439937,514056,257028,257028,3zqXX6kzhkbW3d4TwD2CNjMRwxTbREXySekvq37kfCNk,36891813,519794303,-482902490,437
2022-05-09 02:11:44-04:00,19508,BEuVsj9KuYBTaxrLpKwrQtHxmhRtB16siNfPXsAvf6rz,BTjWitiLbteuKMzaFj1daYyM2v9rZygESDktu8cuzC8g,True,91766891,22941722,61888,30944,30944,C4UnXuShCvjSMgBAgVNMy1oakxCNk1et27A82fywU112,2475539,10475484,-7999945,269
2022-05-09 02:11:44-04:00,19509,31TiU5VAiR77Zec49S5x2Y9EqdyMqi8Gx5T2bLxAazhU,iZkdEaFdSoYXBFEp3GPVJZvg5ZbiVdjNvHaTEvXxUmp,True,99240174077,24810043519,72290863,36145431,36145432,GXyFXZMNk2NFyEzw6JetVqsujqcz2yCixH7n8EpDJYWD,2891634534,7603987901,-4712353367,291
2022-05-09 02:11:46-04:00,19510,HT2SuCbePhjNZaar24uVwihYowCNvSjdvhJ8BRSVw9nX,98Ts4LCnapHVoCJ5PW3Armvh4jvDtpfs3SYRLRxiAgzZ,True,73877428,5107559,24008,12004,12004,6L1WYrPiCMyi7XemPww4B4hvpKD1LQKD4RpiSKmrmgSC,3472622,36950349,-33477727,470
2022-05-09 02:11:46-04:00,19511,5nALef7nAfNkSQSuTBLwewDby4pUx74Gzqib33Znmmt6,8xNTWK2xNK2xZPpgXfcE4QxPT2i6YvNYakiLgdQ2FqEt,True,41300207,10325051,29410,14705,14705,C4UnXuShCvjSMgBAgVNMy1oakxCNk1et27A82fywU112,1176401,5978363,-4801962,284
2022-05-09 02:11:46-04:00,19512,EvyfGotAupGEVB3cYU1CNRUQViTZy5kEqmTLEtcKUk1g,EQPEArqtyfWLkhxAaqqkXdksAyTLfUEpRoDBx4s4Rmwv,False,1596997,1596997,40327,2016,38311,3zqXX6kzhkbW3d4TwD2CNjMRwxTbREXySekvq37kfCNk,40327,938330,-898003,252
2022-05-09 02:11:46-04:00,19513,7qEVqFr1naSPCDV9q3xx6KMZn1yCHvkHZJkaA46NLmSE,8Mohcixq2L9PYrHpb95vuEsXqJ18JhEHi3RA83VM9cLv,True,299404234,74851058,213901,106950,106951,C4UnXuShCvjSMgBAgVNMy1oakxCNk1et27A82fywU112,8556056,100045911,-91489855,285
2022-05-09 02:11:47-04:00,19514,3u8kTzHN7uChpqJpH4WkMvBGxz7Rsg93EvB3k7dPf7G1,GWdMVk7p7EE1fPqfcyrVhcTsYXV6MoyV9bLdMYW45YQv,True,70260427,17565106,50843,25421,25422,C4UnXuShCvjSMgBAgVNMy1oakxCNk1et27A82fywU112,2033738,23310920,-21277182,289
2022-05-09 02:11:47-04:00,19515,Eps7NSYQhiSzaTpTLzx5aoDykXSKtQ6w1JBFuucC8hQp,EeNkTwr26mYEBqYHqoHaBZfybPS2PwcbJsgmQGJY6g89,True,107329848,26832462,74664,37332,37332,C4UnXuShCvjSMgBAgVNMy1oakxCNk1et27A82fywU112,2986564,44470125,-41483561,278
2022-05-09 02:11:47-04:00,19516,CMVVfXQYALSc58NLD67L8YrJAbDHZ9rFZvYQC7r8Png4,44pytMX14zaEQv6aRQ223CxYB2uTP7VUTQfUY58EkaNB,True,360457266,90114316,248609,124304,124305,2xTUy2RS74GJMMDnmFaegMzFLn19RVfYG4CibhBmjP1i,9944396,150219751,-140275355,275
2022-05-09 02:11:47-04:00,19517,FU3fRyQxk6rwtD9Db1nTvTAjSwgSW9vi1q7SjZ92ijyM,7c3maBK3hpb1exxqcvnwiUfhhUBgLgCs5exANSZ7m494,True,464932775,116233193,320250,160125,160125,DA18qE9qesbBqpwNv1M4befYcNQkbSBSeLPTmQzrmbJw,12810034,47646531,-34836497,275
2022-05-09 02:11:47-04:00,19518,EHi1UBG8wMUFZECktsFUZkGjJPaBNEedswS62hyYn6jC,Drx9ErQhAjnPuJ83LPYFnY5ZV5XDzGuXDuSf16VqWayp,True,989497979,54124492,201277,100638,100639,C4UnXuShCvjSMgBAgVNMy1oakxCNk1et27A82fywU112,36797304,629635795,-592838491,371
2022-05-09 02:11:48-04:00,19519,2AAWghW6BUAFBtF3R6hB9uoqMc5oUDkU8FTd2JrXKema,798cfEUZ2YhXwNTNjXMS4Z2J8gAHaK4zZwpMkq2HzWWM,True,55427755,13856938,36223,18111,18112,6L1WYrPiCMyi7XemPww4B4hvpKD1LQKD4RpiSKmrmgSC,1448938,57932856,-56483918,261
2022-05-09 02:11:51-04:00,19520,A7j77tzgnQVGtHTa65VtVZqJRYeJvQk7am8NW6e66379,4vJGwEvXU2tGWoWWGwbsYcfKQAMCHbrBMRk4ZVFzneLs,True,1200756113,300189028,829602,414801,414801,72XWPCtRYEDZbddP7d6dHtUBRRDLSJsB2xZTAfefoEVZ,33184111,334429568,-301245457,276
2022-05-09 02:11:51-04:00,19521,DRVtEzZs9u9ysrcANZLEjrvbuuGqYn77v2h4cDFKuNUx,Fv9qiMZhuSBL2cs9AWUYbDLQjB46W2ZwrhxaNXtPLDpC,True,27761922209,6940480552,19403507,9701753,9701754,72XWPCtRYEDZbddP7d6dHtUBRRDLSJsB2xZTAfefoEVZ,776140308,1423307732,-647167424,279
2022-05-09 02:11:53-04:00,19522,Fczxdc24Eav8xcaKRDwWMEwPEzkGyEJ7qGcXYyGZFKVz,8GqweYpec4cnpaJvueF3FGWoaz72BAzpLYXBX7tuuqEt,True,117809425,29452356,77708,38854,38854,C4UnXuShCvjSMgBAgVNMy1oakxCNk1et27A82fywU112,3108326,82243581,-79135255,263
2022-05-09 02:11:53-04:00,19523,26pvf6YygxQ8CdL4h4PcMuYNQtFbUVisTsYaFB3EZXvd,9tVSyevo14cUe2NMoBteqgV7vw44m6ooz2rD9ricKh55,True,220250017,55062504,132080,66040,66040,3zqXX6kzhkbW3d4TwD2CNjMRwxTbREXySekvq37kfCNk,5283233,92675461,-87392228,239
2022-05-09 02:11:55-04:00,19524,EVoc9HuMgnTyrYjC1ySj3sYVzXccSPjupjgj69gMkuNQ,2ahbZJgSLSyppym6N7iyby3SvQcCzYrjdioGLAmhf7Y8,True,80735694,20183923,57223,28611,28612,C4UnXuShCvjSMgBAgVNMy1oakxCNk1et27A82fywU112,2288942,23877495,-21588553,283
2022-05-09 02:11:55-04:00,19525,8DSiP9CwJm3AEcH6uuAYFpArRRDLYpDQgjHEvjkUgfg2,ERJ8kuhPRRmUAhSM4oxUheh39YUVVYNgaTt6AdMXcCvL,True,44130776,11032694,30905,15452,15453,C4UnXuShCvjSMgBAgVNMy1oakxCNk1et27A82fywU112,1236224,18294717,-17058493,280
2022-05-09 02:11:56-04:00,19526,82EMpA1hwF9KNQy2ZB2A1HdoEowBu2CoYhW3VmohkSnk,hn67zsTzsAs2aqk6ZjfEeoRygd3CdMeCuR82h9yuiz3,False,31392205,31392205,903282,45164,858118,C4UnXuShCvjSMgBAgVNMy1oakxCNk1et27A82fywU112,903282,12641866,-11738584,287
2022-05-09 02:11:57-04:00,19527,7cvbksBKz3SyD4Waqpa3qaBAj7ZVZcxL5M1mJrHemDoK,5Pyxm6RqTPwQp2ji2mkbqC56Bg2Ps9ed9YGXz5HXezRr,True,67165319,16791329,48441,24220,24221,C4UnXuShCvjSMgBAgVNMy1oakxCNk1et27A82fywU112,1937677,14815892,-12878215,288
2022-05-09 02:12:00-04:00,19528,9PhhcWBFRZin6HDmEPzngPgGMd6DrnWpiopAhVGQ9Mpm,3qAx8SsRYqkNdwLtZDdUXDerAmkaib1sbfPNVu2nPmBK,False,33136427,33136427,984319,49215,935104,6L1WYrPiCMyi7XemPww4B4hvpKD1LQKD4RpiSKmrmgSC,984320,10245097,-9260777,297
2022-05-09 02:12:03-04:00,19529,BSDeCyJsPs6y1pbDVHNq5rs6tdxcrbY3NDjXPBxwRjHz,DjHD3jawBVikzjcQ5dXBRLdUmEeBHKt6JZLhvmjScDku,True,37660274,4915776,15843,7921,7922,C4UnXuShCvjSMgBAgVNMy1oakxCNk1et27A82fywU112,1213828,20199874,-18986046,322
2022-05-09 02:12:04-04:00,19530,F47ihi3LtNYspD1tkQhind1ce8udZ628Ye1NuDBd3Me1,HqzXiTisYpcPHCAMvceUL8WSrzEX38TuGkzPaGJSdAHm,True,126026135,31506533,92808,46404,46404,3zqXX6kzhkbW3d4TwD2CNjMRwxTbREXySekvq37kfCNk,3712347,27689190,-23976843,294
2022-05-09 02:16:17-04:00,19531,BEuVsj9KuYBTaxrLpKwrQtHxmhRtB16siNfPXsAvf6rz,BTjWitiLbteuKMzaFj1daYyM2v9rZygESDktu8cuzC8g,True,68399366,17099841,49696,24848,24848,C5o4TfkUfECutAWsDELjhsZX6PYyYgK3XeKvx6p4FphM,1987848,8413692,-6425844,290
2022-05-09 02:16:17-04:00,19532,CnNbPk9YL7y2PiqMfVvS1789stfDA7ZDk3sArJSw6FwP,9oamN33gGnx3tU9Mnn53yhi6F2Du5AAaSV6uAi69rbib,True,83734357,20933589,54914,27457,27457,68sueyVfmy5ToEGtLFGDkwebX47xAmzyXE29z8JrmcWv,2196598,35023022,-32826424,262
2022-05-09 02:16:17-04:00,19533,7tFD53kPTqrzjCu1Wji78gUqhoRtCUhsP1pM3DQKT7uG,BJvgPLYBDJrQJdQVowrsMwUGMurq4zTihoFwWoEokfu3,True,251647597,35387551,102734,51367,51367,C5o4TfkUfECutAWsDELjhsZX6PYyYgK3XeKvx6p4FphM,7305691,62902553,-55596862,290
2022-05-09 02:16:17-04:00,19534,FuhTkUxSaJ7kvuu9LHZaPVfdbKAQSh9W8Zzso1XPKGZp,FLoqPzREreKfRCwqtXs3CJwpTSudmXrVYCRZadWvob7j,True,102185594,25546398,73760,36880,36880,C5o4TfkUfECutAWsDELjhsZX6PYyYgK3XeKvx6p4FphM,2950405,45136301,-42185896,288
2022-05-09 02:16:17-04:00,19535,3Xbsek5MsEGoWr3G9yhuohREr26B2vSQcjqXdspTFHta,2rPxkUiMo9wGDq8EvAiwY3ngRpKmL223cBWWNTYoBmFp,True,1134964984,283741246,772555,386277,386278,A2p75MbAbeUdHkPLkAjgGeiwuu9WPrkMHzjCkDXF1Xr3,30902215,88369881,-57467666,272
2022-05-09 02:16:17-04:00,19536,5xkW7wHTcF5WadNtBBqKPKctVwyQtTqqscivAmxzseCk,7m31ZMZdCn5Gz2q5sETWA7uKA5LsKD7pJHBBqU3g7tCn,True,1646536706,411634176,1142195,571097,571098,6UQfSsLooL4pQKQfLtXCutQS2BnF7A7F7ewJopDLmUpc,45687811,206169639,-160481828,277
2022-05-09 02:16:18-04:00,19537,HXQXfEQe7aCpr6WKh37XaDZsjZcuQPk5t8tWNFgEoK6U,5ufXkCEDwgiXwtyPye4wYVVA3oLW54JVzz4tnXFofto4,True,1116210979,279052744,842543,421271,421272,6L1WYrPiCMyi7XemPww4B4hvpKD1LQKD4RpiSKmrmgSC,33701743,478098360,-444396617,301
2022-05-09 02:16:18-04:00,19538,kEstb9msKrdEaMjoEad819rcrobFGdiknwKxTi1Dw6y,5fgoHmS5JvLHxKc2rqTy9efcwGT92rgEs1eB12DtXvVf,True,41451797,10362949,26118,13059,13059,C4UnXuShCvjSMgBAgVNMy1oakxCNk1et27A82fywU112,1044720,7980357,-6935637,252
2022-05-09 02:16:18-04:00,19539,GpDhvRRae2uiRZ6MnJYnVR2hANNLGFGUDnsQmGjfK8AP,B2pgJ4gPdgzvx2HMJ1wagtthpZebtBk7RD3cF1zqSyT8,True,56550472,14137618,36477,18238,18239,68sueyVfmy5ToEGtLFGDkwebX47xAmzyXE29z8JrmcWv,1459088,24737099,-23278011,258
2022-05-09 02:16:20-04:00,19540,JCagxpXPs6wVRUWbNBPCZ4uLCkZsachnofN7SZEEwGwB,5uGj1TBCkc7FV4ffdBJg31yLcCxkQLxRExjcinnJUow9,True,43391107,3902569,11203,5601,5602,6L1WYrPiCMyi7XemPww4B4hvpKD1LQKD4RpiSKmrmgSC,1245663,44269199,-43023536,287
2022-05-09 02:16:20-04:00,19541,5jAGYgNPbxE171j6GLMhf2WjbGzm7vKMifg5tAPcUPc1,EWoKgDPerFZ2ExRi6wWK9xBSyT2xQptp46Rdh39jF7Kt,True,36744139,3359474,13276,6638,6638,6L1WYrPiCMyi7XemPww4B4hvpKD1LQKD4RpiSKmrmgSC,1452191,11410623,-9958432,395
2022-05-09 02:16:20-04:00,19542,5Y7MpvBDW2jVq5SwkJQrVjqMSBEfwvB7dF9N1dD6s9bk,5KvuS6ew8J4KCeX46ZZmvpuSBzK2DatDJmpm7cMwMKnp,True,45488900,11372225,30645,15322,15323,6L1WYrPiCMyi7XemPww4B4hvpKD1LQKD4RpiSKmrmgSC,1225809,19049058,-17823249,269
2022-05-09 02:16:20-04:00,19543,7eu6E4dPaNaamUEgiQDn9UT6wv347SnEhPb3Dvir7FWD,4zkNx1B5pZDyzeDSVfuv3h91VXeHDQGVMwwdHhNn38fy,False,99850,99850,2935,146,2789,68sueyVfmy5ToEGtLFGDkwebX47xAmzyXE29z8JrmcWv,2935,27007,-24072,293
2022-05-09 02:16:21-04:00,19544,6d6HN8LWikwW2HYdy3BABWuxKHt1sgv4DcneACR133sE,4eKvzmfFvX96XbujKBhUauAvWP4yQYwZH3pd7gXzbCvJ,True,90261166,22565291,62068,31034,31034,C4UnXuShCvjSMgBAgVNMy1oakxCNk1et27A82fywU112,2482731,26117563,-23634832,275
2022-05-09 02:16:21-04:00,19545,AvvZT6q65qCaCdETtpR9XbCvY4Rv9RdpvbGuh6umEA9X,8dP2GJEjKTk9x7focRgCAYJauaGXENyxMU3EtgPA4gas,True,38479146,3368673,13320,6660,6660,68sueyVfmy5ToEGtLFGDkwebX47xAmzyXE29z8JrmcWv,1521604,11839402,-10317798,395
2022-05-09 02:16:21-04:00,19546,26pvf6YygxQ8CdL4h4PcMuYNQtFbUVisTsYaFB3EZXvd,9tVSyevo14cUe2NMoBteqgV7vw44m6ooz2rD9ricKh55,True,164690699,41172674,116358,58179,58179,C4UnXuShCvjSMgBAgVNMy1oakxCNk1et27A82fywU112,4654339,70695927,-66041588,282
2022-05-09 02:16:24-04:00,19547,H7rsFRRhZPe2jLex2NkbYYzVtLobvFiqnCd4BUyJVPBB,8bedwDRfSKLP9vUxoXcpHNJzWQemMaf4QGT2mtHFVJFb,True,118361557,29590389,86007,43003,43004,C4UnXuShCvjSMgBAgVNMy1oakxCNk1et27A82fywU112,3440280,9177872,-5737592,290
2022-05-09 02:16:24-04:00,19548,dXBy1yuMFpCNtCLNfhPACRrcSJ9qZCwjgCjGWzHbNfX,3fh1g6fHkHeycwb9UAUCE8qXgiXdtjVp95GE9j39Kxsn,True,59241145,14810286,39911,19955,19956,3zqXX6kzhkbW3d4TwD2CNjMRwxTbREXySekvq37kfCNk,1596454,35309423,-33712969,269
2022-05-09 02:16:25-04:00,19549,6mFwPJuXCwoqydoapb6H1BoNVj6scgbMQfkEnW93eu2k,B6u1FT2hozVZsyZ1XzZYrUygGCRhHJTfvt6BW24NWDVU,False,475033,475033,14007,700,13307,3zqXX6kzhkbW3d4TwD2CNjMRwxTbREXySekvq37kfCNk,14007,105643,-91636,294
2022-05-09 02:16:25-04:00,19550,3pRKRd4i6jepz5HPbSsSFj2YKwYBjgVAk2v7ZMBYZVNR,Fzf7Gx6KJam5A1eny5G49cRS2zZHFt7XMxCx8N1Ej2Jd,True,59520696,14880174,43774,21887,21887,C5o4TfkUfECutAWsDELjhsZX6PYyYgK3XeKvx6p4FphM,1750966,25279118,-23528152,294
2022-05-09 02:16:26-04:00,19551,3zVmiyif8VbqUW7dAeEMYJYrg8r5pCeBfALsdgu6kgFJ,FwzrxNbJsiCQwqayaDhwkbm9TRG11bK6fWs5Dn75da9a,True,97133960,24283490,72504,36252,36252,6L1WYrPiCMyi7XemPww4B4hvpKD1LQKD4RpiSKmrmgSC,2900188,41159826,-38259638,298
2022-05-09 02:16:26-04:00,19552,C8EuUJigyRy2ojSuZtDSnc4JxmVqoe5XTr4xaPPmKsyV,6PrUiT94hGcBm2AvkmkrnRnjXkR8WxmtJcvSapde3J1P,True,101393659,25348414,73304,36652,36652,68sueyVfmy5ToEGtLFGDkwebX47xAmzyXE29z8JrmcWv,2932172,221312687,-218380515,289
2022-05-09 02:16:28-04:00,19553,6fqbSyhh3PPdgRcLraHb7Jahj9s1oHHeX3SsjNSsGa6t,GpRUow48TYgttdYfsygbgjYQcmHyYjWETUDjDVphEgwq,True,63243318,8084160,22866,11433,11433,68sueyVfmy5ToEGtLFGDkwebX47xAmzyXE29z8JrmcWv,1788845,43924720,-42135875,282
2022-05-09 02:16:39-04:00,19554,DHfy6B2AYsqMCxPLBCXMDfQn3Gr2VwJaLFHUZKqpCjsb,EPZpYaY1gCAb8pMtri5veRowBmCrCpTHBMa3Rmgt6S29,True,84713850,21178462,63817,31908,31909,C5o4TfkUfECutAWsDELjhsZX6PYyYgK3XeKvx6p4FphM,2552691,11905827,-9353136,301
2022-05-09 02:23:23-04:00,19555,85gxgPczGaY9xtDwEvNrWLPhsJFqHPCG1DbbedtFwsVK,AhZjmArZneA5QoTrL8TxzLni6aUxQYZbTYym1YcY4Qhz,True,439821166,109955291,664049,332024,332025,A9TwRM1BMxqb8DCC7YNAMV6zPenEJm3HTZBy7wJKK58U,26561976,94388750,-67826774,603
2022-05-09 02:32:35-04:00,19556,Cb6MEn1MN9XQcVVd3o9J8QdK3cFWxSNETsFzhVJ8jmdh,A6yTKbggUftjbjAVu5YR1M7rg7h78ghbfofmTSnmKNGz,False,16074334,16074334,998113,49905,948208,6L1WYrPiCMyi7XemPww4B4hvpKD1LQKD4RpiSKmrmgSC,998113,1538469,-540356,620
2022-05-09 03:22:54-04:00,19557,3RpbaFEL5ZYrQBPpaAeCUXs43Ssdr5Tm4ScMGtp6XbYF,CpKGwcVZrd3vKTNhdF8xNsd77FT3QxQWb7xFQxiyPB5p,True,1659865704,414966426,2570854,1285427,1285427,A2p75MbAbeUdHkPLkAjgGeiwuu9WPrkMHzjCkDXF1Xr3,102834162,737618279,-634784117,619
2022-05-09 03:24:47-04:00,19558,4nqsW3XCJxzSsDdQzvE3zeM9nqBv8xVdUG8GxFWn6Edf,6eVvNs2rckFeTGkXZgPEGLYg4rmz3MFtoVNPRNmktcrY,True,627573761,156893440,1113822,556911,556911,2py1FiYeL2f7J3HU36qiJz6TD6HCmiTN36RyxYtapQCZ,44552906,94873760,-50320854,709
2022-05-09 03:28:10-04:00,19559,GNohZMtk1VAuhLAgNGT8J3HYCKDCiyjvLeAWr64d7Duy,6soTLVj9DzFht8DzvjRfNPAWhZuiDBS5fDE1fpeuDSSz,True,40853841,10213460,63293,31646,31647,6L1WYrPiCMyi7XemPww4B4hvpKD1LQKD4RpiSKmrmgSC,2531731,26931710,-24399979,619
2022-05-09 04:21:43-04:00,19560,HT2SuCbePhjNZaar24uVwihYowCNvSjdvhJ8BRSVw9nX,98Ts4LCnapHVoCJ5PW3Armvh4jvDtpfs3SYRLRxiAgzZ,True,68551866,4083126,19177,9588,9589,68sueyVfmy5ToEGtLFGDkwebX47xAmzyXE29z8JrmcWv,3219793,34101529,-30881736,469
2022-05-09 04:21:48-04:00,19561,GMpoV2jRyLdf2V3Gb5TQZ5gEs5ftMjD3JhFUzkA6fWVz,5bi814d5gdToTLVWCmbdB6J15kMdsTQk74cZTRd62p81,True,342689198,85672299,611679,305839,305840,68sueyVfmy5ToEGtLFGDkwebX47xAmzyXE29z8JrmcWv,24467160,105433769,-80966609,713
2022-05-09 04:21:54-04:00,19562,8KzrbHiup39X7Zw9grvh7gS9ZcA1zuhLGqgYguSjwnD6,A2EPmTs73YiS15ZKcjom55huNYaJY3WeP7NBDar1VE3R,True,2986819078,746704769,4621568,2310784,2310784,CGtKBgcWZ6HKE3tFNLPUM9khDv2Rc7d6BrPtxz7J1aY,184862740,3594167868,-3409305128,618
2022-05-09 04:23:40-04:00,19563,5rnSL1jkLDsAvWsKNrbxtBJEcavHbc41kSTWywUEmSaX,87ZzyZEPJAXq6UiTqQVNuChRQVSb7QcUJgV41saA8CFC,True,53656342,3350319,15143,7571,7572,6L1WYrPiCMyi7XemPww4B4hvpKD1LQKD4RpiSKmrmgSC,2425291,18777796,-16352505,452
2022-05-09 04:24:25-04:00,19564,AtaNpuHGEDd7kfakJbTbpphMdQk7ZWk9iB585TtNATKx,72egdmxZyhyYsM93hTMuoDd6NeYVB7gpiJG4PWj4Qi8f,True,49227649,4361383,17440,8720,8720,6L1WYrPiCMyi7XemPww4B4hvpKD1LQKD4RpiSKmrmgSC,1968570,15413418,-13444848,399
2022-05-09 04:24:36-04:00,19565,3CTLVMSTYE6azjXhZyhPD5XiUe23aJ4pb456SQnUiohH,13q8wAZ1zte3bd3LdeKLEUY7ubu2suCNRZVrgMScpV3C,True,52085065,2545562,10669,5334,5335,68sueyVfmy5ToEGtLFGDkwebX47xAmzyXE29z8JrmcWv,2183182,16349660,-14166478,419
2022-05-09 04:24:43-04:00,19566,CpeJ8BVz8Nd6SqnM3DYejnvAYnovDwu1taCqMEBD4RRi,GMmBgzDTtes62wJTENptaWPxNY2srWCrAdWErkj22Hzj,True,52052880,2545699,10649,5324,5325,6L1WYrPiCMyi7XemPww4B4hvpKD1LQKD4RpiSKmrmgSC,2177541,16374721,-14197180,418
2022-05-09 04:25:00-04:00,19567,HT2SuCbePhjNZaar24uVwihYowCNvSjdvhJ8BRSVw9nX,98Ts4LCnapHVoCJ5PW3Armvh4jvDtpfs3SYRLRxiAgzZ,True,64181659,9239970,41944,20972,20972,C4UnXuShCvjSMgBAgVNMy1oakxCNk1et27A82fywU112,2913535,33920188,-31006653,453
2022-05-09 04:25:19-04:00,19568,D5VZNThkv6XD6bimPshD2J3PvbPXgCbivZuPfkVxgdjc,8C77LmMk4C3KvyEb1N3scdbAgwN7J45nAcv9tkL5namB,True,305881098,76470274,470925,235462,235463,68sueyVfmy5ToEGtLFGDkwebX47xAmzyXE29z8JrmcWv,18837008,137688145,-118851137,615
2022-05-09 04:27:02-04:00,19569,9eWpSyu71Z6dmx7yTh7WrbVScdrrZN14d5tfmqEGFgXt,2r89PFKSD9zmSp2Wyx4CQ75HAtmUgwhAS2oG5MuYuiV6,True,611081355,109217044,430271,215135,215136,DA18qE9qesbBqpwNv1M4befYcNQkbSBSeLPTmQzrmbJw,24074178,240983643,-216909465,393
2022-05-09 04:28:46-04:00,19570,8T4WK27RvWVGqPuNqY6whk1fmU4vd5qaUQPZG1GJ79bh,DvSz7knS8N3K7L6JhQf1s4mJSyxB8uJXNQXtyjJn8QRL,True,458215403,113036555,313510,156755,156755,A9TwRM1BMxqb8DCC7YNAMV6zPenEJm3HTZBy7wJKK58U,12708780,61069139,-48360359,277
2022-05-09 04:28:46-04:00,19571,BTokEiM61aPMMH2YdKriPq5m6dCyj6TSbVEj16ce1eAh,3gjydeD1QCWV7pySMJpiSMh7V4wFSyqGro8sr1bQwB9P,False,2162792,2162792,58783,2939,55844,6L1WYrPiCMyi7XemPww4B4hvpKD1LQKD4RpiSKmrmgSC,58783,680391,-621608,271
2022-05-09 04:28:46-04:00,19572,7YCSi1xGHn5j65W5cZPkQ9RQzvpNgCGdrafAGGTLYkjE,BdVVPyQgd93sMf1SDCFFMvyugNsbdkrVNgaQCJEGjTLC,True,32880203,1519953,6322,3161,3161,6L1WYrPiCMyi7XemPww4B4hvpKD1LQKD4RpiSKmrmgSC,1367834,12175234,-10807400,416
2022-05-09 04:28:47-04:00,19573,DvSVpLMQyz91ksMwhuwwFDiKMo53FC5FVG5XrQZYWurJ,5jL2cYHg1QQpWYRCF4f378jpeHnTfPMWXiiHuhLNbzq8,True,51870772,2765063,11611,5805,5806,6L1WYrPiCMyi7XemPww4B4hvpKD1LQKD4RpiSKmrmgSC,2178241,17305203,-15126962,419
2022-05-09 04:28:47-04:00,19574,7w76zJFb9nTPDbfC4DCscQ2F5vimT8hiivT8WkuwWYWX,5X5XNdoFZv15bmbv97VRxHgTZzKyiFZpoz7MRNkPZS6f,True,49974235,2079972,8417,4208,4209,6L1WYrPiCMyi7XemPww4B4hvpKD1LQKD4RpiSKmrmgSC,2022391,16110823,-14088432,404
2022-05-09 04:28:48-04:00,19575,4YPn7VhWcrtecLaCBiVmXdmHwNmfR8qf2kzEtivmWrmK,EoEKgrmC6Xx6Ln8fWttD7wEtAkZtUbNifmv2mSHqV1Mf,True,85763890,21440972,59762,29881,29881,68sueyVfmy5ToEGtLFGDkwebX47xAmzyXE29z8JrmcWv,2390495,12133529,-9743034,278
2022-05-09 04:28:52-04:00,19576,FncFHJooh1hy9Gc2y5sKdcYkZ5uHzsxHG4vHT9cVZGcK,BkFa4b5Jyv4ZJCCpwDYv355ezVFiZfAtn18AV7kstd2v,True,157985577,39496394,117644,58822,58822,C4UnXuShCvjSMgBAgVNMy1oakxCNk1et27A82fywU112,4705797,33991259,-29285462,297
2022-05-09 04:29:42-04:00,19577,E6nDc3W2iqNJJASjkU8dj2JViZ5iDys3Qf6nGh4gjA9a,8YnGmR4CECAkHN7QRvxh2KKbrdCcq5gtsFV1rDyzvWG5,True,27158636,1167052,4756,2378,2378,68sueyVfmy5ToEGtLFGDkwebX47xAmzyXE29z8JrmcWv,1106858,9104576,-7997718,407
2022-05-09 04:29:43-04:00,19578,EodTi1tG2TSFyYPtDVKAxc6cuufzeEB6hg66HiZ36FFQ,8x8z784KpUypCtdBnGbs7jmUAiH83yXnG3QwXAWo4AZX,True,27161082,1167065,4766,2383,2383,68sueyVfmy5ToEGtLFGDkwebX47xAmzyXE29z8JrmcWv,1109272,9104587,-7995315,408
2022-05-09 04:29:43-04:00,19579,FRbeFwhUYCiHW5oP26mad8KND7CCYDbfnoNxX7GuXVp8,GrzXKxPX2WDka8i2D8sunMUsrsThKasQi8NYLwuCGygV,True,208511520,19581411,82993,41496,41497,6L1WYrPiCMyi7XemPww4B4hvpKD1LQKD4RpiSKmrmgSC,8837565,95227438,-86389873,423
2022-05-09 04:29:44-04:00,19580,Ai6G7vosJfmkRqtDAkqxRtbzELp6P5xe9r2RH3LYcLZt,8SUpKXakmhi4rYiFKnHYpgaAopomfDqEX6Efew9iM6nk,True,38533349,6740688,26390,13195,13195,6L1WYrPiCMyi7XemPww4B4hvpKD1LQKD4RpiSKmrmgSC,1508604,22023240,-20514636,391
2022-05-09 04:29:44-04:00,19581,A6wyZoJuJa5iqpXwYHfTiRs1G3MMaXVroDxdED89EyJp,HBYgKE6Lt2zXyobSHEbUdNCWPoxkikEEJHae15C1xptu,True,27170756,1167065,4746,2373,2373,6L1WYrPiCMyi7XemPww4B4hvpKD1LQKD4RpiSKmrmgSC,1105195,9090788,-7985593,406
2022-05-09 04:29:44-04:00,19582,9NhqXUfbpn5skKsZzCpnyD5wPTeLgDeKCxYQHR9TY9ej,8H1trMp7ATvrK1fzENWLg3xdDF6a4LJnNSc2APyQLi24,True,27161181,1167054,4758,2379,2379,68sueyVfmy5ToEGtLFGDkwebX47xAmzyXE29z8JrmcWv,1107544,9102034,-7994490,407
2022-05-09 04:30:22-04:00,19583,AXBfrbCpYAWKN5jgDVVMiKXscQ96YtotKV3DT6XSzm9o,Dh3SiHAqrQzPQnTLRMxtBn2EFyHNgyfnYGpgcuNGTvyL,True,54186115,13546528,82180,41090,41090,6L1WYrPiCMyi7XemPww4B4hvpKD1LQKD4RpiSKmrmgSC,3287208,29653248,-26366040,606
2022-05-09 04:30:27-04:00,19584,9AJH82vT5qffJDaufA827gZ3Za7bJcUoL6kLXCV2QfMX,78AU7GRaKkx98LcwijwUiZeYHPuEcKGpY8HWqDLgA6pX,False,31539047,31539047,951931,47596,904335,6L1WYrPiCMyi7XemPww4B4hvpKD1LQKD4RpiSKmrmgSC,951931,11733003,-10781072,301
2022-05-09 04:30:30-04:00,19585,B7235jQd2oUYooVva8FoqrbCAbcnZS1kfaAfATNBgADN,B6dRkkWvQrBpiaVnMJC4yniaNvxHfCcynjehdRP7eH1m,True,534096375,93856638,281999,140999,141000,2py1FiYeL2f7J3HU36qiJz6TD6HCmiTN36RyxYtapQCZ,16047372,85573674,-69526302,300
2022-05-09 04:30:34-04:00,19586,GcwFXxcxRF2xwbgFbQZoYEDreimd3J3UJ9sPfuwYVKtS,7uXjmKS8RxP2qSS7ataBH5hkfpgsFcpSBWUEBuV5zgyZ,True,169398953,42349738,128307,64153,64154,C4UnXuShCvjSMgBAgVNMy1oakxCNk1et27A82fywU112,5132281,46348023,-41215742,302
2022-05-09 04:30:40-04:00,19587,Bu65ba81oA2rZqxGAsctgz39NPPJqbXR3SvdMX5KQfTK,DcxNLDe2GwGiQPtQhzMiUjrMaqXjuyx1EGgX3xPtE98T,True,71378513,17844628,53650,26825,26825,6L1WYrPiCMyi7XemPww4B4hvpKD1LQKD4RpiSKmrmgSC,2146020,19748178,-17602158,300
2022-05-09 04:30:41-04:00,19588,AvvZT6q65qCaCdETtpR9XbCvY4Rv9RdpvbGuh6umEA9X,8dP2GJEjKTk9x7focRgCAYJauaGXENyxMU3EtgPA4gas,True,35071611,1621266,6769,3384,3385,68sueyVfmy5ToEGtLFGDkwebX47xAmzyXE29z8JrmcWv,1464348,11064680,-9600332,417
2022-05-09 04:30:42-04:00,19589,cXqFkCF4gaT9vAcZYMgwLXmmuD5w4hwgxT8YXE8JuBw,5Wtf4ZBL6R1afLeC4WfhFGkfi42TagtNAg6EZWn7gKhg,True,105532150,26383037,79342,39671,39671,C4UnXuShCvjSMgBAgVNMy1oakxCNk1et27A82fywU112,3173713,31117296,-27943583,300
2022-05-09 04:30:43-04:00,19590,GdUWbwTgHF1RRbpVXCahz36G7MqYrM6QaBgnjL2eLKxk,JDYxQpYMt38mmjzLrVjgi3ezpc3DQ8YJEtJTZbG6fCCq,True,51920714,2771824,11715,5857,5858,6L1WYrPiCMyi7XemPww4B4hvpKD1LQKD4RpiSKmrmgSC,2194466,17273863,-15079397,422
2022-05-09 04:30:43-04:00,19591,djW9rVm1v4nW64QiVqgFUCRza24VqthDcSfVEyRHPed,EsXvQmXVXECqZPtmSdiuwieHPP5jsmyn67p78vHaJcqq,True,151249039,37812259,114253,57126,57127,6L1WYrPiCMyi7XemPww4B4hvpKD1LQKD4RpiSKmrmgSC,4570153,18884133,-14313980,302
2022-05-09 04:30:44-04:00,19592,DMACzuFBuj2vGqxZ3FV7QAo24jMV3EHKL8MrDrGbRkaJ,EnLfmDVW4ba2uqZKhj3X1TFnx8AHv7xwSWrMbVBYwcu9,True,48835011,12208752,36686,18343,18343,C4UnXuShCvjSMgBAgVNMy1oakxCNk1et27A82fywU112,1467463,7791698,-6324235,300
2022-05-09 04:30:47-04:00,19593,BNEFSL7Mwtyq4ZbWaQB1UibDumKrqSbqkNVEYCJsMioH,GecT9hsySEeo6hHWed9UUkae2SYBjDCNGeC6R7UVK5Ds,True,27158110,1167050,4746,2373,2373,6L1WYrPiCMyi7XemPww4B4hvpKD1LQKD4RpiSKmrmgSC,1104466,9102724,-7998258,406
2022-05-09 04:30:48-04:00,19594,AtaNpuHGEDd7kfakJbTbpphMdQk7ZWk9iB585TtNATKx,72egdmxZyhyYsM93hTMuoDd6NeYVB7gpiJG4PWj4Qi8f,True,44748540,2079479,8519,4259,4260,6L1WYrPiCMyi7XemPww4B4hvpKD1LQKD4RpiSKmrmgSC,1833404,14507360,-12673956,409
2022-05-09 04:30:55-04:00,19595,agiVhhsNiMPzMaNWTHKRZ435HtBjqQvRuReKkpG32pn,HgcU2oCotYPxvGY6M21SbdqhzXJmNPDWEiTCDu4rA5dB,True,56371890,14092972,42595,21297,21298,C4UnXuShCvjSMgBAgVNMy1oakxCNk1et27A82fywU112,1703834,20412184,-18708350,302
2022-05-09 06:08:49-04:00,19596,HT2SuCbePhjNZaar24uVwihYowCNvSjdvhJ8BRSVw9nX,98Ts4LCnapHVoCJ5PW3Armvh4jvDtpfs3SYRLRxiAgzZ,True,54711009,3675011,17657,8828,8829,Hu94aiQWvce6THeGyCFqGRPM1pQrK3ihzkcXo1EpJcJL,2628712,28434139,-25805427,480
2022-05-09 06:11:25-04:00,19597,13GT6eaKWuaLe7wFcybCnUaYgd9DfyzYRN2FcXWgFwpC,CbwmJ7YpnvcqDyUw3L9b7dqXcA8Ju3rYrTdegeaJJbWC,True,17244577,4311144,26922,13461,13461,8sEswn3kzEhnYjAZVvCQnHEUvYd7pFVvc2Xc2Kd1BpbC,1076918,13896273,-12819355,624
2022-05-09 06:18:17-04:00,19598,EFzTG8kgbs1kExcFxcQrLSteeKD7jVqgQ2x3onCnhNuP,9wLCaZ7eVfs3u7Gp6HypL1Nz7hWgAcLcjbLtdyxf9gFU,True,683174807,79761835,406472,203236,203236,8sEswn3kzEhnYjAZVvCQnHEUvYd7pFVvc2Xc2Kd1BpbC,34815129,74671906,-39856777,509
2022-05-09 06:19:51-04:00,19599,5FewDaMC9U7n5EHcto98GaAmDVxDh5SYimuTP6AtfakM,7DAULUoqV7f9hsBzKEhjQPnWaHSqiMWcBqWcdcadaQv4,True,372279675,93069918,580914,290457,290457,2a35JJeTUW1pm6M3e8DHCjp8qr4vbc2cRPhuzZWyFzYd,23236566,61434372,-38197806,624
2022-05-09 06:19:54-04:00,19600,EVMrznfJS54BZiywDD2WhUtxzicDtbEpm2a5yLrtCgRF,CpzsMYVYvKg8ihrX1cKRw7TDEYwD3kAyiX92hsf2KiTz,True,723094952,47106569,219954,109977,109977,Hu94aiQWvce6THeGyCFqGRPM1pQrK3ihzkcXo1EpJcJL,33763426,478184762,-444421336,466
2022-05-09 06:22:56-04:00,19601,HT2SuCbePhjNZaar24uVwihYowCNvSjdvhJ8BRSVw9nX,98Ts4LCnapHVoCJ5PW3Armvh4jvDtpfs3SYRLRxiAgzZ,True,50807701,3036444,14239,7119,7120,68sueyVfmy5ToEGtLFGDkwebX47xAmzyXE29z8JrmcWv,2382758,26150319,-23767561,468
2022-05-09 06:23:10-04:00,19602,EVMrznfJS54BZiywDD2WhUtxzicDtbEpm2a5yLrtCgRF,CpzsMYVYvKg8ihrX1cKRw7TDEYwD3kAyiX92hsf2KiTz,True,673142958,45037902,205391,102695,102696,6L1WYrPiCMyi7XemPww4B4hvpKD1LQKD4RpiSKmrmgSC,30698047,432113983,-401415936,456
2022-05-09 06:23:11-04:00,19603,E17GuUpNNTyonDV7dtuit35hwQXtZ8fowHpHFHWSiiG3,GZ5DboskwBDP5fgYvp6djKFVFCo3MJkurtCY6cA8XVHr,True,39746321,9936580,62071,31035,31036,8sEswn3kzEhnYjAZVvCQnHEUvYd7pFVvc2Xc2Kd1BpbC,2482868,37736904,-35254036,624
2022-05-09 06:23:13-04:00,19604,7KfkiubVVGHekg5W5NW1QqxnbudXQroe8tCBsx4GgXAC,5j5yEzQKUmQi7dFM89QTYSRpBca2y5S5EvvLC8ZNuDgM,True,39746615,9936653,62066,31033,31033,C4UnXuShCvjSMgBAgVNMy1oakxCNk1et27A82fywU112,2482672,37736426,-35253754,624
2022-05-09 06:23:19-04:00,19605,85gxgPczGaY9xtDwEvNrWLPhsJFqHPCG1DbbedtFwsVK,AhZjmArZneA5QoTrL8TxzLni6aUxQYZbTYym1YcY4Qhz,True,324467793,81116948,505062,252531,252531,2a35JJeTUW1pm6M3e8DHCjp8qr4vbc2cRPhuzZWyFzYd,20202486,76476140,-56273654,622
2022-05-09 06:23:27-04:00,19606,CuFhLMgQ8ixnboam5iej9UdCCpf6D27oZRurcvbZHad7,GBaGVw5fbD2RCUYSK3FxvVHdtqaevRuQMe1p4KZUsfaF,True,39681991,9920497,29728,14864,14864,2a35JJeTUW1pm6M3e8DHCjp8qr4vbc2cRPhuzZWyFzYd,1189128,10543983,-9354855,299
2022-05-09 06:23:27-04:00,19607,EHi1UBG8wMUFZECktsFUZkGjJPaBNEedswS62hyYn6jC,Drx9ErQhAjnPuJ83LPYFnY5ZV5XDzGuXDuSf16VqWayp,True,932239459,99071229,353973,176986,176987,8sEswn3kzEhnYjAZVvCQnHEUvYd7pFVvc2Xc2Kd1BpbC,33308217,577931748,-544623531,357
2022-05-09 06:23:42-04:00,19608,6pUtYz474QrpATEZnfb3iFbTKYA65pNyKAo4TQZAjtqe,8dipRUXvxJiDLdHEtCPkso4vErbVwshHQiRfvSngBS9J,True,568653347,51139341,181164,90582,90582,Hu94aiQWvce6THeGyCFqGRPM1pQrK3ihzkcXo1EpJcJL,20144981,303207412,-283062431,354
2022-05-09 06:23:43-04:00,19609,7sgoB9mHcUoNFFdQSsBvyC4tXYzYR86ct11WQsS1FvAp,5k2QtQPgMUvj88Tmizf1pABHtC3VHJDc6BYNkB9gp19M,True,17598497,4399624,26921,13460,13461,6L1WYrPiCMyi7XemPww4B4hvpKD1LQKD4RpiSKmrmgSC,1076878,8217872,-7140994,611
2022-05-09 06:23:46-04:00,19610,9eWpSyu71Z6dmx7yTh7WrbVScdrrZN14d5tfmqEGFgXt,2r89PFKSD9zmSp2Wyx4CQ75HAtmUgwhAS2oG5MuYuiV6,True,498843598,42919775,176591,88295,88296,Hu94aiQWvce6THeGyCFqGRPM1pQrK3ihzkcXo1EpJcJL,20524659,230623677,-210099018,411
2022-05-09 06:23:51-04:00,19611,CpeJ8BVz8Nd6SqnM3DYejnvAYnovDwu1taCqMEBD4RRi,GMmBgzDTtes62wJTENptaWPxNY2srWCrAdWErkj22Hzj,True,49366817,2162460,8847,4423,4424,2a35JJeTUW1pm6M3e8DHCjp8qr4vbc2cRPhuzZWyFzYd,2019847,15153090,-13133243,409
2022-05-09 06:23:51-04:00,19612,5jAGYgNPbxE171j6GLMhf2WjbGzm7vKMifg5tAPcUPc1,EWoKgDPerFZ2ExRi6wWK9xBSyT2xQptp46Rdh39jF7Kt,True,33297868,3107821,12538,6269,6269,C4UnXuShCvjSMgBAgVNMy1oakxCNk1et27A82fywU112,1343456,10623154,-9279698,403
2022-05-09 06:23:53-04:00,19613,62q4KpVd3UXPomDaqpTF7recRAEh2ZKgWRgT92ztmda4,8xRdV8nWLb3CiCcHt2ZXEJv3NSfaa178zarhUkKv2rP9,True,66112481,4123986,18627,9313,9314,2a35JJeTUW1pm6M3e8DHCjp8qr4vbc2cRPhuzZWyFzYd,2986262,20873924,-17887662,451
2022-05-09 06:23:58-04:00,19614,HT2SuCbePhjNZaar24uVwihYowCNvSjdvhJ8BRSVw9nX,98Ts4LCnapHVoCJ5PW3Armvh4jvDtpfs3SYRLRxiAgzZ,True,47568826,6885595,31354,15677,15677,8sEswn3kzEhnYjAZVvCQnHEUvYd7pFVvc2Xc2Kd1BpbC,2166088,25988543,-23822455,455
2022-05-09 06:24:00-04:00,19615,3CTLVMSTYE6azjXhZyhPD5XiUe23aJ4pb456SQnUiohH,13q8wAZ1zte3bd3LdeKLEUY7ubu2suCNRZVrgMScpV3C,True,49382678,2168020,8819,4409,4410,6L1WYrPiCMyi7XemPww4B4hvpKD1LQKD4RpiSKmrmgSC,2008994,15127858,-13118864,406
2022-05-09 06:24:03-04:00,19616,EVMrznfJS54BZiywDD2WhUtxzicDtbEpm2a5yLrtCgRF,CpzsMYVYvKg8ihrX1cKRw7TDEYwD3kAyiX92hsf2KiTz,True,625265513,87587529,387365,193682,193683,6L1WYrPiCMyi7XemPww4B4hvpKD1LQKD4RpiSKmrmgSC,27653113,396683740,-369030627,442
2022-05-09 06:24:03-04:00,19617,6fqbSyhh3PPdgRcLraHb7Jahj9s1oHHeX3SsjNSsGa6t,GpRUow48TYgttdYfsygbgjYQcmHyYjWETUDjDVphEgwq,True,55055889,7719458,23213,11606,11607,2a35JJeTUW1pm6M3e8DHCjp8qr4vbc2cRPhuzZWyFzYd,1655661,41412376,-39756715,300
2022-05-09 06:24:04-04:00,19618,BSDeCyJsPs6y1pbDVHNq5rs6tdxcrbY3NDjXPBxwRjHz,DjHD3jawBVikzjcQ5dXBRLdUmEeBHKt6JZLhvmjScDku,True,32641216,3863996,12903,6451,6452,Hu94aiQWvce6THeGyCFqGRPM1pQrK3ihzkcXo1EpJcJL,1090075,16875678,-15785603,333
2022-05-09 06:24:05-04:00,19619,HHNj1MooHaJCm7SYAjdKSnk2sa7yUFH2PrQYWiN9E6uy,H6hKDBEsDh76s9H9FVBn1ZDTR27JEZTHUM7zwoWw26bc,True,2975534183,565915649,2264674,1132337,1132337,A9TwRM1BMxqb8DCC7YNAMV6zPenEJm3HTZBy7wJKK58U,119074569,238624906,-119550337,400
2022-05-09 06:24:05-04:00,19620,EFzTG8kgbs1kExcFxcQrLSteeKD7jVqgQ2x3onCnhNuP,9wLCaZ7eVfs3u7Gp6HypL1Nz7hWgAcLcjbLtdyxf9gFU,True,598469338,59306260,291988,145994,145994,3zqXX6kzhkbW3d4TwD2CNjMRwxTbREXySekvq37kfCNk,29465023,65768291,-36303268,492
2022-05-09 06:24:08-04:00,19621,5rnSL1jkLDsAvWsKNrbxtBJEcavHbc41kSTWywUEmSaX,87ZzyZEPJAXq6UiTqQVNuChRQVSb7QcUJgV41saA8CFC,True,50102432,2863216,12563,6281,6282,Hu94aiQWvce6THeGyCFqGRPM1pQrK3ihzkcXo1EpJcJL,2198463,17104880,-14906417,438
2022-05-09 06:24:27-04:00,19622,GNohZMtk1VAuhLAgNGT8J3HYCKDCiyjvLeAWr64d7Duy,6soTLVj9DzFht8DzvjRfNPAWhZuiDBS5fDE1fpeuDSSz,True,30040206,7510051,46314,23157,23157,2a35JJeTUW1pm6M3e8DHCjp8qr4vbc2cRPhuzZWyFzYd,1852567,20752782,-18900215,616
2022-05-09 06:24:46-04:00,19623,4nqsW3XCJxzSsDdQzvE3zeM9nqBv8xVdUG8GxFWn6Edf,6eVvNs2rckFeTGkXZgPEGLYg4rmz3MFtoVNPRNmktcrY,True,459644652,114911163,807436,403718,403718,2py1FiYeL2f7J3HU36qiJz6TD6HCmiTN36RyxYtapQCZ,32297476,81115876,-48818400,702
2022-05-09 06:25:22-04:00,19624,AvvZT6q65qCaCdETtpR9XbCvY4Rv9RdpvbGuh6umEA9X,8dP2GJEjKTk9x7focRgCAYJauaGXENyxMU3EtgPA4gas,True,33356877,3109765,12677,6338,6339,6L1WYrPiCMyi7XemPww4B4hvpKD1LQKD4RpiSKmrmgSC,1359825,10565513,-9205688,407
2022-05-09 06:25:35-04:00,19625,2AAWghW6BUAFBtF3R6hB9uoqMc5oUDkU8FTd2JrXKema,798cfEUZ2YhXwNTNjXMS4Z2J8gAHaK4zZwpMkq2HzWWM,True,41421164,10355291,31372,15686,15686,8sEswn3kzEhnYjAZVvCQnHEUvYd7pFVvc2Xc2Kd1BpbC,1254889,43767537,-42512648,302
2022-05-09 06:25:43-04:00,19626,4hZG7dM716SxDagiFGwt1gSC99B2QK1emGLV9TJmmuR8,7vjfUWySkyx4Z5qAaRr2VWnVvxHHNsvPj1PirGNSjM6,True,36281747,9070436,56666,28333,28333,2a35JJeTUW1pm6M3e8DHCjp8qr4vbc2cRPhuzZWyFzYd,2266646,33026882,-30760236,624
2022-05-09 06:25:59-04:00,19627,EHi1UBG8wMUFZECktsFUZkGjJPaBNEedswS62hyYn6jC,Drx9ErQhAjnPuJ83LPYFnY5ZV5XDzGuXDuSf16VqWayp,True,830387124,93569149,339994,169997,169997,3zqXX6kzhkbW3d4TwD2CNjMRwxTbREXySekvq37kfCNk,30173138,540008317,-509835179,363
2022-05-09 06:26:03-04:00,19628,BAkPsWHtpVcEGqUgKTKjwZ6d5aaUcaUhdgYxBnpSTDW2,BDwDmVaZnXh22sf8nsDtjVfgxMAswbM3PW3si3k4nbRK,True,246747916,61686979,186693,93346,93347,8sEswn3kzEhnYjAZVvCQnHEUvYd7pFVvc2Xc2Kd1BpbC,7467720,99849896,-92382176,302
2022-05-09 06:26:12-04:00,19629,8KzrbHiup39X7Zw9grvh7gS9ZcA1zuhLGqgYguSjwnD6,A2EPmTs73YiS15ZKcjom55huNYaJY3WeP7NBDar1VE3R,True,2198225978,549556494,3429828,1714914,1714914,CGtKBgcWZ6HKE3tFNLPUM9khDv2Rc7d6BrPtxz7J1aY,137193127,2736464004,-2599270877,624
2022-05-09 06:26:46-04:00,19630,A5NXadGWnFZRoHEn1dKTRjcXgWmfMLMyJdpF4rQPZyRR,ALs3Zfotc4c4A6TFDMbd5GM5whK1dTYSnGrHiMBWmApH,True,1368362502,342090625,1036098,518049,518049,DQCvC9mR68hJ3tJsUiddh6JwcBJAmntqGJR2nUsEq7yj,41443938,173043253,-131599315,302
2022-05-09 06:26:51-04:00,19631,648dg79UazWHnwQ9p4kxQdcRXPhc21377kEQnSPssvfz,3d12WWiYbtie5eEyJjqTiLfyR82oQPdaQV2HdVH5d4AK,True,29810425,7452606,46395,23197,23198,6L1WYrPiCMyi7XemPww4B4hvpKD1LQKD4RpiSKmrmgSC,1855807,28295717,-26439910,622
2022-05-09 06:26:52-04:00,19632,5zqXqEjg95BnghcVbHRhYkSTYnzZjUBichgccv1BpS3d,9SuqSxrKpHh9NcNePe4Q3jXvpCmhNnoQv8YAFih3CqMX,True,39114398,9778599,29402,14701,14701,8sEswn3kzEhnYjAZVvCQnHEUvYd7pFVvc2Xc2Kd1BpbC,1176088,16698918,-15522830,300
2022-05-09 06:27:03-04:00,19633,Fczxdc24Eav8xcaKRDwWMEwPEzkGyEJ7qGcXYyGZFKVz,8GqweYpec4cnpaJvueF3FGWoaz72BAzpLYXBX7tuuqEt,True,88010495,22002623,66666,33333,33333,Hu94aiQWvce6THeGyCFqGRPM1pQrK3ihzkcXo1EpJcJL,2666660,62364882,-59698222,302
2022-05-09 06:27:15-04:00,19634,JCagxpXPs6wVRUWbNBPCZ4uLCkZsachnofN7SZEEwGwB,5uGj1TBCkc7FV4ffdBJg31yLcCxkQLxRExjcinnJUow9,True,39446645,3563203,10727,5363,5364,Hu94aiQWvce6THeGyCFqGRPM1pQrK3ihzkcXo1EpJcJL,1187609,42255538,-41067929,301
2022-05-09 06:27:15-04:00,19635,FU3fRyQxk6rwtD9Db1nTvTAjSwgSW9vi1q7SjZ92ijyM,7c3maBK3hpb1exxqcvnwiUfhhUBgLgCs5exANSZ7m494,True,346510935,86627733,255814,127907,127907,6L1WYrPiCMyi7XemPww4B4hvpKD1LQKD4RpiSKmrmgSC,10232577,38550661,-28318084,295
2022-05-09 06:27:15-04:00,19636,A7j77tzgnQVGtHTa65VtVZqJRYeJvQk7am8NW6e66379,4vJGwEvXU2tGWoWWGwbsYcfKQAMCHbrBMRk4ZVFzneLs,True,894933918,223733479,663606,331803,331803,DQCvC9mR68hJ3tJsUiddh6JwcBJAmntqGJR2nUsEq7yj,26544265,258127542,-231583277,296
2022-05-09 06:27:17-04:00,19637,CMVVfXQYALSc58NLD67L8YrJAbDHZ9rFZvYQC7r8Png4,44pytMX14zaEQv6aRQ223CxYB2uTP7VUTQfUY58EkaNB,True,268635232,67158808,198372,99186,99186,Hu94aiQWvce6THeGyCFqGRPM1pQrK3ihzkcXo1EpJcJL,7934916,114850754,-106915838,295
2022-05-09 06:27:18-04:00,19638,Eps7NSYQhiSzaTpTLzx5aoDykXSKtQ6w1JBFuucC8hQp,EeNkTwr26mYEBqYHqoHaBZfybPS2PwcbJsgmQGJY6g89,True,79990483,19997620,59729,29864,29865,2a35JJeTUW1pm6M3e8DHCjp8qr4vbc2cRPhuzZWyFzYd,2389170,34008886,-31619716,298
2022-05-09 06:27:18-04:00,19639,F47ihi3LtNYspD1tkQhind1ce8udZ628Ye1NuDBd3Me1,HqzXiTisYpcPHCAMvceUL8WSrzEX38TuGkzPaGJSdAHm,True,93687244,23421811,69216,34608,34608,8sEswn3kzEhnYjAZVvCQnHEUvYd7pFVvc2Xc2Kd1BpbC,2768644,21583803,-18815159,295
2022-05-09 06:27:21-04:00,19640,6wGzqSWYjB1nukhDwLdgXDzMNSeasuRur3FVZAkVF4pM,HTcJjvQNFJQEewRf8iCcsZgFcfHoUXzpbb7WscqdK4kS,True,108446727,27111681,165709,82854,82855,8sEswn3kzEhnYjAZVvCQnHEUvYd7pFVvc2Xc2Kd1BpbC,6628375,26956625,-20328250,611
2022-05-09 06:27:22-04:00,19641,6pUtYz474QrpATEZnfb3iFbTKYA65pNyKAo4TQZAjtqe,8dipRUXvxJiDLdHEtCPkso4vErbVwshHQiRfvSngBS9J,True,516026037,48701694,174371,87185,87186,Hu94aiQWvce6THeGyCFqGRPM1pQrK3ihzkcXo1EpJcJL,18475848,288790605,-270314757,358
2022-05-09 06:27:23-04:00,19642,HdRgh9niYSd3YKCxzGdusYFquiVoFTP2mEGEzJJL5Nii,78C68Gbb1jYFQmYNCHHjL52keEKMXtGukmBwT7ahon4B,False,7168086,7168086,216722,10836,205886,2a35JJeTUW1pm6M3e8DHCjp8qr4vbc2cRPhuzZWyFzYd,216723,7434933,-7218210,302
2022-05-09 06:27:23-04:00,19643,DRVtEzZs9u9ysrcANZLEjrvbuuGqYn77v2h4cDFKuNUx,Fv9qiMZhuSBL2cs9AWUYbDLQjB46W2ZwrhxaNXtPLDpC,True,20685946509,5171486627,15428524,7714262,7714262,AmTrMPzuTp2BjnjqGNKqz9FTTCdpoKcPAJLwFc8ozcbh,617140988,1245018208,-627877220,298
2022-05-09 06:27:23-04:00,19644,Ai6G7vosJfmkRqtDAkqxRtbzELp6P5xe9r2RH3LYcLZt,8SUpKXakmhi4rYiFKnHYpgaAopomfDqEX6Efew9iM6nk,True,31638582,2847946,11904,5952,5952,Hu94aiQWvce6THeGyCFqGRPM1pQrK3ihzkcXo1EpJcJL,1322527,20069257,-18746730,418
2022-05-09 06:27:23-04:00,19645,7tFD53kPTqrzjCu1Wji78gUqhoRtCUhsP1pM3DQKT7uG,BJvgPLYBDJrQJdQVowrsMwUGMurq4zTihoFwWoEokfu3,True,215469434,27420784,81273,40636,40637,2a35JJeTUW1pm6M3e8DHCjp8qr4vbc2cRPhuzZWyFzYd,6386419,56026083,-49639664,296
2022-05-09 06:27:23-04:00,19646,GMpoV2jRyLdf2V3Gb5TQZ5gEs5ftMjD3JhFUzkA6fWVz,5bi814d5gdToTLVWCmbdB6J15kMdsTQk74cZTRd62p81,True,250569250,62642312,431233,215616,215617,6L1WYrPiCMyi7XemPww4B4hvpKD1LQKD4RpiSKmrmgSC,17249354,84436819,-67187465,688
2022-05-09 06:27:23-04:00,19647,HT2SuCbePhjNZaar24uVwihYowCNvSjdvhJ8BRSVw9nX,98Ts4LCnapHVoCJ5PW3Armvh4jvDtpfs3SYRLRxiAgzZ,True,40459698,2723317,12864,6432,6432,C4UnXuShCvjSMgBAgVNMy1oakxCNk1et27A82fywU112,1911201,21838869,-19927668,472
2022-05-09 06:27:24-04:00,19648,EVMrznfJS54BZiywDD2WhUtxzicDtbEpm2a5yLrtCgRF,CpzsMYVYvKg8ihrX1cKRw7TDEYwD3kAyiX92hsf2KiTz,True,535194848,34926772,161731,80865,80866,Hu94aiQWvce6THeGyCFqGRPM1pQrK3ihzkcXo1EpJcJL,24782612,365228577,-340445965,463
2022-05-09 06:27:24-04:00,19649,3CTLVMSTYE6azjXhZyhPD5XiUe23aJ4pb456SQnUiohH,13q8wAZ1zte3bd3LdeKLEUY7ubu2suCNRZVrgMScpV3C,True,47086525,4156169,16523,8261,8262,2a35JJeTUW1pm6M3e8DHCjp8qr4vbc2cRPhuzZWyFzYd,1872042,14474193,-12602151,397
2022-05-09 06:27:24-04:00,19650,5jAGYgNPbxE171j6GLMhf2WjbGzm7vKMifg5tAPcUPc1,EWoKgDPerFZ2ExRi6wWK9xBSyT2xQptp46Rdh39jF7Kt,True,30102758,1483813,6129,3064,3065,C4UnXuShCvjSMgBAgVNMy1oakxCNk1et27A82fywU112,1243629,9965173,-8721544,413
2022-05-09 06:27:25-04:00,19651,kEstb9msKrdEaMjoEad819rcrobFGdiknwKxTi1Dw6y,5fgoHmS5JvLHxKc2rqTy9efcwGT92rgEs1eB12DtXvVf,False,30974750,30974750,898367,44918,853449,Hu94aiQWvce6THeGyCFqGRPM1pQrK3ihzkcXo1EpJcJL,898367,6214211,-5315844,290
2022-05-09 06:27:26-04:00,19652,8DSiP9CwJm3AEcH6uuAYFpArRRDLYpDQgjHEvjkUgfg2,ERJ8kuhPRRmUAhSM4oxUheh39YUVVYNgaTt6AdMXcCvL,False,32866591,32866591,967316,48365,918951,Hu94aiQWvce6THeGyCFqGRPM1pQrK3ihzkcXo1EpJcJL,967316,13992701,-13025385,294
2022-05-09 06:27:26-04:00,19653,GpDhvRRae2uiRZ6MnJYnVR2hANNLGFGUDnsQmGjfK8AP,B2pgJ4gPdgzvx2HMJ1wagtthpZebtBk7RD3cF1zqSyT8,True,42256997,10564249,31459,15729,15730,C4UnXuShCvjSMgBAgVNMy1oakxCNk1et27A82fywU112,1258382,18872788,-17614406,297
2022-05-09 06:27:26-04:00,19654,7qEVqFr1naSPCDV9q3xx6KMZn1yCHvkHZJkaA46NLmSE,8Mohcixq2L9PYrHpb95vuEsXqJ18JhEHi3RA83VM9cLv,True,222845504,55711376,164758,82379,82379,2a35JJeTUW1pm6M3e8DHCjp8qr4vbc2cRPhuzZWyFzYd,6590329,76916432,-70326103,295
2022-05-09 06:27:26-04:00,19655,5nALef7nAfNkSQSuTBLwewDby4pUx74Gzqib33Znmmt6,8xNTWK2xNK2xZPpgXfcE4QxPT2i6YvNYakiLgdQ2FqEt,False,30739211,30739211,904956,45247,859709,Hu94aiQWvce6THeGyCFqGRPM1pQrK3ihzkcXo1EpJcJL,904956,4742390,-3837434,294
2022-05-09 06:27:26-04:00,19656,HooxSzasW3HMoFJ6sAvRQ75Char1J5aBdJtsqfDV6myp,BCmsWwpGeV4NNfeKZKKydty2uueLGHYTJDk1WErpXsVT,True,130467769,32616942,199900,99950,99950,6L1WYrPiCMyi7XemPww4B4hvpKD1LQKD4RpiSKmrmgSC,7996010,42746814,-34750804,612
2022-05-09 06:27:26-04:00,19657,CpeJ8BVz8Nd6SqnM3DYejnvAYnovDwu1taCqMEBD4RRi,GMmBgzDTtes62wJTENptaWPxNY2srWCrAdWErkj22Hzj,True,47060487,4156858,16492,8246,8246,Hu94aiQWvce6THeGyCFqGRPM1pQrK3ihzkcXo1EpJcJL,1867130,14494196,-12627066,396
2022-05-09 06:27:33-04:00,19658,3u8kTzHN7uChpqJpH4WkMvBGxz7Rsg93EvB3k7dPf7G1,GWdMVk7p7EE1fPqfcyrVhcTsYXV6MoyV9bLdMYW45YQv,True,52279143,13069785,38908,19454,19454,C4UnXuShCvjSMgBAgVNMy1oakxCNk1et27A82fywU112,1556357,17930479,-16374122,297
2022-05-09 06:27:33-04:00,19659,BSDeCyJsPs6y1pbDVHNq5rs6tdxcrbY3NDjXPBxwRjHz,DjHD3jawBVikzjcQ5dXBRLdUmEeBHKt6JZLhvmjScDku,False,28668936,28668936,968887,48444,920443,Hu94aiQWvce6THeGyCFqGRPM1pQrK3ihzkcXo1EpJcJL,968888,15508072,-14539184,337
2022-05-09 06:27:33-04:00,19660,EVoc9HuMgnTyrYjC1ySj3sYVzXccSPjupjgj69gMkuNQ,2ahbZJgSLSyppym6N7iyby3SvQcCzYrjdioGLAmhf7Y8,True,60114523,15028630,44563,22281,22282,C4UnXuShCvjSMgBAgVNMy1oakxCNk1et27A82fywU112,1782558,18411295,-16628737,296
2022-05-09 06:27:33-04:00,19661,CnNbPk9YL7y2PiqMfVvS1789stfDA7ZDk3sArJSw6FwP,9oamN33gGnx3tU9Mnn53yhi6F2Du5AAaSV6uAi69rbib,True,62549775,15637443,46957,23478,23479,Hu94aiQWvce6THeGyCFqGRPM1pQrK3ihzkcXo1EpJcJL,1878295,26749194,-24870899,300
2022-05-09 06:27:38-04:00,19662,7BEY9qatFJomsayFmky3h3dAbKhY5XkRGwMobJuxXYhQ,J8MK3tAQKreBUG2reXY6gqr1uhbHhcAZEcxsLQmG5Ntt,True,461952351,115488087,820070,410035,410035,2py1FiYeL2f7J3HU36qiJz6TD6HCmiTN36RyxYtapQCZ,32802813,168056312,-135253499,710
2022-05-09 06:27:52-04:00,19663,7cvbksBKz3SyD4Waqpa3qaBAj7ZVZcxL5M1mJrHemDoK,5Pyxm6RqTPwQp2ji2mkbqC56Bg2Ps9ed9YGXz5HXezRr,True,50004399,12501099,37743,18871,18872,C5o4TfkUfECutAWsDELjhsZX6PYyYgK3XeKvx6p4FphM,1509735,11538036,-10028301,301
2022-05-09 06:28:10-04:00,19664,5euvq1j9LCJWT1K7xKAE2TjwzbrWA5t6j2SxtnWsEPeU,GKDnouGNzg5JkjWG7Qs4nmka6qUMdYrk1fKwrmj8TvdH,True,66118389,4124333,18633,9316,9317,8sEswn3kzEhnYjAZVvCQnHEUvYd7pFVvc2Xc2Kd1BpbC,2987167,20868872,-17881705,451
2022-05-09 06:28:16-04:00,19665,3AaMzK9WAbD9m27szcJYnucnSPQ4W7tk8EztgWv4vqUo,8oUBQUKo9wHLu1tUEF1AeCUa7oRYyDSoFNRMqQAqKMbH,True,66168379,4124349,18626,9313,9313,Hu94aiQWvce6THeGyCFqGRPM1pQrK3ihzkcXo1EpJcJL,2988308,20827093,-17838785,451
2022-05-09 06:28:17-04:00,19666,5Y7MpvBDW2jVq5SwkJQrVjqMSBEfwvB7dF9N1dD6s9bk,5KvuS6ew8J4KCeX46ZZmvpuSBzK2DatDJmpm7cMwMKnp,True,33950744,8487686,25562,12781,12781,Hu94aiQWvce6THeGyCFqGRPM1pQrK3ihzkcXo1EpJcJL,1022501,14555895,-13533394,301
2022-05-09 06:28:17-04:00,19667,DHfy6B2AYsqMCxPLBCXMDfQn3Gr2VwJaLFHUZKqpCjsb,EPZpYaY1gCAb8pMtri5veRowBmCrCpTHBMa3Rmgt6S29,True,62952687,15738171,47342,23671,23671,6L1WYrPiCMyi7XemPww4B4hvpKD1LQKD4RpiSKmrmgSC,1893689,9491313,-7597624,300
2022-05-09 06:28:17-04:00,19668,5rnSL1jkLDsAvWsKNrbxtBJEcavHbc41kSTWywUEmSaX,87ZzyZEPJAXq6UiTqQVNuChRQVSb7QcUJgV41saA8CFC,True,47076525,2503517,10759,5379,5380,C4UnXuShCvjSMgBAgVNMy1oakxCNk1et27A82fywU112,2023209,16203334,-14180125,429
2022-05-09 06:28:21-04:00,19669,dXBy1yuMFpCNtCLNfhPACRrcSJ9qZCwjgCjGWzHbNfX,3fh1g6fHkHeycwb9UAUCE8qXgiXdtjVp95GE9j39Kxsn,True,44212073,11053018,33224,16612,16612,Hu94aiQWvce6THeGyCFqGRPM1pQrK3ihzkcXo1EpJcJL,1328989,26832552,-25503563,300
2022-05-09 06:28:22-04:00,19670,EHi1UBG8wMUFZECktsFUZkGjJPaBNEedswS62hyYn6jC,Drx9ErQhAjnPuJ83LPYFnY5ZV5XDzGuXDuSf16VqWayp,True,734064696,39672976,146354,73177,73177,Hu94aiQWvce6THeGyCFqGRPM1pQrK3ihzkcXo1EpJcJL,27079865,479773316,-452693451,368
2022-05-09 06:28:22-04:00,19671,62q4KpVd3UXPomDaqpTF7recRAEh2ZKgWRgT92ztmda4,8xRdV8nWLb3CiCcHt2ZXEJv3NSfaa178zarhUkKv2rP9,True,61717901,3513146,15352,7676,7676,8sEswn3kzEhnYjAZVvCQnHEUvYd7pFVvc2Xc2Kd1BpbC,2697041,19729276,-17032235,436
2022-05-09 06:28:22-04:00,19672,JCagxpXPs6wVRUWbNBPCZ4uLCkZsachnofN7SZEEwGwB,5uGj1TBCkc7FV4ffdBJg31yLcCxkQLxRExjcinnJUow9,True,35788946,3372737,10200,5100,5100,2a35JJeTUW1pm6M3e8DHCjp8qr4vbc2cRPhuzZWyFzYd,1082386,35879272,-34796886,302
2022-05-09 06:28:22-04:00,19673,3Xbsek5MsEGoWr3G9yhuohREr26B2vSQcjqXdspTFHta,2rPxkUiMo9wGDq8EvAiwY3ngRpKmL223cBWWNTYoBmFp,True,846855455,211713863,639833,319916,319917,DQCvC9mR68hJ3tJsUiddh6JwcBJAmntqGJR2nUsEq7yj,25593342,73074418,-47481076,302
2022-05-09 06:28:22-04:00,19674,AvvZT6q65qCaCdETtpR9XbCvY4Rv9RdpvbGuh6umEA9X,8dP2GJEjKTk9x7focRgCAYJauaGXENyxMU3EtgPA4gas,True,30142734,1491493,6149,3074,3075,68sueyVfmy5ToEGtLFGDkwebX47xAmzyXE29z8JrmcWv,1242770,9912598,-8669828,412
2022-05-09 06:28:22-04:00,19675,CuFhLMgQ8ixnboam5iej9UdCCpf6D27oZRurcvbZHad7,GBaGVw5fbD2RCUYSK3FxvVHdtqaevRuQMe1p4KZUsfaF,False,29490359,29490359,888265,44413,843852,8sEswn3kzEhnYjAZVvCQnHEUvYd7pFVvc2Xc2Kd1BpbC,888265,8175559,-7287294,301
2022-05-09 06:28:23-04:00,19676,6d6HN8LWikwW2HYdy3BABWuxKHt1sgv4DcneACR133sE,4eKvzmfFvX96XbujKBhUauAvWP4yQYwZH3pd7gXzbCvJ,True,67305006,16826251,50410,25205,25205,8sEswn3kzEhnYjAZVvCQnHEUvYd7pFVvc2Xc2Kd1BpbC,2016435,20133520,-18117085,299
2022-05-09 06:28:25-04:00,19677,DvSVpLMQyz91ksMwhuwwFDiKMo53FC5FVG5XrQZYWurJ,5jL2cYHg1QQpWYRCF4f378jpeHnTfPMWXiiHuhLNbzq8,True,48950477,2076841,8507,4253,4254,8sEswn3kzEhnYjAZVvCQnHEUvYd7pFVvc2Xc2Kd1BpbC,2005149,16112941,-14107792,409
2022-05-09 06:28:27-04:00,19678,H8P77smmiLj1vtt7hoSjf2vmcnBdW4rsgCtagtXZg6yy,3FxygrzNpSWivjLU3CumYif6rXhSzyjLqdKiyvphDnnc,True,66133564,4122247,18527,9263,9264,68sueyVfmy5ToEGtLFGDkwebX47xAmzyXE29z8JrmcWv,2972339,20850231,-17877892,449
2022-05-09 06:28:28-04:00,19679,A6wyZoJuJa5iqpXwYHfTiRs1G3MMaXVroDxdED89EyJp,HBYgKE6Lt2zXyobSHEbUdNCWPoxkikEEJHae15C1xptu,True,25933148,2316166,9171,4585,4586,8sEswn3kzEhnYjAZVvCQnHEUvYd7pFVvc2Xc2Kd1BpbC,1026954,8668119,-7641165,396
2022-05-09 06:28:31-04:00,19680,6fqbSyhh3PPdgRcLraHb7Jahj9s1oHHeX3SsjNSsGa6t,GpRUow48TYgttdYfsygbgjYQcmHyYjWETUDjDVphEgwq,True,47093529,6022694,17770,8885,8885,C4UnXuShCvjSMgBAgVNMy1oakxCNk1et27A82fywU112,1389546,33330449,-31940903,295
2022-05-09 06:28:31-04:00,19681,9rARQ4jwDGA6eEP2yjRNEjVptZbyTd5KC4p1Arvsv1fa,2q7pYrfmM2fmZjFYDNTK1ik27iFTjbzKzPvigxhzAqMc,False,11513459,11513459,345269,17263,328006,C4UnXuShCvjSMgBAgVNMy1oakxCNk1et27A82fywU112,345269,5630113,-5284844,299
2022-05-09 06:28:31-04:00,19682,9NhqXUfbpn5skKsZzCpnyD5wPTeLgDeKCxYQHR9TY9ej,8H1trMp7ATvrK1fzENWLg3xdDF6a4LJnNSc2APyQLi24,True,25921674,2316337,9180,4590,4590,C4UnXuShCvjSMgBAgVNMy1oakxCNk1et27A82fywU112,1027383,8679346,-7651963,396
2022-05-09 06:28:35-04:00,19683,5xkW7wHTcF5WadNtBBqKPKctVwyQtTqqscivAmxzseCk,7m31ZMZdCn5Gz2q5sETWA7uKA5LsKD7pJHBBqU3g7tCn,True,1227422044,306855511,920533,460266,460267,AmTrMPzuTp2BjnjqGNKqz9FTTCdpoKcPAJLwFc8ozcbh,36821340,164689673,-127868333,299
2022-05-09 06:28:36-04:00,19684,EodTi1tG2TSFyYPtDVKAxc6cuufzeEB6hg66HiZ36FFQ,8x8z784KpUypCtdBnGbs7jmUAiH83yXnG3QwXAWo4AZX,True,25922626,2316146,9204,4602,4602,C4UnXuShCvjSMgBAgVNMy1oakxCNk1et27A82fywU112,1030165,8681901,-7651736,397
2022-05-09 06:28:36-04:00,19685,7w76zJFb9nTPDbfC4DCscQ2F5vimT8hiivT8WkuwWYWX,5X5XNdoFZv15bmbv97VRxHgTZzKyiFZpoz7MRNkPZS6f,True,47738563,2061211,8000,4000,4000,72FwbpFGoLEazJEdpqNtPNefsadUrimUqma9wSoy4qiS,1852897,15364499,-13511602,388
2022-05-09 06:28:37-04:00,19686,GtDk7DkAB2jvQynR57z8mjg6UoaTqYDr8Z4wsFX6KGSr,tAPvp4fscJZySZUVG2GZWZwSRVhfnNvkjCC6ZvmxqDQ,True,211777372,52944343,159412,79706,79706,C4UnXuShCvjSMgBAgVNMy1oakxCNk1et27A82fywU112,6376510,32864992,-26488482,301
2022-05-09 06:28:37-04:00,19687,5g5EaEMiM2WQcfDpL3R3caYziX9xvGCFs9eVmmQdcgzS,J71CftCqiK1873fkVx9NGc7v7nvRZMYVBkGN3GhSPyeX,True,19299494,4824873,31895,15947,15948,C4UnXuShCvjSMgBAgVNMy1oakxCNk1et27A82fywU112,1275815,7987436,-6711621,661
2022-05-09 06:28:40-04:00,19688,7YCSi1xGHn5j65W5cZPkQ9RQzvpNgCGdrafAGGTLYkjE,BdVVPyQgd93sMf1SDCFFMvyugNsbdkrVNgaQCJEGjTLC,True,31259516,2928229,11775,5887,5888,2a35JJeTUW1pm6M3e8DHCjp8qr4vbc2cRPhuzZWyFzYd,1257116,11575824,-10318708,402
2022-05-09 06:28:42-04:00,19689,6pUtYz474QrpATEZnfb3iFbTKYA65pNyKAo4TQZAjtqe,8dipRUXvxJiDLdHEtCPkso4vErbVwshHQiRfvSngBS9J,True,465775342,22568800,81172,40586,40586,47z82br5WdW2DZajdnPDPSSRRKsyAggqXqK6oPUwTaLf,16752476,271696914,-254944438,359
2022-05-09 06:28:42-04:00,19690,BNEFSL7Mwtyq4ZbWaQB1UibDumKrqSbqkNVEYCJsMioH,GecT9hsySEeo6hHWed9UUkae2SYBjDCNGeC6R7UVK5Ds,True,25926678,2315538,9220,4610,4610,2a35JJeTUW1pm6M3e8DHCjp8qr4vbc2cRPhuzZWyFzYd,1032387,8680041,-7647654,398
2022-05-09 06:28:42-04:00,19691,CpeJ8BVz8Nd6SqnM3DYejnvAYnovDwu1taCqMEBD4RRi,GMmBgzDTtes62wJTENptaWPxNY2srWCrAdWErkj22Hzj,True,42796961,4070746,16588,8294,8294,C5o4TfkUfECutAWsDELjhsZX6PYyYgK3XeKvx6p4FphM,1743970,13634562,-11890592,407
2022-05-09 06:28:42-04:00,19692,2pMGfXreJV4ZGoQtRyvhdE8TFccLhkguLb7JsjGnyr7p,7FVhyNsmwmSKF8H73YfLmx6ASLw9G13r3LXDnRqKjWKL,False,1124176,1124176,33311,1665,31646,2a35JJeTUW1pm6M3e8DHCjp8qr4vbc2cRPhuzZWyFzYd,33312,1411818,-1378506,296
2022-05-09 06:28:42-04:00,19693,42h4NteqFpLjgjMS4gTTFoLvrEMpEP4sbGRd7SM5YCZR,AasJCLP5qsGzxkQs5jWysSarwoJTuZ6ZDeabNJNimWAX,True,3316357500,829089375,2510166,1255083,1255083,C4UnXuShCvjSMgBAgVNMy1oakxCNk1et27A82fywU112,100406665,295408138,-195001473,302
2022-05-09 06:28:43-04:00,19694,E4VzeJLsf5Y6t3yNi8VpS8QxhJbJGPhnkNBmU2XoCBs9,63CXyYfevXtrL1QcfQtAhz29xeea5BwWcj6d6BWb4qiB,True,1804655164,451163791,1355851,677925,677926,DA18qE9qesbBqpwNv1M4befYcNQkbSBSeLPTmQzrmbJw,54234045,802854313,-748620268,300
2022-05-09 06:28:43-04:00,19695,E6nDc3W2iqNJJASjkU8dj2JViZ5iDys3Qf6nGh4gjA9a,8YnGmR4CECAkHN7QRvxh2KKbrdCcq5gtsFV1rDyzvWG5,True,25908467,2313626,9072,4536,4536,C4UnXuShCvjSMgBAgVNMy1oakxCNk1et27A82fywU112,1016035,8681887,-7665852,392
2022-05-09 06:28:43-04:00,19696,3CTLVMSTYE6azjXhZyhPD5XiUe23aJ4pb456SQnUiohH,13q8wAZ1zte3bd3LdeKLEUY7ubu2suCNRZVrgMScpV3C,True,42819833,4071488,16591,8295,8296,2a35JJeTUW1pm6M3e8DHCjp8qr4vbc2cRPhuzZWyFzYd,1744996,13613839,-11868843,407
2022-05-09 06:28:43-04:00,19697,C8EuUJigyRy2ojSuZtDSnc4JxmVqoe5XTr4xaPPmKsyV,6PrUiT94hGcBm2AvkmkrnRnjXkR8WxmtJcvSapde3J1P,True,75480054,18870013,56967,28483,28484,C4UnXuShCvjSMgBAgVNMy1oakxCNk1et27A82fywU112,2278686,166629554,-164350868,301
2022-05-09 06:28:49-04:00,19698,7A1A93jqxV65F7XwvBarhgfTm3iFh3s75jFNzVCtFnez,8Z6QWdy4zGUzuMdKhkdxzq7RaLHhJmrpYEKeqsw8bopx,True,54649953,13662488,40778,20389,20389,C4UnXuShCvjSMgBAgVNMy1oakxCNk1et27A82fywU112,1631126,12841268,-11210142,298
2022-05-09 06:28:57-04:00,19699,5FewDaMC9U7n5EHcto98GaAmDVxDh5SYimuTP6AtfakM,7DAULUoqV7f9hsBzKEhjQPnWaHSqiMWcBqWcdcadaQv4,True,273610908,68402727,426420,213210,213210,C4UnXuShCvjSMgBAgVNMy1oakxCNk1et27A82fywU112,17056803,51305652,-34248849,623
2022-05-09 06:28:59-04:00,19700,5NVJU6YoZuuEjGNUUUJcGwS2Qd8b8CH7QSgMV7UWL5E7,8ZUq3o1nSkEvSfmiTz4anUpSMECCnX38MRwV7E5AGYSt,True,56471605,14117901,42305,21152,21153,47z82br5WdW2DZajdnPDPSSRRKsyAggqXqK6oPUwTaLf,1692225,13239505,-11547280,299
2022-05-09 06:29:19-04:00,19701,Apqv5iu4bJ6pVg2NxjfwuvnfxDK6navHhhU1CVJEHeMa,7pDPJrxndRsLq983bEwvd3MKYnnqyQzQNMhEaC5NZYN1,True,54638067,13659516,40247,20123,20124,6L1WYrPiCMyi7XemPww4B4hvpKD1LQKD4RpiSKmrmgSC,1609904,12840505,-11230601,294
2022-05-09 06:31:22-04:00,19702,3RpbaFEL5ZYrQBPpaAeCUXs43Ssdr5Tm4ScMGtp6XbYF,CpKGwcVZrd3vKTNhdF8xNsd77FT3QxQWb7xFQxiyPB5p,True,1222591994,305647998,1906694,953347,953347,DA18qE9qesbBqpwNv1M4befYcNQkbSBSeLPTmQzrmbJw,76267775,574769828,-498502053,623
2022-05-09 06:31:27-04:00,19703,8J4BZXZzkK4SmWxc2YoaJRg9ivuuXbdVe5XpEhVds1ZM,3pirVwiye9NftvMpX5F7WpfcGZy5uV3c11xCdkkZbL9D,True,636265487,159066371,476319,238159,238160,Hu94aiQWvce6THeGyCFqGRPM1pQrK3ihzkcXo1EpJcJL,19052790,105944277,-86891487,299
2022-05-09 06:31:48-04:00,19704,8uoS53t92hUWWx6mZHGhpKs3dkYJYyiRufnp4H1anBJH,E1Nc6fTaZ7EFFJqVDnEfV3odtasBRhEzbtg4JDFDzJ3k,True,126661423,31665355,197739,98869,98870,Hu94aiQWvce6THeGyCFqGRPM1pQrK3ihzkcXo1EpJcJL,7909579,101225936,-93316357,624
2022-05-09 06:32:05-04:00,19705,Ai6G7vosJfmkRqtDAkqxRtbzELp6P5xe9r2RH3LYcLZt,8SUpKXakmhi4rYiFKnHYpgaAopomfDqEX6Efew9iM6nk,True,28618759,5026014,19998,9999,9999,68sueyVfmy5ToEGtLFGDkwebX47xAmzyXE29z8JrmcWv,1138746,16806017,-15667271,397
2022-05-09 06:33:39-04:00,19706,5tW54mXQxtM7vGc91HrDeDtWkxJeH2uM4yAviqZnMZCN,7Kg5Zwx5afFdLbTifeyKJLSNVj2p9Xf5anbbqQozNzmY,True,1633800151,158703504,1009984,504992,504992,68sueyVfmy5ToEGtLFGDkwebX47xAmzyXE29z8JrmcWv,103974575,359973738,-255999163,636
2022-05-09 06:34:01-04:00,19707,GdUWbwTgHF1RRbpVXCahz36G7MqYrM6QaBgnjL2eLKxk,JDYxQpYMt38mmjzLrVjgi3ezpc3DQ8YJEtJTZbG6fCCq,True,48988503,2082840,8571,4285,4286,2a35JJeTUW1pm6M3e8DHCjp8qr4vbc2cRPhuzZWyFzYd,2016107,16090214,-14074107,411
2022-05-09 06:34:03-04:00,19708,9gY3X17t7jarkWhnSEHPR51U9nVv8Dv99NqpCi3ewuPf,4Z6TdTW1d4JFRZqZyWA9X7upKhJwVPSfTQjFp14M59uv,False,8423038,8423038,252043,12602,239441,68sueyVfmy5ToEGtLFGDkwebX47xAmzyXE29z8JrmcWv,252044,9849424,-9597380,299
2022-05-09 06:34:03-04:00,19709,6pUtYz474QrpATEZnfb3iFbTKYA65pNyKAo4TQZAjtqe,8dipRUXvxJiDLdHEtCPkso4vErbVwshHQiRfvSngBS9J,True,442071754,38181379,134187,67093,67094,2a35JJeTUW1pm6M3e8DHCjp8qr4vbc2cRPhuzZWyFzYd,15536516,252417571,-236881055,351
2022-05-09 06:34:03-04:00,19710,AtaNpuHGEDd7kfakJbTbpphMdQk7ZWk9iB585TtNATKx,72egdmxZyhyYsM93hTMuoDd6NeYVB7gpiJG4PWj4Qi8f,True,42550064,4194331,16766,8383,8383,8sEswn3kzEhnYjAZVvCQnHEUvYd7pFVvc2Xc2Kd1BpbC,1700889,13620194,-11919305,399
2022-05-09 06:34:03-04:00,19711,EVMrznfJS54BZiywDD2WhUtxzicDtbEpm2a5yLrtCgRF,CpzsMYVYvKg8ihrX1cKRw7TDEYwD3kAyiX92hsf2KiTz,True,498209193,33139107,150074,75037,75037,2a35JJeTUW1pm6M3e8DHCjp8qr4vbc2cRPhuzZWyFzYd,22561998,330274917,-307712919,452
2022-05-09 06:34:19-04:00,19712,D7dQmfuiK31BHRG4Y9wpkRu7sChiZhTYes47YPNGvnpF,AN5jjtJp7d9DG3xJo3DnDRmGmzj5pKKy1owwVuREpReQ,True,337612502,84403125,527419,263709,263710,A9TwRM1BMxqb8DCC7YNAMV6zPenEJm3HTZBy7wJKK58U,21096794,34671258,-13574464,624
2022-05-09 06:34:24-04:00,19713,EHi1UBG8wMUFZECktsFUZkGjJPaBNEedswS62hyYn6jC,Drx9ErQhAjnPuJ83LPYFnY5ZV5XDzGuXDuSf16VqWayp,True,692202654,73877941,264094,132047,132047,Hu94aiQWvce6THeGyCFqGRPM1pQrK3ihzkcXo1EpJcJL,24744445,440194394,-415449949,357
2022-05-09 06:34:24-04:00,19714,JCagxpXPs6wVRUWbNBPCZ4uLCkZsachnofN7SZEEwGwB,5uGj1TBCkc7FV4ffdBJg31yLcCxkQLxRExjcinnJUow9,False,32322302,32322302,978278,48913,929365,Hu94aiQWvce6THeGyCFqGRPM1pQrK3ihzkcXo1EpJcJL,978279,33466985,-32488706,302
2022-05-09 06:34:26-04:00,19715,7tFD53kPTqrzjCu1Wji78gUqhoRtCUhsP1pM3DQKT7uG,BJvgPLYBDJrQJdQVowrsMwUGMurq4zTihoFwWoEokfu3,True,187375281,26350985,79200,39600,39600,Hu94aiQWvce6THeGyCFqGRPM1pQrK3ihzkcXo1EpJcJL,5631777,48690283,-43058506,300
2022-05-09 06:34:27-04:00,19716,BEuVsj9KuYBTaxrLpKwrQtHxmhRtB16siNfPXsAvf6rz,BTjWitiLbteuKMzaFj1daYyM2v9rZygESDktu8cuzC8g,True,50904874,12726218,38334,19167,19167,Hu94aiQWvce6THeGyCFqGRPM1pQrK3ihzkcXo1EpJcJL,1533375,6747455,-5214080,301
2022-05-09 06:34:29-04:00,19717,3zVmiyif8VbqUW7dAeEMYJYrg8r5pCeBfALsdgu6kgFJ,FwzrxNbJsiCQwqayaDhwkbm9TRG11bK6fWs5Dn75da9a,True,72197112,18049278,53999,26999,27000,2a35JJeTUW1pm6M3e8DHCjp8qr4vbc2cRPhuzZWyFzYd,2159965,31508169,-29348204,299
2022-05-09 06:34:39-04:00,19718,5jAGYgNPbxE171j6GLMhf2WjbGzm7vKMifg5tAPcUPc1,EWoKgDPerFZ2ExRi6wWK9xBSyT2xQptp46Rdh39jF7Kt,True,28537737,2501614,10135,5067,5068,8sEswn3kzEhnYjAZVvCQnHEUvYd7pFVvc2Xc2Kd1BpbC,1156292,9227544,-8071252,405
2022-05-09 06:34:39-04:00,19719,7w76zJFb9nTPDbfC4DCscQ2F5vimT8hiivT8WkuwWYWX,5X5XNdoFZv15bmbv97VRxHgTZzKyiFZpoz7MRNkPZS6f,True,45607418,4176694,16254,8127,8127,68sueyVfmy5ToEGtLFGDkwebX47xAmzyXE29z8JrmcWv,1774963,14464584,-12689621,389
2022-05-09 06:34:39-04:00,19720,26pvf6YygxQ8CdL4h4PcMuYNQtFbUVisTsYaFB3EZXvd,9tVSyevo14cUe2NMoBteqgV7vw44m6ooz2rD9ricKh55,True,122458215,30614553,86344,43172,43172,72FwbpFGoLEazJEdpqNtPNefsadUrimUqma9wSoy4qiS,3453796,54045136,-50591340,282
2022-05-09 06:34:39-04:00,19721,H7rsFRRhZPe2jLex2NkbYYzVtLobvFiqnCd4BUyJVPBB,8bedwDRfSKLP9vUxoXcpHNJzWQemMaf4QGT2mtHFVJFb,True,88009482,22002370,64376,32188,32188,C4UnXuShCvjSMgBAgVNMy1oakxCNk1et27A82fywU112,2575069,7640080,-5065011,292
2022-05-09 06:34:40-04:00,19722,FuhTkUxSaJ7kvuu9LHZaPVfdbKAQSh9W8Zzso1XPKGZp,FLoqPzREreKfRCwqtXs3CJwpTSudmXrVYCRZadWvob7j,True,75885927,18971481,52706,26353,26353,3zqXX6kzhkbW3d4TwD2CNjMRwxTbREXySekvq37kfCNk,2108248,34501071,-32392823,277
2022-05-09 06:34:40-04:00,19723,A5NXadGWnFZRoHEn1dKTRjcXgWmfMLMyJdpF4rQPZyRR,ALs3Zfotc4c4A6TFDMbd5GM5whK1dTYSnGrHiMBWmApH,True,1016266991,254066747,760073,380036,380037,2a35JJeTUW1pm6M3e8DHCjp8qr4vbc2cRPhuzZWyFzYd,30402954,139125591,-108722637,299
2022-05-09 06:34:40-04:00,19724,3pRKRd4i6jepz5HPbSsSFj2YKwYBjgVAk2v7ZMBYZVNR,Fzf7Gx6KJam5A1eny5G49cRS2zZHFt7XMxCx8N1Ej2Jd,True,44190681,11047670,31213,15606,15607,C4UnXuShCvjSMgBAgVNMy1oakxCNk1et27A82fywU112,1248542,19344542,-18096000,282
2022-05-09 06:34:40-04:00,19725,BAkPsWHtpVcEGqUgKTKjwZ6d5aaUcaUhdgYxBnpSTDW2,BDwDmVaZnXh22sf8nsDtjVfgxMAswbM3PW3si3k4nbRK,True,183194055,45798513,135353,67676,67677,C4UnXuShCvjSMgBAgVNMy1oakxCNk1et27A82fywU112,5414145,76568404,-71154259,295
2022-05-09 06:34:41-04:00,19726,5zqXqEjg95BnghcVbHRhYkSTYnzZjUBichgccv1BpS3d,9SuqSxrKpHh9NcNePe4Q3jXvpCmhNnoQv8YAFih3CqMX,False,29062162,29062162,873049,43652,829397,C4UnXuShCvjSMgBAgVNMy1oakxCNk1et27A82fywU112,873049,12788828,-11915779,300
2022-05-09 06:34:43-04:00,19727,2tPYXtNrw134ACVhkYdnG9FGT4iHm61PuX8L7AfG9aAT,EyyPLVdjgewzVDKePQUj85BBttWy4MixVr9CSD8JVbrP,True,641024538,160256134,484971,242485,242486,DA18qE9qesbBqpwNv1M4befYcNQkbSBSeLPTmQzrmbJw,19398879,278278241,-258879362,302
2022-05-09 06:34:47-04:00,19728,HT2SuCbePhjNZaar24uVwihYowCNvSjdvhJ8BRSVw9nX,98Ts4LCnapHVoCJ5PW3Armvh4jvDtpfs3SYRLRxiAgzZ,True,37587524,2249240,10468,5234,5234,68sueyVfmy5ToEGtLFGDkwebX47xAmzyXE29z8JrmcWv,1749480,20093439,-18343959,465
2022-05-09 06:34:47-04:00,19729,BJaaH1SK1pF2kZQzmYpLFfDtm52CR9a5rd39RAPtLe8q,HUsT5FVxaisdnCvG1BQxX6zffjfL2Rwx5mMo5y8SDV7e,False,34474,34474,1691,84,1607,Hu94aiQWvce6THeGyCFqGRPM1pQrK3ihzkcXo1EpJcJL,1692,29543,-27851,490
2022-05-09 06:34:48-04:00,19730,HXQXfEQe7aCpr6WKh37XaDZsjZcuQPk5t8tWNFgEoK6U,5ufXkCEDwgiXwtyPye4wYVVA3oLW54JVzz4tnXFofto4,True,825700321,206425080,530900,265450,265450,C4UnXuShCvjSMgBAgVNMy1oakxCNk1et27A82fywU112,21236016,366006895,-344770879,257
2022-05-09 06:34:48-04:00,19731,Fczxdc24Eav8xcaKRDwWMEwPEzkGyEJ7qGcXYyGZFKVz,8GqweYpec4cnpaJvueF3FGWoaz72BAzpLYXBX7tuuqEt,True,65141314,16285328,43335,21667,21668,C4UnXuShCvjSMgBAgVNMy1oakxCNk1et27A82fywU112,1733436,47373778,-45640342,266
2022-05-09 06:34:48-04:00,19732,5jAGYgNPbxE171j6GLMhf2WjbGzm7vKMifg5tAPcUPc1,EWoKgDPerFZ2ExRi6wWK9xBSyT2xQptp46Rdh39jF7Kt,True,25972095,1207860,5032,2516,2516,Hu94aiQWvce6THeGyCFqGRPM1pQrK3ihzkcXo1EpJcJL,1082129,8625269,-7543140,416
2022-05-09 06:34:52-04:00,19733,Ejg8vXVsro4jB2fpdUUXCRfKTiE5TUwfRXhHeR8qtrEi,GnF7xwsjzso48ZEAdYYuxNkJso7ug3s46uogi4XDbs1,True,620997093,155249273,422661,211330,211331,DA18qE9qesbBqpwNv1M4befYcNQkbSBSeLPTmQzrmbJw,16906445,147241416,-130334971,272
2022-05-09 06:34:52-04:00,19734,CnNbPk9YL7y2PiqMfVvS1789stfDA7ZDk3sArJSw6FwP,9oamN33gGnx3tU9Mnn53yhi6F2Du5AAaSV6uAi69rbib,True,46449897,11612474,34222,17111,17111,C4UnXuShCvjSMgBAgVNMy1oakxCNk1et27A82fywU112,1368903,20484562,-19115659,294
2022-05-09 06:34:52-04:00,19735,EVMrznfJS54BZiywDD2WhUtxzicDtbEpm2a5yLrtCgRF,CpzsMYVYvKg8ihrX1cKRw7TDEYwD3kAyiX92hsf2KiTz,True,462993590,64742870,284360,142180,142180,C4UnXuShCvjSMgBAgVNMy1oakxCNk1et27A82fywU112,20335428,303066607,-282731179,439
2022-05-09 06:34:52-04:00,19736,DHfy6B2AYsqMCxPLBCXMDfQn3Gr2VwJaLFHUZKqpCjsb,EPZpYaY1gCAb8pMtri5veRowBmCrCpTHBMa3Rmgt6S29,True,46778941,11694735,35269,17634,17635,C4UnXuShCvjSMgBAgVNMy1oakxCNk1et27A82fywU112,1410772,7544605,-6133833,301
2022-05-09 06:34:54-04:00,19737,3u8kTzHN7uChpqJpH4WkMvBGxz7Rsg93EvB3k7dPf7G1,GWdMVk7p7EE1fPqfcyrVhcTsYXV6MoyV9bLdMYW45YQv,True,38821554,9705388,28241,14120,14121,C4UnXuShCvjSMgBAgVNMy1oakxCNk1et27A82fywU112,1129645,13798073,-12668428,290
2022-05-09 06:34:54-04:00,19738,DRVtEzZs9u9ysrcANZLEjrvbuuGqYn77v2h4cDFKuNUx,Fv9qiMZhuSBL2cs9AWUYbDLQjB46W2ZwrhxaNXtPLDpC,True,15357490198,3839372549,11118569,5559284,5559285,A9TwRM1BMxqb8DCC7YNAMV6zPenEJm3HTZBy7wJKK58U,444742780,1076550958,-631808178,289
2022-05-09 06:34:55-04:00,19739,7cvbksBKz3SyD4Waqpa3qaBAj7ZVZcxL5M1mJrHemDoK,5Pyxm6RqTPwQp2ji2mkbqC56Bg2Ps9ed9YGXz5HXezRr,True,37121798,9280449,27262,13631,13631,C4UnXuShCvjSMgBAgVNMy1oakxCNk1et27A82fywU112,1090490,8993245,-7902755,293
2022-05-09 06:34:55-04:00,19740,62q4KpVd3UXPomDaqpTF7recRAEh2ZKgWRgT92ztmda4,8xRdV8nWLb3CiCcHt2ZXEJv3NSfaa178zarhUkKv2rP9,True,57992855,3074488,13093,6546,6547,3zqXX6kzhkbW3d4TwD2CNjMRwxTbREXySekvq37kfCNk,2469789,17977070,-15507281,425
2022-05-09 06:34:55-04:00,19741,AvvZT6q65qCaCdETtpR9XbCvY4Rv9RdpvbGuh6umEA9X,8dP2GJEjKTk9x7focRgCAYJauaGXENyxMU3EtgPA4gas,True,28549737,2508163,9971,4985,4986,C4UnXuShCvjSMgBAgVNMy1oakxCNk1et27A82fywU112,1135117,9183097,-8047980,397
2022-05-09 06:34:55-04:00,19742,A7j77tzgnQVGtHTa65VtVZqJRYeJvQk7am8NW6e66379,4vJGwEvXU2tGWoWWGwbsYcfKQAMCHbrBMRk4ZVFzneLs,True,663243462,165810865,448092,224046,224046,C4UnXuShCvjSMgBAgVNMy1oakxCNk1et27A82fywU112,17923682,199577099,-181653417,270
2022-05-09 06:34:55-04:00,19743,E17GuUpNNTyonDV7dtuit35hwQXtZ8fowHpHFHWSiiG3,GZ5DboskwBDP5fgYvp6djKFVFCo3MJkurtCY6cA8XVHr,True,29197089,7299272,45203,22601,22602,2a35JJeTUW1pm6M3e8DHCjp8qr4vbc2cRPhuzZWyFzYd,1808145,28861357,-27053212,619
2022-05-09 06:34:56-04:00,19744,5Y7MpvBDW2jVq5SwkJQrVjqMSBEfwvB7dF9N1dD6s9bk,5KvuS6ew8J4KCeX46ZZmvpuSBzK2DatDJmpm7cMwMKnp,False,25218382,25218382,752263,37613,714650,C4UnXuShCvjSMgBAgVNMy1oakxCNk1et27A82fywU112,752263,11147000,-10394737,298
2022-05-09 06:34:56-04:00,19745,GpDhvRRae2uiRZ6MnJYnVR2hANNLGFGUDnsQmGjfK8AP,B2pgJ4gPdgzvx2HMJ1wagtthpZebtBk7RD3cF1zqSyT8,False,31360179,31360179,894354,44717,849637,C4UnXuShCvjSMgBAgVNMy1oakxCNk1et27A82fywU112,894354,14437751,-13543397,285
2022-05-09 06:35:00-04:00,19746,EEQmHFk3WFNmPfe7ujtP1PK6P5yqV5mmWumNSoTu45P8,FG9DScQDQPrgcmBbRugZ5NfhSTRMnKSWLxcUeTF9MgJZ,True,375970789,93992697,282062,141031,141031,2a35JJeTUW1pm6M3e8DHCjp8qr4vbc2cRPhuzZWyFzYd,11282493,58644661,-47362168,300
2022-05-09 06:35:02-04:00,19747,CpeJ8BVz8Nd6SqnM3DYejnvAYnovDwu1taCqMEBD4RRi,GMmBgzDTtes62wJTENptaWPxNY2srWCrAdWErkj22Hzj,True,38616615,1908186,7993,3996,3997,C4UnXuShCvjSMgBAgVNMy1oakxCNk1et27A82fywU112,1617782,12688726,-11070944,418
2022-05-09 06:35:02-04:00,19748,EHi1UBG8wMUFZECktsFUZkGjJPaBNEedswS62hyYn6jC,Drx9ErQhAjnPuJ83LPYFnY5ZV5XDzGuXDuSf16VqWayp,True,616025970,69156555,249015,124507,124508,3zqXX6kzhkbW3d4TwD2CNjMRwxTbREXySekvq37kfCNk,22181608,411326511,-389144903,360
2022-05-09 06:35:02-04:00,19749,FRbeFwhUYCiHW5oP26mad8KND7CCYDbfnoNxX7GuXVp8,GrzXKxPX2WDka8i2D8sunMUsrsThKasQi8NYLwuCGygV,True,187593695,32281557,127062,63531,63531,Hu94aiQWvce6THeGyCFqGRPM1pQrK3ihzkcXo1EpJcJL,7383826,85465437,-78081611,393
2022-05-09 06:35:03-04:00,19750,4oMasDRj8HWfknmdwt6Mkz3eonr8J2byoiSTRo4sCnFQ,3emcATkEFvDVETiK97eVET2Z2jzkgiiSxX3gu5wsUKPe,True,800353861,99136245,651477,325738,325739,AmTrMPzuTp2BjnjqGNKqz9FTTCdpoKcPAJLwFc8ozcbh,52595543,428804311,-376208768,657
2022-05-09 06:35:03-04:00,19751,2AAWghW6BUAFBtF3R6hB9uoqMc5oUDkU8FTd2JrXKema,798cfEUZ2YhXwNTNjXMS4Z2J8gAHaK4zZwpMkq2HzWWM,False,30613439,30613439,771083,38554,732529,8sEswn3kzEhnYjAZVvCQnHEUvYd7pFVvc2Xc2Kd1BpbC,771083,33108035,-32336952,251
2022-05-09 06:35:03-04:00,19752,5euvq1j9LCJWT1K7xKAE2TjwzbrWA5t6j2SxtnWsEPeU,GKDnouGNzg5JkjWG7Qs4nmka6qUMdYrk1fKwrmj8TvdH,True,61730422,3536806,15497,7748,7749,3zqXX6kzhkbW3d4TwD2CNjMRwxTbREXySekvq37kfCNk,2704900,19724567,-17019667,438
2022-05-09 06:35:05-04:00,19753,EFzTG8kgbs1kExcFxcQrLSteeKD7jVqgQ2x3onCnhNuP,9wLCaZ7eVfs3u7Gp6HypL1Nz7hWgAcLcjbLtdyxf9gFU,True,535057535,44430472,208157,104078,104079,8sEswn3kzEhnYjAZVvCQnHEUvYd7pFVvc2Xc2Kd1BpbC,25067492,58587076,-33519584,468
2022-05-09 06:35:05-04:00,19754,EVoc9HuMgnTyrYjC1ySj3sYVzXccSPjupjgj69gMkuNQ,2ahbZJgSLSyppym6N7iyby3SvQcCzYrjdioGLAmhf7Y8,True,44614263,11153565,31659,15829,15830,3zqXX6kzhkbW3d4TwD2CNjMRwxTbREXySekvq37kfCNk,1266365,14209590,-12943225,283
2022-05-09 06:35:07-04:00,19755,A6wyZoJuJa5iqpXwYHfTiRs1G3MMaXVroDxdED89EyJp,HBYgKE6Lt2zXyobSHEbUdNCWPoxkikEEJHae15C1xptu,False,23555812,23555812,956610,47830,908780,2a35JJeTUW1pm6M3e8DHCjp8qr4vbc2cRPhuzZWyFzYd,956613,8162606,-7205993,406
2022-05-09 06:35:07-04:00,19756,6fqbSyhh3PPdgRcLraHb7Jahj9s1oHHeX3SsjNSsGa6t,GpRUow48TYgttdYfsygbgjYQcmHyYjWETUDjDVphEgwq,True,40854013,5702716,16121,8060,8061,Hu94aiQWvce6THeGyCFqGRPM1pQrK3ihzkcXo1EpJcJL,1154954,31410423,-30255469,282
2022-05-09 06:35:07-04:00,19757,FU3fRyQxk6rwtD9Db1nTvTAjSwgSW9vi1q7SjZ92ijyM,7c3maBK3hpb1exxqcvnwiUfhhUBgLgCs5exANSZ7m494,True,256742532,64185633,170902,85451,85451,8sEswn3kzEhnYjAZVvCQnHEUvYd7pFVvc2Xc2Kd1BpbC,6836093,31216484,-24380391,266
2022-05-09 06:35:08-04:00,19758,CMVVfXQYALSc58NLD67L8YrJAbDHZ9rFZvYQC7r8Png4,44pytMX14zaEQv6aRQ223CxYB2uTP7VUTQfUY58EkaNB,True,199045873,49761468,132649,66324,66325,8sEswn3kzEhnYjAZVvCQnHEUvYd7pFVvc2Xc2Kd1BpbC,5305993,87924322,-82618329,266
2022-05-09 06:35:11-04:00,19759,7YCSi1xGHn5j65W5cZPkQ9RQzvpNgCGdrafAGGTLYkjE,BdVVPyQgd93sMf1SDCFFMvyugNsbdkrVNgaQCJEGjTLC,True,28261483,1366534,5684,2842,2842,2a35JJeTUW1pm6M3e8DHCjp8qr4vbc2cRPhuzZWyFzYd,1175537,10742275,-9566738,415
2022-05-09 06:35:11-04:00,19760,3AaMzK9WAbD9m27szcJYnucnSPQ4W7tk8EztgWv4vqUo,8oUBQUKo9wHLu1tUEF1AeCUa7oRYyDSoFNRMqQAqKMbH,True,61788731,3540816,15554,7777,7777,3zqXX6kzhkbW3d4TwD2CNjMRwxTbREXySekvq37kfCNk,2714383,19682808,-16968425,439
2022-05-09 06:35:11-04:00,19761,EodTi1tG2TSFyYPtDVKAxc6cuufzeEB6hg66HiZ36FFQ,8x8z784KpUypCtdBnGbs7jmUAiH83yXnG3QwXAWo4AZX,False,23546101,23546101,960581,48029,912552,2a35JJeTUW1pm6M3e8DHCjp8qr4vbc2cRPhuzZWyFzYd,960582,8176335,-7215753,407
2022-05-09 06:35:12-04:00,19762,7qEVqFr1naSPCDV9q3xx6KMZn1yCHvkHZJkaA46NLmSE,8Mohcixq2L9PYrHpb95vuEsXqJ18JhEHi3RA83VM9cLv,True,165347429,41336857,115971,57985,57986,68sueyVfmy5ToEGtLFGDkwebX47xAmzyXE29z8JrmcWv,4638872,59170731,-54531859,280
2022-05-09 06:35:12-04:00,19763,5rnSL1jkLDsAvWsKNrbxtBJEcavHbc41kSTWywUEmSaX,87ZzyZEPJAXq6UiTqQVNuChRQVSb7QcUJgV41saA8CFC,True,44352893,2136627,8634,4317,4317,Hu94aiQWvce6THeGyCFqGRPM1pQrK3ihzkcXo1EpJcJL,1792335,14946092,-13153757,404
2022-05-09 06:35:13-04:00,19764,7sgoB9mHcUoNFFdQSsBvyC4tXYzYR86ct11WQsS1FvAp,5k2QtQPgMUvj88Tmizf1pABHtC3VHJDc6BYNkB9gp19M,False,12947926,12947926,799010,39950,759060,2a35JJeTUW1pm6M3e8DHCjp8qr4vbc2cRPhuzZWyFzYd,799010,6405708,-5606698,617
2022-05-09 06:35:13-04:00,19765,F47ihi3LtNYspD1tkQhind1ce8udZ628Ye1NuDBd3Me1,HqzXiTisYpcPHCAMvceUL8WSrzEX38TuGkzPaGJSdAHm,True,69417451,17354362,46286,23143,23143,8sEswn3kzEhnYjAZVvCQnHEUvYd7pFVvc2Xc2Kd1BpbC,1851446,16810892,-14959446,266
2022-05-09 06:35:15-04:00,19766,Eps7NSYQhiSzaTpTLzx5aoDykXSKtQ6w1JBFuucC8hQp,EeNkTwr26mYEBqYHqoHaBZfybPS2PwcbJsgmQGJY6g89,True,59268623,14817155,40130,20065,20065,8sEswn3kzEhnYjAZVvCQnHEUvYd7pFVvc2Xc2Kd1BpbC,1605201,26044309,-24439108,270
2022-05-09 06:35:15-04:00,19767,9NhqXUfbpn5skKsZzCpnyD5wPTeLgDeKCxYQHR9TY9ej,8H1trMp7ATvrK1fzENWLg3xdDF6a4LJnNSc2APyQLi24,False,23542697,23542697,955560,47778,907782,Hu94aiQWvce6THeGyCFqGRPM1pQrK3ihzkcXo1EpJcJL,955563,8173998,-7218435,405
2022-05-09 06:35:15-04:00,19768,E6nDc3W2iqNJJASjkU8dj2JViZ5iDys3Qf6nGh4gjA9a,8YnGmR4CECAkHN7QRvxh2KKbrdCcq5gtsFV1rDyzvWG5,False,23541684,23541684,953804,47690,906114,Hu94aiQWvce6THeGyCFqGRPM1pQrK3ihzkcXo1EpJcJL,953806,8173936,-7220130,405
2022-05-09 06:35:15-04:00,19769,DvSVpLMQyz91ksMwhuwwFDiKMo53FC5FVG5XrQZYWurJ,5jL2cYHg1QQpWYRCF4f378jpeHnTfPMWXiiHuhLNbzq8,True,46725868,2065627,8173,4086,4087,2a35JJeTUW1pm6M3e8DHCjp8qr4vbc2cRPhuzZWyFzYd,1848874,15367654,-13518780,395
2022-05-09 06:35:17-04:00,19770,3Xbsek5MsEGoWr3G9yhuohREr26B2vSQcjqXdspTFHta,2rPxkUiMo9wGDq8EvAiwY3ngRpKmL223cBWWNTYoBmFp,True,629233716,157308429,476140,238070,238070,AmTrMPzuTp2BjnjqGNKqz9FTTCdpoKcPAJLwFc8ozcbh,19045633,60571074,-41525441,302
2022-05-09 06:35:18-04:00,19771,3CTLVMSTYE6azjXhZyhPD5XiUe23aJ4pb456SQnUiohH,13q8wAZ1zte3bd3LdeKLEUY7ubu2suCNRZVrgMScpV3C,True,38618286,1908000,7896,3948,3948,8sEswn3kzEhnYjAZVvCQnHEUvYd7pFVvc2Xc2Kd1BpbC,1598346,12668731,-11070385,413
2022-05-09 06:35:19-04:00,19772,Bzp3ZUxzRWqW4QoLq9PtKN1HQeSaKXFQrX1G3a4ocrre,H12B3p4v1ZtZ9gaSgpxCJsKXmmEjiqaRZQzexjzAhevo,True,1218147247,80246777,378745,189372,189373,DA18qE9qesbBqpwNv1M4befYcNQkbSBSeLPTmQzrmbJw,57493657,684485551,-626991894,471
2022-05-09 06:35:20-04:00,19773,68gVM4kjmSYxT1uJW13rYSway8uVLUdcLa7sJuqHQaAf,DshroBQ3da7BcAiQpiFREsLKWbUDrBRmmZRw3Zu2Qfs9,True,124079991,31019997,90422,45211,45211,C4UnXuShCvjSMgBAgVNMy1oakxCNk1et27A82fywU112,3616913,33703096,-30086183,291
2022-05-09 06:35:22-04:00,19774,9eWpSyu71Z6dmx7yTh7WrbVScdrrZN14d5tfmqEGFgXt,2r89PFKSD9zmSp2Wyx4CQ75HAtmUgwhAS2oG5MuYuiV6,True,453171847,81285411,315620,157810,157810,C4UnXuShCvjSMgBAgVNMy1oakxCNk1et27A82fywU112,17596092,185421306,-167825214,388
2022-05-09 06:35:23-04:00,19775,7PzGZgzieFyyFs1dbajkNQgVxooFUNZrj1bUsQvrSwbp,A2gDREmSmJTBPPw3sbKVY3smC9wbHMDdv87gr4Tr2ES7,True,337534336,84383584,250813,125406,125407,2py1FiYeL2f7J3HU36qiJz6TD6HCmiTN36RyxYtapQCZ,10032530,44912057,-34879527,297
2022-05-09 06:35:24-04:00,19776,6d6HN8LWikwW2HYdy3BABWuxKHt1sgv4DcneACR133sE,4eKvzmfFvX96XbujKBhUauAvWP4yQYwZH3pd7gXzbCvJ,True,50026657,12506664,37848,18924,18924,72FwbpFGoLEazJEdpqNtPNefsadUrimUqma9wSoy4qiS,1513927,15553891,-14039964,302
2022-05-09 06:35:24-04:00,19777,dXBy1yuMFpCNtCLNfhPACRrcSJ9qZCwjgCjGWzHbNfX,3fh1g6fHkHeycwb9UAUCE8qXgiXdtjVp95GE9j39Kxsn,False,32834224,32834224,970934,48546,922388,72FwbpFGoLEazJEdpqNtPNefsadUrimUqma9wSoy4qiS,970934,20423465,-19452531,295
2022-05-09 06:35:26-04:00,19778,H8P77smmiLj1vtt7hoSjf2vmcnBdW4rsgCtagtXZg6yy,3FxygrzNpSWivjLU3CumYif6rXhSzyjLqdKiyvphDnnc,True,61775762,3542689,15588,7794,7794,3zqXX6kzhkbW3d4TwD2CNjMRwxTbREXySekvq37kfCNk,2718257,19703398,-16985141,440
2022-05-09 06:35:27-04:00,19779,6pUtYz474QrpATEZnfb3iFbTKYA65pNyKAo4TQZAjtqe,8dipRUXvxJiDLdHEtCPkso4vErbVwshHQiRfvSngBS9J,True,402329210,36126432,124284,62142,62142,8sEswn3kzEhnYjAZVvCQnHEUvYd7pFVvc2Xc2Kd1BpbC,13841164,241433227,-227592063,344
2022-05-09 06:35:32-04:00,19780,CvR57tmtnHbMmPivvJR6VenXivQaWue7z77N81WPpzfv,B4ASc8cUjrzuchv2SHwPrnjKvZgZpwvcLArsdYmMAqBQ,True,203547758,50886939,147352,73676,73676,72FwbpFGoLEazJEdpqNtPNefsadUrimUqma9wSoy4qiS,5894112,57594088,-51699976,289
2022-05-09 06:35:33-04:00,19781,7w76zJFb9nTPDbfC4DCscQ2F5vimT8hiivT8WkuwWYWX,5X5XNdoFZv15bmbv97VRxHgTZzKyiFZpoz7MRNkPZS6f,True,41310918,4101961,16273,8136,8137,C4UnXuShCvjSMgBAgVNMy1oakxCNk1et27A82fywU112,1638903,13375020,-11736117,396
2022-05-09 06:35:33-04:00,19782,D5VZNThkv6XD6bimPshD2J3PvbPXgCbivZuPfkVxgdjc,8C77LmMk4C3KvyEb1N3scdbAgwN7J45nAcv9tkL5namB,True,224702880,56175720,335032,167516,167516,C4UnXuShCvjSMgBAgVNMy1oakxCNk1et27A82fywU112,13401311,107251257,-93849946,596
2022-05-09 06:35:34-04:00,19783,7KfkiubVVGHekg5W5NW1QqxnbudXQroe8tCBsx4GgXAC,5j5yEzQKUmQi7dFM89QTYSRpBca2y5S5EvvLC8ZNuDgM,True,29138143,7284535,43719,21859,21860,8sEswn3kzEhnYjAZVvCQnHEUvYd7pFVvc2Xc2Kd1BpbC,1748787,28860955,-27112168,600
2022-05-09 06:35:36-04:00,19784,BNEFSL7Mwtyq4ZbWaQB1UibDumKrqSbqkNVEYCJsMioH,GecT9hsySEeo6hHWed9UUkae2SYBjDCNGeC6R7UVK5Ds,False,23528536,23528536,940561,47028,893533,Hu94aiQWvce6THeGyCFqGRPM1pQrK3ihzkcXo1EpJcJL,940563,8173850,-7233287,399
2022-05-09 06:35:36-04:00,19785,GdUWbwTgHF1RRbpVXCahz36G7MqYrM6QaBgnjL2eLKxk,JDYxQpYMt38mmjzLrVjgi3ezpc3DQ8YJEtJTZbG6fCCq,True,46753747,2069808,8214,4107,4107,2a35JJeTUW1pm6M3e8DHCjp8qr4vbc2cRPhuzZWyFzYd,1855620,15211357,-13355737,396
2022-05-09 06:35:36-04:00,19786,9tt8Hp2uzgmuv9fHSZDH299ytZGpqQuqA4arrksvpncJ,J1Y4k1hkmxncznXCdgNSmH7aW2Zdppe9QPWZZmanXrAL,False,33487793,33487793,979083,48954,930129,C4UnXuShCvjSMgBAgVNMy1oakxCNk1et27A82fywU112,979083,12104911,-11125828,292
2022-05-09 06:35:38-04:00,19787,AtaNpuHGEDd7kfakJbTbpphMdQk7ZWk9iB585TtNATKx,72egdmxZyhyYsM93hTMuoDd6NeYVB7gpiJG4PWj4Qi8f,True,38227542,1633131,6647,3323,3324,47z82br5WdW2DZajdnPDPSSRRKsyAggqXqK6oPUwTaLf,1555932,12547638,-10991706,407
2022-05-09 06:35:52-04:00,19788,fAJK1wrBhSW297AtFWX2U4rUBf2gkzfQ6UrQL9yHEYW,5pyTFpanSyUCHxeMhJMKtpdrcMSAWc8bFadbyM7q4q4B,True,289895799,72473949,216306,108153,108153,72FwbpFGoLEazJEdpqNtPNefsadUrimUqma9wSoy4qiS,8652262,26225830,-17573568,298
2022-05-09 06:37:15-04:00,19789,HT2SuCbePhjNZaar24uVwihYowCNvSjdvhJ8BRSVw9nX,98Ts4LCnapHVoCJ5PW3Armvh4jvDtpfs3SYRLRxiAgzZ,True,35202856,5083254,23155,11577,11578,Hu94aiQWvce6THeGyCFqGRPM1pQrK3ihzkcXo1EpJcJL,1603584,19944219,-18340635,455
2022-05-09 06:37:22-04:00,19790,7tFD53kPTqrzjCu1Wji78gUqhoRtCUhsP1pM3DQKT7uG,BJvgPLYBDJrQJdQVowrsMwUGMurq4zTihoFwWoEokfu3,True,160295342,20350773,61239,30619,30620,Hu94aiQWvce6THeGyCFqGRPM1pQrK3ihzkcXo1EpJcJL,4823623,43360413,-38536790,300
2022-05-09 06:37:31-04:00,19791,5xkW7wHTcF5WadNtBBqKPKctVwyQtTqqscivAmxzseCk,7m31ZMZdCn5Gz2q5sETWA7uKA5LsKD7pJHBBqU3g7tCn,True,912187487,228046871,688044,344022,344022,A9TwRM1BMxqb8DCC7YNAMV6zPenEJm3HTZBy7wJKK58U,27521761,131816905,-104295144,301
2022-05-09 06:37:31-04:00,19792,AvvZT6q65qCaCdETtpR9XbCvY4Rv9RdpvbGuh6umEA9X,8dP2GJEjKTk9x7focRgCAYJauaGXENyxMU3EtgPA4gas,True,25997077,1207825,5020,2510,2510,2a35JJeTUW1pm6M3e8DHCjp8qr4vbc2cRPhuzZWyFzYd,1080649,8587537,-7506888,415
2022-05-09 06:37:33-04:00,19793,26pvf6YygxQ8CdL4h4PcMuYNQtFbUVisTsYaFB3EZXvd,9tVSyevo14cUe2NMoBteqgV7vw44m6ooz2rD9ricKh55,True,91207628,22801907,68285,34142,34143,2a35JJeTUW1pm6M3e8DHCjp8qr4vbc2cRPhuzZWyFzYd,2731418,41311147,-38579729,299
2022-05-09 06:41:53-04:00,19794,85gxgPczGaY9xtDwEvNrWLPhsJFqHPCG1DbbedtFwsVK,AhZjmArZneA5QoTrL8TxzLni6aUxQYZbTYym1YcY4Qhz,True,238547662,59636915,372356,186178,186178,6L1WYrPiCMyi7XemPww4B4hvpKD1LQKD4RpiSKmrmgSC,14894241,61905728,-47011487,624
2022-05-09 06:42:26-04:00,19795,8T4WK27RvWVGqPuNqY6whk1fmU4vd5qaUQPZG1GJ79bh,DvSz7knS8N3K7L6JhQf1s4mJSyxB8uJXNQXtyjJn8QRL,True,342798594,84237008,245864,122932,122932,AmTrMPzuTp2BjnjqGNKqz9FTTCdpoKcPAJLwFc8ozcbh,10005363,49891459,-39886096,291
2022-05-09 06:42:26-04:00,19796,DvSVpLMQyz91ksMwhuwwFDiKMo53FC5FVG5XrQZYWurJ,5jL2cYHg1QQpWYRCF4f378jpeHnTfPMWXiiHuhLNbzq8,True,44563961,4102102,16057,8028,8029,6L1WYrPiCMyi7XemPww4B4hvpKD1LQKD4RpiSKmrmgSC,1744421,14470508,-12726087,391
2022-05-09 06:42:26-04:00,19797,AL8JFS4gjaQx89f9j8wtaNJgV76K8bw1ugvNtgvhgAnb,HJYvG2kGKe8kXgtZSWTWwTmSjxA3XUeCvyT7acoKtS1C,True,21704729698,5426182424,15762463,7881231,7881232,DA18qE9qesbBqpwNv1M4befYcNQkbSBSeLPTmQzrmbJw,630498525,5662879346,-5032380821,290
2022-05-09 06:42:26-04:00,19798,G7J6rzKaJY5eTjmaCtY1Kxnf6TGXLTNdzuVWBgY93c7j,FZJnEdNgQeYqvRb6g5Vyryv6AWMj1pYMdMm6DbcTdCbL,True,78531903294,19632975823,59114430,29557215,29557215,AmTrMPzuTp2BjnjqGNKqz9FTTCdpoKcPAJLwFc8ozcbh,2364577210,4818196031,-2453618821,301
2022-05-09 06:42:26-04:00,19799,9w3cWF5hSFmbpdF1BnFykMPXD3m6tjZtHmg1UJcXcy7E,F9zQidAfrm7ERv7Mqw7EgFkfN79e6QQ22PEZJWC1B5yg,False,12420133,12420133,308657,15432,293225,3zqXX6kzhkbW3d4TwD2CNjMRwxTbREXySekvq37kfCNk,308657,5804024,-5495367,248
2022-05-09 06:42:37-04:00,19800,BJUNK2orMVx6mYsD9pnQzmsEh95ZF2NWPm9KJ1ZM67Qn,FpxLa3DwWrspYvHVsScSDcscHB2eBHGxRrQ4gVvn4VW,True,89424687,22356171,67083,33541,33542,6L1WYrPiCMyi7XemPww4B4hvpKD1LQKD4RpiSKmrmgSC,2683329,29238630,-26555301,300
2022-05-09 06:42:41-04:00,19801,4hZG7dM716SxDagiFGwt1gSC99B2QK1emGLV9TJmmuR8,7vjfUWySkyx4Z5qAaRr2VWnVvxHHNsvPj1PirGNSjM6,True,26657079,6664269,41393,20696,20697,C4UnXuShCvjSMgBAgVNMy1oakxCNk1et27A82fywU112,1655748,25280184,-23624436,621
2022-05-09 06:42:44-04:00,19802,5rnSL1jkLDsAvWsKNrbxtBJEcavHbc41kSTWywUEmSaX,87ZzyZEPJAXq6UiTqQVNuChRQVSb7QcUJgV41saA8CFC,True,42152627,4057593,16557,8278,8279,C4UnXuShCvjSMgBAgVNMy1oakxCNk1et27A82fywU112,1720062,14259935,-12539873,408
2022-05-09 06:42:58-04:00,19803,532MfQR1PzPn6cmC1kpZsz9MyBWSamSeieh1F6GqVY33,6sJ8XXMZzGbHjVU1vWNW8unWoBZhJa54GguYJQhcb8PA,True,2662255205,373256823,2368354,1184177,1184177,CGtKBgcWZ6HKE3tFNLPUM9khDv2Rc7d6BrPtxz7J1aY,168922979,383754788,-214831809,634
2022-05-09 06:43:03-04:00,19804,FuoFPNTdYVDkSHaBac6UC1aNJXafSNTvFJuBCdrgQQrH,ApBS1Fx83tcECMzDV6wEzEzEdg4e2hgj3djtjRUoSKK5,False,4592079,4592079,247669,12383,235286,6L1WYrPiCMyi7XemPww4B4hvpKD1LQKD4RpiSKmrmgSC,247670,4336458,-4088788,539
2022-05-09 06:43:14-04:00,19805,6pUtYz474QrpATEZnfb3iFbTKYA65pNyKAo4TQZAjtqe,8dipRUXvxJiDLdHEtCPkso4vErbVwshHQiRfvSngBS9J,True,365508298,16689019,59459,29729,29730,47z82br5WdW2DZajdnPDPSSRRKsyAggqXqK6oPUwTaLf,13022400,228218843,-215196443,356
2022-05-09 06:43:15-04:00,19806,5jAGYgNPbxE171j6GLMhf2WjbGzm7vKMifg5tAPcUPc1,EWoKgDPerFZ2ExRi6wWK9xBSyT2xQptp46Rdh39jF7Kt,True,24687401,2291008,9282,4641,4641,C5o4TfkUfECutAWsDELjhsZX6PYyYgK3XeKvx6p4FphM,1000263,8246048,-7245785,405
2022-05-09 06:43:16-04:00,19807,62q4KpVd3UXPomDaqpTF7recRAEh2ZKgWRgT92ztmda4,8xRdV8nWLb3CiCcHt2ZXEJv3NSfaa178zarhUkKv2rP9,True,54744602,2627998,10959,5479,5480,C5o4TfkUfECutAWsDELjhsZX6PYyYgK3XeKvx6p4FphM,2282931,17100956,-14818025,417
2022-05-09 06:43:18-04:00,19808,C8EuUJigyRy2ojSuZtDSnc4JxmVqoe5XTr4xaPPmKsyV,6PrUiT94hGcBm2AvkmkrnRnjXkR8WxmtJcvSapde3J1P,True,56077782,14019445,42236,21118,21118,C4UnXuShCvjSMgBAgVNMy1oakxCNk1et27A82fywU112,1689460,125485034,-123795574,301
2022-05-09 06:43:23-04:00,19809,5euvq1j9LCJWT1K7xKAE2TjwzbrWA5t6j2SxtnWsEPeU,GKDnouGNzg5JkjWG7Qs4nmka6qUMdYrk1fKwrmj8TvdH,True,57972627,3072316,13081,6540,6541,6L1WYrPiCMyi7XemPww4B4hvpKD1LQKD4RpiSKmrmgSC,2468414,17995876,-15527462,425
2022-05-09 06:43:24-04:00,19810,EHi1UBG8wMUFZECktsFUZkGjJPaBNEedswS62hyYn6jC,Drx9ErQhAjnPuJ83LPYFnY5ZV5XDzGuXDuSf16VqWayp,True,544992637,29321766,107904,53952,53952,3zqXX6kzhkbW3d4TwD2CNjMRwxTbREXySekvq37kfCNk,20055815,365135030,-345079215,368
2022-05-09 06:43:24-04:00,19811,xj242sRBwTMF1Df9grLWe4iXm6Yw1my5iBa2byzjgzk,BMZz3sBcTxtzUwasePcpzeCS1TANz9mqdL1ufhnW7vob,True,3079491600,769872900,2313363,1156681,1156682,2py1FiYeL2f7J3HU36qiJz6TD6HCmiTN36RyxYtapQCZ,92534544,652888257,-560353713,300
2022-05-09 06:43:31-04:00,19812,Ai6G7vosJfmkRqtDAkqxRtbzELp6P5xe9r2RH3LYcLZt,8SUpKXakmhi4rYiFKnHYpgaAopomfDqEX6Efew9iM6nk,False,23455271,23455271,981273,49063,932210,6L1WYrPiCMyi7XemPww4B4hvpKD1LQKD4RpiSKmrmgSC,981274,15315013,-14333739,418
2022-05-09 06:43:31-04:00,19813,3AaMzK9WAbD9m27szcJYnucnSPQ4W7tk8EztgWv4vqUo,8oUBQUKo9wHLu1tUEF1AeCUa7oRYyDSoFNRMqQAqKMbH,True,58002597,3072329,12995,6497,6498,47z82br5WdW2DZajdnPDPSSRRKsyAggqXqK6oPUwTaLf,2453511,17956310,-15502799,423
2022-05-09 06:43:31-04:00,19814,6HtdpTubfGUuwW6rympMFLyUsdELKDpYagmkErBdLGc6,7e6N7pnwFYx9kU2TXJWt9gCsCpUZTxnFKzjDNZeyWQyq,True,59645909,14911477,89372,44686,44686,3zqXX6kzhkbW3d4TwD2CNjMRwxTbREXySekvq37kfCNk,3574888,13852693,-10277805,599
2022-05-09 06:43:34-04:00,19815,AvvZT6q65qCaCdETtpR9XbCvY4Rv9RdpvbGuh6umEA9X,8dP2GJEjKTk9x7focRgCAYJauaGXENyxMU3EtgPA4gas,True,24717769,2291453,9308,4654,4654,C4UnXuShCvjSMgBAgVNMy1oakxCNk1et27A82fywU112,1004146,8208308,-7204162,406
2022-05-09 06:43:35-04:00,19816,FuhTkUxSaJ7kvuu9LHZaPVfdbKAQSh9W8Zzso1XPKGZp,FLoqPzREreKfRCwqtXs3CJwpTSudmXrVYCRZadWvob7j,True,56481166,14120291,40556,20278,20278,3zqXX6kzhkbW3d4TwD2CNjMRwxTbREXySekvq37kfCNk,1622262,26350234,-24727972,287
2022-05-09 06:43:38-04:00,19817,AtaNpuHGEDd7kfakJbTbpphMdQk7ZWk9iB585TtNATKx,72egdmxZyhyYsM93hTMuoDd6NeYVB7gpiJG4PWj4Qi8f,True,36484637,3226379,12729,6364,6365,6L1WYrPiCMyi7XemPww4B4hvpKD1LQKD4RpiSKmrmgSC,1439511,11959272,-10519761,394
2022-05-09 06:43:39-04:00,19818,3zVmiyif8VbqUW7dAeEMYJYrg8r5pCeBfALsdgu6kgFJ,FwzrxNbJsiCQwqayaDhwkbm9TRG11bK6fWs5Dn75da9a,True,53619413,13404853,39438,19719,19719,6L1WYrPiCMyi7XemPww4B4hvpKD1LQKD4RpiSKmrmgSC,1577545,24117185,-22539640,294
2022-05-09 06:43:39-04:00,19819,HXQXfEQe7aCpr6WKh37XaDZsjZcuQPk5t8tWNFgEoK6U,5ufXkCEDwgiXwtyPye4wYVVA3oLW54JVzz4tnXFofto4,True,617034144,154258536,461600,230800,230800,A9TwRM1BMxqb8DCC7YNAMV6zPenEJm3HTZBy7wJKK58U,18464019,279291936,-260827917,299
2022-05-09 06:43:43-04:00,19820,3pRKRd4i6jepz5HPbSsSFj2YKwYBjgVAk2v7ZMBYZVNR,Fzf7Gx6KJam5A1eny5G49cRS2zZHFt7XMxCx8N1Ej2Jd,False,32891109,32891109,965427,48271,917156,6L1WYrPiCMyi7XemPww4B4hvpKD1LQKD4RpiSKmrmgSC,965427,14789354,-13823927,293
2022-05-09 06:43:43-04:00,19821,7YCSi1xGHn5j65W5cZPkQ9RQzvpNgCGdrafAGGTLYkjE,BdVVPyQgd93sMf1SDCFFMvyugNsbdkrVNgaQCJEGjTLC,True,26787139,2364938,9376,4688,4688,C4UnXuShCvjSMgBAgVNMy1oakxCNk1et27A82fywU112,1062043,9993749,-8931706,396
2022-05-09 06:43:43-04:00,19822,6fqbSyhh3PPdgRcLraHb7Jahj9s1oHHeX3SsjNSsGa6t,GpRUow48TYgttdYfsygbgjYQcmHyYjWETUDjDVphEgwq,True,35050883,4498610,13327,6663,6664,C5o4TfkUfECutAWsDELjhsZX6PYyYgK3XeKvx6p4FphM,1038419,25263382,-24224963,296
2022-05-09 06:43:45-04:00,19823,CpeJ8BVz8Nd6SqnM3DYejnvAYnovDwu1taCqMEBD4RRi,GMmBgzDTtes62wJTENptaWPxNY2srWCrAdWErkj22Hzj,True,36553574,1606411,6393,3196,3197,C4UnXuShCvjSMgBAgVNMy1oakxCNk1et27A82fywU112,1454934,11776420,-10321486,398
2022-05-09 06:43:47-04:00,19824,7GpG8k6hM27vK1R5Sx1v5xUBuF6vybP41dcymjXDi5P7,7Aip6HDcbZ5mvoSucNupRS9enRdGx37F8L432K7V81do,True,106285561,26571390,162952,81476,81476,C5o4TfkUfECutAWsDELjhsZX6PYyYgK3XeKvx6p4FphM,6518083,70920917,-64402834,613
2022-05-09 06:43:58-04:00,19825,EVMrznfJS54BZiywDD2WhUtxzicDtbEpm2a5yLrtCgRF,CpzsMYVYvKg8ihrX1cKRw7TDEYwD3kAyiX92hsf2KiTz,True,396452947,26115890,120241,60120,60121,C4UnXuShCvjSMgBAgVNMy1oakxCNk1et27A82fywU112,18253295,278532969,-260279674,460
2022-05-09 06:43:59-04:00,19826,GdUWbwTgHF1RRbpVXCahz36G7MqYrM6QaBgnjL2eLKxk,JDYxQpYMt38mmjzLrVjgi3ezpc3DQ8YJEtJTZbG6fCCq,True,44568319,4089536,15890,7945,7945,C5o4TfkUfECutAWsDELjhsZX6PYyYgK3XeKvx6p4FphM,1731786,14460445,-12728659,388
2022-05-09 06:43:59-04:00,19827,BEuVsj9KuYBTaxrLpKwrQtHxmhRtB16siNfPXsAvf6rz,BTjWitiLbteuKMzaFj1daYyM2v9rZygESDktu8cuzC8g,True,37803951,9450987,28008,14004,14004,C4UnXuShCvjSMgBAgVNMy1oakxCNk1et27A82fywU112,1120336,5405627,-4285291,296
2022-05-09 06:43:59-04:00,19828,648dg79UazWHnwQ9p4kxQdcRXPhc21377kEQnSPssvfz,3d12WWiYbtie5eEyJjqTiLfyR82oQPdaQV2HdVH5d4AK,True,21906142,5476535,33943,16971,16972,C4UnXuShCvjSMgBAgVNMy1oakxCNk1et27A82fywU112,1357735,21639363,-20281628,619
2022-05-09 06:43:59-04:00,19829,H7rsFRRhZPe2jLex2NkbYYzVtLobvFiqnCd4BUyJVPBB,8bedwDRfSKLP9vUxoXcpHNJzWQemMaf4QGT2mtHFVJFb,True,65403156,16350789,47668,23834,23834,C4UnXuShCvjSMgBAgVNMy1oakxCNk1et27A82fywU112,1906737,6309525,-4402788,291
2022-05-09 06:43:59-04:00,19830,7w76zJFb9nTPDbfC4DCscQ2F5vimT8hiivT8WkuwWYWX,5X5XNdoFZv15bmbv97VRxHgTZzKyiFZpoz7MRNkPZS6f,True,37103830,1547103,6327,3163,3164,C4UnXuShCvjSMgBAgVNMy1oakxCNk1et27A82fywU112,1517503,12460698,-10943195,408
2022-05-09 06:43:59-04:00,19831,3CTLVMSTYE6azjXhZyhPD5XiUe23aJ4pb456SQnUiohH,13q8wAZ1zte3bd3LdeKLEUY7ubu2suCNRZVrgMScpV3C,True,36577198,1612096,6423,3211,3212,C4UnXuShCvjSMgBAgVNMy1oakxCNk1et27A82fywU112,1457362,11756335,-10298973,398
2022-05-09 06:44:12-04:00,19832,4oMasDRj8HWfknmdwt6Mkz3eonr8J2byoiSTRo4sCnFQ,3emcATkEFvDVETiK97eVET2Z2jzkgiiSxX3gu5wsUKPe,True,695010616,99985381,657980,328990,328990,6L1WYrPiCMyi7XemPww4B4hvpKD1LQKD4RpiSKmrmgSC,45737066,382463067,-336726001,658
2022-05-09 06:44:14-04:00,19833,5TvEy5YBFcLw4RGvv9eMGFXs2Zih724VC382iZykGPiT,66tWw3c3q9eUcc7P7MtJEcK9CrMZpgzTxsVU1ZjXR2V8,False,4173289,4173289,125510,6275,119235,3zqXX6kzhkbW3d4TwD2CNjMRwxTbREXySekvq37kfCNk,125510,952220,-826710,300
2022-05-09 06:44:18-04:00,19834,A7j77tzgnQVGtHTa65VtVZqJRYeJvQk7am8NW6e66379,4vJGwEvXU2tGWoWWGwbsYcfKQAMCHbrBMRk4ZVFzneLs,True,494201548,123550387,356113,178056,178057,2a35JJeTUW1pm6M3e8DHCjp8qr4vbc2cRPhuzZWyFzYd,14244541,153720676,-139476135,288
2022-05-09 06:44:20-04:00,19835,2tPYXtNrw134ACVhkYdnG9FGT4iHm61PuX8L7AfG9aAT,EyyPLVdjgewzVDKePQUj85BBttWy4MixVr9CSD8JVbrP,True,475662590,118915647,345202,172601,172601,3zqXX6kzhkbW3d4TwD2CNjMRwxTbREXySekvq37kfCNk,13808094,213078589,-199270495,290
2022-05-09 06:44:20-04:00,19836,H8P77smmiLj1vtt7hoSjf2vmcnBdW4rsgCtagtXZg6yy,3FxygrzNpSWivjLU3CumYif6rXhSzyjLqdKiyvphDnnc,True,57970558,3070534,12924,6462,6462,3zqXX6kzhkbW3d4TwD2CNjMRwxTbREXySekvq37kfCNk,2440154,17980497,-15540343,420
2022-05-09 06:44:20-04:00,19837,5jAGYgNPbxE171j6GLMhf2WjbGzm7vKMifg5tAPcUPc1,EWoKgDPerFZ2ExRi6wWK9xBSyT2xQptp46Rdh39jF7Kt,False,22337744,22337744,932329,46616,885713,C5o4TfkUfECutAWsDELjhsZX6PYyYgK3XeKvx6p4FphM,932332,7712824,-6780492,417
2022-05-09 06:44:20-04:00,19838,Ejg8vXVsro4jB2fpdUUXCRfKTiE5TUwfRXhHeR8qtrEi,GnF7xwsjzso48ZEAdYYuxNkJso7ug3s46uogi4XDbs1,True,462520116,115630029,331402,165701,165701,8sEswn3kzEhnYjAZVvCQnHEUvYd7pFVvc2Xc2Kd1BpbC,13256080,114239194,-100983114,286
2022-05-09 06:44:24-04:00,19839,A5NXadGWnFZRoHEn1dKTRjcXgWmfMLMyJdpF4rQPZyRR,ALs3Zfotc4c4A6TFDMbd5GM5whK1dTYSnGrHiMBWmApH,True,753883177,188470794,533145,266572,266573,CGtKBgcWZ6HKE3tFNLPUM9khDv2Rc7d6BrPtxz7J1aY,21325814,111195083,-89869269,282
2022-05-09 06:44:29-04:00,19840,5rnSL1jkLDsAvWsKNrbxtBJEcavHbc41kSTWywUEmSaX,87ZzyZEPJAXq6UiTqQVNuChRQVSb7QcUJgV41saA8CFC,True,37963301,1864790,7720,3860,3860,6L1WYrPiCMyi7XemPww4B4hvpKD1LQKD4RpiSKmrmgSC,1571772,13300972,-11729200,414
2022-05-09 06:44:30-04:00,19841,4rVW5SPBGcoxE3wAnjbULgZm4xdHXtqhivrszp9W4YP7,Fzu9D4KRKhAF7p22sNqMybe11zGwuXVe58iSt32MbfYX,True,120094575,30023643,84391,42195,42196,3zqXX6kzhkbW3d4TwD2CNjMRwxTbREXySekvq37kfCNk,3375660,34281085,-30905425,281
2022-05-09 06:44:31-04:00,19842,Fczxdc24Eav8xcaKRDwWMEwPEzkGyEJ7qGcXYyGZFKVz,8GqweYpec4cnpaJvueF3FGWoaz72BAzpLYXBX7tuuqEt,True,48524850,12131212,33974,16987,16987,47z82br5WdW2DZajdnPDPSSRRKsyAggqXqK6oPUwTaLf,1358965,35920423,-34561458,280
2022-05-09 06:44:31-04:00,19843,FU3fRyQxk6rwtD9Db1nTvTAjSwgSW9vi1q7SjZ92ijyM,7c3maBK3hpb1exxqcvnwiUfhhUBgLgCs5exANSZ7m494,True,191372184,47843046,137011,68505,68506,C4UnXuShCvjSMgBAgVNMy1oakxCNk1et27A82fywU112,5480476,24951132,-19470656,286
2022-05-09 06:44:33-04:00,19844,BAkPsWHtpVcEGqUgKTKjwZ6d5aaUcaUhdgYxBnpSTDW2,BDwDmVaZnXh22sf8nsDtjVfgxMAswbM3PW3si3k4nbRK,True,135920608,33980152,95096,47548,47548,C4UnXuShCvjSMgBAgVNMy1oakxCNk1et27A82fywU112,3803858,58644904,-54841046,279
2022-05-09 06:44:38-04:00,19845,DRVtEzZs9u9ysrcANZLEjrvbuuGqYn77v2h4cDFKuNUx,Fv9qiMZhuSBL2cs9AWUYbDLQjB46W2ZwrhxaNXtPLDpC,True,11424654551,2856163637,8504027,4252013,4252014,AmTrMPzuTp2BjnjqGNKqz9FTTCdpoKcPAJLwFc8ozcbh,340161113,909681031,-569519918,297
2022-05-09 06:44:39-04:00,19846,CMVVfXQYALSc58NLD67L8YrJAbDHZ9rFZvYQC7r8Png4,44pytMX14zaEQv6aRQ223CxYB2uTP7VUTQfUY58EkaNB,True,148065183,37016295,98853,49426,49427,C4UnXuShCvjSMgBAgVNMy1oakxCNk1et27A82fywU112,3954122,67137594,-63183472,267
2022-05-09 06:44:42-04:00,19847,7qEVqFr1naSPCDV9q3xx6KMZn1yCHvkHZJkaA46NLmSE,8Mohcixq2L9PYrHpb95vuEsXqJ18JhEHi3RA83VM9cLv,True,122997812,30749453,87753,43876,43877,C4UnXuShCvjSMgBAgVNMy1oakxCNk1et27A82fywU112,3510141,45422122,-41911981,285
2022-05-09 06:44:42-04:00,19848,HooxSzasW3HMoFJ6sAvRQ75Char1J5aBdJtsqfDV6myp,BCmsWwpGeV4NNfeKZKKydty2uueLGHYTJDk1WErpXsVT,True,95999301,23999825,148614,74307,74307,6L1WYrPiCMyi7XemPww4B4hvpKD1LQKD4RpiSKmrmgSC,5944584,33859448,-27914864,619
2022-05-09 06:44:43-04:00,19849,42h4NteqFpLjgjMS4gTTFoLvrEMpEP4sbGRd7SM5YCZR,AasJCLP5qsGzxkQs5jWysSarwoJTuZ6ZDeabNJNimWAX,True,2462382341,615595585,1825267,912633,912634,6UQfSsLooL4pQKQfLtXCutQS2BnF7A7F7ewJopDLmUpc,73010715,244547193,-171536478,296
2022-05-09 06:44:43-04:00,19850,E4VzeJLsf5Y6t3yNi8VpS8QxhJbJGPhnkNBmU2XoCBs9,63CXyYfevXtrL1QcfQtAhz29xeea5BwWcj6d6BWb4qiB,True,1340357109,335089277,993598,496799,496799,6UQfSsLooL4pQKQfLtXCutQS2BnF7A7F7ewJopDLmUpc,39743930,614501551,-574757621,296
2022-05-09 06:44:43-04:00,19851,3CTLVMSTYE6azjXhZyhPD5XiUe23aJ4pb456SQnUiohH,13q8wAZ1zte3bd3LdeKLEUY7ubu2suCNRZVrgMScpV3C,True,34895672,3057165,12102,6051,6051,6L1WYrPiCMyi7XemPww4B4hvpKD1LQKD4RpiSKmrmgSC,1381509,11252358,-9870849,395
2022-05-09 06:44:43-04:00,19852,HT2SuCbePhjNZaar24uVwihYowCNvSjdvhJ8BRSVw9nX,98Ts4LCnapHVoCJ5PW3Armvh4jvDtpfs3SYRLRxiAgzZ,True,29928057,2033800,9438,4719,4719,C4UnXuShCvjSMgBAgVNMy1oakxCNk1et27A82fywU112,1388884,16751376,-15362492,464
2022-05-09 06:44:46-04:00,19853,62q4KpVd3UXPomDaqpTF7recRAEh2ZKgWRgT92ztmda4,8xRdV8nWLb3CiCcHt2ZXEJv3NSfaa178zarhUkKv2rP9,True,51943184,2297494,9281,4640,4641,C4UnXuShCvjSMgBAgVNMy1oakxCNk1et27A82fywU112,2098552,15780495,-13681943,404
2022-05-09 06:44:48-04:00,19854,Eps7NSYQhiSzaTpTLzx5aoDykXSKtQ6w1JBFuucC8hQp,EeNkTwr26mYEBqYHqoHaBZfybPS2PwcbJsgmQGJY6g89,True,44068319,11017079,29548,14774,14774,C4UnXuShCvjSMgBAgVNMy1oakxCNk1et27A82fywU112,1181922,19894447,-18712525,268
2022-05-09 06:44:48-04:00,19855,CpeJ8BVz8Nd6SqnM3DYejnvAYnovDwu1taCqMEBD4RRi,GMmBgzDTtes62wJTENptaWPxNY2srWCrAdWErkj22Hzj,True,34873347,3057808,12053,6026,6027,C4UnXuShCvjSMgBAgVNMy1oakxCNk1et27A82fywU112,1374725,11267057,-9892332,394
2022-05-09 06:44:48-04:00,19856,EHi1UBG8wMUFZECktsFUZkGjJPaBNEedswS62hyYn6jC,Drx9ErQhAjnPuJ83LPYFnY5ZV5XDzGuXDuSf16VqWayp,True,513948385,55185730,195697,97848,97849,C4UnXuShCvjSMgBAgVNMy1oakxCNk1et27A82fywU112,18225425,335019492,-316794067,354
2022-05-09 06:44:48-04:00,19857,7BEY9qatFJomsayFmky3h3dAbKhY5XkRGwMobJuxXYhQ,J8MK3tAQKreBUG2reXY6gqr1uhbHhcAZEcxsLQmG5Ntt,True,338174322,84543580,592320,296160,296160,A9TwRM1BMxqb8DCC7YNAMV6zPenEJm3HTZBy7wJKK58U,23692801,133444417,-109751616,700
2022-05-09 06:44:50-04:00,19858,7A1A93jqxV65F7XwvBarhgfTm3iFh3s75jFNzVCtFnez,8Z6QWdy4zGUzuMdKhkdxzq7RaLHhJmrpYEKeqsw8bopx,True,40584909,10146227,29694,14847,14847,6L1WYrPiCMyi7XemPww4B4hvpKD1LQKD4RpiSKmrmgSC,1187792,9998079,-8810287,292
2022-05-09 06:44:52-04:00,19859,3u8kTzHN7uChpqJpH4WkMvBGxz7Rsg93EvB3k7dPf7G1,GWdMVk7p7EE1fPqfcyrVhcTsYXV6MoyV9bLdMYW45YQv,False,28848798,28848798,834036,41701,792335,C4UnXuShCvjSMgBAgVNMy1oakxCNk1et27A82fywU112,834036,10602744,-9768708,289
2022-05-09 06:44:52-04:00,19860,7cvbksBKz3SyD4Waqpa3qaBAj7ZVZcxL5M1mJrHemDoK,5Pyxm6RqTPwQp2ji2mkbqC56Bg2Ps9ed9YGXz5HXezRr,False,27595761,27595761,817640,40882,776758,C4UnXuShCvjSMgBAgVNMy1oakxCNk1et27A82fywU112,817640,6990310,-6172670,296
2022-05-09 06:44:53-04:00,19861,7tFD53kPTqrzjCu1Wji78gUqhoRtCUhsP1pM3DQKT7uG,BJvgPLYBDJrQJdQVowrsMwUGMurq4zTihoFwWoEokfu3,True,139207828,19683749,56921,28460,28461,47z82br5WdW2DZajdnPDPSSRRKsyAggqXqK6oPUwTaLf,4025643,37643405,-33617762,289
2022-05-09 06:44:53-04:00,19862,CnNbPk9YL7y2PiqMfVvS1789stfDA7ZDk3sArJSw6FwP,9oamN33gGnx3tU9Mnn53yhi6F2Du5AAaSV6uAi69rbib,False,34494302,34494302,991560,49578,941982,C5o4TfkUfECutAWsDELjhsZX6PYyYgK3XeKvx6p4FphM,991560,15671453,-14679893,287
2022-05-09 06:44:53-04:00,19863,F47ihi3LtNYspD1tkQhind1ce8udZ628Ye1NuDBd3Me1,HqzXiTisYpcPHCAMvceUL8WSrzEX38TuGkzPaGJSdAHm,True,51582362,12895590,33110,16555,16555,47z82br5WdW2DZajdnPDPSSRRKsyAggqXqK6oPUwTaLf,1324433,13024798,-11700365,256
2022-05-09 06:44:54-04:00,19864,5NVJU6YoZuuEjGNUUUJcGwS2Qd8b8CH7QSgMV7UWL5E7,8ZUq3o1nSkEvSfmiTz4anUpSMECCnX38MRwV7E5AGYSt,True,41937756,10484439,30849,15424,15425,6L1WYrPiCMyi7XemPww4B4hvpKD1LQKD4RpiSKmrmgSC,1233972,10310512,-9076540,294
2022-05-09 06:44:54-04:00,19865,EVoc9HuMgnTyrYjC1ySj3sYVzXccSPjupjgj69gMkuNQ,2ahbZJgSLSyppym6N7iyby3SvQcCzYrjdioGLAmhf7Y8,False,33151133,33151133,925141,46257,878884,3zqXX6kzhkbW3d4TwD2CNjMRwxTbREXySekvq37kfCNk,925141,10942148,-10017007,279
2022-05-09 06:44:59-04:00,19866,EVMrznfJS54BZiywDD2WhUtxzicDtbEpm2a5yLrtCgRF,CpzsMYVYvKg8ihrX1cKRw7TDEYwD3kAyiX92hsf2KiTz,True,368716817,24548900,109941,54970,54971,C5o4TfkUfECutAWsDELjhsZX6PYyYgK3XeKvx6p4FphM,16512814,252239226,-235726412,447
2022-05-09 06:45:05-04:00,19867,13GT6eaKWuaLe7wFcybCnUaYgd9DfyzYRN2FcXWgFwpC,CbwmJ7YpnvcqDyUw3L9b7dqXcA8Ju3rYrTdegeaJJbWC,False,12671066,12671066,787629,39381,748248,6L1WYrPiCMyi7XemPww4B4hvpKD1LQKD4RpiSKmrmgSC,787629,10664524,-9876895,621
2022-05-09 06:45:05-04:00,19868,Apqv5iu4bJ6pVg2NxjfwuvnfxDK6navHhhU1CVJEHeMa,7pDPJrxndRsLq983bEwvd3MKYnnqyQzQNMhEaC5NZYN1,True,40584602,10146150,29392,14696,14696,C4UnXuShCvjSMgBAgVNMy1oakxCNk1et27A82fywU112,1175708,9992732,-8817024,289
2022-05-09 06:45:19-04:00,19869,6pUtYz474QrpATEZnfb3iFbTKYA65pNyKAo4TQZAjtqe,8dipRUXvxJiDLdHEtCPkso4vErbVwshHQiRfvSngBS9J,True,347915452,28523853,98866,49433,49433,C4UnXuShCvjSMgBAgVNMy1oakxCNk1et27A82fywU112,12059114,213523101,-201463987,346
2022-05-09 06:46:05-04:00,19870,5g5EaEMiM2WQcfDpL3R3caYziX9xvGCFs9eVmmQdcgzS,J71CftCqiK1873fkVx9NGc7v7nvRZMYVBkGN3GhSPyeX,True,14232174,3558043,25036,12518,12518,C5o4TfkUfECutAWsDELjhsZX6PYyYgK3XeKvx6p4FphM,1001473,6277676,-5276203,703
2022-05-09 06:46:24-04:00,19871,FRbeFwhUYCiHW5oP26mad8KND7CCYDbfnoNxX7GuXVp8,GrzXKxPX2WDka8i2D8sunMUsrsThKasQi8NYLwuCGygV,True,154589399,14548487,61491,30745,30746,47z82br5WdW2DZajdnPDPSSRRKsyAggqXqK6oPUwTaLf,6534025,73121658,-66587633,422
2022-05-09 06:46:24-04:00,19872,DHfy6B2AYsqMCxPLBCXMDfQn3Gr2VwJaLFHUZKqpCjsb,EPZpYaY1gCAb8pMtri5veRowBmCrCpTHBMa3Rmgt6S29,True,34751165,8687791,26061,13030,13031,6L1WYrPiCMyi7XemPww4B4hvpKD1LQKD4RpiSKmrmgSC,1042462,5975901,-4933439,299
2022-05-09 06:46:31-04:00,19873,5xkW7wHTcF5WadNtBBqKPKctVwyQtTqqscivAmxzseCk,7m31ZMZdCn5Gz2q5sETWA7uKA5LsKD7pJHBBqU3g7tCn,True,677582204,169395551,506882,253441,253441,A9TwRM1BMxqb8DCC7YNAMV6zPenEJm3HTZBy7wJKK58U,20275305,105063390,-84788085,299
2022-05-09 06:46:32-04:00,19874,532MfQR1PzPn6cmC1kpZsz9MyBWSamSeieh1F6GqVY33,6sJ8XXMZzGbHjVU1vWNW8unWoBZhJa54GguYJQhcb8PA,True,2273829384,289558190,1927802,963901,963901,2a35JJeTUW1pm6M3e8DHCjp8qr4vbc2cRPhuzZWyFzYd,151385627,342601995,-191216368,665
2022-05-09 06:46:32-04:00,19875,4YPn7VhWcrtecLaCBiVmXdmHwNmfR8qf2kzEtivmWrmK,EoEKgrmC6Xx6Ln8fWttD7wEtAkZtUbNifmv2mSHqV1Mf,True,63913798,15978449,48000,24000,24000,Hu94aiQWvce6THeGyCFqGRPM1pQrK3ihzkcXo1EpJcJL,1920005,9636506,-7716501,300
2022-05-09 06:46:34-04:00,19876,AvvZT6q65qCaCdETtpR9XbCvY4Rv9RdpvbGuh6umEA9X,8dP2GJEjKTk9x7focRgCAYJauaGXENyxMU3EtgPA4gas,False,22364059,22364059,932579,46628,885951,2a35JJeTUW1pm6M3e8DHCjp8qr4vbc2cRPhuzZWyFzYd,932581,7677951,-6745370,416
2022-05-09 06:46:34-04:00,19877,3Xbsek5MsEGoWr3G9yhuohREr26B2vSQcjqXdspTFHta,2rPxkUiMo9wGDq8EvAiwY3ngRpKmL223cBWWNTYoBmFp,True,467062654,116765663,342671,171335,171336,68sueyVfmy5ToEGtLFGDkwebX47xAmzyXE29z8JrmcWv,13706860,49717357,-36010497,293
2022-05-09 06:46:34-04:00,19878,6d6HN8LWikwW2HYdy3BABWuxKHt1sgv4DcneACR133sE,4eKvzmfFvX96XbujKBhUauAvWP4yQYwZH3pd7gXzbCvJ,True,37133017,9283254,27227,13613,13614,68sueyVfmy5ToEGtLFGDkwebX47xAmzyXE29z8JrmcWv,1089103,12006081,-10916978,293
2022-05-09 06:46:34-04:00,19879,26pvf6YygxQ8CdL4h4PcMuYNQtFbUVisTsYaFB3EZXvd,9tVSyevo14cUe2NMoBteqgV7vw44m6ooz2rD9ricKh55,True,67753338,16938334,50268,25134,25134,6L1WYrPiCMyi7XemPww4B4hvpKD1LQKD4RpiSKmrmgSC,2010750,31598037,-29587287,296
2022-05-09 06:46:34-04:00,19880,5euvq1j9LCJWT1K7xKAE2TjwzbrWA5t6j2SxtnWsEPeU,GKDnouGNzg5JkjWG7Qs4nmka6qUMdYrk1fKwrmj8TvdH,True,54711477,2622340,10863,5431,5432,68sueyVfmy5ToEGtLFGDkwebX47xAmzyXE29z8JrmcWv,2266499,17117604,-14851105,414
2022-05-09 06:46:35-04:00,19881,DAawvqmcjnThXxJzsp7ExW1bhGaRGRxLgG6h85HpGAN5,2KRCBiCQoQd2fDSS1e2U19WVddWAqM6EPkqK8rZwaRNh,True,69679606,17419901,51794,25897,25897,6L1WYrPiCMyi7XemPww4B4hvpKD1LQKD4RpiSKmrmgSC,2071763,79002124,-76930361,297
2022-05-09 06:46:35-04:00,19882,5B3nic6AUDSiweK5kgbwd6W9DqqX9tJ1zUSQHNWPe24b,2cpauDZ4j1ACSoFfR55NNEVh9quRiVcSFF7Zq3L26U8a,True,7234781944,1808695486,11121462,5560731,5560731,AmTrMPzuTp2BjnjqGNKqz9FTTCdpoKcPAJLwFc8ozcbh,444858503,665528465,-220669962,614
2022-05-09 06:46:37-04:00,19883,DvSVpLMQyz91ksMwhuwwFDiKMo53FC5FVG5XrQZYWurJ,5jL2cYHg1QQpWYRCF4f378jpeHnTfPMWXiiHuhLNbzq8,True,40347803,3946687,15790,7895,7895,6L1WYrPiCMyi7XemPww4B4hvpKD1LQKD4RpiSKmrmgSC,1614308,13556551,-11942243,400
2022-05-09 06:46:37-04:00,19884,6fqbSyhh3PPdgRcLraHb7Jahj9s1oHHeX3SsjNSsGa6t,GpRUow48TYgttdYfsygbgjYQcmHyYjWETUDjDVphEgwq,False,30408303,30408303,881121,44056,837065,68sueyVfmy5ToEGtLFGDkwebX47xAmzyXE29z8JrmcWv,881122,23804949,-22923827,289
2022-05-09 06:46:39-04:00,19885,5FewDaMC9U7n5EHcto98GaAmDVxDh5SYimuTP6AtfakM,7DAULUoqV7f9hsBzKEhjQPnWaHSqiMWcBqWcdcadaQv4,True,201077447,50269361,312491,156245,156246,6L1WYrPiCMyi7XemPww4B4hvpKD1LQKD4RpiSKmrmgSC,12499649,42317936,-29818287,621
2022-05-09 06:46:39-04:00,19886,FuhTkUxSaJ7kvuu9LHZaPVfdbKAQSh9W8Zzso1XPKGZp,FLoqPzREreKfRCwqtXs3CJwpTSudmXrVYCRZadWvob7j,True,42040673,10510168,31537,15768,15769,3zqXX6kzhkbW3d4TwD2CNjMRwxTbREXySekvq37kfCNk,1261504,20127727,-18866223,300
2022-05-09 06:46:39-04:00,19887,52pCCDDTo6uQhENab7rCsqS5ZihDDBmMSTQdCj8QLoea,GZh4ev3p6RrDRo98WfQQ7ZzzMBbqWF9gj9WbicU7YWD4,False,9686081,9686081,604961,30248,574713,3zqXX6kzhkbW3d4TwD2CNjMRwxTbREXySekvq37kfCNk,604961,4267349,-3662388,624
2022-05-09 06:46:39-04:00,19888,FncFHJooh1hy9Gc2y5sKdcYkZ5uHzsxHG4vHT9cVZGcK,BkFa4b5Jyv4ZJCCpwDYv355ezVFiZfAtn18AV7kstd2v,True,117447787,29361946,88594,44297,44297,6L1WYrPiCMyi7XemPww4B4hvpKD1LQKD4RpiSKmrmgSC,3543799,26549670,-23005871,301
2022-05-09 06:46:40-04:00,19889,C8EuUJigyRy2ojSuZtDSnc4JxmVqoe5XTr4xaPPmKsyV,6PrUiT94hGcBm2AvkmkrnRnjXkR8WxmtJcvSapde3J1P,True,41660692,10415173,31239,15619,15620,68sueyVfmy5ToEGtLFGDkwebX47xAmzyXE29z8JrmcWv,1249579,94493997,-93244418,299
2022-05-09 06:46:46-04:00,19890,3AaMzK9WAbD9m27szcJYnucnSPQ4W7tk8EztgWv4vqUo,8oUBQUKo9wHLu1tUEF1AeCUa7oRYyDSoFNRMqQAqKMbH,True,54739603,2625220,10789,5394,5395,C5o4TfkUfECutAWsDELjhsZX6PYyYgK3XeKvx6p4FphM,2249851,17078135,-14828284,411
2022-05-09 06:46:48-04:00,19891,EkKmfEnxTscSs2BDs1mg6SyHdStC8AYTy9zihw9VWP63,DW4ujEZj4H83B9CrSfbks2pkHEj3gh2d114eo1aDh4s9,True,46679747,11669936,33807,16903,16904,2a35JJeTUW1pm6M3e8DHCjp8qr4vbc2cRPhuzZWyFzYd,1352303,15338833,-13986530,289
2022-05-09 06:46:48-04:00,19892,9ancY5Fso8pUktKpRj3qc1YPQA6thy5n4f7uvNnsqMWR,CLUi9rvU9NTi7h4sNwqfr8aqChyGDbVJA1aKvKMWQv2r,True,684931990,171232997,512774,256387,256387,72XWPCtRYEDZbddP7d6dHtUBRRDLSJsB2xZTAfefoEVZ,20510974,168058823,-147547849,299
2022-05-09 06:46:50-04:00,19893,8J4BZXZzkK4SmWxc2YoaJRg9ivuuXbdVe5XpEhVds1ZM,3pirVwiye9NftvMpX5F7WpfcGZy5uV3c11xCdkkZbL9D,True,471510050,117877512,322185,161092,161093,DA18qE9qesbBqpwNv1M4befYcNQkbSBSeLPTmQzrmbJw,12887405,83760903,-70873498,273
2022-05-09 06:46:50-04:00,19894,CvR57tmtnHbMmPivvJR6VenXivQaWue7z77N81WPpzfv,B4ASc8cUjrzuchv2SHwPrnjKvZgZpwvcLArsdYmMAqBQ,True,151433136,37858284,112976,56488,56488,C4UnXuShCvjSMgBAgVNMy1oakxCNk1et27A82fywU112,4519077,44523532,-40004455,298
2022-05-09 06:46:55-04:00,19895,GdUWbwTgHF1RRbpVXCahz36G7MqYrM6QaBgnjL2eLKxk,JDYxQpYMt38mmjzLrVjgi3ezpc3DQ8YJEtJTZbG6fCCq,True,40360018,3956761,15657,7828,7829,8sEswn3kzEhnYjAZVvCQnHEUvYd7pFVvc2Xc2Kd1BpbC,1597131,13534090,-11936959,395
2022-05-09 06:46:55-04:00,19896,8uoS53t92hUWWx6mZHGhpKs3dkYJYyiRufnp4H1anBJH,E1Nc6fTaZ7EFFJqVDnEfV3odtasBRhEzbtg4JDFDzJ3k,True,93089353,23272338,145128,72564,72564,C4UnXuShCvjSMgBAgVNMy1oakxCNk1et27A82fywU112,5805125,77699412,-71894287,623
2022-05-09 06:47:04-04:00,19897,Bzp3ZUxzRWqW4QoLq9PtKN1HQeSaKXFQrX1G3a4ocrre,H12B3p4v1ZtZ9gaSgpxCJsKXmmEjiqaRZQzexjzAhevo,True,1125730633,79519317,354364,177182,177182,68sueyVfmy5ToEGtLFGDkwebX47xAmzyXE29z8JrmcWv,50166373,705375968,-655209595,445
2022-05-09 06:47:06-04:00,19898,HV3BVN9zLURqQBJyUFFeytFvjhhoYYJ3VXTCDYpML7Fd,ZCesJgyYoyWb3wfUP6BusxEBtVAYb2AAe94QbxVkFsb,True,47589853,11897463,30708,15354,15354,C4UnXuShCvjSMgBAgVNMy1oakxCNk1et27A82fywU112,1228323,11216618,-9988295,258
2022-05-09 06:47:07-04:00,19899,DBT4GeddD8Ve8v7kerU1xrdJyy5moqUedcjYgM2jWESV,FVdbkwTpM3U6E4qQ9E2T9rTJ4dFYdkixsibnEiZqNUsA,True,514161765,128540441,368069,184034,184035,DA18qE9qesbBqpwNv1M4befYcNQkbSBSeLPTmQzrmbJw,14722770,151050869,-136328099,286
2022-05-09 06:47:08-04:00,19900,42h4NteqFpLjgjMS4gTTFoLvrEMpEP4sbGRd7SM5YCZR,AasJCLP5qsGzxkQs5jWysSarwoJTuZ6ZDeabNJNimWAX,True,1829160693,457290173,1338984,669492,669492,CGtKBgcWZ6HKE3tFNLPUM9khDv2Rc7d6BrPtxz7J1aY,53559385,200061508,-146502123,292
2022-05-09 06:47:10-04:00,19901,7YCSi1xGHn5j65W5cZPkQ9RQzvpNgCGdrafAGGTLYkjE,BdVVPyQgd93sMf1SDCFFMvyugNsbdkrVNgaQCJEGjTLC,False,24322079,24322079,952543,47627,904916,2a35JJeTUW1pm6M3e8DHCjp8qr4vbc2cRPhuzZWyFzYd,952545,9396182,-8443637,391
2022-05-09 06:47:15-04:00,19902,6pUtYz474QrpATEZnfb3iFbTKYA65pNyKAo4TQZAjtqe,8dipRUXvxJiDLdHEtCPkso4vErbVwshHQiRfvSngBS9J,True,317764073,39163319,127346,63673,63673,8sEswn3kzEhnYjAZVvCQnHEUvYd7pFVvc2Xc2Kd1BpbC,10332722,205174267,-194841545,325
2022-05-09 06:47:17-04:00,19903,m7gf1jAYXBZjRZEY9w4MjPfhzLwgDKaXyaCVhRD6C5E,Aa2aTZnpPux1i5K2MT4i1TsVM8vR7qR7rZGijQW4zpwd,True,603120681,125493760,437448,218724,218724,AmTrMPzuTp2BjnjqGNKqz9FTTCdpoKcPAJLwFc8ozcbh,21023709,257723318,-236699609,348
2022-05-09 06:47:18-04:00,19904,Frobc1KZTVcsyfwyKwSpHJobxmiJBomzHhGCLdrzdAz8,HziyKP9uxWCuXddtbRzWMczHNdgyQB5UXQZj4MnMm14,False,225301,225301,5798,289,5509,47z82br5WdW2DZajdnPDPSSRRKsyAggqXqK6oPUwTaLf,5799,163492,-157693,257
2022-05-09 06:47:18-04:00,19905,AtaNpuHGEDd7kfakJbTbpphMdQk7ZWk9iB585TtNATKx,72egdmxZyhyYsM93hTMuoDd6NeYVB7gpiJG4PWj4Qi8f,True,33141616,1544156,6104,3052,3052,47z82br5WdW2DZajdnPDPSSRRKsyAggqXqK6oPUwTaLf,1310140,11235415,-9925275,395
2022-05-09 06:47:21-04:00,19906,E4VzeJLsf5Y6t3yNi8VpS8QxhJbJGPhnkNBmU2XoCBs9,63CXyYfevXtrL1QcfQtAhz29xeea5BwWcj6d6BWb4qiB,True,995568405,248892101,726272,363136,363136,CGtKBgcWZ6HKE3tFNLPUM9khDv2Rc7d6BrPtxz7J1aY,29050905,469907091,-440856186,291
2022-05-09 06:47:21-04:00,19907,FRbeFwhUYCiHW5oP26mad8KND7CCYDbfnoNxX7GuXVp8,GrzXKxPX2WDka8i2D8sunMUsrsThKasQi8NYLwuCGygV,True,139098747,23864396,94881,47440,47441,72FwbpFGoLEazJEdpqNtPNefsadUrimUqma9wSoy4qiS,5530369,65689004,-60158635,397
2022-05-09 06:47:24-04:00,19908,7w76zJFb9nTPDbfC4DCscQ2F5vimT8hiivT8WkuwWYWX,5X5XNdoFZv15bmbv97VRxHgTZzKyiFZpoz7MRNkPZS6f,True,35403186,1537330,5895,2947,2948,8sEswn3kzEhnYjAZVvCQnHEUvYd7pFVvc2Xc2Kd1BpbC,1357635,11892096,-10534461,383
2022-05-09 06:47:24-04:00,19909,fAJK1wrBhSW297AtFWX2U4rUBf2gkzfQ6UrQL9yHEYW,5pyTFpanSyUCHxeMhJMKtpdrcMSAWc8bFadbyM7q4q4B,True,214867537,53716884,147041,73520,73521,68sueyVfmy5ToEGtLFGDkwebX47xAmzyXE29z8JrmcWv,5881643,21619203,-15737560,273
2022-05-09 06:47:26-04:00,19910,HHNj1MooHaJCm7SYAjdKSnk2sa7yUFH2PrQYWiN9E6uy,H6hKDBEsDh76s9H9FVBn1ZDTR27JEZTHUM7zwoWw26bc,True,2336222065,413023441,1748464,874232,874232,gjBMZYVujDjD1ECG4i97M8Q3gV9ESnwwTSUGropkusj,98900000,144054161,-45154161,423
2022-05-09 06:47:26-04:00,19911,Cv5oVktxmqbU1SxraxH67NEWMKnjgA18R832Fhe9h74a,Cs7xBD4BDiohyopnaYDDChUtR9vmx7uwot6Qp9beQLzt,False,5027239,5027239,149711,7485,142226,68sueyVfmy5ToEGtLFGDkwebX47xAmzyXE29z8JrmcWv,149712,2012385,-1862673,297
2022-05-09 06:47:27-04:00,19912,H8P77smmiLj1vtt7hoSjf2vmcnBdW4rsgCtagtXZg6yy,3FxygrzNpSWivjLU3CumYif6rXhSzyjLqdKiyvphDnnc,True,54749019,2638341,10968,5484,5484,3zqXX6kzhkbW3d4TwD2CNjMRwxTbREXySekvq37kfCNk,2276225,17100188,-14823963,415
2022-05-09 06:47:27-04:00,19913,EHi1UBG8wMUFZECktsFUZkGjJPaBNEedswS62hyYn6jC,Drx9ErQhAjnPuJ83LPYFnY5ZV5XDzGuXDuSf16VqWayp,True,457381774,51227373,186469,93234,93235,3zqXX6kzhkbW3d4TwD2CNjMRwxTbREXySekvq37kfCNk,16648847,313147547,-296498700,364
2022-05-09 06:47:27-04:00,19914,7A1A93jqxV65F7XwvBarhgfTm3iFh3s75jFNzVCtFnez,8Z6QWdy4zGUzuMdKhkdxzq7RaLHhJmrpYEKeqsw8bopx,False,30159051,30159051,878467,43923,834544,C4UnXuShCvjSMgBAgVNMy1oakxCNk1et27A82fywU112,878467,7765883,-6887416,291
2022-05-09 06:47:28-04:00,19915,HXQXfEQe7aCpr6WKh37XaDZsjZcuQPk5t8tWNFgEoK6U,5ufXkCEDwgiXwtyPye4wYVVA3oLW54JVzz4tnXFofto4,True,458526770,114631692,343839,171919,171920,C4UnXuShCvjSMgBAgVNMy1oakxCNk1et27A82fywU112,13753581,213628220,-199874639,299
2022-05-09 06:47:39-04:00,19916,BTXpvCdmYEmg5fB2Hsjc6Wked2sky4oQpGu7r8KuPau4,CaEwxQQds9f44npaSrYAsC6WpE3T6MpAGr9jgXZeqWjA,True,66044971,4081642,18354,9177,9177,3zqXX6kzhkbW3d4TwD2CNjMRwxTbREXySekvq37kfCNk,2969948,20988392,-18018444,449
2022-05-09 06:47:42-04:00,19917,Apqv5iu4bJ6pVg2NxjfwuvnfxDK6navHhhU1CVJEHeMa,7pDPJrxndRsLq983bEwvd3MKYnnqyQzQNMhEaC5NZYN1,False,30180061,30180061,887925,44396,843529,72FwbpFGoLEazJEdpqNtPNefsadUrimUqma9wSoy4qiS,887925,7759154,-6871229,294
2022-05-09 06:47:59-04:00,19918,68gVM4kjmSYxT1uJW13rYSway8uVLUdcLa7sJuqHQaAf,DshroBQ3da7BcAiQpiFREsLKWbUDrBRmmZRw3Zu2Qfs9,True,91926270,22981567,59819,29909,29910,C5o4TfkUfECutAWsDELjhsZX6PYyYgK3XeKvx6p4FphM,2392767,26091788,-23699021,260
2022-05-09 06:48:00-04:00,19919,5NVJU6YoZuuEjGNUUUJcGwS2Qd8b8CH7QSgMV7UWL5E7,8ZUq3o1nSkEvSfmiTz4anUpSMECCnX38MRwV7E5AGYSt,False,31185582,31185582,935388,46769,888619,C5o4TfkUfECutAWsDELjhsZX6PYyYgK3XeKvx6p4FphM,935388,8010602,-7075214,299
2022-05-09 06:48:01-04:00,19920,DvSVpLMQyz91ksMwhuwwFDiKMo53FC5FVG5XrQZYWurJ,5jL2cYHg1QQpWYRCF4f378jpeHnTfPMWXiiHuhLNbzq8,True,36291561,1542386,6328,3164,3164,6L1WYrPiCMyi7XemPww4B4hvpKD1LQKD4RpiSKmrmgSC,1488963,12491127,-11002164,410
2022-05-09 06:48:06-04:00,19921,AXbnJEF6Xottm9wMck8NTq6ZhgM54Fb9V3Zsc2LNTQkN,49Pg4iQXwjTucVDHFuCsEXWin4NLPAMCmVkiU6biMLd7,False,2088166,2088166,62477,3123,59354,3zqXX6kzhkbW3d4TwD2CNjMRwxTbREXySekvq37kfCNk,62477,688811,-626334,299
2022-05-09 06:48:20-04:00,19922,EyNCsqWu8zLyuRnXSbzJWnWZg7ZLjb4oJSZFdDSkbXmT,6rMMMkZibUHXYs8hXY3FmG4rgBx6gWDRGJwR2bP2t6ZD,True,48729365555,11284422548,36549139,18274569,18274570,GXyFXZMNk2NFyEzw6JetVqsujqcz2yCixH7n8EpDJYWD,1578296471,9026810987,-7448514516,323
2022-05-09 06:48:20-04:00,19923,7zuFEyLQFHkAjm3mAuxN42VenwF6fZcqM81mmR8sBnmY,CSnQxjc4Jn8iP4JSxj5wsrvxGsLoAYQn1bKC8naY7YZP,True,8047467668,2011866917,5870959,2935479,2935480,A9TwRM1BMxqb8DCC7YNAMV6zPenEJm3HTZBy7wJKK58U,234838390,634424414,-399586024,291
2022-05-09 06:48:22-04:00,19924,GNohZMtk1VAuhLAgNGT8J3HYCKDCiyjvLeAWr64d7Duy,6soTLVj9DzFht8DzvjRfNPAWhZuiDBS5fDE1fpeuDSSz,True,22098500,5524625,34364,17182,17182,6L1WYrPiCMyi7XemPww4B4hvpKD1LQKD4RpiSKmrmgSC,1374598,15981446,-14606848,622
2022-05-09 06:48:23-04:00,19925,CpeJ8BVz8Nd6SqnM3DYejnvAYnovDwu1taCqMEBD4RRi,GMmBgzDTtes62wJTENptaWPxNY2srWCrAdWErkj22Hzj,True,31736851,3024980,12237,6118,6119,8sEswn3kzEhnYjAZVvCQnHEUvYd7pFVvc2Xc2Kd1BpbC,1283984,10562811,-9278827,404
2022-05-09 06:48:31-04:00,19926,9eWpSyu71Z6dmx7yTh7WrbVScdrrZN14d5tfmqEGFgXt,2r89PFKSD9zmSp2Wyx4CQ75HAtmUgwhAS2oG5MuYuiV6,True,369586942,31768139,128770,64385,64385,47z82br5WdW2DZajdnPDPSSRRKsyAggqXqK6oPUwTaLf,14980978,177103775,-162122797,405
2022-05-09 06:48:52-04:00,19927,6wGzqSWYjB1nukhDwLdgXDzMNSeasuRur3FVZAkVF4pM,HTcJjvQNFJQEewRf8iCcsZgFcfHoUXzpbb7WscqdK4kS,True,79828049,19957012,123891,61945,61946,3zqXX6kzhkbW3d4TwD2CNjMRwxTbREXySekvq37kfCNk,4955669,21709086,-16753417,620
2022-05-09 06:48:56-04:00,19928,7rq3F5ZQXc991M4SCSqvhYKL2SsPT1DKjBBUoxovYt1e,BwzUY6Tyc5TnBfSajK9WeyjGVqVj6Lup73vd88dSc1vh,False,1262475,1262475,77426,3871,73555,6L1WYrPiCMyi7XemPww4B4hvpKD1LQKD4RpiSKmrmgSC,77426,827547,-750121,613
2022-05-09 06:48:58-04:00,19929,GcwFXxcxRF2xwbgFbQZoYEDreimd3J3UJ9sPfuwYVKtS,7uXjmKS8RxP2qSS7ataBH5hkfpgsFcpSBWUEBuV5zgyZ,True,125779107,31444776,93267,46633,46634,47z82br5WdW2DZajdnPDPSSRRKsyAggqXqK6oPUwTaLf,3730689,35913061,-32182372,296
2022-05-09 06:49:05-04:00,19930,Bu65ba81oA2rZqxGAsctgz39NPPJqbXR3SvdMX5KQfTK,DcxNLDe2GwGiQPtQhzMiUjrMaqXjuyx1EGgX3xPtE98T,True,53044410,13261102,40038,20019,20019,C5o4TfkUfECutAWsDELjhsZX6PYyYgK3XeKvx6p4FphM,1601556,15292732,-13691176,301
2022-05-09 06:50:06-04:00,19931,25NUDrsdLhS3fcARLiTMbbmZHvvzvzPj9xAdoN8sJBN3,8baNRGHfYRcLdhbHNuH72ofAWM9UojqhTMLnbBayzGnW,False,246076,246076,15297,764,14533,C5o4TfkUfECutAWsDELjhsZX6PYyYgK3XeKvx6p4FphM,15297,173481,-158184,621
2022-05-09 06:50:24-04:00,19932,243SAnGxchCVB1LQAUF4SsozR86yDwEdg2QQpbWGsMYe,5u8sNkb2oEQjUXJAB3yGStmv3Uwz16gBgExBo5myVK4b,False,81960,81960,5017,250,4767,5HnvdJnCCcmRsm4GkXnYWd4q9RpwuvYDGEUMPkYR3Ts9,5017,56886,-51869,612
2022-05-09 06:55:02-04:00,19933,cXqFkCF4gaT9vAcZYMgwLXmmuD5w4hwgxT8YXE8JuBw,5Wtf4ZBL6R1afLeC4WfhFGkfi42TagtNAg6EZWn7gKhg,True,78428050,19607012,59283,29641,29642,8sEswn3kzEhnYjAZVvCQnHEUvYd7pFVvc2Xc2Kd1BpbC,2371327,24050258,-21678931,302
2022-05-09 06:55:13-04:00,19934,BgNgALwBEuiumVgiXRmBZRnyFrr9QTDy2maHzsNwNHGf,ag35Ec2uFtqkarizCxFyhM2SPBuUwfmLRhAdFEWFCNa,False,160551,160551,9944,497,9447,2a35JJeTUW1pm6M3e8DHCjp8qr4vbc2cRPhuzZWyFzYd,9944,102979,-93035,619
2022-05-09 06:55:44-04:00,19935,DMACzuFBuj2vGqxZ3FV7QAo24jMV3EHKL8MrDrGbRkaJ,EnLfmDVW4ba2uqZKhj3X1TFnx8AHv7xwSWrMbVBYwcu9,True,36293664,9073416,27431,13715,13716,2a35JJeTUW1pm6M3e8DHCjp8qr4vbc2cRPhuzZWyFzYd,1097266,6173073,-5075807,302
2022-05-09 06:56:22-04:00,19936,djW9rVm1v4nW64QiVqgFUCRza24VqthDcSfVEyRHPed,EsXvQmXVXECqZPtmSdiuwieHPP5jsmyn67p78vHaJcqq,True,112388607,28097151,85122,42561,42561,8sEswn3kzEhnYjAZVvCQnHEUvYd7pFVvc2Xc2Kd1BpbC,3404887,15188866,-11783979,302
2022-05-09 06:56:32-04:00,19937,A415rwvXESPhU3yhq4TaPNA6PPVuiaACMHohRduoEp3R,GX9LnZmX6Lycn91ebcFUYgaTD9RQutdmwvKYzpfTXGZx,False,11226054,11226054,335277,16763,318514,Hu94aiQWvce6THeGyCFqGRPM1pQrK3ihzkcXo1EpJcJL,335277,5667550,-5332273,298
2022-05-09 06:56:33-04:00,19938,GtDk7DkAB2jvQynR57z8mjg6UoaTqYDr8Z4wsFX6KGSr,tAPvp4fscJZySZUVG2GZWZwSRVhfnNvkjCC6ZvmxqDQ,True,157356749,39339187,118520,59260,59260,8sEswn3kzEhnYjAZVvCQnHEUvYd7pFVvc2Xc2Kd1BpbC,4740818,26084106,-21343288,301
2022-05-09 06:56:33-04:00,19939,agiVhhsNiMPzMaNWTHKRZ435HtBjqQvRuReKkpG32pn,HgcU2oCotYPxvGY6M21SbdqhzXJmNPDWEiTCDu4rA5dB,True,41871954,10467988,31330,15665,15665,2a35JJeTUW1pm6M3e8DHCjp8qr4vbc2cRPhuzZWyFzYd,1253217,15691499,-14438282,299
2022-05-09 06:57:26-04:00,19940,5rnSL1jkLDsAvWsKNrbxtBJEcavHbc41kSTWywUEmSaX,87ZzyZEPJAXq6UiTqQVNuChRQVSb7QcUJgV41saA8CFC,True,36002086,1585679,6463,3231,3232,Hu94aiQWvce6THeGyCFqGRPM1pQrK3ihzkcXo1EpJcJL,1467627,12345542,-10877915,407
2022-05-09 06:57:27-04:00,19941,iEXYXt9JNg6tud7wsHcTe349MNWHBgAoRptNpasAGwb,DNCFSLLWNWEVfsqht6EuiQ7PwCdzhHjDk9i4UpgnDTxB,True,338402644,64094126,202679,101339,101340,68sueyVfmy5ToEGtLFGDkwebX47xAmzyXE29z8JrmcWv,10701015,40917447,-30216432,316
2022-05-09 06:57:27-04:00,19942,EEQmHFk3WFNmPfe7ujtP1PK6P5yqV5mmWumNSoTu45P8,FG9DScQDQPrgcmBbRugZ5NfhSTRMnKSWLxcUeTF9MgJZ,True,279209596,69802399,205798,102899,102899,5HnvdJnCCcmRsm4GkXnYWd4q9RpwuvYDGEUMPkYR3Ts9,8231935,46524097,-38292162,294
2022-05-09 06:57:29-04:00,19943,7w76zJFb9nTPDbfC4DCscQ2F5vimT8hiivT8WkuwWYWX,5X5XNdoFZv15bmbv97VRxHgTZzKyiFZpoz7MRNkPZS6f,True,33835541,3098706,12101,6050,6051,2a35JJeTUW1pm6M3e8DHCjp8qr4vbc2cRPhuzZWyFzYd,1321425,11208686,-9887261,390
2022-05-09 06:57:32-04:00,19944,7PzGZgzieFyyFs1dbajkNQgVxooFUNZrj1bUsQvrSwbp,A2gDREmSmJTBPPw3sbKVY3smC9wbHMDdv87gr4Tr2ES7,True,250918511,62729627,188736,94368,94368,3zqXX6kzhkbW3d4TwD2CNjMRwxTbREXySekvq37kfCNk,7549476,35942974,-28393498,300
2022-05-09 06:57:33-04:00,19945,7tFD53kPTqrzjCu1Wji78gUqhoRtCUhsP1pM3DQKT7uG,BJvgPLYBDJrQJdQVowrsMwUGMurq4zTihoFwWoEokfu3,True,119149396,15125026,45622,22811,22811,Hu94aiQWvce6THeGyCFqGRPM1pQrK3ihzkcXo1EpJcJL,3594039,33568917,-29974878,301
2022-05-09 06:57:43-04:00,19946,3CTLVMSTYE6azjXhZyhPD5XiUe23aJ4pb456SQnUiohH,13q8wAZ1zte3bd3LdeKLEUY7ubu2suCNRZVrgMScpV3C,True,31764865,3019225,12316,6158,6158,8sEswn3kzEhnYjAZVvCQnHEUvYd7pFVvc2Xc2Kd1BpbC,1295765,10547420,-9251655,407
2022-05-09 06:57:45-04:00,19947,AtaNpuHGEDd7kfakJbTbpphMdQk7ZWk9iB585TtNATKx,72egdmxZyhyYsM93hTMuoDd6NeYVB7gpiJG4PWj4Qi8f,True,31548654,3111085,12377,6188,6189,68sueyVfmy5ToEGtLFGDkwebX47xAmzyXE29z8JrmcWv,1255230,10558620,-9303390,397
2022-05-09 06:57:52-04:00,19948,4gVzwxCsAebj7mjp48mP9QXo99xAVFN3629fPMPbCHpj,AVFph8w5CWcTJExejj4XB7TqsMBWPramC3CS6im2HQrg,False,2064848,2064848,60834,3041,57793,5HnvdJnCCcmRsm4GkXnYWd4q9RpwuvYDGEUMPkYR3Ts9,60834,690586,-629752,294
2022-05-09 06:57:54-04:00,19949,GdUWbwTgHF1RRbpVXCahz36G7MqYrM6QaBgnjL2eLKxk,JDYxQpYMt38mmjzLrVjgi3ezpc3DQ8YJEtJTZbG6fCCq,True,36295887,1555898,6318,3159,3159,2a35JJeTUW1pm6M3e8DHCjp8qr4vbc2cRPhuzZWyFzYd,1474104,12475196,-11001092,406
2022-05-09 06:58:00-04:00,19950,62q4KpVd3UXPomDaqpTF7recRAEh2ZKgWRgT92ztmda4,8xRdV8nWLb3CiCcHt2ZXEJv3NSfaa178zarhUkKv2rP9,True,49506027,4447611,17515,8757,8758,3zqXX6kzhkbW3d4TwD2CNjMRwxTbREXySekvq37kfCNk,1949608,15115574,-13165966,393
2022-05-09 06:58:01-04:00,19951,8T4WK27RvWVGqPuNqY6whk1fmU4vd5qaUQPZG1GJ79bh,DvSz7knS8N3K7L6JhQf1s4mJSyxB8uJXNQXtyjJn8QRL,True,256620543,62705914,191045,95522,95523,8sEswn3kzEhnYjAZVvCQnHEUvYd7pFVvc2Xc2Kd1BpbC,7818456,40963039,-33144583,304
2022-05-09 06:58:09-04:00,19952,F2AU2PjaSmHxWWhkz8XxMggkCMWbMVgawt89tSnYS6RL,ET9febRJiW197DYMaJbgk3kWsAeFv5f4peQ4vFCVppK6,True,1250281759,312570439,1929962,964981,964981,8sEswn3kzEhnYjAZVvCQnHEUvYd7pFVvc2Xc2Kd1BpbC,77198490,132393621,-55195131,617
2022-05-09 06:58:26-04:00,19953,QRNE94J8jKk3gvaSpXcHBvQARihaaomxa44Z8X1zvhh,J4e3wsNJHnifiCj8TbA2BxcCYwfa1aHks7T8nk6tKdhG,False,7500678,7500678,224300,11215,213085,C4UnXuShCvjSMgBAgVNMy1oakxCNk1et27A82fywU112,224300,2718522,-2494222,299
2022-05-09 06:58:26-04:00,19954,4YPn7VhWcrtecLaCBiVmXdmHwNmfR8qf2kzEtivmWrmK,EoEKgrmC6Xx6Ln8fWttD7wEtAkZtUbNifmv2mSHqV1Mf,True,47498951,11874737,35890,17945,17945,C4UnXuShCvjSMgBAgVNMy1oakxCNk1et27A82fywU112,1435607,7659440,-6223833,302
2022-05-09 06:58:26-04:00,19955,9eWpSyu71Z6dmx7yTh7WrbVScdrrZN14d5tfmqEGFgXt,2r89PFKSD9zmSp2Wyx4CQ75HAtmUgwhAS2oG5MuYuiV6,True,336149619,60286750,236430,118215,118215,C4UnXuShCvjSMgBAgVNMy1oakxCNk1et27A82fywU112,13183024,142783411,-129600387,392
2022-05-09 06:58:29-04:00,19956,HDJrLBSkMZ34BjJKrxYvSjhMP1z3dvZeuCAEqHFHqSn7,DXYU9k5x6T9wDCJyPn9KLLSpBgw4FFxe8zg9YsCmfLvp,True,166859537,41714884,125428,62714,62714,2a35JJeTUW1pm6M3e8DHCjp8qr4vbc2cRPhuzZWyFzYd,5017145,40074367,-35057222,300
2022-05-09 06:58:29-04:00,19957,AL8JFS4gjaQx89f9j8wtaNJgV76K8bw1ugvNtgvhgAnb,HJYvG2kGKe8kXgtZSWTWwTmSjxA3XUeCvyT7acoKtS1C,True,16149858881,4037464720,12151191,6075595,6075596,GXyFXZMNk2NFyEzw6JetVqsujqcz2yCixH7n8EpDJYWD,486047669,4396473958,-3910426289,300
2022-05-09 06:58:31-04:00,19958,3AaMzK9WAbD9m27szcJYnucnSPQ4W7tk8EztgWv4vqUo,8oUBQUKo9wHLu1tUEF1AeCUa7oRYyDSoFNRMqQAqKMbH,True,51993519,2283994,9304,4652,4652,3zqXX6kzhkbW3d4TwD2CNjMRwxTbREXySekvq37kfCNk,2118198,15753745,-13635547,407
2022-05-09 06:58:33-04:00,19959,6pUtYz474QrpATEZnfb3iFbTKYA65pNyKAo4TQZAjtqe,8dipRUXvxJiDLdHEtCPkso4vErbVwshHQiRfvSngBS9J,True,277858106,21175218,72114,36057,36057,C4UnXuShCvjSMgBAgVNMy1oakxCNk1et27A82fywU112,9462728,183803393,-174340665,340
2022-05-09 06:58:34-04:00,19960,5euvq1j9LCJWT1K7xKAE2TjwzbrWA5t6j2SxtnWsEPeU,GKDnouGNzg5JkjWG7Qs4nmka6qUMdYrk1fKwrmj8TvdH,True,51939105,2283982,9259,4629,4630,2a35JJeTUW1pm6M3e8DHCjp8qr4vbc2cRPhuzZWyFzYd,2105604,15791580,-13685976,405
2022-05-09 06:58:34-04:00,19961,8J4BZXZzkK4SmWxc2YoaJRg9ivuuXbdVe5XpEhVds1ZM,3pirVwiye9NftvMpX5F7WpfcGZy5uV3c11xCdkkZbL9D,True,351693813,87923453,265662,132831,132831,2py1FiYeL2f7J3HU36qiJz6TD6HCmiTN36RyxYtapQCZ,10626495,65729188,-55102693,302
2022-05-09 06:58:34-04:00,19962,DvSVpLMQyz91ksMwhuwwFDiKMo53FC5FVG5XrQZYWurJ,5jL2cYHg1QQpWYRCF4f378jpeHnTfPMWXiiHuhLNbzq8,True,34652932,1546805,6188,3094,3094,C4UnXuShCvjSMgBAgVNMy1oakxCNk1et27A82fywU112,1386392,11916968,-10530576,400
2022-05-09 06:58:35-04:00,19963,EkKmfEnxTscSs2BDs1mg6SyHdStC8AYTy9zihw9VWP63,DW4ujEZj4H83B9CrSfbks2pkHEj3gh2d114eo1aDh4s9,True,34713305,8678326,25549,12774,12775,Hu94aiQWvce6THeGyCFqGRPM1pQrK3ihzkcXo1EpJcJL,1021990,11808431,-10786441,294
2022-05-09 06:58:38-04:00,19964,BJUNK2orMVx6mYsD9pnQzmsEh95ZF2NWPm9KJ1ZM67Qn,FpxLa3DwWrspYvHVsScSDcscHB2eBHGxRrQ4gVvn4VW,True,66384476,16596119,48305,24152,24153,5HnvdJnCCcmRsm4GkXnYWd4q9RpwuvYDGEUMPkYR3Ts9,1932206,22532856,-20600650,291
2022-05-09 07:03:57-04:00,19965,H7rsFRRhZPe2jLex2NkbYYzVtLobvFiqnCd4BUyJVPBB,8bedwDRfSKLP9vUxoXcpHNJzWQemMaf4QGT2mtHFVJFb,True,48669778,12167444,36863,18431,18432,Hu94aiQWvce6THeGyCFqGRPM1pQrK3ihzkcXo1EpJcJL,1474551,5159273,-3684722,302
2022-05-09 07:08:48-04:00,19966,AXBfrbCpYAWKN5jgDVVMiKXscQ96YtotKV3DT6XSzm9o,Dh3SiHAqrQzPQnTLRMxtBn2EFyHNgyfnYGpgcuNGTvyL,True,39937690,9984422,60926,30463,30463,6L1WYrPiCMyi7XemPww4B4hvpKD1LQKD4RpiSKmrmgSC,2437058,22913609,-20476551,610
2022-05-09 07:10:28-04:00,19967,3zVmiyif8VbqUW7dAeEMYJYrg8r5pCeBfALsdgu6kgFJ,FwzrxNbJsiCQwqayaDhwkbm9TRG11bK6fWs5Dn75da9a,True,39884447,9971111,30160,15080,15080,68sueyVfmy5ToEGtLFGDkwebX47xAmzyXE29z8JrmcWv,1206413,18441294,-17234881,302
2022-05-09 07:15:13-04:00,19968,xj242sRBwTMF1Df9grLWe4iXm6Yw1my5iBa2byzjgzk,BMZz3sBcTxtzUwasePcpzeCS1TANz9mqdL1ufhnW7vob,True,2288027428,572006857,1713477,856738,856739,3zqXX6kzhkbW3d4TwD2CNjMRwxTbREXySekvq37kfCNk,68539092,510496254,-441957162,299
2022-05-09 07:15:24-04:00,19969,BEuVsj9KuYBTaxrLpKwrQtHxmhRtB16siNfPXsAvf6rz,BTjWitiLbteuKMzaFj1daYyM2v9rZygESDktu8cuzC8g,False,28112705,28112705,850954,42547,808407,8sEswn3kzEhnYjAZVvCQnHEUvYd7pFVvc2Xc2Kd1BpbC,850954,4305196,-3454242,302
2022-05-09 07:22:09-04:00,19970,HT2SuCbePhjNZaar24uVwihYowCNvSjdvhJ8BRSVw9nX,98Ts4LCnapHVoCJ5PW3Armvh4jvDtpfs3SYRLRxiAgzZ,True,27830458,1658449,7818,3909,3909,5HnvdJnCCcmRsm4GkXnYWd4q9RpwuvYDGEUMPkYR3Ts9,1312082,15430258,-14118176,471
2022-05-09 07:22:30-04:00,19971,7w76zJFb9nTPDbfC4DCscQ2F5vimT8hiivT8WkuwWYWX,5X5XNdoFZv15bmbv97VRxHgTZzKyiFZpoz7MRNkPZS6f,True,30653986,3033301,12113,6056,6057,2a35JJeTUW1pm6M3e8DHCjp8qr4vbc2cRPhuzZWyFzYd,1224218,10355530,-9131312,399
2022-05-09 07:22:32-04:00,19972,5rnSL1jkLDsAvWsKNrbxtBJEcavHbc41kSTWywUEmSaX,87ZzyZEPJAXq6UiTqQVNuChRQVSb7QcUJgV41saA8CFC,True,34326266,3006083,11986,5993,5993,68sueyVfmy5ToEGtLFGDkwebX47xAmzyXE29z8JrmcWv,1368786,11811907,-10443121,398
2022-05-09 07:22:39-04:00,19973,D8BtQirMEk3W9Pq29B6KkKWrwPfmsUNpwz5npx7aGMLY,J7LMZwaSoh5hbGcwee6oPsnN4ZFD7Zp3LQWkJGNUHRfJ,True,14127645,3531911,25173,12586,12587,5HnvdJnCCcmRsm4GkXnYWd4q9RpwuvYDGEUMPkYR3Ts9,1006941,9398056,-8391115,712
2022-05-09 07:22:41-04:00,19974,AtaNpuHGEDd7kfakJbTbpphMdQk7ZWk9iB585TtNATKx,72egdmxZyhyYsM93hTMuoDd6NeYVB7gpiJG4PWj4Qi8f,True,28339529,1211694,4885,2442,2443,68sueyVfmy5ToEGtLFGDkwebX47xAmzyXE29z8JrmcWv,1142622,9717545,-8574923,403
2022-05-09 07:22:41-04:00,19975,68gVM4kjmSYxT1uJW13rYSway8uVLUdcLa7sJuqHQaAf,DshroBQ3da7BcAiQpiFREsLKWbUDrBRmmZRw3Zu2Qfs9,True,68621552,17155388,50156,25078,25078,8sEswn3kzEhnYjAZVvCQnHEUvYd7pFVvc2Xc2Kd1BpbC,2006247,20104033,-18097786,292
2022-05-09 07:22:42-04:00,19976,H8P77smmiLj1vtt7hoSjf2vmcnBdW4rsgCtagtXZg6yy,3FxygrzNpSWivjLU3CumYif6rXhSzyjLqdKiyvphDnnc,True,51964050,2284552,9297,4648,4649,2a35JJeTUW1pm6M3e8DHCjp8qr4vbc2cRPhuzZWyFzYd,2114775,15786205,-13671430,406
2022-05-09 07:22:42-04:00,19977,GdUWbwTgHF1RRbpVXCahz36G7MqYrM6QaBgnjL2eLKxk,JDYxQpYMt38mmjzLrVjgi3ezpc3DQ8YJEtJTZbG6fCCq,True,34651705,1535683,6101,3050,3051,68sueyVfmy5ToEGtLFGDkwebX47xAmzyXE29z8JrmcWv,1376800,11807229,-10430429,397
2022-05-09 07:22:42-04:00,19978,BTXpvCdmYEmg5fB2Hsjc6Wked2sky4oQpGu7r8KuPau4,CaEwxQQds9f44npaSrYAsC6WpE3T6MpAGr9jgXZeqWjA,True,61701183,3502572,15236,7618,7618,3zqXX6kzhkbW3d4TwD2CNjMRwxTbREXySekvq37kfCNk,2684152,19796383,-17112231,435
2022-05-09 07:22:50-04:00,19979,HV3BVN9zLURqQBJyUFFeytFvjhhoYYJ3VXTCDYpML7Fd,ZCesJgyYoyWb3wfUP6BusxEBtVAYb2AAe94QbxVkFsb,True,35555599,8888899,26474,13237,13237,8sEswn3kzEhnYjAZVvCQnHEUvYd7pFVvc2Xc2Kd1BpbC,1058985,8687093,-7628108,297
2022-05-09 07:22:52-04:00,19980,3CTLVMSTYE6azjXhZyhPD5XiUe23aJ4pb456SQnUiohH,13q8wAZ1zte3bd3LdeKLEUY7ubu2suCNRZVrgMScpV3C,True,28668438,1421142,5969,2984,2985,6L1WYrPiCMyi7XemPww4B4hvpKD1LQKD4RpiSKmrmgSC,1204140,9802216,-8598076,420
2022-05-09 07:22:55-04:00,19981,FRbeFwhUYCiHW5oP26mad8KND7CCYDbfnoNxX7GuXVp8,GrzXKxPX2WDka8i2D8sunMUsrsThKasQi8NYLwuCGygV,True,114651132,10826427,45673,22836,22837,5HnvdJnCCcmRsm4GkXnYWd4q9RpwuvYDGEUMPkYR3Ts9,4836823,56069019,-51232196,421
2022-05-09 07:23:38-04:00,19982,8L2s5h1hSU79naWcS7cvT3oxiPL6ofTDWmqTK1S4F99g,32DYf6ArTTcNwokJrbhHT1QGe4pZ9z29oPdw97aDR7AQ,True,167433337,41858334,126616,63308,63308,68sueyVfmy5ToEGtLFGDkwebX47xAmzyXE29z8JrmcWv,5064677,157009381,-151944704,302
2022-05-09 08:07:10-04:00,19983,4oMasDRj8HWfknmdwt6Mkz3eonr8J2byoiSTRo4sCnFQ,3emcATkEFvDVETiK97eVET2Z2jzkgiiSxX3gu5wsUKPe,True,589430719,73064904,488777,244388,244389,2a35JJeTUW1pm6M3e8DHCjp8qr4vbc2cRPhuzZWyFzYd,39430824,332446403,-293015579,668
2022-05-09 08:10:13-04:00,19984,DLwEaZipqHmVBD5hc5v1NZtDStHyG4hAMwxywDTGGc2e,28GtwJw67UWfrSKxtuvpzoKzPyKXLgP3GKLm3fHdR566,True,62773548,15693387,97940,48970,48970,8sEswn3kzEhnYjAZVvCQnHEUvYd7pFVvc2Xc2Kd1BpbC,3917603,30746027,-26828424,624
2022-05-09 08:10:19-04:00,19985,4Siq98BDakELWP5BzVoEN5tcg1ywRxTYs1aUcfW8spCt,2EBXLTVz1Gk9gS5JcVqCKAP5PatFGw1Vnww65Moz3SUn,True,23662772,5915693,36639,18319,18320,2a35JJeTUW1pm6M3e8DHCjp8qr4vbc2cRPhuzZWyFzYd,1465573,13545481,-12079908,619
2022-05-09 08:10:19-04:00,19986,442usWu6XpJZvU25bqXeynRrQ15jAzWwU9DWMgHpTn3Q,CtvADKp39bjJf3cPKWNL3wxnhq273fVM4fC5DmEcg5cC,True,48582168,12145542,74515,37257,37258,8sEswn3kzEhnYjAZVvCQnHEUvYd7pFVvc2Xc2Kd1BpbC,2980637,8230382,-5249745,613
2022-05-09 08:10:19-04:00,19987,Fn6J1eMQJoA5rXCwX2HjAF86AowsJfULLuYXVfzgb8aX,6Ett2WPmz4HoWVSVEZD73UzFetd3oFSh7C676MEVYd36,True,35515956,8878989,55211,27605,27606,6L1WYrPiCMyi7XemPww4B4hvpKD1LQKD4RpiSKmrmgSC,2208445,21249838,-19041393,621
2022-05-09 08:10:41-04:00,19988,CXppCp4b4npkAzw175YNy6Ei8nF7jCmNbqsbVosHS6fE,FSEchHNYxt7WdBYjyuS2Ft2yUnfk56TCkY8SXdSs8hfe,True,37125056,9281264,57975,28987,28988,Hu94aiQWvce6THeGyCFqGRPM1pQrK3ihzkcXo1EpJcJL,2319030,26458741,-24139711,624
2022-05-09 08:11:26-04:00,19989,532MfQR1PzPn6cmC1kpZsz9MyBWSamSeieh1F6GqVY33,6sJ8XXMZzGbHjVU1vWNW8unWoBZhJa54GguYJQhcb8PA,True,1965023575,274559389,1816715,908357,908358,CGtKBgcWZ6HKE3tFNLPUM9khDv2Rc7d6BrPtxz7J1aY,130022448,322974066,-192951618,661
2022-05-09 08:13:00-04:00,19990,CpeJ8BVz8Nd6SqnM3DYejnvAYnovDwu1taCqMEBD4RRi,GMmBgzDTtes62wJTENptaWPxNY2srWCrAdWErkj22Hzj,True,28645975,1393797,5846,2923,2923,2a35JJeTUW1pm6M3e8DHCjp8qr4vbc2cRPhuzZWyFzYd,1201638,9821343,-8619705,419
2022-05-09 08:13:03-04:00,19991,4nqsW3XCJxzSsDdQzvE3zeM9nqBv8xVdUG8GxFWn6Edf,6eVvNs2rckFeTGkXZgPEGLYg4rmz3MFtoVNPRNmktcrY,True,337421605,84355401,601764,300882,300882,C4UnXuShCvjSMgBAgVNMy1oakxCNk1et27A82fywU112,24070576,68019660,-43949084,713
2022-05-09 08:19:28-04:00,19992,26wo1RqwKXrNnfgMdZEmkGhnDbURpZcp2hasB5EA5QtD,34gwTVGRrdoaBzLUG6SBwRwBovkjBjCebqVUBan6GDnB,True,735104591,183776147,1292757,646378,646379,2py1FiYeL2f7J3HU36qiJz6TD6HCmiTN36RyxYtapQCZ,51710287,546532746,-494822459,703
2022-05-09 08:19:49-04:00,19993,8sQzUoiFfBUsfVKdUjUh3xUjwnaCP1Qmw9BGwtH768ZR,8wZxijgcyRwqxiRKMMZhoREAb6iHhRGCgjgZRd5Yp6RP,True,635797893,158949473,1104141,552070,552071,3zqXX6kzhkbW3d4TwD2CNjMRwxTbREXySekvq37kfCNk,44165649,230456051,-186290402,694
2022-05-09 09:20:26-04:00,19994,BAkPsWHtpVcEGqUgKTKjwZ6d5aaUcaUhdgYxBnpSTDW2,BDwDmVaZnXh22sf8nsDtjVfgxMAswbM3PW3si3k4nbRK,True,101247045,25311761,75065,37532,37533,Hu94aiQWvce6THeGyCFqGRPM1pQrK3ihzkcXo1EpJcJL,3002611,44827040,-41824429,296
2022-05-09 09:20:26-04:00,19995,Fczxdc24Eav8xcaKRDwWMEwPEzkGyEJ7qGcXYyGZFKVz,8GqweYpec4cnpaJvueF3FGWoaz72BAzpLYXBX7tuuqEt,True,36145712,9036428,26812,13406,13406,2a35JJeTUW1pm6M3e8DHCjp8qr4vbc2cRPhuzZWyFzYd,1072517,27241574,-26169057,296
2022-05-09 09:20:27-04:00,19996,F47ihi3LtNYspD1tkQhind1ce8udZ628Ye1NuDBd3Me1,HqzXiTisYpcPHCAMvceUL8WSrzEX38TuGkzPaGJSdAHm,True,38536258,9634064,28398,14199,14199,2a35JJeTUW1pm6M3e8DHCjp8qr4vbc2cRPhuzZWyFzYd,1135959,10061777,-8925818,294
2022-05-09 09:20:27-04:00,19997,4rVW5SPBGcoxE3wAnjbULgZm4xdHXtqhivrszp9W4YP7,Fzu9D4KRKhAF7p22sNqMybe11zGwuXVe58iSt32MbfYX,True,89459038,22364759,66702,33351,33351,Hu94aiQWvce6THeGyCFqGRPM1pQrK3ihzkcXo1EpJcJL,2668116,26459243,-23791127,298
2022-05-09 09:20:27-04:00,19998,CMVVfXQYALSc58NLD67L8YrJAbDHZ9rFZvYQC7r8Png4,44pytMX14zaEQv6aRQ223CxYB2uTP7VUTQfUY58EkaNB,True,110497206,27624301,82242,41121,41121,Hu94aiQWvce6THeGyCFqGRPM1pQrK3ihzkcXo1EpJcJL,3289680,51229248,-47939568,297
2022-05-09 09:20:30-04:00,19999,FU3fRyQxk6rwtD9Db1nTvTAjSwgSW9vi1q7SjZ92ijyM,7c3maBK3hpb1exxqcvnwiUfhhUBgLgCs5exANSZ7m494,True,142512011,35628002,107710,53855,53855,2a35JJeTUW1pm6M3e8DHCjp8qr4vbc2cRPhuzZWyFzYd,4308400,19928882,-15620482,302
2022-05-09 09:20:30-04:00,20000,Eps7NSYQhiSzaTpTLzx5aoDykXSKtQ6w1JBFuucC8hQp,EeNkTwr26mYEBqYHqoHaBZfybPS2PwcbJsgmQGJY6g89,False,32898840,32898840,995833,49791,946042,8sEswn3kzEhnYjAZVvCQnHEUvYd7pFVvc2Xc2Kd1BpbC,995833,15182653,-14186820,302
2022-05-09 09:20:51-04:00,20001,Ejg8vXVsro4jB2fpdUUXCRfKTiE5TUwfRXhHeR8qtrEi,GnF7xwsjzso48ZEAdYYuxNkJso7ug3s46uogi4XDbs1,True,344431247,86107811,260561,130280,130281,2a35JJeTUW1pm6M3e8DHCjp8qr4vbc2cRPhuzZWyFzYd,10422476,88620996,-78198520,302
2022-05-09 09:21:05-04:00,20002,A7j77tzgnQVGtHTa65VtVZqJRYeJvQk7am8NW6e66379,4vJGwEvXU2tGWoWWGwbsYcfKQAMCHbrBMRk4ZVFzneLs,True,367761001,91940250,273798,136899,136899,68sueyVfmy5ToEGtLFGDkwebX47xAmzyXE29z8JrmcWv,10951937,118452015,-107500078,297
2022-05-09 09:21:05-04:00,20003,62q4KpVd3UXPomDaqpTF7recRAEh2ZKgWRgT92ztmda4,8xRdV8nWLb3CiCcHt2ZXEJv3NSfaa178zarhUkKv2rP9,True,44961497,4254048,17276,8638,8638,5HnvdJnCCcmRsm4GkXnYWd4q9RpwuvYDGEUMPkYR3Ts9,1825924,14286419,-12460495,406
2022-05-09 09:21:09-04:00,20004,2tPYXtNrw134ACVhkYdnG9FGT4iHm61PuX8L7AfG9aAT,EyyPLVdjgewzVDKePQUj85BBttWy4MixVr9CSD8JVbrP,True,353919166,88479791,264763,132381,132382,Hu94aiQWvce6THeGyCFqGRPM1pQrK3ihzkcXo1EpJcJL,10590522,162874058,-152283536,299
2022-05-09 09:21:18-04:00,20005,5euvq1j9LCJWT1K7xKAE2TjwzbrWA5t6j2SxtnWsEPeU,GKDnouGNzg5JkjWG7Qs4nmka6qUMdYrk1fKwrmj8TvdH,True,49538348,4448957,17689,8844,8845,8sEswn3kzEhnYjAZVvCQnHEUvYd7pFVvc2Xc2Kd1BpbC,1969727,15103328,-13133601,397
2022-05-09 09:21:18-04:00,20006,HT2SuCbePhjNZaar24uVwihYowCNvSjdvhJ8BRSVw9nX,98Ts4LCnapHVoCJ5PW3Armvh4jvDtpfs3SYRLRxiAgzZ,True,26063560,3756490,17117,8558,8559,5HnvdJnCCcmRsm4GkXnYWd4q9RpwuvYDGEUMPkYR3Ts9,1187667,15281744,-14094077,455
2022-05-09 09:21:22-04:00,20007,GMpoV2jRyLdf2V3Gb5TQZ5gEs5ftMjD3JhFUzkA6fWVz,5bi814d5gdToTLVWCmbdB6J15kMdsTQk74cZTRd62p81,True,184411075,46102768,328693,164346,164347,8sEswn3kzEhnYjAZVvCQnHEUvYd7pFVvc2Xc2Kd1BpbC,13147751,67062467,-53914716,712
2022-05-09 09:21:26-04:00,20008,3AaMzK9WAbD9m27szcJYnucnSPQ4W7tk8EztgWv4vqUo,8oUBQUKo9wHLu1tUEF1AeCUa7oRYyDSoFNRMqQAqKMbH,True,49575584,4454644,17657,8828,8829,2a35JJeTUW1pm6M3e8DHCjp8qr4vbc2cRPhuzZWyFzYd,1965104,15065453,-13100349,396
2022-05-09 09:21:26-04:00,20009,FSonJL6JzKgaZG6C3qp7H8UQYrfWRsuDmbHkrwTHZgYd,6kZCMcaUrPmPQafMUSivWavmDwEmVdvF7N7hyRXb34bw,True,92233955,23058488,68797,34398,34399,2a35JJeTUW1pm6M3e8DHCjp8qr4vbc2cRPhuzZWyFzYd,2751903,20496181,-17744278,298
2022-05-09 09:21:30-04:00,20010,7qEVqFr1naSPCDV9q3xx6KMZn1yCHvkHZJkaA46NLmSE,8Mohcixq2L9PYrHpb95vuEsXqJ18JhEHi3RA83VM9cLv,True,91585826,22896456,68707,34353,34354,2a35JJeTUW1pm6M3e8DHCjp8qr4vbc2cRPhuzZWyFzYd,2748303,34845005,-32096702,300
2022-05-09 09:21:31-04:00,20011,5rnSL1jkLDsAvWsKNrbxtBJEcavHbc41kSTWywUEmSaX,87ZzyZEPJAXq6UiTqQVNuChRQVSb7QcUJgV41saA8CFC,True,31246185,2987214,12222,6111,6111,6L1WYrPiCMyi7XemPww4B4hvpKD1LQKD4RpiSKmrmgSC,1278489,11051690,-9773201,409
2022-05-09 09:22:09-04:00,20012,CpeJ8BVz8Nd6SqnM3DYejnvAYnovDwu1taCqMEBD4RRi,GMmBgzDTtes62wJTENptaWPxNY2srWCrAdWErkj22Hzj,True,27168435,1199067,4898,2449,2449,68sueyVfmy5ToEGtLFGDkwebX47xAmzyXE29z8JrmcWv,1109960,9097830,-7987870,408
2022-05-09 09:22:11-04:00,20013,H8P77smmiLj1vtt7hoSjf2vmcnBdW4rsgCtagtXZg6yy,3FxygrzNpSWivjLU3CumYif6rXhSzyjLqdKiyvphDnnc,True,49553716,4448534,17712,8856,8856,5HnvdJnCCcmRsm4GkXnYWd4q9RpwuvYDGEUMPkYR3Ts9,1973083,15101407,-13128324,398
2022-05-09 09:22:18-04:00,20014,Eo5LYLiUCspbrK13ker5skq9kMjnpUJEJPSbRDWjH6V4,GefeNAw5BdDkibatZknZVGsLhkfc8wfxriEfjHNpvMPm,True,6039016356,1509754089,4492893,2246446,2246447,6UQfSsLooL4pQKQfLtXCutQS2BnF7A7F7ewJopDLmUpc,179715726,1732851788,-1553136062,297
2022-05-09 09:22:19-04:00,20015,66wPLMYSaijGnKqyVVNNjzQJs8XZRhWbZjXJw24AqWWN,DgeG5GFqiGQKEQhRPVrQB6nLiUk4JVVk2W8ky2CoDosD,False,8045811,8045811,239085,11954,227131,Hu94aiQWvce6THeGyCFqGRPM1pQrK3ihzkcXo1EpJcJL,239085,4688174,-4449089,297
2022-05-09 09:22:31-04:00,20016,62q4KpVd3UXPomDaqpTF7recRAEh2ZKgWRgT92ztmda4,8xRdV8nWLb3CiCcHt2ZXEJv3NSfaa178zarhUkKv2rP9,True,40587745,1935977,8055,4027,4028,2a35JJeTUW1pm6M3e8DHCjp8qr4vbc2cRPhuzZWyFzYd,1688944,13273185,-11584241,416
2022-05-09 09:22:31-04:00,20017,3CTLVMSTYE6azjXhZyhPD5XiUe23aJ4pb456SQnUiohH,13q8wAZ1zte3bd3LdeKLEUY7ubu2suCNRZVrgMScpV3C,True,27165421,1203311,4926,2463,2463,2a35JJeTUW1pm6M3e8DHCjp8qr4vbc2cRPhuzZWyFzYd,1112179,9103896,-7991717,409
2022-05-09 09:25:26-04:00,20018,3RpbaFEL5ZYrQBPpaAeCUXs43Ssdr5Tm4ScMGtp6XbYF,CpKGwcVZrd3vKTNhdF8xNsd77FT3QxQWb7xFQxiyPB5p,True,897091902,224272975,1326877,663438,663439,gjBMZYVujDjD1ECG4i97M8Q3gV9ESnwwTSUGropkusj,53075106,446863215,-393788109,591
2022-05-09 09:26:00-04:00,20019,D5VZNThkv6XD6bimPshD2J3PvbPXgCbivZuPfkVxgdjc,8C77LmMk4C3KvyEb1N3scdbAgwN7J45nAcv9tkL5namB,True,165817718,41454429,252283,126141,126142,Hu94aiQWvce6THeGyCFqGRPM1pQrK3ihzkcXo1EpJcJL,10091324,83190257,-73098933,608
2022-05-09 09:29:15-04:00,20020,EVMrznfJS54BZiywDD2WhUtxzicDtbEpm2a5yLrtCgRF,CpzsMYVYvKg8ihrX1cKRw7TDEYwD3kAyiX92hsf2KiTz,True,343091946,47710995,211582,105791,105791,8sEswn3kzEhnYjAZVvCQnHEUvYd7pFVvc2Xc2Kd1BpbC,15214978,231418101,-216203123,443
2022-05-09 09:29:15-04:00,20021,DRVtEzZs9u9ysrcANZLEjrvbuuGqYn77v2h4cDFKuNUx,Fv9qiMZhuSBL2cs9AWUYbDLQjB46W2ZwrhxaNXtPLDpC,True,8493508043,2123377010,6390018,3195009,3195009,8sEswn3kzEhnYjAZVvCQnHEUvYd7pFVvc2Xc2Kd1BpbC,255600722,758956782,-503356060,300
2022-05-09 09:29:23-04:00,20022,26wo1RqwKXrNnfgMdZEmkGhnDbURpZcp2hasB5EA5QtD,34gwTVGRrdoaBzLUG6SBwRwBovkjBjCebqVUBan6GDnB,True,538421126,134605281,938203,469101,469102,5HnvdJnCCcmRsm4GkXnYWd4q9RpwuvYDGEUMPkYR3Ts9,37528127,421617254,-384089127,697
2022-05-09 09:29:52-04:00,20023,DHfy6B2AYsqMCxPLBCXMDfQn3Gr2VwJaLFHUZKqpCjsb,EPZpYaY1gCAb8pMtri5veRowBmCrCpTHBMa3Rmgt6S29,False,25817741,25817741,767502,38375,729127,68sueyVfmy5ToEGtLFGDkwebX47xAmzyXE29z8JrmcWv,767502,4713227,-3945725,297
2022-05-09 09:29:53-04:00,20024,7tFD53kPTqrzjCu1Wji78gUqhoRtCUhsP1pM3DQKT7uG,BJvgPLYBDJrQJdQVowrsMwUGMurq4zTihoFwWoEokfu3,True,103599379,14664341,44103,22051,22052,68sueyVfmy5ToEGtLFGDkwebX47xAmzyXE29z8JrmcWv,3115836,29135791,-26019955,300
2022-05-09 09:29:55-04:00,20025,3Xbsek5MsEGoWr3G9yhuohREr26B2vSQcjqXdspTFHta,2rPxkUiMo9wGDq8EvAiwY3ngRpKmL223cBWWNTYoBmFp,True,347495891,86873972,262978,131489,131489,8sEswn3kzEhnYjAZVvCQnHEUvYd7pFVvc2Xc2Kd1BpbC,10519124,40330215,-29811091,302
2022-05-09 09:29:55-04:00,20026,HT2SuCbePhjNZaar24uVwihYowCNvSjdvhJ8BRSVw9nX,98Ts4LCnapHVoCJ5PW3Armvh4jvDtpfs3SYRLRxiAgzZ,True,22206749,1506116,7258,3629,3629,68sueyVfmy5ToEGtLFGDkwebX47xAmzyXE29z8JrmcWv,1070229,12831408,-11761179,481
2022-05-09 09:29:58-04:00,20027,6d6HN8LWikwW2HYdy3BABWuxKHt1sgv4DcneACR133sE,4eKvzmfFvX96XbujKBhUauAvWP4yQYwZH3pd7gXzbCvJ,False,27626858,27626858,835476,41773,793703,Hu94aiQWvce6THeGyCFqGRPM1pQrK3ihzkcXo1EpJcJL,835476,9246131,-8410655,302
2022-05-09 09:29:58-04:00,20028,5euvq1j9LCJWT1K7xKAE2TjwzbrWA5t6j2SxtnWsEPeU,GKDnouGNzg5JkjWG7Qs4nmka6qUMdYrk1fKwrmj8TvdH,True,44969866,4257880,17350,8675,8675,5HnvdJnCCcmRsm4GkXnYWd4q9RpwuvYDGEUMPkYR3Ts9,1832513,14284599,-12452086,407
2022-05-09 10:30:25-04:00,20029,C8EuUJigyRy2ojSuZtDSnc4JxmVqoe5XTr4xaPPmKsyV,6PrUiT94hGcBm2AvkmkrnRnjXkR8WxmtJcvSapde3J1P,False,30967837,30967837,935414,46770,888644,6L1WYrPiCMyi7XemPww4B4hvpKD1LQKD4RpiSKmrmgSC,935414,71146461,-70211047,302
2022-05-09 10:30:25-04:00,20030,FuhTkUxSaJ7kvuu9LHZaPVfdbKAQSh9W8Zzso1XPKGZp,FLoqPzREreKfRCwqtXs3CJwpTSudmXrVYCRZadWvob7j,False,31249863,31249863,944033,47201,896832,8sEswn3kzEhnYjAZVvCQnHEUvYd7pFVvc2Xc2Kd1BpbC,944033,15374366,-14430333,302
2022-05-09 10:30:27-04:00,20031,5xkW7wHTcF5WadNtBBqKPKctVwyQtTqqscivAmxzseCk,7m31ZMZdCn5Gz2q5sETWA7uKA5LsKD7pJHBBqU3g7tCn,True,503596101,125899025,377314,188657,188657,Hu94aiQWvce6THeGyCFqGRPM1pQrK3ihzkcXo1EpJcJL,15092582,83278853,-68186271,299
2022-05-09 10:30:27-04:00,20032,26pvf6YygxQ8CdL4h4PcMuYNQtFbUVisTsYaFB3EZXvd,9tVSyevo14cUe2NMoBteqgV7vw44m6ooz2rD9ricKh55,True,50352219,12588054,37229,18614,18615,8sEswn3kzEhnYjAZVvCQnHEUvYd7pFVvc2Xc2Kd1BpbC,1489170,24142481,-22653311,295
2022-05-09 10:30:28-04:00,20033,DAawvqmcjnThXxJzsp7ExW1bhGaRGRxLgG6h85HpGAN5,2KRCBiCQoQd2fDSS1e2U19WVddWAqM6EPkqK8rZwaRNh,True,51783787,12945946,38382,19191,19191,Hu94aiQWvce6THeGyCFqGRPM1pQrK3ihzkcXo1EpJcJL,1535281,59709063,-58173782,296
2022-05-09 10:32:23-04:00,20034,EHi1UBG8wMUFZECktsFUZkGjJPaBNEedswS62hyYn6jC,Drx9ErQhAjnPuJ83LPYFnY5ZV5XDzGuXDuSf16VqWayp,True,404740839,22080110,81735,40867,40868,3zqXX6kzhkbW3d4TwD2CNjMRwxTbREXySekvq37kfCNk,14982603,277797469,-262814866,370
2022-05-09 10:32:23-04:00,20035,H7rsFRRhZPe2jLex2NkbYYzVtLobvFiqnCd4BUyJVPBB,8bedwDRfSKLP9vUxoXcpHNJzWQemMaf4QGT2mtHFVJFb,True,36119506,9029876,26254,13127,13127,8sEswn3kzEhnYjAZVvCQnHEUvYd7pFVvc2Xc2Kd1BpbC,1050179,4196572,-3146393,290
2022-05-09 10:32:23-04:00,20036,3zVmiyif8VbqUW7dAeEMYJYrg8r5pCeBfALsdgu6kgFJ,FwzrxNbJsiCQwqayaDhwkbm9TRG11bK6fWs5Dn75da9a,False,29610144,29610144,869223,43461,825762,2a35JJeTUW1pm6M3e8DHCjp8qr4vbc2cRPhuzZWyFzYd,869223,14098597,-13229374,293
2022-05-09 10:32:24-04:00,20037,HXQXfEQe7aCpr6WKh37XaDZsjZcuQPk5t8tWNFgEoK6U,5ufXkCEDwgiXwtyPye4wYVVA3oLW54JVzz4tnXFofto4,True,340748161,85187040,255125,127562,127563,Hu94aiQWvce6THeGyCFqGRPM1pQrK3ihzkcXo1EpJcJL,10205007,163260627,-153055620,299
2022-05-09 10:32:28-04:00,20038,8L2s5h1hSU79naWcS7cvT3oxiPL6ofTDWmqTK1S4F99g,32DYf6ArTTcNwokJrbhHT1QGe4pZ9z29oPdw97aDR7AQ,True,124416597,31104149,94088,47044,47044,C4UnXuShCvjSMgBAgVNMy1oakxCNk1et27A82fywU112,3763528,118880945,-115117417,302
2022-05-09 10:32:52-04:00,20039,3AaMzK9WAbD9m27szcJYnucnSPQ4W7tk8EztgWv4vqUo,8oUBQUKo9wHLu1tUEF1AeCUa7oRYyDSoFNRMqQAqKMbH,True,45013765,4247615,17338,8669,8669,8sEswn3kzEhnYjAZVvCQnHEUvYd7pFVvc2Xc2Kd1BpbC,1837447,14249612,-12412165,408
2022-05-09 10:38:22-04:00,20040,57UJpBg8pjTxWp9LVwVGjCDm9zgYnzs4ru49BdZrG62a,Dor96mgsM5EroCmZUAnuDPiAiLn7nNgGeZDbwHxpHxzw,True,47527954,11881988,35374,17687,17687,68sueyVfmy5ToEGtLFGDkwebX47xAmzyXE29z8JrmcWv,1414998,7767044,-6352046,297
2022-05-09 10:38:25-04:00,20041,7cGERqGwiV7e3MTM5KZNB71raK66QTZP81FyszsXZTy1,E75WGPAqdbVRnKkoWwbNNmMiVJQkFS2BaTMhSThBnma8,False,5168543,5168543,148609,7430,141179,3zqXX6kzhkbW3d4TwD2CNjMRwxTbREXySekvq37kfCNk,148609,2979258,-2830649,287
2022-05-09 10:38:25-04:00,20042,8nQCnDq6v2Fqe9v3qkHhHW3UQjd3Cg1iZJJBbkfnrjYz,FtCPxNE1WQajWJi48Hy3nqh9W1NQSkZPAz5hetsaam6t,False,6463185,6463185,187776,9388,178388,5HnvdJnCCcmRsm4GkXnYWd4q9RpwuvYDGEUMPkYR3Ts9,187776,3723581,-3535805,290
2022-05-09 10:38:29-04:00,20043,FncFHJooh1hy9Gc2y5sKdcYkZ5uHzsxHG4vHT9cVZGcK,BkFa4b5Jyv4ZJCCpwDYv355ezVFiZfAtn18AV7kstd2v,True,87140170,21785042,62622,31311,31311,68sueyVfmy5ToEGtLFGDkwebX47xAmzyXE29z8JrmcWv,2504902,20705189,-18200287,287
2022-05-09 10:39:32-04:00,20044,4oMasDRj8HWfknmdwt6Mkz3eonr8J2byoiSTRo4sCnFQ,3emcATkEFvDVETiK97eVET2Z2jzkgiiSxX3gu5wsUKPe,True,510573536,74249422,481228,240614,240614,2a35JJeTUW1pm6M3e8DHCjp8qr4vbc2cRPhuzZWyFzYd,33091482,296334835,-263243353,648
2022-05-09 10:39:33-04:00,20045,D8BtQirMEk3W9Pq29B6KkKWrwPfmsUNpwz5npx7aGMLY,J7LMZwaSoh5hbGcwee6oPsnN4ZFD7Zp3LQWkJGNUHRfJ,False,10338378,10338378,722851,36142,686709,8sEswn3kzEhnYjAZVvCQnHEUvYd7pFVvc2Xc2Kd1BpbC,722851,7273575,-6550724,699
2022-05-09 10:39:49-04:00,20046,532MfQR1PzPn6cmC1kpZsz9MyBWSamSeieh1F6GqVY33,6sJ8XXMZzGbHjVU1vWNW8unWoBZhJa54GguYJQhcb8PA,True,1674319207,211634367,1414038,707019,707019,68sueyVfmy5ToEGtLFGDkwebX47xAmzyXE29z8JrmcWv,111869927,286486124,-174616197,668
2022-05-09 10:39:54-04:00,20047,6wGzqSWYjB1nukhDwLdgXDzMNSeasuRur3FVZAkVF4pM,HTcJjvQNFJQEewRf8iCcsZgFcfHoUXzpbb7WscqdK4kS,True,58660066,14665016,89405,44702,44703,6L1WYrPiCMyi7XemPww4B4hvpKD1LQKD4RpiSKmrmgSC,3576215,17352378,-13776163,609
2022-05-09 10:40:04-04:00,20048,GcwFXxcxRF2xwbgFbQZoYEDreimd3J3UJ9sPfuwYVKtS,7uXjmKS8RxP2qSS7ataBH5hkfpgsFcpSBWUEBuV5zgyZ,True,93534860,23383715,70824,35412,35412,8sEswn3kzEhnYjAZVvCQnHEUvYd7pFVvc2Xc2Kd1BpbC,2832976,27769482,-24936506,302
2022-05-09 10:40:07-04:00,20049,CpeJ8BVz8Nd6SqnM3DYejnvAYnovDwu1taCqMEBD4RRi,GMmBgzDTtes62wJTENptaWPxNY2srWCrAdWErkj22Hzj,True,25897402,2267869,9032,4516,4516,8sEswn3kzEhnYjAZVvCQnHEUvYd7pFVvc2Xc2Kd1BpbC,1031519,8708387,-7676868,398
2022-05-09 10:40:07-04:00,20050,6pUtYz474QrpATEZnfb3iFbTKYA65pNyKAo4TQZAjtqe,8dipRUXvxJiDLdHEtCPkso4vErbVwshHQiRfvSngBS9J,True,256282233,20087422,70133,35066,35067,6L1WYrPiCMyi7XemPww4B4hvpKD1LQKD4RpiSKmrmgSC,8947926,177284003,-168336077,349
2022-05-09 10:40:08-04:00,20051,H8P77smmiLj1vtt7hoSjf2vmcnBdW4rsgCtagtXZg6yy,3FxygrzNpSWivjLU3CumYif6rXhSzyjLqdKiyvphDnnc,True,44986227,4241891,17289,8644,8645,5HnvdJnCCcmRsm4GkXnYWd4q9RpwuvYDGEUMPkYR3Ts9,1833591,14279401,-12445810,407
2022-05-09 10:40:11-04:00,20052,5rnSL1jkLDsAvWsKNrbxtBJEcavHbc41kSTWywUEmSaX,87ZzyZEPJAXq6UiTqQVNuChRQVSb7QcUJgV41saA8CFC,True,28165192,1381536,5741,2870,2871,C4UnXuShCvjSMgBAgVNMy1oakxCNk1et27A82fywU112,1170593,10274787,-9104194,415
2022-05-09 10:40:14-04:00,20053,7zuFEyLQFHkAjm3mAuxN42VenwF6fZcqM81mmR8sBnmY,CSnQxjc4Jn8iP4JSxj5wsrvxGsLoAYQn1bKC8naY7YZP,True,5986170259,1496542564,4480454,2240227,2240227,72XWPCtRYEDZbddP7d6dHtUBRRDLSJsB2xZTAfefoEVZ,179218181,529212582,-349994401,299
2022-05-09 10:40:14-04:00,20054,Bu65ba81oA2rZqxGAsctgz39NPPJqbXR3SvdMX5KQfTK,DcxNLDe2GwGiQPtQhzMiUjrMaqXjuyx1EGgX3xPtE98T,True,39409548,9852387,29641,14820,14821,2a35JJeTUW1pm6M3e8DHCjp8qr4vbc2cRPhuzZWyFzYd,1185660,11827848,-10642188,300
2022-05-09 10:40:16-04:00,20055,4KMzwWHPeW51cxu4nMpbqCaqo96dMqaHWyRCGQktfQfd,F7q4GNYcbnZa8dJ4qovQwjmxpKpdEmdxQMXRPb9nQupa,False,3969052,3969052,118848,5942,112906,Hu94aiQWvce6THeGyCFqGRPM1pQrK3ihzkcXo1EpJcJL,118849,1588368,-1469519,299
2022-05-09 10:40:18-04:00,20056,Aog11AwpgWF7UgvLLJbV5kn3UrJURYQUhnBFnAFSqbp8,2WXYGpuib3fK3BCXDQVQsoktEnASPuZfcnmC2AZ7KTQK,True,88000108,22000027,66118,33059,33059,5HnvdJnCCcmRsm4GkXnYWd4q9RpwuvYDGEUMPkYR3Ts9,2644747,19797590,-17152843,300
2022-05-09 10:40:35-04:00,20057,cXqFkCF4gaT9vAcZYMgwLXmmuD5w4hwgxT8YXE8JuBw,5Wtf4ZBL6R1afLeC4WfhFGkfi42TagtNAg6EZWn7gKhg,True,58272289,14568072,44004,22002,22002,Hu94aiQWvce6THeGyCFqGRPM1pQrK3ihzkcXo1EpJcJL,1760193,18568242,-16808049,302
2022-05-09 10:40:48-04:00,20058,H9pFRayNBHTAhsbtGyfs1XXUWGxAbw7SgpT1xdrSRWEY,9LNreyXuhgyLCDYViNyA1jUw6h1nv4GmDtTYMoUQBqCG,True,3481832333,493602841,1495584,747792,747792,68sueyVfmy5ToEGtLFGDkwebX47xAmzyXE29z8JrmcWv,105497283,1471568363,-1366071080,302
2022-05-09 10:41:00-04:00,20059,DMACzuFBuj2vGqxZ3FV7QAo24jMV3EHKL8MrDrGbRkaJ,EnLfmDVW4ba2uqZKhj3X1TFnx8AHv7xwSWrMbVBYwcu9,False,26966756,26966756,814908,40745,774163,5HnvdJnCCcmRsm4GkXnYWd4q9RpwuvYDGEUMPkYR3Ts9,814908,4875275,-4060367,302
2022-05-08 13:35:19-04:00,19036,92vHa65f4WpuqzSCMESDMPxZ2yfLxXJMMPYLof75EiN,3QZvcV1wL2ZYnw9yY9sbhiCP3dYYHeUZB7gcqtSutuLK,False,8853758,8853758,255031,12751,242280,C4UnXuShCvjSMgBAgVNMy1oakxCNk1et27A82fywU112,255031,7554856,-7299825,288
2022-05-08 13:35:19-04:00,19037,Aop82qT6CwZbomif4QowqP3VaSHKB1837B2yNKqw4tER,65BVa4jrCx9etU5eXBAXT2PVnwVot2HLWGYyNXbVJDFk,False,191689,191689,5480,274,5206,8sEswn3kzEhnYjAZVvCQnHEUvYd7pFVvc2Xc2Kd1BpbC,5480,270406,-264926,285
2022-05-08 13:35:19-04:00,19038,F82PLGiP5KXaPHD94YDq5FnfGeFbb6Z4gBFHypukaCi9,7ckYcHsEdKq3mfvAUc71uRUw2ugvS9yu7RNJErsdefi7,False,5829830,5829830,171138,8556,162582,C4UnXuShCvjSMgBAgVNMy1oakxCNk1et27A82fywU112,171138,9023077,-8851939,293
2022-05-08 13:35:19-04:00,19039,9Hz4p7gcfDbXBJp8KzhaBBPh9i7xe9kun7zLfDtqPe6c,2bJ43Lep6kp6WY7Ct56oiscKnAbdtC265G5yRvRPFThU,False,50956,50956,1447,72,1375,Hu94aiQWvce6THeGyCFqGRPM1pQrK3ihzkcXo1EpJcJL,1447,51503,-50056,283
2022-05-08 13:35:21-04:00,19040,As81koHnSP9quoXuUVNHp3VR3Qaks8HLa4sFgJDocYiF,AMVm8dXia5s974VgZSbeE6uPDgyXDHZFyJ2W1J1CWvKW,False,390289,390289,11063,553,10510,Hu94aiQWvce6THeGyCFqGRPM1pQrK3ihzkcXo1EpJcJL,11063,550914,-539851,283
2022-05-08 13:35:21-04:00,19041,4rT1wS6WUtvVSDazrJVhn26rspWSsm9Y5DN2qCvmiBZw,BAVHTZSqhKmS3afYrGhG5CMXgffDAmfuPXKo48eDVfka,False,16008072,16008072,482882,24144,458738,C4UnXuShCvjSMgBAgVNMy1oakxCNk1et27A82fywU112,482882,4630985,-4148103,301
2022-05-08 13:35:21-04:00,19042,BLJgLzizx2yLgd12pVBAHTMqn9J5JA3JHCF8PnLnPyUk,HhDmwMysBFWhXnd3mrV31w75WBRKBS8wJSiEMZgqdUSp,False,54832,54832,1616,80,1536,2a35JJeTUW1pm6M3e8DHCjp8qr4vbc2cRPhuzZWyFzYd,1616,80719,-79103,294
2022-05-08 13:35:21-04:00,19043,7cvbksBKz3SyD4Waqpa3qaBAj7ZVZcxL5M1mJrHemDoK,5Pyxm6RqTPwQp2ji2mkbqC56Bg2Ps9ed9YGXz5HXezRr,True,121535749,30383937,88242,44121,44121,C4UnXuShCvjSMgBAgVNMy1oakxCNk1et27A82fywU112,3529685,24293194,-20763509,290
2022-05-08 13:35:22-04:00,19044,3sGCWcgPY7TzRCkFR1uuY8KcUzVRbdTyFYxh7V1csNMX,CcRFNnG2uhyLwhNAbX4U49jkMeC11kJtVhhyqDWdDK5r,False,396697,396697,11350,567,10783,6L1WYrPiCMyi7XemPww4B4hvpKD1LQKD4RpiSKmrmgSC,11350,561703,-550353,286
2022-05-08 13:35:25-04:00,19045,2ZSfbqxhiCTDrDPeRhoWayTZHNmW7ajVXBCxpFS4eGBF,3ZmWsPdQD7qfSMGKQSNhmBtuH7S6qMFRc8oEmBcHXEiR,False,13934,13934,401,20,381,2a35JJeTUW1pm6M3e8DHCjp8qr4vbc2cRPhuzZWyFzYd,401,20110,-19709,287
2022-05-08 13:35:25-04:00,19046,CnNbPk9YL7y2PiqMfVvS1789stfDA7ZDk3sArJSw6FwP,9oamN33gGnx3tU9Mnn53yhi6F2Du5AAaSV6uAi69rbib,True,152014578,38003644,111626,55813,55813,C4UnXuShCvjSMgBAgVNMy1oakxCNk1et27A82fywU112,4465049,59668989,-55203940,293
2022-05-08 13:35:26-04:00,19047,AvpYg74EBhwAXE8rcdGkpwmbBMRyVidF6zMRSFtWAVC6,4WgpqTp4r9wMpMptYMNbvCaP2faBnVr6FdShCAobetpL,False,13825,13825,408,20,388,Hu94aiQWvce6THeGyCFqGRPM1pQrK3ihzkcXo1EpJcJL,408,19959,-19551,295
2022-05-08 13:35:27-04:00,19048,82EMpA1hwF9KNQy2ZB2A1HdoEowBu2CoYhW3VmohkSnk,hn67zsTzsAs2aqk6ZjfEeoRygd3CdMeCuR82h9yuiz3,True,56803859,14200964,40816,20408,20408,C4UnXuShCvjSMgBAgVNMy1oakxCNk1et27A82fywU112,1632652,21505658,-19873006,287
2022-05-08 13:35:27-04:00,19049,EJLgJiVhkNMJJ1sAGKkyKZs6gjdnXNfn6GainLbohkQe,3kp99ozLWY2QBc8SznbyJjz9WGuUHdkdiN1ThbCWEY4a,False,2475527,2475527,69647,3482,66165,C4UnXuShCvjSMgBAgVNMy1oakxCNk1et27A82fywU112,69647,631375,-561728,281
2022-05-08 13:35:27-04:00,19050,DHfy6B2AYsqMCxPLBCXMDfQn3Gr2VwJaLFHUZKqpCjsb,EPZpYaY1gCAb8pMtri5veRowBmCrCpTHBMa3Rmgt6S29,True,153074438,38268609,110869,55434,55435,C4UnXuShCvjSMgBAgVNMy1oakxCNk1et27A82fywU112,4434785,18590015,-14155230,289
2022-05-08 13:35:28-04:00,19051,kEstb9msKrdEaMjoEad819rcrobFGdiknwKxTi1Dw6y,5fgoHmS5JvLHxKc2rqTy9efcwGT92rgEs1eB12DtXvVf,True,75249990,18812497,53677,26838,26839,C4UnXuShCvjSMgBAgVNMy1oakxCNk1et27A82fywU112,2147115,12919094,-10771979,285
2022-05-08 13:35:28-04:00,19052,5nALef7nAfNkSQSuTBLwewDby4pUx74Gzqib33Znmmt6,8xNTWK2xNK2xZPpgXfcE4QxPT2i6YvNYakiLgdQ2FqEt,True,74678566,18669641,52539,26269,26270,47z82br5WdW2DZajdnPDPSSRRKsyAggqXqK6oPUwTaLf,2101599,9382315,-7280716,281
2022-05-08 13:35:28-04:00,19053,GZR24Tu8n2se8vXBZjM9JHNMDBT3X5XhQ9YwsLe63b7v,8PUFWns1xA6uTpZeBBzhA6bnzBQVTg5JgbRtgsEhdyw4,True,38817867,9704466,27072,13536,13536,47z82br5WdW2DZajdnPDPSSRRKsyAggqXqK6oPUwTaLf,1082917,9582581,-8499664,278
2022-05-08 13:35:28-04:00,19054,F5vnN191nY9kUJBtFcm6fUhPDJvUSrSHLvfstesb68rH,9DtiZh3FsVmZA9MRqZhonAN2Pk4rQdcWw8As76DnQ6ee,True,4218471647,1054617911,3195033,1597516,1597517,GXyFXZMNk2NFyEzw6JetVqsujqcz2yCixH7n8EpDJYWD,127801321,211487040,-83685719,302
2022-05-08 13:35:28-04:00,19055,2EkjFzKuqQaT9iLsf4qHnXM6rnbj7ftEyzzRsWx6D347,9NpHNbrRJF3U8Ub4KraPHhhZpyZk9Teo836dJSktJMEV,False,123368,123368,3475,173,3302,8sEswn3kzEhnYjAZVvCQnHEUvYd7pFVvc2Xc2Kd1BpbC,3475,113907,-110432,281
2022-05-08 13:35:29-04:00,19056,BXMMFy2k9b2hVBEG6RyXAq3qqXxJ7EY2xhyPZqtLvBiU,KpoZwr4ZFTHJgebbf4tcjT9iKvpC1EF8Aw4uaVPxXNd,False,1718689,1718689,51100,2555,48545,5HnvdJnCCcmRsm4GkXnYWd4q9RpwuvYDGEUMPkYR3Ts9,51100,437569,-386469,297
2022-05-08 13:35:31-04:00,19057,3tQBuHwr3V8AZu8Yqhg1UfmnFoxzkUq9UeGeLm41UHy4,9cESwduiHBgrxZK1hN1eAFwnyfxw3FEHezTa8Ue5Kpye,False,1121616,1121616,33207,1660,31547,72FwbpFGoLEazJEdpqNtPNefsadUrimUqma9wSoy4qiS,33207,1130622,-1097415,296
2022-05-08 13:35:31-04:00,19058,FdYFnEYtFQKcZPmzUqnvNLzozxdR1emtkmvnYcMgYykS,7arWNJQf2cWxerjhLgQh9CJxwTat1efnr5KmhuD7Qnv4,False,10842,10842,308,15,293,2a35JJeTUW1pm6M3e8DHCjp8qr4vbc2cRPhuzZWyFzYd,308,15659,-15351,284
2022-05-08 13:35:34-04:00,19059,3jJxvfbyc9KvECkLWTGptkezCLZfiums7GgfANyCULF3,C7fXi4upWW22F2Ak7AzsYVASjjdfZZtPmkQ9pBB2bJXZ,False,1505102,1505102,42434,2121,40313,2a35JJeTUW1pm6M3e8DHCjp8qr4vbc2cRPhuzZWyFzYd,42434,1202491,-1160057,281
2022-05-08 13:35:35-04:00,19060,5Y7MpvBDW2jVq5SwkJQrVjqMSBEfwvB7dF9N1dD6s9bk,5KvuS6ew8J4KCeX46ZZmvpuSBzK2DatDJmpm7cMwMKnp,True,82544903,20636225,60936,30468,30468,47z82br5WdW2DZajdnPDPSSRRKsyAggqXqK6oPUwTaLf,2437440,32447272,-30009832,295
2022-05-08 13:35:40-04:00,19061,CJpe9bNHxS63QMaGJhmnr4u7eTo6e5GApZQZyPtXLAkk,EMVL4sDfVXwGEoGEYwLp8D6itfy3eu4FZBAj1kMz6uXa,False,372311,372311,10576,528,10048,6L1WYrPiCMyi7XemPww4B4hvpKD1LQKD4RpiSKmrmgSC,10576,526128,-515552,284
2022-05-08 13:35:43-04:00,19062,FF8rqfM9PTEjYiVFy8jS81weDRwdaYooux2uSa2LexrJ,JBk1JghH1gged1YpDbkczFXP9ka5ivYSkaYoVbbXD4kg,False,10062,10062,301,15,286,47z82br5WdW2DZajdnPDPSSRRKsyAggqXqK6oPUwTaLf,301,15355,-15054,299
2022-05-08 13:35:43-04:00,19063,9Kmy166yoeTZNt9KDchxyj3PWNQ3tJZ5a24pMqx6DxrZ,2TNQaUck5kGpwpPwh98FHnxzsLrQFSvuFBv9t6yBNUb1,False,1384118,1384118,40454,2022,38432,47z82br5WdW2DZajdnPDPSSRRKsyAggqXqK6oPUwTaLf,40454,389073,-348619,292
2022-05-08 13:35:47-04:00,19064,4q5tGJYhKAyUCLkFdAajtrE9KCvZohCEFqGp5XkqAHwD,8a913NCjVRW6F4DzwaxijQ4URD4AkpCDhts2MJUBYPWs,False,106195,106195,3053,152,2901,2a35JJeTUW1pm6M3e8DHCjp8qr4vbc2cRPhuzZWyFzYd,3053,54928,-51875,287
2022-05-08 13:35:48-04:00,19065,5y8ZSWUnrm4B3emh7vLQKTh89vHtCvXqUhk7fJBA52is,Bu1AoKU2QQWpGH54ZzugvvACB3E1d3VvymnegNmTgHqg,False,390262,390262,10954,547,10407,2a35JJeTUW1pm6M3e8DHCjp8qr4vbc2cRPhuzZWyFzYd,10954,550832,-539878,280
2022-05-08 13:35:52-04:00,19066,U3vvMQ4X4aKzVYfhMw1V1p58HRqaLnuXozqmmefYeD9,7JA94MArkNCFRhBq8f5a32DgMF6aPdFsoC5HvXDQ6NuR,False,16844,16844,490,24,466,Hu94aiQWvce6THeGyCFqGRPM1pQrK3ihzkcXo1EpJcJL,490,26770,-26280,290
2022-05-08 13:36:00-04:00,19067,C8EuUJigyRy2ojSuZtDSnc4JxmVqoe5XTr4xaPPmKsyV,6PrUiT94hGcBm2AvkmkrnRnjXkR8WxmtJcvSapde3J1P,True,183779976,45944994,139109,69554,69555,8sEswn3kzEhnYjAZVvCQnHEUvYd7pFVvc2Xc2Kd1BpbC,5564385,390269683,-384705298,302
2022-05-08 13:38:21-04:00,19068,3NhNdphQiKwgHTmTJc4qVhp3aWjqnwMTYbRW1y9CZrZg,BNpP1sKPAr7Dk1ymSrupge9KGMVpk4LfjTjawgi9YaC5,False,81637,81637,2445,122,2323,8sEswn3kzEhnYjAZVvCQnHEUvYd7pFVvc2Xc2Kd1BpbC,2445,115298,-112853,299
2022-05-08 13:38:21-04:00,19069,5xkW7wHTcF5WadNtBBqKPKctVwyQtTqqscivAmxzseCk,7m31ZMZdCn5Gz2q5sETWA7uKA5LsKD7pJHBBqU3g7tCn,True,2985208794,746302198,2206335,1103167,1103168,A9TwRM1BMxqb8DCC7YNAMV6zPenEJm3HTZBy7wJKK58U,88253403,315325203,-227071800,295
2022-05-08 13:38:21-04:00,19070,EBnMKbaJEjNXjt14hxssR8wd3Ua37McPQxUZnKxxbgtd,FAALK2LRFhg98ezHEBFrgrzxTg66eZpmo7ctKDEck8q5,False,24498,24498,733,36,697,8sEswn3kzEhnYjAZVvCQnHEUvYd7pFVvc2Xc2Kd1BpbC,733,32612,-31879,299
2022-05-08 13:38:23-04:00,19071,BKmKy8n1MpB1sdSfuWy7P3c6ReSW8TEWZRsyriz3ujYo,FgRpiZFPz43vDWStgCwRJACiGKtMLkWbTGeTLPeKnnaY,False,25231932,25231932,744724,37236,707488,C4UnXuShCvjSMgBAgVNMy1oakxCNk1et27A82fywU112,744724,9928031,-9183307,295
2022-05-08 13:38:23-04:00,19072,4SX2pj4eHRwFMtyDCrMZ8ZT6ASAMi7yfZWZnccw5dGn8,Ads49ZqvTmPHxfzNYm4oJb4HBYhwS6vXQbarqmpUi5VZ,False,11347,11347,335,16,319,2a35JJeTUW1pm6M3e8DHCjp8qr4vbc2cRPhuzZWyFzYd,335,16401,-16066,295
2022-05-08 13:38:27-04:00,19073,6h43GsVT3TjtLa5nRpsXp15GDpAY4smWCYHgcq58dSPM,CTgbWridYWnfE5Emwr7qiCEb3LcXHupqeB9zwmddoEqB,False,28347643,28347643,843525,42176,801349,2a35JJeTUW1pm6M3e8DHCjp8qr4vbc2cRPhuzZWyFzYd,843525,9273531,-8430006,297
2022-05-08 13:38:31-04:00,19074,9kYkFDNE3qD6s73fn8kJowgqbDZoDSw22XaUJ7rTD43D,E8zJz8pT2c9aZsxe4kLMNs4bY7skt38SU5wK5JTqbGr6,False,213425,213425,6085,304,5781,Hu94aiQWvce6THeGyCFqGRPM1pQrK3ihzkcXo1EpJcJL,6085,308902,-302817,285
2022-05-08 13:38:32-04:00,19075,FuhTkUxSaJ7kvuu9LHZaPVfdbKAQSh9W8Zzso1XPKGZp,FLoqPzREreKfRCwqtXs3CJwpTSudmXrVYCRZadWvob7j,True,185054803,46263700,136727,68363,68364,3zqXX6kzhkbW3d4TwD2CNjMRwxTbREXySekvq37kfCNk,5469095,77073739,-71604644,295
2022-05-08 13:38:33-04:00,19076,4PKNzBvnXxaobjM8zKPDHWnjFme9QLB39qckNAfTLLfT,FP1Rv6hnSChvFJASp2eL7Pt9WNkgok5kp5ADdoduhugD,False,1671166,1671166,49846,2492,47354,3zqXX6kzhkbW3d4TwD2CNjMRwxTbREXySekvq37kfCNk,49846,378681,-328835,298
2022-05-08 13:38:34-04:00,19077,6d6HN8LWikwW2HYdy3BABWuxKHt1sgv4DcneACR133sE,4eKvzmfFvX96XbujKBhUauAvWP4yQYwZH3pd7gXzbCvJ,True,163420891,40855222,115272,57636,57636,C4UnXuShCvjSMgBAgVNMy1oakxCNk1et27A82fywU112,4610906,43671105,-39060199,282
2022-05-08 13:38:34-04:00,19078,AdhLnfiTUme12n7GxSwQXVV5EUYFLqFKtwqjc3DHdu4a,GXzNAxZ6x3zDd3Ctvc43Ct1tuq22YG72VtfZ4FNfpFhL,False,11602238,11602238,372177,18608,353569,C4UnXuShCvjSMgBAgVNMy1oakxCNk1et27A82fywU112,372178,0,372178,320
2022-05-08 13:38:35-04:00,19079,7EvJoetxJVTgpJXqE1VC3fZN1CQ5xdWdv29yCiDuH9gU,6RTEusjGEHNDdMj75qkpzYHjHZ3R2XN5xvptCwkRJz5j,False,15587,15587,448,22,426,Hu94aiQWvce6THeGyCFqGRPM1pQrK3ihzkcXo1EpJcJL,448,22560,-22112,287
2022-05-08 13:38:36-04:00,19080,H4rTN5pSgWQYdgpEXs79UN96nSKGQ7gkfEyS8B2Fqhyk,GttqEEtxJMkyKi2dRiUrdRyqiCyYXRj91EVzjRB6Uf5d,False,33646442,33646442,992768,49638,943130,C4UnXuShCvjSMgBAgVNMy1oakxCNk1et27A82fywU112,992768,3554525,-2561757,295
2022-05-08 13:38:37-04:00,19081,4nhdidD6SASYzwZ7mUnWKyP4xyWXhdBe2gp5F4qDtLrL,HLk6YPhVidsn3i8HfoASvoim1ztxb4bi8JnioiyvorpV,False,78197,78197,2308,115,2193,C4UnXuShCvjSMgBAgVNMy1oakxCNk1et27A82fywU112,2308,110142,-107834,295
2022-05-08 13:38:40-04:00,19082,H7rsFRRhZPe2jLex2NkbYYzVtLobvFiqnCd4BUyJVPBB,8bedwDRfSKLP9vUxoXcpHNJzWQemMaf4QGT2mtHFVJFb,True,214283171,53570792,157928,78964,78964,C4UnXuShCvjSMgBAgVNMy1oakxCNk1et27A82fywU112,6317124,12653689,-6336565,294
2022-05-08 13:38:43-04:00,19083,5iRLEmB6qBHqkJBPyyubnd9f1TpRr4EY8BTxuHUREeLB,GkY73KL6HJ4ycdggFtYWALBgmTRZVCx66P2ZJ7E8ENwC,False,11886,11886,358,17,341,C4UnXuShCvjSMgBAgVNMy1oakxCNk1et27A82fywU112,358,17170,-16812,301
2022-05-08 13:38:43-04:00,19084,3zVmiyif8VbqUW7dAeEMYJYrg8r5pCeBfALsdgu6kgFJ,FwzrxNbJsiCQwqayaDhwkbm9TRG11bK6fWs5Dn75da9a,True,175665411,43916352,128096,64048,64048,C4UnXuShCvjSMgBAgVNMy1oakxCNk1et27A82fywU112,5123876,70157323,-65033447,291
2022-05-08 13:38:44-04:00,19085,C1tcxAjMzZaFVcF2ke2nSyiCjcLBwsz5yKXShy5MB14h,GYkrJj2zHVZuzPC45MbuevYkRJHdeL4Sqj9SWqZfUdiE,False,728288,728288,21966,1098,20868,C4UnXuShCvjSMgBAgVNMy1oakxCNk1et27A82fywU112,21966,1015881,-993915,301
2022-05-08 13:38:45-04:00,19086,BrHRMouGRz3LBNzd9anfdYMhWfg8yUPHL4PqJ8WdEDFS,4uzoLa3mC2VYHAPBoHLX4gTjPTC28rPf2fvEGtJWPYc,False,1766,1766,49,2,47,2a35JJeTUW1pm6M3e8DHCjp8qr4vbc2cRPhuzZWyFzYd,49,3705,-3656,277
2022-05-08 13:38:53-04:00,19087,gwRpwn2swQgwyJ7ijihN1aKNb1LtsvJwWpWkGc3ttEc,HT22Au8YZoja3ijYVuxEwSZdve73yrp1NKczv4vGbzrL,False,121890,121890,3583,179,3404,47z82br5WdW2DZajdnPDPSSRRKsyAggqXqK6oPUwTaLf,3583,48219,-44636,293
2022-05-08 13:38:57-04:00,19088,3pRKRd4i6jepz5HPbSsSFj2YKwYBjgVAk2v7ZMBYZVNR,Fzf7Gx6KJam5A1eny5G49cRS2zZHFt7XMxCx8N1Ej2Jd,True,107752599,26938149,79879,39939,39940,C4UnXuShCvjSMgBAgVNMy1oakxCNk1et27A82fywU112,3195180,43084647,-39889467,296
2022-05-08 13:39:02-04:00,19089,9BMHbUs4d3qX49fnroHv2FTPDs4yoDFrvDMqf8p9U4pE,2yL7zwMr7qVG5Sdwkf7z6ppnNqt1ASppBbmxwYjfFY6Z,False,216117,216117,6287,314,5973,47z82br5WdW2DZajdnPDPSSRRKsyAggqXqK6oPUwTaLf,6287,312915,-306628,290
2022-05-08 13:39:06-04:00,19090,Bt37YbHvD2M8zcGmanksKy8MCi4Qzto7hEnGRJyNvWyg,4WGRnDhpoY4zJi74iJyALasETpJNJMCJtf9aWJUVrHQv,False,17769195,17769195,538343,26917,511426,C4UnXuShCvjSMgBAgVNMy1oakxCNk1et27A82fywU112,538343,15324123,-14785780,302
2022-05-08 13:39:12-04:00,19091,EPWsutEpgpcz776maq552k8QhDKdmkSfAED5E3jgpTdY,CCwGZYDvqoHEBBtSSieAJgy5e3k4jYrpjyDffypwnWxu,False,578777,578777,17255,862,16393,47z82br5WdW2DZajdnPDPSSRRKsyAggqXqK6oPUwTaLf,17255,810092,-792837,298
2022-05-08 13:39:16-04:00,19092,E8iuHK2DErFnMAYfWmNoix4jVb4WDG8Sc41hBycLUxbd,77Zoru23JmnK5EJ8eURonQoEpJcLP4edabjD8MR8NKdX,False,215862,215862,6456,322,6134,47z82br5WdW2DZajdnPDPSSRRKsyAggqXqK6oPUwTaLf,6456,311996,-305540,299
2022-05-08 13:39:19-04:00,19093,6Z6y2QLJUZ5s6zdjanJcKprTAotx8tqr9DRNqqycMeS4,JCYwt8MHVaBb14GB2qAvDWwYVMaL7VTxyNEt7Eo5Zy8x,False,11404,11404,336,16,320,47z82br5WdW2DZajdnPDPSSRRKsyAggqXqK6oPUwTaLf,336,16477,-16141,294
2022-05-08 13:39:20-04:00,19094,BMawc4jLJMER4ryGcwdm27H3MU8JQCiSfwb9onVfYDpr,5ciaGDuaB3rBKvV7MphT2eMkCUxBzWZc7zYXQM7vbQ46,False,81833,81833,2438,121,2317,47z82br5WdW2DZajdnPDPSSRRKsyAggqXqK6oPUwTaLf,2438,115093,-112655,297
2022-05-08 13:39:21-04:00,19095,446VESPwhh16pG3VcpgraT83MoqWy87qgU36mKZC8BsW,SmUPkPpnnRfSH3tcKUnbpK6HHNJtLfvMiUWk9eUwkNy,False,575271,575271,17083,854,16229,47z82br5WdW2DZajdnPDPSSRRKsyAggqXqK6oPUwTaLf,17083,805138,-788055,296
2022-05-08 13:39:21-04:00,19096,9rgrRAMcGSarfz8xXckw1LjkemMwwjzJLApPjpfY2XZ3,BRtNdDDtCiNDYDERZTBCefUiYvjShucRX1hxEBLyeggT,False,10990,10990,328,16,312,47z82br5WdW2DZajdnPDPSSRRKsyAggqXqK6oPUwTaLf,328,15886,-15558,298
2022-05-08 13:39:22-04:00,19097,EB5HH1VyFu2XrwMArCsDer8tGysBYyx9NHtpPGhma2K4,BoYdgR6GHMPghAQZVeahdFkCZW3xsuDsUZks7wetb9nD,False,44634,44634,1341,67,1274,47z82br5WdW2DZajdnPDPSSRRKsyAggqXqK6oPUwTaLf,1341,10950,-9609,300
2022-05-08 13:39:30-04:00,19098,73PpLzJmAimmqtjGpRcYHua8t6wx3gYiiXFvQxnSDMJV,CRCpLcS8LNKX22co94spJBXEes9Fnh5rYBvbVEte4JXA,False,1634042,1634042,47758,2387,45371,47z82br5WdW2DZajdnPDPSSRRKsyAggqXqK6oPUwTaLf,47758,2137624,-2089866,292
2022-05-08 13:39:30-04:00,19099,43EtYHdVkdBxHTtFR3QWVgvCKj1SqsAf7xLY2yphsv1x,8WJbP4mVJWYuN1dVzHpRg7YR2nBELB4Krkq8Zch8sp4g,False,17025,17025,511,25,486,47z82br5WdW2DZajdnPDPSSRRKsyAggqXqK6oPUwTaLf,511,23069,-22558,300
2022-05-08 13:39:41-04:00,19100,4vyDdNpAy92raa6roc12PdabWyqKLgKsrGGVpHaSCwPg,6hzYoxgC3ZHqhdmkgmudaVe6o7hmvThKqzPbH3xtFGF1,False,45853,45853,1338,66,1272,47z82br5WdW2DZajdnPDPSSRRKsyAggqXqK6oPUwTaLf,1338,11875,-10537,291
2022-05-08 13:39:41-04:00,19101,GcjcaWoMUcGkLaJBx3svxtzwGNn5SLcFrwaLqnpadUZY,Ep9sDjTMMasVjKdshsE88uk3mWYkKuMTVRooVJWvCq9F,False,211588,211588,6303,315,5988,47z82br5WdW2DZajdnPDPSSRRKsyAggqXqK6oPUwTaLf,6303,305644,-299341,297
2022-05-08 13:39:41-04:00,19102,HXQXfEQe7aCpr6WKh37XaDZsjZcuQPk5t8tWNFgEoK6U,5ufXkCEDwgiXwtyPye4wYVVA3oLW54JVzz4tnXFofto4,True,2020502754,505125688,1526065,763032,763033,gjBMZYVujDjD1ECG4i97M8Q3gV9ESnwwTSUGropkusj,61042617,814838247,-753795630,302
2022-05-08 13:39:44-04:00,19103,BAkPsWHtpVcEGqUgKTKjwZ6d5aaUcaUhdgYxBnpSTDW2,BDwDmVaZnXh22sf8nsDtjVfgxMAswbM3PW3si3k4nbRK,True,446516038,111629009,337150,168575,168575,A9TwRM1BMxqb8DCC7YNAMV6zPenEJm3HTZBy7wJKK58U,13486000,169862371,-156376371,302
2022-05-08 13:39:47-04:00,19104,95urWGJ4HN1bTarbDi8Dpj4K4ms7dovs8gwaYdaSLC6e,2THhqxjhXjp2Zui9ML2MzAbGN4dsfa3dkdqzC8LYhnbQ,False,20366,20366,603,30,573,47z82br5WdW2DZajdnPDPSSRRKsyAggqXqK6oPUwTaLf,603,28609,-28006,296
2022-05-08 13:39:48-04:00,19105,BEuVsj9KuYBTaxrLpKwrQtHxmhRtB16siNfPXsAvf6rz,BTjWitiLbteuKMzaFj1daYyM2v9rZygESDktu8cuzC8g,True,123803793,30950948,92719,46359,46360,C4UnXuShCvjSMgBAgVNMy1oakxCNk1et27A82fywU112,3708764,12927224,-9218460,299
2022-05-08 13:39:49-04:00,19106,9T6bCVf7AshQP1NNbsF3eCdbChKbcfrFUPFWUXRijY5M,4ZFq3kdwaUhiotXCXzDFjVCAP3udzGsx5CicgLLXd4PR,False,7813293,7813293,235267,11763,223504,C4UnXuShCvjSMgBAgVNMy1oakxCNk1et27A82fywU112,235267,6746066,-6510799,301
2022-05-08 13:39:53-04:00,19107,5zCfNUARbvDrkdkf8rKNnf6D7HXn7Wz6D61jQGTGpw3N,6T76MLTxS5vnRuodEgADt3iXMx8WUFLQzoyKh7f2uPFy,False,25193877,25193877,756250,37812,718438,C4UnXuShCvjSMgBAgVNMy1oakxCNk1et27A82fywU112,756250,21862847,-21106597,300
2022-05-08 13:39:56-04:00,19108,Hqzz5RdbkkmMPCVdxF3Q3sLuh7XVJHEwAP6zpz7pCwTj,TNwXSETgrJGM9S5zbBY3mMWKbPFskbKjPAhBrWFNfuK,False,12440,12440,370,18,352,47z82br5WdW2DZajdnPDPSSRRKsyAggqXqK6oPUwTaLf,370,17924,-17554,297
2022-05-08 13:39:56-04:00,19109,4yhW5mBsFVNgQ5QQc2Yg65guctPsTSXcERbzmYM6rdnL,5uJnMZ6DWA9bMSvHvS5zomwtt1sv7YCWq3GDJh77YC3q,False,13689,13689,406,20,386,47z82br5WdW2DZajdnPDPSSRRKsyAggqXqK6oPUwTaLf,406,19828,-19422,296
2022-05-08 13:40:09-04:00,19110,9wsQcvpqPp8c9q42RntWDNbqNCnmJeW4GMG2AtKAHkBu,EMqRbzGvXTU1LtmoSw9uSrpTX2L4tpJQAMJJJ4duvzf5,False,1975004,1975004,58686,2934,55752,47z82br5WdW2DZajdnPDPSSRRKsyAggqXqK6oPUwTaLf,58686,1706210,-1647524,297
2022-05-08 13:40:18-04:00,19111,5FgPU7KpsDnx4Xc1UdQoLPR7MDd5cBkJXW2Q8ctopMZR,9GWzAZFVfTY8WjTYvDAE2YcAjgeKiDXgToK76KBZF7Rv,False,18399,18399,550,27,523,47z82br5WdW2DZajdnPDPSSRRKsyAggqXqK6oPUwTaLf,550,25801,-25251,298
2022-05-08 13:40:19-04:00,19112,4eaXYcx5ayhTq9TmmQFgLDjy6p3z93txUN97v8PTSh1J,J3vgUnjDUy5ngrmrs6FwpZTexxJNxXM1UjsHvsgw9g9y,False,13919,13919,416,20,396,47z82br5WdW2DZajdnPDPSSRRKsyAggqXqK6oPUwTaLf,416,20100,-19684,298
2022-05-08 13:40:40-04:00,19113,DD1a8rMoUCwmEiLKRN43VpdqL8Qgfr5yi92ejQxDVRMo,3vMJVNAuyRhM9jkaEZARhwbR6MerR5UmcgoZ9c5bs1VS,False,254624,254624,7582,379,7203,47z82br5WdW2DZajdnPDPSSRRKsyAggqXqK6oPUwTaLf,7582,367949,-360367,297
2022-05-08 13:40:40-04:00,19114,EmXaq1sxmAZUiwYW6LXpKtKFZXu5MzQ3sK4MEAojDK1h,HuAsa5G2wJi8Ah9stxEmggwcB5zW1QjBsP3Ndgke7r8X,False,18633,18633,563,28,535,47z82br5WdW2DZajdnPDPSSRRKsyAggqXqK6oPUwTaLf,563,26870,-26307,302
2022-05-08 13:40:51-04:00,19115,DMgD2KCEhTGFLUZ5GnfNcwfiiwKYbyVpoWiN6knMkCAf,5KU2vgBkPTNVHsSULjgX7ZkZS56U3Dy3xqLTxL5sUZJ3,False,76288,76288,2207,110,2097,47z82br5WdW2DZajdnPDPSSRRKsyAggqXqK6oPUwTaLf,2207,132828,-130621,289
2022-05-08 13:40:51-04:00,19116,43wwd6zLB8yKfXEu7rtbeDFhKBuxFR66MnyhTKW3zqa3,A9t6AMvVNenwWymz3QMtdUuuGYjjTPLaA9bhRjTzNY9h,False,216827,216827,6328,316,6012,47z82br5WdW2DZajdnPDPSSRRKsyAggqXqK6oPUwTaLf,6328,313250,-306922,291
2022-05-08 13:40:58-04:00,19117,s3MwEMLs777XFqetPJT55cw8NYXg8uHqr6Bnxdvq3bE,GN2D9JsJ8oXhSHXTvvWnoXDfv8JLVYx3ZGNwjAV2Dd3j,False,917207,917207,27606,1380,26226,3zqXX6kzhkbW3d4TwD2CNjMRwxTbREXySekvq37kfCNk,27606,299300,-271694,300
2022-05-08 13:41:03-04:00,19118,5zqXqEjg95BnghcVbHRhYkSTYnzZjUBichgccv1BpS3d,9SuqSxrKpHh9NcNePe4Q3jXvpCmhNnoQv8YAFih3CqMX,True,70812264,17703066,53589,26794,26795,C4UnXuShCvjSMgBAgVNMy1oakxCNk1et27A82fywU112,2143568,28464009,-26320441,302
2022-05-08 13:41:09-04:00,19119,58EpnDFZvzpSqs4YjpCHAmuXigCxvk9bfGDFos5cPjjB,HBNacFRqXrbRzVD72sRSzVXyCb6zDntS7YzgGJMuVmPh,False,5337,5337,159,7,152,C4UnXuShCvjSMgBAgVNMy1oakxCNk1et27A82fywU112,159,1585,-1426,297
2022-05-08 13:41:10-04:00,19120,EHi1UBG8wMUFZECktsFUZkGjJPaBNEedswS62hyYn6jC,Drx9ErQhAjnPuJ83LPYFnY5ZV5XDzGuXDuSf16VqWayp,True,1505947651,169039595,611053,305526,305527,2xTUy2RS74GJMMDnmFaegMzFLn19RVfYG4CibhBmjP1i,54437815,931076826,-876639011,361
2022-05-08 13:41:11-04:00,19121,BTds7W9qPzLihhoWt6vX5paepTtZBeDvSbeqbvDRuUMP,6dZH72G6AerkQybAFyaPqYdYeHofkSnZbciBGsqF74hk,False,101367,101367,2889,144,2745,47z82br5WdW2DZajdnPDPSSRRKsyAggqXqK6oPUwTaLf,2889,31342,-28453,285
2022-05-08 13:41:12-04:00,19122,8xjstKJD2RopRxxRP8JbMYRmpBKgSZivMFRXXRZ5syPh,HUfevkvBsm5SDpxnZ4NBD8Re7LvqBQLrx5UWXCeYTBgK,False,20581,20581,589,29,560,47z82br5WdW2DZajdnPDPSSRRKsyAggqXqK6oPUwTaLf,589,28941,-28352,286
2022-05-08 13:41:12-04:00,19123,2AAWghW6BUAFBtF3R6hB9uoqMc5oUDkU8FTd2JrXKema,798cfEUZ2YhXwNTNjXMS4Z2J8gAHaK4zZwpMkq2HzWWM,True,74828869,18707217,55791,27895,27896,C4UnXuShCvjSMgBAgVNMy1oakxCNk1et27A82fywU112,2231650,76618212,-74386562,298
2022-05-08 13:41:12-04:00,19124,EVMrznfJS54BZiywDD2WhUtxzicDtbEpm2a5yLrtCgRF,CpzsMYVYvKg8ihrX1cKRw7TDEYwD3kAyiX92hsf2KiTz,True,1224159801,82197615,372333,186166,186167,AmTrMPzuTp2BjnjqGNKqz9FTTCdpoKcPAJLwFc8ozcbh,55451193,741596473,-686145280,452
2022-05-08 13:41:15-04:00,19125,Fw2e6jxKVeFcJSe9MyVhSz3dUdJQLs3XULHrT1mtMU9U,591U5bexgLRJXygtK5fpCRXcZEq89KgewFTdfPkti8bY,False,1643531,1643531,45283,2264,43019,47z82br5WdW2DZajdnPDPSSRRKsyAggqXqK6oPUwTaLf,45283,2155683,-2110400,275
2022-05-08 13:41:15-04:00,19126,HZSJVNb6g4o52N7pAJCLkGjur8evF5Ex1sAx7uUxUDdm,8LQHKhXStrwcd6f4AxaTVcrGdYpGjQz8vWf5JXsAzcsp,False,15970,15970,449,22,427,47z82br5WdW2DZajdnPDPSSRRKsyAggqXqK6oPUwTaLf,449,23153,-22704,281
2022-05-08 13:41:15-04:00,19127,HpRYrL8HzCPaBJTLFgZmYg2aXBnBQUpf1mikVkzkY56z,8DzHRd8qWcEjnX6cefwYtgRGpQJUaw9QPjyfAsN7j33r,False,141693,141693,3992,199,3793,47z82br5WdW2DZajdnPDPSSRRKsyAggqXqK6oPUwTaLf,3992,200536,-196544,281
2022-05-08 13:41:15-04:00,19128,6Gx7dYXVEaUNVimG7ou6MTzqMYvS2BRUqydmAWVaWiqw,E9oA5LP5kQEXaiEhU3mEj1Wfmt9DDV28X9NHNDx6Z5Wd,False,27520204,27520204,820697,41034,779663,C4UnXuShCvjSMgBAgVNMy1oakxCNk1et27A82fywU112,820697,8684716,-7864019,298
2022-05-08 13:41:16-04:00,19129,6fqbSyhh3PPdgRcLraHb7Jahj9s1oHHeX3SsjNSsGa6t,GpRUow48TYgttdYfsygbgjYQcmHyYjWETUDjDVphEgwq,True,99453896,13937178,41433,20716,20717,C4UnXuShCvjSMgBAgVNMy1oakxCNk1et27A82fywU112,2956641,72058273,-69101632,297
2022-05-08 13:41:20-04:00,19130,Gwj6CMXQeoWVsmD775Knsm6BmWuysFvSKo78FRLQByb4,6cvChMYj7TfDcnc8hG9H89PABJr2svspqjJSdSGD4RUt,False,14274125,14274125,889718,44485,845233,2a35JJeTUW1pm6M3e8DHCjp8qr4vbc2cRPhuzZWyFzYd,889719,3090773,-2201054,623
2022-05-08 13:41:21-04:00,19131,A7j77tzgnQVGtHTa65VtVZqJRYeJvQk7am8NW6e66379,4vJGwEvXU2tGWoWWGwbsYcfKQAMCHbrBMRk4ZVFzneLs,True,1618863582,404715895,1212593,606296,606297,DQCvC9mR68hJ3tJsUiddh6JwcBJAmntqGJR2nUsEq7yj,48503747,432270747,-383767000,299
2022-05-08 13:41:23-04:00,19132,EAUFD16wab8qRMJ4H6updHGt4xFqgRCDeRHVCsLCTSTL,8vkfYSyCyBY9g4TZrp52jUcQj6udy9xAaA4fioRE2RXx,False,8337096,8337096,237244,11862,225382,C4UnXuShCvjSMgBAgVNMy1oakxCNk1et27A82fywU112,237244,7483938,-7246694,284
2022-05-08 13:41:24-04:00,19133,Eps7NSYQhiSzaTpTLzx5aoDykXSKtQ6w1JBFuucC8hQp,EeNkTwr26mYEBqYHqoHaBZfybPS2PwcbJsgmQGJY6g89,True,144659653,36164913,108087,54043,54044,C4UnXuShCvjSMgBAgVNMy1oakxCNk1et27A82fywU112,4323492,58081379,-53757887,298
2022-05-08 13:41:25-04:00,19134,9PhhcWBFRZin6HDmEPzngPgGMd6DrnWpiopAhVGQ9Mpm,3qAx8SsRYqkNdwLtZDdUXDerAmkaib1sbfPNVu2nPmBK,True,47135001,7800264,23021,11510,11511,3zqXX6kzhkbW3d4TwD2CNjMRwxTbREXySekvq37kfCNk,1391197,14151196,-12759999,295
2022-05-08 13:41:26-04:00,19135,CMVVfXQYALSc58NLD67L8YrJAbDHZ9rFZvYQC7r8Png4,44pytMX14zaEQv6aRQ223CxYB2uTP7VUTQfUY58EkaNB,True,485804309,121451077,360387,180193,180194,2xTUy2RS74GJMMDnmFaegMzFLn19RVfYG4CibhBmjP1i,14415514,196250879,-181835365,296
2022-05-08 13:41:26-04:00,19136,AiLCB8xw3k5FXdJE1T42PLFhHrz1bLTKpNekR61a915N,HB7CNWxLipWAc6MPGq9wV4TT7AYjiELA5T3onYeVqBbU,False,279690,279690,8125,406,7719,C4UnXuShCvjSMgBAgVNMy1oakxCNk1et27A82fywU112,8125,407014,-398889,290
2022-05-08 13:41:28-04:00,19137,6X5por58mMECmNZQEWpo8M8aA1eHJqr5LNeV9vC7GW5e,DPB2C5UB2Ls1kNzbs1GP33junQvhUyFJWP75RoYjqByn,False,741473,741473,21008,1050,19958,47z82br5WdW2DZajdnPDPSSRRKsyAggqXqK6oPUwTaLf,21008,1621850,-1600842,283
2022-05-08 13:41:29-04:00,19138,HCAGpyYM2NYudMd55Geta13tUbS6eiygnJY5ULHsHAVa,3PPyWhqXrmifWPieLV34bZ1rzi8eEnrDDAF7ifXkXspn,True,26841854,2135983,9099,4549,4550,C4UnXuShCvjSMgBAgVNMy1oakxCNk1et27A82fywU112,1143462,13068689,-11925227,425
2022-05-08 13:41:29-04:00,19139,68F35fonSGS1P6LMYmAmeoM8kC6Z78NabMqYLeCZr9GJ,8apmWSZdS8s1ScoNVj4AvSJsbQCj1drU3HL74khuANT2,False,14792,14792,418,20,398,47z82br5WdW2DZajdnPDPSSRRKsyAggqXqK6oPUwTaLf,418,21380,-20962,282
2022-05-08 13:41:31-04:00,19140,HGJoZvLakWfSDFwuvShNBc4kCf7nP7VqzyM3mELpbFEf,12Qn5jin7QvsBngXqYAv4UstyG3b6nRf1jsLp9Dp8G7k,False,866,866,24,1,23,47z82br5WdW2DZajdnPDPSSRRKsyAggqXqK6oPUwTaLf,24,1287,-1263,277
2022-05-08 13:41:33-04:00,19141,FU3fRyQxk6rwtD9Db1nTvTAjSwgSW9vi1q7SjZ92ijyM,7c3maBK3hpb1exxqcvnwiUfhhUBgLgCs5exANSZ7m494,True,626550514,156637628,463260,231630,231630,2xTUy2RS74GJMMDnmFaegMzFLn19RVfYG4CibhBmjP1i,18530421,58334017,-39803596,295
2022-05-08 13:41:34-04:00,19142,Fczxdc24Eav8xcaKRDwWMEwPEzkGyEJ7qGcXYyGZFKVz,8GqweYpec4cnpaJvueF3FGWoaz72BAzpLYXBX7tuuqEt,True,158849427,39712356,115543,57771,57772,C4UnXuShCvjSMgBAgVNMy1oakxCNk1et27A82fywU112,4621756,108364742,-103742986,290
2022-05-08 13:41:35-04:00,19143,7afnF1MkAootZGWc7zsMVLpBuve83hGmvAHkfmwgsq5A,HKdJE8bReznq1Qxqd5iZ4nWQGCk62Vo5TpkRD51bpbGp,False,14280,14280,396,19,377,C4UnXuShCvjSMgBAgVNMy1oakxCNk1et27A82fywU112,396,20657,-20261,277
2022-05-08 13:41:35-04:00,19144,6xMkac8utsZoLQDLDmvEuXXsxYe5iRnXchYuCzbfVyyB,2uk7QcYFW8W75dQZBoaumUGCAuhLsu5Z1CAunWxrfGXT,False,4471033,4471033,127402,6370,121032,47z82br5WdW2DZajdnPDPSSRRKsyAggqXqK6oPUwTaLf,127402,976852,-849450,284
2022-05-08 13:41:35-04:00,19145,28YQqynu5oRud5xEcsDvAaGhJhgpiVJSTNeMwkrbpbyv,9zYqRWiRatbohCdBfV3PrAxp8v1kwgbvV9ta4RJRRp68,False,564925,564925,14716,735,13981,47z82br5WdW2DZajdnPDPSSRRKsyAggqXqK6oPUwTaLf,14716,793670,-778954,260
2022-05-08 13:41:40-04:00,19146,ymyzGH4Qc7HH5PbKpVphCbsQgLLXyGkPcXamQJuNj5C,8oTLHaV2XzbKXNWRuUjCfHjUn61Pw93LYK14m9q2VDpZ,False,734,734,20,1,19,47z82br5WdW2DZajdnPDPSSRRKsyAggqXqK6oPUwTaLf,20,1002,-982,272
2022-05-08 13:41:41-04:00,19147,Hkc6fny4GVzErYtfZiHYK995QLoWSfrNutYo3La78cRc,B8ZbsieWAkXEKBiXqzpwjhHTxFC42N1ddQp4jxVE8mra,False,2225943,2225943,61135,3056,58079,3zqXX6kzhkbW3d4TwD2CNjMRwxTbREXySekvq37kfCNk,61135,532745,-471610,274
2022-05-08 13:41:41-04:00,19148,6Y7FZTyXEwKHvoYQGDnuZShg8YFgZUetGt4eoBpPPp7E,2dkDLHmDZKUA96PPUvkz6s4g1cMeJfaF5t68VexgooFo,False,234917,234917,6467,323,6144,47z82br5WdW2DZajdnPDPSSRRKsyAggqXqK6oPUwTaLf,6467,74202,-67735,275
2022-05-08 13:41:41-04:00,19149,Gfe4UgUGqvzcehSbETrWwLRAcqzFnkTrs6vJx8h6kTxi,7exMQ8sLti4Pmb2ZQtZhyuWRuQ6pq7XSXL9sCcWTqCvF,False,1127400,1127400,30524,1526,28998,47z82br5WdW2DZajdnPDPSSRRKsyAggqXqK6oPUwTaLf,30524,1607631,-1577107,270
2022-05-08 13:41:42-04:00,19150,CEtpqFD4BbeiNfaXyLLYEapY2mWgE26H5q6H34tWwRuD,BVqRyqwGFPzSkk1H2finiyfaL3LScbEiQGk3mihirxqs,False,10215,10215,275,13,262,72FwbpFGoLEazJEdpqNtPNefsadUrimUqma9wSoy4qiS,275,14611,-14336,269
2022-05-08 13:41:42-04:00,19151,3R2wxFQwjCqUwwxJmp9tNrT6osYFpB5gczq2QYik6QYm,7At5Ej3ZsynfWr56FYrd4P4Y6UtD8FHA4gCFB8TaAyaG,False,13911,13911,391,19,372,72FwbpFGoLEazJEdpqNtPNefsadUrimUqma9wSoy4qiS,391,20134,-19743,281
2022-05-08 13:41:43-04:00,19152,AzLdwyd8Q4V3iMaSwWgvWwQ9nCs7X7YV2YKpd6CH33nP,BYjeXF5YkcJy3mNMbvfHzXTtyjkc4U53hM5tvfERUH8y,False,13823,13823,385,19,366,72FwbpFGoLEazJEdpqNtPNefsadUrimUqma9wSoy4qiS,385,19965,-19580,278
2022-05-08 13:41:44-04:00,19153,6kt64nJRnYaWMi9GbpZaUuhbToAVRd7FUMTGASAAJrve,2Sdxv9ZtogNcVbJwBPxKmVjwAiKyX5GHEfnRmFcydQ1G,False,1614063,1614063,44268,2213,42055,47z82br5WdW2DZajdnPDPSSRRKsyAggqXqK6oPUwTaLf,44268,2122415,-2078147,274
2022-05-08 13:41:45-04:00,19154,HxhVxMpFpKzeuC6Z6CpsuUhPHdHUzvpMNYJ8LpQ3NYCp,8KyiipC39iU15zVErVvj6hdhbv89STsexrB8dVw3RcLs,False,14568,14568,407,20,387,72FwbpFGoLEazJEdpqNtPNefsadUrimUqma9wSoy4qiS,407,21108,-20701,279
2022-05-08 13:41:46-04:00,19155,GZR24Tu8n2se8vXBZjM9JHNMDBT3X5XhQ9YwsLe63b7v,8PUFWns1xA6uTpZeBBzhA6bnzBQVTg5JgbRtgsEhdyw4,False,28928281,28928281,870725,43536,827189,72FwbpFGoLEazJEdpqNtPNefsadUrimUqma9wSoy4qiS,870725,7430610,-6559885,300
2022-05-08 13:41:47-04:00,19156,oTq8BsGLNc2ddcdR7ELnCXgzf4KvtA7REmfbFKo56FT,4PgxGgi2UaB753PFyELQCrJy7phAkYsW4e39J9wGWrcM,False,873585,873585,24818,1240,23578,47z82br5WdW2DZajdnPDPSSRRKsyAggqXqK6oPUwTaLf,24818,1966920,-1942102,284
2022-05-08 13:41:48-04:00,19157,HZJyrD4eqM4nKnyRh2JAs1sC2TaJxFhNPixBdK7PLMuS,Hycz71z4tEsKUogJnefT2GN3MPCLdTJdv9B6T82Ngw2u,False,59848,59848,1679,83,1596,47z82br5WdW2DZajdnPDPSSRRKsyAggqXqK6oPUwTaLf,1679,87163,-85484,280
2022-05-08 13:41:51-04:00,19158,6bMu9G5S9o2CSgHegDAymE4UcxrnKH9UfPE5iUmUJ6Aa,ACG6V3LfAH3JtJbBhiumrx7c4QciavNmGWKfBFt7eRz7,False,861943,861943,24608,1230,23378,47z82br5WdW2DZajdnPDPSSRRKsyAggqXqK6oPUwTaLf,24608,498841,-474233,285
2022-05-08 13:41:52-04:00,19159,2DHhfXSzcuSwsKfAYLMuWuD17w84mCwNer9fcBNLTpSc,89BVfDycKjdSkQzFVqCXd5c16DntdND7WsqoZtCafYFH,False,665335,665335,18339,916,17423,72FwbpFGoLEazJEdpqNtPNefsadUrimUqma9wSoy4qiS,18339,938475,-920136,275
2022-05-08 13:41:53-04:00,19160,Dqnxcekm1QfxGQ2FSJ6SjFiwmaQRWEjW9WTJQG4AjEpE,9JiMtjm5AJqngosRg787FiN8NyuBPuAPD2jYpRQkAc1d,False,18118,18118,527,26,501,72FwbpFGoLEazJEdpqNtPNefsadUrimUqma9wSoy4qiS,527,26188,-25661,290
2022-05-08 13:41:53-04:00,19161,GM22yjVoBCzgBcVTT5EcgRhVWiXVV82kSj1dPCbegKWj,CDDy8JmJMwJyx1YAvEPpj8AYxCpngRovf3wWfVzao5Rc,False,8225,8225,242,12,230,72FwbpFGoLEazJEdpqNtPNefsadUrimUqma9wSoy4qiS,242,7063,-6821,294
2022-05-08 13:41:53-04:00,19162,8GdYhwX26GRmVfGFCbJ3MJrH1UdneN2FNRUexhLsqprN,DpUTHSVucDPyCWoLCdpm8EFRZFiKL88tmnSiWG2TRpS8,False,12439,12439,338,16,322,72FwbpFGoLEazJEdpqNtPNefsadUrimUqma9wSoy4qiS,338,17971,-17633,271
2022-05-08 13:41:53-04:00,19163,69byqtDPmgEY1NqKBCR95CEPVHRUxgbNW9Y4P4HjQ7ND,E47T4q4zMGzNL6vDxgWdLn3EQbW3WfVryr8Jsymy1hAL,False,22963,22963,640,32,608,72FwbpFGoLEazJEdpqNtPNefsadUrimUqma9wSoy4qiS,640,30590,-29950,278
2022-05-08 13:42:00-04:00,19164,G8nRLTWTT5aD7q7TcSa2mw7p12GUuHDVq5ev4vyXbdKi,3DmQyungZMK4T1a1PgXh5shBskwP69tTLmZPh7HZ76vh,False,20327,20327,575,28,547,47z82br5WdW2DZajdnPDPSSRRKsyAggqXqK6oPUwTaLf,575,29357,-28782,282
2022-05-08 13:42:09-04:00,19165,9hB3EPuj4SrSrpAzHvExDb6mzh2vNGGVbj7qqfRjeao4,9725jRXGPRUuo1dijvv8mwzvSu1ed4y5hi9FAQNwb8dG,False,236466,236466,6975,348,6627,47z82br5WdW2DZajdnPDPSSRRKsyAggqXqK6oPUwTaLf,6975,341278,-334303,294
2022-05-08 13:42:11-04:00,19166,9QZvB1Gqhk5PKt3MoJMjZL3FaU2bTbTDcVw3nF316zh7,DGJWGr9RCWkzdWn21mWG7NyUN8uuvSQbA53HojFJe1rH,False,179110,179110,5015,250,4765,47z82br5WdW2DZajdnPDPSSRRKsyAggqXqK6oPUwTaLf,5015,250249,-245234,279
2022-05-08 13:42:11-04:00,19167,8VQ21PFXdHBNmiZiF18LyGvsRSpr13vkyktfembNCe3m,5exbVC7vaGFeHEGAx7epYfMaU932QafqzfhFm5FKAq2H,False,12583,12583,357,17,340,72FwbpFGoLEazJEdpqNtPNefsadUrimUqma9wSoy4qiS,357,18171,-17814,283
2022-05-08 13:42:13-04:00,19168,45AiuRBbmupfwYXqsWwKHtmEWN8XNJDUSHwHL3b6PvHc,CfvwVkxYPP3jqK2dpAvSRFA1513E9ti84mEpYgtkzFUt,False,23645,23645,665,33,632,72FwbpFGoLEazJEdpqNtPNefsadUrimUqma9wSoy4qiS,665,33187,-32522,281
2022-05-08 13:42:15-04:00,19169,8YMEydGnQH9W5AEXFGquFkb1bcf3PcxiMvYBSMPXKJyQ,3CmWH8eYtkmHNisqMmMBLff6C6z6ZcSj38KoQ34DPUE7,False,10886,10886,301,15,286,47z82br5WdW2DZajdnPDPSSRRKsyAggqXqK6oPUwTaLf,301,14810,-14509,276
2022-05-08 13:42:21-04:00,19170,ANXYsUNpZ34dBt7cp6HEE7oi2pTKsbj7B5TeFHKPbHBU,2pqeP4fuMREosHcfWUecEBssp1GM4isihNjn7ALUD51d,False,16930,16930,493,24,469,72FwbpFGoLEazJEdpqNtPNefsadUrimUqma9wSoy4qiS,493,24448,-23955,291
2022-05-08 13:42:21-04:00,19171,AECUZGm5DjFvbLZEUYhepSPg1Wa7hBjxF9e7ZRBzRPhm,Ar7e1iLKAqa54QiQnXifvnETixDZT1T8KL5YWJA8Ykv1,False,16848,16848,468,23,445,72FwbpFGoLEazJEdpqNtPNefsadUrimUqma9wSoy4qiS,468,24331,-23863,277
2022-05-08 13:42:22-04:00,19172,7qEVqFr1naSPCDV9q3xx6KMZn1yCHvkHZJkaA46NLmSE,8Mohcixq2L9PYrHpb95vuEsXqJ18JhEHi3RA83VM9cLv,True,402990160,100747540,296739,148369,148370,A9TwRM1BMxqb8DCC7YNAMV6zPenEJm3HTZBy7wJKK58U,11869587,130069070,-118199483,294
2022-05-08 13:42:25-04:00,19173,CygwJ5Z1ZP6xfjN1ZGH7yw8b2oYvf6JTpenXx7A5yFdt,59VKgJtBCTb3Pji7BWtqttisBYVVCnWtyEn5Eba5r52Y,False,241338,241338,6334,316,6018,72FwbpFGoLEazJEdpqNtPNefsadUrimUqma9wSoy4qiS,6334,328717,-322383,262
2022-05-08 13:42:25-04:00,19174,9WRDBHzD4aNHw5qvrhc6nqXCBLA5D7YYP8TvSrLksXd6,GwxWNmv9XDkqQsx7DfCMccFjVik8asPnFU9gtnb4UVx,False,10748,10748,288,14,274,72FwbpFGoLEazJEdpqNtPNefsadUrimUqma9wSoy4qiS,288,15573,-15285,267
2022-05-08 13:42:25-04:00,19175,8GhXRNmsEgFgKPhGNNgEPUywVzW3bE7uZRWys2P1yNeJ,Bvi5vD5fhRFNdVhEXsSv9vkJzyQzgEswFHBxowkUEgF,False,119794,119794,3153,157,2996,72FwbpFGoLEazJEdpqNtPNefsadUrimUqma9wSoy4qiS,3153,171987,-168834,263
2022-05-08 13:42:28-04:00,19176,kEstb9msKrdEaMjoEad819rcrobFGdiknwKxTi1Dw6y,5fgoHmS5JvLHxKc2rqTy9efcwGT92rgEs1eB12DtXvVf,True,56014105,14003526,41751,20875,20876,C4UnXuShCvjSMgBAgVNMy1oakxCNk1et27A82fywU112,1670050,10172480,-8502430,298
2022-05-08 13:42:28-04:00,19177,3u8kTzHN7uChpqJpH4WkMvBGxz7Rsg93EvB3k7dPf7G1,GWdMVk7p7EE1fPqfcyrVhcTsYXV6MoyV9bLdMYW45YQv,True,94561805,23640451,70167,35083,35084,3zqXX6kzhkbW3d4TwD2CNjMRwxTbREXySekvq37kfCNk,2806694,30294897,-27488203,296
2022-05-08 13:42:28-04:00,19178,EVoc9HuMgnTyrYjC1ySj3sYVzXccSPjupjgj69gMkuNQ,2ahbZJgSLSyppym6N7iyby3SvQcCzYrjdioGLAmhf7Y8,True,108734313,27183578,80823,40411,40412,3zqXX6kzhkbW3d4TwD2CNjMRwxTbREXySekvq37kfCNk,3232943,30930783,-27697840,297
2022-05-08 13:42:28-04:00,19179,8DSiP9CwJm3AEcH6uuAYFpArRRDLYpDQgjHEvjkUgfg2,ERJ8kuhPRRmUAhSM4oxUheh39YUVVYNgaTt6AdMXcCvL,True,59435075,14858768,43796,21898,21898,C4UnXuShCvjSMgBAgVNMy1oakxCNk1et27A82fywU112,1751863,23902421,-22150558,294
2022-05-08 13:42:29-04:00,19180,7tFD53kPTqrzjCu1Wji78gUqhoRtCUhsP1pM3DQKT7uG,BJvgPLYBDJrQJdQVowrsMwUGMurq4zTihoFwWoEokfu3,True,389656563,49586420,148654,74327,74327,C4UnXuShCvjSMgBAgVNMy1oakxCNk1et27A82fywU112,11681516,93327736,-81646220,299
2022-05-08 13:42:37-04:00,19181,4cNmhgaMic1xBiaDJ6phrQuXmm8WfF1qjyYMqZcKG4c9,43vgfXiLTtcs1bkrcDar2iz9M6RMbGqbA6BMkBHdh7T4,False,12983,12983,306,15,291,72FwbpFGoLEazJEdpqNtPNefsadUrimUqma9wSoy4qiS,306,18980,-18674,235
2022-05-08 15:54:20-04:00,19182,29JVska5UEG3axs63EmtHpPvkswNEqYpZ3PKMSfupiAG,DCftNBUsuogxyaJe9G9m3eWipH6o3qo4Rn4TuQXdVaBF,True,224535132,56133783,346807,173403,173404,6L1WYrPiCMyi7XemPww4B4hvpKD1LQKD4RpiSKmrmgSC,13872292,21817278,-7944986,617
2022-05-08 16:20:58-04:00,19183,29JVska5UEG3axs63EmtHpPvkswNEqYpZ3PKMSfupiAG,DCftNBUsuogxyaJe9G9m3eWipH6o3qo4Rn4TuQXdVaBF,True,171338064,42834516,265172,132586,132586,8sEswn3kzEhnYjAZVvCQnHEUvYd7pFVvc2Xc2Kd1BpbC,10606911,19504084,-8897173,619
2022-05-08 20:32:21-04:00,19184,29JVska5UEG3axs63EmtHpPvkswNEqYpZ3PKMSfupiAG,DCftNBUsuogxyaJe9G9m3eWipH6o3qo4Rn4TuQXdVaBF,True,130723860,32680965,203630,101815,101815,2a35JJeTUW1pm6M3e8DHCjp8qr4vbc2cRPhuzZWyFzYd,8145228,17039395,-8894167,623
2022-05-08 21:34:43-04:00,19185,29JVska5UEG3axs63EmtHpPvkswNEqYpZ3PKMSfupiAG,DCftNBUsuogxyaJe9G9m3eWipH6o3qo4Rn4TuQXdVaBF,True,99765562,24941390,155518,77759,77759,8sEswn3kzEhnYjAZVvCQnHEUvYd7pFVvc2Xc2Kd1BpbC,6220734,14614579,-8393845,623
2022-05-08 21:47:12-04:00,19186,Bzp3ZUxzRWqW4QoLq9PtKN1HQeSaKXFQrX1G3a4ocrre,H12B3p4v1ZtZ9gaSgpxCJsKXmmEjiqaRZQzexjzAhevo,True,2123331397,150094189,694023,347011,347012,AmTrMPzuTp2BjnjqGNKqz9FTTCdpoKcPAJLwFc8ozcbh,98181080,950852330,-852671250,462
2022-05-08 22:05:11-04:00,19187,3CPsqvzeuQAH1V5m3FDFDwNgGUPUHkU1q4jn781sPxWu,vbqWE3N9QXgEwwp4HVukJp9eyCnT33kVMAqCS9AMBxU,True,38780005,1905066,7966,3983,3983,2a35JJeTUW1pm6M3e8DHCjp8qr4vbc2cRPhuzZWyFzYd,1621698,12533856,-10912158,418
2022-05-08 22:05:15-04:00,19188,A6wyZoJuJa5iqpXwYHfTiRs1G3MMaXVroDxdED89EyJp,HBYgKE6Lt2zXyobSHEbUdNCWPoxkikEEJHae15C1xptu,True,52165830,2609257,10906,5453,5453,6L1WYrPiCMyi7XemPww4B4hvpKD1LQKD4RpiSKmrmgSC,2180571,16264857,-14084286,418
2022-05-08 22:05:42-04:00,19189,42h4NteqFpLjgjMS4gTTFoLvrEMpEP4sbGRd7SM5YCZR,AasJCLP5qsGzxkQs5jWysSarwoJTuZ6ZDeabNJNimWAX,True,8078978140,2019744535,6112448,3056224,3056224,DA18qE9qesbBqpwNv1M4befYcNQkbSBSeLPTmQzrmbJw,244497959,481758380,-237260421,302
2022-05-08 22:05:42-04:00,19190,BNEFSL7Mwtyq4ZbWaQB1UibDumKrqSbqkNVEYCJsMioH,GecT9hsySEeo6hHWed9UUkae2SYBjDCNGeC6R7UVK5Ds,True,52151146,2609624,10946,5473,5473,Hu94aiQWvce6THeGyCFqGRPM1pQrK3ihzkcXo1EpJcJL,2187494,16286503,-14099009,419
2022-05-08 22:05:42-04:00,19191,ETbDcnYMv5nwauExRwHHdHpChMBhD8FNgNszUE2CAdVx,2VEs3EouQ4fkdhmuehz7Jy7RW8LonkM3WpAVz7KfmydP,True,38745103,1919255,8042,4021,4021,8sEswn3kzEhnYjAZVvCQnHEUvYd7pFVvc2Xc2Kd1BpbC,1623580,12565278,-10941698,419
2022-05-08 22:09:37-04:00,19192,4Kr2N2ePqWvyDp9n5ey7MW8J34BvJYC3pcHzvEqRLjcU,H9DoqL8DddZiWRwusQQcS8vHmEGvkkukfiLf7r3Kqcj7,True,38891799,1834549,7642,3821,3821,6L1WYrPiCMyi7XemPww4B4hvpKD1LQKD4RpiSKmrmgSC,1620315,12416133,-10795818,416
2022-05-08 22:09:37-04:00,19193,3atA8mjJH2GxCpXxoiDsizEvPtJctaVDAfwyxj4koJmJ,5Sr5fFo455uSbM3nwKfvziPM9eaCarsJEhCa9wzPU8Ct,True,38895168,1832439,7624,3812,3812,6L1WYrPiCMyi7XemPww4B4hvpKD1LQKD4RpiSKmrmgSC,1618341,12410776,-10792435,416
2022-05-08 22:09:38-04:00,19194,36C7WZ1ufgJ5vSBPMpPVRsv4EoS9AsGAp5wx5LiRTvjx,DRBttFFwyyqZwK8fn5W1xc59iHxV7JZkR76d1DDnEng3,True,43062225,4105588,16643,8321,8322,8sEswn3kzEhnYjAZVvCQnHEUvYd7pFVvc2Xc2Kd1BpbC,1745701,13371211,-11625510,405
2022-05-08 22:09:39-04:00,19195,C6TnjCL81NkSp5GTkqPwzAwerpsGtnQzs8LqRAd7PMoi,66DYSdSzH8h5p6eeSZE3eZHXkuBC6EYjbGxHEqb9f5zb,True,38892489,1831727,7627,3813,3814,5HnvdJnCCcmRsm4GkXnYWd4q9RpwuvYDGEUMPkYR3Ts9,1619629,12414999,-10795370,416
2022-05-08 22:09:41-04:00,19196,2EcKNNHjAgZGnMhmRg98XGHFTAnM24gpAMsJA6FkdqHp,D6xW3oLCh9DP18E4wFNbVanbZyJUwhPVU3GsZEUEAjv3,True,38742829,1902840,7960,3980,3980,5HnvdJnCCcmRsm4GkXnYWd4q9RpwuvYDGEUMPkYR3Ts9,1620893,12565695,-10944802,418
2022-05-08 22:09:41-04:00,19197,Hyh93pAbHGME7rUUFPXXPJVUba1cjgJK6Udw2D8yW4nf,A8VCG5wfCEQGgUbwtjq2xh47RKbwaV7RvVuuj3C9bKPu,True,38751501,1903270,7955,3977,3978,Hu94aiQWvce6THeGyCFqGRPM1pQrK3ihzkcXo1EpJcJL,1619880,12555999,-10936119,418
2022-05-08 22:10:00-04:00,19198,HAiBRAw8ahBFB5WacCzRfycQgEYC53TJ1YmXBcHjFLmf,7hjAT4L9n7LY33YTvw79xngMfxsfv3bQkypRmBaDxMhk,True,38810149,1903263,7951,3975,3976,6L1WYrPiCMyi7XemPww4B4hvpKD1LQKD4RpiSKmrmgSC,1621388,12498863,-10877475,417
2022-05-08 22:10:00-04:00,19199,9RtNbEZ4ZR8T1HFF4cujPVy2kejVBKFo3CPQi8psSa1q,7zwaGb71jKc9y2HKCKy5q2XV2YUphkyU1hkDaab1GBas,True,52065451,11128819,33654,16827,16827,2a35JJeTUW1pm6M3e8DHCjp8qr4vbc2cRPhuzZWyFzYd,1574520,20822445,-19247925,302
2022-05-08 22:10:02-04:00,19200,E4VzeJLsf5Y6t3yNi8VpS8QxhJbJGPhnkNBmU2XoCBs9,63CXyYfevXtrL1QcfQtAhz29xeea5BwWcj6d6BWb4qiB,True,4397801218,1099450304,3320226,1660113,1660113,2py1FiYeL2f7J3HU36qiJz6TD6HCmiTN36RyxYtapQCZ,132809054,1784450543,-1651641489,301
2022-05-08 22:10:03-04:00,19201,93Jp2cnKVsSUcpoNEXmuq3K17MWt7JkW3jx6v5v2UAvN,5bos8dvpCKDxeYbXxRXwEdY8tAMZoL2XhNKUdFKxTrd6,True,40179805,7289754,28238,14119,14119,8sEswn3kzEhnYjAZVvCQnHEUvYd7pFVvc2Xc2Kd1BpbC,1556519,28857424,-27300905,387
2022-05-08 22:10:03-04:00,19202,Ai6G7vosJfmkRqtDAkqxRtbzELp6P5xe9r2RH3LYcLZt,8SUpKXakmhi4rYiFKnHYpgaAopomfDqEX6Efew9iM6nk,True,77789244,7159780,30116,15058,15058,8sEswn3kzEhnYjAZVvCQnHEUvYd7pFVvc2Xc2Kd1BpbC,3272069,44914245,-41642176,420
2022-05-08 22:10:03-04:00,19203,7YCSi1xGHn5j65W5cZPkQ9RQzvpNgCGdrafAGGTLYkjE,BdVVPyQgd93sMf1SDCFFMvyugNsbdkrVNgaQCJEGjTLC,True,57845877,3344094,14648,7324,7324,2a35JJeTUW1pm6M3e8DHCjp8qr4vbc2cRPhuzZWyFzYd,2533860,20688095,-18154235,438
2022-05-08 22:10:13-04:00,19204,Apqv5iu4bJ6pVg2NxjfwuvnfxDK6navHhhU1CVJEHeMa,7pDPJrxndRsLq983bEwvd3MKYnnqyQzQNMhEaC5NZYN1,True,133166271,33291567,99707,49853,49854,C4UnXuShCvjSMgBAgVNMy1oakxCNk1et27A82fywU112,3988290,26952990,-22964700,299
2022-05-08 22:10:25-04:00,19205,Bzp3ZUxzRWqW4QoLq9PtKN1HQeSaKXFQrX1G3a4ocrre,H12B3p4v1ZtZ9gaSgpxCJsKXmmEjiqaRZQzexjzAhevo,True,1960022127,265306336,1194602,597301,597301,DA18qE9qesbBqpwNv1M4befYcNQkbSBSeLPTmQzrmbJw,88254515,980487112,-892232597,450
2022-05-08 22:10:26-04:00,19206,7A1A93jqxV65F7XwvBarhgfTm3iFh3s75jFNzVCtFnez,8Z6QWdy4zGUzuMdKhkdxzq7RaLHhJmrpYEKeqsw8bopx,True,133151911,33287977,100716,50358,50358,8sEswn3kzEhnYjAZVvCQnHEUvYd7pFVvc2Xc2Kd1BpbC,4028665,26987404,-22958739,302
2022-05-08 22:10:29-04:00,19207,DxmkdZiygge1YAwbL8U6LudY3QJkSnZMHThQXkE4Z5qy,Gi8oNcSDphbtosjFudeEPtX88bUnYid1tL9FnXnLfASU,True,33918217,8479554,25646,12823,12823,5HnvdJnCCcmRsm4GkXnYWd4q9RpwuvYDGEUMPkYR3Ts9,1025842,5857839,-4831997,302
2022-05-08 22:10:35-04:00,19208,3CPsqvzeuQAH1V5m3FDFDwNgGUPUHkU1q4jn781sPxWu,vbqWE3N9QXgEwwp4HVukJp9eyCnT33kVMAqCS9AMBxU,True,36762187,1586017,6475,3237,3238,68sueyVfmy5ToEGtLFGDkwebX47xAmzyXE29z8JrmcWv,1500980,11618456,-10117476,408
2022-05-08 22:10:38-04:00,19209,13GT6eaKWuaLe7wFcybCnUaYgd9DfyzYRN2FcXWgFwpC,CbwmJ7YpnvcqDyUw3L9b7dqXcA8Ju3rYrTdegeaJJbWC,True,31858602,7964650,49696,24848,24848,6L1WYrPiCMyi7XemPww4B4hvpKD1LQKD4RpiSKmrmgSC,1987878,23576180,-21588302,623
2022-05-08 22:11:04-04:00,19210,9NhqXUfbpn5skKsZzCpnyD5wPTeLgDeKCxYQHR9TY9ej,8H1trMp7ATvrK1fzENWLg3xdDF6a4LJnNSc2APyQLi24,True,49381902,2124239,8653,4326,4327,Hu94aiQWvce6THeGyCFqGRPM1pQrK3ihzkcXo1EpJcJL,2011633,15128644,-13117011,407
2022-05-08 22:11:04-04:00,19211,E6nDc3W2iqNJJASjkU8dj2JViZ5iDys3Qf6nGh4gjA9a,8YnGmR4CECAkHN7QRvxh2KKbrdCcq5gtsFV1rDyzvWG5,True,49387187,2124224,8677,4338,4339,2a35JJeTUW1pm6M3e8DHCjp8qr4vbc2cRPhuzZWyFzYd,2017556,15130496,-13112940,408
2022-05-08 22:11:04-04:00,19212,5jAGYgNPbxE171j6GLMhf2WjbGzm7vKMifg5tAPcUPc1,EWoKgDPerFZ2ExRi6wWK9xBSyT2xQptp46Rdh39jF7Kt,True,57884984,2945219,12633,6316,6317,2a35JJeTUW1pm6M3e8DHCjp8qr4vbc2cRPhuzZWyFzYd,2482889,17368882,-14885993,428
2022-05-08 22:11:04-04:00,19213,A6wyZoJuJa5iqpXwYHfTiRs1G3MMaXVroDxdED89EyJp,HBYgKE6Lt2zXyobSHEbUdNCWPoxkikEEJHae15C1xptu,True,49402349,2124254,8666,4333,4333,6L1WYrPiCMyi7XemPww4B4hvpKD1LQKD4RpiSKmrmgSC,2015441,15113209,-13097768,407
2022-05-08 22:11:06-04:00,19214,EodTi1tG2TSFyYPtDVKAxc6cuufzeEB6hg66HiZ36FFQ,8x8z784KpUypCtdBnGbs7jmUAiH83yXnG3QwXAWo4AZX,True,49384179,2124244,8675,4337,4338,68sueyVfmy5ToEGtLFGDkwebX47xAmzyXE29z8JrmcWv,2016849,15132876,-13116027,408
2022-05-08 22:12:27-04:00,19215,5NVJU6YoZuuEjGNUUUJcGwS2Qd8b8CH7QSgMV7UWL5E7,8ZUq3o1nSkEvSfmiTz4anUpSMECCnX38MRwV7E5AGYSt,True,137541961,34385490,103330,51665,51665,2a35JJeTUW1pm6M3e8DHCjp8qr4vbc2cRPhuzZWyFzYd,4133225,27818903,-23685678,300
2022-05-08 22:12:50-04:00,19216,36C7WZ1ufgJ5vSBPMpPVRsv4EoS9AsGAp5wx5LiRTvjx,DRBttFFwyyqZwK8fn5W1xc59iHxV7JZkR76d1DDnEng3,True,38844914,1827562,7609,3804,3805,6L1WYrPiCMyi7XemPww4B4hvpKD1LQKD4RpiSKmrmgSC,1617335,12460161,-10842826,416
2022-05-08 22:13:11-04:00,19217,ETbDcnYMv5nwauExRwHHdHpChMBhD8FNgNszUE2CAdVx,2VEs3EouQ4fkdhmuehz7Jy7RW8LonkM3WpAVz7KfmydP,True,36710099,1582156,6463,3231,3232,8sEswn3kzEhnYjAZVvCQnHEUvYd7pFVvc2Xc2Kd1BpbC,1499789,11663990,-10164201,408
2022-05-08 22:13:14-04:00,19218,BNEFSL7Mwtyq4ZbWaQB1UibDumKrqSbqkNVEYCJsMioH,GecT9hsySEeo6hHWed9UUkae2SYBjDCNGeC6R7UVK5Ds,True,49382178,2123937,8676,4338,4338,2a35JJeTUW1pm6M3e8DHCjp8qr4vbc2cRPhuzZWyFzYd,2017204,15135179,-13117975,408
2022-05-08 22:13:15-04:00,19219,4Kr2N2ePqWvyDp9n5ey7MW8J34BvJYC3pcHzvEqRLjcU,H9DoqL8DddZiWRwusQQcS8vHmEGvkkukfiLf7r3Kqcj7,True,36944546,1594213,6472,3236,3236,5HnvdJnCCcmRsm4GkXnYWd4q9RpwuvYDGEUMPkYR3Ts9,1499969,11430539,-9930570,406
2022-05-08 22:13:15-04:00,19220,3atA8mjJH2GxCpXxoiDsizEvPtJctaVDAfwyxj4koJmJ,5Sr5fFo455uSbM3nwKfvziPM9eaCarsJEhCa9wzPU8Ct,True,36952267,1593734,6470,3235,3235,6L1WYrPiCMyi7XemPww4B4hvpKD1LQKD4RpiSKmrmgSC,1500255,11423090,-9922835,405
2022-05-08 22:13:15-04:00,19221,C6TnjCL81NkSp5GTkqPwzAwerpsGtnQzs8LqRAd7PMoi,66DYSdSzH8h5p6eeSZE3eZHXkuBC6EYjbGxHEqb9f5zb,True,36943991,1593927,6450,3225,3225,2a35JJeTUW1pm6M3e8DHCjp8qr4vbc2cRPhuzZWyFzYd,1495231,11426597,-9931366,404
2022-05-08 22:14:42-04:00,19222,FRbeFwhUYCiHW5oP26mad8KND7CCYDbfnoNxX7GuXVp8,GrzXKxPX2WDka8i2D8sunMUsrsThKasQi8NYLwuCGygV,True,379364795,35621934,150714,75357,75357,Hu94aiQWvce6THeGyCFqGRPM1pQrK3ihzkcXo1EpJcJL,16050747,160947751,-144897004,423
2022-05-08 22:17:04-04:00,19223,Hyh93pAbHGME7rUUFPXXPJVUba1cjgJK6Udw2D8yW4nf,A8VCG5wfCEQGgUbwtjq2xh47RKbwaV7RvVuuj3C9bKPu,True,36735724,1581972,6456,3228,3228,2a35JJeTUW1pm6M3e8DHCjp8qr4vbc2cRPhuzZWyFzYd,1499418,11638813,-10139395,408
2022-05-08 22:17:09-04:00,19224,2EcKNNHjAgZGnMhmRg98XGHFTAnM24gpAMsJA6FkdqHp,D6xW3oLCh9DP18E4wFNbVanbZyJUwhPVU3GsZEUEAjv3,True,36726045,1581761,6455,3227,3228,8sEswn3kzEhnYjAZVvCQnHEUvYd7pFVvc2Xc2Kd1BpbC,1498989,11648075,-10149086,408
2022-05-08 22:21:05-04:00,19225,532MfQR1PzPn6cmC1kpZsz9MyBWSamSeieh1F6GqVY33,6sJ8XXMZzGbHjVU1vWNW8unWoBZhJa54GguYJQhcb8PA,True,3930212258,682856725,4449843,2224921,2224922,6L1WYrPiCMyi7XemPww4B4hvpKD1LQKD4RpiSKmrmgSC,256112724,484806719,-228693995,651
2022-05-08 22:21:05-04:00,19226,4oMasDRj8HWfknmdwt6Mkz3eonr8J2byoiSTRo4sCnFQ,3emcATkEFvDVETiK97eVET2Z2jzkgiiSxX3gu5wsUKPe,True,1087941549,134180083,880501,440250,440251,Hu94aiQWvce6THeGyCFqGRPM1pQrK3ihzkcXo1EpJcJL,71391725,552142239,-480750514,656
2022-05-08 22:21:05-04:00,19227,AvvZT6q65qCaCdETtpR9XbCvY4Rv9RdpvbGuh6umEA9X,8dP2GJEjKTk9x7focRgCAYJauaGXENyxMU3EtgPA4gas,True,57948205,2939948,12589,6294,6295,2a35JJeTUW1pm6M3e8DHCjp8qr4vbc2cRPhuzZWyFzYd,2481540,17283407,-14801867,428
2022-05-08 22:21:23-04:00,19228,HAiBRAw8ahBFB5WacCzRfycQgEYC53TJ1YmXBcHjFLmf,7hjAT4L9n7LY33YTvw79xngMfxsfv3bQkypRmBaDxMhk,True,36794791,1586357,6472,3236,3236,2a35JJeTUW1pm6M3e8DHCjp8qr4vbc2cRPhuzZWyFzYd,1501342,11581674,-10080332,408
2022-05-08 22:21:50-04:00,19229,6pUtYz474QrpATEZnfb3iFbTKYA65pNyKAo4TQZAjtqe,8dipRUXvxJiDLdHEtCPkso4vErbVwshHQiRfvSngBS9J,True,1026665751,55806793,207491,103745,103746,2a35JJeTUW1pm6M3e8DHCjp8qr4vbc2cRPhuzZWyFzYd,38171842,499697401,-461525559,371
2022-05-08 22:21:52-04:00,19230,8J4BZXZzkK4SmWxc2YoaJRg9ivuuXbdVe5XpEhVds1ZM,3pirVwiye9NftvMpX5F7WpfcGZy5uV3c11xCdkkZbL9D,True,1551023189,387755797,1169767,584883,584884,2py1FiYeL2f7J3HU36qiJz6TD6HCmiTN36RyxYtapQCZ,46790688,209640608,-162849920,301
2022-05-08 22:22:06-04:00,19231,7YCSi1xGHn5j65W5cZPkQ9RQzvpNgCGdrafAGGTLYkjE,BdVVPyQgd93sMf1SDCFFMvyugNsbdkrVNgaQCJEGjTLC,True,54299537,2758582,11770,5885,5885,5HnvdJnCCcmRsm4GkXnYWd4q9RpwuvYDGEUMPkYR3Ts9,2316966,19017540,-16700574,426
2022-05-08 22:22:12-04:00,19232,5jAGYgNPbxE171j6GLMhf2WjbGzm7vKMifg5tAPcUPc1,EWoKgDPerFZ2ExRi6wWK9xBSyT2xQptp46Rdh39jF7Kt,True,54720165,2695692,11087,5543,5544,8sEswn3kzEhnYjAZVvCQnHEUvYd7pFVvc2Xc2Kd1BpbC,2250656,16551431,-14300775,411
2022-05-08 22:22:13-04:00,19233,BSDeCyJsPs6y1pbDVHNq5rs6tdxcrbY3NDjXPBxwRjHz,DjHD3jawBVikzjcQ5dXBRLdUmEeBHKt6JZLhvmjScDku,True,75557781,9340888,28438,14219,14219,6L1WYrPiCMyi7XemPww4B4hvpKD1LQKD4RpiSKmrmgSC,2300365,37566729,-35266364,304
2022-05-08 22:22:17-04:00,19234,3CPsqvzeuQAH1V5m3FDFDwNgGUPUHkU1q4jn781sPxWu,vbqWE3N9QXgEwwp4HVukJp9eyCnT33kVMAqCS9AMBxU,True,35078135,3159798,12578,6289,6289,8sEswn3kzEhnYjAZVvCQnHEUvYd7pFVvc2Xc2Kd1BpbC,1396470,11088620,-9692150,398
2022-05-08 22:22:21-04:00,19235,9NhqXUfbpn5skKsZzCpnyD5wPTeLgDeKCxYQHR9TY9ej,8H1trMp7ATvrK1fzENWLg3xdDF6a4LJnNSc2APyQLi24,True,47134348,4216741,16815,8407,8408,Hu94aiQWvce6THeGyCFqGRPM1pQrK3ihzkcXo1EpJcJL,1879665,14431728,-12552063,398
2022-05-08 22:22:23-04:00,19236,A6wyZoJuJa5iqpXwYHfTiRs1G3MMaXVroDxdED89EyJp,HBYgKE6Lt2zXyobSHEbUdNCWPoxkikEEJHae15C1xptu,True,47151606,4216420,16813,8406,8407,68sueyVfmy5ToEGtLFGDkwebX47xAmzyXE29z8JrmcWv,1880286,14416292,-12536006,398
2022-05-08 22:22:32-04:00,19237,E6nDc3W2iqNJJASjkU8dj2JViZ5iDys3Qf6nGh4gjA9a,8YnGmR4CECAkHN7QRvxh2KKbrdCcq5gtsFV1rDyzvWG5,True,47133588,4217395,16817,8408,8409,Hu94aiQWvce6THeGyCFqGRPM1pQrK3ihzkcXo1EpJcJL,1879504,14433537,-12554033,398
2022-05-08 22:22:32-04:00,19238,EodTi1tG2TSFyYPtDVKAxc6cuufzeEB6hg66HiZ36FFQ,8x8z784KpUypCtdBnGbs7jmUAiH83yXnG3QwXAWo4AZX,True,47130940,4216288,16810,8405,8405,2a35JJeTUW1pm6M3e8DHCjp8qr4vbc2cRPhuzZWyFzYd,1879179,14435941,-12556762,398
2022-05-08 22:26:18-04:00,19239,93Jp2cnKVsSUcpoNEXmuq3K17MWt7JkW3jx6v5v2UAvN,5bos8dvpCKDxeYbXxRXwEdY8tAMZoL2XhNKUdFKxTrd6,True,32700462,2732014,11184,5592,5592,6L1WYrPiCMyi7XemPww4B4hvpKD1LQKD4RpiSKmrmgSC,1338692,24254515,-22915823,409
2022-05-08 22:26:18-04:00,19240,ETbDcnYMv5nwauExRwHHdHpChMBhD8FNgNszUE2CAdVx,2VEs3EouQ4fkdhmuehz7Jy7RW8LonkM3WpAVz7KfmydP,True,35021493,3150182,12474,6237,6237,68sueyVfmy5ToEGtLFGDkwebX47xAmzyXE29z8JrmcWv,1386876,11130507,-9743631,396
2022-05-08 22:26:18-04:00,19241,9eWpSyu71Z6dmx7yTh7WrbVScdrrZN14d5tfmqEGFgXt,2r89PFKSD9zmSp2Wyx4CQ75HAtmUgwhAS2oG5MuYuiV6,True,908866000,79498368,329355,164677,164678,8sEswn3kzEhnYjAZVvCQnHEUvYd7pFVvc2Xc2Kd1BpbC,37653636,389109336,-351455700,414
2022-05-08 22:26:18-04:00,19242,3atA8mjJH2GxCpXxoiDsizEvPtJctaVDAfwyxj4koJmJ,5Sr5fFo455uSbM3nwKfvziPM9eaCarsJEhCa9wzPU8Ct,True,35259043,3197485,12644,6322,6322,8sEswn3kzEhnYjAZVvCQnHEUvYd7pFVvc2Xc2Kd1BpbC,1394295,10900972,-9506677,395
2022-05-08 22:26:18-04:00,19243,36C7WZ1ufgJ5vSBPMpPVRsv4EoS9AsGAp5wx5LiRTvjx,DRBttFFwyyqZwK8fn5W1xc59iHxV7JZkR76d1DDnEng3,True,36906083,1591232,6460,3230,3230,Hu94aiQWvce6THeGyCFqGRPM1pQrK3ihzkcXo1EpJcJL,1498457,11467576,-9969119,406
2022-05-08 22:26:19-04:00,19244,4Kr2N2ePqWvyDp9n5ey7MW8J34BvJYC3pcHzvEqRLjcU,H9DoqL8DddZiWRwusQQcS8vHmEGvkkukfiLf7r3Kqcj7,True,35250825,3197098,12642,6321,6321,68sueyVfmy5ToEGtLFGDkwebX47xAmzyXE29z8JrmcWv,1393989,10908903,-9514914,395
2022-05-08 22:26:20-04:00,19245,AtaNpuHGEDd7kfakJbTbpphMdQk7ZWk9iB585TtNATKx,72egdmxZyhyYsM93hTMuoDd6NeYVB7gpiJG4PWj4Qi8f,True,65861750,3974040,18003,9001,9002,68sueyVfmy5ToEGtLFGDkwebX47xAmzyXE29z8JrmcWv,2983763,21122658,-18138895,453
2022-05-08 22:26:21-04:00,19246,BNEFSL7Mwtyq4ZbWaQB1UibDumKrqSbqkNVEYCJsMioH,GecT9hsySEeo6hHWed9UUkae2SYBjDCNGeC6R7UVK5Ds,True,47117054,4212684,16695,8347,8348,5HnvdJnCCcmRsm4GkXnYWd4q9RpwuvYDGEUMPkYR3Ts9,1867341,14437933,-12570592,396
2022-05-08 22:26:30-04:00,19247,2EcKNNHjAgZGnMhmRg98XGHFTAnM24gpAMsJA6FkdqHp,D6xW3oLCh9DP18E4wFNbVanbZyJUwhPVU3GsZEUEAjv3,True,35045633,3159024,12564,6282,6282,5HnvdJnCCcmRsm4GkXnYWd4q9RpwuvYDGEUMPkYR3Ts9,1393883,11114000,-9720117,397
2022-05-08 22:26:31-04:00,19248,Hyh93pAbHGME7rUUFPXXPJVUba1cjgJK6Udw2D8yW4nf,A8VCG5wfCEQGgUbwtjq2xh47RKbwaV7RvVuuj3C9bKPu,True,35053915,3156429,12544,6272,6272,C4UnXuShCvjSMgBAgVNMy1oakxCNk1et27A82fywU112,1393125,11104948,-9711823,397
2022-05-08 22:26:33-04:00,19249,C6TnjCL81NkSp5GTkqPwzAwerpsGtnQzs8LqRAd7PMoi,66DYSdSzH8h5p6eeSZE3eZHXkuBC6EYjbGxHEqb9f5zb,True,35243126,3196050,12531,6265,6266,2a35JJeTUW1pm6M3e8DHCjp8qr4vbc2cRPhuzZWyFzYd,1381843,10904636,-9522793,392
2022-05-08 22:26:48-04:00,19250,AvvZT6q65qCaCdETtpR9XbCvY4Rv9RdpvbGuh6umEA9X,8dP2GJEjKTk9x7focRgCAYJauaGXENyxMU3EtgPA4gas,True,54810308,2710373,11230,5615,5615,C4UnXuShCvjSMgBAgVNMy1oakxCNk1et27A82fywU112,2271002,16460765,-14189763,414
2022-05-08 22:26:54-04:00,19251,Ai6G7vosJfmkRqtDAkqxRtbzELp6P5xe9r2RH3LYcLZt,8SUpKXakmhi4rYiFKnHYpgaAopomfDqEX6Efew9iM6nk,True,70198729,12225527,48958,24479,24479,Hu94aiQWvce6THeGyCFqGRPM1pQrK3ihzkcXo1EpJcJL,2811218,37586397,-34775179,400
2022-05-08 22:26:54-04:00,19252,HAiBRAw8ahBFB5WacCzRfycQgEYC53TJ1YmXBcHjFLmf,7hjAT4L9n7LY33YTvw79xngMfxsfv3bQkypRmBaDxMhk,True,35102917,3163571,12520,6260,6260,68sueyVfmy5ToEGtLFGDkwebX47xAmzyXE29z8JrmcWv,1389353,11052178,-9662825,395
2022-05-08 22:26:58-04:00,19253,68gVM4kjmSYxT1uJW13rYSway8uVLUdcLa7sJuqHQaAf,DshroBQ3da7BcAiQpiFREsLKWbUDrBRmmZRw3Zu2Qfs9,True,302672130,75668032,227961,113980,113981,2a35JJeTUW1pm6M3e8DHCjp8qr4vbc2cRPhuzZWyFzYd,9118478,71865743,-62747265,301
2022-05-08 22:26:59-04:00,19254,5QxR9QPTADFys9VQNm473RgprTikCXC23vhsBc9ojyAQ,H9zdf8nJ4JCF7jrwGsxiuiFoa14gzDmYsZ5N5ig3UGna,True,44181740,11045435,33071,16535,16536,6L1WYrPiCMyi7XemPww4B4hvpKD1LQKD4RpiSKmrmgSC,1322851,7995874,-6673023,299
2022-05-08 22:27:00-04:00,19255,3CPsqvzeuQAH1V5m3FDFDwNgGUPUHkU1q4jn781sPxWu,vbqWE3N9QXgEwwp4HVukJp9eyCnT33kVMAqCS9AMBxU,True,31830311,3009452,12251,6125,6126,2a35JJeTUW1pm6M3e8DHCjp8qr4vbc2cRPhuzZWyFzYd,1295866,10485834,-9189968,407
2022-05-08 22:27:00-04:00,19256,9NhqXUfbpn5skKsZzCpnyD5wPTeLgDeKCxYQHR9TY9ej,8H1trMp7ATvrK1fzENWLg3xdDF6a4LJnNSc2APyQLi24,True,42801294,4046795,16513,8256,8257,Hu94aiQWvce6THeGyCFqGRPM1pQrK3ihzkcXo1EpJcJL,1746537,13631658,-11885121,408
2022-05-08 22:27:02-04:00,19257,CvR57tmtnHbMmPivvJR6VenXivQaWue7z77N81WPpzfv,B4ASc8cUjrzuchv2SHwPrnjKvZgZpwvcLArsdYmMAqBQ,True,496640230,124160057,373271,186635,186636,Hu94aiQWvce6THeGyCFqGRPM1pQrK3ihzkcXo1EpJcJL,14930841,123290940,-108360099,300
2022-05-08 22:27:04-04:00,19258,A6wyZoJuJa5iqpXwYHfTiRs1G3MMaXVroDxdED89EyJp,HBYgKE6Lt2zXyobSHEbUdNCWPoxkikEEJHae15C1xptu,True,42819228,4045253,16508,8254,8254,C4UnXuShCvjSMgBAgVNMy1oakxCNk1et27A82fywU112,1747515,13615897,-11868382,408
2022-05-08 22:27:07-04:00,19259,4oMasDRj8HWfknmdwt6Mkz3eonr8J2byoiSTRo4sCnFQ,3emcATkEFvDVETiK97eVET2Z2jzkgiiSxX3gu5wsUKPe,True,945728138,136810184,903812,451906,451906,C4UnXuShCvjSMgBAgVNMy1oakxCNk1et27A82fywU112,62477896,492364073,-429886177,660
2022-05-08 22:27:07-04:00,19260,EodTi1tG2TSFyYPtDVKAxc6cuufzeEB6hg66HiZ36FFQ,8x8z784KpUypCtdBnGbs7jmUAiH83yXnG3QwXAWo4AZX,True,42799720,4046800,16522,8261,8261,2a35JJeTUW1pm6M3e8DHCjp8qr4vbc2cRPhuzZWyFzYd,1747437,13635416,-11887979,408
2022-05-08 22:27:07-04:00,19261,6pUtYz474QrpATEZnfb3iFbTKYA65pNyKAo4TQZAjtqe,8dipRUXvxJiDLdHEtCPkso4vErbVwshHQiRfvSngBS9J,True,967196380,92230100,327095,163547,163548,2xTUy2RS74GJMMDnmFaegMzFLn19RVfYG4CibhBmjP1i,34301773,456294783,-421993010,354
2022-05-08 22:27:07-04:00,19262,5FewDaMC9U7n5EHcto98GaAmDVxDh5SYimuTP6AtfakM,7DAULUoqV7f9hsBzKEhjQPnWaHSqiMWcBqWcdcadaQv4,True,504688959,126172239,762839,381419,381420,5HnvdJnCCcmRsm4GkXnYWd4q9RpwuvYDGEUMPkYR3Ts9,30513586,73124003,-42610417,604
2022-05-08 22:27:07-04:00,19263,BSDeCyJsPs6y1pbDVHNq5rs6tdxcrbY3NDjXPBxwRjHz,DjHD3jawBVikzjcQ5dXBRLdUmEeBHKt6JZLhvmjScDku,True,66044134,8876980,28214,14107,14107,6L1WYrPiCMyi7XemPww4B4hvpKD1LQKD4RpiSKmrmgSC,2099168,34509016,-32409848,317
2022-05-08 22:27:08-04:00,19264,5jAGYgNPbxE171j6GLMhf2WjbGzm7vKMifg5tAPcUPc1,EWoKgDPerFZ2ExRi6wWK9xBSyT2xQptp46Rdh39jF7Kt,True,51889295,2197977,8913,4456,4457,Hu94aiQWvce6THeGyCFqGRPM1pQrK3ihzkcXo1EpJcJL,2104391,15297701,-13193310,405
2022-05-08 22:27:10-04:00,19265,E6nDc3W2iqNJJASjkU8dj2JViZ5iDys3Qf6nGh4gjA9a,8YnGmR4CECAkHN7QRvxh2KKbrdCcq5gtsFV1rDyzvWG5,True,42796658,4047222,16484,8242,8242,Hu94aiQWvce6THeGyCFqGRPM1pQrK3ihzkcXo1EpJcJL,1743152,13634117,-11890965,407
2022-05-08 22:27:11-04:00,19266,7YCSi1xGHn5j65W5cZPkQ9RQzvpNgCGdrafAGGTLYkjE,BdVVPyQgd93sMf1SDCFFMvyugNsbdkrVNgaQCJEGjTLC,True,51375576,2468188,10280,5140,5140,2a35JJeTUW1pm6M3e8DHCjp8qr4vbc2cRPhuzZWyFzYd,2139817,18014350,-15874533,416
2022-05-08 22:27:11-04:00,19267,Bzp3ZUxzRWqW4QoLq9PtKN1HQeSaKXFQrX1G3a4ocrre,H12B3p4v1ZtZ9gaSgpxCJsKXmmEjiqaRZQzexjzAhevo,True,1682449653,111471232,527987,263993,263994,2py1FiYeL2f7J3HU36qiJz6TD6HCmiTN36RyxYtapQCZ,79689761,893033394,-813343633,473
2022-05-08 22:27:13-04:00,19268,BNEFSL7Mwtyq4ZbWaQB1UibDumKrqSbqkNVEYCJsMioH,GecT9hsySEeo6hHWed9UUkae2SYBjDCNGeC6R7UVK5Ds,True,42797037,4046077,16481,8240,8241,8sEswn3kzEhnYjAZVvCQnHEUvYd7pFVvc2Xc2Kd1BpbC,1743313,13633919,-11890606,407
2022-05-08 22:27:13-04:00,19269,9RtNbEZ4ZR8T1HFF4cujPVy2kejVBKFo3CPQi8psSa1q,7zwaGb71jKc9y2HKCKy5q2XV2YUphkyU1hkDaab1GBas,True,40603034,8280392,24619,12309,12310,Hu94aiQWvce6THeGyCFqGRPM1pQrK3ihzkcXo1EpJcJL,1207268,16496127,-15288859,297
2022-05-08 22:27:16-04:00,19270,ETbDcnYMv5nwauExRwHHdHpChMBhD8FNgNszUE2CAdVx,2VEs3EouQ4fkdhmuehz7Jy7RW8LonkM3WpAVz7KfmydP,True,31789608,3001041,12203,6101,6102,8sEswn3kzEhnYjAZVvCQnHEUvYd7pFVvc2Xc2Kd1BpbC,1292699,10518206,-9225507,406
2022-05-08 22:27:19-04:00,19271,HT2SuCbePhjNZaar24uVwihYowCNvSjdvhJ8BRSVw9nX,98Ts4LCnapHVoCJ5PW3Armvh4jvDtpfs3SYRLRxiAgzZ,True,117126169,16659808,75704,37852,37852,Hu94aiQWvce6THeGyCFqGRPM1pQrK3ihzkcXo1EpJcJL,5322388,57419540,-52097152,454
2022-05-08 22:27:20-04:00,19272,4Kr2N2ePqWvyDp9n5ey7MW8J34BvJYC3pcHzvEqRLjcU,H9DoqL8DddZiWRwusQQcS8vHmEGvkkukfiLf7r3Kqcj7,True,31954600,3059057,12274,6137,6137,5HnvdJnCCcmRsm4GkXnYWd4q9RpwuvYDGEUMPkYR3Ts9,1282220,10343353,-9061133,401
2022-05-08 22:27:20-04:00,19273,36C7WZ1ufgJ5vSBPMpPVRsv4EoS9AsGAp5wx5LiRTvjx,DRBttFFwyyqZwK8fn5W1xc59iHxV7JZkR76d1DDnEng3,True,35202896,3191991,12513,6256,6257,2a35JJeTUW1pm6M3e8DHCjp8qr4vbc2cRPhuzZWyFzYd,1380042,10942969,-9562927,392
2022-05-08 22:27:20-04:00,19274,Hyh93pAbHGME7rUUFPXXPJVUba1cjgJK6Udw2D8yW4nf,A8VCG5wfCEQGgUbwtjq2xh47RKbwaV7RvVuuj3C9bKPu,True,31807162,3006144,12194,6097,6097,Hu94aiQWvce6THeGyCFqGRPM1pQrK3ihzkcXo1EpJcJL,1290257,10498828,-9208571,405
2022-05-08 22:27:20-04:00,19275,3atA8mjJH2GxCpXxoiDsizEvPtJctaVDAfwyxj4koJmJ,5Sr5fFo455uSbM3nwKfvziPM9eaCarsJEhCa9wzPU8Ct,True,31962349,3062154,12286,6143,6143,8sEswn3kzEhnYjAZVvCQnHEUvYd7pFVvc2Xc2Kd1BpbC,1282442,10335809,-9053367,401
2022-05-08 22:27:22-04:00,19276,2EcKNNHjAgZGnMhmRg98XGHFTAnM24gpAMsJA6FkdqHp,D6xW3oLCh9DP18E4wFNbVanbZyJUwhPVU3GsZEUEAjv3,True,31796128,3001667,12185,6092,6093,C4UnXuShCvjSMgBAgVNMy1oakxCNk1et27A82fywU112,1290838,10510451,-9219613,405
2022-05-08 22:27:22-04:00,19277,D8BtQirMEk3W9Pq29B6KkKWrwPfmsUNpwz5npx7aGMLY,J7LMZwaSoh5hbGcwee6oPsnN4ZFD7Zp3LQWkJGNUHRfJ,True,19202345,4800586,33002,16501,16501,Hu94aiQWvce6THeGyCFqGRPM1pQrK3ihzkcXo1EpJcJL,1320116,12142708,-10822592,687
2022-05-08 22:27:22-04:00,19278,8KzrbHiup39X7Zw9grvh7gS9ZcA1zuhLGqgYguSjwnD6,A2EPmTs73YiS15ZKcjom55huNYaJY3WeP7NBDar1VE3R,True,4060319632,1015079908,6315917,3157958,3157959,72XWPCtRYEDZbddP7d6dHtUBRRDLSJsB2xZTAfefoEVZ,252636684,4719516624,-4466879940,622
2022-05-08 22:27:25-04:00,19279,C6TnjCL81NkSp5GTkqPwzAwerpsGtnQzs8LqRAd7PMoi,66DYSdSzH8h5p6eeSZE3eZHXkuBC6EYjbGxHEqb9f5zb,True,31964595,3062159,12327,6163,6164,8sEswn3kzEhnYjAZVvCQnHEUvYd7pFVvc2Xc2Kd1BpbC,1286831,10338144,-9051313,402
2022-05-08 22:27:30-04:00,19280,FRbeFwhUYCiHW5oP26mad8KND7CCYDbfnoNxX7GuXVp8,GrzXKxPX2WDka8i2D8sunMUsrsThKasQi8NYLwuCGygV,True,341601927,58847315,237025,118512,118513,2a35JJeTUW1pm6M3e8DHCjp8qr4vbc2cRPhuzZWyFzYd,13759099,144462123,-130703024,402
2022-05-08 22:27:31-04:00,19281,42h4NteqFpLjgjMS4gTTFoLvrEMpEP4sbGRd7SM5YCZR,AasJCLP5qsGzxkQs5jWysSarwoJTuZ6ZDeabNJNimWAX,True,6002364353,1500591088,4537906,2268953,2268953,2py1FiYeL2f7J3HU36qiJz6TD6HCmiTN36RyxYtapQCZ,181516259,418603545,-237087286,302
2022-05-08 22:27:31-04:00,19282,7w76zJFb9nTPDbfC4DCscQ2F5vimT8hiivT8WkuwWYWX,5X5XNdoFZv15bmbv97VRxHgTZzKyiFZpoz7MRNkPZS6f,True,63839262,3760713,17029,8514,8515,2a35JJeTUW1pm6M3e8DHCjp8qr4vbc2cRPhuzZWyFzYd,2890860,21051764,-18160904,452
2022-05-08 22:27:31-04:00,19283,AtaNpuHGEDd7kfakJbTbpphMdQk7ZWk9iB585TtNATKx,72egdmxZyhyYsM93hTMuoDd6NeYVB7gpiJG4PWj4Qi8f,True,61650779,3750717,16601,8300,8301,2a35JJeTUW1pm6M3e8DHCjp8qr4vbc2cRPhuzZWyFzYd,2728829,19828690,-17099861,442
2022-05-08 22:27:32-04:00,19284,JCagxpXPs6wVRUWbNBPCZ4uLCkZsachnofN7SZEEwGwB,5uGj1TBCkc7FV4ffdBJg31yLcCxkQLxRExjcinnJUow9,True,72275563,7014566,21183,10591,10592,8sEswn3kzEhnYjAZVvCQnHEUvYd7pFVvc2Xc2Kd1BpbC,2182708,73266689,-71083981,301
2022-05-08 22:27:40-04:00,19285,E4VzeJLsf5Y6t3yNi8VpS8QxhJbJGPhnkNBmU2XoCBs9,63CXyYfevXtrL1QcfQtAhz29xeea5BwWcj6d6BWb4qiB,True,3267598663,816899665,2468414,1234207,1234207,2py1FiYeL2f7J3HU36qiJz6TD6HCmiTN36RyxYtapQCZ,98736577,1369120232,-1270383655,302
2022-05-08 22:27:41-04:00,19286,HAiBRAw8ahBFB5WacCzRfycQgEYC53TJ1YmXBcHjFLmf,7hjAT4L9n7LY33YTvw79xngMfxsfv3bQkypRmBaDxMhk,True,31860676,3012705,12275,6137,6138,Hu94aiQWvce6THeGyCFqGRPM1pQrK3ihzkcXo1EpJcJL,1298163,10453226,-9155063,407
2022-05-08 22:27:49-04:00,19287,Apqv5iu4bJ6pVg2NxjfwuvnfxDK6navHhhU1CVJEHeMa,7pDPJrxndRsLq983bEwvd3MKYnnqyQzQNMhEaC5NZYN1,True,98982916,24745729,74919,37459,37460,8sEswn3kzEhnYjAZVvCQnHEUvYd7pFVvc2Xc2Kd1BpbC,2996795,21112813,-18116018,302
2022-05-08 22:27:59-04:00,19288,6pUtYz474QrpATEZnfb3iFbTKYA65pNyKAo4TQZAjtqe,8dipRUXvxJiDLdHEtCPkso4vErbVwshHQiRfvSngBS9J,True,872595911,87836494,318132,159066,159066,AmTrMPzuTp2BjnjqGNKqz9FTTCdpoKcPAJLwFc8ozcbh,31604309,431977824,-400373515,362
2022-05-08 22:28:00-04:00,19289,AvvZT6q65qCaCdETtpR9XbCvY4Rv9RdpvbGuh6umEA9X,8dP2GJEjKTk9x7focRgCAYJauaGXENyxMU3EtgPA4gas,True,51920677,4538735,18186,9093,9093,6L1WYrPiCMyi7XemPww4B4hvpKD1LQKD4RpiSKmrmgSC,2080514,15222408,-13141894,400
2022-05-08 22:28:01-04:00,19290,31TiU5VAiR77Zec49S5x2Y9EqdyMqi8Gx5T2bLxAazhU,iZkdEaFdSoYXBFEp3GPVJZvg5ZbiVdjNvHaTEvXxUmp,True,147938175998,36984540942,107773140,53886570,53886570,A9TwRM1BMxqb8DCC7YNAMV6zPenEJm3HTZBy7wJKK58U,4310925988,10137593325,-5826667337,291
2022-05-08 22:28:03-04:00,19291,EVMrznfJS54BZiywDD2WhUtxzicDtbEpm2a5yLrtCgRF,CpzsMYVYvKg8ihrX1cKRw7TDEYwD3kAyiX92hsf2KiTz,True,1135282677,157844002,666379,333189,333190,Hu94aiQWvce6THeGyCFqGRPM1pQrK3ihzkcXo1EpJcJL,47928933,680264048,-632335115,422
2022-05-08 22:28:08-04:00,19292,HT2SuCbePhjNZaar24uVwihYowCNvSjdvhJ8BRSVw9nX,98Ts4LCnapHVoCJ5PW3Armvh4jvDtpfs3SYRLRxiAgzZ,True,100057103,6989414,33791,16895,16896,C4UnXuShCvjSMgBAgVNMy1oakxCNk1et27A82fywU112,4837426,47920371,-43082945,483
2022-05-08 22:28:08-04:00,19293,CpeJ8BVz8Nd6SqnM3DYejnvAYnovDwu1taCqMEBD4RRi,GMmBgzDTtes62wJTENptaWPxNY2srWCrAdWErkj22Hzj,True,62898455,3904873,17702,8851,8851,3zqXX6kzhkbW3d4TwD2CNjMRwxTbREXySekvq37kfCNk,2851450,19953062,-17101612,453
2022-05-08 22:28:10-04:00,19294,BSDeCyJsPs6y1pbDVHNq5rs6tdxcrbY3NDjXPBxwRjHz,DjHD3jawBVikzjcQ5dXBRLdUmEeBHKt6JZLhvmjScDku,True,56920612,6959827,22307,11153,11154,C4UnXuShCvjSMgBAgVNMy1oakxCNk1et27A82fywU112,1824412,28745353,-26920941,320
2022-05-08 22:28:11-04:00,19295,93Jp2cnKVsSUcpoNEXmuq3K17MWt7JkW3jx6v5v2UAvN,5bos8dvpCKDxeYbXxRXwEdY8tAMZoL2XhNKUdFKxTrd6,True,29801836,5412494,21083,10541,10542,2a35JJeTUW1pm6M3e8DHCjp8qr4vbc2cRPhuzZWyFzYd,1160896,21969648,-20808752,389
2022-05-08 22:28:13-04:00,19296,5jAGYgNPbxE171j6GLMhf2WjbGzm7vKMifg5tAPcUPc1,EWoKgDPerFZ2ExRi6wWK9xBSyT2xQptp46Rdh39jF7Kt,True,49560519,4526295,17942,8971,8971,8sEswn3kzEhnYjAZVvCQnHEUvYd7pFVvc2Xc2Kd1BpbC,1964679,14674235,-12709556,396
2022-05-08 22:28:25-04:00,19297,DxmkdZiygge1YAwbL8U6LudY3QJkSnZMHThQXkE4Z5qy,Gi8oNcSDphbtosjFudeEPtX88bUnYid1tL9FnXnLfASU,False,25178858,25178858,740391,37019,703372,Hu94aiQWvce6THeGyCFqGRPM1pQrK3ihzkcXo1EpJcJL,740391,4624239,-3883848,294
2022-05-08 22:28:26-04:00,19298,4nqsW3XCJxzSsDdQzvE3zeM9nqBv8xVdUG8GxFWn6Edf,6eVvNs2rckFeTGkXZgPEGLYg4rmz3MFtoVNPRNmktcrY,True,856104753,214026188,1515363,757681,757682,A2p75MbAbeUdHkPLkAjgGeiwuu9WPrkMHzjCkDXF1Xr3,60614556,108268394,-47653838,708
2022-05-08 22:28:26-04:00,19299,EHi1UBG8wMUFZECktsFUZkGjJPaBNEedswS62hyYn6jC,Drx9ErQhAjnPuJ83LPYFnY5ZV5XDzGuXDuSf16VqWayp,True,1332831191,72784863,269793,134896,134897,AmTrMPzuTp2BjnjqGNKqz9FTTCdpoKcPAJLwFc8ozcbh,49404394,826341373,-776936979,370
2022-05-08 22:28:26-04:00,19300,EEQmHFk3WFNmPfe7ujtP1PK6P5yqV5mmWumNSoTu45P8,FG9DScQDQPrgcmBbRugZ5NfhSTRMnKSWLxcUeTF9MgJZ,True,680131829,170032957,509008,254504,254504,A2p75MbAbeUdHkPLkAjgGeiwuu9WPrkMHzjCkDXF1Xr3,20360337,92805298,-72444961,299
2022-05-08 22:28:26-04:00,19301,9NhqXUfbpn5skKsZzCpnyD5wPTeLgDeKCxYQHR9TY9ej,8H1trMp7ATvrK1fzENWLg3xdDF6a4LJnNSc2APyQLi24,True,38636658,1912473,7980,3990,3990,6L1WYrPiCMyi7XemPww4B4hvpKD1LQKD4RpiSKmrmgSC,1612183,12661937,-11049754,417
2022-05-08 22:28:27-04:00,19302,E6nDc3W2iqNJJASjkU8dj2JViZ5iDys3Qf6nGh4gjA9a,8YnGmR4CECAkHN7QRvxh2KKbrdCcq5gtsFV1rDyzvWG5,True,38640678,1912562,8007,4003,4004,2a35JJeTUW1pm6M3e8DHCjp8qr4vbc2cRPhuzZWyFzYd,1617910,12664852,-11046942,418
2022-05-08 22:28:27-04:00,19303,EodTi1tG2TSFyYPtDVKAxc6cuufzeEB6hg66HiZ36FFQ,8x8z784KpUypCtdBnGbs7jmUAiH83yXnG3QwXAWo4AZX,True,38635082,1913461,7988,3994,3994,2a35JJeTUW1pm6M3e8DHCjp8qr4vbc2cRPhuzZWyFzYd,1613077,12665691,-11052614,417
2022-05-08 22:28:28-04:00,19304,7A1A93jqxV65F7XwvBarhgfTm3iFh3s75jFNzVCtFnez,8Z6QWdy4zGUzuMdKhkdxzq7RaLHhJmrpYEKeqsw8bopx,True,98806962,24701740,71774,35887,35887,8sEswn3kzEhnYjAZVvCQnHEUvYd7pFVvc2Xc2Kd1BpbC,2870977,21147708,-18276731,290
2022-05-08 22:28:28-04:00,19305,ETbDcnYMv5nwauExRwHHdHpChMBhD8FNgNszUE2CAdVx,2VEs3EouQ4fkdhmuehz7Jy7RW8LonkM3WpAVz7KfmydP,True,28705478,1410375,5883,2941,2942,6L1WYrPiCMyi7XemPww4B4hvpKD1LQKD4RpiSKmrmgSC,1197407,9757045,-8559638,417
2022-05-08 22:28:28-04:00,19306,9tt8Hp2uzgmuv9fHSZDH299ytZGpqQuqA4arrksvpncJ,J1Y4k1hkmxncznXCdgNSmH7aW2Zdppe9QPWZZmanXrAL,True,60563278,15140819,43059,21529,21530,C4UnXuShCvjSMgBAgVNMy1oakxCNk1et27A82fywU112,1722373,20472055,-18749682,284
2022-05-08 22:28:28-04:00,19307,3CPsqvzeuQAH1V5m3FDFDwNgGUPUHkU1q4jn781sPxWu,vbqWE3N9QXgEwwp4HVukJp9eyCnT33kVMAqCS9AMBxU,True,28716136,1400161,5748,2874,2874,C4UnXuShCvjSMgBAgVNMy1oakxCNk1et27A82fywU112,1178892,9731894,-8553002,410
2022-05-08 22:28:28-04:00,19308,Cb6MEn1MN9XQcVVd3o9J8QdK3cFWxSNETsFzhVJ8jmdh,A6yTKbggUftjbjAVu5YR1M7rg7h78ghbfofmTSnmKNGz,True,68904065,17226016,49052,24526,24526,2a35JJeTUW1pm6M3e8DHCjp8qr4vbc2cRPhuzZWyFzYd,1962083,7163556,-5201473,284
2022-05-08 22:28:28-04:00,19309,5NVJU6YoZuuEjGNUUUJcGwS2Qd8b8CH7QSgMV7UWL5E7,8ZUq3o1nSkEvSfmiTz4anUpSMECCnX38MRwV7E5AGYSt,True,102099962,25524990,74334,37167,37167,8sEswn3kzEhnYjAZVvCQnHEUvYd7pFVvc2Xc2Kd1BpbC,2973386,21794905,-18821519,291
2022-05-08 22:28:29-04:00,19310,BNEFSL7Mwtyq4ZbWaQB1UibDumKrqSbqkNVEYCJsMioH,GecT9hsySEeo6hHWed9UUkae2SYBjDCNGeC6R7UVK5Ds,True,38635294,1917274,7995,3997,3998,Hu94aiQWvce6THeGyCFqGRPM1pQrK3ihzkcXo1EpJcJL,1611166,12663511,-11052345,417
2022-05-08 22:28:29-04:00,19311,7YCSi1xGHn5j65W5cZPkQ9RQzvpNgCGdrafAGGTLYkjE,BdVVPyQgd93sMf1SDCFFMvyugNsbdkrVNgaQCJEGjTLC,True,48736079,4312139,17326,8663,8663,8sEswn3kzEhnYjAZVvCQnHEUvYd7pFVvc2Xc2Kd1BpbC,1958228,16722255,-14764027,401
2022-05-08 22:28:29-04:00,19312,A6wyZoJuJa5iqpXwYHfTiRs1G3MMaXVroDxdED89EyJp,HBYgKE6Lt2zXyobSHEbUdNCWPoxkikEEJHae15C1xptu,True,38622226,1915904,7834,3917,3917,8sEswn3kzEhnYjAZVvCQnHEUvYd7pFVvc2Xc2Kd1BpbC,1579258,12644643,-11065385,408
2022-05-08 22:28:30-04:00,19313,36C7WZ1ufgJ5vSBPMpPVRsv4EoS9AsGAp5wx5LiRTvjx,DRBttFFwyyqZwK8fn5W1xc59iHxV7JZkR76d1DDnEng3,True,31922151,3053506,12231,6115,6116,C4UnXuShCvjSMgBAgVNMy1oakxCNk1et27A82fywU112,1278775,10372442,-9093667,400
2022-05-08 22:28:30-04:00,19314,7PzGZgzieFyyFs1dbajkNQgVxooFUNZrj1bUsQvrSwbp,A2gDREmSmJTBPPw3sbKVY3smC9wbHMDdv87gr4Tr2ES7,True,610395179,152598794,447606,223803,223803,3zqXX6kzhkbW3d4TwD2CNjMRwxTbREXySekvq37kfCNk,17904265,69566216,-51661951,293
2022-05-08 22:28:34-04:00,19315,JE6YNDmKQsxj4zsURyr1eh5cJjNCR2CvLmawufXWMCKx,2ctukoNZQ4BwabFZBJfhK2ic67ChHnGSBJyiSnmiCpAW,True,34964369,8741092,25357,12678,12679,6L1WYrPiCMyi7XemPww4B4hvpKD1LQKD4RpiSKmrmgSC,1014295,7905647,-6891352,290
2022-05-08 22:28:34-04:00,19316,9eWpSyu71Z6dmx7yTh7WrbVScdrrZN14d5tfmqEGFgXt,2r89PFKSD9zmSp2Wyx4CQ75HAtmUgwhAS2oG5MuYuiV6,True,824625016,146991422,580775,290387,290388,A9TwRM1BMxqb8DCC7YNAMV6zPenEJm3HTZBy7wJKK58U,32581665,311934978,-279353313,395
2022-05-08 22:28:34-04:00,19317,3atA8mjJH2GxCpXxoiDsizEvPtJctaVDAfwyxj4koJmJ,5Sr5fFo455uSbM3nwKfvziPM9eaCarsJEhCa9wzPU8Ct,True,28820826,1348115,5569,2784,2785,2a35JJeTUW1pm6M3e8DHCjp8qr4vbc2cRPhuzZWyFzYd,1190787,9635678,-8444891,413
2022-05-08 22:28:35-04:00,19318,DppVZcLwBrEGAe97GqQbDkHHwFiFoEXUgazACHvuLLAz,6s49UuzFmn4iAxNaZG2ohDeQp5VMcTfg2z4Kkc1BPyDy,False,16758571,16758571,486976,24348,462628,8sEswn3kzEhnYjAZVvCQnHEUvYd7pFVvc2Xc2Kd1BpbC,486976,2728405,-2241429,290
2022-05-08 22:28:35-04:00,19319,4Kr2N2ePqWvyDp9n5ey7MW8J34BvJYC3pcHzvEqRLjcU,H9DoqL8DddZiWRwusQQcS8vHmEGvkkukfiLf7r3Kqcj7,True,28816107,1349187,5573,2786,2787,8sEswn3kzEhnYjAZVvCQnHEUvYd7pFVvc2Xc2Kd1BpbC,1190510,9640131,-8449621,413
2022-05-08 22:28:36-04:00,19320,2EcKNNHjAgZGnMhmRg98XGHFTAnM24gpAMsJA6FkdqHp,D6xW3oLCh9DP18E4wFNbVanbZyJUwhPVU3GsZEUEAjv3,True,28715613,1400500,5851,2925,2926,8sEswn3kzEhnYjAZVvCQnHEUvYd7pFVvc2Xc2Kd1BpbC,1199805,9749930,-8550125,417
2022-05-08 22:28:36-04:00,19321,Hyh93pAbHGME7rUUFPXXPJVUba1cjgJK6Udw2D8yW4nf,A8VCG5wfCEQGgUbwtjq2xh47RKbwaV7RvVuuj3C9bKPu,True,28722092,1400816,5848,2924,2924,C4UnXuShCvjSMgBAgVNMy1oakxCNk1et27A82fywU112,1199137,9742775,-8543638,417
2022-05-08 22:28:36-04:00,19322,C6TnjCL81NkSp5GTkqPwzAwerpsGtnQzs8LqRAd7PMoi,66DYSdSzH8h5p6eeSZE3eZHXkuBC6EYjbGxHEqb9f5zb,True,28823044,1348159,5589,2794,2795,C4UnXuShCvjSMgBAgVNMy1oakxCNk1et27A82fywU112,1195112,9637977,-8442865,414
2022-05-08 22:28:37-04:00,19323,BJUNK2orMVx6mYsD9pnQzmsEh95ZF2NWPm9KJ1ZM67Qn,FpxLa3DwWrspYvHVsScSDcscHB2eBHGxRrQ4gVvn4VW,True,161990058,40497514,122482,61241,61241,C4UnXuShCvjSMgBAgVNMy1oakxCNk1et27A82fywU112,4899303,49094898,-44195595,302
2022-05-08 22:28:45-04:00,19324,3CTLVMSTYE6azjXhZyhPD5XiUe23aJ4pb456SQnUiohH,13q8wAZ1zte3bd3LdeKLEUY7ubu2suCNRZVrgMScpV3C,True,62930598,3913624,17651,8825,8826,2a35JJeTUW1pm6M3e8DHCjp8qr4vbc2cRPhuzZWyFzYd,2838355,19910427,-17072072,451
2022-05-08 22:28:46-04:00,19325,Ai6G7vosJfmkRqtDAkqxRtbzELp6P5xe9r2RH3LYcLZt,8SUpKXakmhi4rYiFKnHYpgaAopomfDqEX6Efew9iM6nk,True,57625936,5296606,22196,11098,11098,2a35JJeTUW1pm6M3e8DHCjp8qr4vbc2cRPhuzZWyFzYd,2414994,34362762,-31947768,419
2022-05-08 22:28:46-04:00,19326,EkKmfEnxTscSs2BDs1mg6SyHdStC8AYTy9zihw9VWP63,DW4ujEZj4H83B9CrSfbks2pkHEj3gh2d114eo1aDh4s9,True,84661973,21165493,63996,31998,31998,8sEswn3kzEhnYjAZVvCQnHEUvYd7pFVvc2Xc2Kd1BpbC,2559871,25748785,-23188914,302
2022-05-08 22:28:55-04:00,19327,532MfQR1PzPn6cmC1kpZsz9MyBWSamSeieh1F6GqVY33,6sJ8XXMZzGbHjVU1vWNW8unWoBZhJa54GguYJQhcb8PA,True,3206542649,507117139,3334608,1667304,1667304,AmTrMPzuTp2BjnjqGNKqz9FTTCdpoKcPAJLwFc8ozcbh,210849997,430761564,-219911567,657
2022-05-08 22:28:55-04:00,19328,8J4BZXZzkK4SmWxc2YoaJRg9ivuuXbdVe5XpEhVds1ZM,3pirVwiye9NftvMpX5F7WpfcGZy5uV3c11xCdkkZbL9D,True,1152567922,288141980,873036,436518,436518,AmTrMPzuTp2BjnjqGNKqz9FTTCdpoKcPAJLwFc8ozcbh,34921451,167848454,-132927003,302
2022-05-08 22:28:55-04:00,19329,DvSVpLMQyz91ksMwhuwwFDiKMo53FC5FVG5XrQZYWurJ,5jL2cYHg1QQpWYRCF4f378jpeHnTfPMWXiiHuhLNbzq8,True,62741934,3751503,16989,8494,8495,8sEswn3kzEhnYjAZVvCQnHEUvYd7pFVvc2Xc2Kd1BpbC,2841465,21103364,-18261899,452
2022-05-08 22:28:56-04:00,19330,6pUtYz474QrpATEZnfb3iFbTKYA65pNyKAo4TQZAjtqe,8dipRUXvxJiDLdHEtCPkso4vErbVwshHQiRfvSngBS9J,True,782487759,41419457,153582,76791,76791,2a35JJeTUW1pm6M3e8DHCjp8qr4vbc2cRPhuzZWyFzYd,29014519,402842310,-373827791,370
2022-05-08 22:28:56-04:00,19331,JCagxpXPs6wVRUWbNBPCZ4uLCkZsachnofN7SZEEwGwB,5uGj1TBCkc7FV4ffdBJg31yLcCxkQLxRExjcinnJUow9,True,65029796,6461936,19181,9590,9591,2a35JJeTUW1pm6M3e8DHCjp8qr4vbc2cRPhuzZWyFzYd,1930324,69771078,-67840754,296
2022-05-08 22:28:57-04:00,19332,AvvZT6q65qCaCdETtpR9XbCvY4Rv9RdpvbGuh6umEA9X,8dP2GJEjKTk9x7focRgCAYJauaGXENyxMU3EtgPA4gas,True,47290318,2191135,9130,4565,4565,Hu94aiQWvce6THeGyCFqGRPM1pQrK3ihzkcXo1EpJcJL,1970704,14242960,-12272256,416
2022-05-08 22:28:58-04:00,19333,8T4WK27RvWVGqPuNqY6whk1fmU4vd5qaUQPZG1GJ79bh,DvSz7knS8N3K7L6JhQf1s4mJSyxB8uJXNQXtyjJn8QRL,True,615664966,152388420,452193,226096,226097,A9TwRM1BMxqb8DCC7YNAMV6zPenEJm3HTZBy7wJKK58U,18269085,74364967,-56095882,296
2022-05-08 22:29:00-04:00,19334,AsQi8mNw8RZ8Fy11XJKKZhpy6xGb1CWWq1zdSndxtnyV,BJP93iScjvoA3TtFfchAYDn6VuyfDTbk1h2wnahREUFL,False,9700977,9700977,285589,14279,271310,Hu94aiQWvce6THeGyCFqGRPM1pQrK3ihzkcXo1EpJcJL,285589,4320012,-4034423,294
2022-05-08 22:29:03-04:00,19335,HAiBRAw8ahBFB5WacCzRfycQgEYC53TJ1YmXBcHjFLmf,7hjAT4L9n7LY33YTvw79xngMfxsfv3bQkypRmBaDxMhk,True,28751725,1401535,5799,2899,2900,8sEswn3kzEhnYjAZVvCQnHEUvYd7pFVvc2Xc2Kd1BpbC,1189642,9703650,-8514008,413
2022-05-08 22:29:08-04:00,19336,E17GuUpNNTyonDV7dtuit35hwQXtZ8fowHpHFHWSiiG3,GZ5DboskwBDP5fgYvp6djKFVFCo3MJkurtCY6cA8XVHr,True,53972808,13493202,83229,41614,41615,C4UnXuShCvjSMgBAgVNMy1oakxCNk1et27A82fywU112,3329168,49356758,-46027590,616
2022-05-08 22:29:09-04:00,19337,FncFHJooh1hy9Gc2y5sKdcYkZ5uHzsxHG4vHT9cVZGcK,BkFa4b5Jyv4ZJCCpwDYv355ezVFiZfAtn18AV7kstd2v,True,212230765,53057691,151500,75750,75750,47z82br5WdW2DZajdnPDPSSRRKsyAggqXqK6oPUwTaLf,6060011,43523064,-37463053,285
2022-05-08 22:29:12-04:00,19338,7KfkiubVVGHekg5W5NW1QqxnbudXQroe8tCBsx4GgXAC,5j5yEzQKUmQi7dFM89QTYSRpBca2y5S5EvvLC8ZNuDgM,True,53970718,13492679,83176,41588,41588,8sEswn3kzEhnYjAZVvCQnHEUvYd7pFVvc2Xc2Kd1BpbC,3327058,49356753,-46029695,616
2022-05-08 22:29:12-04:00,19339,7YCSi1xGHn5j65W5cZPkQ9RQzvpNgCGdrafAGGTLYkjE,BdVVPyQgd93sMf1SDCFFMvyugNsbdkrVNgaQCJEGjTLC,True,44319939,2056092,8521,4260,4261,3zqXX6kzhkbW3d4TwD2CNjMRwxTbREXySekvq37kfCNk,1836901,15767072,-13930171,414
2022-05-08 22:29:12-04:00,19340,7sgoB9mHcUoNFFdQSsBvyC4tXYzYR86ct11WQsS1FvAp,5k2QtQPgMUvj88Tmizf1pABHtC3VHJDc6BYNkB9gp19M,True,23957556,5989389,37429,18714,18715,8sEswn3kzEhnYjAZVvCQnHEUvYd7pFVvc2Xc2Kd1BpbC,1497199,10525619,-9028420,624
2022-05-08 22:29:13-04:00,19341,iEXYXt9JNg6tud7wsHcTe349MNWHBgAoRptNpasAGwb,DNCFSLLWNWEVfsqht6EuiQ7PwCdzhHjDk9i4UpgnDTxB,True,434247344,87335382,275964,137982,137982,A9TwRM1BMxqb8DCC7YNAMV6zPenEJm3HTZBy7wJKK58U,13721450,59511371,-45789921,315
2022-05-08 22:29:13-04:00,19342,9AJH82vT5qffJDaufA827gZ3Za7bJcUoL6kLXCV2QfMX,78AU7GRaKkx98LcwijwUiZeYHPuEcKGpY8HWqDLgA6pX,True,42373138,10593284,30660,15330,15330,Hu94aiQWvce6THeGyCFqGRPM1pQrK3ihzkcXo1EpJcJL,1226437,15280082,-14053645,289
2022-05-08 22:29:13-04:00,19343,3CPsqvzeuQAH1V5m3FDFDwNgGUPUHkU1q4jn781sPxWu,vbqWE3N9QXgEwwp4HVukJp9eyCnT33kVMAqCS9AMBxU,True,27253958,1178719,4805,2402,2403,2a35JJeTUW1pm6M3e8DHCjp8qr4vbc2cRPhuzZWyFzYd,1111127,9016932,-7905805,407
2022-05-08 22:29:15-04:00,19344,AtaNpuHGEDd7kfakJbTbpphMdQk7ZWk9iB585TtNATKx,72egdmxZyhyYsM93hTMuoDd6NeYVB7gpiJG4PWj4Qi8f,True,57667559,2962027,12736,6368,6368,C4UnXuShCvjSMgBAgVNMy1oakxCNk1et27A82fywU112,2479725,18312803,-15833078,430
2022-05-08 22:29:17-04:00,19345,7w76zJFb9nTPDbfC4DCscQ2F5vimT8hiivT8WkuwWYWX,5X5XNdoFZv15bmbv97VRxHgTZzKyiFZpoz7MRNkPZS6f,True,59830523,3725880,16351,8175,8176,3zqXX6kzhkbW3d4TwD2CNjMRwxTbREXySekvq37kfCNk,2625805,19795449,-17169644,438
2022-05-08 22:29:18-04:00,19346,EodTi1tG2TSFyYPtDVKAxc6cuufzeEB6hg66HiZ36FFQ,8x8z784KpUypCtdBnGbs7jmUAiH83yXnG3QwXAWo4AZX,True,36611265,1578728,6445,3222,3223,Hu94aiQWvce6THeGyCFqGRPM1pQrK3ihzkcXo1EpJcJL,1494733,11758644,-10263911,408
2022-05-08 22:29:18-04:00,19347,GdUWbwTgHF1RRbpVXCahz36G7MqYrM6QaBgnjL2eLKxk,JDYxQpYMt38mmjzLrVjgi3ezpc3DQ8YJEtJTZbG6fCCq,True,62812595,3754027,17136,8568,8568,8sEswn3kzEhnYjAZVvCQnHEUvYd7pFVvc2Xc2Kd1BpbC,2867390,21054915,-18187525,456
2022-05-08 22:29:18-04:00,19348,A6wyZoJuJa5iqpXwYHfTiRs1G3MMaXVroDxdED89EyJp,HBYgKE6Lt2zXyobSHEbUdNCWPoxkikEEJHae15C1xptu,True,36624376,1578734,6420,3210,3210,8sEswn3kzEhnYjAZVvCQnHEUvYd7pFVvc2Xc2Kd1BpbC,1489478,11740213,-10250735,406
2022-05-08 22:29:18-04:00,19349,9NhqXUfbpn5skKsZzCpnyD5wPTeLgDeKCxYQHR9TY9ej,8H1trMp7ATvrK1fzENWLg3xdDF6a4LJnNSc2APyQLi24,True,36609259,1578719,6422,3211,3211,8sEswn3kzEhnYjAZVvCQnHEUvYd7pFVvc2Xc2Kd1BpbC,1489277,11754225,-10264948,406
2022-05-08 22:29:19-04:00,19350,6fqbSyhh3PPdgRcLraHb7Jahj9s1oHHeX3SsjNSsGa6t,GpRUow48TYgttdYfsygbgjYQcmHyYjWETUDjDVphEgwq,True,85116657,10819794,31774,15887,15887,C4UnXuShCvjSMgBAgVNMy1oakxCNk1et27A82fywU112,2499606,57888451,-55388845,293
2022-05-08 22:29:19-04:00,19351,E6nDc3W2iqNJJASjkU8dj2JViZ5iDys3Qf6nGh4gjA9a,8YnGmR4CECAkHN7QRvxh2KKbrdCcq5gtsFV1rDyzvWG5,True,36613158,1578708,6445,3222,3223,2a35JJeTUW1pm6M3e8DHCjp8qr4vbc2cRPhuzZWyFzYd,1494945,11756905,-10261960,408
2022-05-08 22:29:19-04:00,19352,GcwFXxcxRF2xwbgFbQZoYEDreimd3J3UJ9sPfuwYVKtS,7uXjmKS8RxP2qSS7ataBH5hkfpgsFcpSBWUEBuV5zgyZ,True,227842534,56960633,170040,85020,85020,C4UnXuShCvjSMgBAgVNMy1oakxCNk1et27A82fywU112,6801612,59777583,-52975971,298
2022-05-08 22:29:24-04:00,19353,H3x9b27yHVdCxvtDf7mmJxkNeubcmQMwfAkLTYADPWNv,HGVCCz23rWx78vrTB2wvm2aesbLZuYFhhNuznGiSSAyA,False,26908037,26908037,801975,40098,761877,72FwbpFGoLEazJEdpqNtPNefsadUrimUqma9wSoy4qiS,801975,11498236,-10696261,298
2022-05-08 22:29:24-04:00,19354,7tFD53kPTqrzjCu1Wji78gUqhoRtCUhsP1pM3DQKT7uG,BJvgPLYBDJrQJdQVowrsMwUGMurq4zTihoFwWoEokfu3,True,338706148,47360926,141398,70699,70699,C4UnXuShCvjSMgBAgVNMy1oakxCNk1et27A82fywU112,10112274,81064355,-70952081,298
2022-05-08 22:29:38-04:00,19355,Bu65ba81oA2rZqxGAsctgz39NPPJqbXR3SvdMX5KQfTK,DcxNLDe2GwGiQPtQhzMiUjrMaqXjuyx1EGgX3xPtE98T,True,96063250,24015812,72354,36177,36177,8sEswn3kzEhnYjAZVvCQnHEUvYd7pFVvc2Xc2Kd1BpbC,2894191,25471641,-22577450,301
2022-05-08 22:29:42-04:00,19356,cXqFkCF4gaT9vAcZYMgwLXmmuD5w4hwgxT8YXE8JuBw,5Wtf4ZBL6R1afLeC4WfhFGkfi42TagtNAg6EZWn7gKhg,True,142056931,35514232,107550,53775,53775,Hu94aiQWvce6THeGyCFqGRPM1pQrK3ihzkcXo1EpJcJL,4302003,40212284,-35910281,302
2022-05-08 22:29:49-04:00,19357,GNohZMtk1VAuhLAgNGT8J3HYCKDCiyjvLeAWr64d7Duy,6soTLVj9DzFht8DzvjRfNPAWhZuiDBS5fDE1fpeuDSSz,True,55532320,13883080,85839,42919,42920,C4UnXuShCvjSMgBAgVNMy1oakxCNk1et27A82fywU112,3433561,34906201,-31472640,618
2022-05-08 22:30:15-04:00,19358,7BEY9qatFJomsayFmky3h3dAbKhY5XkRGwMobJuxXYhQ,J8MK3tAQKreBUG2reXY6gqr1uhbHhcAZEcxsLQmG5Ntt,True,629399124,157349781,1108296,554148,554148,8sEswn3kzEhnYjAZVvCQnHEUvYd7pFVvc2Xc2Kd1BpbC,44331849,211155563,-166823714,704
2022-05-08 22:30:35-04:00,19359,5jAGYgNPbxE171j6GLMhf2WjbGzm7vKMifg5tAPcUPc1,EWoKgDPerFZ2ExRi6wWK9xBSyT2xQptp46Rdh39jF7Kt,True,44909406,4204867,17058,8529,8529,2a35JJeTUW1pm6M3e8DHCjp8qr4vbc2cRPhuzZWyFzYd,1821919,13682585,-11860666,405
2022-05-08 22:30:35-04:00,19360,EHi1UBG8wMUFZECktsFUZkGjJPaBNEedswS62hyYn6jC,Drx9ErQhAjnPuJ83LPYFnY5ZV5XDzGuXDuSf16VqWayp,True,1255415721,132727255,470512,235256,235256,Hu94aiQWvce6THeGyCFqGRPM1pQrK3ihzkcXo1EpJcJL,44503994,758226163,-713722169,354
2022-05-08 22:30:54-04:00,19361,9RtNbEZ4ZR8T1HFF4cujPVy2kejVBKFo3CPQi8psSa1q,7zwaGb71jKc9y2HKCKy5q2XV2YUphkyU1hkDaab1GBas,False,32101907,32101907,961913,48095,913818,2a35JJeTUW1pm6M3e8DHCjp8qr4vbc2cRPhuzZWyFzYd,961914,13185746,-12223832,299
2022-05-08 22:36:28-04:00,19362,5QxR9QPTADFys9VQNm473RgprTikCXC23vhsBc9ojyAQ,H9zdf8nJ4JCF7jrwGsxiuiFoa14gzDmYsZ5N5ig3UGna,False,32840851,32840851,994326,49716,944610,68sueyVfmy5ToEGtLFGDkwebX47xAmzyXE29z8JrmcWv,994326,6294624,-5300298,302
2022-05-08 22:36:33-04:00,19363,68gVM4kjmSYxT1uJW13rYSway8uVLUdcLa7sJuqHQaAf,DshroBQ3da7BcAiQpiFREsLKWbUDrBRmmZRw3Zu2Qfs9,True,224770533,56192633,166423,83211,83212,2a35JJeTUW1pm6M3e8DHCjp8qr4vbc2cRPhuzZWyFzYd,6656952,55954720,-49297768,296
2022-05-08 22:36:33-04:00,19364,CvR57tmtnHbMmPivvJR6VenXivQaWue7z77N81WPpzfv,B4ASc8cUjrzuchv2SHwPrnjKvZgZpwvcLArsdYmMAqBQ,True,368967537,92241884,276123,138061,138062,8sEswn3kzEhnYjAZVvCQnHEUvYd7pFVvc2Xc2Kd1BpbC,11044934,95837845,-84792911,299
2022-05-08 22:36:36-04:00,19365,FRbeFwhUYCiHW5oP26mad8KND7CCYDbfnoNxX7GuXVp8,GrzXKxPX2WDka8i2D8sunMUsrsThKasQi8NYLwuCGygV,True,281128967,26465989,111994,55997,55997,68sueyVfmy5ToEGtLFGDkwebX47xAmzyXE29z8JrmcWv,11896429,123966967,-112070538,423
2022-05-08 22:36:37-04:00,19366,BNEFSL7Mwtyq4ZbWaQB1UibDumKrqSbqkNVEYCJsMioH,GecT9hsySEeo6hHWed9UUkae2SYBjDCNGeC6R7UVK5Ds,True,36611833,1577379,6449,3224,3225,68sueyVfmy5ToEGtLFGDkwebX47xAmzyXE29z8JrmcWv,1496984,11760289,-10263305,408
2022-05-08 22:36:37-04:00,19367,4Kr2N2ePqWvyDp9n5ey7MW8J34BvJYC3pcHzvEqRLjcU,H9DoqL8DddZiWRwusQQcS8vHmEGvkkukfiLf7r3Kqcj7,True,27394469,1184142,4808,2404,2404,8sEswn3kzEhnYjAZVvCQnHEUvYd7pFVvc2Xc2Kd1BpbC,1112486,8874369,-7761883,406
2022-05-08 22:36:37-04:00,19368,ETbDcnYMv5nwauExRwHHdHpChMBhD8FNgNszUE2CAdVx,2VEs3EouQ4fkdhmuehz7Jy7RW8LonkM3WpAVz7KfmydP,True,27214963,1174853,4797,2398,2399,2a35JJeTUW1pm6M3e8DHCjp8qr4vbc2cRPhuzZWyFzYd,1111384,9052161,-7940777,408
2022-05-08 22:36:37-04:00,19369,3atA8mjJH2GxCpXxoiDsizEvPtJctaVDAfwyxj4koJmJ,5Sr5fFo455uSbM3nwKfvziPM9eaCarsJEhCa9wzPU8Ct,True,27400213,1183786,4807,2403,2404,6L1WYrPiCMyi7XemPww4B4hvpKD1LQKD4RpiSKmrmgSC,1112720,8868847,-7756127,406
2022-05-08 22:36:39-04:00,19370,36C7WZ1ufgJ5vSBPMpPVRsv4EoS9AsGAp5wx5LiRTvjx,DRBttFFwyyqZwK8fn5W1xc59iHxV7JZkR76d1DDnEng3,True,28795173,1352464,5603,2801,2802,Hu94aiQWvce6THeGyCFqGRPM1pQrK3ihzkcXo1EpJcJL,1193072,9663719,-8470647,414
2022-05-08 22:36:46-04:00,19371,C6TnjCL81NkSp5GTkqPwzAwerpsGtnQzs8LqRAd7PMoi,66DYSdSzH8h5p6eeSZE3eZHXkuBC6EYjbGxHEqb9f5zb,True,27397928,1183205,4804,2402,2402,5HnvdJnCCcmRsm4GkXnYWd4q9RpwuvYDGEUMPkYR3Ts9,1112566,8871171,-7758605,406
2022-05-08 22:36:48-04:00,19372,Hyh93pAbHGME7rUUFPXXPJVUba1cjgJK6Udw2D8yW4nf,A8VCG5wfCEQGgUbwtjq2xh47RKbwaV7RvVuuj3C9bKPu,True,27240120,1176732,4804,2402,2402,5HnvdJnCCcmRsm4GkXnYWd4q9RpwuvYDGEUMPkYR3Ts9,1112133,9028367,-7916234,408
2022-05-08 22:36:53-04:00,19373,2EcKNNHjAgZGnMhmRg98XGHFTAnM24gpAMsJA6FkdqHp,D6xW3oLCh9DP18E4wFNbVanbZyJUwhPVU3GsZEUEAjv3,True,27230537,1176842,4794,2397,2397,8sEswn3kzEhnYjAZVvCQnHEUvYd7pFVvc2Xc2Kd1BpbC,1109378,9035203,-7925825,407
2022-05-08 22:37:09-04:00,19374,Bzp3ZUxzRWqW4QoLq9PtKN1HQeSaKXFQrX1G3a4ocrre,H12B3p4v1ZtZ9gaSgpxCJsKXmmEjiqaRZQzexjzAhevo,True,1559199329,110888614,511368,255684,255684,2xTUy2RS74GJMMDnmFaegMzFLn19RVfYG4CibhBmjP1i,71903348,731317495,-659414147,461
2022-05-08 22:37:15-04:00,19375,HAiBRAw8ahBFB5WacCzRfycQgEYC53TJ1YmXBcHjFLmf,7hjAT4L9n7LY33YTvw79xngMfxsfv3bQkypRmBaDxMhk,True,27276925,1179658,4802,2401,2401,Hu94aiQWvce6THeGyCFqGRPM1pQrK3ihzkcXo1EpJcJL,1110578,8990010,-7879432,407
2022-05-08 22:37:16-04:00,19376,JCagxpXPs6wVRUWbNBPCZ4uLCkZsachnofN7SZEEwGwB,5uGj1TBCkc7FV4ffdBJg31yLcCxkQLxRExjcinnJUow9,True,58395493,5225405,15558,7779,7779,68sueyVfmy5ToEGtLFGDkwebX47xAmzyXE29z8JrmcWv,1738776,58562750,-56823974,297
2022-05-08 22:37:17-04:00,19377,9NhqXUfbpn5skKsZzCpnyD5wPTeLgDeKCxYQHR9TY9ej,8H1trMp7ATvrK1fzENWLg3xdDF6a4LJnNSc2APyQLi24,True,34928857,3109700,12296,6148,6148,2a35JJeTUW1pm6M3e8DHCjp8qr4vbc2cRPhuzZWyFzYd,1381172,11217145,-9835973,395
2022-05-08 22:37:18-04:00,19378,Ai6G7vosJfmkRqtDAkqxRtbzELp6P5xe9r2RH3LYcLZt,8SUpKXakmhi4rYiFKnHYpgaAopomfDqEX6Efew9iM6nk,True,51957792,9034964,35147,17573,17574,8sEswn3kzEhnYjAZVvCQnHEUvYd7pFVvc2Xc2Kd1BpbC,2021260,28794022,-26772762,389
2022-05-08 22:37:18-04:00,19379,7YCSi1xGHn5j65W5cZPkQ9RQzvpNgCGdrafAGGTLYkjE,BdVVPyQgd93sMf1SDCFFMvyugNsbdkrVNgaQCJEGjTLC,True,42145888,3946012,16014,8007,8007,2a35JJeTUW1pm6M3e8DHCjp8qr4vbc2cRPhuzZWyFzYd,1710421,15002140,-13291719,405
2022-05-08 22:37:18-04:00,19380,93Jp2cnKVsSUcpoNEXmuq3K17MWt7JkW3jx6v5v2UAvN,5bos8dvpCKDxeYbXxRXwEdY8tAMZoL2XhNKUdFKxTrd6,False,24195683,24195683,946153,47307,898846,Hu94aiQWvce6THeGyCFqGRPM1pQrK3ihzkcXo1EpJcJL,946154,18462720,-17516566,391
2022-05-08 22:37:19-04:00,19381,E6nDc3W2iqNJJASjkU8dj2JViZ5iDys3Qf6nGh4gjA9a,8YnGmR4CECAkHN7QRvxh2KKbrdCcq5gtsFV1rDyzvWG5,True,34932637,3110227,12346,6173,6173,C4UnXuShCvjSMgBAgVNMy1oakxCNk1et27A82fywU112,1386687,11219788,-9833101,396
2022-05-08 22:37:19-04:00,19382,A6wyZoJuJa5iqpXwYHfTiRs1G3MMaXVroDxdED89EyJp,HBYgKE6Lt2zXyobSHEbUdNCWPoxkikEEJHae15C1xptu,True,34943813,3109433,12290,6145,6145,C4UnXuShCvjSMgBAgVNMy1oakxCNk1et27A82fywU112,1381229,11203147,-9821918,395
2022-05-08 22:37:19-04:00,19383,3CPsqvzeuQAH1V5m3FDFDwNgGUPUHkU1q4jn781sPxWu,vbqWE3N9QXgEwwp4HVukJp9eyCnT33kVMAqCS9AMBxU,True,25992259,2329832,9172,4586,4586,5HnvdJnCCcmRsm4GkXnYWd4q9RpwuvYDGEUMPkYR3Ts9,1023342,8608812,-7585470,393
2022-05-08 22:37:19-04:00,19384,BSDeCyJsPs6y1pbDVHNq5rs6tdxcrbY3NDjXPBxwRjHz,DjHD3jawBVikzjcQ5dXBRLdUmEeBHKt6JZLhvmjScDku,True,49714805,6617958,20714,10357,10357,C4UnXuShCvjSMgBAgVNMy1oakxCNk1et27A82fywU112,1556125,26405222,-24849097,313
2022-05-08 22:37:19-04:00,19385,E4VzeJLsf5Y6t3yNi8VpS8QxhJbJGPhnkNBmU2XoCBs9,63CXyYfevXtrL1QcfQtAhz29xeea5BwWcj6d6BWb4qiB,True,2425068775,606267193,1765948,882974,882974,2py1FiYeL2f7J3HU36qiJz6TD6HCmiTN36RyxYtapQCZ,70637940,1049560125,-978922185,291
2022-05-08 22:37:19-04:00,19386,42h4NteqFpLjgjMS4gTTFoLvrEMpEP4sbGRd7SM5YCZR,AasJCLP5qsGzxkQs5jWysSarwoJTuZ6ZDeabNJNimWAX,True,4451676075,1112919018,3172029,1586014,1586015,C4UnXuShCvjSMgBAgVNMy1oakxCNk1et27A82fywU112,126881163,356067022,-229185859,285
2022-05-08 22:37:20-04:00,19387,DvSVpLMQyz91ksMwhuwwFDiKMo53FC5FVG5XrQZYWurJ,5jL2cYHg1QQpWYRCF4f378jpeHnTfPMWXiiHuhLNbzq8,True,58786314,3722426,16592,8296,8296,2a35JJeTUW1pm6M3e8DHCjp8qr4vbc2cRPhuzZWyFzYd,2620359,19835891,-17215532,445
2022-05-08 22:37:22-04:00,19388,ETbDcnYMv5nwauExRwHHdHpChMBhD8FNgNszUE2CAdVx,2VEs3EouQ4fkdhmuehz7Jy7RW8LonkM3WpAVz7KfmydP,True,25968612,2324283,9264,4632,4632,C4UnXuShCvjSMgBAgVNMy1oakxCNk1et27A82fywU112,1035089,8640335,-7605246,398
2022-05-08 22:37:22-04:00,19389,4Kr2N2ePqWvyDp9n5ey7MW8J34BvJYC3pcHzvEqRLjcU,H9DoqL8DddZiWRwusQQcS8vHmEGvkkukfiLf7r3Kqcj7,True,26137757,2358903,9341,4670,4671,C4UnXuShCvjSMgBAgVNMy1oakxCNk1et27A82fywU112,1035108,8471669,-7436561,396
2022-05-08 22:37:22-04:00,19390,6pUtYz474QrpATEZnfb3iFbTKYA65pNyKAo4TQZAjtqe,8dipRUXvxJiDLdHEtCPkso4vErbVwshHQiRfvSngBS9J,True,737824920,68619537,238249,119124,119125,8sEswn3kzEhnYjAZVvCQnHEUvYd7pFVvc2Xc2Kd1BpbC,25617555,369856330,-344238775,347
2022-05-08 22:37:22-04:00,19391,7A1A93jqxV65F7XwvBarhgfTm3iFh3s75jFNzVCtFnez,8Z6QWdy4zGUzuMdKhkdxzq7RaLHhJmrpYEKeqsw8bopx,True,73419656,18354914,52840,26420,26420,C4UnXuShCvjSMgBAgVNMy1oakxCNk1et27A82fywU112,2113637,16507146,-14393509,287
2022-05-08 22:37:23-04:00,19392,5NVJU6YoZuuEjGNUUUJcGwS2Qd8b8CH7QSgMV7UWL5E7,8ZUq3o1nSkEvSfmiTz4anUpSMECCnX38MRwV7E5AGYSt,True,75866754,18966688,54770,27385,27385,C4UnXuShCvjSMgBAgVNMy1oakxCNk1et27A82fywU112,2190834,17015612,-14824778,288
2022-05-08 22:37:23-04:00,19393,EodTi1tG2TSFyYPtDVKAxc6cuufzeEB6hg66HiZ36FFQ,8x8z784KpUypCtdBnGbs7jmUAiH83yXnG3QwXAWo4AZX,True,34922581,3107409,12264,6132,6132,C4UnXuShCvjSMgBAgVNMy1oakxCNk1et27A82fywU112,1378332,11221549,-9843217,394
2022-05-08 22:37:30-04:00,19394,BNEFSL7Mwtyq4ZbWaQB1UibDumKrqSbqkNVEYCJsMioH,GecT9hsySEeo6hHWed9UUkae2SYBjDCNGeC6R7UVK5Ds,True,34938278,3108185,12404,6202,6202,C4UnXuShCvjSMgBAgVNMy1oakxCNk1et27A82fywU112,1394359,11221838,-9827479,399
2022-05-08 22:37:30-04:00,19395,AtaNpuHGEDd7kfakJbTbpphMdQk7ZWk9iB585TtNATKx,72egdmxZyhyYsM93hTMuoDd6NeYVB7gpiJG4PWj4Qi8f,True,54531159,2806678,11799,5899,5900,68sueyVfmy5ToEGtLFGDkwebX47xAmzyXE29z8JrmcWv,2292616,17324588,-15031972,420
2022-05-08 22:37:33-04:00,19396,3atA8mjJH2GxCpXxoiDsizEvPtJctaVDAfwyxj4koJmJ,5Sr5fFo455uSbM3nwKfvziPM9eaCarsJEhCa9wzPU8Ct,True,26143597,2359147,9340,4670,4670,C4UnXuShCvjSMgBAgVNMy1oakxCNk1et27A82fywU112,1035083,8465789,-7430706,395
2022-05-08 22:37:33-04:00,19397,36C7WZ1ufgJ5vSBPMpPVRsv4EoS9AsGAp5wx5LiRTvjx,DRBttFFwyyqZwK8fn5W1xc59iHxV7JZkR76d1DDnEng3,True,27367273,1182325,4804,2402,2402,6L1WYrPiCMyi7XemPww4B4hvpKD1LQKD4RpiSKmrmgSC,1112033,8901175,-7789142,406
2022-05-08 22:37:35-04:00,19398,Apqv5iu4bJ6pVg2NxjfwuvnfxDK6navHhhU1CVJEHeMa,7pDPJrxndRsLq983bEwvd3MKYnnqyQzQNMhEaC5NZYN1,True,73418429,18354607,52577,26288,26289,68sueyVfmy5ToEGtLFGDkwebX47xAmzyXE29z8JrmcWv,2103118,16509284,-14406166,286
2022-05-08 22:38:14-04:00,19399,C6TnjCL81NkSp5GTkqPwzAwerpsGtnQzs8LqRAd7PMoi,66DYSdSzH8h5p6eeSZE3eZHXkuBC6EYjbGxHEqb9f5zb,True,26141042,2358197,9328,4664,4664,2a35JJeTUW1pm6M3e8DHCjp8qr4vbc2cRPhuzZWyFzYd,1034081,8467492,-7433411,395
2022-05-08 22:38:21-04:00,19400,Hyh93pAbHGME7rUUFPXXPJVUba1cjgJK6Udw2D8yW4nf,A8VCG5wfCEQGgUbwtjq2xh47RKbwaV7RvVuuj3C9bKPu,True,25992078,2328107,9279,4639,4640,6L1WYrPiCMyi7XemPww4B4hvpKD1LQKD4RpiSKmrmgSC,1036019,8618259,-7582240,398
2022-05-08 22:38:30-04:00,19401,2EcKNNHjAgZGnMhmRg98XGHFTAnM24gpAMsJA6FkdqHp,D6xW3oLCh9DP18E4wFNbVanbZyJUwhPVU3GsZEUEAjv3,True,25984992,2329915,9288,4644,4644,6L1WYrPiCMyi7XemPww4B4hvpKD1LQKD4RpiSKmrmgSC,1035881,8625215,-7589334,398
2022-05-08 22:38:33-04:00,19402,EVMrznfJS54BZiywDD2WhUtxzicDtbEpm2a5yLrtCgRF,CpzsMYVYvKg8ihrX1cKRw7TDEYwD3kAyiX92hsf2KiTz,True,975652903,64313902,299777,149888,149889,A9TwRM1BMxqb8DCC7YNAMV6zPenEJm3HTZBy7wJKK58U,45476782,626503685,-581026903,466
2022-05-08 22:38:38-04:00,19403,8J4BZXZzkK4SmWxc2YoaJRg9ivuuXbdVe5XpEhVds1ZM,3pirVwiye9NftvMpX5F7WpfcGZy5uV3c11xCdkkZbL9D,True,855907450,213976862,638248,319124,319124,A9TwRM1BMxqb8DCC7YNAMV6zPenEJm3HTZBy7wJKK58U,25529923,133794117,-108264194,298
2022-05-08 22:38:39-04:00,19404,7w76zJFb9nTPDbfC4DCscQ2F5vimT8hiivT8WkuwWYWX,5X5XNdoFZv15bmbv97VRxHgTZzKyiFZpoz7MRNkPZS6f,True,55908768,2803757,12103,6051,6052,8sEswn3kzEhnYjAZVvCQnHEUvYd7pFVvc2Xc2Kd1BpbC,2413579,18254979,-15841400,431
2022-05-08 22:38:55-04:00,19405,GdUWbwTgHF1RRbpVXCahz36G7MqYrM6QaBgnjL2eLKxk,JDYxQpYMt38mmjzLrVjgi3ezpc3DQ8YJEtJTZbG6fCCq,True,58819144,3729206,16552,8276,8276,3zqXX6kzhkbW3d4TwD2CNjMRwxTbREXySekvq37kfCNk,2610830,19791803,-17180973,443
2022-05-08 22:39:02-04:00,19406,HAiBRAw8ahBFB5WacCzRfycQgEYC53TJ1YmXBcHjFLmf,7hjAT4L9n7LY33YTvw79xngMfxsfv3bQkypRmBaDxMhk,True,26028074,2331482,9285,4642,4643,Hu94aiQWvce6THeGyCFqGRPM1pQrK3ihzkcXo1EpJcJL,1036583,8582830,-7546247,398
2022-05-08 22:39:02-04:00,19407,JCagxpXPs6wVRUWbNBPCZ4uLCkZsachnofN7SZEEwGwB,5uGj1TBCkc7FV4ffdBJg31yLcCxkQLxRExjcinnJUow9,True,53054093,4831403,14636,7318,7318,Hu94aiQWvce6THeGyCFqGRPM1pQrK3ihzkcXo1EpJcJL,1607223,55905844,-54298621,302
2022-05-08 22:39:08-04:00,19408,CpeJ8BVz8Nd6SqnM3DYejnvAYnovDwu1taCqMEBD4RRi,GMmBgzDTtes62wJTENptaWPxNY2srWCrAdWErkj22Hzj,True,58740594,3429673,15068,7534,7534,2a35JJeTUW1pm6M3e8DHCjp8qr4vbc2cRPhuzZWyFzYd,2580760,18840229,-16259469,439
2022-05-08 22:39:08-04:00,19409,3CTLVMSTYE6azjXhZyhPD5XiUe23aJ4pb456SQnUiohH,13q8wAZ1zte3bd3LdeKLEUY7ubu2suCNRZVrgMScpV3C,True,58781198,3429487,15081,7540,7541,2a35JJeTUW1pm6M3e8DHCjp8qr4vbc2cRPhuzZWyFzYd,2584928,18805757,-16220829,439
2022-05-08 22:39:08-04:00,19410,agiVhhsNiMPzMaNWTHKRZ435HtBjqQvRuReKkpG32pn,HgcU2oCotYPxvGY6M21SbdqhzXJmNPDWEiTCDu4rA5dB,True,75840306,18960076,56862,28431,28431,Hu94aiQWvce6THeGyCFqGRPM1pQrK3ihzkcXo1EpJcJL,2274482,26541032,-24266550,299
2022-05-08 22:39:08-04:00,19411,DMACzuFBuj2vGqxZ3FV7QAo24jMV3EHKL8MrDrGbRkaJ,EnLfmDVW4ba2uqZKhj3X1TFnx8AHv7xwSWrMbVBYwcu9,True,65682375,16420593,48691,24345,24346,2a35JJeTUW1pm6M3e8DHCjp8qr4vbc2cRPhuzZWyFzYd,1947642,9810844,-7863202,296
2022-05-08 22:39:12-04:00,19412,AvvZT6q65qCaCdETtpR9XbCvY4Rv9RdpvbGuh6umEA9X,8dP2GJEjKTk9x7focRgCAYJauaGXENyxMU3EtgPA4gas,True,44949053,4208445,16959,8479,8480,Hu94aiQWvce6THeGyCFqGRPM1pQrK3ihzkcXo1EpJcJL,1811444,13612462,-11801018,402
2022-05-08 22:39:13-04:00,19413,djW9rVm1v4nW64QiVqgFUCRza24VqthDcSfVEyRHPed,EsXvQmXVXECqZPtmSdiuwieHPP5jsmyn67p78vHaJcqq,True,203425281,50856320,151402,75701,75701,2a35JJeTUW1pm6M3e8DHCjp8qr4vbc2cRPhuzZWyFzYd,6056086,23380733,-17324647,297
2022-05-08 22:39:20-04:00,19414,GMpoV2jRyLdf2V3Gb5TQZ5gEs5ftMjD3JhFUzkA6fWVz,5bi814d5gdToTLVWCmbdB6J15kMdsTQk74cZTRd62p81,True,466047400,116511850,816982,408491,408491,2a35JJeTUW1pm6M3e8DHCjp8qr4vbc2cRPhuzZWyFzYd,32679289,131470730,-98791441,701
2022-05-08 22:39:27-04:00,19415,EodTi1tG2TSFyYPtDVKAxc6cuufzeEB6hg66HiZ36FFQ,8x8z784KpUypCtdBnGbs7jmUAiH83yXnG3QwXAWo4AZX,True,31746033,3004575,12274,6137,6137,8sEswn3kzEhnYjAZVvCQnHEUvYd7pFVvc2Xc2Kd1BpbC,1296929,10566687,-9269758,408
2022-05-08 22:39:27-04:00,19416,9NhqXUfbpn5skKsZzCpnyD5wPTeLgDeKCxYQHR9TY9ej,8H1trMp7ATvrK1fzENWLg3xdDF6a4LJnNSc2APyQLi24,True,31743785,3004566,12242,6121,6121,8sEswn3kzEhnYjAZVvCQnHEUvYd7pFVvc2Xc2Kd1BpbC,1293504,10564548,-9271044,407
2022-05-08 22:39:32-04:00,19417,GtDk7DkAB2jvQynR57z8mjg6UoaTqYDr8Z4wsFX6KGSr,tAPvp4fscJZySZUVG2GZWZwSRVhfnNvkjCC6ZvmxqDQ,True,284791352,71197838,210728,105364,105364,C4UnXuShCvjSMgBAgVNMy1oakxCNk1et27A82fywU112,8429153,41324068,-32894915,295
2022-05-08 22:39:33-04:00,19418,5jAGYgNPbxE171j6GLMhf2WjbGzm7vKMifg5tAPcUPc1,EWoKgDPerFZ2ExRi6wWK9xBSyT2xQptp46Rdh39jF7Kt,True,40578056,2000203,8273,4136,4137,C4UnXuShCvjSMgBAgVNMy1oakxCNk1et27A82fywU112,1678378,12866042,-11187664,413
2022-05-08 22:39:33-04:00,19419,3CPsqvzeuQAH1V5m3FDFDwNgGUPUHkU1q4jn781sPxWu,vbqWE3N9QXgEwwp4HVukJp9eyCnT33kVMAqCS9AMBxU,False,23599279,23599279,951020,47551,903469,Hu94aiQWvce6THeGyCFqGRPM1pQrK3ihzkcXo1EpJcJL,951022,8116964,-7165942,402
2022-05-08 22:39:33-04:00,19420,5nALef7nAfNkSQSuTBLwewDby4pUx74Gzqib33Znmmt6,8xNTWK2xNK2xZPpgXfcE4QxPT2i6YvNYakiLgdQ2FqEt,True,55626254,13906563,41188,20594,20594,2a35JJeTUW1pm6M3e8DHCjp8qr4vbc2cRPhuzZWyFzYd,1647557,7490820,-5843263,296
2022-05-08 22:39:34-04:00,19421,FRbeFwhUYCiHW5oP26mad8KND7CCYDbfnoNxX7GuXVp8,GrzXKxPX2WDka8i2D8sunMUsrsThKasQi8NYLwuCGygV,True,253040146,43495610,174669,87334,87335,C4UnXuShCvjSMgBAgVNMy1oakxCNk1et27A82fywU112,10161603,111353053,-101191450,401
2022-05-08 22:39:34-04:00,19422,A6wyZoJuJa5iqpXwYHfTiRs1G3MMaXVroDxdED89EyJp,HBYgKE6Lt2zXyobSHEbUdNCWPoxkikEEJHae15C1xptu,True,31748801,3002623,12137,6068,6069,C4UnXuShCvjSMgBAgVNMy1oakxCNk1et27A82fywU112,1283360,10550283,-9266923,404
2022-05-08 22:39:34-04:00,19423,9PhhcWBFRZin6HDmEPzngPgGMd6DrnWpiopAhVGQ9Mpm,3qAx8SsRYqkNdwLtZDdUXDerAmkaib1sbfPNVu2nPmBK,True,39127081,5845784,17212,8606,8606,5HnvdJnCCcmRsm4GkXnYWd4q9RpwuvYDGEUMPkYR3Ts9,1152088,11921269,-10769181,294
2022-05-08 22:39:36-04:00,19424,82EMpA1hwF9KNQy2ZB2A1HdoEowBu2CoYhW3VmohkSnk,hn67zsTzsAs2aqk6ZjfEeoRygd3CdMeCuR82h9yuiz3,True,42305765,10576441,32009,16004,16005,C4UnXuShCvjSMgBAgVNMy1oakxCNk1et27A82fywU112,1280384,16482308,-15201924,302
2022-05-08 22:39:36-04:00,19425,E6nDc3W2iqNJJASjkU8dj2JViZ5iDys3Qf6nGh4gjA9a,8YnGmR4CECAkHN7QRvxh2KKbrdCcq5gtsFV1rDyzvWG5,True,31732046,3004125,12155,6077,6078,5HnvdJnCCcmRsm4GkXnYWd4q9RpwuvYDGEUMPkYR3Ts9,1283977,10567666,-9283689,404
2022-05-08 22:39:37-04:00,19426,6pUtYz474QrpATEZnfb3iFbTKYA65pNyKAo4TQZAjtqe,8dipRUXvxJiDLdHEtCPkso4vErbVwshHQiRfvSngBS9J,True,667785519,65003591,233226,116613,116613,5HnvdJnCCcmRsm4GkXnYWd4q9RpwuvYDGEUMPkYR3Ts9,23959442,351071689,-327112247,358
2022-05-08 22:39:43-04:00,19427,7YCSi1xGHn5j65W5cZPkQ9RQzvpNgCGdrafAGGTLYkjE,BdVVPyQgd93sMf1SDCFFMvyugNsbdkrVNgaQCJEGjTLC,True,38093512,1838712,7665,3832,3833,68sueyVfmy5ToEGtLFGDkwebX47xAmzyXE29z8JrmcWv,1588043,13932137,-12344094,416
2022-05-08 22:39:49-04:00,19428,ETbDcnYMv5nwauExRwHHdHpChMBhD8FNgNszUE2CAdVx,2VEs3EouQ4fkdhmuehz7Jy7RW8LonkM3WpAVz7KfmydP,False,23579956,23579956,961450,48072,913378,Hu94aiQWvce6THeGyCFqGRPM1pQrK3ihzkcXo1EpJcJL,961452,8142845,-7181393,407
2022-05-08 22:39:49-04:00,19429,7cvbksBKz3SyD4Waqpa3qaBAj7ZVZcxL5M1mJrHemDoK,5Pyxm6RqTPwQp2ji2mkbqC56Bg2Ps9ed9YGXz5HXezRr,True,90386254,22596563,66131,33065,33066,47z82br5WdW2DZajdnPDPSSRRKsyAggqXqK6oPUwTaLf,2645241,18983584,-16338343,292
2022-05-08 22:39:50-04:00,19430,6fqbSyhh3PPdgRcLraHb7Jahj9s1oHHeX3SsjNSsGa6t,GpRUow48TYgttdYfsygbgjYQcmHyYjWETUDjDVphEgwq,True,74042357,10416190,31136,15568,15568,47z82br5WdW2DZajdnPDPSSRRKsyAggqXqK6oPUwTaLf,2213326,54587704,-52374378,298
2022-05-08 22:39:50-04:00,19431,C6TnjCL81NkSp5GTkqPwzAwerpsGtnQzs8LqRAd7PMoi,66DYSdSzH8h5p6eeSZE3eZHXkuBC6EYjbGxHEqb9f5zb,False,23719915,23719915,961821,48091,913730,8sEswn3kzEhnYjAZVvCQnHEUvYd7pFVvc2Xc2Kd1BpbC,961823,8003850,-7042027,405
2022-05-08 22:39:50-04:00,19432,HT2SuCbePhjNZaar24uVwihYowCNvSjdvhJ8BRSVw9nX,98Ts4LCnapHVoCJ5PW3Armvh4jvDtpfs3SYRLRxiAgzZ,True,92557490,5577857,25873,12936,12937,8sEswn3kzEhnYjAZVvCQnHEUvYd7pFVvc2Xc2Kd1BpbC,4293436,44313942,-40020506,463
2022-05-08 22:39:50-04:00,19433,CnNbPk9YL7y2PiqMfVvS1789stfDA7ZDk3sArJSw6FwP,9oamN33gGnx3tU9Mnn53yhi6F2Du5AAaSV6uAi69rbib,True,113053444,28263361,83940,41970,41970,47z82br5WdW2DZajdnPDPSSRRKsyAggqXqK6oPUwTaLf,3357604,45718327,-42360723,296
2022-05-08 22:39:50-04:00,19434,4Kr2N2ePqWvyDp9n5ey7MW8J34BvJYC3pcHzvEqRLjcU,H9DoqL8DddZiWRwusQQcS8vHmEGvkkukfiLf7r3Kqcj7,False,23712414,23712414,959325,47966,911359,8sEswn3kzEhnYjAZVvCQnHEUvYd7pFVvc2Xc2Kd1BpbC,959327,8008724,-7049397,404
2022-05-08 22:39:53-04:00,19435,36C7WZ1ufgJ5vSBPMpPVRsv4EoS9AsGAp5wx5LiRTvjx,DRBttFFwyyqZwK8fn5W1xc59iHxV7JZkR76d1DDnEng3,True,26112933,2358862,9351,4675,4676,8sEswn3kzEhnYjAZVvCQnHEUvYd7pFVvc2Xc2Kd1BpbC,1035214,8496662,-7461448,396
2022-05-08 22:39:54-04:00,19436,3atA8mjJH2GxCpXxoiDsizEvPtJctaVDAfwyxj4koJmJ,5Sr5fFo455uSbM3nwKfvziPM9eaCarsJEhCa9wzPU8Ct,False,23718082,23718082,959373,47968,911405,C4UnXuShCvjSMgBAgVNMy1oakxCNk1et27A82fywU112,959375,8003089,-7043714,404
2022-05-08 22:39:54-04:00,19437,BNEFSL7Mwtyq4ZbWaQB1UibDumKrqSbqkNVEYCJsMioH,GecT9hsySEeo6hHWed9UUkae2SYBjDCNGeC6R7UVK5Ds,True,31740361,3002748,12224,6112,6112,C4UnXuShCvjSMgBAgVNMy1oakxCNk1et27A82fywU112,1292223,10567612,-9275389,407
2022-05-08 22:39:55-04:00,19438,CuFhLMgQ8ixnboam5iej9UdCCpf6D27oZRurcvbZHad7,GBaGVw5fbD2RCUYSK3FxvVHdtqaevRuQMe1p4KZUsfaF,True,53383972,13345993,40076,20038,20038,47z82br5WdW2DZajdnPDPSSRRKsyAggqXqK6oPUwTaLf,1603073,13601520,-11998447,300
2022-05-08 22:40:00-04:00,19439,DHfy6B2AYsqMCxPLBCXMDfQn3Gr2VwJaLFHUZKqpCjsb,EPZpYaY1gCAb8pMtri5veRowBmCrCpTHBMa3Rmgt6S29,True,113857042,28464260,83413,41706,41707,C4UnXuShCvjSMgBAgVNMy1oakxCNk1et27A82fywU112,3336527,14901963,-11565436,293
2022-05-08 22:40:02-04:00,19440,3Xbsek5MsEGoWr3G9yhuohREr26B2vSQcjqXdspTFHta,2rPxkUiMo9wGDq8EvAiwY3ngRpKmL223cBWWNTYoBmFp,True,1532034550,383008637,1160318,580159,580159,AmTrMPzuTp2BjnjqGNKqz9FTTCdpoKcPAJLwFc8ozcbh,46412728,104259656,-57846928,302
2022-05-08 22:40:04-04:00,19441,GpDhvRRae2uiRZ6MnJYnVR2hANNLGFGUDnsQmGjfK8AP,B2pgJ4gPdgzvx2HMJ1wagtthpZebtBk7RD3cF1zqSyT8,True,76341780,19085445,55881,27940,27941,3zqXX6kzhkbW3d4TwD2CNjMRwxTbREXySekvq37kfCNk,2235245,32331346,-30096101,292
2022-05-08 22:40:16-04:00,19442,HCAGpyYM2NYudMd55Geta13tUbS6eiygnJY5ULHsHAVa,3PPyWhqXrmifWPieLV34bZ1rzi8eEnrDDAF7ifXkXspn,False,24571728,24571728,992018,49600,942418,72FwbpFGoLEazJEdpqNtPNefsadUrimUqma9wSoy4qiS,992019,12452460,-11460441,403
2022-05-08 22:40:18-04:00,19443,5Y7MpvBDW2jVq5SwkJQrVjqMSBEfwvB7dF9N1dD6s9bk,5KvuS6ew8J4KCeX46ZZmvpuSBzK2DatDJmpm7cMwMKnp,True,61389627,15347406,45915,22957,22958,47z82br5WdW2DZajdnPDPSSRRKsyAggqXqK6oPUwTaLf,1836635,24863143,-23026508,299
2022-05-08 22:51:08-04:00,19444,4hZG7dM716SxDagiFGwt1gSC99B2QK1emGLV9TJmmuR8,7vjfUWySkyx4Z5qAaRr2VWnVvxHHNsvPj1PirGNSjM6,True,49316283,12329070,76908,38454,38454,8sEswn3kzEhnYjAZVvCQnHEUvYd7pFVvc2Xc2Kd1BpbC,3076344,43149306,-40072962,623
2022-05-08 22:51:24-04:00,19445,5g5EaEMiM2WQcfDpL3R3caYziX9xvGCFs9eVmmQdcgzS,J71CftCqiK1873fkVx9NGc7v7nvRZMYVBkGN3GhSPyeX,True,26469147,6617286,47226,23613,23613,68sueyVfmy5ToEGtLFGDkwebX47xAmzyXE29z8JrmcWv,1889060,10101302,-8212242,713
2022-05-08 22:51:46-04:00,19446,Cb6MEn1MN9XQcVVd3o9J8QdK3cFWxSNETsFzhVJ8jmdh,A6yTKbggUftjbjAVu5YR1M7rg7h78ghbfofmTSnmKNGz,True,51298447,12824611,38335,19167,19168,8sEswn3kzEhnYjAZVvCQnHEUvYd7pFVvc2Xc2Kd1BpbC,1533429,5814201,-4280772,298
2022-05-08 22:51:48-04:00,19447,9tt8Hp2uzgmuv9fHSZDH299ytZGpqQuqA4arrksvpncJ,J1Y4k1hkmxncznXCdgNSmH7aW2Zdppe9QPWZZmanXrAL,True,45088624,11272156,33636,16818,16818,Hu94aiQWvce6THeGyCFqGRPM1pQrK3ihzkcXo1EpJcJL,1345479,15741637,-14396158,298
2022-05-08 22:51:48-04:00,19448,5XcrJqz4M3F7d5SruWRSWLH8zY6cDVwTXbqcA2Y5YLBS,6gJ1xLxAQ1HW4WRpBx7LhHiQuqqdMvLxSdeeNUS5NFsi,True,113616947,28404236,84406,42203,42203,Hu94aiQWvce6THeGyCFqGRPM1pQrK3ihzkcXo1EpJcJL,3376240,5753938,-2377698,297
2022-05-08 22:51:54-04:00,19449,AtaNpuHGEDd7kfakJbTbpphMdQk7ZWk9iB585TtNATKx,72egdmxZyhyYsM93hTMuoDd6NeYVB7gpiJG4PWj4Qi8f,True,51559703,2210454,9071,4535,4536,8sEswn3kzEhnYjAZVvCQnHEUvYd7pFVvc2Xc2Kd1BpbC,2116039,16181964,-14065925,410
2022-05-08 22:51:55-04:00,19450,G7J6rzKaJY5eTjmaCtY1Kxnf6TGXLTNdzuVWBgY93c7j,FZJnEdNgQeYqvRb6g5Vyryv6AWMj1pYMdMm6DbcTdCbL,True,105707219941,26426804985,80070639,40035319,40035320,8sEswn3kzEhnYjAZVvCQnHEUvYd7pFVvc2Xc2Kd1BpbC,3202825582,5282140483,-2079314901,302
2022-05-08 22:51:55-04:00,19451,EEQmHFk3WFNmPfe7ujtP1PK6P5yqV5mmWumNSoTu45P8,FG9DScQDQPrgcmBbRugZ5NfhSTRMnKSWLxcUeTF9MgJZ,True,503772782,125943195,338130,169065,169065,2xTUy2RS74GJMMDnmFaegMzFLn19RVfYG4CibhBmjP1i,13525239,74191552,-60666313,268
2022-05-08 22:51:55-04:00,19452,7w76zJFb9nTPDbfC4DCscQ2F5vimT8hiivT8WkuwWYWX,5X5XNdoFZv15bmbv97VRxHgTZzKyiFZpoz7MRNkPZS6f,True,52902840,2781874,11564,5782,5782,Hu94aiQWvce6THeGyCFqGRPM1pQrK3ihzkcXo1EpJcJL,2199305,17296632,-15097327,415
2022-05-08 22:51:55-04:00,19453,EHi1UBG8wMUFZECktsFUZkGjJPaBNEedswS62hyYn6jC,Drx9ErQhAjnPuJ83LPYFnY5ZV5XDzGuXDuSf16VqWayp,True,1119075681,126614089,457326,228663,228663,8sEswn3kzEhnYjAZVvCQnHEUvYd7pFVvc2Xc2Kd1BpbC,40420697,708298208,-667877511,361
2022-05-08 22:51:55-04:00,19454,7PzGZgzieFyyFs1dbajkNQgVxooFUNZrj1bUsQvrSwbp,A2gDREmSmJTBPPw3sbKVY3smC9wbHMDdv87gr4Tr2ES7,True,452758248,113189562,310463,155231,155232,8sEswn3kzEhnYjAZVvCQnHEUvYd7pFVvc2Xc2Kd1BpbC,12418522,56208259,-43789737,274
2022-05-08 22:51:55-04:00,19455,9eWpSyu71Z6dmx7yTh7WrbVScdrrZN14d5tfmqEGFgXt,2r89PFKSD9zmSp2Wyx4CQ75HAtmUgwhAS2oG5MuYuiV6,True,672446308,59080642,235582,117791,117791,2a35JJeTUW1pm6M3e8DHCjp8qr4vbc2cRPhuzZWyFzYd,26813604,299617470,-272803866,398
2022-05-08 22:51:55-04:00,19456,HAiBRAw8ahBFB5WacCzRfycQgEYC53TJ1YmXBcHjFLmf,7hjAT4L9n7LY33YTvw79xngMfxsfv3bQkypRmBaDxMhk,False,23616305,23616305,947009,47350,899659,Hu94aiQWvce6THeGyCFqGRPM1pQrK3ihzkcXo1EpJcJL,947011,8092522,-7145511,400
