ts,record_id,user_authority,user,partial,base_asset_value,base_asset_value_closed,liquidation_fee,fee_to_liquidator,fee_to_insurance_fund,liquidator,total_collateral,collateral,unrealized_pnl,margin_ratio
2021-11-02 23:44:44-04:00,1,73Wkg27usHy8knWENTmb9zbikugYh93JvBB2bF855vZ2,J9WaUA7r8ct4ZG8o8ATZjvHUPuCYqY42aTsr9xveW5BX,True,109019053,27254763,170209,85104,85105,72FwbpFGoLEazJEdpqNtPNefsadUrimUqma9wSoy4qiS,6808394,20827447,-14019053,624
2021-11-03 15:16:48-04:00,2,73Wkg27usHy8knWENTmb9zbikugYh93JvBB2bF855vZ2,J9WaUA7r8ct4ZG8o8ATZjvHUPuCYqY42aTsr9xveW5BX,True,83711127,20927781,111875,55937,55938,72FwbpFGoLEazJEdpqNtPNefsadUrimUqma9wSoy4qiS,4475031,16936405,-12461374,534
2021-11-03 16:14:45-04:00,3,DSEgVqfxXp5wxjn3gNZtmb4E6rJeBm3VcbqdwDnsuzSq,6YVCWznUKheSMPuywSRJgCes7wghPGJXgxfrVfnjN4mB,True,886842089,221710522,1365175,682587,682588,72FwbpFGoLEazJEdpqNtPNefsadUrimUqma9wSoy4qiS,54607013,149594012,-94986999,615
2021-11-03 16:47:45-04:00,4,73Wkg27usHy8knWENTmb9zbikugYh93JvBB2bF855vZ2,J9WaUA7r8ct4ZG8o8ATZjvHUPuCYqY42aTsr9xveW5BX,True,63192132,15798033,98701,49350,49351,72FwbpFGoLEazJEdpqNtPNefsadUrimUqma9wSoy4qiS,3948050,13703072,-9755022,624
2021-11-03 17:03:45-04:00,5,3oG1F9Ea32KTbfJcBQRMwn6fftcyARJNnibBZz84UrBi,2rwC8bmYjDxMM58LvLSYr1UpxsnTnqZXoyQa8qsBogst,True,2793365886,698341471,4359465,2179732,2179733,72FwbpFGoLEazJEdpqNtPNefsadUrimUqma9wSoy4qiS,174378631,472745517,-298366886,624
2021-11-03 18:24:21-04:00,6,DSEgVqfxXp5wxjn3gNZtmb4E6rJeBm3VcbqdwDnsuzSq,6YVCWznUKheSMPuywSRJgCes7wghPGJXgxfrVfnjN4mB,True,678174523,169543630,991998,495999,495999,72FwbpFGoLEazJEdpqNtPNefsadUrimUqma9wSoy4qiS,39679938,123983399,-84303461,585
2021-11-03 18:24:21-04:00,7,73Wkg27usHy8knWENTmb9zbikugYh93JvBB2bF855vZ2,J9WaUA7r8ct4ZG8o8ATZjvHUPuCYqY42aTsr9xveW5BX,True,48202614,12050653,75098,37549,37549,72FwbpFGoLEazJEdpqNtPNefsadUrimUqma9wSoy4qiS,3003948,11128829,-8124881,623
2021-11-03 19:01:25-04:00,8,3oG1F9Ea32KTbfJcBQRMwn6fftcyARJNnibBZz84UrBi,2rwC8bmYjDxMM58LvLSYr1UpxsnTnqZXoyQa8qsBogst,True,2130201752,532550438,3333349,1666674,1666675,72FwbpFGoLEazJEdpqNtPNefsadUrimUqma9wSoy4qiS,133333982,392486730,-259152748,625
2021-11-04 16:51:33-04:00,9,73Wkg27usHy8knWENTmb9zbikugYh93JvBB2bF855vZ2,J9WaUA7r8ct4ZG8o8ATZjvHUPuCYqY42aTsr9xveW5BX,True,36758326,9189581,55871,27935,27936,72FwbpFGoLEazJEdpqNtPNefsadUrimUqma9wSoy4qiS,2234866,8934976,-6700110,607
2021-11-04 16:52:33-04:00,10,3oG1F9Ea32KTbfJcBQRMwn6fftcyARJNnibBZz84UrBi,2rwC8bmYjDxMM58LvLSYr1UpxsnTnqZXoyQa8qsBogst,True,1633200505,408300126,2274195,1137097,1137098,72FwbpFGoLEazJEdpqNtPNefsadUrimUqma9wSoy4qiS,90967827,321023385,-230055558,556
2021-11-04 19:22:34-04:00,11,73Wkg27usHy8knWENTmb9zbikugYh93JvBB2bF855vZ2,J9WaUA7r8ct4ZG8o8ATZjvHUPuCYqY42aTsr9xveW5BX,True,27998439,6999609,43513,21756,21757,72FwbpFGoLEazJEdpqNtPNefsadUrimUqma9wSoy4qiS,1740533,7195369,-5454836,621
2021-11-06 04:34:38-04:00,12,3oG1F9Ea32KTbfJcBQRMwn6fftcyARJNnibBZz84UrBi,2rwC8bmYjDxMM58LvLSYr1UpxsnTnqZXoyQa8qsBogst,True,1233563244,308390811,1926349,963174,963175,72FwbpFGoLEazJEdpqNtPNefsadUrimUqma9wSoy4qiS,77053993,258339105,-181285112,624
2021-11-06 13:20:38-04:00,13,73Wkg27usHy8knWENTmb9zbikugYh93JvBB2bF855vZ2,J9WaUA7r8ct4ZG8o8ATZjvHUPuCYqY42aTsr9xveW5BX,True,21304502,5326125,33278,16639,16639,72FwbpFGoLEazJEdpqNtPNefsadUrimUqma9wSoy4qiS,1331129,5727961,-4396832,624
2021-11-06 15:39:37-04:00,14,81GV2H9ipJSZD6YpJGj2XQNfoUroWWnKfwMHGSwvhixd,7cLHoNuNVj8qkn3QmBYLFwja37f1MWEo4e3ZcNSpXTPw,True,6571396827,1642849206,10284072,5142036,5142036,72FwbpFGoLEazJEdpqNtPNefsadUrimUqma9wSoy4qiS,411362904,1122722501,-711359597,625
2021-11-06 17:34:39-04:00,15,81GV2H9ipJSZD6YpJGj2XQNfoUroWWnKfwMHGSwvhixd,7cLHoNuNVj8qkn3QmBYLFwja37f1MWEo4e3ZcNSpXTPw,True,5055468436,1263867109,6840919,3420459,3420460,72FwbpFGoLEazJEdpqNtPNefsadUrimUqma9wSoy4qiS,273636788,935544466,-661907678,541
2021-11-10 16:25:04-05:00,16,6zc2j7WaicYnnYjR6iMVLgJ9sqmvuKzkHNSSmcgbXrHw,5NBipewC9DDqx4p8cQn1UxRLZhDWyaTubUFoEzWdLH5Y,True,641803413,160450853,962996,481498,481498,72FwbpFGoLEazJEdpqNtPNefsadUrimUqma9wSoy4qiS,38519854,90906930,-52387076,600
2021-11-16 05:15:19-05:00,17,6zc2j7WaicYnnYjR6iMVLgJ9sqmvuKzkHNSSmcgbXrHw,5NBipewC9DDqx4p8cQn1UxRLZhDWyaTubUFoEzWdLH5Y,True,470929608,117732402,725163,362581,362582,72FwbpFGoLEazJEdpqNtPNefsadUrimUqma9wSoy4qiS,29006556,78738048,-49731492,615
2021-11-16 22:14:26-05:00,18,82ahWrNx6L73jAvzt4PAv7FuhwSdGqG4KqAZWD2uwEZt,2funPHa9Xi1hcgj7rHc7NHDYQ5HjgZ7UvbnZpet3u7kQ,True,115186277,28796569,169416,84708,84708,72FwbpFGoLEazJEdpqNtPNefsadUrimUqma9wSoy4qiS,6776654,27848342,-21071688,588
2021-11-16 22:17:18-05:00,19,7ckvB1uchDPcA5vkjJvu4DHCkgGq81qbJrd4P2CwPDV8,pVjScFyTQfYJ74uA9JLEsChSrtY8fRi2dCM3jtWC6bp,True,42902924,10725731,66987,33493,33494,72FwbpFGoLEazJEdpqNtPNefsadUrimUqma9wSoy4qiS,2679504,10312820,-7633316,624
2021-11-16 22:17:20-05:00,20,3fB955q6xxxZcgnCyguLwkSa7egxgBoksPQVQ3U8HRHL,GK7cTdhfSpapJB8dFzEkV8c1UFkJPj281DwztnpKjxLx,True,1001309929,250327482,1566816,783408,783408,72FwbpFGoLEazJEdpqNtPNefsadUrimUqma9wSoy4qiS,62672667,241361738,-178689071,625
2021-11-17 06:36:22-05:00,21,66SjFhmiNYz8tLRnBhZUbowWGTbM16G52X3AT2hma2wN,3wVy8nk24HCFZWMiacGe8QsJquYaadZ9pQg44bGRwdE3,True,306353682,76588420,479244,239622,239622,72FwbpFGoLEazJEdpqNtPNefsadUrimUqma9wSoy4qiS,19169799,73394042,-54224243,625
2021-11-17 06:36:22-05:00,22,6zc2j7WaicYnnYjR6iMVLgJ9sqmvuKzkHNSSmcgbXrHw,5NBipewC9DDqx4p8cQn1UxRLZhDWyaTubUFoEzWdLH5Y,True,344295978,86073994,488459,244229,244230,72FwbpFGoLEazJEdpqNtPNefsadUrimUqma9wSoy4qiS,19538382,65748413,-46210031,567
2021-11-17 06:36:22-05:00,23,HNCJ9xJCwy9rBzYHDF4AsE677ueQDGHS1riTGoBGdDgh,D8ZBxkpAFu877Lnsuazfyme3nB5cHYsSoDCUrMPMPLe3,True,285091156,71272789,424331,212165,212166,72FwbpFGoLEazJEdpqNtPNefsadUrimUqma9wSoy4qiS,16973272,66275286,-49302014,595
2021-11-18 04:35:19-05:00,24,7qJorn74oJLvVFiDqfhRRSGvcxNuU6DTAhQDtkJ3ERnz,EXYBVDWDDvY6fb45EHxTjL7FWJGHN8Cy9FQFHCKSPrEC,True,211058704,52764676,308403,154201,154202,72FwbpFGoLEazJEdpqNtPNefsadUrimUqma9wSoy4qiS,12336123,51282819,-38946696,584
2021-11-18 04:35:20-05:00,25,82ahWrNx6L73jAvzt4PAv7FuhwSdGqG4KqAZWD2uwEZt,2funPHa9Xi1hcgj7rHc7NHDYQ5HjgZ7UvbnZpet3u7kQ,True,84570913,21142728,122750,61375,61375,72FwbpFGoLEazJEdpqNtPNefsadUrimUqma9wSoy4qiS,4910002,22533254,-17623252,580
2021-11-18 04:37:17-05:00,26,7ckvB1uchDPcA5vkjJvu4DHCkgGq81qbJrd4P2CwPDV8,pVjScFyTQfYJ74uA9JLEsChSrtY8fRi2dCM3jtWC6bp,True,31455807,7863951,48411,24205,24206,72FwbpFGoLEazJEdpqNtPNefsadUrimUqma9wSoy4qiS,1936461,8382947,-6446486,615
2021-11-18 04:37:17-05:00,27,3fB955q6xxxZcgnCyguLwkSa7egxgBoksPQVQ3U8HRHL,GK7cTdhfSpapJB8dFzEkV8c1UFkJPj281DwztnpKjxLx,True,734224303,183556075,1135148,567574,567574,72FwbpFGoLEazJEdpqNtPNefsadUrimUqma9wSoy4qiS,45405959,196230002,-150824043,618
2021-11-18 07:10:54-05:00,28,6zc2j7WaicYnnYjR6iMVLgJ9sqmvuKzkHNSSmcgbXrHw,5NBipewC9DDqx4p8cQn1UxRLZhDWyaTubUFoEzWdLH5Y,True,253983496,63495874,384784,192392,192392,72FwbpFGoLEazJEdpqNtPNefsadUrimUqma9wSoy4qiS,15391368,54293148,-38901780,605
2021-11-18 07:10:59-05:00,29,5F6M2rEMMvaFGWWCf8XioLucUfb7nnp96vx9BcbroVsD,EYxYvNkDPViCFpWt7nsnhU27BLNuMbikAV7tNjcs3fFe,True,78518409,19629602,120444,60222,60222,72FwbpFGoLEazJEdpqNtPNefsadUrimUqma9wSoy4qiS,4817771,19103387,-14285616,613
2021-11-18 08:20:16-05:00,30,HNCJ9xJCwy9rBzYHDF4AsE677ueQDGHS1riTGoBGdDgh,D8ZBxkpAFu877Lnsuazfyme3nB5cHYsSoDCUrMPMPLe3,True,209844870,52461217,327261,163630,163631,72FwbpFGoLEazJEdpqNtPNefsadUrimUqma9wSoy4qiS,13090441,54044549,-40954108,623
2021-11-18 08:20:16-05:00,31,A2gRXnnsmLvMSzZray4DJdn7dgsrZwwK8uxqnajnyZHs,Gtwdm7MT23sMC9bucL12YD9LLjWftjzGso887FsatiuN,True,511674698,127918674,792551,396275,396276,72FwbpFGoLEazJEdpqNtPNefsadUrimUqma9wSoy4qiS,31702048,121599840,-89897792,619
2021-11-18 08:26:16-05:00,32,82ahWrNx6L73jAvzt4PAv7FuhwSdGqG4KqAZWD2uwEZt,2funPHa9Xi1hcgj7rHc7NHDYQ5HjgZ7UvbnZpet3u7kQ,True,62463019,15615754,96469,48234,48235,72FwbpFGoLEazJEdpqNtPNefsadUrimUqma9wSoy4qiS,3858790,18041823,-14183033,617
2021-11-18 08:26:18-05:00,33,3Ek5j2ea8wS2nCxsNgn2AbovxzJwGK7zc6xarkigSA3u,DEWmTn3Ah4F3nNXpoQLt1GG65Dsf4ZmGjn7FZUJyK6rP,True,9648863001,2412215750,14711849,7355924,7355925,72FwbpFGoLEazJEdpqNtPNefsadUrimUqma9wSoy4qiS,588473981,2294065700,-1705591719,609
2021-11-18 08:26:18-05:00,34,EFHg5FatMRRSZnKJPJF9e1iw2cjPJRmwTTZYtkHno9DP,84LnLKhZDJgWFnbBYnYjqWkjymemXfidecPFwnUAvuFj,True,1875250752,468812688,2832332,1416166,1416166,72FwbpFGoLEazJEdpqNtPNefsadUrimUqma9wSoy4qiS,113293312,446689045,-333395733,604
2021-11-18 08:26:19-05:00,35,26F7WDhDLwsFPgkeUDruwUiRn1R6SWS9rD3t33Tn1Ueq,88RtRiccENAcTo3hExVk9KgWhW5zrfGY175KN5EhnejY,True,420461143,105115285,626973,313486,313487,72FwbpFGoLEazJEdpqNtPNefsadUrimUqma9wSoy4qiS,25078946,101583114,-76504168,596
2021-11-18 08:26:19-05:00,36,7qJorn74oJLvVFiDqfhRRSGvcxNuU6DTAhQDtkJ3ERnz,EXYBVDWDDvY6fb45EHxTjL7FWJGHN8Cy9FQFHCKSPrEC,True,155668659,38917164,237348,118674,118674,72FwbpFGoLEazJEdpqNtPNefsadUrimUqma9wSoy4qiS,9493953,41331624,-31837671,609
2021-11-18 08:26:19-05:00,37,BELLbzmdx1SYke9kZUxFi9VcdvwaHmkZyv24FArQ1J2f,5a5LfKakAaFEVkavVHgExKaUr25RWYpzFic6MUQQ62uc,True,12586404230,3146601057,19204976,9602488,9602488,72FwbpFGoLEazJEdpqNtPNefsadUrimUqma9wSoy4qiS,768199057,2992456467,-2224257410,610
2021-11-18 08:27:17-05:00,38,66SjFhmiNYz8tLRnBhZUbowWGTbM16G52X3AT2hma2wN,3wVy8nk24HCFZWMiacGe8QsJquYaadZ9pQg44bGRwdE3,True,223649976,55912494,328215,164107,164108,72FwbpFGoLEazJEdpqNtPNefsadUrimUqma9wSoy4qiS,13128638,59916842,-46788204,587
2021-11-18 08:27:19-05:00,39,CQSb6ZVY1KVNXFAg8pxm8RvBBGGqRSU7FMvwHJPy46u8,FRBv3b5VTfKN1bK4DXFY4329LFbvm882P47edrgpuSM,True,6151578840,1537894710,9266157,4633078,4633079,72FwbpFGoLEazJEdpqNtPNefsadUrimUqma9wSoy4qiS,370646284,1130588794,-759942510,602
2021-11-18 08:27:19-05:00,40,AzmgakTxLAutgbcNkxi3S4M6MvuZvwcrzMc43ErMFk4h,7KR9xHmrpNDAuYo63YTTvWuaKsjbzF3bPTWDudsJK9oU,True,434658457,108664614,658799,329399,329400,72FwbpFGoLEazJEdpqNtPNefsadUrimUqma9wSoy4qiS,26351972,113882515,-87530543,606
2021-11-18 08:27:21-05:00,41,2XFYFxNQbCr5ao4cVzRZt45fsAwZc4jD9XTABmdqaJWd,CvpzBuDjyimaYFGWFkkBcaZGSRtAvtF6MtRV54mqZ74k,True,4230725,1057681,6440,3220,3220,72FwbpFGoLEazJEdpqNtPNefsadUrimUqma9wSoy4qiS,257622,1025897,-768275,608
2021-11-18 08:27:22-05:00,42,EQYUWtYbtvN9C9ixiupXPjHyFWHsYa7dUh4DSd6rxbzt,iS616uGNCwCxP1taAvvdvA2KdqfXRSjcQWwZRUgBkLb,True,72557222,18139305,106395,53197,53198,72FwbpFGoLEazJEdpqNtPNefsadUrimUqma9wSoy4qiS,4255810,17580388,-13324578,586
2021-11-18 08:27:22-05:00,43,36ByQojnxEckWdQTjqHfxKqCx9yjqWQsPsZyqaN72UWR,AZoirtS1fjX61agRM64tqThVinnJTh3BWgiHyNHPTgZP,True,63741003,15935250,97662,48831,48831,72FwbpFGoLEazJEdpqNtPNefsadUrimUqma9wSoy4qiS,3906499,15164496,-11257997,612
2021-11-18 08:27:35-05:00,44,EvSdLa5PeJiaaaE3omJNG7cw1tptZnHTituYswVHSwm3,68ESX2mBsfxQo2U9jsbmHo7TzPTxr9mGH5Y11ZLR7E3A,True,849278040,212319510,1283255,641627,641628,72FwbpFGoLEazJEdpqNtPNefsadUrimUqma9wSoy4qiS,51330227,202051187,-150720960,604
2021-11-18 08:55:17-05:00,45,8nXbrdjjaHB73CRPRenGEQj73wbtEFGDwXsehRGMhsap,43pvdcJ6f27wz94D6ZboKwRJYbyvYCrjsJhYsvk7LJCM,True,263455372,65863843,411779,205889,205890,72FwbpFGoLEazJEdpqNtPNefsadUrimUqma9wSoy4qiS,16471180,64837056,-48365876,625
2021-11-18 09:19:56-05:00,46,7ckvB1uchDPcA5vkjJvu4DHCkgGq81qbJrd4P2CwPDV8,pVjScFyTQfYJ74uA9JLEsChSrtY8fRi2dCM3jtWC6bp,True,23131331,5782832,36138,18069,18069,72FwbpFGoLEazJEdpqNtPNefsadUrimUqma9wSoy4qiS,1445534,6741005,-5295471,624
2021-11-18 09:21:54-05:00,47,3fB955q6xxxZcgnCyguLwkSa7egxgBoksPQVQ3U8HRHL,GK7cTdhfSpapJB8dFzEkV8c1UFkJPj281DwztnpKjxLx,True,539753368,134938342,844410,422205,422205,72FwbpFGoLEazJEdpqNtPNefsadUrimUqma9wSoy4qiS,33776400,157837180,-124060780,625
2021-11-18 09:22:55-05:00,48,J5WcVsKNHbfioai1LRowvjvtEmUJBEkeoBim1ThshpoP,Ajh7SWBq3zJR4vb6AFoBS6C9D99wC6YF1sVN22qC1vCA,True,68115782,17028945,106144,53072,53072,72FwbpFGoLEazJEdpqNtPNefsadUrimUqma9wSoy4qiS,4245770,16601048,-12355278,623
2021-11-18 09:26:56-05:00,49,FpqCxvTkSiwDwD5qEt6hXJxzFDLFLAQ8VevK8zwRqYun,A3p6YQisCJKpNkF7vkjZRbEfbnUt7vTZdR2zPBUSdTkk,True,408660222,102165055,639122,319561,319561,72FwbpFGoLEazJEdpqNtPNefsadUrimUqma9wSoy4qiS,25564893,98695221,-73130328,625
2021-11-18 09:28:55-05:00,50,6meAnGTy2XNUDk9qSJZGT6BBRinA5iGiDYEy2T88LXuX,BCzNQCn3J1381yNH5xp5ky9QmVKVdSofSUaLHtxKxPBW,True,4245793,1061448,6628,3314,3314,72FwbpFGoLEazJEdpqNtPNefsadUrimUqma9wSoy4qiS,265144,1018351,-753207,624
2021-11-18 09:28:55-05:00,51,EDE1swNYZ99y9idZacAw5Ncwz2DyD78SqvKMUXA2Dbw4,HSmYYMpNQNr1F2zjvysGRrC57FyusAJNsaXWfbmCfZh4,True,120751016,30187754,187648,93824,93824,72FwbpFGoLEazJEdpqNtPNefsadUrimUqma9wSoy4qiS,7505959,35696335,-28190376,621
2021-11-18 09:43:17-05:00,52,6zc2j7WaicYnnYjR6iMVLgJ9sqmvuKzkHNSSmcgbXrHw,5NBipewC9DDqx4p8cQn1UxRLZhDWyaTubUFoEzWdLH5Y,True,187099811,46774952,292135,146067,146068,72FwbpFGoLEazJEdpqNtPNefsadUrimUqma9wSoy4qiS,11685407,44252758,-32567351,624
2021-11-18 09:43:17-05:00,53,3A5AuwDWP4fT7RUqNBj51AxdS4uYkjEZmFYrykBJPp1X,GEXVPiMjcD2RS8jcEmo3k8CET3bJ8Fv3cAUn1ZwhxJy6,True,31144977083,7786244270,48055613,24027806,24027807,72FwbpFGoLEazJEdpqNtPNefsadUrimUqma9wSoy4qiS,1922224555,10079235642,-8157011087,617
2021-11-18 09:44:15-05:00,54,5F6M2rEMMvaFGWWCf8XioLucUfb7nnp96vx9BcbroVsD,EYxYvNkDPViCFpWt7nsnhU27BLNuMbikAV7tNjcs3fFe,True,57603118,14400779,85805,42902,42903,72FwbpFGoLEazJEdpqNtPNefsadUrimUqma9wSoy4qiS,3432227,15432505,-12000278,595
2021-11-18 09:44:17-05:00,55,J2gTwrYpzezkRupgBtgudQn5D33x6WjeBhTHnrA1qgqa,FBzoHRwqGRjnMvPEpiZVjtGZYJmAbneE4dpToXPzy8bv,True,42376177448,10594044362,65155050,32577525,32577525,72FwbpFGoLEazJEdpqNtPNefsadUrimUqma9wSoy4qiS,2606202004,10230023556,-7623821552,615
2021-11-18 09:45:15-05:00,56,E5KDZriZ89a5D4VsMaWxndMMG68RT4weruJ1tCEc6tSx,CaSwkUocpbyyGCQBgKjJZJgcexbyqs2GTrGJH6EMWXAz,True,42291150405,10572787601,62974033,31487016,31487017,72FwbpFGoLEazJEdpqNtPNefsadUrimUqma9wSoy4qiS,2518961323,10227809918,-7708848595,595
2021-11-18 09:45:15-05:00,57,82ahWrNx6L73jAvzt4PAv7FuhwSdGqG4KqAZWD2uwEZt,2funPHa9Xi1hcgj7rHc7NHDYQ5HjgZ7UvbnZpet3u7kQ,True,45712477,11428119,65905,32952,32953,72FwbpFGoLEazJEdpqNtPNefsadUrimUqma9wSoy4qiS,2636225,14408554,-11772329,576
2021-11-18 09:45:17-05:00,58,HNCJ9xJCwy9rBzYHDF4AsE677ueQDGHS1riTGoBGdDgh,D8ZBxkpAFu877Lnsuazfyme3nB5cHYsSoDCUrMPMPLe3,True,152994206,38248551,210070,105035,105035,72FwbpFGoLEazJEdpqNtPNefsadUrimUqma9wSoy4qiS,8402826,43510143,-35107317,549
2021-11-18 09:45:19-05:00,59,3Ek5j2ea8wS2nCxsNgn2AbovxzJwGK7zc6xarkigSA3u,DEWmTn3Ah4F3nNXpoQLt1GG65Dsf4ZmGjn7FZUJyK6rP,True,7069173332,1767293333,10190866,5095433,5095433,72FwbpFGoLEazJEdpqNtPNefsadUrimUqma9wSoy4qiS,407634677,1859031518,-1451396841,576
2021-11-18 09:45:19-05:00,60,66SjFhmiNYz8tLRnBhZUbowWGTbM16G52X3AT2hma2wN,3wVy8nk24HCFZWMiacGe8QsJquYaadZ9pQg44bGRwdE3,True,164254987,41063746,233729,116864,116865,72FwbpFGoLEazJEdpqNtPNefsadUrimUqma9wSoy4qiS,9349189,47925479,-38576290,569
2021-11-18 09:45:19-05:00,61,26F7WDhDLwsFPgkeUDruwUiRn1R6SWS9rD3t33Tn1Ueq,88RtRiccENAcTo3hExVk9KgWhW5zrfGY175KN5EhnejY,True,307864068,76966017,425719,212859,212860,72FwbpFGoLEazJEdpqNtPNefsadUrimUqma9wSoy4qiS,17028778,81897729,-64868951,553
2021-11-18 09:45:20-05:00,62,4xsYjVsPm2C2itNtJb3NYkBp4WySHUwtSbWdu9fge8wz,8zu2jMoTndZpf9khY9PMhve88LRwrKNTuVuLpa5ss8qo,True,2111279004,527819751,2905598,1452799,1452799,72FwbpFGoLEazJEdpqNtPNefsadUrimUqma9wSoy4qiS,116223943,504991684,-388767741,550
2021-11-18 09:45:20-05:00,63,7DWHQdHp5svNzMwB6E5sStKHdHTw2jWwhK5pGHW8bjXg,EG3PvMxk7SP6J9aDwkPBBqtZYckFHWGTfsnK8nunhYka,True,107006179,26751544,144400,72200,72200,72FwbpFGoLEazJEdpqNtPNefsadUrimUqma9wSoy4qiS,5776019,25796685,-20020666,539
2021-11-18 09:45:20-05:00,64,7qJorn74oJLvVFiDqfhRRSGvcxNuU6DTAhQDtkJ3ERnz,EXYBVDWDDvY6fb45EHxTjL7FWJGHN8Cy9FQFHCKSPrEC,True,113949939,28487484,161918,80959,80959,72FwbpFGoLEazJEdpqNtPNefsadUrimUqma9wSoy4qiS,6476742,33157817,-26681075,568
2021-11-18 09:45:20-05:00,65,7zDNgPFeomS1hdQhuY8iGF3nnGMNnx1YrinZJetrefje,AKyG5R6Bac6Fu83ruL9FGpjKCfDKxbP6QfEGbCgqegiV,True,409767671,102441917,556359,278179,278180,72FwbpFGoLEazJEdpqNtPNefsadUrimUqma9wSoy4qiS,22254386,97635132,-75380746,543
2021-11-18 09:45:20-05:00,66,EFHg5FatMRRSZnKJPJF9e1iw2cjPJRmwTTZYtkHno9DP,84LnLKhZDJgWFnbBYnYjqWkjymemXfidecPFwnUAvuFj,True,1372519660,343129915,1920099,960049,960050,72FwbpFGoLEazJEdpqNtPNefsadUrimUqma9wSoy4qiS,76803965,360947969,-284144004,559
2021-11-18 09:51:16-05:00,67,EQYUWtYbtvN9C9ixiupXPjHyFWHsYa7dUh4DSd6rxbzt,iS616uGNCwCxP1taAvvdvA2KdqfXRSjcQWwZRUgBkLb,True,53595891,13398972,83438,41719,41719,72FwbpFGoLEazJEdpqNtPNefsadUrimUqma9wSoy4qiS,3337538,14153280,-10815742,622
2021-11-18 09:55:16-05:00,68,BELLbzmdx1SYke9kZUxFi9VcdvwaHmkZyv24FArQ1J2f,5a5LfKakAaFEVkavVHgExKaUr25RWYpzFic6MUQQ62uc,True,9264879654,2316219913,14395772,7197886,7197886,72FwbpFGoLEazJEdpqNtPNefsadUrimUqma9wSoy4qiS,575830891,2427001038,-1851170147,621
2021-11-18 09:58:15-05:00,69,8d333AWdyiVhvkAdiKCTwhgzaPBMbn8mtucwUC1SAbZZ,3BM8UNLN7XGRaYRjezAqFVMr1z4PS3VRXiN1NAtvBuD9,True,495185323,123796330,753891,376945,376946,72FwbpFGoLEazJEdpqNtPNefsadUrimUqma9wSoy4qiS,30155678,119969355,-89813677,608
2021-11-18 09:58:16-05:00,70,EvSdLa5PeJiaaaE3omJNG7cw1tptZnHTituYswVHSwm3,68ESX2mBsfxQo2U9jsbmHo7TzPTxr9mGH5Y11ZLR7E3A,True,625507296,156376824,967866,483933,483933,72FwbpFGoLEazJEdpqNtPNefsadUrimUqma9wSoy4qiS,38714659,163243378,-124528719,618
2021-11-18 09:58:16-05:00,71,36ByQojnxEckWdQTjqHfxKqCx9yjqWQsPsZyqaN72UWR,AZoirtS1fjX61agRM64tqThVinnJTh3BWgiHyNHPTgZP,True,46900742,11725185,72818,36409,36409,72FwbpFGoLEazJEdpqNtPNefsadUrimUqma9wSoy4qiS,2912742,12261513,-9348771,621
2021-11-18 09:58:16-05:00,72,CQSb6ZVY1KVNXFAg8pxm8RvBBGGqRSU7FMvwHJPy46u8,FRBv3b5VTfKN1bK4DXFY4329LFbvm882P47edrgpuSM,True,4526046613,1131511653,6865098,3432549,3432549,72FwbpFGoLEazJEdpqNtPNefsadUrimUqma9wSoy4qiS,274603950,934037279,-659433329,606
2021-11-18 09:58:18-05:00,73,2XFYFxNQbCr5ao4cVzRZt45fsAwZc4jD9XTABmdqaJWd,CvpzBuDjyimaYFGWFkkBcaZGSRtAvtF6MtRV54mqZ74k,True,3111405,777851,4753,2376,2377,72FwbpFGoLEazJEdpqNtPNefsadUrimUqma9wSoy4qiS,190134,828047,-637913,611
2021-11-18 09:58:19-05:00,74,AzmgakTxLAutgbcNkxi3S4M6MvuZvwcrzMc43ErMFk4h,7KR9xHmrpNDAuYo63YTTvWuaKsjbzF3bPTWDudsJK9oU,True,319645813,79911453,485148,242574,242574,72FwbpFGoLEazJEdpqNtPNefsadUrimUqma9wSoy4qiS,19405946,91411736,-72005790,607
2021-11-18 10:11:18-05:00,75,8nXbrdjjaHB73CRPRenGEQj73wbtEFGDwXsehRGMhsap,43pvdcJ6f27wz94D6ZboKwRJYbyvYCrjsJhYsvk7LJCM,True,193573515,48393378,302816,151408,151408,72FwbpFGoLEazJEdpqNtPNefsadUrimUqma9wSoy4qiS,12112672,52408670,-40295998,625
2021-11-18 10:13:18-05:00,76,7ckvB1uchDPcA5vkjJvu4DHCkgGq81qbJrd4P2CwPDV8,pVjScFyTQfYJ74uA9JLEsChSrtY8fRi2dCM3jtWC6bp,True,16998011,4249502,26548,13274,13274,72FwbpFGoLEazJEdpqNtPNefsadUrimUqma9wSoy4qiS,1061939,5384109,-4322170,624
2021-11-18 10:13:18-05:00,77,9b5c6WqiKuBa6ARf1evmyrDZ8rYv2VCgjSDME7HFbzGk,65TnTCwZ8nTgu8CXXAMvjm6iZhdjwGxmWZnmAgWeebYM,True,543161554,135790388,842403,421201,421202,72FwbpFGoLEazJEdpqNtPNefsadUrimUqma9wSoy4qiS,33696157,129121268,-95425111,620
2021-11-18 10:14:17-05:00,78,J5WcVsKNHbfioai1LRowvjvtEmUJBEkeoBim1ThshpoP,Ajh7SWBq3zJR4vb6AFoBS6C9D99wC6YF1sVN22qC1vCA,True,50067166,12516791,78222,39111,39111,72FwbpFGoLEazJEdpqNtPNefsadUrimUqma9wSoy4qiS,3128890,13415276,-10286386,624
2021-11-18 10:14:18-05:00,79,3fB955q6xxxZcgnCyguLwkSa7egxgBoksPQVQ3U8HRHL,GK7cTdhfSpapJB8dFzEkV8c1UFkJPj281DwztnpKjxLx,True,396512066,99128016,617495,308747,308748,72FwbpFGoLEazJEdpqNtPNefsadUrimUqma9wSoy4qiS,24699804,126063918,-101364114,622
2021-11-18 10:15:21-05:00,80,FpqCxvTkSiwDwD5qEt6hXJxzFDLFLAQ8VevK8zwRqYun,A3p6YQisCJKpNkF7vkjZRbEfbnUt7vTZdR2zPBUSdTkk,True,300181552,75045388,466645,233322,233323,72FwbpFGoLEazJEdpqNtPNefsadUrimUqma9wSoy4qiS,18665800,79835746,-61169946,621
2021-11-18 10:16:26-05:00,81,EDE1swNYZ99y9idZacAw5Ncwz2DyD78SqvKMUXA2Dbw4,HSmYYMpNQNr1F2zjvysGRrC57FyusAJNsaXWfbmCfZh4,True,88752328,22188082,138081,69040,69041,72FwbpFGoLEazJEdpqNtPNefsadUrimUqma9wSoy4qiS,5523240,28477746,-22954506,622
2021-11-18 10:17:21-05:00,82,6meAnGTy2XNUDk9qSJZGT6BBRinA5iGiDYEy2T88LXuX,BCzNQCn3J1381yNH5xp5ky9QmVKVdSofSUaLHtxKxPBW,True,3118482,779620,4830,2415,2415,72FwbpFGoLEazJEdpqNtPNefsadUrimUqma9wSoy4qiS,193210,823990,-630780,619
2021-11-18 10:18:18-05:00,83,DXZMRSKFgnNdiXHps2xzayuztJNH9EUUz2wkCCneXtW5,9Z2sUfTCZCkmw5n3HSsoLG992AcpJo2qxp7XpJnnBxZM,True,121458953,30364738,187677,93838,93839,72FwbpFGoLEazJEdpqNtPNefsadUrimUqma9wSoy4qiS,7507105,29597161,-22090056,618
2021-11-18 10:20:16-05:00,84,6zc2j7WaicYnnYjR6iMVLgJ9sqmvuKzkHNSSmcgbXrHw,5NBipewC9DDqx4p8cQn1UxRLZhDWyaTubUFoEzWdLH5Y,True,137471424,34367856,214112,107056,107056,72FwbpFGoLEazJEdpqNtPNefsadUrimUqma9wSoy4qiS,8564480,35845261,-27280781,623
2021-11-18 10:20:16-05:00,85,5F6M2rEMMvaFGWWCf8XioLucUfb7nnp96vx9BcbroVsD,EYxYvNkDPViCFpWt7nsnhU27BLNuMbikAV7tNjcs3fFe,True,42478478,10619619,65754,32877,32877,72FwbpFGoLEazJEdpqNtPNefsadUrimUqma9wSoy4qiS,2630175,12354458,-9724283,619
2021-11-18 10:21:18-05:00,86,3PmLtoHk5uuB5e6KNUqr9XaFiZYSMSB6yt1k5xzHUFUv,DyrVKXFMchomdbzRaK4CEwYwVMFbGYVja6hwGJQJvUMH,True,1452381802,363095450,2238026,1119013,1119013,72FwbpFGoLEazJEdpqNtPNefsadUrimUqma9wSoy4qiS,89521049,392083423,-302562374,616
2021-11-18 10:24:18-05:00,87,3A5AuwDWP4fT7RUqNBj51AxdS4uYkjEZmFYrykBJPp1X,GEXVPiMjcD2RS8jcEmo3k8CET3bJ8Fv3cAUn1ZwhxJy6,True,22913240139,5728310034,35820390,17910195,17910195,72FwbpFGoLEazJEdpqNtPNefsadUrimUqma9wSoy4qiS,1432815612,8049286942,-6616471330,625
2021-11-18 10:24:18-05:00,88,HNCJ9xJCwy9rBzYHDF4AsE677ueQDGHS1riTGoBGdDgh,D8ZBxkpAFu877Lnsuazfyme3nB5cHYsSoDCUrMPMPLe3,True,113260723,28315180,168205,84102,84103,72FwbpFGoLEazJEdpqNtPNefsadUrimUqma9wSoy4qiS,6728230,34544949,-27816719,594
2021-11-18 10:24:18-05:00,89,7zDNgPFeomS1hdQhuY8iGF3nnGMNnx1YrinZJetrefje,AKyG5R6Bac6Fu83ruL9FGpjKCfDKxbP6QfEGbCgqegiV,True,303707994,75926998,453374,226687,226687,72FwbpFGoLEazJEdpqNtPNefsadUrimUqma9wSoy4qiS,18134989,78297014,-60162025,597
2021-11-18 10:24:18-05:00,90,7DWHQdHp5svNzMwB6E5sStKHdHTw2jWwhK5pGHW8bjXg,EG3PvMxk7SP6J9aDwkPBBqtZYckFHWGTfsnK8nunhYka,True,79302367,19825591,117340,58670,58670,72FwbpFGoLEazJEdpqNtPNefsadUrimUqma9wSoy4qiS,4693639,20662052,-15968413,591
2021-11-18 10:25:17-05:00,91,3XzkSrNTGd3Fhd4M3gYzvz2utbQpFN1fhtbAaZu7C39R,GMsZGGfktTzYi7GhD3W6HY9QY9bznqTKfeArksikLE71,True,20670789,5167697,31429,15714,15715,72FwbpFGoLEazJEdpqNtPNefsadUrimUqma9wSoy4qiS,1257163,5085393,-3828230,608
2021-11-18 10:25:18-05:00,92,26F7WDhDLwsFPgkeUDruwUiRn1R6SWS9rD3t33Tn1Ueq,88RtRiccENAcTo3hExVk9KgWhW5zrfGY175KN5EhnejY,True,227988000,56997000,343352,171676,171676,72FwbpFGoLEazJEdpqNtPNefsadUrimUqma9wSoy4qiS,13734108,65300929,-51566821,602
2021-11-18 10:25:18-05:00,93,82ahWrNx6L73jAvzt4PAv7FuhwSdGqG4KqAZWD2uwEZt,2funPHa9Xi1hcgj7rHc7NHDYQ5HjgZ7UvbnZpet3u7kQ,True,33821151,8455287,52830,26415,26415,72FwbpFGoLEazJEdpqNtPNefsadUrimUqma9wSoy4qiS,2113209,11405843,-9292634,624
2021-11-18 10:25:19-05:00,94,57GUgfEp9ZQ5iAU2nx1Z2Tiz3gqq7yBNaqfE1cvxjFYt,98upivFa9Tdy3RZHGM1i2k5zeczaGqioq3rTzc3DMf4x,True,437207805,109301951,670348,335174,335174,72FwbpFGoLEazJEdpqNtPNefsadUrimUqma9wSoy4qiS,26813931,120624442,-93810511,613
2021-11-18 10:25:19-05:00,95,EFHg5FatMRRSZnKJPJF9e1iw2cjPJRmwTTZYtkHno9DP,84LnLKhZDJgWFnbBYnYjqWkjymemXfidecPFwnUAvuFj,True,1016651737,254162934,1558230,779115,779115,72FwbpFGoLEazJEdpqNtPNefsadUrimUqma9wSoy4qiS,62329212,288274608,-225945396,613
2021-11-18 10:25:19-05:00,96,4xsYjVsPm2C2itNtJb3NYkBp4WySHUwtSbWdu9fge8wz,8zu2jMoTndZpf9khY9PMhve88LRwrKNTuVuLpa5ss8qo,True,1563315078,390828769,2336404,1168202,1168202,72FwbpFGoLEazJEdpqNtPNefsadUrimUqma9wSoy4qiS,93456185,405406859,-311950674,597
2021-11-18 10:25:20-05:00,97,66SjFhmiNYz8tLRnBhZUbowWGTbM16G52X3AT2hma2wN,3wVy8nk24HCFZWMiacGe8QsJquYaadZ9pQg44bGRwdE3,True,121567163,30391790,187832,93916,93916,72FwbpFGoLEazJEdpqNtPNefsadUrimUqma9wSoy4qiS,7513308,38071109,-30557801,618
2021-11-18 10:25:20-05:00,98,7qJorn74oJLvVFiDqfhRRSGvcxNuU6DTAhQDtkJ3ERnz,EXYBVDWDDvY6fb45EHxTjL7FWJGHN8Cy9FQFHCKSPrEC,True,84360427,21090106,130700,65350,65350,72FwbpFGoLEazJEdpqNtPNefsadUrimUqma9wSoy4qiS,5228012,26341558,-21113546,619
2021-11-18 10:26:15-05:00,99,J2gTwrYpzezkRupgBtgudQn5D33x6WjeBhTHnrA1qgqa,FBzoHRwqGRjnMvPEpiZVjtGZYJmAbneE4dpToXPzy8bv,True,31163779066,7790944766,48209107,24104553,24104554,72FwbpFGoLEazJEdpqNtPNefsadUrimUqma9wSoy4qiS,1928364286,8356936515,-6428572229,618
2021-11-18 10:26:15-05:00,100,3Ek5j2ea8wS2nCxsNgn2AbovxzJwGK7zc6xarkigSA3u,DEWmTn3Ah4F3nNXpoQLt1GG65Dsf4ZmGjn7FZUJyK6rP,True,5204417208,1301104302,7523145,3761572,3761573,72FwbpFGoLEazJEdpqNtPNefsadUrimUqma9wSoy4qiS,300925823,1489568013,-1188642190,578
2021-11-18 10:27:24-05:00,101,HfRH3JeKFL399DkU3omcbiXjKvfdVq8YuXBN1rtrcwxz,3pgq9GHmS5DSUqwtPEAx5WgfHwAp65teUyTbnQVuq1UA,True,21132854,5283213,31308,15654,15654,72FwbpFGoLEazJEdpqNtPNefsadUrimUqma9wSoy4qiS,1252342,5121973,-3869631,592
2021-11-18 10:27:24-05:00,102,E5KDZriZ89a5D4VsMaWxndMMG68RT4weruJ1tCEc6tSx,CaSwkUocpbyyGCQBgKjJZJgcexbyqs2GTrGJH6EMWXAz,True,31068030927,7767007731,45283447,22641723,22641724,72FwbpFGoLEazJEdpqNtPNefsadUrimUqma9wSoy4qiS,1811337898,8335656089,-6524318191,583
2021-11-18 10:27:27-05:00,103,36ByQojnxEckWdQTjqHfxKqCx9yjqWQsPsZyqaN72UWR,AZoirtS1fjX61agRM64tqThVinnJTh3BWgiHyNHPTgZP,True,34317688,8579422,49707,24853,24854,72FwbpFGoLEazJEdpqNtPNefsadUrimUqma9wSoy4qiS,1988308,9857876,-7869568,579
2021-11-18 10:27:29-05:00,104,2XFYFxNQbCr5ao4cVzRZt45fsAwZc4jD9XTABmdqaJWd,CvpzBuDjyimaYFGWFkkBcaZGSRtAvtF6MtRV54mqZ74k,True,2277907,569476,3253,1626,1627,72FwbpFGoLEazJEdpqNtPNefsadUrimUqma9wSoy4qiS,130149,664253,-534104,571
2021-11-18 10:27:34-05:00,105,8nXbrdjjaHB73CRPRenGEQj73wbtEFGDwXsehRGMhsap,43pvdcJ6f27wz94D6ZboKwRJYbyvYCrjsJhYsvk7LJCM,True,141776801,35444200,210163,105081,105082,72FwbpFGoLEazJEdpqNtPNefsadUrimUqma9wSoy4qiS,8406520,42033889,-33627369,592
2021-11-18 10:27:34-05:00,106,EQYUWtYbtvN9C9ixiupXPjHyFWHsYa7dUh4DSd6rxbzt,iS616uGNCwCxP1taAvvdvA2KdqfXRSjcQWwZRUgBkLb,True,39062986,9765746,53182,26591,26591,72FwbpFGoLEazJEdpqNtPNefsadUrimUqma9wSoy4qiS,2127285,11373205,-9245920,544
2021-11-18 10:27:37-05:00,107,CQSb6ZVY1KVNXFAg8pxm8RvBBGGqRSU7FMvwHJPy46u8,FRBv3b5VTfKN1bK4DXFY4329LFbvm882P47edrgpuSM,True,3313448254,828362063,4681411,2340705,2340706,72FwbpFGoLEazJEdpqNtPNefsadUrimUqma9wSoy4qiS,187256452,763943372,-576686920,565
2021-11-18 10:27:37-05:00,108,EvSdLa5PeJiaaaE3omJNG7cw1tptZnHTituYswVHSwm3,68ESX2mBsfxQo2U9jsbmHo7TzPTxr9mGH5Y11ZLR7E3A,True,457497802,114374450,654938,327469,327469,72FwbpFGoLEazJEdpqNtPNefsadUrimUqma9wSoy4qiS,26197537,131247284,-105049747,572
2021-11-18 10:27:37-05:00,109,AzmgakTxLAutgbcNkxi3S4M6MvuZvwcrzMc43ErMFk4h,7KR9xHmrpNDAuYo63YTTvWuaKsjbzF3bPTWDudsJK9oU,True,233910605,58477651,328492,164246,164246,72FwbpFGoLEazJEdpqNtPNefsadUrimUqma9wSoy4qiS,13139691,72973326,-59833635,561
2021-11-18 10:27:37-05:00,110,8d333AWdyiVhvkAdiKCTwhgzaPBMbn8mtucwUC1SAbZZ,3BM8UNLN7XGRaYRjezAqFVMr1z4PS3VRXiN1NAtvBuD9,True,362123835,90530958,505066,252533,252533,72FwbpFGoLEazJEdpqNtPNefsadUrimUqma9wSoy4qiS,20202658,96840749,-76638091,557
2021-11-18 10:27:38-05:00,111,BELLbzmdx1SYke9kZUxFi9VcdvwaHmkZyv24FArQ1J2f,5a5LfKakAaFEVkavVHgExKaUr25RWYpzFic6MUQQ62uc,True,6764584126,1691146031,9464871,4732435,4732436,72FwbpFGoLEazJEdpqNtPNefsadUrimUqma9wSoy4qiS,378594870,1955541773,-1576946903,559
2021-11-18 11:31:18-05:00,112,J5WcVsKNHbfioai1LRowvjvtEmUJBEkeoBim1ThshpoP,Ajh7SWBq3zJR4vb6AFoBS6C9D99wC6YF1sVN22qC1vCA,True,36779372,9194843,57466,28733,28733,72FwbpFGoLEazJEdpqNtPNefsadUrimUqma9wSoy4qiS,2298644,10784628,-8485984,624
2021-11-18 11:31:18-05:00,113,9b5c6WqiKuBa6ARf1evmyrDZ8rYv2VCgjSDME7HFbzGk,65TnTCwZ8nTgu8CXXAMvjm6iZhdjwGxmWZnmAgWeebYM,True,398721943,99680485,610257,305128,305129,72FwbpFGoLEazJEdpqNtPNefsadUrimUqma9wSoy4qiS,24410307,104643595,-80233288,612
2021-11-18 11:31:18-05:00,114,3fB955q6xxxZcgnCyguLwkSa7egxgBoksPQVQ3U8HRHL,GK7cTdhfSpapJB8dFzEkV8c1UFkJPj281DwztnpKjxLx,True,291275614,72818903,453105,226552,226553,72FwbpFGoLEazJEdpqNtPNefsadUrimUqma9wSoy4qiS,18124201,100264365,-82140164,622
2021-11-18 11:31:18-05:00,115,7ckvB1uchDPcA5vkjJvu4DHCkgGq81qbJrd4P2CwPDV8,pVjScFyTQfYJ74uA9JLEsChSrtY8fRi2dCM3jtWC6bp,True,12476212,3119053,19238,9619,9619,72FwbpFGoLEazJEdpqNtPNefsadUrimUqma9wSoy4qiS,769532,4283542,-3514010,616
2021-11-18 11:34:18-05:00,116,FpqCxvTkSiwDwD5qEt6hXJxzFDLFLAQ8VevK8zwRqYun,A3p6YQisCJKpNkF7vkjZRbEfbnUt7vTZdR2zPBUSdTkk,True,220586284,55146571,344080,172040,172040,72FwbpFGoLEazJEdpqNtPNefsadUrimUqma9wSoy4qiS,13763218,64195344,-50432126,623
2021-11-18 11:35:16-05:00,117,6meAnGTy2XNUDk9qSJZGT6BBRinA5iGiDYEy2T88LXuX,BCzNQCn3J1381yNH5xp5ky9QmVKVdSofSUaLHtxKxPBW,True,2290920,572730,3540,1770,1770,72FwbpFGoLEazJEdpqNtPNefsadUrimUqma9wSoy4qiS,141622,662711,-521089,618
2021-11-18 11:35:16-05:00,118,EDE1swNYZ99y9idZacAw5Ncwz2DyD78SqvKMUXA2Dbw4,HSmYYMpNQNr1F2zjvysGRrC57FyusAJNsaXWfbmCfZh4,True,65159844,16289961,100361,50180,50181,72FwbpFGoLEazJEdpqNtPNefsadUrimUqma9wSoy4qiS,4014451,22635175,-18620724,616
2021-11-18 11:35:17-05:00,119,DXZMRSKFgnNdiXHps2xzayuztJNH9EUUz2wkCCneXtW5,9Z2sUfTCZCkmw5n3HSsoLG992AcpJo2qxp7XpJnnBxZM,True,89304340,22326085,139393,69696,69697,72FwbpFGoLEazJEdpqNtPNefsadUrimUqma9wSoy4qiS,5575732,23933968,-18358236,624
2021-11-18 12:03:13-05:00,120,5F6M2rEMMvaFGWWCf8XioLucUfb7nnp96vx9BcbroVsD,EYxYvNkDPViCFpWt7nsnhU27BLNuMbikAV7tNjcs3fFe,True,31210620,7802655,48706,24353,24353,72FwbpFGoLEazJEdpqNtPNefsadUrimUqma9wSoy4qiS,1948263,9889813,-7941550,624
2021-11-18 12:07:14-05:00,121,FZhvN1RjLoBK9EpCeyEobYsvdHirtbTXV82c9EV9nn2u,FSeHqYNof79JYrRb7ZkJWEb4TfS5wx7HTdvT1kLCexHM,True,123917896,30979474,189729,94864,94865,72FwbpFGoLEazJEdpqNtPNefsadUrimUqma9wSoy4qiS,7589181,30069915,-22480734,612
2021-11-18 12:07:14-05:00,122,4xsYjVsPm2C2itNtJb3NYkBp4WySHUwtSbWdu9fge8wz,8zu2jMoTndZpf9khY9PMhve88LRwrKNTuVuLpa5ss8qo,True,1151164028,287791007,1774643,887321,887322,72FwbpFGoLEazJEdpqNtPNefsadUrimUqma9wSoy4qiS,70985752,326400030,-255414278,616
2021-11-18 12:07:16-05:00,123,3PmLtoHk5uuB5e6KNUqr9XaFiZYSMSB6yt1k5xzHUFUv,DyrVKXFMchomdbzRaK4CEwYwVMFbGYVja6hwGJQJvUMH,True,1064078010,266019502,1579329,789664,789665,72FwbpFGoLEazJEdpqNtPNefsadUrimUqma9wSoy4qiS,63173168,315415177,-252242009,593
2021-11-18 12:07:16-05:00,124,3XzkSrNTGd3Fhd4M3gYzvz2utbQpFN1fhtbAaZu7C39R,GMsZGGfktTzYi7GhD3W6HY9QY9bznqTKfeArksikLE71,True,15208879,3802219,23680,11840,11840,72FwbpFGoLEazJEdpqNtPNefsadUrimUqma9wSoy4qiS,947219,4112693,-3165474,622
2021-11-18 12:07:16-05:00,125,Gs3WP18hbzNpbBgiU39e6tfkggfCKRyNqPqJQcthuHFD,4XAY25YUma6gUdG2GdbXeivum3t21g93ZagfWGTZYkWZ,True,94249166,23562291,145701,72850,72851,72FwbpFGoLEazJEdpqNtPNefsadUrimUqma9wSoy4qiS,5828076,23597379,-17769303,618
2021-11-18 12:07:18-05:00,126,7zDNgPFeomS1hdQhuY8iGF3nnGMNnx1YrinZJetrefje,AKyG5R6Bac6Fu83ruL9FGpjKCfDKxbP6QfEGbCgqegiV,True,223344749,55836187,336898,168449,168449,72FwbpFGoLEazJEdpqNtPNefsadUrimUqma9wSoy4qiS,13475921,63038561,-49562640,603
2021-11-18 12:07:18-05:00,127,7DWHQdHp5svNzMwB6E5sStKHdHTw2jWwhK5pGHW8bjXg,EG3PvMxk7SP6J9aDwkPBBqtZYckFHWGTfsnK8nunhYka,True,58317218,14579304,86923,43461,43462,72FwbpFGoLEazJEdpqNtPNefsadUrimUqma9wSoy4qiS,3476939,16613142,-13136203,596
2021-11-18 12:07:20-05:00,128,HNCJ9xJCwy9rBzYHDF4AsE677ueQDGHS1riTGoBGdDgh,D8ZBxkpAFu877Lnsuazfyme3nB5cHYsSoDCUrMPMPLe3,True,83285395,20821348,124646,62323,62323,72FwbpFGoLEazJEdpqNtPNefsadUrimUqma9wSoy4qiS,4985850,27509246,-22523396,598
2021-11-18 12:07:25-05:00,129,26F7WDhDLwsFPgkeUDruwUiRn1R6SWS9rD3t33Tn1Ueq,88RtRiccENAcTo3hExVk9KgWhW5zrfGY175KN5EhnejY,True,167623450,41905862,254909,127454,127455,72FwbpFGoLEazJEdpqNtPNefsadUrimUqma9wSoy4qiS,10196364,52241888,-42045524,608
2021-11-18 12:08:18-05:00,130,57GUgfEp9ZQ5iAU2nx1Z2Tiz3gqq7yBNaqfE1cvxjFYt,98upivFa9Tdy3RZHGM1i2k5zeczaGqioq3rTzc3DMf4x,True,321374904,80343726,498619,249309,249310,72FwbpFGoLEazJEdpqNtPNefsadUrimUqma9wSoy4qiS,19944781,96843864,-76899083,620
2021-11-18 12:08:21-05:00,131,EFHg5FatMRRSZnKJPJF9e1iw2cjPJRmwTTZYtkHno9DP,84LnLKhZDJgWFnbBYnYjqWkjymemXfidecPFwnUAvuFj,True,747363707,186840926,1160460,580230,580230,72FwbpFGoLEazJEdpqNtPNefsadUrimUqma9wSoy4qiS,46418411,231058162,-184639751,621
2021-11-18 12:09:17-05:00,132,82ahWrNx6L73jAvzt4PAv7FuhwSdGqG4KqAZWD2uwEZt,2funPHa9Xi1hcgj7rHc7NHDYQ5HjgZ7UvbnZpet3u7kQ,True,24829146,6207286,38733,19366,19367,72FwbpFGoLEazJEdpqNtPNefsadUrimUqma9wSoy4qiS,1549347,9055632,-7506285,624
2021-11-18 12:09:17-05:00,133,EQYUWtYbtvN9C9ixiupXPjHyFWHsYa7dUh4DSd6rxbzt,iS616uGNCwCxP1taAvvdvA2KdqfXRSjcQWwZRUgBkLb,True,28990699,7247674,44938,22469,22469,72FwbpFGoLEazJEdpqNtPNefsadUrimUqma9wSoy4qiS,1797553,9038684,-7241131,620
2021-11-18 12:09:18-05:00,134,3A5AuwDWP4fT7RUqNBj51AxdS4uYkjEZmFYrykBJPp1X,GEXVPiMjcD2RS8jcEmo3k8CET3bJ8Fv3cAUn1ZwhxJy6,True,16812510597,4203127649,26050959,13025479,13025480,72FwbpFGoLEazJEdpqNtPNefsadUrimUqma9wSoy4qiS,1042038377,6406555163,-5364516786,619
2021-11-18 12:09:19-05:00,135,3Ek5j2ea8wS2nCxsNgn2AbovxzJwGK7zc6xarkigSA3u,DEWmTn3Ah4F3nNXpoQLt1GG65Dsf4ZmGjn7FZUJyK6rP,True,3837650532,959412633,5793050,2896525,2896525,72FwbpFGoLEazJEdpqNtPNefsadUrimUqma9wSoy4qiS,231722022,1190333774,-958611752,603
2021-11-18 12:09:20-05:00,136,66SjFhmiNYz8tLRnBhZUbowWGTbM16G52X3AT2hma2wN,3wVy8nk24HCFZWMiacGe8QsJquYaadZ9pQg44bGRwdE3,True,89053218,22263304,132392,66196,66196,72FwbpFGoLEazJEdpqNtPNefsadUrimUqma9wSoy4qiS,5295700,30337086,-25041386,594
2021-11-18 12:10:15-05:00,137,J2gTwrYpzezkRupgBtgudQn5D33x6WjeBhTHnrA1qgqa,FBzoHRwqGRjnMvPEpiZVjtGZYJmAbneE4dpToXPzy8bv,True,22857269773,5714317443,34713202,17356601,17356601,72FwbpFGoLEazJEdpqNtPNefsadUrimUqma9wSoy4qiS,1388528093,6777185060,-5388656967,607
2021-11-18 12:10:24-05:00,138,36ByQojnxEckWdQTjqHfxKqCx9yjqWQsPsZyqaN72UWR,AZoirtS1fjX61agRM64tqThVinnJTh3BWgiHyNHPTgZP,True,25227517,6306879,36354,18177,18177,72FwbpFGoLEazJEdpqNtPNefsadUrimUqma9wSoy4qiS,1454199,7867217,-6413018,576
2021-11-18 12:10:28-05:00,139,8d333AWdyiVhvkAdiKCTwhgzaPBMbn8mtucwUC1SAbZZ,3BM8UNLN7XGRaYRjezAqFVMr1z4PS3VRXiN1NAtvBuD9,True,266346246,66586561,368228,184114,184114,72FwbpFGoLEazJEdpqNtPNefsadUrimUqma9wSoy4qiS,14729151,77461439,-62732288,553
2021-11-18 12:10:28-05:00,140,BELLbzmdx1SYke9kZUxFi9VcdvwaHmkZyv24FArQ1J2f,5a5LfKakAaFEVkavVHgExKaUr25RWYpzFic6MUQQ62uc,True,4979291774,1244822943,7004760,3502380,3502380,72FwbpFGoLEazJEdpqNtPNefsadUrimUqma9wSoy4qiS,280190410,1559543262,-1279352852,562
2021-11-18 12:10:28-05:00,141,CQSb6ZVY1KVNXFAg8pxm8RvBBGGqRSU7FMvwHJPy46u8,FRBv3b5VTfKN1bK4DXFY4329LFbvm882P47edrgpuSM,True,2435265809,608816452,3382528,1691264,1691264,72FwbpFGoLEazJEdpqNtPNefsadUrimUqma9wSoy4qiS,135301127,618206723,-482905596,555
2021-11-18 12:10:31-05:00,142,HfRH3JeKFL399DkU3omcbiXjKvfdVq8YuXBN1rtrcwxz,3pgq9GHmS5DSUqwtPEAx5WgfHwAp65teUyTbnQVuq1UA,True,15464111,3866027,21291,10645,10646,72FwbpFGoLEazJEdpqNtPNefsadUrimUqma9wSoy4qiS,851669,4139498,-3287829,550
2021-11-18 12:10:32-05:00,143,8nXbrdjjaHB73CRPRenGEQj73wbtEFGDwXsehRGMhsap,43pvdcJ6f27wz94D6ZboKwRJYbyvYCrjsJhYsvk7LJCM,True,104128774,26032193,152534,76267,76267,72FwbpFGoLEazJEdpqNtPNefsadUrimUqma9wSoy4qiS,6101385,33526886,-27425501,585
2021-11-18 12:10:33-05:00,144,E5KDZriZ89a5D4VsMaWxndMMG68RT4weruJ1tCEc6tSx,CaSwkUocpbyyGCQBgKjJZJgcexbyqs2GTrGJH6EMWXAz,True,22818612463,5704653115,32690703,16345351,16345352,72FwbpFGoLEazJEdpqNtPNefsadUrimUqma9wSoy4qiS,1307628128,6734911979,-5427283851,573
2021-11-18 12:10:33-05:00,145,EvSdLa5PeJiaaaE3omJNG7cw1tptZnHTituYswVHSwm3,68ESX2mBsfxQo2U9jsbmHo7TzPTxr9mGH5Y11ZLR7E3A,True,335245530,83811382,450405,225202,225203,72FwbpFGoLEazJEdpqNtPNefsadUrimUqma9wSoy4qiS,18016217,104692788,-86676571,537
2021-11-18 12:10:35-05:00,146,AzmgakTxLAutgbcNkxi3S4M6MvuZvwcrzMc43ErMFk4h,7KR9xHmrpNDAuYo63YTTvWuaKsjbzF3bPTWDudsJK9oU,True,171402840,42850710,224019,112009,112010,72FwbpFGoLEazJEdpqNtPNefsadUrimUqma9wSoy4qiS,8960767,57869158,-48908391,522
2021-11-18 12:10:42-05:00,147,3BJxs1GkLhq2fri6KfiD7bdvx8ntCaSnhCkcmwpJvST8,HT9DNPcrs5JdheyKkBHjtzncg5Wf9axnSAVTtUHF3h9e,True,274668211,68667052,358717,179358,179359,72FwbpFGoLEazJEdpqNtPNefsadUrimUqma9wSoy4qiS,14348686,66283060,-51934374,522
2021-11-18 12:10:54-05:00,148,2XFYFxNQbCr5ao4cVzRZt45fsAwZc4jD9XTABmdqaJWd,CvpzBuDjyimaYFGWFkkBcaZGSRtAvtF6MtRV54mqZ74k,True,1668136,417034,2208,1104,1104,72FwbpFGoLEazJEdpqNtPNefsadUrimUqma9wSoy4qiS,88349,529224,-440875,529
2021-11-18 12:11:15-05:00,149,DSEgVqfxXp5wxjn3gNZtmb4E6rJeBm3VcbqdwDnsuzSq,6YVCWznUKheSMPuywSRJgCes7wghPGJXgxfrVfnjN4mB,True,1489636252,372409063,2289689,1144844,1144845,72FwbpFGoLEazJEdpqNtPNefsadUrimUqma9wSoy4qiS,91587560,354791718,-263204158,614
2021-11-18 12:11:15-05:00,150,J5WcVsKNHbfioai1LRowvjvtEmUJBEkeoBim1ThshpoP,Ajh7SWBq3zJR4vb6AFoBS6C9D99wC6YF1sVN22qC1vCA,True,27008659,6752164,41982,20991,20991,72FwbpFGoLEazJEdpqNtPNefsadUrimUqma9wSoy4qiS,1679308,8619760,-6940452,621
2021-11-18 12:11:18-05:00,151,7ckvB1uchDPcA5vkjJvu4DHCkgGq81qbJrd4P2CwPDV8,pVjScFyTQfYJ74uA9JLEsChSrtY8fRi2dCM3jtWC6bp,True,9162539,2290634,14010,7005,7005,72FwbpFGoLEazJEdpqNtPNefsadUrimUqma9wSoy4qiS,560423,3390565,-2830142,611
2021-11-18 12:11:18-05:00,152,9b5c6WqiKuBa6ARf1evmyrDZ8rYv2VCgjSDME7HFbzGk,65TnTCwZ8nTgu8CXXAMvjm6iZhdjwGxmWZnmAgWeebYM,True,292812254,73203063,443066,221533,221533,72FwbpFGoLEazJEdpqNtPNefsadUrimUqma9wSoy4qiS,17722642,84135258,-66412616,605
2021-11-18 12:11:24-05:00,153,3fB955q6xxxZcgnCyguLwkSa7egxgBoksPQVQ3U8HRHL,GK7cTdhfSpapJB8dFzEkV8c1UFkJPj281DwztnpKjxLx,True,213905975,53476493,330781,165390,165391,72FwbpFGoLEazJEdpqNtPNefsadUrimUqma9wSoy4qiS,13231252,79391964,-66160712,618
2021-11-18 12:11:28-05:00,154,CBEv8v9XZrgFT8UdEdd813XnRVv9R7GB5PLMyG8UWGC8,4uNcMEcQpJdThpisgNrttkQJTUFTsjEr25qgjkm4titC,True,632081677,158020419,965651,482825,482826,72FwbpFGoLEazJEdpqNtPNefsadUrimUqma9wSoy4qiS,38626066,235308679,-196682613,611
2021-11-18 12:12:20-05:00,155,FpqCxvTkSiwDwD5qEt6hXJxzFDLFLAQ8VevK8zwRqYun,A3p6YQisCJKpNkF7vkjZRbEfbnUt7vTZdR2zPBUSdTkk,True,161815904,40453976,246984,123492,123492,72FwbpFGoLEazJEdpqNtPNefsadUrimUqma9wSoy4qiS,9879381,51329979,-41450598,610
2021-11-18 12:12:21-05:00,156,EDE1swNYZ99y9idZacAw5Ncwz2DyD78SqvKMUXA2Dbw4,HSmYYMpNQNr1F2zjvysGRrC57FyusAJNsaXWfbmCfZh4,True,47850441,11962610,72987,36493,36494,72FwbpFGoLEazJEdpqNtPNefsadUrimUqma9wSoy4qiS,2919502,17904757,-14985255,610
2021-11-18 12:12:22-05:00,157,A9BZ5kjh7iKu7SMzA5WUF31Zst9V7fehwDZaoKs4NpSi,3FzwTaT5LYucvoGGcRVXu5AUDnGHADv6yGqrBT6jEtvH,True,896444058,224111014,1374848,687424,687424,72FwbpFGoLEazJEdpqNtPNefsadUrimUqma9wSoy4qiS,54993955,213548897,-158554942,613
2021-11-18 12:12:22-05:00,158,DXZMRSKFgnNdiXHps2xzayuztJNH9EUUz2wkCCneXtW5,9Z2sUfTCZCkmw5n3HSsoLG992AcpJo2qxp7XpJnnBxZM,True,65574196,16393549,101658,50829,50829,72FwbpFGoLEazJEdpqNtPNefsadUrimUqma9wSoy4qiS,4066345,19239517,-15173172,620
2021-11-18 12:12:37-05:00,159,6meAnGTy2XNUDk9qSJZGT6BBRinA5iGiDYEy2T88LXuX,BCzNQCn3J1381yNH5xp5ky9QmVKVdSofSUaLHtxKxPBW,True,1682291,420572,2576,1288,1288,72FwbpFGoLEazJEdpqNtPNefsadUrimUqma9wSoy4qiS,103056,529841,-426785,612
2021-11-18 12:13:15-05:00,160,8w4uRzN81cghupkF7jNLinGLtCqYwNQFgQtdJfC5so7z,BbbRkq85fYEBGmuxBEEPbt6up4GNB7WQ83VSXwe4ro98,True,9660833088,2415208272,14964396,7482198,7482198,72FwbpFGoLEazJEdpqNtPNefsadUrimUqma9wSoy4qiS,598575860,2298576936,-1700001076,619
2021-11-18 12:13:20-05:00,161,7zDNgPFeomS1hdQhuY8iGF3nnGMNnx1YrinZJetrefje,AKyG5R6Bac6Fu83ruL9FGpjKCfDKxbP6QfEGbCgqegiV,True,164408856,41102214,250982,125491,125491,72FwbpFGoLEazJEdpqNtPNefsadUrimUqma9wSoy4qiS,10039317,50313730,-40274413,610
2021-11-18 12:13:23-05:00,162,E6kVebJVmwutZmtjJ1erBzBq4C2yLrSyK1wWTXSeRkc,9HWMtKySmuhf8E5WLjZZLHhGweDL1tCvXMcVunBDaUtE,True,57978888,14494722,87717,43858,43859,72FwbpFGoLEazJEdpqNtPNefsadUrimUqma9wSoy4qiS,3508694,20529055,-17020361,605
2021-11-18 12:13:23-05:00,163,3PmLtoHk5uuB5e6KNUqr9XaFiZYSMSB6yt1k5xzHUFUv,DyrVKXFMchomdbzRaK4CEwYwVMFbGYVja6hwGJQJvUMH,True,783240408,195810102,1169393,584696,584697,72FwbpFGoLEazJEdpqNtPNefsadUrimUqma9wSoy4qiS,46775739,250837572,-204061833,597
2021-11-18 12:13:23-05:00,164,FYNnguyYqSVbToc4eDU9zJipCNy2ooz3nMN8AQuq4JzQ,FgkMfWga8jjrTGynPGghMsJHdP4d8wiT9s8xTrqGFaRv,True,67866714,16966678,101582,50791,50791,72FwbpFGoLEazJEdpqNtPNefsadUrimUqma9wSoy4qiS,4063314,16227090,-12163776,598
2021-11-18 12:13:27-05:00,165,7dSwoqvrbAn6zQ9stAtQEgsgqNze2szYLjuigAXEaapr,7G25dgArTKkpEvqAocVnVNPSAvbAAcogdeeBDak1qetD,True,156753964,39188491,236264,118132,118132,72FwbpFGoLEazJEdpqNtPNefsadUrimUqma9wSoy4qiS,9450560,20675961,-11225401,602
2021-11-18 12:13:28-05:00,166,5F6M2rEMMvaFGWWCf8XioLucUfb7nnp96vx9BcbroVsD,EYxYvNkDPViCFpWt7nsnhU27BLNuMbikAV7tNjcs3fFe,True,22874730,5718682,34158,17079,17079,72FwbpFGoLEazJEdpqNtPNefsadUrimUqma9wSoy4qiS,1366322,7855777,-6489455,597
2021-11-18 12:13:28-05:00,167,7DWHQdHp5svNzMwB6E5sStKHdHTw2jWwhK5pGHW8bjXg,EG3PvMxk7SP6J9aDwkPBBqtZYckFHWGTfsnK8nunhYka,True,42922508,10730627,64365,32182,32183,72FwbpFGoLEazJEdpqNtPNefsadUrimUqma9wSoy4qiS,2574610,13242410,-10667800,599
2021-11-18 12:13:29-05:00,168,FjDp4bWCtqehFD7FunCrjrcdxMezTJj5aqh2VnBvHDQU,HRYeZqcqhP1RPiAGXziR1qCWwk4sF6c5ZYbvSDhX7foN,True,860232907,215058226,1290663,645331,645332,72FwbpFGoLEazJEdpqNtPNefsadUrimUqma9wSoy4qiS,51626544,204926787,-153300243,600
2021-11-18 12:14:18-05:00,169,4xsYjVsPm2C2itNtJb3NYkBp4WySHUwtSbWdu9fge8wz,8zu2jMoTndZpf9khY9PMhve88LRwrKNTuVuLpa5ss8qo,True,846478482,211619620,1307914,653957,653957,72FwbpFGoLEazJEdpqNtPNefsadUrimUqma9wSoy4qiS,52316570,260843704,-208527134,618
2021-11-18 12:14:18-05:00,170,Gs3WP18hbzNpbBgiU39e6tfkggfCKRyNqPqJQcthuHFD,4XAY25YUma6gUdG2GdbXeivum3t21g93ZagfWGTZYkWZ,True,69306102,17326525,107540,53770,53770,72FwbpFGoLEazJEdpqNtPNefsadUrimUqma9wSoy4qiS,4301602,19009858,-14708256,620
2021-11-18 12:14:21-05:00,171,4M7XECgNotuYef6fXsB659bgvA4LBYq9WrUFZP8jEZ8q,EjF9ZKUaBWZodjKy7ET7rEyK1uSsKX2cvcd4eJSYarF8,True,336646336,84161584,513234,256617,256617,72FwbpFGoLEazJEdpqNtPNefsadUrimUqma9wSoy4qiS,20529393,80400907,-59871514,609
2021-11-18 12:14:23-05:00,172,FZhvN1RjLoBK9EpCeyEobYsvdHirtbTXV82c9EV9nn2u,FSeHqYNof79JYrRb7ZkJWEb4TfS5wx7HTdvT1kLCexHM,True,91093701,22773425,138868,69434,69434,72FwbpFGoLEazJEdpqNtPNefsadUrimUqma9wSoy4qiS,5554731,24260857,-18706126,609
2021-11-18 12:14:23-05:00,173,26F7WDhDLwsFPgkeUDruwUiRn1R6SWS9rD3t33Tn1Ueq,88RtRiccENAcTo3hExVk9KgWhW5zrfGY175KN5EhnejY,True,123347849,30836962,189292,94646,94646,72FwbpFGoLEazJEdpqNtPNefsadUrimUqma9wSoy4qiS,7571716,41477218,-33905502,613
2021-11-18 12:17:26-05:00,174,3XzkSrNTGd3Fhd4M3gYzvz2utbQpFN1fhtbAaZu7C39R,GMsZGGfktTzYi7GhD3W6HY9QY9bznqTKfeArksikLE71,True,11181106,2795276,17449,8724,8725,72FwbpFGoLEazJEdpqNtPNefsadUrimUqma9wSoy4qiS,697985,3297681,-2599696,624
2021-11-19 12:01:40-05:00,175,8w1hzDtCFuTJqWAtwihztrPzxwa7YrJH5uPk877SJnNj,D3gnctosqTZxTQNfLJQRdPgCvGx2JLLHHDmcvW5UX1QN,True,7268846152,1817211538,11334921,5667460,5667461,72FwbpFGoLEazJEdpqNtPNefsadUrimUqma9wSoy4qiS,453396869,1284313812,-830916943,623
2021-11-21 12:59:45-05:00,176,8w1hzDtCFuTJqWAtwihztrPzxwa7YrJH5uPk877SJnNj,D3gnctosqTZxTQNfLJQRdPgCvGx2JLLHHDmcvW5UX1QN,True,5543393732,1385848433,8489000,4244500,4244500,72FwbpFGoLEazJEdpqNtPNefsadUrimUqma9wSoy4qiS,339560036,1056469171,-716909135,612
2021-11-21 13:09:43-05:00,177,8w1hzDtCFuTJqWAtwihztrPzxwa7YrJH5uPk877SJnNj,D3gnctosqTZxTQNfLJQRdPgCvGx2JLLHHDmcvW5UX1QN,True,4233718340,1058429585,6372802,3186401,3186401,72FwbpFGoLEazJEdpqNtPNefsadUrimUqma9wSoy4qiS,254912100,869879282,-614967182,602
2021-11-21 13:34:45-05:00,178,8w1hzDtCFuTJqWAtwihztrPzxwa7YrJH5uPk877SJnNj,D3gnctosqTZxTQNfLJQRdPgCvGx2JLLHHDmcvW5UX1QN,True,3231728035,807932008,4802500,2401250,2401250,72FwbpFGoLEazJEdpqNtPNefsadUrimUqma9wSoy4qiS,192100018,710395718,-518295700,594
2021-11-21 15:37:45-05:00,179,8w1hzDtCFuTJqWAtwihztrPzxwa7YrJH5uPk877SJnNj,D3gnctosqTZxTQNfLJQRdPgCvGx2JLLHHDmcvW5UX1QN,True,2458851672,614712918,3828982,1914491,1914491,72FwbpFGoLEazJEdpqNtPNefsadUrimUqma9wSoy4qiS,153159300,577294696,-424135396,622
2021-11-26 03:37:59-05:00,180,Gwe1S7Wthi8pcNCzk1ttAvXwTUpBtfsEoDW5fMWRrPcW,B17Z5G2kPPLkGzhoXmjkjJoNDqPfahXg2gat2u5AmfEc,True,1178704336,294676084,1824478,912239,912239,72FwbpFGoLEazJEdpqNtPNefsadUrimUqma9wSoy4qiS,72979144,282722931,-209743787,619
2021-11-26 05:09:54-05:00,181,EmHwYySUTRtPZVsRfb3XsnjvGz7hygvp84YDHbx3yUTF,F9zeqPaZA21Kv4nAdfUpsYmX5Xo6M7DaTu24xYLSnsry,True,628830350,157207587,979872,489936,489936,72FwbpFGoLEazJEdpqNtPNefsadUrimUqma9wSoy4qiS,39194905,152676794,-113481889,623
2021-11-26 05:10:05-05:00,182,Gwe1S7Wthi8pcNCzk1ttAvXwTUpBtfsEoDW5fMWRrPcW,B17Z5G2kPPLkGzhoXmjkjJoNDqPfahXg2gat2u5AmfEc,True,867181735,216795433,1355723,677861,677862,72FwbpFGoLEazJEdpqNtPNefsadUrimUqma9wSoy4qiS,54228942,228454771,-174225829,625
2021-11-26 05:50:53-05:00,183,GSaQj6w7ssfDpMGzMQd4pyhZvLeGvYc1Vc9Qcsx1t69g,HSNX4PwuAAuUncgs11suc9rFJ6ntB8BRN7ViFYT9RATM,True,4405096173,1101274043,6696907,3348453,3348454,72FwbpFGoLEazJEdpqNtPNefsadUrimUqma9wSoy4qiS,267876295,1011944285,-744067990,608
2021-11-26 05:50:53-05:00,184,Hn2vg5sPj8WYVoh5H19rjBBcJQRWZfW3u7THZqu9AT8,4xvgBQuFQGaeJyVVjNEBiNhc6rWnjGGY5nxvZt2HBDAm,True,42955840,10738960,66140,33070,33070,72FwbpFGoLEazJEdpqNtPNefsadUrimUqma9wSoy4qiS,2645614,9894113,-7248499,615
2021-11-26 05:51:18-05:00,185,D9UqfagwAQjJt8f7pi3UM2tdj7EeyFHtYi7uTzvnnMQM,5ojof7CaDX2tPd3mRQfCxAkiZAu8h8V1hrGPzBPQ782E,True,2320133237,580033309,3609087,1804543,1804544,72FwbpFGoLEazJEdpqNtPNefsadUrimUqma9wSoy4qiS,144363489,536725721,-392362232,622
2021-11-26 05:51:18-05:00,186,EmHwYySUTRtPZVsRfb3XsnjvGz7hygvp84YDHbx3yUTF,F9zeqPaZA21Kv4nAdfUpsYmX5Xo6M7DaTu24xYLSnsry,True,460157210,115039302,668737,334368,334369,72FwbpFGoLEazJEdpqNtPNefsadUrimUqma9wSoy4qiS,26749480,123347048,-96597568,581
2021-11-26 05:51:18-05:00,187,2XFYFxNQbCr5ao4cVzRZt45fsAwZc4jD9XTABmdqaJWd,CvpzBuDjyimaYFGWFkkBcaZGSRtAvtF6MtRV54mqZ74k,True,1230957,307739,1876,938,938,72FwbpFGoLEazJEdpqNtPNefsadUrimUqma9wSoy4qiS,75055,425900,-350845,609
2021-11-26 05:51:18-05:00,188,3Ek5j2ea8wS2nCxsNgn2AbovxzJwGK7zc6xarkigSA3u,DEWmTn3Ah4F3nNXpoQLt1GG65Dsf4ZmGjn7FZUJyK6rP,True,2801583783,700395945,4247635,2123817,2123818,72FwbpFGoLEazJEdpqNtPNefsadUrimUqma9wSoy4qiS,169905404,966337426,-796432022,606
2021-11-26 05:51:18-05:00,189,8d333AWdyiVhvkAdiKCTwhgzaPBMbn8mtucwUC1SAbZZ,3BM8UNLN7XGRaYRjezAqFVMr1z4PS3VRXiN1NAtvBuD9,True,195752790,48938197,294877,147438,147439,72FwbpFGoLEazJEdpqNtPNefsadUrimUqma9wSoy4qiS,11795117,62855144,-51060027,602
2021-11-26 05:51:18-05:00,190,AzmgakTxLAutgbcNkxi3S4M6MvuZvwcrzMc43ErMFk4h,7KR9xHmrpNDAuYo63YTTvWuaKsjbzF3bPTWDudsJK9oU,True,126434831,31608707,188756,94378,94378,72FwbpFGoLEazJEdpqNtPNefsadUrimUqma9wSoy4qiS,7550241,46350547,-38800306,597
2021-11-26 05:51:18-05:00,191,CQSb6ZVY1KVNXFAg8pxm8RvBBGGqRSU7FMvwHJPy46u8,FRBv3b5VTfKN1bK4DXFY4329LFbvm882P47edrgpuSM,True,1791341932,447835483,2750103,1375051,1375052,72FwbpFGoLEazJEdpqNtPNefsadUrimUqma9wSoy4qiS,110004144,507608267,-397604123,614
2021-11-26 05:51:18-05:00,192,EvSdLa5PeJiaaaE3omJNG7cw1tptZnHTituYswVHSwm3,68ESX2mBsfxQo2U9jsbmHo7TzPTxr9mGH5Y11ZLR7E3A,True,247231576,61807894,379594,189797,189797,72FwbpFGoLEazJEdpqNtPNefsadUrimUqma9wSoy4qiS,15183784,84400122,-69216338,614
2021-11-26 05:51:18-05:00,193,HwMdPKabtCSiMZPhXGZjxMKg7RVwxfHSJGt6FW6XKKN5,4Wuu74hfqpRHY6sB55hzSgqEkK4G6oYXZv4ZA21LUckA,True,44944938135,11236234533,63721992,31860996,31860996,72FwbpFGoLEazJEdpqNtPNefsadUrimUqma9wSoy4qiS,2548879697,10943262497,-8394382800,567
2021-11-26 05:51:18-05:00,194,66SjFhmiNYz8tLRnBhZUbowWGTbM16G52X3AT2hma2wN,3wVy8nk24HCFZWMiacGe8QsJquYaadZ9pQg44bGRwdE3,True,64642426,16160606,87359,43679,43680,72FwbpFGoLEazJEdpqNtPNefsadUrimUqma9wSoy4qiS,3494360,24423349,-20928989,540
2021-11-26 05:51:18-05:00,195,57GUgfEp9ZQ5iAU2nx1Z2Tiz3gqq7yBNaqfE1cvxjFYt,98upivFa9Tdy3RZHGM1i2k5zeczaGqioq3rTzc3DMf4x,True,232412864,58103216,313711,156855,156856,72FwbpFGoLEazJEdpqNtPNefsadUrimUqma9wSoy4qiS,12548457,78846812,-66298355,539
2021-11-26 05:51:18-05:00,196,82ahWrNx6L73jAvzt4PAv7FuhwSdGqG4KqAZWD2uwEZt,2funPHa9Xi1hcgj7rHc7NHDYQ5HjgZ7UvbnZpet3u7kQ,True,17973608,4493402,24885,12442,12443,72FwbpFGoLEazJEdpqNtPNefsadUrimUqma9wSoy4qiS,995423,7273491,-6278068,553
2021-11-26 05:51:19-05:00,197,EQYUWtYbtvN9C9ixiupXPjHyFWHsYa7dUh4DSd6rxbzt,iS616uGNCwCxP1taAvvdvA2KdqfXRSjcQWwZRUgBkLb,True,20986121,5246530,28776,14388,14388,72FwbpFGoLEazJEdpqNtPNefsadUrimUqma9wSoy4qiS,1151074,7338905,-6187831,548
2021-11-26 05:51:19-05:00,198,5kwvkEtRFFD84j4ntVgxkacadgJaFvQ9JLhJqzLR7Y3G,GpMMkTv9T7y8DTiizuoJUsWvnSk3GSxADjRMGyYpryxm,False,422806258,422806258,21076744,1053837,20022907,72FwbpFGoLEazJEdpqNtPNefsadUrimUqma9wSoy4qiS,21076744,101135727,-80058983,498
2021-11-26 06:09:05-05:00,199,BELLbzmdx1SYke9kZUxFi9VcdvwaHmkZyv24FArQ1J2f,5a5LfKakAaFEVkavVHgExKaUr25RWYpzFic6MUQQ62uc,True,3663995297,915998824,5698510,2849255,2849255,72FwbpFGoLEazJEdpqNtPNefsadUrimUqma9wSoy4qiS,227940430,1259320682,-1031380252,622
2021-11-26 06:13:54-05:00,200,8nXbrdjjaHB73CRPRenGEQj73wbtEFGDwXsehRGMhsap,43pvdcJ6f27wz94D6ZboKwRJYbyvYCrjsJhYsvk7LJCM,True,76354170,19088542,118343,59171,59172,72FwbpFGoLEazJEdpqNtPNefsadUrimUqma9wSoy4qiS,4733725,27045896,-22312171,619
2021-11-27 21:28:01-05:00,201,E5KDZriZ89a5D4VsMaWxndMMG68RT4weruJ1tCEc6tSx,CaSwkUocpbyyGCQBgKjJZJgcexbyqs2GTrGJH6EMWXAz,True,16882488982,4220622245,26315883,13157941,13157942,72FwbpFGoLEazJEdpqNtPNefsadUrimUqma9wSoy4qiS,1052635330,5383403449,-4330768119,623
2021-11-27 21:28:12-05:00,202,J2gTwrYpzezkRupgBtgudQn5D33x6WjeBhTHnrA1qgqa,FBzoHRwqGRjnMvPEpiZVjtGZYJmAbneE4dpToXPzy8bv,True,16816260223,4204065055,25906827,12953413,12953414,72FwbpFGoLEazJEdpqNtPNefsadUrimUqma9wSoy4qiS,1036273099,5433288949,-4397015850,616
2021-11-27 21:28:26-05:00,203,3fB955q6xxxZcgnCyguLwkSa7egxgBoksPQVQ3U8HRHL,GK7cTdhfSpapJB8dFzEkV8c1UFkJPj281DwztnpKjxLx,True,157252477,39313119,245220,122610,122610,72FwbpFGoLEazJEdpqNtPNefsadUrimUqma9wSoy4qiS,9808839,62609104,-52800265,623
2021-11-27 21:28:26-05:00,204,CBEv8v9XZrgFT8UdEdd813XnRVv9R7GB5PLMyG8UWGC8,4uNcMEcQpJdThpisgNrttkQJTUFTsjEr25qgjkm4titC,True,464700412,116175103,713797,356898,356899,72FwbpFGoLEazJEdpqNtPNefsadUrimUqma9wSoy4qiS,28551881,185448145,-156896264,614
2021-11-27 21:28:28-05:00,205,7ckvB1uchDPcA5vkjJvu4DHCkgGq81qbJrd4P2CwPDV8,pVjScFyTQfYJ74uA9JLEsChSrtY8fRi2dCM3jtWC6bp,True,6735544,1683886,10342,5171,5171,72FwbpFGoLEazJEdpqNtPNefsadUrimUqma9wSoy4qiS,413708,2672699,-2258991,614
2021-11-27 21:38:37-05:00,206,FpqCxvTkSiwDwD5qEt6hXJxzFDLFLAQ8VevK8zwRqYun,A3p6YQisCJKpNkF7vkjZRbEfbnUt7vTZdR2zPBUSdTkk,True,119032256,29758064,184185,92092,92093,72FwbpFGoLEazJEdpqNtPNefsadUrimUqma9wSoy4qiS,7367434,40786575,-33419141,618
2021-11-27 21:38:37-05:00,207,EDE1swNYZ99y9idZacAw5Ncwz2DyD78SqvKMUXA2Dbw4,HSmYYMpNQNr1F2zjvysGRrC57FyusAJNsaXWfbmCfZh4,True,35198590,8799647,54410,27205,27205,72FwbpFGoLEazJEdpqNtPNefsadUrimUqma9wSoy4qiS,2176409,14104727,-11928318,618
2021-11-27 21:38:38-05:00,208,GSaQj6w7ssfDpMGzMQd4pyhZvLeGvYc1Vc9Qcsx1t69g,HSNX4PwuAAuUncgs11suc9rFJ6ntB8BRN7ViFYT9RATM,True,3268252792,817063198,5081493,2540746,2540747,72FwbpFGoLEazJEdpqNtPNefsadUrimUqma9wSoy4qiS,203259736,797886797,-594627061,621
2021-11-27 21:38:49-05:00,209,6meAnGTy2XNUDk9qSJZGT6BBRinA5iGiDYEy2T88LXuX,BCzNQCn3J1381yNH5xp5ky9QmVKVdSofSUaLHtxKxPBW,True,1237035,309258,1911,955,956,72FwbpFGoLEazJEdpqNtPNefsadUrimUqma9wSoy4qiS,76468,421259,-344791,618
2021-11-27 21:38:49-05:00,210,A9BZ5kjh7iKu7SMzA5WUF31Zst9V7fehwDZaoKs4NpSi,3FzwTaT5LYucvoGGcRVXu5AUDnGHADv6yGqrBT6jEtvH,True,659234170,164808542,1021970,510985,510985,72FwbpFGoLEazJEdpqNtPNefsadUrimUqma9wSoy4qiS,40878806,172936235,-132057429,620
2021-11-27 21:41:37-05:00,211,J5WcVsKNHbfioai1LRowvjvtEmUJBEkeoBim1ThshpoP,Ajh7SWBq3zJR4vb6AFoBS6C9D99wC6YF1sVN22qC1vCA,True,662377377,165594344,1023990,511995,511995,72FwbpFGoLEazJEdpqNtPNefsadUrimUqma9wSoy4qiS,40959621,106410401,-65450780,618
2021-11-27 21:41:38-05:00,212,BpvWyveup3q7q6Cws5TWkFYiZ8bQXRrfdxvzrN9FnYo6,2CWjropYSn9fJ66FT4zqUcwTrEaPp3CjGgoRATixyca1,True,187924699,46981174,250041,125020,125021,72FwbpFGoLEazJEdpqNtPNefsadUrimUqma9wSoy4qiS,10001661,42072145,-32070484,532
2021-11-27 21:41:38-05:00,213,57GUgfEp9ZQ5iAU2nx1Z2Tiz3gqq7yBNaqfE1cvxjFYt,98upivFa9Tdy3RZHGM1i2k5zeczaGqioq3rTzc3DMf4x,True,172831272,43207818,239024,119512,119512,72FwbpFGoLEazJEdpqNtPNefsadUrimUqma9wSoy4qiS,9560994,60766274,-51205280,553
2021-11-27 21:41:38-05:00,214,EvSdLa5PeJiaaaE3omJNG7cw1tptZnHTituYswVHSwm3,68ESX2mBsfxQo2U9jsbmHo7TzPTxr9mGH5Y11ZLR7E3A,True,182865501,45716375,274530,137265,137265,72FwbpFGoLEazJEdpqNtPNefsadUrimUqma9wSoy4qiS,10981203,65455176,-54473973,600
2021-11-27 21:41:38-05:00,215,D9UqfagwAQjJt8f7pi3UM2tdj7EeyFHtYi7uTzvnnMQM,5ojof7CaDX2tPd3mRQfCxAkiZAu8h8V1hrGPzBPQ782E,True,1714912479,428728119,2592524,1296262,1296262,72FwbpFGoLEazJEdpqNtPNefsadUrimUqma9wSoy4qiS,103700994,423440667,-319739673,604
2021-11-27 21:41:38-05:00,216,FZhvN1RjLoBK9EpCeyEobYsvdHirtbTXV82c9EV9nn2u,FSeHqYNof79JYrRb7ZkJWEb4TfS5wx7HTdvT1kLCexHM,True,66524049,16631012,91406,45703,45703,72FwbpFGoLEazJEdpqNtPNefsadUrimUqma9wSoy4qiS,3656248,19482532,-15826284,549
2021-11-27 21:41:38-05:00,217,4xsYjVsPm2C2itNtJb3NYkBp4WySHUwtSbWdu9fge8wz,8zu2jMoTndZpf9khY9PMhve88LRwrKNTuVuLpa5ss8qo,True,618127687,154531921,865443,432721,432722,72FwbpFGoLEazJEdpqNtPNefsadUrimUqma9wSoy4qiS,34617723,207784318,-173166595,560
2021-11-27 21:41:38-05:00,218,3Ek5j2ea8wS2nCxsNgn2AbovxzJwGK7zc6xarkigSA3u,DEWmTn3Ah4F3nNXpoQLt1GG65Dsf4ZmGjn7FZUJyK6rP,True,2070983098,517745774,3027949,1513974,1513975,72FwbpFGoLEazJEdpqNtPNefsadUrimUqma9wSoy4qiS,121117977,749096115,-627978138,584
2021-11-27 21:41:38-05:00,219,Hn2vg5sPj8WYVoh5H19rjBBcJQRWZfW3u7THZqu9AT8,4xvgBQuFQGaeJyVVjNEBiNhc6rWnjGGY5nxvZt2HBDAm,True,31470181,7867545,40374,20187,20187,72FwbpFGoLEazJEdpqNtPNefsadUrimUqma9wSoy4qiS,1614996,7798198,-6183202,513
2021-11-27 21:41:38-05:00,220,8w4uRzN81cghupkF7jNLinGLtCqYwNQFgQtdJfC5so7z,BbbRkq85fYEBGmuxBEEPbt6up4GNB7WQ83VSXwe4ro98,True,7045459660,1761364915,9683291,4841645,4841646,72FwbpFGoLEazJEdpqNtPNefsadUrimUqma9wSoy4qiS,387331664,1867415983,-1480084319,549
2021-11-27 21:41:38-05:00,221,66SjFhmiNYz8tLRnBhZUbowWGTbM16G52X3AT2hma2wN,3wVy8nk24HCFZWMiacGe8QsJquYaadZ9pQg44bGRwdE3,True,48000776,12000194,64837,32418,32419,72FwbpFGoLEazJEdpqNtPNefsadUrimUqma9wSoy4qiS,2593499,18771540,-16178041,540
2021-11-27 21:41:38-05:00,222,3XzkSrNTGd3Fhd4M3gYzvz2utbQpFN1fhtbAaZu7C39R,GMsZGGfktTzYi7GhD3W6HY9QY9bznqTKfeArksikLE71,True,8157048,2039262,11406,5703,5703,72FwbpFGoLEazJEdpqNtPNefsadUrimUqma9wSoy4qiS,456248,2634816,-2178568,559
2021-11-27 21:41:38-05:00,223,4M7XECgNotuYef6fXsB659bgvA4LBYq9WrUFZP8jEZ8q,EjF9ZKUaBWZodjKy7ET7rEyK1uSsKX2cvcd4eJSYarF8,True,245553126,61388281,330496,165248,165248,72FwbpFGoLEazJEdpqNtPNefsadUrimUqma9wSoy4qiS,13219842,65061156,-51841314,538
2021-11-27 21:41:38-05:00,224,C24que1C7tC3ysDSKhcBTF9NUnjiNhSanWp8Go5FRRb8,hgm3qRRG2njhNPWcUp9UnEU8pyg4gLaR2K13r4Lsqxm,True,662918858,165729714,909355,454677,454678,72FwbpFGoLEazJEdpqNtPNefsadUrimUqma9wSoy4qiS,36374228,173455370,-137081142,548
2021-11-27 21:41:38-05:00,225,Gs3WP18hbzNpbBgiU39e6tfkggfCKRyNqPqJQcthuHFD,4XAY25YUma6gUdG2GdbXeivum3t21g93ZagfWGTZYkWZ,True,50544988,12636247,69683,34841,34842,72FwbpFGoLEazJEdpqNtPNefsadUrimUqma9wSoy4qiS,2787327,15253424,-12466097,551
2021-11-27 21:41:38-05:00,226,3t7w8ABEfDYRKp5fLeTJF2jGKWPkgYifD63jSYbvrLrw,DdoegKd6nEoX385sxZtbMWCEUftL9mHVkkQgG1ywdKGh,True,6777110333,1694277583,9699511,4849755,4849756,72FwbpFGoLEazJEdpqNtPNefsadUrimUqma9wSoy4qiS,387980452,1516730352,-1128749900,572
2021-11-27 21:41:38-05:00,227,8d333AWdyiVhvkAdiKCTwhgzaPBMbn8mtucwUC1SAbZZ,3BM8UNLN7XGRaYRjezAqFVMr1z4PS3VRXiN1NAtvBuD9,True,144413584,36103396,202451,101225,101226,72FwbpFGoLEazJEdpqNtPNefsadUrimUqma9wSoy4qiS,8098051,48796273,-40698222,560
2021-11-27 21:41:38-05:00,228,E6kVebJVmwutZmtjJ1erBzBq4C2yLrSyK1wWTXSeRkc,9HWMtKySmuhf8E5WLjZZLHhGweDL1tCvXMcVunBDaUtE,True,42206277,10551569,54159,27079,27080,72FwbpFGoLEazJEdpqNtPNefsadUrimUqma9wSoy4qiS,2166366,16209745,-14043379,513
2021-11-27 21:41:38-05:00,229,GJvu3coUrkqTGMomAKmNdRqKaEaZrhLss3KUFpdcsr6F,FTKCbVVJYqyMXxoW3AMhZcCj1gHdpQMyuRuJq4KUVB6W,True,9904167798,2476041949,12526453,6263226,6263227,72FwbpFGoLEazJEdpqNtPNefsadUrimUqma9wSoy4qiS,501058156,2157990225,-1656932069,505
2021-11-27 21:41:38-05:00,230,EQYUWtYbtvN9C9ixiupXPjHyFWHsYa7dUh4DSd6rxbzt,iS616uGNCwCxP1taAvvdvA2KdqfXRSjcQWwZRUgBkLb,True,15550505,3887626,20631,10315,10316,72FwbpFGoLEazJEdpqNtPNefsadUrimUqma9wSoy4qiS,825277,5655306,-4830029,530
2021-11-27 21:41:38-05:00,231,8DKsQyYNJFCzNnHSQMYb6fPnirYJ2rFp5ws3WHW7xU8x,D8gtj4otCcNcRiJn54raBTEf2E5HNf9d9ozuoL9hSiCg,True,9313172366,2328293091,12432636,6216318,6216318,72FwbpFGoLEazJEdpqNtPNefsadUrimUqma9wSoy4qiS,497305455,2022547385,-1525241930,533
2021-11-27 21:41:38-05:00,232,EmHwYySUTRtPZVsRfb3XsnjvGz7hygvp84YDHbx3yUTF,F9zeqPaZA21Kv4nAdfUpsYmX5Xo6M7DaTu24xYLSnsry,True,338563675,84640918,429344,214672,214672,72FwbpFGoLEazJEdpqNtPNefsadUrimUqma9wSoy4qiS,17173760,96187619,-79013859,507
2021-11-27 21:41:38-05:00,233,6RkvJTPLnRHhdfat6yP9Jd8QWrC6ad8c9oEygRgpg2Li,14UWcWSMirA7yAaW36BxGuvdYTAqNoxL1YKcstXQmGD5,True,106619814,26654953,144544,72272,72272,72FwbpFGoLEazJEdpqNtPNefsadUrimUqma9wSoy4qiS,5781775,23539303,-17757528,542
2021-11-27 21:41:38-05:00,234,CQSb6ZVY1KVNXFAg8pxm8RvBBGGqRSU7FMvwHJPy46u8,FRBv3b5VTfKN1bK4DXFY4329LFbvm882P47edrgpuSM,True,1318694892,329673723,1831898,915949,915949,72FwbpFGoLEazJEdpqNtPNefsadUrimUqma9wSoy4qiS,73275953,396465460,-323189507,555
2021-11-27 21:41:38-05:00,235,HwMdPKabtCSiMZPhXGZjxMKg7RVwxfHSJGt6FW6XKKN5,4Wuu74hfqpRHY6sB55hzSgqEkK4G6oYXZv4ZA21LUckA,True,33259121260,8314780313,45103062,22551531,22551531,72FwbpFGoLEazJEdpqNtPNefsadUrimUqma9wSoy4qiS,1804122504,8654434726,-6850312222,542
2021-11-27 21:41:39-05:00,236,82ahWrNx6L73jAvzt4PAv7FuhwSdGqG4KqAZWD2uwEZt,2funPHa9Xi1hcgj7rHc7NHDYQ5HjgZ7UvbnZpet3u7kQ,False,13248043,13248043,645933,32296,613637,72FwbpFGoLEazJEdpqNtPNefsadUrimUqma9wSoy4qiS,645933,5586735,-4940802,487
2021-11-27 21:41:39-05:00,237,DXZMRSKFgnNdiXHps2xzayuztJNH9EUUz2wkCCneXtW5,9Z2sUfTCZCkmw5n3HSsoLG992AcpJo2qxp7XpJnnBxZM,False,47266644,47266644,2076909,103845,1973064,72FwbpFGoLEazJEdpqNtPNefsadUrimUqma9wSoy4qiS,2076909,15371058,-13294149,439
2021-11-27 21:41:39-05:00,238,5F6M2rEMMvaFGWWCf8XioLucUfb7nnp96vx9BcbroVsD,EYxYvNkDPViCFpWt7nsnhU27BLNuMbikAV7tNjcs3fFe,False,16554209,16554209,739510,36975,702535,72FwbpFGoLEazJEdpqNtPNefsadUrimUqma9wSoy4qiS,739510,6208482,-5468972,446
2021-11-27 21:41:39-05:00,239,7dSwoqvrbAn6zQ9stAtQEgsgqNze2szYLjuigAXEaapr,7G25dgArTKkpEvqAocVnVNPSAvbAAcogdeeBDak1qetD,False,113439993,113439993,5151760,257588,4894172,72FwbpFGoLEazJEdpqNtPNefsadUrimUqma9wSoy4qiS,5151760,17697491,-12545731,454
2021-11-27 21:41:39-05:00,240,BELLbzmdx1SYke9kZUxFi9VcdvwaHmkZyv24FArQ1J2f,5a5LfKakAaFEVkavVHgExKaUr25RWYpzFic6MUQQ62uc,True,2687462730,671865682,3606857,1803428,1803429,72FwbpFGoLEazJEdpqNtPNefsadUrimUqma9wSoy4qiS,144274302,979110070,-834835768,536
2021-11-27 21:41:39-05:00,241,2XFYFxNQbCr5ao4cVzRZt45fsAwZc4jD9XTABmdqaJWd,CvpzBuDjyimaYFGWFkkBcaZGSRtAvtF6MtRV54mqZ74k,True,902468,225617,1153,576,577,72FwbpFGoLEazJEdpqNtPNefsadUrimUqma9wSoy4qiS,46135,330069,-283934,511
2021-11-27 21:41:40-05:00,242,E6kVebJVmwutZmtjJ1erBzBq4C2yLrSyK1wWTXSeRkc,9HWMtKySmuhf8E5WLjZZLHhGweDL1tCvXMcVunBDaUtE,True,31468311,7867077,48145,24072,24073,72FwbpFGoLEazJEdpqNtPNefsadUrimUqma9wSoy4qiS,1925810,12644887,-10719077,611
2021-11-27 21:41:40-05:00,243,GJvu3coUrkqTGMomAKmNdRqKaEaZrhLss3KUFpdcsr6F,FTKCbVVJYqyMXxoW3AMhZcCj1gHdpQMyuRuJq4KUVB6W,True,7393817919,1848454479,11355594,5677797,5677797,72FwbpFGoLEazJEdpqNtPNefsadUrimUqma9wSoy4qiS,454223773,1736380457,-1282156684,614
2021-11-27 21:41:40-05:00,244,EmHwYySUTRtPZVsRfb3XsnjvGz7hygvp84YDHbx3yUTF,F9zeqPaZA21Kv4nAdfUpsYmX5Xo6M7DaTu24xYLSnsry,True,252817525,63204381,390979,195489,195490,72FwbpFGoLEazJEdpqNtPNefsadUrimUqma9wSoy4qiS,15639184,76011230,-60372046,618
2021-11-27 21:41:40-05:00,245,BpvWyveup3q7q6Cws5TWkFYiZ8bQXRrfdxvzrN9FnYo6,2CWjropYSn9fJ66FT4zqUcwTrEaPp3CjGgoRATixyca1,True,139663703,34915925,211794,105897,105897,72FwbpFGoLEazJEdpqNtPNefsadUrimUqma9wSoy4qiS,8471798,33806349,-25334551,606
2021-11-27 21:41:41-05:00,246,Hn2vg5sPj8WYVoh5H19rjBBcJQRWZfW3u7THZqu9AT8,4xvgBQuFQGaeJyVVjNEBiNhc6rWnjGGY5nxvZt2HBDAm,True,23401509,5850377,34337,17168,17169,72FwbpFGoLEazJEdpqNtPNefsadUrimUqma9wSoy4qiS,1373495,6212083,-4838588,586
2021-11-27 21:41:49-05:00,247,EDE1swNYZ99y9idZacAw5Ncwz2DyD78SqvKMUXA2Dbw4,HSmYYMpNQNr1F2zjvysGRrC57FyusAJNsaXWfbmCfZh4,True,25879088,6469772,40053,20026,20027,72FwbpFGoLEazJEdpqNtPNefsadUrimUqma9wSoy4qiS,1602144,11068314,-9466170,619
2021-11-27 21:41:49-05:00,248,J2gTwrYpzezkRupgBtgudQn5D33x6WjeBhTHnrA1qgqa,FBzoHRwqGRjnMvPEpiZVjtGZYJmAbneE4dpToXPzy8bv,True,12351029987,3087757496,18730027,9365013,9365014,72FwbpFGoLEazJEdpqNtPNefsadUrimUqma9wSoy4qiS,749201091,4324038227,-3574837136,606
2021-11-27 21:41:50-05:00,249,DSEgVqfxXp5wxjn3gNZtmb4E6rJeBm3VcbqdwDnsuzSq,6YVCWznUKheSMPuywSRJgCes7wghPGJXgxfrVfnjN4mB,True,1424459465,356114866,2012110,1006055,1006055,72FwbpFGoLEazJEdpqNtPNefsadUrimUqma9wSoy4qiS,80484428,318892896,-238408468,565
2021-11-27 21:41:50-05:00,250,3fB955q6xxxZcgnCyguLwkSa7egxgBoksPQVQ3U8HRHL,GK7cTdhfSpapJB8dFzEkV8c1UFkJPj281DwztnpKjxLx,True,115271115,28817778,172384,86192,86192,72FwbpFGoLEazJEdpqNtPNefsadUrimUqma9wSoy4qiS,6895376,49165332,-42269956,598
2021-11-27 21:41:50-05:00,251,CDwRuL5cpwTTFEskmrZNNzBfmaLyJ4i1Z9vs9iJANpk8,4MNxu9upSbkx4B2QzVomDxSknNjce8hVKFbF23m5JYS2,True,201649928,50412482,303779,151889,151890,72FwbpFGoLEazJEdpqNtPNefsadUrimUqma9wSoy4qiS,12151188,44955238,-32804050,602
2021-11-27 21:41:50-05:00,252,A9BZ5kjh7iKu7SMzA5WUF31Zst9V7fehwDZaoKs4NpSi,3FzwTaT5LYucvoGGcRVXu5AUDnGHADv6yGqrBT6jEtvH,True,484097863,121024465,738226,369113,369113,72FwbpFGoLEazJEdpqNtPNefsadUrimUqma9wSoy4qiS,29529071,138923201,-109394130,609
2021-11-27 21:41:50-05:00,253,6meAnGTy2XNUDk9qSJZGT6BBRinA5iGiDYEy2T88LXuX,BCzNQCn3J1381yNH5xp5ky9QmVKVdSofSUaLHtxKxPBW,True,908313,227078,1377,688,689,72FwbpFGoLEazJEdpqNtPNefsadUrimUqma9wSoy4qiS,55093,333203,-278110,606
2021-11-27 21:41:51-05:00,254,8nXbrdjjaHB73CRPRenGEQj73wbtEFGDwXsehRGMhsap,43pvdcJ6f27wz94D6ZboKwRJYbyvYCrjsJhYsvk7LJCM,True,56101946,14025486,77185,38592,38593,72FwbpFGoLEazJEdpqNtPNefsadUrimUqma9wSoy4qiS,3087401,20985567,-17898166,550
2021-11-27 21:41:51-05:00,255,E5KDZriZ89a5D4VsMaWxndMMG68RT4weruJ1tCEc6tSx,CaSwkUocpbyyGCQBgKjJZJgcexbyqs2GTrGJH6EMWXAz,True,12353508034,3088377008,17949018,8974509,8974509,72FwbpFGoLEazJEdpqNtPNefsadUrimUqma9wSoy4qiS,717960744,4290352465,-3572391721,581
2021-11-27 21:41:51-05:00,256,7ckvB1uchDPcA5vkjJvu4DHCkgGq81qbJrd4P2CwPDV8,pVjScFyTQfYJ74uA9JLEsChSrtY8fRi2dCM3jtWC6bp,True,4931543,1232885,7081,3540,3541,72FwbpFGoLEazJEdpqNtPNefsadUrimUqma9wSoy4qiS,283251,2097618,-1814367,574
2021-11-27 21:41:51-05:00,257,FpqCxvTkSiwDwD5qEt6hXJxzFDLFLAQ8VevK8zwRqYun,A3p6YQisCJKpNkF7vkjZRbEfbnUt7vTZdR2zPBUSdTkk,True,87277072,21819268,129653,64826,64827,72FwbpFGoLEazJEdpqNtPNefsadUrimUqma9wSoy4qiS,5186129,32248445,-27062316,594
2021-11-27 21:41:51-05:00,258,CBEv8v9XZrgFT8UdEdd813XnRVv9R7GB5PLMyG8UWGC8,4uNcMEcQpJdThpisgNrttkQJTUFTsjEr25qgjkm4titC,True,340288184,85072046,490023,245011,245012,72FwbpFGoLEazJEdpqNtPNefsadUrimUqma9wSoy4qiS,19600959,145523197,-125922238,576
2021-11-27 21:41:51-05:00,259,8Xdf67Q5jXKwS52e492xUBu1tMUgS14jJg7V4R2Q28EP,GAPL3bsXP4xcukhgzyqrbDntGwUSm5BfuwJ8TLKkRaZc,True,681146373,170286593,915796,457898,457898,72FwbpFGoLEazJEdpqNtPNefsadUrimUqma9wSoy4qiS,36631853,163206767,-126574914,537
2021-11-28 13:41:23-05:00,260,4M7XECgNotuYef6fXsB659bgvA4LBYq9WrUFZP8jEZ8q,EjF9ZKUaBWZodjKy7ET7rEyK1uSsKX2cvcd4eJSYarF8,True,182359090,45589772,270067,135033,135034,72FwbpFGoLEazJEdpqNtPNefsadUrimUqma9wSoy4qiS,10802694,51492780,-40690086,592
2021-11-28 13:41:25-05:00,261,8w4uRzN81cghupkF7jNLinGLtCqYwNQFgQtdJfC5so7z,BbbRkq85fYEBGmuxBEEPbt6up4GNB7WQ83VSXwe4ro98,True,5232930771,1308232692,7960381,3980190,3980191,72FwbpFGoLEazJEdpqNtPNefsadUrimUqma9wSoy4qiS,318415274,1482341012,-1163925738,608
2021-11-28 13:41:25-05:00,262,2XFYFxNQbCr5ao4cVzRZt45fsAwZc4jD9XTABmdqaJWd,CvpzBuDjyimaYFGWFkkBcaZGSRtAvtF6MtRV54mqZ74k,True,674513,168628,1040,520,520,72FwbpFGoLEazJEdpqNtPNefsadUrimUqma9wSoy4qiS,41605,256931,-215326,616
2021-11-28 13:41:25-05:00,263,Gs3WP18hbzNpbBgiU39e6tfkggfCKRyNqPqJQcthuHFD,4XAY25YUma6gUdG2GdbXeivum3t21g93ZagfWGTZYkWZ,True,37532381,9383095,57086,28543,28543,72FwbpFGoLEazJEdpqNtPNefsadUrimUqma9wSoy4qiS,2283461,12009580,-9726119,608
2021-11-28 13:41:25-05:00,264,FZhvN1RjLoBK9EpCeyEobYsvdHirtbTXV82c9EV9nn2u,FSeHqYNof79JYrRb7ZkJWEb4TfS5wx7HTdvT1kLCexHM,True,49333436,12333359,73230,36615,36615,72FwbpFGoLEazJEdpqNtPNefsadUrimUqma9wSoy4qiS,2929236,15358801,-12429565,593
2021-11-28 13:41:25-05:00,265,3XzkSrNTGd3Fhd4M3gYzvz2utbQpFN1fhtbAaZu7C39R,GMsZGGfktTzYi7GhD3W6HY9QY9bznqTKfeArksikLE71,True,6056355,1514088,9352,4676,4676,72FwbpFGoLEazJEdpqNtPNefsadUrimUqma9wSoy4qiS,374081,2069489,-1695408,617
2021-11-28 13:41:25-05:00,266,57GUgfEp9ZQ5iAU2nx1Z2Tiz3gqq7yBNaqfE1cvxjFYt,98upivFa9Tdy3RZHGM1i2k5zeczaGqioq3rTzc3DMf4x,True,128138999,32034749,191002,95501,95501,72FwbpFGoLEazJEdpqNtPNefsadUrimUqma9wSoy4qiS,7640095,47530287,-39890192,596
2021-11-28 13:41:26-05:00,267,C24que1C7tC3ysDSKhcBTF9NUnjiNhSanWp8Go5FRRb8,hgm3qRRG2njhNPWcUp9UnEU8pyg4gLaR2K13r4Lsqxm,True,492235506,123058876,743819,371909,371910,72FwbpFGoLEazJEdpqNtPNefsadUrimUqma9wSoy4qiS,29752781,137541117,-107788336,604
2021-11-28 13:41:26-05:00,268,EQYUWtYbtvN9C9ixiupXPjHyFWHsYa7dUh4DSd6rxbzt,iS616uGNCwCxP1taAvvdvA2KdqfXRSjcQWwZRUgBkLb,True,11569593,2892398,17338,8669,8669,72FwbpFGoLEazJEdpqNtPNefsadUrimUqma9wSoy4qiS,693535,4409422,-3715887,599
2021-11-28 13:41:26-05:00,269,66SjFhmiNYz8tLRnBhZUbowWGTbM16G52X3AT2hma2wN,3wVy8nk24HCFZWMiacGe8QsJquYaadZ9pQg44bGRwdE3,True,35635796,8908949,52724,26362,26362,72FwbpFGoLEazJEdpqNtPNefsadUrimUqma9wSoy4qiS,2108970,14607448,-12498478,591
2021-11-28 13:41:26-05:00,270,GSaQj6w7ssfDpMGzMQd4pyhZvLeGvYc1Vc9Qcsx1t69g,HSNX4PwuAAuUncgs11suc9rFJ6ntB8BRN7ViFYT9RATM,True,2394795397,598698849,3452303,1726151,1726152,72FwbpFGoLEazJEdpqNtPNefsadUrimUqma9wSoy4qiS,138092129,641020152,-502928023,576
2021-11-28 13:41:35-05:00,271,4xsYjVsPm2C2itNtJb3NYkBp4WySHUwtSbWdu9fge8wz,8zu2jMoTndZpf9khY9PMhve88LRwrKNTuVuLpa5ss8qo,True,458621846,114655461,701800,350900,350900,72FwbpFGoLEazJEdpqNtPNefsadUrimUqma9wSoy4qiS,28072014,162942905,-134870891,612
2021-11-28 13:41:37-05:00,272,7gxTghaVZPNNwaNEdtQHh4QDCJ4JgigYMd4MMCC9VtFo,4ZZTUrm4jX1jqqTYVFJ9TJQ2BLx2eZgXesmoon1LBa1a,True,12732280,3183070,18945,9472,9473,72FwbpFGoLEazJEdpqNtPNefsadUrimUqma9wSoy4qiS,757830,3015550,-2257720,595
2021-11-28 13:42:49-05:00,273,8d333AWdyiVhvkAdiKCTwhgzaPBMbn8mtucwUC1SAbZZ,3BM8UNLN7XGRaYRjezAqFVMr1z4PS3VRXiN1NAtvBuD9,True,107229330,26807332,166234,83117,83117,72FwbpFGoLEazJEdpqNtPNefsadUrimUqma9wSoy4qiS,6649394,38255177,-31605783,620
2021-11-28 13:42:54-05:00,274,DCxghVXCXzEar41CPGichdzvtjwmf4NW7uHtKTj57BNN,Fmh5FPdnFb1KpFkoL6eNfWFGxN78GLdaJgPcVpCoCnkh,True,422294236,105573559,660882,330441,330441,72FwbpFGoLEazJEdpqNtPNefsadUrimUqma9wSoy4qiS,26435298,117269699,-90834401,625
2021-11-28 13:42:59-05:00,275,6RkvJTPLnRHhdfat6yP9Jd8QWrC6ad8c9oEygRgpg2Li,14UWcWSMirA7yAaW36BxGuvdYTAqNoxL1YKcstXQmGD5,True,79356396,19839099,122660,61330,61330,72FwbpFGoLEazJEdpqNtPNefsadUrimUqma9wSoy4qiS,4906402,18833672,-13927270,618
2021-12-02 14:51:27-05:00,276,ABjtqe2knhPfwbPpbXyr3XmFA6hDKXAHTfRZ8mwbdcJ6,HXPWkfFS1u3crwgu1kBKLtsn5E7owLWUr5poaQe3NcUs,False,7402334578,7402334578,354342695,17717134,336625561,4BnQKPLuE3DMTtxp8MjUBytgnhvxqq3ZTqZHTVZo4JJh,354342695,1231291688,-876948993,478
2021-12-03 19:48:41-05:00,277,8GuH7tofwd6okCa9CPV4kbZ1RdpjPAS14kzKgJrUhbP5,DW3PVKVSBEswSoyfFsne169qSSt9Z3JFXcaLqFVSiYfY,True,912298552,228074638,1406888,703444,703444,72FwbpFGoLEazJEdpqNtPNefsadUrimUqma9wSoy4qiS,56275524,213868902,-157593378,616
2021-12-03 20:01:56-05:00,278,9kK2PuehQxgcXtnYnPNmukmzfDTsVHv15pE86xwi7vYt,DtbCSCur1w6ZMGu56auQaHf8c6gVDJoD1iEwiUyCBcYJ,True,76910126,19227531,120054,60027,60027,4BnQKPLuE3DMTtxp8MjUBytgnhvxqq3ZTqZHTVZo4JJh,4802176,17882960,-13080784,624
2021-12-03 22:26:14-05:00,279,CUhCSd7jHvycC89L6EqMoDWcWVTXXHhAeXVyB4362qZg,J7B9JBV1xR8a7DKKrw3JwGusY4H2bSQuyHtod2Fzf4jq,True,540742672,135185668,839387,419693,419694,72FwbpFGoLEazJEdpqNtPNefsadUrimUqma9wSoy4qiS,33575487,120642278,-87066791,620
2021-12-03 22:28:05-05:00,280,DE8KcmECtrF8XoCzuiTJLDFgm4cTSjQFJYSP81WHfr8L,J9GYsnRjDbkwrcqa1XfBmVNXqa9pgzzRymdntFZu1PCv,True,392808366,98202091,614280,307140,307140,72FwbpFGoLEazJEdpqNtPNefsadUrimUqma9wSoy4qiS,24571210,91964508,-67393298,625
2021-12-03 22:56:47-05:00,281,C66xkhG3GSswFRqZ8BHATwPbPhyGsWxJ1ymMaDerKbLX,HkJXe2vivbt9aVuJkmA11w9uz8Kbg4fB9sdL2fUmJcQR,True,302957295,75739323,470222,235111,235111,4BnQKPLuE3DMTtxp8MjUBytgnhvxqq3ZTqZHTVZo4JJh,18808908,70815758,-52006850,620
2021-12-03 22:57:50-05:00,282,A4Ce8RnM3qZW9Njo363ywPyhpcUqQTH2PVJn2ugYMmqx,DWSTAcKdqtc8qixLxWGx4shHe1PT2h4hDSMDVQqn1N8L,True,17754933,4438733,27631,13815,13816,4BnQKPLuE3DMTtxp8MjUBytgnhvxqq3ZTqZHTVZo4JJh,1105246,4350313,-3245067,622
2021-12-03 22:58:18-05:00,283,Gq7fPzML38eX6tSedGqCMhmbw7WsaSEYoEZM3BucjZh8,AvEB59ycFk7Y74Wt79cUV9B49GJqwc5c26GCGc29i5zC,True,212946670,53236667,321069,160534,160535,4BnQKPLuE3DMTtxp8MjUBytgnhvxqq3ZTqZHTVZo4JJh,12842760,49870840,-37028080,603
2021-12-03 22:58:29-05:00,284,8GuH7tofwd6okCa9CPV4kbZ1RdpjPAS14kzKgJrUhbP5,DW3PVKVSBEswSoyfFsne169qSSt9Z3JFXcaLqFVSiYfY,True,670539535,167634883,1023977,511988,511989,4BnQKPLuE3DMTtxp8MjUBytgnhvxqq3ZTqZHTVZo4JJh,40959117,172870621,-131911504,610
2021-12-03 22:58:30-05:00,285,9hzdQrYGDWaS9vDhDZGjh79WxE1urqR4ubNacHddr4Us,971fdspGqjQBdVuG7D5JGvxsRYDJPtAMHaJrQQzDuBUg,True,238307084,59576771,361477,180738,180739,72FwbpFGoLEazJEdpqNtPNefsadUrimUqma9wSoy4qiS,14459083,55788538,-41329455,606
2021-12-03 22:59:30-05:00,286,9kK2PuehQxgcXtnYnPNmukmzfDTsVHv15pE86xwi7vYt,DtbCSCur1w6ZMGu56auQaHf8c6gVDJoD1iEwiUyCBcYJ,True,56448157,14112039,85905,42952,42953,72FwbpFGoLEazJEdpqNtPNefsadUrimUqma9wSoy4qiS,3436235,14481502,-11045267,608
2021-12-03 23:00:45-05:00,287,94KFzzXCAvEfSf3jrnUpyN3pne8Xfc6nroB7UxTVqeyB,ERQEKcL8qV9WEzLwi5WFjh2wN97q9GD9pqd9umcTypxy,True,21277752,5319438,33199,16599,16600,4BnQKPLuE3DMTtxp8MjUBytgnhvxqq3ZTqZHTVZo4JJh,1327967,4976172,-3648205,624
2021-12-03 23:00:54-05:00,288,CUhCSd7jHvycC89L6EqMoDWcWVTXXHhAeXVyB4362qZg,J7B9JBV1xR8a7DKKrw3JwGusY4H2bSQuyHtod2Fzf4jq,True,397098307,99274576,605470,302735,302735,4BnQKPLuE3DMTtxp8MjUBytgnhvxqq3ZTqZHTVZo4JJh,24218829,97988860,-73770031,609
2021-12-03 23:00:55-05:00,289,DE8KcmECtrF8XoCzuiTJLDFgm4cTSjQFJYSP81WHfr8L,J9GYsnRjDbkwrcqa1XfBmVNXqa9pgzzRymdntFZu1PCv,True,288624582,72156145,448316,224158,224158,72FwbpFGoLEazJEdpqNtPNefsadUrimUqma9wSoy4qiS,17932668,74465305,-56532637,621
2021-12-03 23:54:05-05:00,290,DSnvQca2ReL3mzwucUGzXTqhxqX5BABy4XvoWDLUfKCU,GfRyJVAx5ckPZn4iJ9ZW9yrLVsw3a2nzwg8QVWaQ6qkF,True,2121303257,530325814,3246592,1623296,1623296,72FwbpFGoLEazJEdpqNtPNefsadUrimUqma9wSoy4qiS,129863681,494589240,-364725559,612
2021-12-03 23:54:23-05:00,291,E5KDZriZ89a5D4VsMaWxndMMG68RT4weruJ1tCEc6tSx,CaSwkUocpbyyGCQBgKjJZJgcexbyqs2GTrGJH6EMWXAz,True,13891806267,3472951566,21586604,10793302,10793302,4BnQKPLuE3DMTtxp8MjUBytgnhvxqq3ZTqZHTVZo4JJh,863464169,3512383910,-2648919741,621
2021-12-03 23:54:26-05:00,292,C66xkhG3GSswFRqZ8BHATwPbPhyGsWxJ1ymMaDerKbLX,HkJXe2vivbt9aVuJkmA11w9uz8Kbg4fB9sdL2fUmJcQR,True,222577924,55644481,341641,170820,170821,72FwbpFGoLEazJEdpqNtPNefsadUrimUqma9wSoy4qiS,13665670,57314436,-43648766,613
2021-12-03 23:54:50-05:00,293,A4Ce8RnM3qZW9Njo363ywPyhpcUqQTH2PVJn2ugYMmqx,DWSTAcKdqtc8qixLxWGx4shHe1PT2h4hDSMDVQqn1N8L,True,13053708,3263427,20329,10164,10165,72FwbpFGoLEazJEdpqNtPNefsadUrimUqma9wSoy4qiS,813186,3509550,-2696364,622
2021-12-03 23:54:50-05:00,294,HnUkyFhntoajDEgXMKeoh4nAuY5y7osLYwmYAApyLSNs,GntEkHxrGpcHFCVLQGjKiXWdenbsqfQgxddpEpxpE65z,True,119305609,29826402,183184,91592,91592,72FwbpFGoLEazJEdpqNtPNefsadUrimUqma9wSoy4qiS,7327362,28007613,-20680251,614
2021-12-03 23:55:18-05:00,295,J2gTwrYpzezkRupgBtgudQn5D33x6WjeBhTHnrA1qgqa,FBzoHRwqGRjnMvPEpiZVjtGZYJmAbneE4dpToXPzy8bv,True,13307132849,3326783212,20786219,10393109,10393110,4BnQKPLuE3DMTtxp8MjUBytgnhvxqq3ZTqZHTVZo4JJh,831448765,3537919254,-2706470489,624
2021-12-03 23:55:23-05:00,296,Gq7fPzML38eX6tSedGqCMhmbw7WsaSEYoEZM3BucjZh8,AvEB59ycFk7Y74Wt79cUV9B49GJqwc5c26GCGc29i5zC,True,156959862,39239965,243705,121852,121853,4BnQKPLuE3DMTtxp8MjUBytgnhvxqq3ZTqZHTVZo4JJh,9748219,40271237,-30523018,621
2021-12-03 23:55:40-05:00,297,8GuH7tofwd6okCa9CPV4kbZ1RdpjPAS14kzKgJrUhbP5,DW3PVKVSBEswSoyfFsne169qSSt9Z3JFXcaLqFVSiYfY,True,489198808,122299702,653895,326947,326948,72FwbpFGoLEazJEdpqNtPNefsadUrimUqma9wSoy4qiS,26155820,138813193,-112657373,534
2021-12-03 23:55:40-05:00,298,9kK2PuehQxgcXtnYnPNmukmzfDTsVHv15pE86xwi7vYt,DtbCSCur1w6ZMGu56auQaHf8c6gVDJoD1iEwiUyCBcYJ,True,41337327,10334331,58633,29316,29317,72FwbpFGoLEazJEdpqNtPNefsadUrimUqma9wSoy4qiS,2345331,11628259,-9282928,567
2021-12-03 23:55:40-05:00,299,E3uCNxXMRHD2ayCY48Kafwy55443r3p1EijT92ug26yd,AMqLEmYQZRhhE7dRQQ21QYfBbthnAVQvmPh9PNbyavta,True,12744192,3186048,17540,8770,8770,72FwbpFGoLEazJEdpqNtPNefsadUrimUqma9wSoy4qiS,701623,2975354,-2273731,550
2021-12-03 23:55:42-05:00,300,CUhCSd7jHvycC89L6EqMoDWcWVTXXHhAeXVyB4362qZg,J7B9JBV1xR8a7DKKrw3JwGusY4H2bSQuyHtod2Fzf4jq,True,292473996,73118499,456590,228295,228295,72FwbpFGoLEazJEdpqNtPNefsadUrimUqma9wSoy4qiS,18263624,78947120,-60683496,624
2021-12-03 23:55:42-05:00,301,EBUcTqh9AYyRokZRzLbPKL9ZmTUx6KcDEbBeuCLGwqYC,B5WSXfHzYQhUFE2T97GaiqSkeejTWKKGVjMkcFrxEvyJ,True,186135299,46533824,254265,127132,127133,72FwbpFGoLEazJEdpqNtPNefsadUrimUqma9wSoy4qiS,10170626,44013107,-33842481,546
2021-12-03 23:55:43-05:00,302,9hzdQrYGDWaS9vDhDZGjh79WxE1urqR4ubNacHddr4Us,971fdspGqjQBdVuG7D5JGvxsRYDJPtAMHaJrQQzDuBUg,True,173839588,43459897,229519,114759,114760,72FwbpFGoLEazJEdpqNtPNefsadUrimUqma9wSoy4qiS,9180769,45070855,-35890086,528
2021-12-03 23:56:03-05:00,303,DSnvQca2ReL3mzwucUGzXTqhxqX5BABy4XvoWDLUfKCU,GfRyJVAx5ckPZn4iJ9ZW9yrLVsw3a2nzwg8QVWaQ6qkF,True,1561879911,390469977,2437988,1218994,1218994,72FwbpFGoLEazJEdpqNtPNefsadUrimUqma9wSoy4qiS,97519557,400337303,-302817746,624
2021-12-03 23:56:07-05:00,304,EvSdLa5PeJiaaaE3omJNG7cw1tptZnHTituYswVHSwm3,68ESX2mBsfxQo2U9jsbmHo7TzPTxr9mGH5Y11ZLR7E3A,True,143437552,35859388,220042,110021,110021,4BnQKPLuE3DMTtxp8MjUBytgnhvxqq3ZTqZHTVZo4JJh,8801716,43370745,-34569029,613
2021-12-03 23:56:11-05:00,305,DE8KcmECtrF8XoCzuiTJLDFgm4cTSjQFJYSP81WHfr8L,J9GYsnRjDbkwrcqa1XfBmVNXqa9pgzzRymdntFZu1PCv,True,212221893,53055473,330945,165472,165473,72FwbpFGoLEazJEdpqNtPNefsadUrimUqma9wSoy4qiS,13237808,59887168,-46649360,623
2021-12-03 23:56:15-05:00,306,94KFzzXCAvEfSf3jrnUpyN3pne8Xfc6nroB7UxTVqeyB,ERQEKcL8qV9WEzLwi5WFjh2wN97q9GD9pqd9umcTypxy,True,15601891,3900472,23458,11729,11729,72FwbpFGoLEazJEdpqNtPNefsadUrimUqma9wSoy4qiS,938345,4030985,-3092640,601
2021-12-03 23:56:26-05:00,307,FEWgesdpjtMv15TjLLY1LHjzXjZDaLENFTdjuhbwdBg9,4J2YMa9XUzLMfjYDwHeD4GRmXHFBGywYsmcVFvCDYW6T,True,967610649,241902662,1503832,751916,751916,72FwbpFGoLEazJEdpqNtPNefsadUrimUqma9wSoy4qiS,60153282,250212037,-190058755,621
2021-12-03 23:56:53-05:00,308,C66xkhG3GSswFRqZ8BHATwPbPhyGsWxJ1ymMaDerKbLX,HkJXe2vivbt9aVuJkmA11w9uz8Kbg4fB9sdL2fUmJcQR,True,163654809,40913702,251134,125567,125567,72FwbpFGoLEazJEdpqNtPNefsadUrimUqma9wSoy4qiS,10045395,46062603,-36017208,613
2021-12-04 00:04:04-05:00,309,9hzdQrYGDWaS9vDhDZGjh79WxE1urqR4ubNacHddr4Us,971fdspGqjQBdVuG7D5JGvxsRYDJPtAMHaJrQQzDuBUg,True,129448980,32362245,200045,100022,100023,72FwbpFGoLEazJEdpqNtPNefsadUrimUqma9wSoy4qiS,8001839,35851348,-27849509,618
2021-12-04 00:04:04-05:00,310,8GuH7tofwd6okCa9CPV4kbZ1RdpjPAS14kzKgJrUhbP5,DW3PVKVSBEswSoyfFsne169qSSt9Z3JFXcaLqFVSiYfY,True,364237222,91059305,569685,284842,284843,72FwbpFGoLEazJEdpqNtPNefsadUrimUqma9wSoy4qiS,22787421,109952284,-87164863,625
2021-12-04 00:04:05-05:00,311,HnUkyFhntoajDEgXMKeoh4nAuY5y7osLYwmYAApyLSNs,GntEkHxrGpcHFCVLQGjKiXWdenbsqfQgxddpEpxpE65z,True,87765406,21941351,135442,67721,67721,72FwbpFGoLEazJEdpqNtPNefsadUrimUqma9wSoy4qiS,5417698,22642282,-17224584,617
2021-12-04 00:04:26-05:00,312,Gq7fPzML38eX6tSedGqCMhmbw7WsaSEYoEZM3BucjZh8,AvEB59ycFk7Y74Wt79cUV9B49GJqwc5c26GCGc29i5zC,True,114616316,28654079,159605,79802,79803,72FwbpFGoLEazJEdpqNtPNefsadUrimUqma9wSoy4qiS,6384225,32381090,-25996865,557
2021-12-04 00:04:26-05:00,313,EBUcTqh9AYyRokZRzLbPKL9ZmTUx6KcDEbBeuCLGwqYC,B5WSXfHzYQhUFE2T97GaiqSkeejTWKKGVjMkcFrxEvyJ,True,137349471,34337367,191108,95554,95554,72FwbpFGoLEazJEdpqNtPNefsadUrimUqma9wSoy4qiS,7644335,35279612,-27635277,556
2021-12-04 00:04:26-05:00,314,GSaQj6w7ssfDpMGzMQd4pyhZvLeGvYc1Vc9Qcsx1t69g,HSNX4PwuAAuUncgs11suc9rFJ6ntB8BRN7ViFYT9RATM,True,3217170677,804292669,4838829,2419414,2419415,72FwbpFGoLEazJEdpqNtPNefsadUrimUqma9wSoy4qiS,193553173,746348946,-552795773,601
2021-12-04 00:04:26-05:00,315,A4Ce8RnM3qZW9Njo363ywPyhpcUqQTH2PVJn2ugYMmqx,DWSTAcKdqtc8qixLxWGx4shHe1PT2h4hDSMDVQqn1N8L,True,9513576,2378394,12869,6434,6435,72FwbpFGoLEazJEdpqNtPNefsadUrimUqma9wSoy4qiS,514765,2813793,-2299028,541
2021-12-04 00:04:26-05:00,316,6HzCJnV3Z4psm7V64UpJBstZxK2XAxUySyuoX8RJaFwY,2AsimTXANwSRChLJWdLjdJG8X2gwGsrjPguqFZjuAeA9,True,40456428,10114107,61377,30688,30689,72FwbpFGoLEazJEdpqNtPNefsadUrimUqma9wSoy4qiS,2455097,9959447,-7504350,606
2021-12-04 00:04:26-05:00,317,3LfgumhfN7fRDEPhEN8SfVWXVnmSj6wuWQ1qYxKv6Eup,BYDZyXhUyMKvQnsnVLT8RqNYqUtf5SAFZGZx99E5dUmW,True,4215311,1053827,5796,2898,2898,72FwbpFGoLEazJEdpqNtPNefsadUrimUqma9wSoy4qiS,231867,1016556,-784689,550
2021-12-04 00:04:30-05:00,318,9kK2PuehQxgcXtnYnPNmukmzfDTsVHv15pE86xwi7vYt,DtbCSCur1w6ZMGu56auQaHf8c6gVDJoD1iEwiUyCBcYJ,True,30491171,7622792,44260,22130,22130,72FwbpFGoLEazJEdpqNtPNefsadUrimUqma9wSoy4qiS,1770427,9244556,-7474129,580
2021-12-04 00:04:30-05:00,319,E3uCNxXMRHD2ayCY48Kafwy55443r3p1EijT92ug26yd,AMqLEmYQZRhhE7dRQQ21QYfBbthnAVQvmPh9PNbyavta,True,9400812,2350203,13134,6567,6567,72FwbpFGoLEazJEdpqNtPNefsadUrimUqma9wSoy4qiS,525381,2388071,-1862690,558
2021-12-04 00:04:31-05:00,320,J2gTwrYpzezkRupgBtgudQn5D33x6WjeBhTHnrA1qgqa,FBzoHRwqGRjnMvPEpiZVjtGZYJmAbneE4dpToXPzy8bv,True,9714845104,2428711276,13593474,6796737,6796737,72FwbpFGoLEazJEdpqNtPNefsadUrimUqma9wSoy4qiS,543738994,2846226264,-2302487270,559
2021-12-04 00:04:32-05:00,321,7ckvB1uchDPcA5vkjJvu4DHCkgGq81qbJrd4P2CwPDV8,pVjScFyTQfYJ74uA9JLEsChSrtY8fRi2dCM3jtWC6bp,True,104848669,26212167,141619,70809,70810,72FwbpFGoLEazJEdpqNtPNefsadUrimUqma9wSoy4qiS,5664762,26284995,-20620233,540
2021-12-04 00:04:35-05:00,322,E5KDZriZ89a5D4VsMaWxndMMG68RT4weruJ1tCEc6tSx,CaSwkUocpbyyGCQBgKjJZJgcexbyqs2GTrGJH6EMWXAz,True,10132618086,2533154521,13850742,6925371,6925371,72FwbpFGoLEazJEdpqNtPNefsadUrimUqma9wSoy4qiS,554029687,2832325796,-2278296109,546
2021-12-04 00:04:54-05:00,323,2JH43pKUeXTXPd6LnL4BWgGQpwZHhX8EqyohKCFLAS4i,Bir3EKnDWkv6XX7KmoqAi1y6rxSaC5RfVV6Hwvnkfr2i,True,81088239,20272059,122579,61289,61290,72FwbpFGoLEazJEdpqNtPNefsadUrimUqma9wSoy4qiS,4903171,18805337,-13902166,604
2021-12-04 00:05:01-05:00,324,7ckvB1uchDPcA5vkjJvu4DHCkgGq81qbJrd4P2CwPDV8,pVjScFyTQfYJ74uA9JLEsChSrtY8fRi2dCM3jtWC6bp,True,77887101,19471775,119343,59671,59672,72FwbpFGoLEazJEdpqNtPNefsadUrimUqma9wSoy4qiS,4773742,20988800,-16215058,612
2021-12-04 00:05:01-05:00,325,A4Ce8RnM3qZW9Njo363ywPyhpcUqQTH2PVJn2ugYMmqx,DWSTAcKdqtc8qixLxWGx4shHe1PT2h4hDSMDVQqn1N8L,True,7061312,1765328,10700,5350,5350,72FwbpFGoLEazJEdpqNtPNefsadUrimUqma9wSoy4qiS,428026,2226182,-1798156,606
2021-12-04 00:05:05-05:00,326,FEWgesdpjtMv15TjLLY1LHjzXjZDaLENFTdjuhbwdBg9,4J2YMa9XUzLMfjYDwHeD4GRmXHFBGywYsmcVFvCDYW6T,True,708893766,177223441,1043269,521634,521635,72FwbpFGoLEazJEdpqNtPNefsadUrimUqma9wSoy4qiS,41730768,201126836,-159396068,588
2021-12-04 00:05:05-05:00,327,9hzdQrYGDWaS9vDhDZGjh79WxE1urqR4ubNacHddr4Us,971fdspGqjQBdVuG7D5JGvxsRYDJPtAMHaJrQQzDuBUg,True,95182089,23795522,147428,73714,73714,72FwbpFGoLEazJEdpqNtPNefsadUrimUqma9wSoy4qiS,5897148,28689635,-22792487,619
2021-12-04 00:05:10-05:00,328,94KFzzXCAvEfSf3jrnUpyN3pne8Xfc6nroB7UxTVqeyB,ERQEKcL8qV9WEzLwi5WFjh2wN97q9GD9pqd9umcTypxy,True,11432434,2858108,16105,8052,8053,72FwbpFGoLEazJEdpqNtPNefsadUrimUqma9wSoy4qiS,644218,3232703,-2588485,563
2021-12-04 00:05:10-05:00,329,3LfgumhfN7fRDEPhEN8SfVWXVnmSj6wuWQ1qYxKv6Eup,BYDZyXhUyMKvQnsnVLT8RqNYqUtf5SAFZGZx99E5dUmW,True,3128613,782153,4830,2415,2415,72FwbpFGoLEazJEdpqNtPNefsadUrimUqma9wSoy4qiS,193200,814625,-621425,617
2021-12-04 00:05:10-05:00,330,EBUcTqh9AYyRokZRzLbPKL9ZmTUx6KcDEbBeuCLGwqYC,B5WSXfHzYQhUFE2T97GaiqSkeejTWKKGVjMkcFrxEvyJ,True,101911895,25477973,158825,79412,79413,72FwbpFGoLEazJEdpqNtPNefsadUrimUqma9wSoy4qiS,6353018,28180463,-21827445,623
2021-12-04 00:05:10-05:00,331,CUhCSd7jHvycC89L6EqMoDWcWVTXXHhAeXVyB4362qZg,J7B9JBV1xR8a7DKKrw3JwGusY4H2bSQuyHtod2Fzf4jq,True,213503939,53375984,298100,149050,149050,72FwbpFGoLEazJEdpqNtPNefsadUrimUqma9wSoy4qiS,11924015,63291678,-51367663,558
2021-12-04 00:05:17-05:00,332,DE8KcmECtrF8XoCzuiTJLDFgm4cTSjQFJYSP81WHfr8L,J9GYsnRjDbkwrcqa1XfBmVNXqa9pgzzRymdntFZu1PCv,True,155161956,38790489,221988,110994,110994,72FwbpFGoLEazJEdpqNtPNefsadUrimUqma9wSoy4qiS,8879535,47872927,-38993392,572
2021-12-04 00:05:19-05:00,333,EvSdLa5PeJiaaaE3omJNG7cw1tptZnHTituYswVHSwm3,68ESX2mBsfxQo2U9jsbmHo7TzPTxr9mGH5Y11ZLR7E3A,True,105008925,26252231,149924,74962,74962,72FwbpFGoLEazJEdpqNtPNefsadUrimUqma9wSoy4qiS,5996961,34493874,-28496913,571
2021-12-04 00:05:19-05:00,334,FV9CBGGTbppLnBKh79f2LzD1diTiS5g6u89FcpZHZmnK,Fe7mtmCUziFqbbYTvrhAcAq1Ub7YLfTJRtQ1hG7GzJD1,True,53757264,13439316,83338,41669,41669,72FwbpFGoLEazJEdpqNtPNefsadUrimUqma9wSoy4qiS,3333552,12359767,-9026215,620
2021-12-04 00:05:20-05:00,335,Gq7fPzML38eX6tSedGqCMhmbw7WsaSEYoEZM3BucjZh8,AvEB59ycFk7Y74Wt79cUV9B49GJqwc5c26GCGc29i5zC,True,85038485,21259621,132521,66260,66261,72FwbpFGoLEazJEdpqNtPNefsadUrimUqma9wSoy4qiS,5300868,25722871,-20422003,623
2021-12-04 00:05:20-05:00,336,DSnvQca2ReL3mzwucUGzXTqhxqX5BABy4XvoWDLUfKCU,GfRyJVAx5ckPZn4iJ9ZW9yrLVsw3a2nzwg8QVWaQ6qkF,True,1143395064,285848766,1672454,836227,836227,72FwbpFGoLEazJEdpqNtPNefsadUrimUqma9wSoy4qiS,66898174,322124458,-255226284,585
2021-12-04 00:05:20-05:00,337,C66xkhG3GSswFRqZ8BHATwPbPhyGsWxJ1ymMaDerKbLX,HkJXe2vivbt9aVuJkmA11w9uz8Kbg4fB9sdL2fUmJcQR,True,120153678,30038419,179728,89864,89864,72FwbpFGoLEazJEdpqNtPNefsadUrimUqma9wSoy4qiS,7189124,36790599,-29601475,598
2021-12-04 00:05:20-05:00,338,8w1hzDtCFuTJqWAtwihztrPzxwa7YrJH5uPk877SJnNj,D3gnctosqTZxTQNfLJQRdPgCvGx2JLLHHDmcvW5UX1QN,True,1751986511,437996627,2492665,1246332,1246333,72FwbpFGoLEazJEdpqNtPNefsadUrimUqma9wSoy4qiS,99706603,417722271,-318015668,569
2021-12-04 00:05:22-05:00,339,HnUkyFhntoajDEgXMKeoh4nAuY5y7osLYwmYAApyLSNs,GntEkHxrGpcHFCVLQGjKiXWdenbsqfQgxddpEpxpE65z,True,64513116,16128279,99282,49641,49641,72FwbpFGoLEazJEdpqNtPNefsadUrimUqma9wSoy4qiS,3971317,18201072,-14229755,615
2021-12-04 00:05:28-05:00,340,E3uCNxXMRHD2ayCY48Kafwy55443r3p1EijT92ug26yd,AMqLEmYQZRhhE7dRQQ21QYfBbthnAVQvmPh9PNbyavta,True,6974751,1743687,10909,5454,5455,72FwbpFGoLEazJEdpqNtPNefsadUrimUqma9wSoy4qiS,436389,1909270,-1472881,625
2021-12-04 00:10:06-05:00,341,5Rxuqgs4CaSKbfDXqBMFXkLTQ9dxrUjThXzoy3ouYVtK,BgvbKru66ebrGUcFFymGTmsaQv6GgcGMybiWaXqzBtwX,True,47053440,11763360,73104,36552,36552,72FwbpFGoLEazJEdpqNtPNefsadUrimUqma9wSoy4qiS,2924184,10865189,-7941005,621
2021-12-04 00:24:29-05:00,342,GbPWktFegZQEz5CDL2kphHexVrQgy3hTmXa8mCEZtdps,BVQzSYxgF1v6ftSLe5mftqgvretxPcNCrtN8RrHKDn5x,True,894996000,223749000,1375929,687964,687965,72FwbpFGoLEazJEdpqNtPNefsadUrimUqma9wSoy4qiS,55037178,207032031,-151994853,614
2021-12-04 00:24:39-05:00,343,FFsQo78UMHAfXc8F38txcR3sjWCqEjLT9AGoCvtuWbh6,Bn1dsirxXSzuWVCz8rSnGXDz7UTUV2yLqfa8QNa7QgcR,True,8477880,2119470,13045,6522,6523,72FwbpFGoLEazJEdpqNtPNefsadUrimUqma9wSoy4qiS,521834,2043954,-1522120,615
2021-12-04 00:24:39-05:00,344,2qsrQ75TWz5g3KVoWbKKa9DsLQ5uCAndmfjqPsWzwExJ,Bj7LHrHSg9M3H9ZxFCxqdw8u79iw8K2awJHzk7QNdayy,True,3359522,839880,5210,2605,2605,72FwbpFGoLEazJEdpqNtPNefsadUrimUqma9wSoy4qiS,208419,848897,-640478,620
2021-12-04 00:24:39-05:00,345,8GuH7tofwd6okCa9CPV4kbZ1RdpjPAS14kzKgJrUhbP5,DW3PVKVSBEswSoyfFsne169qSSt9Z3JFXcaLqFVSiYfY,True,267328816,66832204,409215,204607,204608,72FwbpFGoLEazJEdpqNtPNefsadUrimUqma9wSoy4qiS,16368635,87596971,-71228336,612
2021-12-04 00:24:46-05:00,346,J2gTwrYpzezkRupgBtgudQn5D33x6WjeBhTHnrA1qgqa,FBzoHRwqGRjnMvPEpiZVjtGZYJmAbneE4dpToXPzy8bv,True,7180479961,1795119990,10612291,5306145,5306146,72FwbpFGoLEazJEdpqNtPNefsadUrimUqma9wSoy4qiS,424491653,2260971972,-1836480319,591
2021-12-04 00:24:46-05:00,347,6HzCJnV3Z4psm7V64UpJBstZxK2XAxUySyuoX8RJaFwY,2AsimTXANwSRChLJWdLjdJG8X2gwGsrjPguqFZjuAeA9,True,29631342,7407835,42068,21034,21034,72FwbpFGoLEazJEdpqNtPNefsadUrimUqma9wSoy4qiS,1682741,8022460,-6339719,567
2021-12-04 00:24:55-05:00,348,E5KDZriZ89a5D4VsMaWxndMMG68RT4weruJ1tCEc6tSx,CaSwkUocpbyyGCQBgKjJZJgcexbyqs2GTrGJH6EMWXAz,True,7464234059,1866058514,10123735,5061867,5061868,72FwbpFGoLEazJEdpqNtPNefsadUrimUqma9wSoy4qiS,404949439,2251879079,-1846929640,542
2021-12-04 00:25:00-05:00,349,3TTUCUbDMr98vbwUidKDsmkVdLavhTsypKwMvn7s3De6,53PNcr23uUHeNEQWzez9BZdSDMvqMw3DR5NcMAQvDhrq,True,21680400569,5420100142,31819793,15909896,15909897,72FwbpFGoLEazJEdpqNtPNefsadUrimUqma9wSoy4qiS,1272791739,5047921985,-3775130246,587
2021-12-04 00:25:01-05:00,350,BHQFfHCfTAp6xYFNdHRv65BtaobfhBaLFp2KTMxL6ZhN,Eg8q7M4e3qQvUUGqy8QZVxgE6hR1rtdsYPUXqksJhkv3,True,425457258,106364314,612418,306209,306209,72FwbpFGoLEazJEdpqNtPNefsadUrimUqma9wSoy4qiS,24496745,99012294,-74515549,575
2021-12-04 00:25:08-05:00,351,9kK2PuehQxgcXtnYnPNmukmzfDTsVHv15pE86xwi7vYt,DtbCSCur1w6ZMGu56auQaHf8c6gVDJoD1iEwiUyCBcYJ,True,22392290,5598072,31251,15625,15626,72FwbpFGoLEazJEdpqNtPNefsadUrimUqma9wSoy4qiS,1250078,7331841,-6081763,558
2021-12-04 00:25:08-05:00,352,GSaQj6w7ssfDpMGzMQd4pyhZvLeGvYc1Vc9Qcsx1t69g,HSNX4PwuAAuUncgs11suc9rFJ6ntB8BRN7ViFYT9RATM,True,2362672279,590668069,3462715,1731357,1731358,72FwbpFGoLEazJEdpqNtPNefsadUrimUqma9wSoy4qiS,138508615,603722507,-465213892,586
2021-12-04 00:25:14-05:00,353,FP6SmbXDbcb6c8Pi8uZMn6hnQDUbvbdCfzd5pEqyBgTm,53A9dhER1x3JjdceGMQmjujvWht7uemsoB3ngQLdo6Ub,True,1865197022,466299255,2825427,1412713,1412714,72FwbpFGoLEazJEdpqNtPNefsadUrimUqma9wSoy4qiS,113017102,515616752,-402599650,605
2021-12-04 00:25:31-05:00,354,CUhCSd7jHvycC89L6EqMoDWcWVTXXHhAeXVyB4362qZg,J7B9JBV1xR8a7DKKrw3JwGusY4H2bSQuyHtod2Fzf4jq,True,158159558,39539889,241437,120718,120719,72FwbpFGoLEazJEdpqNtPNefsadUrimUqma9wSoy4qiS,9657518,50153636,-40496118,610
2021-12-04 00:25:31-05:00,355,2JH43pKUeXTXPd6LnL4BWgGQpwZHhX8EqyohKCFLAS4i,Bir3EKnDWkv6XX7KmoqAi1y6rxSaC5RfVV6Hwvnkfr2i,True,59518751,14879687,87079,43539,43540,72FwbpFGoLEazJEdpqNtPNefsadUrimUqma9wSoy4qiS,3483163,15207491,-11724328,585
2021-12-04 00:25:32-05:00,356,94KFzzXCAvEfSf3jrnUpyN3pne8Xfc6nroB7UxTVqeyB,ERQEKcL8qV9WEzLwi5WFjh2wN97q9GD9pqd9umcTypxy,True,8468522,2117130,13057,6528,6529,72FwbpFGoLEazJEdpqNtPNefsadUrimUqma9wSoy4qiS,522309,2569533,-2047224,616
2021-12-04 00:26:05-05:00,357,EvSdLa5PeJiaaaE3omJNG7cw1tptZnHTituYswVHSwm3,68ESX2mBsfxQo2U9jsbmHo7TzPTxr9mGH5Y11ZLR7E3A,True,77470436,19367609,114019,57009,57010,72FwbpFGoLEazJEdpqNtPNefsadUrimUqma9wSoy4qiS,4560779,27220210,-22659431,588
2021-12-04 00:26:05-05:00,358,C66xkhG3GSswFRqZ8BHATwPbPhyGsWxJ1ymMaDerKbLX,HkJXe2vivbt9aVuJkmA11w9uz8Kbg4fB9sdL2fUmJcQR,True,88654182,22163545,138707,69353,69354,72FwbpFGoLEazJEdpqNtPNefsadUrimUqma9wSoy4qiS,5548319,29211132,-23662813,625
2021-12-04 00:26:13-05:00,359,DE8KcmECtrF8XoCzuiTJLDFgm4cTSjQFJYSP81WHfr8L,J9GYsnRjDbkwrcqa1XfBmVNXqa9pgzzRymdntFZu1PCv,True,114468225,28617056,168857,84428,84429,72FwbpFGoLEazJEdpqNtPNefsadUrimUqma9wSoy4qiS,6754305,37903690,-31149385,590
2021-12-04 00:26:13-05:00,360,DSnvQca2ReL3mzwucUGzXTqhxqX5BABy4XvoWDLUfKCU,GfRyJVAx5ckPZn4iJ9ZW9yrLVsw3a2nzwg8QVWaQ6qkF,True,843619488,210904872,1282472,641236,641236,72FwbpFGoLEazJEdpqNtPNefsadUrimUqma9wSoy4qiS,51298910,256699984,-205401074,608
2021-12-04 00:26:14-05:00,361,8w1hzDtCFuTJqWAtwihztrPzxwa7YrJH5uPk877SJnNj,D3gnctosqTZxTQNfLJQRdPgCvGx2JLLHHDmcvW5UX1QN,True,1292771437,323192859,1899887,949943,949944,72FwbpFGoLEazJEdpqNtPNefsadUrimUqma9wSoy4qiS,75995491,335849413,-259853922,587
2021-12-04 00:27:32-05:00,362,E5KDZriZ89a5D4VsMaWxndMMG68RT4weruJ1tCEc6tSx,CaSwkUocpbyyGCQBgKjJZJgcexbyqs2GTrGJH6EMWXAz,True,5534004227,1383501056,8266359,4133179,4133180,72FwbpFGoLEazJEdpqNtPNefsadUrimUqma9wSoy4qiS,330654386,1781685620,-1451031234,597
2021-12-04 00:27:32-05:00,363,FEWgesdpjtMv15TjLLY1LHjzXjZDaLENFTdjuhbwdBg9,4J2YMa9XUzLMfjYDwHeD4GRmXHFBGywYsmcVFvCDYW6T,True,521668962,130417240,767153,383576,383577,72FwbpFGoLEazJEdpqNtPNefsadUrimUqma9wSoy4qiS,30686136,160255572,-129569436,588
2021-12-04 00:27:33-05:00,364,A4Ce8RnM3qZW9Njo363ywPyhpcUqQTH2PVJn2ugYMmqx,DWSTAcKdqtc8qixLxWGx4shHe1PT2h4hDSMDVQqn1N8L,True,5195795,1298948,7928,3964,3964,72FwbpFGoLEazJEdpqNtPNefsadUrimUqma9wSoy4qiS,317137,1766016,-1448879,610
2021-12-04 00:27:37-05:00,365,7ckvB1uchDPcA5vkjJvu4DHCkgGq81qbJrd4P2CwPDV8,pVjScFyTQfYJ74uA9JLEsChSrtY8fRi2dCM3jtWC6bp,True,57290377,14322594,88236,44118,44118,72FwbpFGoLEazJEdpqNtPNefsadUrimUqma9wSoy4qiS,3529450,16815958,-13286508,616
2021-12-04 00:27:52-05:00,366,FV9CBGGTbppLnBKh79f2LzD1diTiS5g6u89FcpZHZmnK,Fe7mtmCUziFqbbYTvrhAcAq1Ub7YLfTJRtQ1hG7GzJD1,True,39537082,9884270,61733,30866,30867,72FwbpFGoLEazJEdpqNtPNefsadUrimUqma9wSoy4qiS,2469348,10019999,-7550651,624
2021-12-04 00:27:52-05:00,367,5Rxuqgs4CaSKbfDXqBMFXkLTQ9dxrUjThXzoy3ouYVtK,BgvbKru66ebrGUcFFymGTmsaQv6GgcGMybiWaXqzBtwX,True,34581600,8645400,53565,26782,26783,72FwbpFGoLEazJEdpqNtPNefsadUrimUqma9wSoy4qiS,2142600,8807609,-6665009,619
2021-12-04 00:27:53-05:00,368,3LfgumhfN7fRDEPhEN8SfVWXVnmSj6wuWQ1qYxKv6Eup,BYDZyXhUyMKvQnsnVLT8RqNYqUtf5SAFZGZx99E5dUmW,True,2299494,574873,3535,1767,1768,72FwbpFGoLEazJEdpqNtPNefsadUrimUqma9wSoy4qiS,141404,654475,-513071,614
2021-12-04 00:27:55-05:00,369,2g4SyyPcuijqJtfVrxeNs6z5iEAuyizoG1PyTXvxN7SH,4fez27oGJ3gKdY4JKpPVT2bzMNhDWAAQ64J5kxNUAf1e,True,563678896,140919724,864212,432106,432106,72FwbpFGoLEazJEdpqNtPNefsadUrimUqma9wSoy4qiS,34568496,130822940,-96254444,613
2021-12-04 00:28:02-05:00,370,9hzdQrYGDWaS9vDhDZGjh79WxE1urqR4ubNacHddr4Us,971fdspGqjQBdVuG7D5JGvxsRYDJPtAMHaJrQQzDuBUg,True,69953389,17488347,107913,53956,53957,72FwbpFGoLEazJEdpqNtPNefsadUrimUqma9wSoy4qiS,4316542,22844541,-18527999,617
2021-12-04 00:28:02-05:00,371,HnUkyFhntoajDEgXMKeoh4nAuY5y7osLYwmYAApyLSNs,GntEkHxrGpcHFCVLQGjKiXWdenbsqfQgxddpEpxpE65z,True,47429385,11857346,72914,36457,36457,72FwbpFGoLEazJEdpqNtPNefsadUrimUqma9wSoy4qiS,2916583,14544534,-11627951,614
2021-12-04 00:28:20-05:00,372,8GuH7tofwd6okCa9CPV4kbZ1RdpjPAS14kzKgJrUhbP5,DW3PVKVSBEswSoyfFsne169qSSt9Z3JFXcaLqFVSiYfY,True,196838979,49209744,307544,153772,153772,72FwbpFGoLEazJEdpqNtPNefsadUrimUqma9wSoy4qiS,12301787,69383830,-57082043,624
2021-12-04 00:28:20-05:00,373,6HzCJnV3Z4psm7V64UpJBstZxK2XAxUySyuoX8RJaFwY,2AsimTXANwSRChLJWdLjdJG8X2gwGsrjPguqFZjuAeA9,True,21946002,5486500,34079,17039,17040,72FwbpFGoLEazJEdpqNtPNefsadUrimUqma9wSoy4qiS,1363168,6396761,-5033593,621
2021-12-04 00:28:20-05:00,374,Gq7fPzML38eX6tSedGqCMhmbw7WsaSEYoEZM3BucjZh8,AvEB59ycFk7Y74Wt79cUV9B49GJqwc5c26GCGc29i5zC,True,62500444,15625111,97248,48624,48624,72FwbpFGoLEazJEdpqNtPNefsadUrimUqma9wSoy4qiS,3889927,20485175,-16595248,622
2021-12-04 00:28:21-05:00,375,EBUcTqh9AYyRokZRzLbPKL9ZmTUx6KcDEbBeuCLGwqYC,B5WSXfHzYQhUFE2T97GaiqSkeejTWKKGVjMkcFrxEvyJ,True,74897454,18724363,116443,58221,58222,72FwbpFGoLEazJEdpqNtPNefsadUrimUqma9wSoy4qiS,4657725,22565277,-17907552,621
2021-12-04 00:28:26-05:00,376,3VdSA9CED9f5swRwHX2U15U7J6Muaq8VPnCNy9CaGDHe,2YYstfnfdYic5NWmEbcUEHpccNUVd1EhuCkExvMsoMk8,True,1118897280,279724320,1718955,859477,859478,72FwbpFGoLEazJEdpqNtPNefsadUrimUqma9wSoy4qiS,68758221,259728631,-190970410,614
2021-12-04 00:29:38-05:00,377,GbPWktFegZQEz5CDL2kphHexVrQgy3hTmXa8mCEZtdps,BVQzSYxgF1v6ftSLe5mftqgvretxPcNCrtN8RrHKDn5x,True,654963840,163740960,934452,467226,467226,72FwbpFGoLEazJEdpqNtPNefsadUrimUqma9wSoy4qiS,37378089,167695991,-130317902,570
2021-12-04 00:31:27-05:00,378,3VdSA9CED9f5swRwHX2U15U7J6Muaq8VPnCNy9CaGDHe,2YYstfnfdYic5NWmEbcUEHpccNUVd1EhuCkExvMsoMk8,True,823154400,205788600,1275517,637758,637759,72FwbpFGoLEazJEdpqNtPNefsadUrimUqma9wSoy4qiS,51020706,210327828,-159307122,619
2021-12-04 00:31:30-05:00,379,5Rxuqgs4CaSKbfDXqBMFXkLTQ9dxrUjThXzoy3ouYVtK,BgvbKru66ebrGUcFFymGTmsaQv6GgcGMybiWaXqzBtwX,True,25436160,6359040,39724,19862,19862,72FwbpFGoLEazJEdpqNtPNefsadUrimUqma9wSoy4qiS,1588995,7088344,-5499349,624
2021-12-04 00:32:39-05:00,380,FFsQo78UMHAfXc8F38txcR3sjWCqEjLT9AGoCvtuWbh6,Bn1dsirxXSzuWVCz8rSnGXDz7UTUV2yLqfa8QNa7QgcR,True,6213945,1553486,9108,4554,4554,72FwbpFGoLEazJEdpqNtPNefsadUrimUqma9wSoy4qiS,364324,1650418,-1286094,586
2021-12-04 00:32:39-05:00,381,9kK2PuehQxgcXtnYnPNmukmzfDTsVHv15pE86xwi7vYt,DtbCSCur1w6ZMGu56auQaHf8c6gVDJoD1iEwiUyCBcYJ,True,16557109,4139277,24542,12271,12271,72FwbpFGoLEazJEdpqNtPNefsadUrimUqma9wSoy4qiS,981718,5780237,-4798519,592
2021-12-04 00:32:39-05:00,382,2qsrQ75TWz5g3KVoWbKKa9DsLQ5uCAndmfjqPsWzwExJ,Bj7LHrHSg9M3H9ZxFCxqdw8u79iw8K2awJHzk7QNdayy,True,2462323,615580,3647,1823,1824,72FwbpFGoLEazJEdpqNtPNefsadUrimUqma9wSoy4qiS,145890,683588,-537698,592
2021-12-04 00:32:39-05:00,383,3TTUCUbDMr98vbwUidKDsmkVdLavhTsypKwMvn7s3De6,53PNcr23uUHeNEQWzez9BZdSDMvqMw3DR5NcMAQvDhrq,True,15997440173,3999360043,24452792,12226396,12226396,9S3tZN1dKmwsMw7We6YNFamHgC8GttWEJU54tAHEaJPC,978111692,4091214377,-3113102685,611
2021-12-04 00:32:42-05:00,384,J2gTwrYpzezkRupgBtgudQn5D33x6WjeBhTHnrA1qgqa,FBzoHRwqGRjnMvPEpiZVjtGZYJmAbneE4dpToXPzy8bv,True,5275523604,1318880901,7601074,3800537,3800537,72FwbpFGoLEazJEdpqNtPNefsadUrimUqma9wSoy4qiS,304042995,1793453140,-1489410145,576
2021-12-04 00:32:43-05:00,385,BHQFfHCfTAp6xYFNdHRv65BtaobfhBaLFp2KTMxL6ZhN,Eg8q7M4e3qQvUUGqy8QZVxgE6hR1rtdsYPUXqksJhkv3,True,313331808,78332952,453079,226539,226540,72FwbpFGoLEazJEdpqNtPNefsadUrimUqma9wSoy4qiS,18123191,79778316,-61655125,578
2021-12-04 00:32:43-05:00,386,2bjiHeP82LQ56fEsqR7xEZ9xyyE8LLeeNc7LBvSQm54r,6wdVmvunXFaPuCAXiDdYNmoumYkXz8M5C5vRnBZ9HSXT,True,398663199,99665799,590811,295405,295406,72FwbpFGoLEazJEdpqNtPNefsadUrimUqma9wSoy4qiS,23632449,92724642,-69092193,592
2021-12-04 00:32:48-05:00,387,E3uCNxXMRHD2ayCY48Kafwy55443r3p1EijT92ug26yd,AMqLEmYQZRhhE7dRQQ21QYfBbthnAVQvmPh9PNbyavta,True,5094495,1273623,7222,3611,3611,72FwbpFGoLEazJEdpqNtPNefsadUrimUqma9wSoy4qiS,288911,1530170,-1241259,567
2021-12-04 00:32:57-05:00,388,GSaQj6w7ssfDpMGzMQd4pyhZvLeGvYc1Vc9Qcsx1t69g,HSNX4PwuAAuUncgs11suc9rFJ6ntB8BRN7ViFYT9RATM,True,1743860960,435965240,2672566,1336283,1336283,72FwbpFGoLEazJEdpqNtPNefsadUrimUqma9wSoy4qiS,106902650,484185342,-377282692,613
2021-12-04 00:33:22-05:00,389,2JH43pKUeXTXPd6LnL4BWgGQpwZHhX8EqyohKCFLAS4i,Bir3EKnDWkv6XX7KmoqAi1y6rxSaC5RfVV6Hwvnkfr2i,True,43993829,10998457,68771,34385,34386,72FwbpFGoLEazJEdpqNtPNefsadUrimUqma9wSoy4qiS,2750849,12189479,-9438630,625
2021-12-04 00:33:40-05:00,390,6woJkgUd2cpQQQBEp1C2G9NsYAvPwYmZXXTd6AxhieMy,E6xCdLJbDq5qFsvHEffD1Qfqrsj19H81mbj7XMUXUPnr,True,4045454490,1011363622,6158249,3079124,3079125,72FwbpFGoLEazJEdpqNtPNefsadUrimUqma9wSoy4qiS,246329978,821794527,-575464549,608
2021-12-04 00:33:51-05:00,391,DVV4Vhk44E5YvVzpXgjJMepYgUB5uKXmAhEbFg6R5vWJ,8CS7rCKNx7AQ5yaEA2rHrYx4PHnC9mK3DtSQmiKW2nUb,True,280391414,70097853,432245,216122,216123,72FwbpFGoLEazJEdpqNtPNefsadUrimUqma9wSoy4qiS,17289820,93308498,-76018678,616
2021-12-04 00:34:25-05:00,392,CUhCSd7jHvycC89L6EqMoDWcWVTXXHhAeXVyB4362qZg,J7B9JBV1xR8a7DKKrw3JwGusY4H2bSQuyHtod2Fzf4jq,True,116386615,29096653,179575,89787,89788,72FwbpFGoLEazJEdpqNtPNefsadUrimUqma9wSoy4qiS,7183027,39789258,-32606231,617
2021-12-04 00:34:30-05:00,393,DSEgVqfxXp5wxjn3gNZtmb4E6rJeBm3VcbqdwDnsuzSq,6YVCWznUKheSMPuywSRJgCes7wghPGJXgxfrVfnjN4mB,True,1425193220,356298305,2217512,1108756,1108756,72FwbpFGoLEazJEdpqNtPNefsadUrimUqma9wSoy4qiS,88700491,330155148,-241454657,622
2021-12-04 00:34:32-05:00,394,94KFzzXCAvEfSf3jrnUpyN3pne8Xfc6nroB7UxTVqeyB,ERQEKcL8qV9WEzLwi5WFjh2wN97q9GD9pqd9umcTypxy,True,6231024,1557756,9722,4861,4861,72FwbpFGoLEazJEdpqNtPNefsadUrimUqma9wSoy4qiS,388884,2044718,-1655834,624
2021-12-04 00:34:34-05:00,395,6Rk6wVu6pCDFwEWDbiY8wS93nDghyHP9kzdUEa6eFRRq,B5v7eFjSX6dDt1kt84Uvtqmrn7STbQPMbFMvjH6WGXJg,True,1453921737,363480433,2223923,1111961,1111962,72FwbpFGoLEazJEdpqNtPNefsadUrimUqma9wSoy4qiS,88956928,491712636,-402755708,611
2021-12-04 00:34:42-05:00,396,FP6SmbXDbcb6c8Pi8uZMn6hnQDUbvbdCfzd5pEqyBgTm,53A9dhER1x3JjdceGMQmjujvWht7uemsoB3ngQLdo6Ub,True,1372210563,343052640,2087611,1043805,1043806,72FwbpFGoLEazJEdpqNtPNefsadUrimUqma9wSoy4qiS,83504471,412286571,-328782100,608
2021-12-04 00:34:42-05:00,397,EvSdLa5PeJiaaaE3omJNG7cw1tptZnHTituYswVHSwm3,68ESX2mBsfxQo2U9jsbmHo7TzPTxr9mGH5Y11ZLR7E3A,True,57222766,14305691,89167,44583,44584,72FwbpFGoLEazJEdpqNtPNefsadUrimUqma9wSoy4qiS,3566699,21441644,-17874945,623
2021-12-04 00:34:42-05:00,398,8w1hzDtCFuTJqWAtwihztrPzxwa7YrJH5uPk877SJnNj,D3gnctosqTZxTQNfLJQRdPgCvGx2JLLHHDmcvW5UX1QN,True,955092218,238773054,1490231,745115,745116,72FwbpFGoLEazJEdpqNtPNefsadUrimUqma9wSoy4qiS,59609244,269055095,-209445851,624
2021-12-04 00:34:52-05:00,399,DE8KcmECtrF8XoCzuiTJLDFgm4cTSjQFJYSP81WHfr8L,J9GYsnRjDbkwrcqa1XfBmVNXqa9pgzzRymdntFZu1PCv,True,84488936,21122234,130580,65290,65290,72FwbpFGoLEazJEdpqNtPNefsadUrimUqma9wSoy4qiS,5223215,29948127,-24724912,618
2021-12-04 00:45:24-05:00,400,BgoKAyBNaJ1geeQ2FcGSHEQDWATVD3w3wmcNHtj8Awu3,8Haz7duE2ycueaJsGdrGNnK79KGHwnzKBpoafC8RZGg2,True,4302729200,1075682300,6631022,3315511,3315511,4BnQKPLuE3DMTtxp8MjUBytgnhvxqq3ZTqZHTVZo4JJh,265240897,962006697,-696765800,616
2021-12-04 00:46:12-05:00,401,C8P84Hs3ARCuQNvkRo8F9UcGMeYeZbNW4UUy4cfW3mV7,8XT1CpJzma29EiwATKe8qe9MAuZwcUoV9skvCjjfyeBJ,True,200083180,50020795,306467,153233,153234,72FwbpFGoLEazJEdpqNtPNefsadUrimUqma9wSoy4qiS,12258687,46175507,-33916820,612
2021-12-04 00:46:12-05:00,402,Cea5Ry4zLro67jEoS3ba213KYNbvq6VXyZ6JgnjTHd89,DCSyLohbXL5yhmu9ESBHR4ku4MgfnSoNeUsL7oDcEG8Z,True,4535655900,1133913975,6846209,3423104,3423105,72FwbpFGoLEazJEdpqNtPNefsadUrimUqma9wSoy4qiS,273848367,1031273018,-757424651,603
2021-12-04 00:46:18-05:00,403,E4iZW2i7YcrVadVRGaRNGathDN3pQY1W2tjBExek1rMh,3amQVHc5eUWMTpvK9cgAr8Rxit75o4JfqdcnMgqbUBmv,True,1590686940,397671735,2247280,1123640,1123640,72FwbpFGoLEazJEdpqNtPNefsadUrimUqma9wSoy4qiS,89891233,359005400,-269114167,565
2021-12-04 00:46:20-05:00,404,DH2tcZVt4nHQbph6znZRrwcyhjwiNYtgeamu72vcC6nR,ACsbP5BDFQEHQHTsdrWTBShhEUh9HeAKsE7iwyK72v2p,True,143576360,35894090,212719,106359,106360,72FwbpFGoLEazJEdpqNtPNefsadUrimUqma9wSoy4qiS,8508772,33033271,-24524499,592
2021-12-04 00:46:22-05:00,405,6woJkgUd2cpQQQBEp1C2G9NsYAvPwYmZXXTd6AxhieMy,E6xCdLJbDq5qFsvHEffD1Qfqrsj19H81mbj7XMUXUPnr,True,2970285840,742571460,4409167,2204583,2204584,72FwbpFGoLEazJEdpqNtPNefsadUrimUqma9wSoy4qiS,176366701,671986711,-495620010,593
2021-12-04 00:47:44-05:00,406,GKNBtZbwK4w9hyXD1r38NTGcTJhpjt8R9WFCzdXup9Tk,7RLaL2XoFuqrcCcPEB6FzPJzLnAhjQpwcRmDfdpRXFgB,True,3858216000,964554000,5980967,2990483,2990484,72FwbpFGoLEazJEdpqNtPNefsadUrimUqma9wSoy4qiS,239238681,880568181,-641329500,620
2021-12-04 00:48:12-05:00,407,4gzW9gBbEMnNm1epY6MMJ1XfxGMtvn2mKFyKPQ2Gyb79,G6x862hmMJ2PLpyyPDwVPGapXjvEeNkqFRTAS3jWVozB,True,387942000,96985500,605741,302870,302871,72FwbpFGoLEazJEdpqNtPNefsadUrimUqma9wSoy4qiS,24229654,92200195,-67970541,624
2021-12-04 00:48:26-05:00,408,BgoKAyBNaJ1geeQ2FcGSHEQDWATVD3w3wmcNHtj8Awu3,8Haz7duE2ycueaJsGdrGNnK79KGHwnzKBpoafC8RZGg2,True,3165552000,791388000,4927874,2463937,2463937,72FwbpFGoLEazJEdpqNtPNefsadUrimUqma9wSoy4qiS,197114975,781438076,-584323101,622
2021-12-04 00:48:37-05:00,409,J1sBDjpdBZcsSBS5eg95SSRjRqmQUR9cXJCsLJu8yCUt,F5wRpD2senMkGbL8Uquqo8W9x5NQDDa268dHuVFAZCww,True,405726000,101431500,608293,304146,304147,72FwbpFGoLEazJEdpqNtPNefsadUrimUqma9wSoy4qiS,24331724,98142309,-73810585,599
2021-12-04 00:48:43-05:00,410,E4iZW2i7YcrVadVRGaRNGathDN3pQY1W2tjBExek1rMh,3amQVHc5eUWMTpvK9cgAr8Rxit75o4JfqdcnMgqbUBmv,True,1177962000,294490500,1814768,907384,907384,72FwbpFGoLEazJEdpqNtPNefsadUrimUqma9wSoy4qiS,72590748,289526497,-216935749,616
2021-12-04 00:49:12-05:00,411,3qyKG4juvhcDnhoSVAFibqJtk5i4q8vLVgvwzXtdk5KP,2ofR6Hdm8qgQfKnaNFouzzBs311xgPcxny4ViS7g2Wxo,True,88934700,22233675,137677,68838,68839,72FwbpFGoLEazJEdpqNtPNefsadUrimUqma9wSoy4qiS,5507105,21572405,-16065300,619
2021-12-04 01:14:45-05:00,412,6woJkgUd2cpQQQBEp1C2G9NsYAvPwYmZXXTd6AxhieMy,E6xCdLJbDq5qFsvHEffD1Qfqrsj19H81mbj7XMUXUPnr,True,2195092200,548773050,3388023,1694011,1694012,4BnQKPLuE3DMTtxp8MjUBytgnhvxqq3ZTqZHTVZo4JJh,135520922,539976407,-404455485,617
2021-12-04 01:14:46-05:00,413,DH2tcZVt4nHQbph6znZRrwcyhjwiNYtgeamu72vcC6nR,ACsbP5BDFQEHQHTsdrWTBShhEUh9HeAKsE7iwyK72v2p,True,106082100,26520525,162787,81393,81394,72FwbpFGoLEazJEdpqNtPNefsadUrimUqma9wSoy4qiS,6511503,26512242,-20000739,613
2021-12-04 01:16:38-05:00,414,Cea5Ry4zLro67jEoS3ba213KYNbvq6VXyZ6JgnjTHd89,DCSyLohbXL5yhmu9ESBHR4ku4MgfnSoNeUsL7oDcEG8Z,True,3350170500,837542625,5240161,2620080,2620081,4BnQKPLuE3DMTtxp8MjUBytgnhvxqq3ZTqZHTVZo4JJh,209606446,829524480,-619918034,625
2021-12-04 01:18:12-05:00,415,C8P84Hs3ARCuQNvkRo8F9UcGMeYeZbNW4UUy4cfW3mV7,8XT1CpJzma29EiwATKe8qe9MAuZwcUoV9skvCjjfyeBJ,True,147525750,36881437,228966,114483,114483,72FwbpFGoLEazJEdpqNtPNefsadUrimUqma9wSoy4qiS,9158669,37146132,-27987463,620
2021-12-04 02:10:48-05:00,416,GKNBtZbwK4w9hyXD1r38NTGcTJhpjt8R9WFCzdXup9Tk,7RLaL2XoFuqrcCcPEB6FzPJzLnAhjQpwcRmDfdpRXFgB,True,2846706900,711676725,4453134,2226567,2226567,72FwbpFGoLEazJEdpqNtPNefsadUrimUqma9wSoy4qiS,178125376,706284982,-528159606,625
2021-12-04 02:11:04-05:00,417,UJ6ntLsLvDndrqeHcW18GApMs1smigx1yM1RRPrw5cP,HY1KY2jXT1fU6HrS2DySXFsLgykZzhR6AxdLYScU7giX,True,4150050,1037512,5201,2600,2601,72FwbpFGoLEazJEdpqNtPNefsadUrimUqma9wSoy4qiS,208047,1057997,-849950,501
2021-12-04 02:11:46-05:00,418,4gzW9gBbEMnNm1epY6MMJ1XfxGMtvn2mKFyKPQ2Gyb79,G6x862hmMJ2PLpyyPDwVPGapXjvEeNkqFRTAS3jWVozB,True,285841800,71460450,442154,221077,221077,72FwbpFGoLEazJEdpqNtPNefsadUrimUqma9wSoy4qiS,17686186,73785914,-56099728,618
2021-12-04 02:15:31-05:00,419,J1sBDjpdBZcsSBS5eg95SSRjRqmQUR9cXJCsLJu8yCUt,F5wRpD2senMkGbL8Uquqo8W9x5NQDDa268dHuVFAZCww,True,299997450,74999362,463988,231994,231994,72FwbpFGoLEazJEdpqNtPNefsadUrimUqma9wSoy4qiS,18559528,78228718,-59669190,618
2021-12-04 02:16:02-05:00,420,E4iZW2i7YcrVadVRGaRNGathDN3pQY1W2tjBExek1rMh,3amQVHc5eUWMTpvK9cgAr8Rxit75o4JfqdcnMgqbUBmv,True,869520750,217380187,1357693,678846,678847,4BnQKPLuE3DMTtxp8MjUBytgnhvxqq3ZTqZHTVZo4JJh,54307733,230995655,-176687922,624
2021-12-04 02:16:03-05:00,421,BgoKAyBNaJ1geeQ2FcGSHEQDWATVD3w3wmcNHtj8Awu3,8Haz7duE2ycueaJsGdrGNnK79KGHwnzKBpoafC8RZGg2,True,2333351400,583337850,3615453,1807726,1807727,72FwbpFGoLEazJEdpqNtPNefsadUrimUqma9wSoy4qiS,144618121,623822629,-479204508,619
2021-12-04 06:24:28-05:00,422,3qyKG4juvhcDnhoSVAFibqJtk5i4q8vLVgvwzXtdk5KP,2ofR6Hdm8qgQfKnaNFouzzBs311xgPcxny4ViS7g2Wxo,True,65718600,16429650,100751,50375,50376,4BnQKPLuE3DMTtxp8MjUBytgnhvxqq3ZTqZHTVZo4JJh,4030040,17074195,-13044155,613
2021-12-04 06:24:33-05:00,423,BCGo6RhFcVnLCzZxtEh5YDyfq59nEWXPyJ5STC9PkzA1,24ShUfs1AB1n5NUus99sZ58kuSvMPhVgpiiT56rcLHRk,True,373618200,93404550,577849,288924,288925,4BnQKPLuE3DMTtxp8MjUBytgnhvxqq3ZTqZHTVZo4JJh,23113979,84566485,-61452506,618
2021-12-04 06:32:23-05:00,424,C8P84Hs3ARCuQNvkRo8F9UcGMeYeZbNW4UUy4cfW3mV7,8XT1CpJzma29EiwATKe8qe9MAuZwcUoV9skvCjjfyeBJ,True,108924600,27231150,170233,85116,85117,72FwbpFGoLEazJEdpqNtPNefsadUrimUqma9wSoy4qiS,6809328,29533164,-22723836,625
2021-12-04 06:32:23-05:00,425,6woJkgUd2cpQQQBEp1C2G9NsYAvPwYmZXXTd6AxhieMy,E6xCdLJbDq5qFsvHEffD1Qfqrsj19H81mbj7XMUXUPnr,True,1616984550,404246137,2421251,1210625,1210626,72FwbpFGoLEazJEdpqNtPNefsadUrimUqma9wSoy4qiS,96850061,429599589,-332749528,598
2021-12-04 06:32:28-05:00,426,DH2tcZVt4nHQbph6znZRrwcyhjwiNYtgeamu72vcC6nR,ACsbP5BDFQEHQHTsdrWTBShhEUh9HeAKsE7iwyK72v2p,True,78168750,19542187,116708,58354,58354,72FwbpFGoLEazJEdpqNtPNefsadUrimUqma9wSoy4qiS,4668351,21071089,-16402738,597
2021-12-04 06:43:10-05:00,427,UJ6ntLsLvDndrqeHcW18GApMs1smigx1yM1RRPrw5cP,HY1KY2jXT1fU6HrS2DySXFsLgykZzhR6AxdLYScU7giX,False,3069900,3069900,152253,7612,144641,72FwbpFGoLEazJEdpqNtPNefsadUrimUqma9wSoy4qiS,152253,848659,-696406,495
2021-12-04 06:43:10-05:00,428,GKNBtZbwK4w9hyXD1r38NTGcTJhpjt8R9WFCzdXup9Tk,7RLaL2XoFuqrcCcPEB6FzPJzLnAhjQpwcRmDfdpRXFgB,True,2095888950,523972237,3229311,1614655,1614656,72FwbpFGoLEazJEdpqNtPNefsadUrimUqma9wSoy4qiS,129172452,564559481,-435387029,616
2021-12-04 06:43:32-05:00,429,4gzW9gBbEMnNm1epY6MMJ1XfxGMtvn2mKFyKPQ2Gyb79,G6x862hmMJ2PLpyyPDwVPGapXjvEeNkqFRTAS3jWVozB,True,210799800,52699950,328078,164039,164039,72FwbpFGoLEazJEdpqNtPNefsadUrimUqma9wSoy4qiS,13123158,58788656,-45665498,622
2021-12-05 10:43:22-05:00,430,C66xkhG3GSswFRqZ8BHATwPbPhyGsWxJ1ymMaDerKbLX,HkJXe2vivbt9aVuJkmA11w9uz8Kbg4fB9sdL2fUmJcQR,False,63443262,63443262,2071940,103597,1968343,72FwbpFGoLEazJEdpqNtPNefsadUrimUqma9wSoy4qiS,2071940,22866816,-20794876,326
2021-12-05 10:43:23-05:00,431,GSaQj6w7ssfDpMGzMQd4pyhZvLeGvYc1Vc9Qcsx1t69g,HSNX4PwuAAuUncgs11suc9rFJ6ntB8BRN7ViFYT9RATM,False,1261361076,1261361076,51923929,2596196,49327733,72FwbpFGoLEazJEdpqNtPNefsadUrimUqma9wSoy4qiS,51923929,381548439,-329624510,411
2021-12-05 10:43:23-05:00,432,FEWgesdpjtMv15TjLLY1LHjzXjZDaLENFTdjuhbwdBg9,4J2YMa9XUzLMfjYDwHeD4GRmXHFBGywYsmcVFvCDYW6T,False,374185478,374185478,11140169,557008,10583161,72FwbpFGoLEazJEdpqNtPNefsadUrimUqma9wSoy4qiS,11140169,125395244,-114255075,297
2021-12-05 10:43:23-05:00,433,CUhCSd7jHvycC89L6EqMoDWcWVTXXHhAeXVyB4362qZg,J7B9JBV1xR8a7DKKrw3JwGusY4H2bSQuyHtod2Fzf4jq,True,85262141,21315535,114720,57360,57360,72FwbpFGoLEazJEdpqNtPNefsadUrimUqma9wSoy4qiS,4588804,31071932,-26483128,538
2021-12-05 10:43:24-05:00,434,FFsQo78UMHAfXc8F38txcR3sjWCqEjLT9AGoCvtuWbh6,Bn1dsirxXSzuWVCz8rSnGXDz7UTUV2yLqfa8QNa7QgcR,False,4526230,4526230,200470,10023,190447,72FwbpFGoLEazJEdpqNtPNefsadUrimUqma9wSoy4qiS,200470,1299340,-1098870,442
2021-12-05 10:43:25-05:00,435,E5KDZriZ89a5D4VsMaWxndMMG68RT4weruJ1tCEc6tSx,CaSwkUocpbyyGCQBgKjJZJgcexbyqs2GTrGJH6EMWXAz,True,4075724256,1018931064,5692804,2846402,2846402,72FwbpFGoLEazJEdpqNtPNefsadUrimUqma9wSoy4qiS,227712160,1391695748,-1163983588,558
2021-12-05 10:43:25-05:00,436,3Ek5j2ea8wS2nCxsNgn2AbovxzJwGK7zc6xarkigSA3u,DEWmTn3Ah4F3nNXpoQLt1GG65Dsf4ZmGjn7FZUJyK6rP,True,1502976916,375744229,2032054,1016027,1016027,72FwbpFGoLEazJEdpqNtPNefsadUrimUqma9wSoy4qiS,81282194,602777249,-521495055,540
2021-12-05 10:43:25-05:00,437,8w1hzDtCFuTJqWAtwihztrPzxwa7YrJH5uPk877SJnNj,D3gnctosqTZxTQNfLJQRdPgCvGx2JLLHHDmcvW5UX1QN,True,700417992,175104498,976041,488020,488021,72FwbpFGoLEazJEdpqNtPNefsadUrimUqma9wSoy4qiS,39041647,212065769,-173024122,557
2021-12-05 10:43:25-05:00,438,3LfgumhfN7fRDEPhEN8SfVWXVnmSj6wuWQ1qYxKv6Eup,BYDZyXhUyMKvQnsnVLT8RqNYqUtf5SAFZGZx99E5dUmW,False,1666659,1666659,72350,3617,68733,72FwbpFGoLEazJEdpqNtPNefsadUrimUqma9wSoy4qiS,72350,515144,-442794,434
2021-12-05 10:43:25-05:00,439,J2gTwrYpzezkRupgBtgudQn5D33x6WjeBhTHnrA1qgqa,FBzoHRwqGRjnMvPEpiZVjtGZYJmAbneE4dpToXPzy8bv,False,3849153381,3849153381,171488072,8574403,162913669,72FwbpFGoLEazJEdpqNtPNefsadUrimUqma9wSoy4qiS,171488072,1397268112,-1225780040,445
2021-12-05 10:43:25-05:00,440,DSEgVqfxXp5wxjn3gNZtmb4E6rJeBm3VcbqdwDnsuzSq,6YVCWznUKheSMPuywSRJgCes7wghPGJXgxfrVfnjN4mB,True,1043489290,260872322,1408476,704238,704238,72FwbpFGoLEazJEdpqNtPNefsadUrimUqma9wSoy4qiS,56339044,262917964,-206578920,539
2021-12-05 10:43:25-05:00,441,3TTUCUbDMr98vbwUidKDsmkVdLavhTsypKwMvn7s3De6,53PNcr23uUHeNEQWzez9BZdSDMvqMw3DR5NcMAQvDhrq,False,11653750882,11653750882,556316388,27815819,528500569,72FwbpFGoLEazJEdpqNtPNefsadUrimUqma9wSoy4qiS,556316388,3246033028,-2689716640,477
2021-12-05 10:43:25-05:00,442,E3uCNxXMRHD2ayCY48Kafwy55443r3p1EijT92ug26yd,AMqLEmYQZRhhE7dRQQ21QYfBbthnAVQvmPh9PNbyavta,False,3697813,3697813,141776,7088,134688,72FwbpFGoLEazJEdpqNtPNefsadUrimUqma9wSoy4qiS,141776,1195785,-1054009,383
2021-12-05 10:43:25-05:00,443,8Xdf67Q5jXKwS52e492xUBu1tMUgS14jJg7V4R2Q28EP,GAPL3bsXP4xcukhgzyqrbDntGwUSm5BfuwJ8TLKkRaZc,True,496692928,124173232,650441,325220,325221,72FwbpFGoLEazJEdpqNtPNefsadUrimUqma9wSoy4qiS,26017666,135140538,-109122872,523
2021-12-05 10:43:25-05:00,444,8GuH7tofwd6okCa9CPV4kbZ1RdpjPAS14kzKgJrUhbP5,DW3PVKVSBEswSoyfFsne169qSSt9Z3JFXcaLqFVSiYfY,False,141949630,141949630,5667643,283382,5384261,72FwbpFGoLEazJEdpqNtPNefsadUrimUqma9wSoy4qiS,5667643,54160561,-48492918,399
2021-12-05 10:43:25-05:00,445,7ckvB1uchDPcA5vkjJvu4DHCkgGq81qbJrd4P2CwPDV8,pVjScFyTQfYJ74uA9JLEsChSrtY8fRi2dCM3jtWC6bp,False,41274160,41274160,1559461,77973,1481488,72FwbpFGoLEazJEdpqNtPNefsadUrimUqma9wSoy4qiS,1559461,13218140,-11658679,377
2021-12-05 10:43:25-05:00,446,8Xt3qHjZG3zLxozgM5vPHMVxp8eYFMg89kaVW7vdHKoA,2i8riSsQpfADD9LUVpiBJBfX5qjVAgmZegzfKx6RG9dW,False,20033606,20033606,991292,49564,941728,72FwbpFGoLEazJEdpqNtPNefsadUrimUqma9wSoy4qiS,991292,5893224,-4901932,494
2021-12-05 10:43:25-05:00,447,6oRHRnLX93bYeTN5YD2XHqskhbv8wN2pgSia9Kz3QkED,D6QG2KYp9vYZZe8tTZux5tDR6fXgm8k4SVWbpaPvEmZ1,True,103242602,25810650,149607,74803,74804,72FwbpFGoLEazJEdpqNtPNefsadUrimUqma9wSoy4qiS,5984309,26290444,-20306135,579
2021-12-05 10:43:26-05:00,448,Gq7fPzML38eX6tSedGqCMhmbw7WsaSEYoEZM3BucjZh8,AvEB59ycFk7Y74Wt79cUV9B49GJqwc5c26GCGc29i5zC,False,45463035,45463035,2174949,108747,2066202,72FwbpFGoLEazJEdpqNtPNefsadUrimUqma9wSoy4qiS,2174949,16033924,-13858975,478
2021-12-05 10:43:27-05:00,449,FP6SmbXDbcb6c8Pi8uZMn6hnQDUbvbdCfzd5pEqyBgTm,53A9dhER1x3JjdceGMQmjujvWht7uemsoB3ngQLdo6Ub,True,1009718842,252429710,1435365,717682,717683,72FwbpFGoLEazJEdpqNtPNefsadUrimUqma9wSoy4qiS,57414605,323521162,-266106557,568
2021-12-05 10:43:27-05:00,450,FV9CBGGTbppLnBKh79f2LzD1diTiS5g6u89FcpZHZmnK,Fe7mtmCUziFqbbYTvrhAcAq1Ub7YLfTJRtQ1hG7GzJD1,False,28737950,28737950,1362890,68144,1294746,72FwbpFGoLEazJEdpqNtPNefsadUrimUqma9wSoy4qiS,1362890,7940833,-6577943,474
2021-12-05 10:43:27-05:00,451,9hzdQrYGDWaS9vDhDZGjh79WxE1urqR4ubNacHddr4Us,971fdspGqjQBdVuG7D5JGvxsRYDJPtAMHaJrQQzDuBUg,False,50879913,50879913,2393577,119678,2273899,72FwbpFGoLEazJEdpqNtPNefsadUrimUqma9wSoy4qiS,2393577,17874960,-15481383,470
2021-12-05 10:43:27-05:00,452,FAGKyc6XrDNSchaaYGW6rv48p32ipYZNdGTYRYNekwh2,55oJXDZLx8Vv1HA1GYiS65Zmt4tHr9yuji63SEkiEumS,False,16941723,16941723,833720,41686,792034,72FwbpFGoLEazJEdpqNtPNefsadUrimUqma9wSoy4qiS,833720,3889977,-3056257,492
2021-12-05 10:43:27-05:00,453,BELLbzmdx1SYke9kZUxFi9VcdvwaHmkZyv24FArQ1J2f,5a5LfKakAaFEVkavVHgExKaUr25RWYpzFic6MUQQ62uc,True,1971941856,492985464,2865160,1432580,1432580,72FwbpFGoLEazJEdpqNtPNefsadUrimUqma9wSoy4qiS,114606411,784815160,-670208749,581
2021-12-05 10:43:28-05:00,454,DSnvQca2ReL3mzwucUGzXTqhxqX5BABy4XvoWDLUfKCU,GfRyJVAx5ckPZn4iJ9ZW9yrLVsw3a2nzwg8QVWaQ6qkF,False,611455931,611455931,25994802,1299740,24695062,72FwbpFGoLEazJEdpqNtPNefsadUrimUqma9wSoy4qiS,25994802,201334770,-175339968,425
2021-12-05 10:43:28-05:00,455,Hp4bpHhSds7eMRmW1wpCg8HPUKk5vdRJt9Wm1axJgbcG,5sPxP3PAUqWr5FuHY1kUTz5u1J4pvVB95L1rbxepS2S6,True,934396,233599,1234,617,617,72FwbpFGoLEazJEdpqNtPNefsadUrimUqma9wSoy4qiS,49390,218342,-168952,528
2021-12-05 10:43:28-05:00,456,2qsrQ75TWz5g3KVoWbKKa9DsLQ5uCAndmfjqPsWzwExJ,Bj7LHrHSg9M3H9ZxFCxqdw8u79iw8K2awJHzk7QNdayy,False,1799075,1799075,86445,4322,82123,72FwbpFGoLEazJEdpqNtPNefsadUrimUqma9wSoy4qiS,86445,537448,-451003,480
2021-12-05 10:43:29-05:00,457,81GV2H9ipJSZD6YpJGj2XQNfoUroWWnKfwMHGSwvhixd,7cLHoNuNVj8qkn3QmBYLFwja37f1MWEo4e3ZcNSpXTPw,True,3037237860,759309465,4150592,2075296,2075296,72FwbpFGoLEazJEdpqNtPNefsadUrimUqma9wSoy4qiS,166023687,745755836,-579732149,546
2021-12-05 10:43:30-05:00,458,2JH43pKUeXTXPd6LnL4BWgGQpwZHhX8EqyohKCFLAS4i,Bir3EKnDWkv6XX7KmoqAi1y6rxSaC5RfVV6Hwvnkfr2i,True,32217488,8054372,43965,21982,21983,72FwbpFGoLEazJEdpqNtPNefsadUrimUqma9wSoy4qiS,1758625,9615608,-7856983,545
2021-12-05 10:43:32-05:00,459,HnUkyFhntoajDEgXMKeoh4nAuY5y7osLYwmYAApyLSNs,GntEkHxrGpcHFCVLQGjKiXWdenbsqfQgxddpEpxpE65z,True,34826498,8706624,48555,24277,24278,72FwbpFGoLEazJEdpqNtPNefsadUrimUqma9wSoy4qiS,1942237,11408882,-9466645,557
2021-12-05 10:43:32-05:00,460,2bjiHeP82LQ56fEsqR7xEZ9xyyE8LLeeNc7LBvSQm54r,6wdVmvunXFaPuCAXiDdYNmoumYkXz8M5C5vRnBZ9HSXT,True,294648093,73662023,434334,217167,217167,72FwbpFGoLEazJEdpqNtPNefsadUrimUqma9wSoy4qiS,17373366,73548322,-56174956,589
2021-12-05 10:43:36-05:00,461,9kK2PuehQxgcXtnYnPNmukmzfDTsVHv15pE86xwi7vYt,DtbCSCur1w6ZMGu56auQaHf8c6gVDJoD1iEwiUyCBcYJ,True,12219208,3054802,17597,8798,8799,72FwbpFGoLEazJEdpqNtPNefsadUrimUqma9wSoy4qiS,703886,4501455,-3797569,576
2021-12-06 04:35:22-05:00,462,DVV4Vhk44E5YvVzpXgjJMepYgUB5uKXmAhEbFg6R5vWJ,8CS7rCKNx7AQ5yaEA2rHrYx4PHnC9mK3DtSQmiKW2nUb,True,207920723,51980180,325312,162656,162656,9S3tZN1dKmwsMw7We6YNFamHgC8GttWEJU54tAHEaJPC,13012510,72402841,-59390331,625
2021-12-06 04:36:19-05:00,463,CQSb6ZVY1KVNXFAg8pxm8RvBBGGqRSU7FMvwHJPy46u8,FRBv3b5VTfKN1bK4DXFY4329LFbvm882P47edrgpuSM,True,970907004,242726751,1484583,742291,742292,9S3tZN1dKmwsMw7We6YNFamHgC8GttWEJU54tAHEaJPC,59383344,319987081,-260603737,611
2021-12-06 04:36:21-05:00,464,DE8KcmECtrF8XoCzuiTJLDFgm4cTSjQFJYSP81WHfr8L,J9GYsnRjDbkwrcqa1XfBmVNXqa9pgzzRymdntFZu1PCv,True,62633795,15658448,97855,48927,48928,9S3tZN1dKmwsMw7We6YNFamHgC8GttWEJU54tAHEaJPC,3914217,23191163,-19276946,624
2021-12-06 04:36:21-05:00,465,94KFzzXCAvEfSf3jrnUpyN3pne8Xfc6nroB7UxTVqeyB,ERQEKcL8qV9WEzLwi5WFjh2wN97q9GD9pqd9umcTypxy,True,4614663,1153665,7193,3596,3597,9S3tZN1dKmwsMw7We6YNFamHgC8GttWEJU54tAHEaJPC,287733,1588246,-1300513,623
2021-12-06 04:36:22-05:00,466,EvSdLa5PeJiaaaE3omJNG7cw1tptZnHTituYswVHSwm3,68ESX2mBsfxQo2U9jsbmHo7TzPTxr9mGH5Y11ZLR7E3A,True,42388464,10597116,66185,33092,33093,9S3tZN1dKmwsMw7We6YNFamHgC8GttWEJU54tAHEaJPC,2647413,16582396,-13934983,624
2021-12-06 04:36:40-05:00,467,8soQsYfQCngqJ5gLpWSuuzDUo1YLg53mU6GBF5RBizNn,HdsRtpasJYyFdS3sKqFAwJespt8x7cKUfGuvEuxmWdxV,True,53877047,13469261,82957,41478,41479,9S3tZN1dKmwsMw7We6YNFamHgC8GttWEJU54tAHEaJPC,3318310,12036820,-8718510,615
2021-12-06 04:37:59-05:00,468,J5WcVsKNHbfioai1LRowvjvtEmUJBEkeoBim1ThshpoP,Ajh7SWBq3zJR4vb6AFoBS6C9D99wC6YF1sVN22qC1vCA,True,483843926,120960981,750546,375273,375273,9S3tZN1dKmwsMw7We6YNFamHgC8GttWEJU54tAHEaJPC,30021872,92070750,-62048878,620
2021-12-06 04:38:18-05:00,469,6Rk6wVu6pCDFwEWDbiY8wS93nDghyHP9kzdUEa6eFRRq,B5v7eFjSX6dDt1kt84Uvtqmrn7STbQPMbFMvjH6WGXJg,True,816638503,204159625,1268979,634489,634490,72FwbpFGoLEazJEdpqNtPNefsadUrimUqma9wSoy4qiS,50759195,328749045,-277989850,621
2021-12-06 04:38:45-05:00,470,HnUkyFhntoajDEgXMKeoh4nAuY5y7osLYwmYAApyLSNs,GntEkHxrGpcHFCVLQGjKiXWdenbsqfQgxddpEpxpE65z,True,25890310,6472577,39893,19946,19947,9S3tZN1dKmwsMw7We6YNFamHgC8GttWEJU54tAHEaJPC,1595750,8925407,-7329657,616
2021-12-06 04:44:02-05:00,471,2bjiHeP82LQ56fEsqR7xEZ9xyyE8LLeeNc7LBvSQm54r,6wdVmvunXFaPuCAXiDdYNmoumYkXz8M5C5vRnBZ9HSXT,True,217710126,54427531,327115,163557,163558,4BnQKPLuE3DMTtxp8MjUBytgnhvxqq3ZTqZHTVZo4JJh,13084633,58494961,-45410328,601
2021-12-06 04:44:04-05:00,472,A9BZ5kjh7iKu7SMzA5WUF31Zst9V7fehwDZaoKs4NpSi,3FzwTaT5LYucvoGGcRVXu5AUDnGHADv6yGqrBT6jEtvH,True,353707601,88426900,541434,270717,270717,72FwbpFGoLEazJEdpqNtPNefsadUrimUqma9wSoy4qiS,21657395,113081774,-91424379,612
2021-12-06 04:44:07-05:00,473,7gxTghaVZPNNwaNEdtQHh4QDCJ4JgigYMd4MMCC9VtFo,4ZZTUrm4jX1jqqTYVFJ9TJQ2BLx2eZgXesmoon1LBa1a,True,9319398,2329849,14564,7282,7282,72FwbpFGoLEazJEdpqNtPNefsadUrimUqma9wSoy4qiS,582575,2505716,-1923141,625
2021-12-06 04:44:07-05:00,474,BpvWyveup3q7q6Cws5TWkFYiZ8bQXRrfdxvzrN9FnYo6,2CWjropYSn9fJ66FT4zqUcwTrEaPp3CjGgoRATixyca1,True,102027934,25506983,154596,77298,77298,72FwbpFGoLEazJEdpqNtPNefsadUrimUqma9wSoy4qiS,6183871,27905680,-21721809,606
2021-12-06 04:44:07-05:00,475,CBEv8v9XZrgFT8UdEdd813XnRVv9R7GB5PLMyG8UWGC8,4uNcMEcQpJdThpisgNrttkQJTUFTsjEr25qgjkm4titC,True,248959296,62239824,360621,180310,180311,72FwbpFGoLEazJEdpqNtPNefsadUrimUqma9wSoy4qiS,14424869,115130626,-100705757,579
2021-12-06 04:44:07-05:00,476,6meAnGTy2XNUDk9qSJZGT6BBRinA5iGiDYEy2T88LXuX,BCzNQCn3J1381yNH5xp5ky9QmVKVdSofSUaLHtxKxPBW,True,663716,165929,1009,504,505,72FwbpFGoLEazJEdpqNtPNefsadUrimUqma9wSoy4qiS,40385,266526,-226141,608
2021-12-06 04:44:07-05:00,477,9kK2PuehQxgcXtnYnPNmukmzfDTsVHv15pE86xwi7vYt,DtbCSCur1w6ZMGu56auQaHf8c6gVDJoD1iEwiUyCBcYJ,True,9026258,2256564,13104,6552,6552,72FwbpFGoLEazJEdpqNtPNefsadUrimUqma9wSoy4qiS,524167,3510555,-2986388,580
2021-12-06 04:44:07-05:00,478,Hp4bpHhSds7eMRmW1wpCg8HPUKk5vdRJt9Wm1axJgbcG,5sPxP3PAUqWr5FuHY1kUTz5u1J4pvVB95L1rbxepS2S6,True,697171,174292,1066,533,533,72FwbpFGoLEazJEdpqNtPNefsadUrimUqma9wSoy4qiS,42679,173038,-130359,612
2021-12-06 04:44:07-05:00,479,FpqCxvTkSiwDwD5qEt6hXJxzFDLFLAQ8VevK8zwRqYun,A3p6YQisCJKpNkF7vkjZRbEfbnUt7vTZdR2zPBUSdTkk,True,63847996,15961999,96237,48118,48119,72FwbpFGoLEazJEdpqNtPNefsadUrimUqma9wSoy4qiS,3849505,25756543,-21907038,602
2021-12-06 04:44:07-05:00,480,3fB955q6xxxZcgnCyguLwkSa7egxgBoksPQVQ3U8HRHL,GK7cTdhfSpapJB8dFzEkV8c1UFkJPj281DwztnpKjxLx,True,84236270,21059067,125935,62967,62968,72FwbpFGoLEazJEdpqNtPNefsadUrimUqma9wSoy4qiS,5037403,38957825,-33920422,598
2021-12-06 04:44:07-05:00,481,66SjFhmiNYz8tLRnBhZUbowWGTbM16G52X3AT2hma2wN,3wVy8nk24HCFZWMiacGe8QsJquYaadZ9pQg44bGRwdE3,True,26096186,6524046,40785,20392,20393,72FwbpFGoLEazJEdpqNtPNefsadUrimUqma9wSoy4qiS,1631416,11636040,-10004624,625
2021-12-06 04:44:08-05:00,482,EDE1swNYZ99y9idZacAw5Ncwz2DyD78SqvKMUXA2Dbw4,HSmYYMpNQNr1F2zjvysGRrC57FyusAJNsaXWfbmCfZh4,True,18880934,4720233,28820,14410,14410,72FwbpFGoLEazJEdpqNtPNefsadUrimUqma9wSoy4qiS,1152829,8780953,-7628124,610
2021-12-06 06:13:20-05:00,483,57GUgfEp9ZQ5iAU2nx1Z2Tiz3gqq7yBNaqfE1cvxjFYt,98upivFa9Tdy3RZHGM1i2k5zeczaGqioq3rTzc3DMf4x,True,93796871,23449217,146329,73164,73165,4BnQKPLuE3DMTtxp8MjUBytgnhvxqq3ZTqZHTVZo4JJh,5853188,38079209,-32226021,624
2021-12-06 06:13:23-05:00,484,FZhvN1RjLoBK9EpCeyEobYsvdHirtbTXV82c9EV9nn2u,FSeHqYNof79JYrRb7ZkJWEb4TfS5wx7HTdvT1kLCexHM,True,36079535,9019883,55234,27617,27617,9S3tZN1dKmwsMw7We6YNFamHgC8GttWEJU54tAHEaJPC,2209373,12452272,-10242899,612
2021-12-06 06:13:28-05:00,485,EQYUWtYbtvN9C9ixiupXPjHyFWHsYa7dUh4DSd6rxbzt,iS616uGNCwCxP1taAvvdvA2KdqfXRSjcQWwZRUgBkLb,True,8461737,2115434,13124,6562,6562,72FwbpFGoLEazJEdpqNtPNefsadUrimUqma9wSoy4qiS,524980,3527379,-3002399,620
2021-12-06 06:13:28-05:00,486,81GV2H9ipJSZD6YpJGj2XQNfoUroWWnKfwMHGSwvhixd,7cLHoNuNVj8qkn3QmBYLFwja37f1MWEo4e3ZcNSpXTPw,True,2263837294,565959323,3526695,1763347,1763348,72FwbpFGoLEazJEdpqNtPNefsadUrimUqma9wSoy4qiS,141067825,590290754,-449222929,623
2021-12-06 06:13:28-05:00,487,2JH43pKUeXTXPd6LnL4BWgGQpwZHhX8EqyohKCFLAS4i,Bir3EKnDWkv6XX7KmoqAi1y6rxSaC5RfVV6Hwvnkfr2i,True,24001164,6000291,37038,18519,18519,72FwbpFGoLEazJEdpqNtPNefsadUrimUqma9wSoy4qiS,1481537,7536305,-6054768,617
2021-12-06 06:13:32-05:00,488,7aKxZg1aoLuB51JUw7fruF77ts7SWoB7pcLBZKHZMynr,AAnbLY82UGULqaDNdyJHrYu7X3hGaBuiTkGWmh8qKTc,True,9272286802,2318071700,14307179,7153589,7153590,72FwbpFGoLEazJEdpqNtPNefsadUrimUqma9wSoy4qiS,572287167,2111592247,-1539305080,617
2021-12-06 06:13:32-05:00,489,E5KDZriZ89a5D4VsMaWxndMMG68RT4weruJ1tCEc6tSx,CaSwkUocpbyyGCQBgKjJZJgcexbyqs2GTrGJH6EMWXAz,True,3032100349,758025087,4694561,2347280,2347281,72FwbpFGoLEazJEdpqNtPNefsadUrimUqma9wSoy4qiS,187782479,1085914228,-898131749,619
2021-12-06 06:13:42-05:00,490,4xsYjVsPm2C2itNtJb3NYkBp4WySHUwtSbWdu9fge8wz,8zu2jMoTndZpf9khY9PMhve88LRwrKNTuVuLpa5ss8qo,True,334892406,83723101,521046,260523,260523,72FwbpFGoLEazJEdpqNtPNefsadUrimUqma9wSoy4qiS,20841848,131081301,-110239453,622
2021-12-06 06:13:42-05:00,491,7WB5fc5DQAWYBSgc11KfWa4kpThfyaoxp49kFGELCQMj,4qD4BkxDzJ6uZ2iKgsXZtghNbNsnHmaKyjGWLZW9YTdU,True,45017360,11254340,70024,35012,35012,72FwbpFGoLEazJEdpqNtPNefsadUrimUqma9wSoy4qiS,2800992,10418315,-7617323,622
2021-12-06 06:13:44-05:00,492,C24que1C7tC3ysDSKhcBTF9NUnjiNhSanWp8Go5FRRb8,hgm3qRRG2njhNPWcUp9UnEU8pyg4gLaR2K13r4Lsqxm,True,359586062,89896515,553795,276897,276898,72FwbpFGoLEazJEdpqNtPNefsadUrimUqma9wSoy4qiS,22151805,112597001,-90445196,616
2021-12-06 06:13:55-05:00,493,8w4uRzN81cghupkF7jNLinGLtCqYwNQFgQtdJfC5so7z,BbbRkq85fYEBGmuxBEEPbt6up4GNB7WQ83VSXwe4ro98,True,3819648777,954912194,5862360,2931180,2931180,4BnQKPLuE3DMTtxp8MjUBytgnhvxqq3ZTqZHTVZo4JJh,234494412,1213999721,-979505309,613
2021-12-06 06:14:07-05:00,494,2XFYFxNQbCr5ao4cVzRZt45fsAwZc4jD9XTABmdqaJWd,CvpzBuDjyimaYFGWFkkBcaZGSRtAvtF6MtRV54mqZ74k,True,491996,122999,760,380,380,72FwbpFGoLEazJEdpqNtPNefsadUrimUqma9wSoy4qiS,30422,205853,-175431,618
2021-12-06 06:14:07-05:00,495,DVV4Vhk44E5YvVzpXgjJMepYgUB5uKXmAhEbFg6R5vWJ,8CS7rCKNx7AQ5yaEA2rHrYx4PHnC9mK3DtSQmiKW2nUb,True,152767478,38191869,236683,118341,118342,72FwbpFGoLEazJEdpqNtPNefsadUrimUqma9wSoy4qiS,9467357,57184886,-47717529,619
2021-12-06 06:14:08-05:00,496,FP6SmbXDbcb6c8Pi8uZMn6hnQDUbvbdCfzd5pEqyBgTm,53A9dhER1x3JjdceGMQmjujvWht7uemsoB3ngQLdo6Ub,True,750326077,187581519,1169627,584813,584814,72FwbpFGoLEazJEdpqNtPNefsadUrimUqma9wSoy4qiS,46785095,253367101,-206582006,623
2021-12-06 06:14:09-05:00,497,3XzkSrNTGd3Fhd4M3gYzvz2utbQpFN1fhtbAaZu7C39R,GMsZGGfktTzYi7GhD3W6HY9QY9bznqTKfeArksikLE71,True,4416508,1104127,6814,3407,3407,72FwbpFGoLEazJEdpqNtPNefsadUrimUqma9wSoy4qiS,272596,1669933,-1397337,617
2021-12-06 06:14:09-05:00,498,3Ek5j2ea8wS2nCxsNgn2AbovxzJwGK7zc6xarkigSA3u,DEWmTn3Ah4F3nNXpoQLt1GG65Dsf4ZmGjn7FZUJyK6rP,True,1120595467,280148866,1732010,866005,866005,72FwbpFGoLEazJEdpqNtPNefsadUrimUqma9wSoy4qiS,69280432,467131295,-397850863,618
2021-12-07 07:49:35-05:00,499,EntLemtuTqmuHY9F4pycmGmNwBNeUghf9R6QHHd7ZTYw,EdMJPDmD6f3T9FtjdUZ433z1w8JHZVwQqYVkzmrG2ToK,False,560803117632,560803117632,0,0,0,72FwbpFGoLEazJEdpqNtPNefsadUrimUqma9wSoy4qiS,0,139743715395,-212926529347,0
2021-12-07 07:57:36-05:00,500,D3o7CSh2zCAQ93BDomDCitZ4vuxC83wGPMwJEEyBJK4C,A4nDfpUZkdtuWRRWZkoNXc5Ux7JU1UJA2JTHgkHAfYyP,False,131143811549,131143811549,0,0,0,72FwbpFGoLEazJEdpqNtPNefsadUrimUqma9wSoy4qiS,0,80799610730,-140718271110,0
2021-12-10 00:03:20-05:00,501,8d333AWdyiVhvkAdiKCTwhgzaPBMbn8mtucwUC1SAbZZ,3BM8UNLN7XGRaYRjezAqFVMr1z4PS3VRXiN1NAtvBuD9,True,78851677,19712919,123161,61580,61581,GmqQKnMfFxkv6ChqGaZ2wmSFDow7R1x7WeRfU58GVvfw,4926443,30201844,-25275401,624
2021-12-10 00:03:26-05:00,502,DSEgVqfxXp5wxjn3gNZtmb4E6rJeBm3VcbqdwDnsuzSq,6YVCWznUKheSMPuywSRJgCes7wghPGJXgxfrVfnjN4mB,True,784934067,196233516,1228349,614174,614175,4BnQKPLuE3DMTtxp8MjUBytgnhvxqq3ZTqZHTVZo4JJh,49133962,201790667,-152656705,625
2021-12-10 00:27:46-05:00,503,DCxghVXCXzEar41CPGichdzvtjwmf4NW7uHtKTj57BNN,Fmh5FPdnFb1KpFkoL6eNfWFGxN78GLdaJgPcVpCoCnkh,True,310312917,77578229,485505,242752,242753,4BnQKPLuE3DMTtxp8MjUBytgnhvxqq3ZTqZHTVZo4JJh,19420232,93963606,-74543374,625
2021-12-10 00:28:19-05:00,504,8w1hzDtCFuTJqWAtwihztrPzxwa7YrJH5uPk877SJnNj,D3gnctosqTZxTQNfLJQRdPgCvGx2JLLHHDmcvW5UX1QN,True,525553936,131388484,821683,410841,410842,4BnQKPLuE3DMTtxp8MjUBytgnhvxqq3ZTqZHTVZo4JJh,32867326,162413599,-129546273,625
2021-12-10 00:28:22-05:00,505,BELLbzmdx1SYke9kZUxFi9VcdvwaHmkZyv24FArQ1J2f,5a5LfKakAaFEVkavVHgExKaUr25RWYpzFic6MUQQ62uc,True,1474800914,368700228,2308029,1154014,1154015,4BnQKPLuE3DMTtxp8MjUBytgnhvxqq3ZTqZHTVZo4JJh,92321190,599291062,-506969872,625
2021-12-10 00:28:40-05:00,506,CQSb6ZVY1KVNXFAg8pxm8RvBBGGqRSU7FMvwHJPy46u8,FRBv3b5VTfKN1bK4DXFY4329LFbvm882P47edrgpuSM,True,720903589,180225897,1126771,563385,563386,4BnQKPLuE3DMTtxp8MjUBytgnhvxqq3ZTqZHTVZo4JJh,45070859,247836480,-202765621,625
2021-12-10 00:28:49-05:00,507,8Xdf67Q5jXKwS52e492xUBu1tMUgS14jJg7V4R2Q28EP,GAPL3bsXP4xcukhgzyqrbDntGwUSm5BfuwJ8TLKkRaZc,True,374377551,93594387,583712,291856,291856,4BnQKPLuE3DMTtxp8MjUBytgnhvxqq3ZTqZHTVZo4JJh,23348501,103342002,-79993501,623
2021-12-10 00:38:55-05:00,508,94KFzzXCAvEfSf3jrnUpyN3pne8Xfc6nroB7UxTVqeyB,ERQEKcL8qV9WEzLwi5WFjh2wN97q9GD9pqd9umcTypxy,True,3419647,854911,5320,2660,2660,4BnQKPLuE3DMTtxp8MjUBytgnhvxqq3ZTqZHTVZo4JJh,212807,1229564,-1016757,622
2021-12-10 00:38:58-05:00,509,EvSdLa5PeJiaaaE3omJNG7cw1tptZnHTituYswVHSwm3,68ESX2mBsfxQo2U9jsbmHo7TzPTxr9mGH5Y11ZLR7E3A,True,31411296,7852824,48971,24485,24486,4BnQKPLuE3DMTtxp8MjUBytgnhvxqq3ZTqZHTVZo4JJh,1958841,12790242,-10831401,623
2021-12-10 00:40:32-05:00,510,8soQsYfQCngqJ5gLpWSuuzDUo1YLg53mU6GBF5RBizNn,HdsRtpasJYyFdS3sKqFAwJespt8x7cKUfGuvEuxmWdxV,True,39980183,9995045,62479,31239,31240,4BnQKPLuE3DMTtxp8MjUBytgnhvxqq3ZTqZHTVZo4JJh,2499165,9465792,-6966627,625
2021-12-10 01:43:32-05:00,511,J5WcVsKNHbfioai1LRowvjvtEmUJBEkeoBim1ThshpoP,Ajh7SWBq3zJR4vb6AFoBS6C9D99wC6YF1sVN22qC1vCA,True,358662662,89665665,555389,277694,277695,72FwbpFGoLEazJEdpqNtPNefsadUrimUqma9wSoy4qiS,22215586,72980566,-50764980,619
2021-12-10 01:56:43-05:00,512,7TBoPCDA6BACBPJvpwHVHQh1EeydCHD2KT4TaQ4NWrc3,6GLRsMGMNBA8qf27VGfXyXtTt31J9GUVrqqJM7H2RhwK,True,205273110,51318277,318104,159052,159052,72FwbpFGoLEazJEdpqNtPNefsadUrimUqma9wSoy4qiS,12724179,44586161,-31861982,619
2021-12-10 02:00:19-05:00,513,EFHg5FatMRRSZnKJPJF9e1iw2cjPJRmwTTZYtkHno9DP,84LnLKhZDJgWFnbBYnYjqWkjymemXfidecPFwnUAvuFj,True,2741191214,685297803,4279749,2139874,2139875,72FwbpFGoLEazJEdpqNtPNefsadUrimUqma9wSoy4qiS,171189968,897966027,-726776059,624
2021-12-10 02:03:20-05:00,514,HnUkyFhntoajDEgXMKeoh4nAuY5y7osLYwmYAApyLSNs,GntEkHxrGpcHFCVLQGjKiXWdenbsqfQgxddpEpxpE65z,True,19218992,4804748,30042,15021,15021,72FwbpFGoLEazJEdpqNtPNefsadUrimUqma9wSoy4qiS,1201693,6897756,-5696063,625
2021-12-10 02:04:33-05:00,515,CBEv8v9XZrgFT8UdEdd813XnRVv9R7GB5PLMyG8UWGC8,4uNcMEcQpJdThpisgNrttkQJTUFTsjEr25qgjkm4titC,True,185762382,46440595,290096,145048,145048,72FwbpFGoLEazJEdpqNtPNefsadUrimUqma9wSoy4qiS,11603873,88092977,-76489104,624
2021-12-10 02:07:56-05:00,516,9kK2PuehQxgcXtnYnPNmukmzfDTsVHv15pE86xwi7vYt,DtbCSCur1w6ZMGu56auQaHf8c6gVDJoD1iEwiUyCBcYJ,True,6731911,1682977,10469,5234,5235,72FwbpFGoLEazJEdpqNtPNefsadUrimUqma9wSoy4qiS,418778,2696418,-2277640,622
2021-12-10 02:07:56-05:00,517,6oRHRnLX93bYeTN5YD2XHqskhbv8wN2pgSia9Kz3QkED,D6QG2KYp9vYZZe8tTZux5tDR6fXgm8k4SVWbpaPvEmZ1,True,77240464,19310116,120288,60144,60144,72FwbpFGoLEazJEdpqNtPNefsadUrimUqma9wSoy4qiS,4811544,20233027,-15421483,622
2021-12-10 02:11:20-05:00,518,FSduW743jAGyyn8HTifEJitgb89Spp5gEeMXDE59aEHF,HjojGNpR3ACtLCP2mP8DKGyXj6SeqWPKjcCAofcyQpsm,True,886132181,221533045,1377083,688541,688542,72FwbpFGoLEazJEdpqNtPNefsadUrimUqma9wSoy4qiS,55083353,224428515,-169345162,621
2021-12-10 02:11:20-05:00,519,3fB955q6xxxZcgnCyguLwkSa7egxgBoksPQVQ3U8HRHL,GK7cTdhfSpapJB8dFzEkV8c1UFkJPj281DwztnpKjxLx,True,62666314,15666578,97298,48649,48649,72FwbpFGoLEazJEdpqNtPNefsadUrimUqma9wSoy4qiS,3891940,29843511,-25951571,621
2021-12-10 02:19:58-05:00,520,FpqCxvTkSiwDwD5qEt6hXJxzFDLFLAQ8VevK8zwRqYun,A3p6YQisCJKpNkF7vkjZRbEfbnUt7vTZdR2zPBUSdTkk,True,47487171,11871792,74222,37111,37111,72FwbpFGoLEazJEdpqNtPNefsadUrimUqma9wSoy4qiS,2968916,19798256,-16829340,625
2021-12-10 02:41:19-05:00,521,6meAnGTy2XNUDk9qSJZGT6BBRinA5iGiDYEy2T88LXuX,BCzNQCn3J1381yNH5xp5ky9QmVKVdSofSUaLHtxKxPBW,True,492932,123233,762,381,381,72FwbpFGoLEazJEdpqNtPNefsadUrimUqma9wSoy4qiS,30512,205047,-174535,618
2021-12-10 02:41:19-05:00,522,Hp4bpHhSds7eMRmW1wpCg8HPUKk5vdRJt9Wm1axJgbcG,5sPxP3PAUqWr5FuHY1kUTz5u1J4pvVB95L1rbxepS2S6,True,517497,129374,800,400,400,72FwbpFGoLEazJEdpqNtPNefsadUrimUqma9wSoy4qiS,32021,135202,-103181,618
2021-12-10 02:41:20-05:00,523,A9BZ5kjh7iKu7SMzA5WUF31Zst9V7fehwDZaoKs4NpSi,3FzwTaT5LYucvoGGcRVXu5AUDnGHADv6yGqrBT6jEtvH,True,262693330,65673332,409803,204901,204902,72FwbpFGoLEazJEdpqNtPNefsadUrimUqma9wSoy4qiS,16392149,87552657,-71160508,624
2021-12-10 02:41:20-05:00,524,EDE1swNYZ99y9idZacAw5Ncwz2DyD78SqvKMUXA2Dbw4,HSmYYMpNQNr1F2zjvysGRrC57FyusAJNsaXWfbmCfZh4,True,14017582,3504395,21672,10836,10836,72FwbpFGoLEazJEdpqNtPNefsadUrimUqma9wSoy4qiS,866889,6731198,-5864309,618
2021-12-10 02:48:57-05:00,525,FZhvN1RjLoBK9EpCeyEobYsvdHirtbTXV82c9EV9nn2u,FSeHqYNof79JYrRb7ZkJWEb4TfS5wx7HTdvT1kLCexHM,True,26788210,6697052,41820,20910,20910,72FwbpFGoLEazJEdpqNtPNefsadUrimUqma9wSoy4qiS,1672833,9626508,-7953675,624
2021-12-10 10:00:04-05:00,526,66SjFhmiNYz8tLRnBhZUbowWGTbM16G52X3AT2hma2wN,3wVy8nk24HCFZWMiacGe8QsJquYaadZ9pQg44bGRwdE3,True,19372697,4843174,30306,15153,15153,GmqQKnMfFxkv6ChqGaZ2wmSFDow7R1x7WeRfU58GVvfw,1212274,8915291,-7703017,625
2021-12-10 10:00:12-05:00,527,7gxTghaVZPNNwaNEdtQHh4QDCJ4JgigYMd4MMCC9VtFo,4ZZTUrm4jX1jqqTYVFJ9TJQ2BLx2eZgXesmoon1LBa1a,True,6917433,1729358,10800,5400,5400,72FwbpFGoLEazJEdpqNtPNefsadUrimUqma9wSoy4qiS,432005,1946494,-1514489,624
2021-12-10 10:01:40-05:00,528,57GUgfEp9ZQ5iAU2nx1Z2Tiz3gqq7yBNaqfE1cvxjFYt,98upivFa9Tdy3RZHGM1i2k5zeczaGqioq3rTzc3DMf4x,True,69562693,17390673,107501,53750,53751,4BnQKPLuE3DMTtxp8MjUBytgnhvxqq3ZTqZHTVZo4JJh,4300051,29254928,-24954877,618
2021-12-10 10:01:48-05:00,529,EQYUWtYbtvN9C9ixiupXPjHyFWHsYa7dUh4DSd6rxbzt,iS616uGNCwCxP1taAvvdvA2KdqfXRSjcQWwZRUgBkLb,True,6281089,1570272,9762,4881,4881,4BnQKPLuE3DMTtxp8MjUBytgnhvxqq3ZTqZHTVZo4JJh,390494,2707579,-2317085,621
2021-12-10 10:01:53-05:00,530,2JH43pKUeXTXPd6LnL4BWgGQpwZHhX8EqyohKCFLAS4i,Bir3EKnDWkv6XX7KmoqAi1y6rxSaC5RfVV6Hwvnkfr2i,True,17819035,4454758,27584,13792,13792,72FwbpFGoLEazJEdpqNtPNefsadUrimUqma9wSoy4qiS,1103372,5826363,-4722991,619
2021-12-10 10:02:42-05:00,531,C24que1C7tC3ysDSKhcBTF9NUnjiNhSanWp8Go5FRRb8,hgm3qRRG2njhNPWcUp9UnEU8pyg4gLaR2K13r4Lsqxm,True,266850622,66712655,409249,204624,204625,72FwbpFGoLEazJEdpqNtPNefsadUrimUqma9wSoy4qiS,16369988,87047732,-70677744,613
2021-12-10 10:02:44-05:00,532,7aKxZg1aoLuB51JUw7fruF77ts7SWoB7pcLBZKHZMynr,AAnbLY82UGULqaDNdyJHrYu7X3hGaBuiTkGWmh8qKTc,True,6879885560,1719971390,10549946,5274973,5274973,72FwbpFGoLEazJEdpqNtPNefsadUrimUqma9wSoy4qiS,421997853,1653852739,-1231854886,613
2021-12-10 10:02:44-05:00,533,81GV2H9ipJSZD6YpJGj2XQNfoUroWWnKfwMHGSwvhixd,7cLHoNuNVj8qkn3QmBYLFwja37f1MWEo4e3ZcNSpXTPw,True,1677443725,419360931,2551962,1275981,1275981,72FwbpFGoLEazJEdpqNtPNefsadUrimUqma9wSoy4qiS,102078499,459616576,-357538077,608
2021-12-10 10:02:46-05:00,534,7WB5fc5DQAWYBSgc11KfWa4kpThfyaoxp49kFGELCQMj,4qD4BkxDzJ6uZ2iKgsXZtghNbNsnHmaKyjGWLZW9YTdU,True,33422798,8355699,52291,26145,26146,72FwbpFGoLEazJEdpqNtPNefsadUrimUqma9wSoy4qiS,2091669,8145009,-6053340,625
2021-12-10 10:03:03-05:00,535,4xsYjVsPm2C2itNtJb3NYkBp4WySHUwtSbWdu9fge8wz,8zu2jMoTndZpf9khY9PMhve88LRwrKNTuVuLpa5ss8qo,True,248472914,62118228,384986,192493,192493,72FwbpFGoLEazJEdpqNtPNefsadUrimUqma9wSoy4qiS,15399457,100780019,-85380562,619
2021-12-10 10:03:12-05:00,536,8w4uRzN81cghupkF7jNLinGLtCqYwNQFgQtdJfC5so7z,BbbRkq85fYEBGmuxBEEPbt6up4GNB7WQ83VSXwe4ro98,True,2838903005,709725751,4434256,2217128,2217128,72FwbpFGoLEazJEdpqNtPNefsadUrimUqma9wSoy4qiS,177370252,938390430,-761020178,624
2021-12-10 10:04:37-05:00,537,3Ek5j2ea8wS2nCxsNgn2AbovxzJwGK7zc6xarkigSA3u,DEWmTn3Ah4F3nNXpoQLt1GG65Dsf4ZmGjn7FZUJyK6rP,True,832215362,208053840,1296459,648229,648230,72FwbpFGoLEazJEdpqNtPNefsadUrimUqma9wSoy4qiS,51858390,358529614,-306671224,623
2021-12-10 10:04:37-05:00,538,7UwBQLT7uc8DFabDUwRBgTCjm2Tprh79HoDwhPCap6v7,CdWQHx3cRLC7ApxXSbVD3D6y2V6vtqQJLMjuhFcdbp4X,True,218901868,54725467,339478,169739,169739,72FwbpFGoLEazJEdpqNtPNefsadUrimUqma9wSoy4qiS,13579157,101631626,-88052469,620
2021-12-10 10:04:38-05:00,539,2XFYFxNQbCr5ao4cVzRZt45fsAwZc4jD9XTABmdqaJWd,CvpzBuDjyimaYFGWFkkBcaZGSRtAvtF6MtRV54mqZ74k,True,365195,91298,564,282,282,72FwbpFGoLEazJEdpqNtPNefsadUrimUqma9wSoy4qiS,22586,158007,-135421,618
2021-12-10 10:04:39-05:00,540,3XzkSrNTGd3Fhd4M3gYzvz2utbQpFN1fhtbAaZu7C39R,GMsZGGfktTzYi7GhD3W6HY9QY9bznqTKfeArksikLE71,True,3279277,819819,5082,2541,2541,72FwbpFGoLEazJEdpqNtPNefsadUrimUqma9wSoy4qiS,203288,1284399,-1081111,619
2021-12-10 10:04:42-05:00,541,DVV4Vhk44E5YvVzpXgjJMepYgUB5uKXmAhEbFg6R5vWJ,8CS7rCKNx7AQ5yaEA2rHrYx4PHnC9mK3DtSQmiKW2nUb,True,113425744,28356436,176606,88303,88303,72FwbpFGoLEazJEdpqNtPNefsadUrimUqma9wSoy4qiS,7064249,44003195,-36938946,622
2021-12-10 10:05:11-05:00,542,FP6SmbXDbcb6c8Pi8uZMn6hnQDUbvbdCfzd5pEqyBgTm,53A9dhER1x3JjdceGMQmjujvWht7uemsoB3ngQLdo6Ub,True,556695254,139173813,864315,432157,432158,72FwbpFGoLEazJEdpqNtPNefsadUrimUqma9wSoy4qiS,34572601,195580300,-161007699,621
2021-12-10 10:06:01-05:00,543,8fVwuVA2CL5sZoHh6Dg4MBpcX3cvoUm7mnitnpQSdPBD,4F4ccaNm1KQu29XvsKvdjFkmpsbWqNvXkV41851EYQyu,True,44447458,11111864,69443,34721,34722,72FwbpFGoLEazJEdpqNtPNefsadUrimUqma9wSoy4qiS,2777729,15248888,-12471159,624
2021-12-10 10:06:01-05:00,544,DSEgVqfxXp5wxjn3gNZtmb4E6rJeBm3VcbqdwDnsuzSq,6YVCWznUKheSMPuywSRJgCes7wghPGJXgxfrVfnjN4mB,True,577613192,144403298,899522,449761,449761,72FwbpFGoLEazJEdpqNtPNefsadUrimUqma9wSoy4qiS,35980902,161579681,-125598779,622
2021-12-10 10:06:01-05:00,545,8d333AWdyiVhvkAdiKCTwhgzaPBMbn8mtucwUC1SAbZZ,3BM8UNLN7XGRaYRjezAqFVMr1z4PS3VRXiN1NAtvBuD9,True,58019600,14504900,90000,45000,45000,72FwbpFGoLEazJEdpqNtPNefsadUrimUqma9wSoy4qiS,3600017,23675980,-20075963,620
2021-12-10 10:07:24-05:00,546,CQSb6ZVY1KVNXFAg8pxm8RvBBGGqRSU7FMvwHJPy46u8,FRBv3b5VTfKN1bK4DXFY4329LFbvm882P47edrgpuSM,True,530595324,132648831,827289,413644,413645,72FwbpFGoLEazJEdpqNtPNefsadUrimUqma9wSoy4qiS,33091564,195265279,-162173715,623
2021-12-10 10:07:24-05:00,547,DCxghVXCXzEar41CPGichdzvtjwmf4NW7uHtKTj57BNN,Fmh5FPdnFb1KpFkoL6eNfWFGxN78GLdaJgPcVpCoCnkh,True,228208399,57052099,351929,175964,175965,72FwbpFGoLEazJEdpqNtPNefsadUrimUqma9wSoy4qiS,14077197,74514087,-60436890,616
2021-12-10 10:07:24-05:00,548,BELLbzmdx1SYke9kZUxFi9VcdvwaHmkZyv24FArQ1J2f,5a5LfKakAaFEVkavVHgExKaUr25RWYpzFic6MUQQ62uc,True,1085207956,271301989,1688626,844313,844313,72FwbpFGoLEazJEdpqNtPNefsadUrimUqma9wSoy4qiS,67545055,468740322,-401195267,622
2021-12-10 10:07:24-05:00,549,8Xdf67Q5jXKwS52e492xUBu1tMUgS14jJg7V4R2Q28EP,GAPL3bsXP4xcukhgzyqrbDntGwUSm5BfuwJ8TLKkRaZc,True,275598012,68899503,429489,214744,214745,72FwbpFGoLEazJEdpqNtPNefsadUrimUqma9wSoy4qiS,17179571,82364258,-65184687,623
2021-12-10 10:07:33-05:00,550,8w1hzDtCFuTJqWAtwihztrPzxwa7YrJH5uPk877SJnNj,D3gnctosqTZxTQNfLJQRdPgCvGx2JLLHHDmcvW5UX1QN,True,386644486,96661121,599084,299542,299542,72FwbpFGoLEazJEdpqNtPNefsadUrimUqma9wSoy4qiS,23963394,128652977,-104689583,619
2021-12-10 10:48:33-05:00,551,9WoXgsHByBW41nJtgCBoLS1ZP2GredkysgyZeNRWx13u,26Hb8DNrxtVBHcThu71DJ3pTbhXRcGApnTrgk6iAVTau,True,209907564,52476891,326496,163248,163248,4BnQKPLuE3DMTtxp8MjUBytgnhvxqq3ZTqZHTVZo4JJh,13059840,48127531,-35067691,622
2021-12-10 10:54:32-05:00,552,94KFzzXCAvEfSf3jrnUpyN3pne8Xfc6nroB7UxTVqeyB,ERQEKcL8qV9WEzLwi5WFjh2wN97q9GD9pqd9umcTypxy,True,2518471,629617,3939,1969,1970,4BnQKPLuE3DMTtxp8MjUBytgnhvxqq3ZTqZHTVZo4JJh,157562,966405,-808843,625
2021-12-10 10:54:51-05:00,553,9WoXgsHByBW41nJtgCBoLS1ZP2GredkysgyZeNRWx13u,26Hb8DNrxtVBHcThu71DJ3pTbhXRcGApnTrgk6iAVTau,True,153949519,38487379,231304,115652,115652,72FwbpFGoLEazJEdpqNtPNefsadUrimUqma9wSoy4qiS,9252190,39039700,-29787510,600
2021-12-10 10:56:02-05:00,554,E5KDZriZ89a5D4VsMaWxndMMG68RT4weruJ1tCEc6tSx,CaSwkUocpbyyGCQBgKjJZJgcexbyqs2GTrGJH6EMWXAz,True,2252985430,563246357,3516083,1758041,1758042,72FwbpFGoLEazJEdpqNtPNefsadUrimUqma9wSoy4qiS,140643356,835585217,-694941861,624
2021-12-10 10:56:31-05:00,555,EvSdLa5PeJiaaaE3omJNG7cw1tptZnHTituYswVHSwm3,68ESX2mBsfxQo2U9jsbmHo7TzPTxr9mGH5Y11ZLR7E3A,True,23118237,5779559,35900,17950,17950,GmqQKnMfFxkv6ChqGaZ2wmSFDow7R1x7WeRfU58GVvfw,1436016,9999886,-8563870,621
2021-12-10 10:57:04-05:00,556,8soQsYfQCngqJ5gLpWSuuzDUo1YLg53mU6GBF5RBizNn,HdsRtpasJYyFdS3sKqFAwJespt8x7cKUfGuvEuxmWdxV,True,29416873,7354218,45640,22820,22820,GmqQKnMfFxkv6ChqGaZ2wmSFDow7R1x7WeRfU58GVvfw,1825611,7618942,-5793331,620
2021-12-10 10:57:28-05:00,557,J5WcVsKNHbfioai1LRowvjvtEmUJBEkeoBim1ThshpoP,Ajh7SWBq3zJR4vb6AFoBS6C9D99wC6YF1sVN22qC1vCA,True,264079484,66019871,410091,205045,205046,GmqQKnMfFxkv6ChqGaZ2wmSFDow7R1x7WeRfU58GVvfw,16403662,59398742,-42995080,621
2021-12-10 10:57:33-05:00,558,64w7jdrK2Kv8Wc55SfKBt7U6paGQ2NRGf31zPFC6Qk8G,3t6zWvFwvvfSFLaEdUoEzZZSW4ykWScvQnQDkTatKKg1,True,8582923,2145730,13267,6633,6634,GmqQKnMfFxkv6ChqGaZ2wmSFDow7R1x7WeRfU58GVvfw,530706,1947783,-1417077,618
2021-12-10 10:57:34-05:00,559,BtUb2aiZEXz89D8KgduJDt4SeLDuQeociXcAfey3sK7r,B4ZCTjVxHvAqSb4GqVWdan6qoSLVnYdq8KbUPbYMiz6v,True,5781226930,1445306732,8899082,4449541,4449541,GmqQKnMfFxkv6ChqGaZ2wmSFDow7R1x7WeRfU58GVvfw,355963290,1487624681,-1131661391,615
2021-12-10 10:57:34-05:00,560,7TBoPCDA6BACBPJvpwHVHQh1EeydCHD2KT4TaQ4NWrc3,6GLRsMGMNBA8qf27VGfXyXtTt31J9GUVrqqJM7H2RhwK,True,150997880,37749470,231373,115686,115687,GmqQKnMfFxkv6ChqGaZ2wmSFDow7R1x7WeRfU58GVvfw,9254955,36109650,-26854695,612
2021-12-10 10:57:36-05:00,561,EFHg5FatMRRSZnKJPJF9e1iw2cjPJRmwTTZYtkHno9DP,84LnLKhZDJgWFnbBYnYjqWkjymemXfidecPFwnUAvuFj,True,2015394326,503848581,3104022,1552011,1552011,GmqQKnMfFxkv6ChqGaZ2wmSFDow7R1x7WeRfU58GVvfw,124160914,709986935,-585826021,616
2021-12-10 10:57:36-05:00,562,G7kJUwq3DhEH6zhaeToRFMTKBEH3ME45hbqmrHbQD1nP,JmGGddHjC5bSieVcDn3sMeRBLryEhQKJmmtnkWza66L,True,356883706,89220926,549009,274504,274505,GmqQKnMfFxkv6ChqGaZ2wmSFDow7R1x7WeRfU58GVvfw,21960390,77281742,-55321352,615
2021-12-10 10:57:38-05:00,563,7uzNVopRjtoGCPz2CZPd88S6iLaXox1s1j3DAJE3YLSY,4HBjxtkRLW4bL6R6s5HpyUfk5FqQoQUsy9mLq3zKdc2M,True,11329675387,2832418846,17556595,8778297,8778298,4BnQKPLuE3DMTtxp8MjUBytgnhvxqq3ZTqZHTVZo4JJh,702263806,2530269335,-1828005529,619
2021-12-10 10:57:39-05:00,564,HnUkyFhntoajDEgXMKeoh4nAuY5y7osLYwmYAApyLSNs,GntEkHxrGpcHFCVLQGjKiXWdenbsqfQgxddpEpxpE65z,True,14132451,3533112,21851,10925,10926,GmqQKnMfFxkv6ChqGaZ2wmSFDow7R1x7WeRfU58GVvfw,874073,5427950,-4553877,618
2021-12-10 10:57:39-05:00,565,9kK2PuehQxgcXtnYnPNmukmzfDTsVHv15pE86xwi7vYt,DtbCSCur1w6ZMGu56auQaHf8c6gVDJoD1iEwiUyCBcYJ,True,4952253,1238063,7652,3826,3826,4BnQKPLuE3DMTtxp8MjUBytgnhvxqq3ZTqZHTVZo4JJh,306093,2111024,-1804931,618
2021-12-10 10:57:40-05:00,566,CBEv8v9XZrgFT8UdEdd813XnRVv9R7GB5PLMyG8UWGC8,4uNcMEcQpJdThpisgNrttkQJTUFTsjEr25qgjkm4titC,True,136592877,34148219,210804,105402,105402,4BnQKPLuE3DMTtxp8MjUBytgnhvxqq3ZTqZHTVZo4JJh,8432185,68529224,-60097039,617
2021-12-10 10:57:41-05:00,567,6oRHRnLX93bYeTN5YD2XHqskhbv8wN2pgSia9Kz3QkED,D6QG2KYp9vYZZe8tTZux5tDR6fXgm8k4SVWbpaPvEmZ1,True,56821542,14205385,87973,43986,43987,4BnQKPLuE3DMTtxp8MjUBytgnhvxqq3ZTqZHTVZo4JJh,3518936,16194042,-12675106,619
2021-12-10 11:03:57-05:00,568,FSduW743jAGyyn8HTifEJitgb89Spp5gEeMXDE59aEHF,HjojGNpR3ACtLCP2mP8DKGyXj6SeqWPKjcCAofcyQpsm,True,652513688,163128422,1019956,509978,509978,GmqQKnMfFxkv6ChqGaZ2wmSFDow7R1x7WeRfU58GVvfw,40798263,179916746,-139118483,625
2021-12-10 11:03:57-05:00,569,3fB955q6xxxZcgnCyguLwkSa7egxgBoksPQVQ3U8HRHL,GK7cTdhfSpapJB8dFzEkV8c1UFkJPj281DwztnpKjxLx,True,46143128,11535782,71996,35998,35998,GmqQKnMfFxkv6ChqGaZ2wmSFDow7R1x7WeRfU58GVvfw,2879869,23200304,-20320435,624
2021-12-10 11:04:26-05:00,570,FpqCxvTkSiwDwD5qEt6hXJxzFDLFLAQ8VevK8zwRqYun,A3p6YQisCJKpNkF7vkjZRbEfbnUt7vTZdR2zPBUSdTkk,True,34949088,8737272,54607,27303,27304,GmqQKnMfFxkv6ChqGaZ2wmSFDow7R1x7WeRfU58GVvfw,2184316,15472720,-13288404,624
2021-12-10 11:04:34-05:00,571,EDE1swNYZ99y9idZacAw5Ncwz2DyD78SqvKMUXA2Dbw4,HSmYYMpNQNr1F2zjvysGRrC57FyusAJNsaXWfbmCfZh4,True,10327020,2581755,16150,8075,8075,GmqQKnMfFxkv6ChqGaZ2wmSFDow7R1x7WeRfU58GVvfw,646014,5230446,-4584432,625
2021-12-10 11:04:54-05:00,572,6meAnGTy2XNUDk9qSJZGT6BBRinA5iGiDYEy2T88LXuX,BCzNQCn3J1381yNH5xp5ky9QmVKVdSofSUaLHtxKxPBW,True,363090,90772,567,283,284,GmqQKnMfFxkv6ChqGaZ2wmSFDow7R1x7WeRfU58GVvfw,22683,160217,-137534,624
2021-12-10 11:05:42-05:00,573,Hp4bpHhSds7eMRmW1wpCg8HPUKk5vdRJt9Wm1axJgbcG,5sPxP3PAUqWr5FuHY1kUTz5u1J4pvVB95L1rbxepS2S6,True,381104,95276,593,296,297,GmqQKnMfFxkv6ChqGaZ2wmSFDow7R1x7WeRfU58GVvfw,23721,108193,-84472,622
2021-12-10 11:06:00-05:00,574,A9BZ5kjh7iKu7SMzA5WUF31Zst9V7fehwDZaoKs4NpSi,3FzwTaT5LYucvoGGcRVXu5AUDnGHADv6yGqrBT6jEtvH,True,193383771,48345942,302545,151272,151273,GmqQKnMfFxkv6ChqGaZ2wmSFDow7R1x7WeRfU58GVvfw,12101804,69110685,-57008881,625
2021-12-10 11:06:15-05:00,575,8jmTkoNA5LM3xnsV2E1RRUegxYb8TospBNRbupaCeLF8,36LmDVFR5fgAYxgqhAtToJmRmYqYt5sVtUBkDQ3xmXhT,True,3158558,789639,4888,2444,2444,GmqQKnMfFxkv6ChqGaZ2wmSFDow7R1x7WeRfU58GVvfw,195555,852484,-656929,619
2021-12-10 11:06:15-05:00,576,66SjFhmiNYz8tLRnBhZUbowWGTbM16G52X3AT2hma2wN,3wVy8nk24HCFZWMiacGe8QsJquYaadZ9pQg44bGRwdE3,True,14237495,3559373,22198,11099,11099,GmqQKnMfFxkv6ChqGaZ2wmSFDow7R1x7WeRfU58GVvfw,887925,6957280,-6069355,623
2021-12-10 11:06:15-05:00,577,FZhvN1RjLoBK9EpCeyEobYsvdHirtbTXV82c9EV9nn2u,FSeHqYNof79JYrRb7ZkJWEb4TfS5wx7HTdvT1kLCexHM,True,19708649,4927162,30589,15294,15295,GmqQKnMfFxkv6ChqGaZ2wmSFDow7R1x7WeRfU58GVvfw,1223560,7571354,-6347794,620
2021-12-10 11:06:15-05:00,578,7gxTghaVZPNNwaNEdtQHh4QDCJ4JgigYMd4MMCC9VtFo,4ZZTUrm4jX1jqqTYVFJ9TJQ2BLx2eZgXesmoon1LBa1a,True,5084201,1271050,7915,3957,3958,GmqQKnMfFxkv6ChqGaZ2wmSFDow7R1x7WeRfU58GVvfw,316612,1556361,-1239749,622
2021-12-10 11:06:41-05:00,579,EQYUWtYbtvN9C9ixiupXPjHyFWHsYa7dUh4DSd6rxbzt,iS616uGNCwCxP1taAvvdvA2KdqfXRSjcQWwZRUgBkLb,True,4617705,1154426,7174,3587,3587,GmqQKnMfFxkv6ChqGaZ2wmSFDow7R1x7WeRfU58GVvfw,286966,2117899,-1830933,621
2021-12-10 11:06:41-05:00,580,2JH43pKUeXTXPd6LnL4BWgGQpwZHhX8EqyohKCFLAS4i,Bir3EKnDWkv6XX7KmoqAi1y6rxSaC5RfVV6Hwvnkfr2i,True,13100264,3275066,20247,10123,10124,GmqQKnMfFxkv6ChqGaZ2wmSFDow7R1x7WeRfU58GVvfw,809919,4616256,-3806337,618
2021-12-10 11:06:41-05:00,581,81GV2H9ipJSZD6YpJGj2XQNfoUroWWnKfwMHGSwvhixd,7cLHoNuNVj8qkn3QmBYLFwja37f1MWEo4e3ZcNSpXTPw,True,1235824030,308956007,1927315,963657,963658,GmqQKnMfFxkv6ChqGaZ2wmSFDow7R1x7WeRfU58GVvfw,77092626,367593308,-290500682,623
2021-12-10 11:06:41-05:00,582,C24que1C7tC3ysDSKhcBTF9NUnjiNhSanWp8Go5FRRb8,hgm3qRRG2njhNPWcUp9UnEU8pyg4gLaR2K13r4Lsqxm,True,196463723,49115930,306466,153233,153233,GmqQKnMfFxkv6ChqGaZ2wmSFDow7R1x7WeRfU58GVvfw,12258653,68943564,-56684911,623
2021-12-10 11:06:52-05:00,583,57GUgfEp9ZQ5iAU2nx1Z2Tiz3gqq7yBNaqfE1cvxjFYt,98upivFa9Tdy3RZHGM1i2k5zeczaGqioq3rTzc3DMf4x,True,51136557,12784139,78746,39373,39373,GmqQKnMfFxkv6ChqGaZ2wmSFDow7R1x7WeRfU58GVvfw,3149841,22901675,-19751834,615
2021-12-10 11:07:01-05:00,584,4xsYjVsPm2C2itNtJb3NYkBp4WySHUwtSbWdu9fge8wz,8zu2jMoTndZpf9khY9PMhve88LRwrKNTuVuLpa5ss8qo,True,182802681,45700670,285913,142956,142957,GmqQKnMfFxkv6ChqGaZ2wmSFDow7R1x7WeRfU58GVvfw,11436537,79026145,-67589608,625
2021-12-10 11:07:01-05:00,585,7aKxZg1aoLuB51JUw7fruF77ts7SWoB7pcLBZKHZMynr,AAnbLY82UGULqaDNdyJHrYu7X3hGaBuiTkGWmh8qKTc,True,5063039452,1265759863,7846363,3923181,3923182,GmqQKnMfFxkv6ChqGaZ2wmSFDow7R1x7WeRfU58GVvfw,313854536,1336064840,-1022210304,619
2021-12-10 11:07:10-05:00,586,7WB5fc5DQAWYBSgc11KfWa4kpThfyaoxp49kFGELCQMj,4qD4BkxDzJ6uZ2iKgsXZtghNbNsnHmaKyjGWLZW9YTdU,True,24568259,6142064,38426,19213,19213,GmqQKnMfFxkv6ChqGaZ2wmSFDow7R1x7WeRfU58GVvfw,1537053,6575987,-5038934,625
2021-12-10 11:14:21-05:00,587,3XzkSrNTGd3Fhd4M3gYzvz2utbQpFN1fhtbAaZu7C39R,GMsZGGfktTzYi7GhD3W6HY9QY9bznqTKfeArksikLE71,True,2412492,603123,3772,1886,1886,4BnQKPLuE3DMTtxp8MjUBytgnhvxqq3ZTqZHTVZo4JJh,150898,1008720,-857822,625
2021-12-10 11:14:23-05:00,588,8w4uRzN81cghupkF7jNLinGLtCqYwNQFgQtdJfC5so7z,BbbRkq85fYEBGmuxBEEPbt6up4GNB7WQ83VSXwe4ro98,True,2086936704,521734176,3259977,1629988,1629989,GmqQKnMfFxkv6ChqGaZ2wmSFDow7R1x7WeRfU58GVvfw,130399084,743669320,-613270236,624
2021-12-10 11:14:31-05:00,589,7UwBQLT7uc8DFabDUwRBgTCjm2Tprh79HoDwhPCap6v7,CdWQHx3cRLC7ApxXSbVD3D6y2V6vtqQJLMjuhFcdbp4X,True,161019362,40254840,251494,125747,125747,GmqQKnMfFxkv6ChqGaZ2wmSFDow7R1x7WeRfU58GVvfw,10059777,79257948,-69198171,624
2021-12-10 11:16:47-05:00,590,2XFYFxNQbCr5ao4cVzRZt45fsAwZc4jD9XTABmdqaJWd,CvpzBuDjyimaYFGWFkkBcaZGSRtAvtF6MtRV54mqZ74k,True,268574,67143,416,208,208,GmqQKnMfFxkv6ChqGaZ2wmSFDow7R1x7WeRfU58GVvfw,16661,123627,-106966,620
2021-12-10 11:16:58-05:00,591,DVV4Vhk44E5YvVzpXgjJMepYgUB5uKXmAhEbFg6R5vWJ,8CS7rCKNx7AQ5yaEA2rHrYx4PHnC9mK3DtSQmiKW2nUb,True,83356618,20839154,129077,64538,64539,GmqQKnMfFxkv6ChqGaZ2wmSFDow7R1x7WeRfU58GVvfw,5163107,34580481,-29417374,619
2021-12-10 11:16:58-05:00,592,3Ek5j2ea8wS2nCxsNgn2AbovxzJwGK7zc6xarkigSA3u,DEWmTn3Ah4F3nNXpoQLt1GG65Dsf4ZmGjn7FZUJyK6rP,True,611578520,152894630,947300,473650,473650,GmqQKnMfFxkv6ChqGaZ2wmSFDow7R1x7WeRfU58GVvfw,37892004,280503002,-242610998,619
2021-12-10 11:17:00-05:00,593,FP6SmbXDbcb6c8Pi8uZMn6hnQDUbvbdCfzd5pEqyBgTm,53A9dhER1x3JjdceGMQmjujvWht7uemsoB3ngQLdo6Ub,True,409433789,102358447,639061,319530,319531,GmqQKnMfFxkv6ChqGaZ2wmSFDow7R1x7WeRfU58GVvfw,25562440,154416272,-128853832,624
2021-12-10 11:17:11-05:00,594,UW2CpVNGdbJggmssZki77W8jKUKzXG33UHMKpWHdan8,9XWQR558UZHBfGk17D7z69xH2PH9BTFe9kfxSa467sEW,True,137969673,34492418,215791,107895,107896,GmqQKnMfFxkv6ChqGaZ2wmSFDow7R1x7WeRfU58GVvfw,8631648,29915439,-21283791,625
2021-12-10 11:17:15-05:00,595,8d333AWdyiVhvkAdiKCTwhgzaPBMbn8mtucwUC1SAbZZ,3BM8UNLN7XGRaYRjezAqFVMr1z4PS3VRXiN1NAtvBuD9,True,42672480,10668120,66543,33271,33272,GmqQKnMfFxkv6ChqGaZ2wmSFDow7R1x7WeRfU58GVvfw,2661728,18561047,-15899319,623
2021-12-10 11:17:32-05:00,596,J1sBDjpdBZcsSBS5eg95SSRjRqmQUR9cXJCsLJu8yCUt,F5wRpD2senMkGbL8Uquqo8W9x5NQDDa268dHuVFAZCww,True,227282302,56820575,354389,177194,177195,GmqQKnMfFxkv6ChqGaZ2wmSFDow7R1x7WeRfU58GVvfw,14175591,56649392,-42473801,623
2021-12-10 11:17:41-05:00,597,DSEgVqfxXp5wxjn3gNZtmb4E6rJeBm3VcbqdwDnsuzSq,6YVCWznUKheSMPuywSRJgCes7wghPGJXgxfrVfnjN4mB,True,424478412,106119603,657236,328618,328618,GmqQKnMfFxkv6ChqGaZ2wmSFDow7R1x7WeRfU58GVvfw,26289470,129230593,-102941123,619
2021-12-10 11:17:41-05:00,598,9gPrKNWv1QtsESCPUw943xgbjkekLYzfQnByM3hDRw8v,DYYhdA6LaKnRhRP7ut5u9xvoecDSY2TSYnfc2oJjz2MZ,True,64197751,16049437,99393,49696,49697,GmqQKnMfFxkv6ChqGaZ2wmSFDow7R1x7WeRfU58GVvfw,3975739,13928223,-9952484,619
2021-12-10 11:17:41-05:00,599,DCxghVXCXzEar41CPGichdzvtjwmf4NW7uHtKTj57BNN,Fmh5FPdnFb1KpFkoL6eNfWFGxN78GLdaJgPcVpCoCnkh,True,167914103,41978525,261479,130739,130740,GmqQKnMfFxkv6ChqGaZ2wmSFDow7R1x7WeRfU58GVvfw,10459167,59030750,-48571583,622
2021-12-10 11:17:43-05:00,600,8fVwuVA2CL5sZoHh6Dg4MBpcX3cvoUm7mnitnpQSdPBD,4F4ccaNm1KQu29XvsKvdjFkmpsbWqNvXkV41851EYQyu,True,32660823,8165205,50721,25360,25361,GmqQKnMfFxkv6ChqGaZ2wmSFDow7R1x7WeRfU58GVvfw,2028866,12057074,-10028208,621
2021-12-10 11:18:30-05:00,601,8w1hzDtCFuTJqWAtwihztrPzxwa7YrJH5uPk877SJnNj,D3gnctosqTZxTQNfLJQRdPgCvGx2JLLHHDmcvW5UX1QN,True,284291361,71072840,440795,220397,220398,GmqQKnMfFxkv6ChqGaZ2wmSFDow7R1x7WeRfU58GVvfw,17631801,101845954,-84214153,620
2021-12-10 11:18:30-05:00,602,8Xdf67Q5jXKwS52e492xUBu1tMUgS14jJg7V4R2Q28EP,GAPL3bsXP4xcukhgzyqrbDntGwUSm5BfuwJ8TLKkRaZc,True,202631815,50657953,316362,158181,158181,GmqQKnMfFxkv6ChqGaZ2wmSFDow7R1x7WeRfU58GVvfw,12654518,65612227,-52957709,624
2021-12-10 11:18:33-05:00,603,BELLbzmdx1SYke9kZUxFi9VcdvwaHmkZyv24FArQ1J2f,5a5LfKakAaFEVkavVHgExKaUr25RWYpzFic6MUQQ62uc,True,797291306,199322826,1228201,614100,614101,GmqQKnMfFxkv6ChqGaZ2wmSFDow7R1x7WeRfU58GVvfw,49128078,366681049,-317552971,616
2021-12-10 11:18:40-05:00,604,CQSb6ZVY1KVNXFAg8pxm8RvBBGGqRSU7FMvwHJPy46u8,FRBv3b5VTfKN1bK4DXFY4329LFbvm882P47edrgpuSM,True,389765612,97441403,600695,300347,300348,GmqQKnMfFxkv6ChqGaZ2wmSFDow7R1x7WeRfU58GVvfw,24027816,153848541,-129820725,616
2021-12-10 11:19:10-05:00,605,6TWJ8huRvaHdb1Rr9TvV5oNA163kaV8o8dpXoZBrCotK,FB8yfdGootXBhsPpUB6i2cqjweFD2rjtUXg5KHM2zDPs,True,760856348,190214087,1092652,546326,546326,GmqQKnMfFxkv6ChqGaZ2wmSFDow7R1x7WeRfU58GVvfw,43706109,189369850,-145663741,574
2021-12-10 11:19:22-05:00,606,EvSdLa5PeJiaaaE3omJNG7cw1tptZnHTituYswVHSwm3,68ESX2mBsfxQo2U9jsbmHo7TzPTxr9mGH5Y11ZLR7E3A,True,17002316,4250579,26533,13266,13267,GmqQKnMfFxkv6ChqGaZ2wmSFDow7R1x7WeRfU58GVvfw,1061328,7820660,-6759332,624
2021-12-10 11:19:29-05:00,607,94KFzzXCAvEfSf3jrnUpyN3pne8Xfc6nroB7UxTVqeyB,ERQEKcL8qV9WEzLwi5WFjh2wN97q9GD9pqd9umcTypxy,True,1851012,462753,2887,1443,1444,GmqQKnMfFxkv6ChqGaZ2wmSFDow7R1x7WeRfU58GVvfw,115517,760016,-644499,624
2021-12-10 11:19:59-05:00,608,BgoKAyBNaJ1geeQ2FcGSHEQDWATVD3w3wmcNHtj8Awu3,8Haz7duE2ycueaJsGdrGNnK79KGHwnzKBpoafC8RZGg2,True,1766355279,441588819,2724682,1362341,1362341,GmqQKnMfFxkv6ChqGaZ2wmSFDow7R1x7WeRfU58GVvfw,108987294,452139158,-343151864,617
2021-12-10 11:19:59-05:00,609,6Q1rYCUFMg3Jf95EfDtPyK4cKFZ2t3koq64coK6haUjV,7JwejhxWxNP7yYB2utHcbFPz9UEGsEGszd7fvpwEwnq3,True,2038817400,509704350,3178321,1589160,1589161,GmqQKnMfFxkv6ChqGaZ2wmSFDow7R1x7WeRfU58GVvfw,127132851,896031843,-768898992,623
2021-12-10 11:23:03-05:00,610,8soQsYfQCngqJ5gLpWSuuzDUo1YLg53mU6GBF5RBizNn,HdsRtpasJYyFdS3sKqFAwJespt8x7cKUfGuvEuxmWdxV,True,21623764,5405941,33449,16724,16725,GmqQKnMfFxkv6ChqGaZ2wmSFDow7R1x7WeRfU58GVvfw,1337991,6121949,-4783958,618
2021-12-10 11:23:53-05:00,611,64w7jdrK2Kv8Wc55SfKBt7U6paGQ2NRGf31zPFC6Qk8G,3t6zWvFwvvfSFLaEdUoEzZZSW4ykWScvQnQDkTatKKg1,True,6312906,1578226,9806,4903,4903,GmqQKnMfFxkv6ChqGaZ2wmSFDow7R1x7WeRfU58GVvfw,392248,1579375,-1187127,621
2021-12-10 11:23:53-05:00,612,E5KDZriZ89a5D4VsMaWxndMMG68RT4weruJ1tCEc6tSx,CaSwkUocpbyyGCQBgKjJZJgcexbyqs2GTrGJH6EMWXAz,True,1654699545,413674886,2546193,1273096,1273097,GmqQKnMfFxkv6ChqGaZ2wmSFDow7R1x7WeRfU58GVvfw,101847741,658213994,-556366253,615
2021-12-10 11:23:54-05:00,613,7TBoPCDA6BACBPJvpwHVHQh1EeydCHD2KT4TaQ4NWrc3,6GLRsMGMNBA8qf27VGfXyXtTt31J9GUVrqqJM7H2RhwK,True,111074313,27768578,170839,85419,85420,GmqQKnMfFxkv6ChqGaZ2wmSFDow7R1x7WeRfU58GVvfw,6833578,29149402,-22315824,615
2021-12-10 11:23:54-05:00,614,J5WcVsKNHbfioai1LRowvjvtEmUJBEkeoBim1ThshpoP,Ajh7SWBq3zJR4vb6AFoBS6C9D99wC6YF1sVN22qC1vCA,True,193936595,48484148,296069,148034,148035,72FwbpFGoLEazJEdpqNtPNefsadUrimUqma9wSoy4qiS,11842778,48214233,-36371455,610
2021-12-10 12:19:51-05:00,615,FCrgF8s6BHP9Hho11yzZgbSaVXraUxJA3zSEzQK52DFQ,HAikgTkQvmKEseE5mXxVFKe1pyvVmTZePHh4M27YgFDg,True,4377373,1094343,6762,3381,3381,GmqQKnMfFxkv6ChqGaZ2wmSFDow7R1x7WeRfU58GVvfw,270511,893138,-622627,617
2021-12-10 12:19:51-05:00,616,BCGo6RhFcVnLCzZxtEh5YDyfq59nEWXPyJ5STC9PkzA1,24ShUfs1AB1n5NUus99sZ58kuSvMPhVgpiiT56rcLHRk,True,282312134,70578033,437898,218949,218949,GmqQKnMfFxkv6ChqGaZ2wmSFDow7R1x7WeRfU58GVvfw,17515934,61521395,-44005461,620
2021-12-10 12:19:51-05:00,617,3qyKG4juvhcDnhoSVAFibqJtk5i4q8vLVgvwzXtdk5KP,2ofR6Hdm8qgQfKnaNFouzzBs311xgPcxny4ViS7g2Wxo,True,49629177,12407294,75420,37710,37710,GmqQKnMfFxkv6ChqGaZ2wmSFDow7R1x7WeRfU58GVvfw,3016820,12468768,-9451948,607
2021-12-10 12:19:51-05:00,618,DH2tcZVt4nHQbph6znZRrwcyhjwiNYtgeamu72vcC6nR,ACsbP5BDFQEHQHTsdrWTBShhEUh9HeAKsE7iwyK72v2p,True,59236658,14809164,91688,45844,45844,GmqQKnMfFxkv6ChqGaZ2wmSFDow7R1x7WeRfU58GVvfw,3667543,15360509,-11692966,619
2021-12-10 12:19:51-05:00,619,6woJkgUd2cpQQQBEp1C2G9NsYAvPwYmZXXTd6AxhieMy,E6xCdLJbDq5qFsvHEffD1Qfqrsj19H81mbj7XMUXUPnr,True,1225778138,306444534,1913951,956975,956976,GmqQKnMfFxkv6ChqGaZ2wmSFDow7R1x7WeRfU58GVvfw,76558075,313132071,-236573996,624
2021-12-10 12:20:49-05:00,620,D58t4uTjFumsUeYFaKnpV8BRTEQEqKXBreFTdwGrott7,67p6kHDfVqQijfcwugvZK59c3aRRH9x3eHxruqH8WEqF,True,64975895,16243973,100292,50146,50146,72FwbpFGoLEazJEdpqNtPNefsadUrimUqma9wSoy4qiS,4011681,13355402,-9343721,617
2021-12-10 12:20:49-05:00,621,2hffMTM4DWHvJndYsT5pMMqS8PcyEyqVU9nGA73ozRRB,5BMxbZHCQaBxXcJvpZM33G2pyvp7pJMqAREooPWnMQdB,False,937106142,937106142,31067117,1553355,29513762,72FwbpFGoLEazJEdpqNtPNefsadUrimUqma9wSoy4qiS,31067117,207769355,-176702238,331
2021-12-10 12:20:49-05:00,622,FgQ1T5Jdtb9hGAv8VnArbNATkPnoNAE3kh89AuRAghmm,ZCcEop7zQrFmzrSVMTSJ64sabtjWNKYNmx5q8C68LZk,False,430545905,430545905,11536973,576848,10960125,72FwbpFGoLEazJEdpqNtPNefsadUrimUqma9wSoy4qiS,11536973,99455158,-87918185,267
2021-12-10 12:20:49-05:00,623,8soQsYfQCngqJ5gLpWSuuzDUo1YLg53mU6GBF5RBizNn,HdsRtpasJYyFdS3sKqFAwJespt8x7cKUfGuvEuxmWdxV,False,15513692,15513692,597352,29867,567485,72FwbpFGoLEazJEdpqNtPNefsadUrimUqma9wSoy4qiS,597352,4889488,-4292136,385
2021-12-10 12:20:49-05:00,624,7gxTghaVZPNNwaNEdtQHh4QDCJ4JgigYMd4MMCC9VtFo,4ZZTUrm4jX1jqqTYVFJ9TJQ2BLx2eZgXesmoon1LBa1a,False,3614059,3614059,108893,5444,103449,72FwbpFGoLEazJEdpqNtPNefsadUrimUqma9wSoy4qiS,108893,1237815,-1128922,301
2021-12-10 12:20:49-05:00,625,94KFzzXCAvEfSf3jrnUpyN3pne8Xfc6nroB7UxTVqeyB,ERQEKcL8qV9WEzLwi5WFjh2wN97q9GD9pqd9umcTypxy,False,1326262,1326262,50372,2518,47854,72FwbpFGoLEazJEdpqNtPNefsadUrimUqma9wSoy4qiS,50372,595745,-545373,379
2021-12-10 12:20:49-05:00,626,6HzCJnV3Z4psm7V64UpJBstZxK2XAxUySyuoX8RJaFwY,2AsimTXANwSRChLJWdLjdJG8X2gwGsrjPguqFZjuAeA9,False,844540921,844540921,37594706,1879735,35714971,72FwbpFGoLEazJEdpqNtPNefsadUrimUqma9wSoy4qiS,37594706,185217942,-147623236,445
2021-12-10 12:20:49-05:00,627,E4VbQS7DPAs2DEZQhJ3zmHyXQPC5juU7XqLmSabjiPxy,2Va5k3pVPrEAtcVTz37hKGyrS9uszw79ngrJVxkfo6w7,False,312088832,312088832,12559169,627958,11931211,72FwbpFGoLEazJEdpqNtPNefsadUrimUqma9wSoy4qiS,12559169,150469337,-137910168,402
2021-12-10 12:20:49-05:00,628,Hp4bpHhSds7eMRmW1wpCg8HPUKk5vdRJt9Wm1axJgbcG,5sPxP3PAUqWr5FuHY1kUTz5u1J4pvVB95L1rbxepS2S6,False,270212,270212,7459,372,7087,72FwbpFGoLEazJEdpqNtPNefsadUrimUqma9wSoy4qiS,7459,86461,-79002,276
2021-12-10 12:20:51-05:00,629,UW2CpVNGdbJggmssZki77W8jKUKzXG33UHMKpWHdan8,9XWQR558UZHBfGk17D7z69xH2PH9BTFe9kfxSa467sEW,False,98503009,98503009,3422190,171109,3251081,72FwbpFGoLEazJEdpqNtPNefsadUrimUqma9wSoy4qiS,3422190,24359882,-20937692,347
2021-12-10 12:20:52-05:00,630,7jvKp6onXyWgwsFrFWj4hYTXJsYYD6ot5mn6rPFuJriy,J7N6HiozevJVTiY9hDEUs2ud5BwT5QSE7wnMBS1w5ie2,True,2834528547,708632136,4295795,2147897,2147898,72FwbpFGoLEazJEdpqNtPNefsadUrimUqma9wSoy4qiS,171831839,712316774,-540484935,606
2021-12-10 12:20:52-05:00,631,3fB955q6xxxZcgnCyguLwkSa7egxgBoksPQVQ3U8HRHL,GK7cTdhfSpapJB8dFzEkV8c1UFkJPj281DwztnpKjxLx,False,32674392,32674392,868476,43423,825053,72FwbpFGoLEazJEdpqNtPNefsadUrimUqma9wSoy4qiS,868476,18041845,-17173369,265
2021-12-10 12:20:52-05:00,632,64w7jdrK2Kv8Wc55SfKBt7U6paGQ2NRGf31zPFC6Qk8G,3t6zWvFwvvfSFLaEdUoEzZZSW4ykWScvQnQDkTatKKg1,False,4540501,4540501,187368,9368,178000,72FwbpFGoLEazJEdpqNtPNefsadUrimUqma9wSoy4qiS,187368,1271948,-1084580,412
2021-12-10 12:20:52-05:00,633,9kK2PuehQxgcXtnYnPNmukmzfDTsVHv15pE86xwi7vYt,DtbCSCur1w6ZMGu56auQaHf8c6gVDJoD1iEwiUyCBcYJ,False,3501061,3501061,84099,4204,79895,72FwbpFGoLEazJEdpqNtPNefsadUrimUqma9wSoy4qiS,84099,1650969,-1566870,240
2021-12-10 12:20:52-05:00,634,DCTeYphaDsdFWZ61JXusR3dwLqKWkYgCjkxZSQvPzRuK,4jrC1EU7WC2vAPZdhnWyb39nK1XacNv32tPgsuK4MVn6,False,10538824257,10538824257,406158025,20307901,385850124,72FwbpFGoLEazJEdpqNtPNefsadUrimUqma9wSoy4qiS,406158025,2366071269,-1959913244,385
2021-12-10 12:20:52-05:00,635,CQSb6ZVY1KVNXFAg8pxm8RvBBGGqRSU7FMvwHJPy46u8,FRBv3b5VTfKN1bK4DXFY4329LFbvm882P47edrgpuSM,False,278292181,278292181,9340047,467002,8873045,72FwbpFGoLEazJEdpqNtPNefsadUrimUqma9wSoy4qiS,9340047,120742973,-111402926,335
2021-12-10 12:20:52-05:00,636,3cL7zgQV5KP7iv83P3xHMGQaPBFcf2p3gWHu7oWg2wAr,G8m6Tv9LKASkqYQdYJWzt7kFLrBQrRiCjHUCVsSCAL9w,False,84006532,84006532,3000351,150017,2850334,72FwbpFGoLEazJEdpqNtPNefsadUrimUqma9wSoy4qiS,3000351,18983719,-15983368,357
2021-12-10 12:20:52-05:00,637,FpqCxvTkSiwDwD5qEt6hXJxzFDLFLAQ8VevK8zwRqYun,A3p6YQisCJKpNkF7vkjZRbEfbnUt7vTZdR2zPBUSdTkk,False,24689211,24689211,602221,30111,572110,72FwbpFGoLEazJEdpqNtPNefsadUrimUqma9wSoy4qiS,602221,12091189,-11488968,243
2021-12-10 12:20:52-05:00,638,93ho4cgnpAJiJsG6uu2udkLVNU7rkz4QjCYfsqvpbPA5,45ouQn9gGwXqnTGfaP5CvU8fCKadBRA5kPwtfvJzykRU,True,744153306,186038326,980204,490102,490102,72FwbpFGoLEazJEdpqNtPNefsadUrimUqma9wSoy4qiS,39208193,192490460,-153282267,526
2021-12-10 12:20:53-05:00,639,6oRHRnLX93bYeTN5YD2XHqskhbv8wN2pgSia9Kz3QkED,D6QG2KYp9vYZZe8tTZux5tDR6fXgm8k4SVWbpaPvEmZ1,False,40046391,40046391,847277,42363,804914,72FwbpFGoLEazJEdpqNtPNefsadUrimUqma9wSoy4qiS,847277,12923493,-12076216,211
2021-12-10 12:20:53-05:00,640,DSEgVqfxXp5wxjn3gNZtmb4E6rJeBm3VcbqdwDnsuzSq,6YVCWznUKheSMPuywSRJgCes7wghPGJXgxfrVfnjN4mB,False,302535717,302535717,9749293,487464,9261829,72FwbpFGoLEazJEdpqNtPNefsadUrimUqma9wSoy4qiS,9749293,102784140,-93034847,322
2021-12-10 12:20:53-05:00,641,7TBoPCDA6BACBPJvpwHVHQh1EeydCHD2KT4TaQ4NWrc3,6GLRsMGMNBA8qf27VGfXyXtTt31J9GUVrqqJM7H2RhwK,False,79638217,79638217,2979466,148973,2830493,72FwbpFGoLEazJEdpqNtPNefsadUrimUqma9wSoy4qiS,2979466,23384272,-20404806,374
2021-12-10 12:20:53-05:00,642,6Q1rYCUFMg3Jf95EfDtPyK4cKFZ2t3koq64coK6haUjV,7JwejhxWxNP7yYB2utHcbFPz9UEGsEGszd7fvpwEwnq3,False,1457062591,1457062591,51615751,2580787,49034964,72FwbpFGoLEazJEdpqNtPNefsadUrimUqma9wSoy4qiS,51615751,700490529,-648874778,354
2021-12-10 12:20:53-05:00,643,7WB5fc5DQAWYBSgc11KfWa4kpThfyaoxp49kFGELCQMj,4qD4BkxDzJ6uZ2iKgsXZtghNbNsnHmaKyjGWLZW9YTdU,False,17440972,17440972,509953,25497,484456,72FwbpFGoLEazJEdpqNtPNefsadUrimUqma9wSoy4qiS,509953,5274457,-4764504,292
2021-12-10 12:20:53-05:00,644,B5CTBTggmGFvGFSunjbB4C9tLKcYcULehmEiEXRihY2J,FX3ebF8P89rZBWfR74PDWUzxnLuDkUDgGcPYCBD5sMUG,False,58457320,58457320,1885942,94297,1791645,72FwbpFGoLEazJEdpqNtPNefsadUrimUqma9wSoy4qiS,1885942,13440545,-11554603,322
2021-12-10 12:20:53-05:00,645,49hagnoMSB3ozBBMaTgeZ2nwEbKKS3NZWUuPShMBUwp9,6ivAhvY6bUr98jqBp4ye1w8Vz8NesEubqKDSn1jeqxmr,False,59083319,59083319,2480351,124017,2356334,72FwbpFGoLEazJEdpqNtPNefsadUrimUqma9wSoy4qiS,2480351,15690983,-13210632,419
2021-12-10 12:20:53-05:00,646,HnUkyFhntoajDEgXMKeoh4nAuY5y7osLYwmYAApyLSNs,GntEkHxrGpcHFCVLQGjKiXWdenbsqfQgxddpEpxpE65z,False,9947320,9947320,196744,9837,186907,72FwbpFGoLEazJEdpqNtPNefsadUrimUqma9wSoy4qiS,196744,4264254,-4067510,197
2021-12-10 12:20:53-05:00,647,3ufE8ZossNvypfLHuvbYMGyrAwKk7CUShTFqfpkjsCFB,DKF6tQstSHpxM9QTUCt6yU1iFZrRiXodRSZd9pSYBJN9,True,466563677,116640919,621535,310767,310768,72FwbpFGoLEazJEdpqNtPNefsadUrimUqma9wSoy4qiS,24861404,102770250,-77908846,532
2021-12-10 12:20:53-05:00,648,EvSdLa5PeJiaaaE3omJNG7cw1tptZnHTituYswVHSwm3,68ESX2mBsfxQo2U9jsbmHo7TzPTxr9mGH5Y11ZLR7E3A,False,12139665,12139665,420321,21016,399305,72FwbpFGoLEazJEdpqNtPNefsadUrimUqma9wSoy4qiS,420321,6101949,-5681628,346
2021-12-10 12:20:53-05:00,649,7uzNVopRjtoGCPz2CZPd88S6iLaXox1s1j3DAJE3YLSY,4HBjxtkRLW4bL6R6s5HpyUfk5FqQoQUsy9mLq3zKdc2M,False,7976688781,7976688781,161361796,8068089,153293707,72FwbpFGoLEazJEdpqNtPNefsadUrimUqma9wSoy4qiS,161361796,2056813071,-1895451275,202
2021-12-10 12:20:55-05:00,650,3XzkSrNTGd3Fhd4M3gYzvz2utbQpFN1fhtbAaZu7C39R,GMsZGGfktTzYi7GhD3W6HY9QY9bznqTKfeArksikLE71,False,1722105,1722105,59523,2976,56547,72FwbpFGoLEazJEdpqNtPNefsadUrimUqma9wSoy4qiS,59523,790183,-730660,345
2021-12-10 12:20:55-05:00,651,6H9q1kvPwD2ZxS5ir2EDWF4RjH31Qto5fj3KUjirPSXq,5a3JtjtVmE1UEiHs5cv9YVzWKyayj2SumGiB6YeDZKVh,False,131353567,131353567,4988113,249405,4738708,72FwbpFGoLEazJEdpqNtPNefsadUrimUqma9wSoy4qiS,4988113,28618891,-23630778,379
2021-12-10 12:20:56-05:00,652,BELLbzmdx1SYke9kZUxFi9VcdvwaHmkZyv24FArQ1J2f,5a5LfKakAaFEVkavVHgExKaUr25RWYpzFic6MUQQ62uc,False,571941074,571941074,21759869,1087993,20671876,72FwbpFGoLEazJEdpqNtPNefsadUrimUqma9wSoy4qiS,21759869,285975322,-264215453,380
2021-12-10 12:20:59-05:00,653,9gPrKNWv1QtsESCPUw943xgbjkekLYzfQnByM3hDRw8v,DYYhdA6LaKnRhRP7ut5u9xvoecDSY2TSYnfc2oJjz2MZ,False,45975854,45975854,1694835,84741,1610094,72FwbpFGoLEazJEdpqNtPNefsadUrimUqma9wSoy4qiS,1694835,11331811,-9636976,368
2021-12-10 12:20:59-05:00,654,G7kJUwq3DhEH6zhaeToRFMTKBEH3ME45hbqmrHbQD1nP,JmGGddHjC5bSieVcDn3sMeRBLryEhQKJmmtnkWza66L,False,252458954,252458954,6120228,306011,5814217,72FwbpFGoLEazJEdpqNtPNefsadUrimUqma9wSoy4qiS,6120228,62818907,-56698679,242
2021-12-10 12:20:59-05:00,655,EwXuWCu3Y5p2HUSHa6PvqDrtx84YCKnQ6qaMQ6ZX97y4,2Ah5UrJc8fJb3aouTH2Afv2zDsvQfJU2NoWiodepqWJV,False,31535335870,31535335870,1269217711,63460885,1205756826,72FwbpFGoLEazJEdpqNtPNefsadUrimUqma9wSoy4qiS,1269217711,9745439249,-8476221538,402
2021-12-10 12:20:59-05:00,656,EDE1swNYZ99y9idZacAw5Ncwz2DyD78SqvKMUXA2Dbw4,HSmYYMpNQNr1F2zjvysGRrC57FyusAJNsaXWfbmCfZh4,False,7270230,7270230,153385,7669,145716,72FwbpFGoLEazJEdpqNtPNefsadUrimUqma9wSoy4qiS,153385,4066767,-3913382,210
2021-12-10 12:20:59-05:00,657,BC5PbNKwQoyH6tU7HAX4iLnuG7zUHc2QjSDkYLCsdhGx,Eu38e4GbPPtqtHpXgy9cwTn8MBLBPBjprGv1wv4L2evR,False,373868710,373868710,9291315,464565,8826750,72FwbpFGoLEazJEdpqNtPNefsadUrimUqma9wSoy4qiS,9291315,86634158,-77342843,248
2021-12-10 12:20:59-05:00,658,8w4uRzN81cghupkF7jNLinGLtCqYwNQFgQtdJfC5so7z,BbbRkq85fYEBGmuxBEEPbt6up4GNB7WQ83VSXwe4ro98,False,1477350501,1477350501,38993541,1949677,37043864,72FwbpFGoLEazJEdpqNtPNefsadUrimUqma9wSoy4qiS,38993541,586945592,-547952051,263
2021-12-10 12:20:59-05:00,659,EDSf2w1UyGvbgMuxyoXL58ifR1dviZinnLBYnFmgjcNG,DFenkzbL9SUjs9cSCaHJ1eXK75mHfk3GSPRFs8TSzrFV,False,47373705,47373705,878230,43911,834319,72FwbpFGoLEazJEdpqNtPNefsadUrimUqma9wSoy4qiS,878230,21787027,-20908797,185
2021-12-10 12:20:59-05:00,660,9WyHRAB1rNAWcb1SzNRsAVgxaYoVCLeFZGEX93jsftcK,8fM8LBrUCEjtXitNNU1MvvqEQy4M6DNdrMRpNf3E3wPr,False,1247620959,1247620959,58914909,2945745,55969164,72FwbpFGoLEazJEdpqNtPNefsadUrimUqma9wSoy4qiS,58914909,390610188,-331695279,472
2021-12-10 12:20:59-05:00,661,7BY59PkXpdNQBwBAUte9icDDzB9H7pUWpG92DDtb5bQp,7Vp4w3nAdypxFAbZsq9CyLi83GM4z1rXPkrwUvPkP6XE,True,292003756,73000939,371786,185893,185893,72FwbpFGoLEazJEdpqNtPNefsadUrimUqma9wSoy4qiS,14871451,65134328,-50262877,509
2021-12-10 12:21:00-05:00,662,8w1hzDtCFuTJqWAtwihztrPzxwa7YrJH5uPk877SJnNj,D3gnctosqTZxTQNfLJQRdPgCvGx2JLLHHDmcvW5UX1QN,False,201788893,201788893,5721262,286063,5435199,72FwbpFGoLEazJEdpqNtPNefsadUrimUqma9wSoy4qiS,5721262,80314283,-74593021,283
2021-12-10 12:21:00-05:00,663,6eNfcSNvCuHs81L6nJcWHZjuc1ZUimLKHrhMh4LFsPi7,8DYdD73cQgw21P1QmiCAQWYrU5yG5K72yKjokzDLNcs8,False,78591525,78591525,1303687,65184,1238503,72FwbpFGoLEazJEdpqNtPNefsadUrimUqma9wSoy4qiS,1303687,17702567,-16398880,165
2021-12-10 12:21:01-05:00,664,CrVwfwqXiECyR4PMHs3ZiibPmEpRnJFdtG2wDEBAUDB7,H3VLpUgvEpQXkBsEQu6Rzcan9gESe8w7LDFzfQbxhmME,False,138565075,138565075,3958498,197924,3760574,72FwbpFGoLEazJEdpqNtPNefsadUrimUqma9wSoy4qiS,3958498,30484757,-26526259,285
2021-12-10 12:21:01-05:00,665,Gbxc51WERLLeCtiHv7rDvE52aqF541RoQWG5n5aqErq6,4ngBoHbfXijLMqGKxFMNht9sbmxy2g5eqBmn8QsBmbx1,True,64891947,16222986,93839,46919,46920,72FwbpFGoLEazJEdpqNtPNefsadUrimUqma9wSoy4qiS,3753581,13487223,-9733642,578
2021-12-10 12:21:01-05:00,666,EBUcTqh9AYyRokZRzLbPKL9ZmTUx6KcDEbBeuCLGwqYC,B5WSXfHzYQhUFE2T97GaiqSkeejTWKKGVjMkcFrxEvyJ,False,32753233,32753233,770210,38510,731700,72FwbpFGoLEazJEdpqNtPNefsadUrimUqma9wSoy4qiS,770210,7387445,-6617235,235
2021-12-10 12:21:01-05:00,667,4DFa7jRrs71bUCbkpD19kWJG8RU6z58ymgG47NhuP6gC,7jvKYqZ5QU44VqsgRJiptmrvPf5A3XJ1EWkXUqxNGv1d,True,21432861,5358215,28810,14405,14405,72FwbpFGoLEazJEdpqNtPNefsadUrimUqma9wSoy4qiS,1152426,4717040,-3564614,537
2021-12-10 12:21:01-05:00,668,ARVhD7UsVWatKbNfjebsG5wpttsknLxpSbfQgrAedJdk,5Ysnmna1DVUhAA8syzSCzQ2snhnQvyXN9ShjeN95LJeP,False,208919221,208919221,10184699,509234,9675465,72FwbpFGoLEazJEdpqNtPNefsadUrimUqma9wSoy4qiS,10184699,101264478,-91079779,487
2021-12-10 12:21:03-05:00,669,66SjFhmiNYz8tLRnBhZUbowWGTbM16G52X3AT2hma2wN,3wVy8nk24HCFZWMiacGe8QsJquYaadZ9pQg44bGRwdE3,False,10040900,10040900,226509,11325,215184,72FwbpFGoLEazJEdpqNtPNefsadUrimUqma9wSoy4qiS,226509,5415824,-5189315,225
2021-12-10 12:21:03-05:00,670,BtUb2aiZEXz89D8KgduJDt4SeLDuQeociXcAfey3sK7r,B4ZCTjVxHvAqSb4GqVWdan6qoSLVnYdq8KbUPbYMiz6v,False,4190581896,4190581896,200390776,10019538,190371238,72FwbpFGoLEazJEdpqNtPNefsadUrimUqma9wSoy4qiS,200390776,1195089397,-994698621,478
2021-12-10 12:21:03-05:00,671,C24que1C7tC3ysDSKhcBTF9NUnjiNhSanWp8Go5FRRb8,hgm3qRRG2njhNPWcUp9UnEU8pyg4gLaR2K13r4Lsqxm,False,138633389,138633389,3210208,160510,3049698,72FwbpFGoLEazJEdpqNtPNefsadUrimUqma9wSoy4qiS,3210208,54439650,-51229442,231
2021-12-10 12:21:05-05:00,672,8jmTkoNA5LM3xnsV2E1RRUegxYb8TospBNRbupaCeLF8,36LmDVFR5fgAYxgqhAtToJmRmYqYt5sVtUBkDQ3xmXhT,False,2227437,2227437,48743,2437,46306,72FwbpFGoLEazJEdpqNtPNefsadUrimUqma9wSoy4qiS,48743,682951,-634208,218
2021-12-10 12:21:06-05:00,673,7UwBQLT7uc8DFabDUwRBgTCjm2Tprh79HoDwhPCap6v7,CdWQHx3cRLC7ApxXSbVD3D6y2V6vtqQJLMjuhFcdbp4X,False,113898557,113898557,2919674,145983,2773691,72FwbpFGoLEazJEdpqNtPNefsadUrimUqma9wSoy4qiS,2919674,61685253,-58765579,256
2021-12-10 12:21:08-05:00,674,3Ek5j2ea8wS2nCxsNgn2AbovxzJwGK7zc6xarkigSA3u,DEWmTn3Ah4F3nNXpoQLt1GG65Dsf4ZmGjn7FZUJyK6rP,False,433024839,433024839,11199561,559978,10639583,72FwbpFGoLEazJEdpqNtPNefsadUrimUqma9wSoy4qiS,11199561,218830572,-207631011,258
2021-12-10 12:21:08-05:00,675,7iUx7JBwqUvPVPeCqMEXQdLccZJmaFYm1DUQiu3ouHa3,3EVZzhRmJnX9ZiBZZo9tenDtMogAyuA1yf2cKzvUWiuu,True,73675782,18418945,105980,52990,52990,72FwbpFGoLEazJEdpqNtPNefsadUrimUqma9wSoy4qiS,4239215,15570745,-11331530,575
2021-12-10 12:21:08-05:00,676,2XFYFxNQbCr5ao4cVzRZt45fsAwZc4jD9XTABmdqaJWd,CvpzBuDjyimaYFGWFkkBcaZGSRtAvtF6MtRV54mqZ74k,False,190201,190201,4978,248,4730,72FwbpFGoLEazJEdpqNtPNefsadUrimUqma9wSoy4qiS,4978,96442,-91464,261
2021-12-10 12:21:08-05:00,677,775ANAGx3kyFQV6YHvQXmfA7gB6DFkyojsQZXVdF4vwr,AzCb6gcTAdQLC3XKYDP3VwhHivXcURRCDfZ2cb81A6Kq,False,34090094668,34090094668,1670198430,83509921,1586688509,72FwbpFGoLEazJEdpqNtPNefsadUrimUqma9wSoy4qiS,1670198430,7738053683,-6067855253,489
2021-12-10 12:21:10-05:00,678,8djD77wbxqJCCesESU7EgPJsk4tq7KGDi5EQgXon6H49,AFZo239G3pF5EMHWMJa77SZbC7KeUr5qxc34gUBBis1J,False,437513404,437513404,16017484,800874,15216610,72FwbpFGoLEazJEdpqNtPNefsadUrimUqma9wSoy4qiS,16017484,101591892,-85574408,366
2021-12-10 12:21:10-05:00,679,EFHg5FatMRRSZnKJPJF9e1iw2cjPJRmwTTZYtkHno9DP,84LnLKhZDJgWFnbBYnYjqWkjymemXfidecPFwnUAvuFj,False,1398262768,1398262768,7280688,364034,6916654,72FwbpFGoLEazJEdpqNtPNefsadUrimUqma9wSoy4qiS,7280688,560069576,-552788888,52
2021-12-10 12:21:10-05:00,680,DfAra3qDA5bmgteTWxUzuFkw9ovSwKVeUhPQkaVxwPvF,CYU9XqGkGpkPm9KzNU5Kc2xBfcmi8kAaD6FBhPfY5xcc,False,3711647397,3711647397,88672799,4433639,84239160,72FwbpFGoLEazJEdpqNtPNefsadUrimUqma9wSoy4qiS,88672799,1214167504,-1125494705,238
2021-12-10 12:21:10-05:00,681,2Qz9cDjDujf5jxvnAcnNks567iD1cEndStmjaK8e8wCe,3863f1FRuKKXZ1sJFd3eVzj4Ddhuw2qMtkxKRLX9PRYB,False,396639063,396639063,2211236,110561,2100675,72FwbpFGoLEazJEdpqNtPNefsadUrimUqma9wSoy4qiS,2211236,90523188,-88311952,55
2021-12-10 12:21:10-05:00,682,JCQKDnPvyHnk9a99k8HqR97iW6QjUvAYnkAJs8hJQ2dg,CcZaAvUVdTj6p3kYEoEknnbEspjiNz1nkLbZKL32CUQW,False,20863332066,20863332066,688331686,34416584,653915102,72FwbpFGoLEazJEdpqNtPNefsadUrimUqma9wSoy4qiS,688331686,4822474622,-4134142936,329
2021-12-10 12:21:10-05:00,683,HEFpdWLZaiQnjftmXgxs6RNzhH72YiMjortxPkKekkvb,5Q8mmxBgVTijNGrWsnoA3VMArLHZEX5MkaigYXHpgXHE,False,65885299,65885299,3206929,160346,3046583,72FwbpFGoLEazJEdpqNtPNefsadUrimUqma9wSoy4qiS,3206929,13759855,-10552926,486
2021-12-10 12:21:11-05:00,684,FSduW743jAGyyn8HTifEJitgb89Spp5gEeMXDE59aEHF,HjojGNpR3ACtLCP2mP8DKGyXj6SeqWPKjcCAofcyQpsm,False,450628875,450628875,930796,46539,884257,72FwbpFGoLEazJEdpqNtPNefsadUrimUqma9wSoy4qiS,930796,144039526,-143108730,20
2021-12-10 12:21:13-05:00,685,FP6SmbXDbcb6c8Pi8uZMn6hnQDUbvbdCfzd5pEqyBgTm,53A9dhER1x3JjdceGMQmjujvWht7uemsoB3ngQLdo6Ub,False,285007715,285007715,2798115,139905,2658210,72FwbpFGoLEazJEdpqNtPNefsadUrimUqma9wSoy4qiS,2798115,121511955,-118713840,98
2021-12-10 12:21:15-05:00,686,DVV4Vhk44E5YvVzpXgjJMepYgUB5uKXmAhEbFg6R5vWJ,8CS7rCKNx7AQ5yaEA2rHrYx4PHnC9mK3DtSQmiKW2nUb,False,58015622,58015622,520455,26022,494433,72FwbpFGoLEazJEdpqNtPNefsadUrimUqma9wSoy4qiS,520455,27085628,-26565173,89
2021-12-10 12:21:15-05:00,687,2JH43pKUeXTXPd6LnL4BWgGQpwZHhX8EqyohKCFLAS4i,Bir3EKnDWkv6XX7KmoqAi1y6rxSaC5RfVV6Hwvnkfr2i,False,9090595,9090595,53231,2661,50570,72FwbpFGoLEazJEdpqNtPNefsadUrimUqma9wSoy4qiS,53231,3642611,-3589380,58
2021-12-10 12:21:16-05:00,688,8Xdf67Q5jXKwS52e492xUBu1tMUgS14jJg7V4R2Q28EP,GAPL3bsXP4xcukhgzyqrbDntGwUSm5BfuwJ8TLKkRaZc,False,141381599,141381599,1717300,85865,1631435,72FwbpFGoLEazJEdpqNtPNefsadUrimUqma9wSoy4qiS,1717300,52029266,-50311966,121
2021-12-10 12:21:16-05:00,689,29JVska5UEG3axs63EmtHpPvkswNEqYpZ3PKMSfupiAG,DCftNBUsuogxyaJe9G9m3eWipH6o3qo4Rn4TuQXdVaBF,False,174455345,174455345,4467911,223395,4244516,72FwbpFGoLEazJEdpqNtPNefsadUrimUqma9wSoy4qiS,4467911,40012566,-35544655,256
2021-12-10 12:21:16-05:00,690,3r4x7wkHNge6PBnKFQo45KUihUpTAgjWB72vKZEseTs4,1hsPi4ReN3nTPqxETBE697KALqcqo5Dh3HnPaoLS1Sq,False,36819752,36819752,446261,22313,423948,72FwbpFGoLEazJEdpqNtPNefsadUrimUqma9wSoy4qiS,446261,8621964,-8175703,121
2021-12-10 12:21:16-05:00,691,81GV2H9ipJSZD6YpJGj2XQNfoUroWWnKfwMHGSwvhixd,7cLHoNuNVj8qkn3QmBYLFwja37f1MWEo4e3ZcNSpXTPw,False,857556826,857556826,5680641,284032,5396609,72FwbpFGoLEazJEdpqNtPNefsadUrimUqma9wSoy4qiS,5680641,292916685,-287236044,66
2021-12-10 12:21:16-05:00,692,iiAw2xrR4TyAfuUbbSKWNJzxPjfcXVBtx2GKDCbA6LM,2sFNTdu2SmmpTFUjzZnqwKrDbnAhKFN3xCLZjPzgd8Pa,False,77846862,77846862,1064068,53203,1010865,72FwbpFGoLEazJEdpqNtPNefsadUrimUqma9wSoy4qiS,1064068,18207611,-17143543,136
2021-12-10 12:21:16-05:00,693,4xsYjVsPm2C2itNtJb3NYkBp4WySHUwtSbWdu9fge8wz,8zu2jMoTndZpf9khY9PMhve88LRwrKNTuVuLpa5ss8qo,False,126931678,126931678,954611,47730,906881,72FwbpFGoLEazJEdpqNtPNefsadUrimUqma9wSoy4qiS,954611,61818372,-60863761,75
2021-12-10 12:21:16-05:00,694,AaMCg49sJwNtdB5wHACg15TYAzzJXy8xtG4zuVXhKiVE,HbDYqDa9bewGPvsiaHRM9HmEvh1scPaUaGvqog66gYir,True,63417579,15854394,82302,41151,41151,72FwbpFGoLEazJEdpqNtPNefsadUrimUqma9wSoy4qiS,3292080,12905245,-9613165,519
2021-12-10 12:21:16-05:00,695,2xu5Vz1x3SpuxdhBVr1HQDPj5pyWD1FWBMdcGyAjkJYV,57MievWg8GXop9c213H2ivXMHkm1HyMgx8DUTNXoCUpt,False,2539132810,2539132810,40850429,2042521,38807908,72FwbpFGoLEazJEdpqNtPNefsadUrimUqma9wSoy4qiS,40850429,701241107,-660390678,160
2021-12-10 12:21:16-05:00,696,5W6PdHtcFCSFHWKNBX7JGgjGKt43A5j7kmmy1TY9SicJ,FynUWXgGoMu1bnUFtGwzH6DVRhhBnKvH29jWrWYu7iYm,False,8259604,8259604,90228,4511,85717,72FwbpFGoLEazJEdpqNtPNefsadUrimUqma9wSoy4qiS,90228,3829412,-3739184,109
2021-12-10 12:21:16-05:00,697,DCxghVXCXzEar41CPGichdzvtjwmf4NW7uHtKTj57BNN,Fmh5FPdnFb1KpFkoL6eNfWFGxN78GLdaJgPcVpCoCnkh,False,116926806,116926806,1165242,58262,1106980,72FwbpFGoLEazJEdpqNtPNefsadUrimUqma9wSoy4qiS,1165242,46603710,-45438468,99
2021-12-10 12:21:16-05:00,698,4AB6iMAC1Un3azYSR5SYnaWGisGDVHmL1ts2Xh9HTB66,4BTwjwGqfw2xB9KCu87qRLrBrEmNoKcc6DfLzebUtZ8T,False,27535681,27535681,262553,13127,249426,72FwbpFGoLEazJEdpqNtPNefsadUrimUqma9wSoy4qiS,262553,10793120,-10530567,95
2021-12-10 12:21:16-05:00,699,EQYUWtYbtvN9C9ixiupXPjHyFWHsYa7dUh4DSd6rxbzt,iS616uGNCwCxP1taAvvdvA2KdqfXRSjcQWwZRUgBkLb,False,3200669,3200669,16534,826,15708,72FwbpFGoLEazJEdpqNtPNefsadUrimUqma9wSoy4qiS,16534,1652383,-1635849,51
2021-12-10 12:21:16-05:00,700,CBEv8v9XZrgFT8UdEdd813XnRVv9R7GB5PLMyG8UWGC8,4uNcMEcQpJdThpisgNrttkQJTUFTsjEr25qgjkm4titC,False,94059597,94059597,0,0,0,GmqQKnMfFxkv6ChqGaZ2wmSFDow7R1x7WeRfU58GVvfw,0,53261408,-53458552,0
2021-12-10 12:21:16-05:00,701,A9BZ5kjh7iKu7SMzA5WUF31Zst9V7fehwDZaoKs4NpSi,3FzwTaT5LYucvoGGcRVXu5AUDnGHADv6yGqrBT6jEtvH,False,133671777,133671777,406143,20307,385836,72FwbpFGoLEazJEdpqNtPNefsadUrimUqma9wSoy4qiS,406143,54530164,-54124021,30
2021-12-10 12:21:16-05:00,702,57GUgfEp9ZQ5iAU2nx1Z2Tiz3gqq7yBNaqfE1cvxjFYt,98upivFa9Tdy3RZHGM1i2k5zeczaGqioq3rTzc3DMf4x,False,35448571,35448571,160071,8003,152068,72FwbpFGoLEazJEdpqNtPNefsadUrimUqma9wSoy4qiS,160071,17877936,-17717865,45
2021-12-10 12:21:16-05:00,703,BcFk9XUrzJRvxe3LPE5go95n7ALfu2yM8SXDm7BYHvzZ,3T6sS2uz9dd8VR8AB88VYtke88PEsoJ711EDHCCR9Ahk,False,298188692,298188692,7955346,397767,7557579,72FwbpFGoLEazJEdpqNtPNefsadUrimUqma9wSoy4qiS,7955346,65491207,-57535861,266
2021-12-10 12:21:16-05:00,704,2bovNUkndmEk62WDwvaWJMbSP63pUvQUattkbq54YLqh,FBvEdMGmwT7b3JCKKXVJoaHxdx1k8cWDeWqaZaik4Vec,False,41045591,41045591,1299633,64981,1234652,72FwbpFGoLEazJEdpqNtPNefsadUrimUqma9wSoy4qiS,1299633,20253042,-18953409,316
2021-12-10 12:21:16-05:00,705,4DFa7jRrs71bUCbkpD19kWJG8RU6z58ymgG47NhuP6gC,7jvKYqZ5QU44VqsgRJiptmrvPf5A3XJ1EWkXUqxNGv1d,True,15783904,3945976,20821,10410,10411,72FwbpFGoLEazJEdpqNtPNefsadUrimUqma9wSoy4qiS,832874,3797158,-2964284,527
2021-12-10 12:21:16-05:00,706,8fVwuVA2CL5sZoHh6Dg4MBpcX3cvoUm7mnitnpQSdPBD,4F4ccaNm1KQu29XvsKvdjFkmpsbWqNvXkV41851EYQyu,False,22742513,22742513,220436,11021,209415,GmqQKnMfFxkv6ChqGaZ2wmSFDow7R1x7WeRfU58GVvfw,220436,9494758,-9274322,96
2021-12-10 12:21:17-05:00,707,Frobc1KZTVcsyfwyKwSpHJobxmiJBomzHhGCLdrzdAz8,HziyKP9uxWCuXddtbRzWMczHNdgyQB5UXQZj4MnMm14,False,66041330,66041330,3162732,158136,3004596,72FwbpFGoLEazJEdpqNtPNefsadUrimUqma9wSoy4qiS,3162732,13746027,-10583295,478
2021-12-10 12:21:17-05:00,708,5gN3624v6n1zQ1BKtZi1e9ZLpbCa4MEfhgHySFB81Qfm,UXT3oB5ud18rBsygsfxwA93kQYdSNbbzTCjt4gtU2jP,True,74468301,18617074,103513,51756,51757,72FwbpFGoLEazJEdpqNtPNefsadUrimUqma9wSoy4qiS,4140555,15171342,-11030787,556
2021-12-10 12:21:17-05:00,709,pkvFVn6bFvjCYCgWV4BPksGzqpyikFANqMn3xPXHMPk,EY5wUnUeoLRQD6WJ3Ay1EgzPZmsidtcd9wVQj2Fh4sz9,False,17049340,17049340,825093,41254,783839,72FwbpFGoLEazJEdpqNtPNefsadUrimUqma9wSoy4qiS,825093,3827912,-3002819,483
2021-12-10 12:21:18-05:00,710,6meAnGTy2XNUDk9qSJZGT6BBRinA5iGiDYEy2T88LXuX,BCzNQCn3J1381yNH5xp5ky9QmVKVdSofSUaLHtxKxPBW,False,250794,250794,542,27,515,72FwbpFGoLEazJEdpqNtPNefsadUrimUqma9wSoy4qiS,542,125227,-124685,21
2021-12-10 12:21:18-05:00,711,FZhvN1RjLoBK9EpCeyEobYsvdHirtbTXV82c9EV9nn2u,FSeHqYNof79JYrRb7ZkJWEb4TfS5wx7HTdvT1kLCexHM,False,13647707,13647707,56428,2821,53607,72FwbpFGoLEazJEdpqNtPNefsadUrimUqma9wSoy4qiS,56428,5951084,-5894656,41
2021-12-10 12:21:18-05:00,712,7D4rFmGMPKNAF75VRPxHAhSn2wTjiW8jmth1UD22Xqq9,GQ7BrT6vsXu8tHCMm75YdxFR2r9QTCrCUbdPEZBSAg9w,False,574481537,574481537,23091738,1154586,21937152,72FwbpFGoLEazJEdpqNtPNefsadUrimUqma9wSoy4qiS,23091738,176187625,-153095887,401
2021-12-10 12:21:18-05:00,713,J5WcVsKNHbfioai1LRowvjvtEmUJBEkeoBim1ThshpoP,Ajh7SWBq3zJR4vb6AFoBS6C9D99wC6YF1sVN22qC1vCA,False,135850787,135850787,1917540,95877,1821663,72FwbpFGoLEazJEdpqNtPNefsadUrimUqma9wSoy4qiS,1917540,38798991,-36881451,141
2021-12-10 12:21:18-05:00,714,7BY59PkXpdNQBwBAUte9icDDzB9H7pUWpG92DDtb5bQp,7Vp4w3nAdypxFAbZsq9CyLi83GM4z1rXPkrwUvPkP6XE,False,215008940,215008940,10505788,525289,9980499,72FwbpFGoLEazJEdpqNtPNefsadUrimUqma9wSoy4qiS,10505788,52199578,-41693790,488
2021-12-10 12:21:18-05:00,715,E5KDZriZ89a5D4VsMaWxndMMG68RT4weruJ1tCEc6tSx,CaSwkUocpbyyGCQBgKjJZJgcexbyqs2GTrGJH6EMWXAz,False,1176764379,1176764379,34818423,1740921,33077502,72FwbpFGoLEazJEdpqNtPNefsadUrimUqma9wSoy4qiS,34818423,516420878,-481602455,295
2021-12-10 12:21:21-05:00,716,3DEyi4Dnfxc7d91JbTpQjdAP1Ypgx5kaTSm4wwh8Zbm2,Cb2aqg5MyjopPzx5zd4zU81RUwJDeNTGV1jfiCLmgNTL,False,3545512,3545512,168264,8413,159851,72FwbpFGoLEazJEdpqNtPNefsadUrimUqma9wSoy4qiS,168264,1519213,-1350949,474
2021-12-10 12:21:21-05:00,717,7DQvMas21zgbHgaiGPUYF5WyLWouqCqxmrxuT1J3cqFo,GfjHJF6z9KxCGJ2pXncYSzjkSMSyTTmzLuBB2JEpytT4,False,451342422,451342422,21138269,1056913,20081356,72FwbpFGoLEazJEdpqNtPNefsadUrimUqma9wSoy4qiS,21138269,130323472,-109185203,468
2021-12-10 12:21:21-05:00,718,7aKxZg1aoLuB51JUw7fruF77ts7SWoB7pcLBZKHZMynr,AAnbLY82UGULqaDNdyJHrYu7X3hGaBuiTkGWmh8qKTc,False,3512708482,3512708482,20725185,1036259,19688926,72FwbpFGoLEazJEdpqNtPNefsadUrimUqma9wSoy4qiS,20725185,1072759174,-1052033989,59
2021-12-10 12:21:21-05:00,719,9RSTBp82LizcenitXWpsccH53G2YFS2Yh42N9ofogpUX,9WUxAg5BaJtUFthTod8dSUDprUjLygsUFUGg5N7Uy2JG,False,50681992,50681992,2168160,108408,2059752,72FwbpFGoLEazJEdpqNtPNefsadUrimUqma9wSoy4qiS,2168160,11480108,-9311948,427
2021-12-10 12:21:23-05:00,720,8d333AWdyiVhvkAdiKCTwhgzaPBMbn8mtucwUC1SAbZZ,3BM8UNLN7XGRaYRjezAqFVMr1z4PS3VRXiN1NAtvBuD9,False,29652226,29652226,237040,11852,225188,GmqQKnMfFxkv6ChqGaZ2wmSFDow7R1x7WeRfU58GVvfw,237040,14513729,-14276689,79
2021-12-10 12:21:23-05:00,721,8G2hAWXgJZRNMv32dcGkCrsMpqs1aTmGo2rsDm2VZ5Fn,4PMxnUH1oQQdtchAZ2sKDYkg8iiFCFxCS7yE9iP5bQyi,True,41738785,10434696,54798,27399,27399,72FwbpFGoLEazJEdpqNtPNefsadUrimUqma9wSoy4qiS,2191941,18431381,-16239440,525
2021-12-10 12:21:23-05:00,722,Dng7By2saPu5TVxcvXidBe71ggBo8tiHkAXPi4kKL1tk,75ufEJmHbLHffphL7tvAXhGyftKLr1z2PXXoB2GGY5fG,True,60521962,15130489,90220,45110,45110,72FwbpFGoLEazJEdpqNtPNefsadUrimUqma9wSoy4qiS,3608809,12439869,-8831060,596
2021-12-10 12:21:23-05:00,723,AHm7zF4rpaxaayBLn5QDHgJSp8KAr647s4cNvQ9wLgd7,FDM33WngED24pukBvSDpPAzinW6afVAeGReum5nyLRiC,True,39509943,9877485,54932,27466,27466,72FwbpFGoLEazJEdpqNtPNefsadUrimUqma9wSoy4qiS,2197318,9682628,-7485310,556
2021-12-10 12:21:23-05:00,724,4j19AEcDwhtAZrnoDc4epNPmEL1jPpVUMeg7RmQ72Qkb,84WB42AAGbczVE9txZPwXrx4FD5jP87r8QdDzEABTm5G,False,36301465166,36301465166,1581895699,79094784,1502800915,72FwbpFGoLEazJEdpqNtPNefsadUrimUqma9wSoy4qiS,1581895699,11770463589,-10188567890,435
2021-12-10 12:21:23-05:00,725,3ufE8ZossNvypfLHuvbYMGyrAwKk7CUShTFqfpkjsCFB,DKF6tQstSHpxM9QTUCt6yU1iFZrRiXodRSZd9pSYBJN9,False,338066172,338066172,12383283,619164,11764119,72FwbpFGoLEazJEdpqNtPNefsadUrimUqma9wSoy4qiS,12383283,82678342,-70295059,366
2021-12-10 12:21:23-05:00,726,29rwdfrBkccfAXJdN6rhW5JNpCzDhg4oWF9ntWtMpQvo,HCjTVhGTSSqJFwQY68vSXYF7dQ1QCtz4EZca4HqmkYuo,True,342488996,85622249,438964,219482,219482,72FwbpFGoLEazJEdpqNtPNefsadUrimUqma9wSoy4qiS,17558597,145387417,-127828820,512
2021-12-10 12:21:23-05:00,727,93ho4cgnpAJiJsG6uu2udkLVNU7rkz4QjCYfsqvpbPA5,45ouQn9gGwXqnTGfaP5CvU8fCKadBRA5kPwtfvJzykRU,False,538835979,538835979,18948988,947449,18001539,72FwbpFGoLEazJEdpqNtPNefsadUrimUqma9wSoy4qiS,18948988,153207692,-134258704,351
2021-12-10 12:21:23-05:00,728,7v9ZoB7qxQsHBENVV5DXWJCUn33Y2cwvkVbvgUgBn3g4,BbVVWmu5jFbq5Efijex19vwpyP7dXmZGjLijf8BLtoq4,False,586183716,586183716,24293707,1214685,23079022,72FwbpFGoLEazJEdpqNtPNefsadUrimUqma9wSoy4qiS,24293707,188109991,-163816284,414
2021-12-10 12:21:23-05:00,729,4KMzwWHPeW51cxu4nMpbqCaqo96dMqaHWyRCGQktfQfd,F7q4GNYcbnZa8dJ4qovQwjmxpKpdEmdxQMXRPb9nQupa,True,64021646,16005411,80253,40126,40127,72FwbpFGoLEazJEdpqNtPNefsadUrimUqma9wSoy4qiS,3210129,13486344,-10276215,501
2021-12-10 12:21:23-05:00,730,AoPQqPjLPi8fZiLkhMGLRj6oD5k2asrvJtCkpW19DvGr,H5Sgmf1VuY13iHjPuLJ2q9wtSdkXG1AQsEv2eq6zzm8Y,True,62821671,15705417,82764,41382,41382,72FwbpFGoLEazJEdpqNtPNefsadUrimUqma9wSoy4qiS,3310570,12873624,-9563054,526
2021-12-10 12:21:28-05:00,731,BQBQicboM5o25LihnffqxcJmoPoA3mgBKNeG4H8UTHVh,E8rJFAs7dbDmQA1o5aTeNqdmADxWMd5cDzvwAGMFFCix,True,71850256,17962564,90776,45388,45388,72FwbpFGoLEazJEdpqNtPNefsadUrimUqma9wSoy4qiS,3631071,35377865,-31746794,505
2021-12-10 12:21:29-05:00,732,8G2hAWXgJZRNMv32dcGkCrsMpqs1aTmGo2rsDm2VZ5Fn,4PMxnUH1oQQdtchAZ2sKDYkg8iiFCFxCS7yE9iP5bQyi,True,30974278,7743569,45183,22591,22592,72FwbpFGoLEazJEdpqNtPNefsadUrimUqma9wSoy4qiS,1807332,14316827,-12509495,583
2021-12-10 12:21:29-05:00,733,Cv5oVktxmqbU1SxraxH67NEWMKnjgA18R832Fhe9h74a,Cs7xBD4BDiohyopnaYDDChUtR9vmx7uwot6Qp9beQLzt,True,56563082,14140770,82709,41354,41355,72FwbpFGoLEazJEdpqNtPNefsadUrimUqma9wSoy4qiS,3308377,11732841,-8424464,584
2021-12-10 12:21:30-05:00,734,4DFa7jRrs71bUCbkpD19kWJG8RU6z58ymgG47NhuP6gC,7jvKYqZ5QU44VqsgRJiptmrvPf5A3XJ1EWkXUqxNGv1d,True,11699839,2924959,16849,8424,8425,72FwbpFGoLEazJEdpqNtPNefsadUrimUqma9wSoy4qiS,673964,3035282,-2361318,576
2021-12-10 12:21:31-05:00,735,BrHRMouGRz3LBNzd9anfdYMhWfg8yUPHL4PqJ8WdEDFS,4uzoLa3mC2VYHAPBoHLX4gTjPTC28rPf2fvEGtJWPYc,True,2890602445,722650611,3679666,1839833,1839833,72FwbpFGoLEazJEdpqNtPNefsadUrimUqma9wSoy4qiS,147186655,1441166068,-1293979413,509
2021-12-10 12:21:31-05:00,736,8eTH6eJyyVeMno3UQkffeBg32xofKsQfkhLhXdtaf87s,BCFC7CPXrQPsUfJb2eYSht8GhaApWHpc49AeCXqaYq13,True,64597558,16149389,90814,45407,45407,72FwbpFGoLEazJEdpqNtPNefsadUrimUqma9wSoy4qiS,3632597,13115744,-9483147,562
2021-12-10 12:21:32-05:00,737,4oAmAWPdfD7Wc8zHUVeuQnJpp2WD5xH7K5yL5We4qX6k,D48tXw9B8jaF32MrWwCszztc4juCSDgFwCgCDy6PU3iB,False,1618784505,1618784505,53619620,2680981,50938639,72FwbpFGoLEazJEdpqNtPNefsadUrimUqma9wSoy4qiS,53619620,374639175,-321019555,331
2021-12-10 12:21:36-05:00,738,HqtTbC1LFreGvgfpZe7nCqkNnh8GHPQKosfmc19zb1yi,E39UNiHNkwQEd5GXkCtTPqSorQSB1kLx8kjzK4jdFoi3,True,11906421327,2976605331,16180872,8090436,8090436,72FwbpFGoLEazJEdpqNtPNefsadUrimUqma9wSoy4qiS,647234880,2850010871,-2202775991,543
2021-12-10 12:21:37-05:00,739,7jvKp6onXyWgwsFrFWj4hYTXJsYYD6ot5mn6rPFuJriy,J7N6HiozevJVTiY9hDEUs2ud5BwT5QSE7wnMBS1w5ie2,True,2078908196,519727048,3013695,1506847,1506848,72FwbpFGoLEazJEdpqNtPNefsadUrimUqma9wSoy4qiS,120547829,573024550,-452476721,579
2021-12-10 12:21:37-05:00,740,BpvWyveup3q7q6Cws5TWkFYiZ8bQXRrfdxvzrN9FnYo6,2CWjropYSn9fJ66FT4zqUcwTrEaPp3CjGgoRATixyca1,True,41808034,10452008,59435,29717,29718,72FwbpFGoLEazJEdpqNtPNefsadUrimUqma9wSoy4qiS,2377406,12588661,-10211255,568
2021-12-10 12:21:37-05:00,741,AHm7zF4rpaxaayBLn5QDHgJSp8KAr647s4cNvQ9wLgd7,FDM33WngED24pukBvSDpPAzinW6afVAeGReum5nyLRiC,True,29297792,7324448,45193,22596,22597,72FwbpFGoLEazJEdpqNtPNefsadUrimUqma9wSoy4qiS,1807720,7756456,-5948736,617
2021-12-10 12:21:37-05:00,742,6QZamUpLHzSzJhj1XtzPP5dHQRvTUmaqRmntxcLfWwE3,D9F6yp639JKp473cZTsB5puUr1URdi18ZxZTFXE1p8py,True,59855873,14963968,88581,44290,44291,72FwbpFGoLEazJEdpqNtPNefsadUrimUqma9wSoy4qiS,3543249,15431304,-11888055,591
2021-12-10 12:21:39-05:00,743,4FazDUgfQ3AKoFcnWHr8E9Ht8jLA3tkxf75yrGZVHdmF,HzRMH6mbgEKydRCnnMvSsKgTEVNQi6nuzoR1xutYFdzg,True,2170120,542530,3155,1577,1578,72FwbpFGoLEazJEdpqNtPNefsadUrimUqma9wSoy4qiS,126233,953322,-827089,581
2021-12-10 12:21:39-05:00,744,2XnLbeSYLmYWRhErrHMyaXTFtLGMZu6S5fDzp3KkFGC5,8zatCNqr7MQuJXeL7aUFSDGrrEEwa6fgviFu6M1WErHX,True,168105942,42026485,245451,122725,122726,72FwbpFGoLEazJEdpqNtPNefsadUrimUqma9wSoy4qiS,9818063,38496384,-28678321,584
2021-12-10 12:21:39-05:00,745,72L76qDRMK3M7X52zuuB9GVyvFFLDBZwFMpVjWjghXzA,4m2ZVuemUctu1edv4YJVAcjXzKwpbCmBujzoUmLDeA7h,True,66000297,16500074,96786,48393,48393,72FwbpFGoLEazJEdpqNtPNefsadUrimUqma9wSoy4qiS,3871457,13467364,-9595907,586
2021-12-10 12:22:00-05:00,746,AaMCg49sJwNtdB5wHACg15TYAzzJXy8xtG4zuVXhKiVE,HbDYqDa9bewGPvsiaHRM9HmEvh1scPaUaGvqog66gYir,True,47240338,11810084,72173,36086,36087,72FwbpFGoLEazJEdpqNtPNefsadUrimUqma9wSoy4qiS,2886931,10430233,-7543302,611
2021-12-10 12:22:05-05:00,747,GKNBtZbwK4w9hyXD1r38NTGcTJhpjt8R9WFCzdXup9Tk,7RLaL2XoFuqrcCcPEB6FzPJzLnAhjQpwcRmDfdpRXFgB,True,1582846707,395711676,2413735,1206867,1206868,4BnQKPLuE3DMTtxp8MjUBytgnhvxqq3ZTqZHTVZo4JJh,96549403,412236162,-315686759,609
2021-12-10 12:30:48-05:00,748,36ByQojnxEckWdQTjqHfxKqCx9yjqWQsPsZyqaN72UWR,AZoirtS1fjX61agRM64tqThVinnJTh3BWgiHyNHPTgZP,True,99872427,24968106,142189,71094,71095,4BnQKPLuE3DMTtxp8MjUBytgnhvxqq3ZTqZHTVZo4JJh,5687591,21717217,-16029626,569
2021-12-10 12:30:56-05:00,749,GbPWktFegZQEz5CDL2kphHexVrQgy3hTmXa8mCEZtdps,BVQzSYxgF1v6ftSLe5mftqgvretxPcNCrtN8RrHKDn5x,False,488531520,488531520,22555501,1127775,21427726,72FwbpFGoLEazJEdpqNtPNefsadUrimUqma9wSoy4qiS,22555501,123007847,-100452346,461
2021-12-10 12:31:10-05:00,750,6wYw2tQWSj6YzrPL8s5ZVp4pKnX4tUdovt8wzUCyoWfs,DCuvqHhUwZiZ2XZGyxPREjEA5WQZNwuV9eAcFMEeS3a5,True,1658841120,414710280,2288371,1144185,1144186,72FwbpFGoLEazJEdpqNtPNefsadUrimUqma9wSoy4qiS,91534840,367810498,-276275658,551
2021-12-10 17:04:52-05:00,751,9WoXgsHByBW41nJtgCBoLS1ZP2GredkysgyZeNRWx13u,26Hb8DNrxtVBHcThu71DJ3pTbhXRcGApnTrgk6iAVTau,True,113292322,28323080,171344,85672,85672,4BnQKPLuE3DMTtxp8MjUBytgnhvxqq3ZTqZHTVZo4JJh,6853761,31367328,-24513567,604
2021-12-10 17:22:44-05:00,752,6TWJ8huRvaHdb1Rr9TvV5oNA163kaV8o8dpXoZBrCotK,FB8yfdGootXBhsPpUB6i2cqjweFD2rjtUXg5KHM2zDPs,True,563307345,140826836,881394,440697,440697,4BnQKPLuE3DMTtxp8MjUBytgnhvxqq3ZTqZHTVZo4JJh,35255781,151914486,-116658705,625
2021-12-10 17:27:23-05:00,753,9WoXgsHByBW41nJtgCBoLS1ZP2GredkysgyZeNRWx13u,26Hb8DNrxtVBHcThu71DJ3pTbhXRcGApnTrgk6iAVTau,True,83456229,20864057,129235,64617,64618,4BnQKPLuE3DMTtxp8MjUBytgnhvxqq3ZTqZHTVZo4JJh,5169404,25069329,-19899925,619
2021-12-10 17:33:38-05:00,754,6TWJ8huRvaHdb1Rr9TvV5oNA163kaV8o8dpXoZBrCotK,FB8yfdGootXBhsPpUB6i2cqjweFD2rjtUXg5KHM2zDPs,True,413678427,103419606,639307,319653,319654,GmqQKnMfFxkv6ChqGaZ2wmSFDow7R1x7WeRfU58GVvfw,25572305,121906993,-96334688,618
2021-12-10 19:12:04-05:00,755,CRW3nidAs2C3irLsEMsnffCvcjZH3wMBoKXG8PRp1Ss8,GD2un4iqMrnZ1kKnGLbzaSQy5iKjGSHHDN58tKibtHN3,True,511822209,127955551,795982,397991,397991,GmqQKnMfFxkv6ChqGaZ2wmSFDow7R1x7WeRfU58GVvfw,31839318,113827390,-81988072,622
2021-12-10 19:12:21-05:00,756,J7i9qHaXQbWVGEVDGTgM9kYcBWYo4Gc8zbPkU2V9SXzp,ET2wi1T7WYUwekTMEncvbqP24Xw9WfULRyb8DV2M3wZc,True,41122758,10280689,64173,32086,32087,GmqQKnMfFxkv6ChqGaZ2wmSFDow7R1x7WeRfU58GVvfw,2566957,9444095,-6877138,624
2021-12-10 19:12:29-05:00,757,2pmVGLVRhBdJdQicVjRZbRNGcdPxqd99bvBXnw4ckhCS,7ab23P9dAKiBSuXx7xJG7QzEvSfGVcTEBMrSjiH8YEhf,True,46984163,11746040,72474,36237,36237,GmqQKnMfFxkv6ChqGaZ2wmSFDow7R1x7WeRfU58GVvfw,2898978,10798407,-7899429,617
2021-12-10 19:14:03-05:00,758,9WoXgsHByBW41nJtgCBoLS1ZP2GredkysgyZeNRWx13u,26Hb8DNrxtVBHcThu71DJ3pTbhXRcGApnTrgk6iAVTau,True,61376046,15344011,95444,47722,47722,GmqQKnMfFxkv6ChqGaZ2wmSFDow7R1x7WeRfU58GVvfw,3817790,19959738,-16141948,622
2021-12-10 19:18:25-05:00,759,DGbj8tnqECzM9FG8j225Ap7A4Fdm3J1Ksm32JBFG7igv,Cd3D2UVwoSZLygM2e3UQppQANsokpmx5CNBs1C5zueay,True,59187015,14796753,91902,45951,45951,GmqQKnMfFxkv6ChqGaZ2wmSFDow7R1x7WeRfU58GVvfw,3676085,11874587,-8198502,621
2021-12-10 19:20:51-05:00,760,gMjmD7WioyUdQdwNqE5fobLcxPwoJv5rAvLmJaf8Jjw,5n77euFjVJiwKrnbYq1KpcENW1mzBZj2BuDGyzazrkJ8,True,58668161,14667040,91115,45557,45558,72FwbpFGoLEazJEdpqNtPNefsadUrimUqma9wSoy4qiS,3644625,12226317,-8581692,621
2021-12-11 14:20:31-05:00,761,5qY8ZrqpHPqkAuXp6HpE2zC8qTfzsP8MXWSoxkZQV5jx,GPs3ap45TuHwHwmDb5bnKYHLBa5wj3AyuEsXcfHjEcAL,True,593062130,148265532,926483,463241,463242,GmqQKnMfFxkv6ChqGaZ2wmSFDow7R1x7WeRfU58GVvfw,37059358,131597049,-94537691,624
2021-12-11 14:23:57-05:00,762,D3o7CSh2zCAQ93BDomDCitZ4vuxC83wGPMwJEEyBJK4C,A4nDfpUZkdtuWRRWZkoNXc5Ux7JU1UJA2JTHgkHAfYyP,True,258332876701,64583219175,403426152,201713076,201713076,GmqQKnMfFxkv6ChqGaZ2wmSFDow7R1x7WeRfU58GVvfw,16137046116,111474043020,-95336996904,624
2021-12-11 14:23:57-05:00,763,6TWJ8huRvaHdb1Rr9TvV5oNA163kaV8o8dpXoZBrCotK,FB8yfdGootXBhsPpUB6i2cqjweFD2rjtUXg5KHM2zDPs,False,283473497,283473497,0,0,0,GmqQKnMfFxkv6ChqGaZ2wmSFDow7R1x7WeRfU58GVvfw,0,96660279,-99057817,0
2021-12-11 14:24:00-05:00,764,9WoXgsHByBW41nJtgCBoLS1ZP2GredkysgyZeNRWx13u,26Hb8DNrxtVBHcThu71DJ3pTbhXRcGApnTrgk6iAVTau,False,42673410,42673410,286321,14316,272005,GmqQKnMfFxkv6ChqGaZ2wmSFDow7R1x7WeRfU58GVvfw,286321,15751909,-15465588,67
2021-12-11 14:24:01-05:00,765,9JJoEQ8yMhbU8RjCUSb4rGyFzf5fcFwmRrhgwuP1gzoJ,2PgvGtcExTfvNFaXEpTtSAFETxA458m3L2SEU4wr7zjs,False,2889980257,2889980257,92417775,4620888,87796887,GmqQKnMfFxkv6ChqGaZ2wmSFDow7R1x7WeRfU58GVvfw,92417775,687162633,-594744858,319
2021-12-11 14:24:01-05:00,766,J7i9qHaXQbWVGEVDGTgM9kYcBWYo4Gc8zbPkU2V9SXzp,ET2wi1T7WYUwekTMEncvbqP24Xw9WfULRyb8DV2M3wZc,False,29152174,29152174,761245,38062,723183,GmqQKnMfFxkv6ChqGaZ2wmSFDow7R1x7WeRfU58GVvfw,761245,7609203,-6847958,261
2021-12-11 14:24:01-05:00,767,5qY8ZrqpHPqkAuXp6HpE2zC8qTfzsP8MXWSoxkZQV5jx,GPs3ap45TuHwHwmDb5bnKYHLBa5wj3AyuEsXcfHjEcAL,False,422522267,422522267,13858544,692927,13165617,GmqQKnMfFxkv6ChqGaZ2wmSFDow7R1x7WeRfU58GVvfw,13858544,107077980,-93219436,327
2021-12-11 14:24:01-05:00,768,HfF7RiVgyJfoVyr12C96KpK9oT7Aux5jHK4LvrEUNRf8,FCRk8WBGtu2p6dboan8fuVsKaECWyNxLkgWxuVmyv4r2,False,118299,118299,3971,198,3773,GmqQKnMfFxkv6ChqGaZ2wmSFDow7R1x7WeRfU58GVvfw,3971,38795,-34824,335
2021-12-11 14:24:01-05:00,769,2bjiHeP82LQ56fEsqR7xEZ9xyyE8LLeeNc7LBvSQm54r,6wdVmvunXFaPuCAXiDdYNmoumYkXz8M5C5vRnBZ9HSXT,False,122929353,122929353,4927097,246354,4680743,GmqQKnMfFxkv6ChqGaZ2wmSFDow7R1x7WeRfU58GVvfw,4927097,24084726,-19157629,400
2021-12-11 14:24:01-05:00,770,2pmVGLVRhBdJdQicVjRZbRNGcdPxqd99bvBXnw4ckhCS,7ab23P9dAKiBSuXx7xJG7QzEvSfGVcTEBMrSjiH8YEhf,False,33334906,33334906,864203,43210,820993,72FwbpFGoLEazJEdpqNtPNefsadUrimUqma9wSoy4qiS,864203,8692260,-7828057,259
2021-12-11 14:24:01-05:00,771,CRW3nidAs2C3irLsEMsnffCvcjZH3wMBoKXG8PRp1Ss8,GD2un4iqMrnZ1kKnGLbzaSQy5iKjGSHHDN58tKibtHN3,False,363214361,363214361,9751309,487565,9263744,GmqQKnMfFxkv6ChqGaZ2wmSFDow7R1x7WeRfU58GVvfw,9751309,91923788,-82172479,268
2021-12-11 14:24:01-05:00,772,v5cMbxv4J1QzgCUb3BRQsYX7yWz6C8AWZcvQ3JTXAK1,9vXUPbwsc7VZJoxhtUi6GCAqxz1iLeseW9NikwjrQzwj,False,14199009529,14199009529,543078695,27153934,515924761,72FwbpFGoLEazJEdpqNtPNefsadUrimUqma9wSoy4qiS,543078695,4893332894,-4350254199,382
2021-12-13 09:45:30-05:00,773,EAUFD16wab8qRMJ4H6updHGt4xFqgRCDeRHVCsLCTSTL,8vkfYSyCyBY9g4TZrp52jUcQj6udy9xAaA4fioRE2RXx,True,895029758,223757439,1394094,697047,697047,GmqQKnMfFxkv6ChqGaZ2wmSFDow7R1x7WeRfU58GVvfw,55763793,253483683,-197719890,623
2021-12-13 10:03:46-05:00,774,HGAFdundf5voDqeh9g7d6Q9mgMf8eEg898QMRBqwPZ6C,deanBuZXWBHEe2TGfP37S9aMBEnEgmZoyRJjAvruzfA,True,205852279,51463069,322045,161022,161023,GmqQKnMfFxkv6ChqGaZ2wmSFDow7R1x7WeRfU58GVvfw,12881802,93882814,-81001012,625
2021-12-13 10:08:02-05:00,775,C1CsbgQFvEvSXzuVHTr39tQHr3drDhjxeYiotd8eNocF,4rAaTCAMj5VpgNVKiYizabH7cMLhEA12seu2QXQNTyV3,True,116114192,29028547,181592,90796,90796,GmqQKnMfFxkv6ChqGaZ2wmSFDow7R1x7WeRfU58GVvfw,7263701,25764216,-18500515,625
2021-12-13 10:15:19-05:00,776,2ce2v2TCbjNH635NgbwTG3sqiRWYrRRaBpxPxBZJ929q,9cnoebT43FkWDFhidndGCVNiFD4NErv8DuL1Va4Jv9S8,True,215591709,53897927,335125,167562,167563,GmqQKnMfFxkv6ChqGaZ2wmSFDow7R1x7WeRfU58GVvfw,13405031,100812322,-87407291,621
2021-12-13 10:26:55-05:00,777,7iUx7JBwqUvPVPeCqMEXQdLccZJmaFYm1DUQiu3ouHa3,3EVZzhRmJnX9ZiBZZo9tenDtMogAyuA1yf2cKzvUWiuu,True,55006975,13751743,85601,42800,42801,GmqQKnMfFxkv6ChqGaZ2wmSFDow7R1x7WeRfU58GVvfw,3424074,12182798,-8758724,622
2021-12-13 10:27:59-05:00,778,4KMzwWHPeW51cxu4nMpbqCaqo96dMqaHWyRCGQktfQfd,F7q4GNYcbnZa8dJ4qovQwjmxpKpdEmdxQMXRPb9nQupa,True,48289135,12072283,74795,37397,37398,GmqQKnMfFxkv6ChqGaZ2wmSFDow7R1x7WeRfU58GVvfw,2991800,10430001,-7438201,619
2021-12-13 10:29:15-05:00,779,GGGyesjbt7h2XHHp9u8vpiWGugFwEbrtYaKrNQSDhQd7,8tydo1ZjGHmPBSqU33tywB3f9szdsHk1ckGFe4Ay5pgs,True,1800468204,450117051,2804217,1402108,1402109,GmqQKnMfFxkv6ChqGaZ2wmSFDow7R1x7WeRfU58GVvfw,112168682,830181196,-718012514,622
2021-12-13 10:35:28-05:00,780,Gbxc51WERLLeCtiHv7rDvE52aqF541RoQWG5n5aqErq6,4ngBoHbfXijLMqGKxFMNht9sbmxy2g5eqBmn8QsBmbx1,True,48410561,12102639,74765,37382,37383,GmqQKnMfFxkv6ChqGaZ2wmSFDow7R1x7WeRfU58GVvfw,2990639,10557738,-7567099,617
2021-12-13 10:37:07-05:00,781,EAUFD16wab8qRMJ4H6updHGt4xFqgRCDeRHVCsLCTSTL,8vkfYSyCyBY9g4TZrp52jUcQj6udy9xAaA4fioRE2RXx,True,658206958,164551739,1029825,514912,514913,GmqQKnMfFxkv6ChqGaZ2wmSFDow7R1x7WeRfU58GVvfw,41193004,202563723,-161370719,625
2021-12-13 10:37:36-05:00,782,BhiAaiZu7fF8ndggJrLyiFVCRq526cNBw7VaeascEmNL,4en8MipPi7vq15NGhpPMQfptNdEyhp2j7fpgxBBtjyfz,True,56355274,14088818,86442,43221,43221,GmqQKnMfFxkv6ChqGaZ2wmSFDow7R1x7WeRfU58GVvfw,3457701,10775162,-7317461,613
2021-12-13 10:45:57-05:00,783,HGAFdundf5voDqeh9g7d6Q9mgMf8eEg898QMRBqwPZ6C,deanBuZXWBHEe2TGfP37S9aMBEnEgmZoyRJjAvruzfA,True,151229528,37807381,235001,117500,117501,GmqQKnMfFxkv6ChqGaZ2wmSFDow7R1x7WeRfU58GVvfw,9400075,73311488,-63911413,621
2021-12-13 10:49:32-05:00,784,36ByQojnxEckWdQTjqHfxKqCx9yjqWQsPsZyqaN72UWR,AZoirtS1fjX61agRM64tqThVinnJTh3BWgiHyNHPTgZP,True,74215297,18553824,113785,56892,56893,GmqQKnMfFxkv6ChqGaZ2wmSFDow7R1x7WeRfU58GVvfw,4551405,17264094,-12712689,613
2021-12-13 10:50:41-05:00,785,AoPQqPjLPi8fZiLkhMGLRj6oD5k2asrvJtCkpW19DvGr,H5Sgmf1VuY13iHjPuLJ2q9wtSdkXG1AQsEv2eq6zzm8Y,True,47213167,11803291,72752,36376,36376,GmqQKnMfFxkv6ChqGaZ2wmSFDow7R1x7WeRfU58GVvfw,2910083,9991174,-7081091,616
2021-12-13 10:53:00-05:00,786,5gN3624v6n1zQ1BKtZi1e9ZLpbCa4MEfhgHySFB81Qfm,UXT3oB5ud18rBsygsfxwA93kQYdSNbbzTCjt4gtU2jP,True,55741738,13935434,86051,43025,43026,GmqQKnMfFxkv6ChqGaZ2wmSFDow7R1x7WeRfU58GVvfw,3442069,11830596,-8388527,617
2021-12-13 10:55:38-05:00,787,D58t4uTjFumsUeYFaKnpV8BRTEQEqKXBreFTdwGrott7,67p6kHDfVqQijfcwugvZK59c3aRRH9x3eHxruqH8WEqF,True,48200446,12050110,74038,37019,37019,4BnQKPLuE3DMTtxp8MjUBytgnhvxqq3ZTqZHTVZo4JJh,2961521,10505939,-7544418,614
2021-12-13 10:55:52-05:00,788,Fn6J1eMQJoA5rXCwX2HjAF86AowsJfULLuYXVfzgb8aX,6Ett2WPmz4HoWVSVEZD73UzFetd3oFSh7C676MEVYd36,True,2774820764,693705191,4290956,2145478,2145478,GmqQKnMfFxkv6ChqGaZ2wmSFDow7R1x7WeRfU58GVvfw,171638262,998724239,-827085977,618
2021-12-13 10:57:06-05:00,789,34235h7L3VPHqcUkLycAsaJAXyq4vtgoG27yei34CKaj,Bg6WtWMQXGBakzrizVhBrE1X2hafMHBtktn3YYjeyscf,True,552928824,138232206,823950,411975,411975,GmqQKnMfFxkv6ChqGaZ2wmSFDow7R1x7WeRfU58GVvfw,32958019,196518959,-163560940,596
2021-12-13 10:57:20-05:00,790,29rwdfrBkccfAXJdN6rhW5JNpCzDhg4oWF9ntWtMpQvo,HCjTVhGTSSqJFwQY68vSXYF7dQ1QCtz4EZca4HqmkYuo,True,257346403,64336600,401818,200909,200909,GmqQKnMfFxkv6ChqGaZ2wmSFDow7R1x7WeRfU58GVvfw,16072747,111469189,-95396442,624
2021-12-13 10:57:20-05:00,791,6kt64nJRnYaWMi9GbpZaUuhbToAVRd7FUMTGASAAJrve,2Sdxv9ZtogNcVbJwBPxKmVjwAiKyX5GHEfnRmFcydQ1G,True,223891085,55972771,346013,173006,173007,GmqQKnMfFxkv6ChqGaZ2wmSFDow7R1x7WeRfU58GVvfw,13840531,95918540,-82078009,618
2021-12-13 10:57:20-05:00,792,Ggjn39zkoAcCcmDmmzqYw8RFsMqjQGtAX8myhB3p4WQ4,FWnftuAeU86mR8RMR9qQwLfkujqcfzEiupBPkvWre3RS,True,234990843,58747710,366009,183004,183005,GmqQKnMfFxkv6ChqGaZ2wmSFDow7R1x7WeRfU58GVvfw,14640372,100617108,-85976736,623
2021-12-13 10:57:27-05:00,793,GqAS41YJssg9aaEp3hs3sG98APCsXhiQBQszXaSjZ2bN,2wodJ3AhrXdE1T4oVL95KvoBND7PubG5Wd5GWiLCMZJU,True,6772236509,1693059127,10324046,5162023,5162023,GmqQKnMfFxkv6ChqGaZ2wmSFDow7R1x7WeRfU58GVvfw,412961867,3462746366,-3049784499,609
2021-12-13 10:57:29-05:00,794,6VBYUiLyQXvvsDmq1vh1oJ5VeA89tGgxtkgFfofc372m,35pyoeRA4duKX7njdYny3KffM2xaxuWUZGRUMQJ5iAiu,True,221592527,55398131,340026,170013,170013,GmqQKnMfFxkv6ChqGaZ2wmSFDow7R1x7WeRfU58GVvfw,13601045,94977915,-81376870,613
2021-12-13 10:57:31-05:00,795,DjbEch16uzdDtujFUeqxjquTTS3JXzEys8e9ogUv3aTy,6N8eKb3kfcbJEUZKZERiFiUR4hubB635D8Sotiji2TU8,True,230429052,57607263,354965,177482,177483,GmqQKnMfFxkv6ChqGaZ2wmSFDow7R1x7WeRfU58GVvfw,14198618,98737751,-84539133,616
2021-12-13 10:57:31-05:00,796,4nEJqarcHzgizZsc11SYg3PP5E91nsjqzzNxUCSYA5sb,zayUU1osJ9byFsmsi9CZqvQAhtEenpmXv2UwN6YDt6B,True,239098771,59774692,365841,182920,182921,GmqQKnMfFxkv6ChqGaZ2wmSFDow7R1x7WeRfU58GVvfw,14633678,102501880,-87868202,612
2021-12-13 10:57:31-05:00,797,C1CsbgQFvEvSXzuVHTr39tQHr3drDhjxeYiotd8eNocF,4rAaTCAMj5VpgNVKiYizabH7cMLhEA12seu2QXQNTyV3,True,85110143,21277535,127665,63832,63833,GmqQKnMfFxkv6ChqGaZ2wmSFDow7R1x7WeRfU58GVvfw,5106607,20957879,-15851272,599
2021-12-13 10:57:31-05:00,798,BQBQicboM5o25LihnffqxcJmoPoA3mgBKNeG4H8UTHVh,E8rJFAs7dbDmQA1o5aTeNqdmADxWMd5cDzvwAGMFFCix,True,53954016,13488504,82159,41079,41080,GmqQKnMfFxkv6ChqGaZ2wmSFDow7R1x7WeRfU58GVvfw,3286395,27030435,-23744040,609
2021-12-13 10:57:31-05:00,799,9bhB755nk1VKCFQ15knBRdXESNqN6T1o3Lp3u214mARe,FvZuSbYfVMwGg8UUurGDFe7VVtoUBghrPNFYTr2gKCFc,True,237030887,59257721,365543,182771,182772,4BnQKPLuE3DMTtxp8MjUBytgnhvxqq3ZTqZHTVZo4JJh,14621737,101558126,-86936389,616
2021-12-13 10:57:32-05:00,800,Ad4hjpPdExRAqUATSvqZYLBVNBcmtB2Pqh6MWwc1XGj,6TnqcHDyBnSZMds1eUc28aKuBThwGjAPsnaFKeC2fGnK,True,232688307,58172076,359913,179956,179957,72FwbpFGoLEazJEdpqNtPNefsadUrimUqma9wSoy4qiS,14396535,99676110,-85279575,618
2021-12-13 10:57:32-05:00,801,73PpLzJmAimmqtjGpRcYHua8t6wx3gYiiXFvQxnSDMJV,CRCpLcS8LNKX22co94spJBXEes9Fnh5rYBvbVEte4JXA,True,225937212,56484303,345692,172846,172846,GmqQKnMfFxkv6ChqGaZ2wmSFDow7R1x7WeRfU58GVvfw,13827693,96859272,-83031579,612
2021-12-13 10:57:32-05:00,802,DTWFNeptqa59hRfBzQUVtVjto8fmRW7TvXcH8Tz8PXkT,67JFe2J2ZVJJWkGcYBeJUhXsScYAH2zTJbzfmFL1kGDb,True,241248304,60312076,368114,184057,184057,GmqQKnMfFxkv6ChqGaZ2wmSFDow7R1x7WeRfU58GVvfw,14724593,103442959,-88718366,610
2021-12-13 10:57:32-05:00,803,Fw2e6jxKVeFcJSe9MyVhSz3dUdJQLs3XULHrT1mtMU9U,591U5bexgLRJXygtK5fpCRXcZEq89KgewFTdfPkti8bY,True,228201614,57050403,350768,175384,175384,GmqQKnMfFxkv6ChqGaZ2wmSFDow7R1x7WeRfU58GVvfw,14030755,97797629,-83766874,614
2021-12-13 10:57:32-05:00,804,BrHRMouGRz3LBNzd9anfdYMhWfg8yUPHL4PqJ8WdEDFS,4uzoLa3mC2VYHAPBoHLX4gTjPTC28rPf2fvEGtJWPYc,True,2170653372,542663343,3333011,1666505,1666506,72FwbpFGoLEazJEdpqNtPNefsadUrimUqma9wSoy4qiS,133320474,1101434125,-968113651,614
2021-12-13 10:58:06-05:00,805,8eTH6eJyyVeMno3UQkffeBg32xofKsQfkhLhXdtaf87s,BCFC7CPXrQPsUfJb2eYSht8GhaApWHpc49AeCXqaYq13,True,48301718,12075429,74184,37092,37092,72FwbpFGoLEazJEdpqNtPNefsadUrimUqma9wSoy4qiS,2967363,10235104,-7267741,614
2021-12-13 10:58:34-05:00,806,J1sBDjpdBZcsSBS5eg95SSRjRqmQUR9cXJCsLJu8yCUt,F5wRpD2senMkGbL8Uquqo8W9x5NQDDa268dHuVFAZCww,True,168898379,42224594,263543,131771,131772,72FwbpFGoLEazJEdpqNtPNefsadUrimUqma9wSoy4qiS,10541721,43963700,-33421979,624
2021-12-13 11:11:54-05:00,807,7mYQ2DJZ1YYMpNbpA93hCDtzQDhEHjAGxLJt2g4KeYTW,8nTKeruC3wiPjT7VytdM2gX7msjwbHxTkyhsR88GJgpc,True,54839751,13709937,83858,41929,41929,72FwbpFGoLEazJEdpqNtPNefsadUrimUqma9wSoy4qiS,3354334,12153880,-8799546,611
2021-12-13 11:11:54-05:00,808,BpvWyveup3q7q6Cws5TWkFYiZ8bQXRrfdxvzrN9FnYo6,2CWjropYSn9fJ66FT4zqUcwTrEaPp3CjGgoRATixyca1,True,31129854,7782463,47393,23696,23697,GmqQKnMfFxkv6ChqGaZ2wmSFDow7R1x7WeRfU58GVvfw,1895728,9780449,-7884721,608
2021-12-13 11:11:54-05:00,809,HqtTbC1LFreGvgfpZe7nCqkNnh8GHPQKosfmc19zb1yi,E39UNiHNkwQEd5GXkCtTPqSorQSB1kLx8kjzK4jdFoi3,True,8866528601,2216632150,12796268,6398134,6398134,GmqQKnMfFxkv6ChqGaZ2wmSFDow7R1x7WeRfU58GVvfw,511850727,2231812732,-1719962005,577
2021-12-13 11:11:54-05:00,810,Dng7By2saPu5TVxcvXidBe71ggBo8tiHkAXPi4kKL1tk,75ufEJmHbLHffphL7tvAXhGyftKLr1z2PXXoB2GGY5fG,True,45038150,11259537,68780,34390,34390,GmqQKnMfFxkv6ChqGaZ2wmSFDow7R1x7WeRfU58GVvfw,2751208,9730015,-6978807,610
2021-12-13 11:11:54-05:00,811,H6UTHgiUSkFbavHHZAfGB8R74SHcGDpQLeP1acduznG6,Gz56dyUAKnQ2WAHuCi8CWd5wsikowFvNAi4bzxPUpuyT,True,2146025923,536506480,3074178,1537089,1537089,GmqQKnMfFxkv6ChqGaZ2wmSFDow7R1x7WeRfU58GVvfw,122967122,476688699,-353721577,572
2021-12-13 11:11:54-05:00,812,4MmpDGUTyMcYEqJ1RoZ46AN2BhrBUseHaHqF8AmiTPyD,7HW2YZpYM349HMfW7u4h9ESZ1AXkwN8JcVDTNFzp9aTz,True,3427871896,856967974,4925115,2462557,2462558,GmqQKnMfFxkv6ChqGaZ2wmSFDow7R1x7WeRfU58GVvfw,197004622,988706506,-791701884,574
2021-12-13 11:11:54-05:00,813,F7ZpqKKvip659597Jpy6dB91CXS1Cqvxu734GV8mrWFk,BeCPgg2XqH44ed2BYYDadJNZzYTFKBHWhC2oFgQGZTCc,True,2149300755,537325188,3163708,1581854,1581854,GmqQKnMfFxkv6ChqGaZ2wmSFDow7R1x7WeRfU58GVvfw,126548349,476995094,-350446745,588
2021-12-13 11:12:01-05:00,814,9YEzjb49Awvedv9yNc6LG54SkGBug2RYiJwiUV13mGsS,3H8w5WCD187NWWoZMNUCzUDdxTgqrRJLga8gDzUVXBgZ,True,31316547,7829136,45191,22595,22596,GmqQKnMfFxkv6ChqGaZ2wmSFDow7R1x7WeRfU58GVvfw,1807660,11151762,-9344102,577
2021-12-13 11:12:11-05:00,815,2ce2v2TCbjNH635NgbwTG3sqiRWYrRRaBpxPxBZJ929q,9cnoebT43FkWDFhidndGCVNiFD4NErv8DuL1Va4Jv9S8,True,158424857,39606214,243801,121900,121901,GmqQKnMfFxkv6ChqGaZ2wmSFDow7R1x7WeRfU58GVvfw,9752073,78578240,-68826167,615
2021-12-13 11:12:11-05:00,816,8G2hAWXgJZRNMv32dcGkCrsMpqs1aTmGo2rsDm2VZ5Fn,4PMxnUH1oQQdtchAZ2sKDYkg8iiFCFxCS7yE9iP5bQyi,True,23019510,5754877,35144,17572,17572,GmqQKnMfFxkv6ChqGaZ2wmSFDow7R1x7WeRfU58GVvfw,1405798,10999230,-9593432,610
2021-12-13 11:12:12-05:00,817,2XnLbeSYLmYWRhErrHMyaXTFtLGMZu6S5fDzp3KkFGC5,8zatCNqr7MQuJXeL7aUFSDGrrEEwa6fgviFu6M1WErHX,True,125008141,31252035,192825,96412,96413,GmqQKnMfFxkv6ChqGaZ2wmSFDow7R1x7WeRfU58GVvfw,7713026,30294055,-22581029,617
2021-12-13 11:12:18-05:00,818,7jvKp6onXyWgwsFrFWj4hYTXJsYYD6ot5mn6rPFuJriy,J7N6HiozevJVTiY9hDEUs2ud5BwT5QSE7wnMBS1w5ie2,True,1549577006,387394251,2388968,1194484,1194484,GmqQKnMfFxkv6ChqGaZ2wmSFDow7R1x7WeRfU58GVvfw,95558748,444595155,-349036407,616
2021-12-13 11:12:20-05:00,819,4FazDUgfQ3AKoFcnWHr8E9Ht8jLA3tkxf75yrGZVHdmF,HzRMH6mbgEKydRCnnMvSsKgTEVNQi6nuzoR1xutYFdzg,True,1614021,403505,2483,1241,1242,GmqQKnMfFxkv6ChqGaZ2wmSFDow7R1x7WeRfU58GVvfw,99334,733230,-633896,615
2021-12-13 11:12:50-05:00,820,GGGyesjbt7h2XHHp9u8vpiWGugFwEbrtYaKrNQSDhQd7,8tydo1ZjGHmPBSqU33tywB3f9szdsHk1ckGFe4Ay5pgs,True,1321407853,330351963,2000282,1000141,1000141,GmqQKnMfFxkv6ChqGaZ2wmSFDow7R1x7WeRfU58GVvfw,80011284,647583802,-567572518,605
2021-12-13 11:12:50-05:00,821,Hkn5Ghsa35dqjtkXHRvnx3wkSoo9hfuRGkdbhqhCzyy5,67C58WFj5x7evA4xTh3pj7FQL49xyxtCzcZVGRMwQyMi,True,1495447001,373861750,2222504,1111252,1111252,GmqQKnMfFxkv6ChqGaZ2wmSFDow7R1x7WeRfU58GVvfw,88900183,440707364,-351807181,594
2021-12-13 11:12:50-05:00,822,gHv15388BYFZ6PS2p7XTvT9QViJ1rjevHdykD6Pmvzh,9YZPTB6d7St4TPpMY2vP4rZ56B2ZvzViB1DLWbPLK1hn,True,285075050,71268761,422864,211432,211432,GmqQKnMfFxkv6ChqGaZ2wmSFDow7R1x7WeRfU58GVvfw,16914571,83733355,-66818784,593
2021-12-13 11:12:50-05:00,823,Cv5oVktxmqbU1SxraxH67NEWMKnjgA18R832Fhe9h74a,Cs7xBD4BDiohyopnaYDDChUtR9vmx7uwot6Qp9beQLzt,True,42185146,10546286,64902,32451,32451,4BnQKPLuE3DMTtxp8MjUBytgnhvxqq3ZTqZHTVZo4JJh,2596088,9166399,-6570311,615
2021-12-13 11:12:55-05:00,824,72L76qDRMK3M7X52zuuB9GVyvFFLDBZwFMpVjWjghXzA,4m2ZVuemUctu1edv4YJVAcjXzKwpbCmBujzoUmLDeA7h,True,49224163,12306040,76096,38048,38048,GmqQKnMfFxkv6ChqGaZ2wmSFDow7R1x7WeRfU58GVvfw,3043864,10519449,-7475585,618
2021-12-13 11:12:59-05:00,825,AHm7zF4rpaxaayBLn5QDHgJSp8KAr647s4cNvQ9wLgd7,FDM33WngED24pukBvSDpPAzinW6afVAeGReum5nyLRiC,True,21687165,5421791,33473,16736,16737,GmqQKnMfFxkv6ChqGaZ2wmSFDow7R1x7WeRfU58GVvfw,1338948,6086720,-4747772,617
2021-12-13 11:13:02-05:00,826,6QZamUpLHzSzJhj1XtzPP5dHQRvTUmaqRmntxcLfWwE3,D9F6yp639JKp473cZTsB5puUr1URdi18ZxZTFXE1p8py,True,44307322,11076830,64734,32367,32367,GmqQKnMfFxkv6ChqGaZ2wmSFDow7R1x7WeRfU58GVvfw,2589371,12090151,-9500780,584
2021-12-13 11:22:30-05:00,827,5Rxuqgs4CaSKbfDXqBMFXkLTQ9dxrUjThXzoy3ouYVtK,BgvbKru66ebrGUcFFymGTmsaQv6GgcGMybiWaXqzBtwX,True,19236960,4809240,29747,14873,14874,GmqQKnMfFxkv6ChqGaZ2wmSFDow7R1x7WeRfU58GVvfw,1189880,5154932,-3965052,618
2021-12-13 11:22:32-05:00,828,3VdSA9CED9f5swRwHX2U15U7J6Muaq8VPnCNy9CaGDHe,2YYstfnfdYic5NWmEbcUEHpccNUVd1EhuCkExvMsoMk8,True,622136160,155534040,942777,471388,471389,GmqQKnMfFxkv6ChqGaZ2wmSFDow7R1x7WeRfU58GVvfw,37711109,152455947,-114744838,606
2021-12-13 11:34:45-05:00,829,BgoKAyBNaJ1geeQ2FcGSHEQDWATVD3w3wmcNHtj8Awu3,8Haz7duE2ycueaJsGdrGNnK79KGHwnzKBpoafC8RZGg2,True,1313894088,328473522,2039719,1019859,1019860,GmqQKnMfFxkv6ChqGaZ2wmSFDow7R1x7WeRfU58GVvfw,81588773,349881389,-268292616,620
2021-12-13 11:36:57-05:00,830,3qyKG4juvhcDnhoSVAFibqJtk5i4q8vLVgvwzXtdk5KP,2ofR6Hdm8qgQfKnaNFouzzBs311xgPcxny4ViS7g2Wxo,True,36951850,9237962,57310,28655,28655,GmqQKnMfFxkv6ChqGaZ2wmSFDow7R1x7WeRfU58GVvfw,2292422,9667331,-7374909,620
2021-12-13 11:40:03-05:00,831,BCGo6RhFcVnLCzZxtEh5YDyfq59nEWXPyJ5STC9PkzA1,24ShUfs1AB1n5NUus99sZ58kuSvMPhVgpiiT56rcLHRk,True,209886508,52471627,326943,163471,163472,GmqQKnMfFxkv6ChqGaZ2wmSFDow7R1x7WeRfU58GVvfw,13077738,47935371,-34857633,623
2021-12-13 14:10:46-05:00,832,36ByQojnxEckWdQTjqHfxKqCx9yjqWQsPsZyqaN72UWR,AZoirtS1fjX61agRM64tqThVinnJTh3BWgiHyNHPTgZP,True,54695063,13673765,85490,42745,42745,GmqQKnMfFxkv6ChqGaZ2wmSFDow7R1x7WeRfU58GVvfw,3419612,13921606,-10501994,625
2021-12-13 14:17:16-05:00,833,DTWFNeptqa59hRfBzQUVtVjto8fmRW7TvXcH8Tz8PXkT,67JFe2J2ZVJJWkGcYBeJUhXsScYAH2zTJbzfmFL1kGDb,True,177743746,44435936,275658,137829,137829,GmqQKnMfFxkv6ChqGaZ2wmSFDow7R1x7WeRfU58GVvfw,11026326,80759750,-69733424,620
2021-12-13 14:17:16-05:00,834,BQBQicboM5o25LihnffqxcJmoPoA3mgBKNeG4H8UTHVh,E8rJFAs7dbDmQA1o5aTeNqdmADxWMd5cDzvwAGMFFCix,True,39748338,9937084,61406,30703,30703,GmqQKnMfFxkv6ChqGaZ2wmSFDow7R1x7WeRfU58GVvfw,2456276,20981622,-18525346,617
2021-12-13 14:17:16-05:00,835,73PpLzJmAimmqtjGpRcYHua8t6wx3gYiiXFvQxnSDMJV,CRCpLcS8LNKX22co94spJBXEes9Fnh5rYBvbVEte4JXA,True,166457530,41614382,258942,129471,129471,GmqQKnMfFxkv6ChqGaZ2wmSFDow7R1x7WeRfU58GVvfw,10357691,75628647,-65270956,622
2021-12-13 14:17:16-05:00,836,4nEJqarcHzgizZsc11SYg3PP5E91nsjqzzNxUCSYA5sb,zayUU1osJ9byFsmsi9CZqvQAhtEenpmXv2UwN6YDt6B,True,176142826,44035706,273753,136876,136877,GmqQKnMfFxkv6ChqGaZ2wmSFDow7R1x7WeRfU58GVvfw,10950149,80034677,-69084528,621
2021-12-13 14:17:17-05:00,837,6VBYUiLyQXvvsDmq1vh1oJ5VeA89tGgxtkgFfofc372m,35pyoeRA4duKX7njdYny3KffM2xaxuWUZGRUMQJ5iAiu,True,163238378,40809594,254464,127232,127232,GmqQKnMfFxkv6ChqGaZ2wmSFDow7R1x7WeRfU58GVvfw,10178560,74169015,-63990455,623
2021-12-13 14:17:18-05:00,838,GqAS41YJssg9aaEp3hs3sG98APCsXhiQBQszXaSjZ2bN,2wodJ3AhrXdE1T4oVL95KvoBND7PubG5Wd5GWiLCMZJU,True,4988735061,1247183765,7708215,3854107,3854108,GmqQKnMfFxkv6ChqGaZ2wmSFDow7R1x7WeRfU58GVvfw,308328620,2687872505,-2379543885,618
2021-12-13 14:17:27-05:00,839,Fw2e6jxKVeFcJSe9MyVhSz3dUdJQLs3XULHrT1mtMU9U,591U5bexgLRJXygtK5fpCRXcZEq89KgewFTdfPkti8bY,True,168065468,42016367,261600,130800,130800,4BnQKPLuE3DMTtxp8MjUBytgnhvxqq3ZTqZHTVZo4JJh,10464016,76376838,-65912822,622
2021-12-13 14:17:31-05:00,840,DjbEch16uzdDtujFUeqxjquTTS3JXzEys8e9ogUv3aTy,6N8eKb3kfcbJEUZKZERiFiUR4hubB635D8Sotiji2TU8,True,169686274,42421568,264416,132208,132208,GmqQKnMfFxkv6ChqGaZ2wmSFDow7R1x7WeRfU58GVvfw,10576653,77118461,-66541808,623
2021-12-13 14:17:31-05:00,841,6kt64nJRnYaWMi9GbpZaUuhbToAVRd7FUMTGASAAJrve,2Sdxv9ZtogNcVbJwBPxKmVjwAiKyX5GHEfnRmFcydQ1G,True,164782916,41195729,255785,127892,127893,GmqQKnMfFxkv6ChqGaZ2wmSFDow7R1x7WeRfU58GVvfw,10231433,74927176,-64695743,620
2021-12-13 14:17:31-05:00,842,B4Uc39nKzz9wBRQsCkMR4A7RwTJ8rSuwpR6EQn2AesRb,H49bGZgatRZVpj6QufZRVgYrQtH7LpdbiqKBs23151m,True,680122595,170030648,1061374,530687,530687,GmqQKnMfFxkv6ChqGaZ2wmSFDow7R1x7WeRfU58GVvfw,42454976,412331381,-369876405,624
2021-12-13 14:17:32-05:00,843,9bhB755nk1VKCFQ15knBRdXESNqN6T1o3Lp3u214mARe,FvZuSbYfVMwGg8UUurGDFe7VVtoUBghrPNFYTr2gKCFc,True,174541906,43635476,272241,136120,136121,GmqQKnMfFxkv6ChqGaZ2wmSFDow7R1x7WeRfU58GVvfw,10889676,79325279,-68435603,623
2021-12-13 14:17:37-05:00,844,BrHRMouGRz3LBNzd9anfdYMhWfg8yUPHL4PqJ8WdEDFS,4uzoLa3mC2VYHAPBoHLX4gTjPTC28rPf2fvEGtJWPYc,True,1598732885,399683221,2487278,1243639,1243639,GmqQKnMfFxkv6ChqGaZ2wmSFDow7R1x7WeRfU58GVvfw,99491144,855014211,-755523067,622
2021-12-13 14:17:58-05:00,845,Ggjn39zkoAcCcmDmmzqYw8RFsMqjQGtAX8myhB3p4WQ4,FWnftuAeU86mR8RMR9qQwLfkujqcfzEiupBPkvWre3RS,True,172922738,43230684,270498,135249,135249,GmqQKnMfFxkv6ChqGaZ2wmSFDow7R1x7WeRfU58GVvfw,10819948,78624905,-67804957,625
2021-12-13 14:17:59-05:00,846,Ad4hjpPdExRAqUATSvqZYLBVNBcmtB2Pqh6MWwc1XGj,6TnqcHDyBnSZMds1eUc28aKuBThwGjAPsnaFKeC2fGnK,True,171323222,42830805,267770,133885,133885,GmqQKnMfFxkv6ChqGaZ2wmSFDow7R1x7WeRfU58GVvfw,10710831,77865541,-67154710,625
2021-12-13 14:18:16-05:00,847,4M7XECgNotuYef6fXsB659bgvA4LBYq9WrUFZP8jEZ8q,EjF9ZKUaBWZodjKy7ET7rEyK1uSsKX2cvcd4eJSYarF8,True,219174653,54793663,343000,171500,171500,72FwbpFGoLEazJEdpqNtPNefsadUrimUqma9wSoy4qiS,13720000,49008554,-35288554,625
2021-12-13 14:18:53-05:00,848,29rwdfrBkccfAXJdN6rhW5JNpCzDhg4oWF9ntWtMpQvo,HCjTVhGTSSqJFwQY68vSXYF7dQ1QCtz4EZca4HqmkYuo,True,189252214,47313053,294164,147082,147082,4BnQKPLuE3DMTtxp8MjUBytgnhvxqq3ZTqZHTVZo4JJh,11766575,87073970,-75307395,621
2021-12-13 14:19:07-05:00,849,EXP61AETWHw3kHSjrJH1jQBt6cXR9Zebz34Cueb3KAzg,2JT9GrgdUKjuQQtXvZqevbjFquUQBMYDoADmBjDKWXj3,True,1680136338,420034084,2624923,1312461,1312462,GmqQKnMfFxkv6ChqGaZ2wmSFDow7R1x7WeRfU58GVvfw,104996936,772000910,-667003974,624
2021-12-13 14:22:55-05:00,850,Dn916KSmX3HqxT53hrxrbCrV3tdRMCPdaoiRLqetMrth,ATCXRiXgnjRRUbSTPBvtBXMENCqsViexSZbZ6aDaXXWA,True,61554767,15388691,94989,47494,47495,GmqQKnMfFxkv6ChqGaZ2wmSFDow7R1x7WeRfU58GVvfw,3799594,13228703,-9429109,617
2021-12-13 14:23:53-05:00,851,HGAFdundf5voDqeh9g7d6Q9mgMf8eEg898QMRBqwPZ6C,deanBuZXWBHEe2TGfP37S9aMBEnEgmZoyRJjAvruzfA,True,111303704,27825925,174098,87049,87049,GmqQKnMfFxkv6ChqGaZ2wmSFDow7R1x7WeRfU58GVvfw,6963955,57016501,-50052546,625
2021-12-13 14:24:36-05:00,852,H6UTHgiUSkFbavHHZAfGB8R74SHcGDpQLeP1acduznG6,Gz56dyUAKnQ2WAHuCi8CWd5wsikowFvNAi4bzxPUpuyT,True,1589586142,397396535,2480482,1240241,1240241,GmqQKnMfFxkv6ChqGaZ2wmSFDow7R1x7WeRfU58GVvfw,99219317,384586759,-285367442,624
2021-12-13 14:24:39-05:00,853,4MmpDGUTyMcYEqJ1RoZ46AN2BhrBUseHaHqF8AmiTPyD,7HW2YZpYM349HMfW7u4h9ESZ1AXkwN8JcVDTNFzp9aTz,True,2538094072,634523518,3952177,1976088,1976089,GmqQKnMfFxkv6ChqGaZ2wmSFDow7R1x7WeRfU58GVvfw,158087098,785058697,-626971599,622
2021-12-13 14:24:43-05:00,854,3njiRuSRMXRzKmamyiR72Hc38PU8UDDmWdfPhgxmGxEW,5WoF3gkgygyNNbwxWgVfqGWkExcDixuzgJQQjXEZQ6J5,True,9760066937,2440016734,15139937,7569968,7569969,GmqQKnMfFxkv6ChqGaZ2wmSFDow7R1x7WeRfU58GVvfw,605597516,4773374435,-4167776919,620
2021-12-13 14:24:44-05:00,855,HqtTbC1LFreGvgfpZe7nCqkNnh8GHPQKosfmc19zb1yi,E39UNiHNkwQEd5GXkCtTPqSorQSB1kLx8kjzK4jdFoi3,True,6557868124,1639467031,10099141,5049570,5049571,GmqQKnMfFxkv6ChqGaZ2wmSFDow7R1x7WeRfU58GVvfw,403965674,1788465935,-1384500261,616
2021-12-13 14:24:55-05:00,856,9YEzjb49Awvedv9yNc6LG54SkGBug2RYiJwiUV13mGsS,3H8w5WCD187NWWoZMNUCzUDdxTgqrRJLga8gDzUVXBgZ,True,23162453,5790613,35667,17833,17834,GmqQKnMfFxkv6ChqGaZ2wmSFDow7R1x7WeRfU58GVvfw,1426707,8759824,-7333117,615
2021-12-13 14:25:58-05:00,857,7iUx7JBwqUvPVPeCqMEXQdLccZJmaFYm1DUQiu3ouHa3,3EVZzhRmJnX9ZiBZZo9tenDtMogAyuA1yf2cKzvUWiuu,True,40452846,10113211,62378,31189,31189,72FwbpFGoLEazJEdpqNtPNefsadUrimUqma9wSoy4qiS,2495129,9868985,-7373856,616
2021-12-13 14:25:58-05:00,858,F7ZpqKKvip659597Jpy6dB91CXS1Cqvxu734GV8mrWFk,BeCPgg2XqH44ed2BYYDadJNZzYTFKBHWhC2oFgQGZTCc,True,1588473476,397118369,2478526,1239263,1239263,72FwbpFGoLEazJEdpqNtPNefsadUrimUqma9wSoy4qiS,99141065,385621353,-286480288,624
2021-12-13 14:25:59-05:00,859,AaMCg49sJwNtdB5wHACg15TYAzzJXy8xtG4zuVXhKiVE,HbDYqDa9bewGPvsiaHRM9HmEvh1scPaUaGvqog66gYir,True,35111320,8777830,53815,26907,26908,GmqQKnMfFxkv6ChqGaZ2wmSFDow7R1x7WeRfU58GVvfw,2152628,8141761,-5989133,613
2021-12-13 14:26:30-05:00,860,EAUFD16wab8qRMJ4H6updHGt4xFqgRCDeRHVCsLCTSTL,8vkfYSyCyBY9g4TZrp52jUcQj6udy9xAaA4fioRE2RXx,True,484121874,121030468,756977,378488,378489,GmqQKnMfFxkv6ChqGaZ2wmSFDow7R1x7WeRfU58GVvfw,30279101,160849101,-130570000,625
2021-12-13 14:26:42-05:00,861,gMjmD7WioyUdQdwNqE5fobLcxPwoJv5rAvLmJaf8Jjw,5n77euFjVJiwKrnbYq1KpcENW1mzBZj2BuDGyzazrkJ8,True,43515614,10878902,66868,33434,33434,GmqQKnMfFxkv6ChqGaZ2wmSFDow7R1x7WeRfU58GVvfw,2674739,9604288,-6929549,614
2021-12-13 14:26:58-05:00,862,DGbj8tnqECzM9FG8j225Ap7A4Fdm3J1Ksm32JBFG7igv,Cd3D2UVwoSZLygM2e3UQppQANsokpmx5CNBs1C5zueay,True,43918442,10979610,67714,33857,33857,GmqQKnMfFxkv6ChqGaZ2wmSFDow7R1x7WeRfU58GVvfw,2708560,9334553,-6625993,616
2021-12-13 14:27:57-05:00,863,4KMzwWHPeW51cxu4nMpbqCaqo96dMqaHWyRCGQktfQfd,F7q4GNYcbnZa8dJ4qovQwjmxpKpdEmdxQMXRPb9nQupa,True,35542261,8885564,55147,27573,27574,GmqQKnMfFxkv6ChqGaZ2wmSFDow7R1x7WeRfU58GVvfw,2205884,8467392,-6261508,620
2021-12-13 14:28:10-05:00,864,Gbxc51WERLLeCtiHv7rDvE52aqF541RoQWG5n5aqErq6,4ngBoHbfXijLMqGKxFMNht9sbmxy2g5eqBmn8QsBmbx1,True,35617831,8904457,54731,27365,27366,GmqQKnMfFxkv6ChqGaZ2wmSFDow7R1x7WeRfU58GVvfw,2189246,8566250,-6377004,614
2021-12-13 14:28:17-05:00,865,7mYQ2DJZ1YYMpNbpA93hCDtzQDhEHjAGxLJt2g4KeYTW,8nTKeruC3wiPjT7VytdM2gX7msjwbHxTkyhsR88GJgpc,True,40354269,10088567,61900,30950,30950,GmqQKnMfFxkv6ChqGaZ2wmSFDow7R1x7WeRfU58GVvfw,2476032,9851382,-7375350,613
2021-12-13 14:28:18-05:00,866,BpvWyveup3q7q6Cws5TWkFYiZ8bQXRrfdxvzrN9FnYo6,2CWjropYSn9fJ66FT4zqUcwTrEaPp3CjGgoRATixyca1,True,22856681,5714170,33672,16836,16836,GmqQKnMfFxkv6ChqGaZ2wmSFDow7R1x7WeRfU58GVvfw,1346897,7751236,-6404339,589
2021-12-13 14:28:18-05:00,867,8G2hAWXgJZRNMv32dcGkCrsMpqs1aTmGo2rsDm2VZ5Fn,4PMxnUH1oQQdtchAZ2sKDYkg8iiFCFxCS7yE9iP5bQyi,True,16922071,4230517,25503,12751,12752,GmqQKnMfFxkv6ChqGaZ2wmSFDow7R1x7WeRfU58GVvfw,1020150,8557820,-7537670,602
2021-12-13 14:28:27-05:00,868,2ce2v2TCbjNH635NgbwTG3sqiRWYrRRaBpxPxBZJ929q,9cnoebT43FkWDFhidndGCVNiFD4NErv8DuL1Va4Jv9S8,True,116480663,29120165,177890,88945,88945,GmqQKnMfFxkv6ChqGaZ2wmSFDow7R1x7WeRfU58GVvfw,7115632,61074243,-53958611,610
2021-12-13 14:28:27-05:00,869,4FazDUgfQ3AKoFcnWHr8E9Ht8jLA3tkxf75yrGZVHdmF,HzRMH6mbgEKydRCnnMvSsKgTEVNQi6nuzoR1xutYFdzg,True,1186360,296590,1803,901,902,GmqQKnMfFxkv6ChqGaZ2wmSFDow7R1x7WeRfU58GVvfw,72139,571791,-499652,608
2021-12-13 14:28:29-05:00,870,2XnLbeSYLmYWRhErrHMyaXTFtLGMZu6S5fDzp3KkFGC5,8zatCNqr7MQuJXeL7aUFSDGrrEEwa6fgviFu6M1WErHX,True,91913808,22978452,140869,70434,70435,GmqQKnMfFxkv6ChqGaZ2wmSFDow7R1x7WeRfU58GVvfw,5634772,24413389,-18778617,613
2021-12-13 14:28:29-05:00,871,6QZamUpLHzSzJhj1XtzPP5dHQRvTUmaqRmntxcLfWwE3,D9F6yp639JKp473cZTsB5puUr1URdi18ZxZTFXE1p8py,True,32731710,8182927,50262,25131,25131,GmqQKnMfFxkv6ChqGaZ2wmSFDow7R1x7WeRfU58GVvfw,2010496,9634956,-7624460,614
2021-12-13 14:28:30-05:00,872,gHv15388BYFZ6PS2p7XTvT9QViJ1rjevHdykD6Pmvzh,9YZPTB6d7St4TPpMY2vP4rZ56B2ZvzViB1DLWbPLK1hn,True,210549518,52637379,328471,164235,164236,GmqQKnMfFxkv6ChqGaZ2wmSFDow7R1x7WeRfU58GVvfw,13138850,66511882,-53373032,624
2021-12-13 14:28:46-05:00,873,Hkn5Ghsa35dqjtkXHRvnx3wkSoo9hfuRGkdbhqhCzyy5,67C58WFj5x7evA4xTh3pj7FQL49xyxtCzcZVGRMwQyMi,True,1104510235,276127558,1727104,863552,863552,GmqQKnMfFxkv6ChqGaZ2wmSFDow7R1x7WeRfU58GVvfw,69084184,350088377,-281004193,625
2021-12-13 14:29:32-05:00,874,6woJkgUd2cpQQQBEp1C2G9NsYAvPwYmZXXTd6AxhieMy,E6xCdLJbDq5qFsvHEffD1Qfqrsj19H81mbj7XMUXUPnr,True,911687413,227921853,1422494,711247,711247,GmqQKnMfFxkv6ChqGaZ2wmSFDow7R1x7WeRfU58GVvfw,56899774,242013486,-185113712,624
2021-12-13 14:29:32-05:00,875,DH2tcZVt4nHQbph6znZRrwcyhjwiNYtgeamu72vcC6nR,ACsbP5BDFQEHQHTsdrWTBShhEUh9HeAKsE7iwyK72v2p,True,44057975,11014493,67953,33976,33977,GmqQKnMfFxkv6ChqGaZ2wmSFDow7R1x7WeRfU58GVvfw,2718147,11864562,-9146415,616
2021-12-13 14:29:34-05:00,876,FCrgF8s6BHP9Hho11yzZgbSaVXraUxJA3zSEzQK52DFQ,HAikgTkQvmKEseE5mXxVFKe1pyvVmTZePHh4M27YgFDg,True,3240393,810098,4625,2312,2313,GmqQKnMfFxkv6ChqGaZ2wmSFDow7R1x7WeRfU58GVvfw,185024,695491,-510467,570
2021-12-13 14:31:37-05:00,877,6wYw2tQWSj6YzrPL8s5ZVp4pKnX4tUdovt8wzUCyoWfs,DCuvqHhUwZiZ2XZGyxPREjEA5WQZNwuV9eAcFMEeS3a5,True,1238345280,309586320,1936449,968224,968225,GmqQKnMfFxkv6ChqGaZ2wmSFDow7R1x7WeRfU58GVvfw,77457968,290563167,-213105199,625
2021-12-13 14:31:54-05:00,878,C1CsbgQFvEvSXzuVHTr39tQHr3drDhjxeYiotd8eNocF,4rAaTCAMj5VpgNVKiYizabH7cMLhEA12seu2QXQNTyV3,True,62826974,15706743,97912,48956,48956,GmqQKnMfFxkv6ChqGaZ2wmSFDow7R1x7WeRfU58GVvfw,3916504,16810895,-12894391,623
2021-12-13 14:33:14-05:00,879,Fn6J1eMQJoA5rXCwX2HjAF86AowsJfULLuYXVfzgb8aX,6Ett2WPmz4HoWVSVEZD73UzFetd3oFSh7C676MEVYd36,True,2032899991,508224997,2943267,1471633,1471634,72FwbpFGoLEazJEdpqNtPNefsadUrimUqma9wSoy4qiS,117730689,786619547,-668888858,579
2021-12-13 14:33:14-05:00,880,34235h7L3VPHqcUkLycAsaJAXyq4vtgoG27yei34CKaj,Bg6WtWMQXGBakzrizVhBrE1X2hafMHBtktn3YYjeyscf,True,406584404,101646101,593541,296770,296771,72FwbpFGoLEazJEdpqNtPNefsadUrimUqma9wSoy4qiS,23741678,154538866,-130797188,583
2021-12-13 14:33:14-05:00,881,F4hN7ecndZ8Gr5KQNSFaSrMGawMasz7jfWTLTMpk7gaB,AJ23FpXSGjipcqywk88WGsKfqfiiUjPzZLsvLtBAhB12,True,208566052,52141513,301596,150798,150798,GmqQKnMfFxkv6ChqGaZ2wmSFDow7R1x7WeRfU58GVvfw,12063878,47694729,-35630851,578
2021-12-13 14:33:27-05:00,882,3EkaWW2WfpdRsgX7KF2DxjW4DA5qyvHMRtUNrea7c5Bk,B9JxYbj471pp49bkZic3LWfWFVT75oJd3UzMcysYitdg,True,68662080,17165520,105625,52812,52813,GmqQKnMfFxkv6ChqGaZ2wmSFDow7R1x7WeRfU58GVvfw,4225010,15215062,-10990052,615
2021-12-13 14:33:34-05:00,883,9WJBnVi84E926j7xEd566WzrZJkPJWRgmEnYj9vyjuad,4dLaFS5F7TGyLdwuJLMGkz3bSL53aHzd9ZfpNmhHxXeF,True,1410622560,352655640,2175640,1087820,1087820,GmqQKnMfFxkv6ChqGaZ2wmSFDow7R1x7WeRfU58GVvfw,87025614,291849782,-204824168,616
2021-12-13 14:33:48-05:00,884,AoPQqPjLPi8fZiLkhMGLRj6oD5k2asrvJtCkpW19DvGr,H5Sgmf1VuY13iHjPuLJ2q9wtSdkXG1AQsEv2eq6zzm8Y,True,34736279,8684069,53176,26588,26588,GmqQKnMfFxkv6ChqGaZ2wmSFDow7R1x7WeRfU58GVvfw,2127063,8123451,-5996388,612
2021-12-13 14:34:24-05:00,885,D58t4uTjFumsUeYFaKnpV8BRTEQEqKXBreFTdwGrott7,67p6kHDfVqQijfcwugvZK59c3aRRH9x3eHxruqH8WEqF,True,35514638,8878659,55367,27683,27684,GmqQKnMfFxkv6ChqGaZ2wmSFDow7R1x7WeRfU58GVvfw,2214701,8513463,-6298762,623
2021-12-13 14:34:38-05:00,886,5gN3624v6n1zQ1BKtZi1e9ZLpbCa4MEfhgHySFB81Qfm,UXT3oB5ud18rBsygsfxwA93kQYdSNbbzTCjt4gtU2jP,True,41006316,10251578,62825,31412,31413,GmqQKnMfFxkv6ChqGaZ2wmSFDow7R1x7WeRfU58GVvfw,2513027,9615449,-7102422,612
2021-12-13 14:34:47-05:00,887,AHm7zF4rpaxaayBLn5QDHgJSp8KAr647s4cNvQ9wLgd7,FDM33WngED24pukBvSDpPAzinW6afVAeGReum5nyLRiC,True,15962876,3990719,24886,12443,12443,GmqQKnMfFxkv6ChqGaZ2wmSFDow7R1x7WeRfU58GVvfw,995459,4858802,-3863343,623
2021-12-13 14:34:47-05:00,888,2FrqGFZjbiNykJyo9BZ5S9FguQJPJiTi681rJJsQ5dta,3QUncYP92NKrfpaTvuF9iQg11PXKgZAgEngwh6BbnCCj,True,15919361,3979840,24702,12351,12351,GmqQKnMfFxkv6ChqGaZ2wmSFDow7R1x7WeRfU58GVvfw,988108,3583195,-2595087,620
2021-12-13 14:34:47-05:00,889,GGGyesjbt7h2XHHp9u8vpiWGugFwEbrtYaKrNQSDhQd7,8tydo1ZjGHmPBSqU33tywB3f9szdsHk1ckGFe4Ay5pgs,True,972559159,243139789,1476404,738202,738202,GmqQKnMfFxkv6ChqGaZ2wmSFDow7R1x7WeRfU58GVvfw,59056165,503298963,-444242798,607
2021-12-13 14:35:00-05:00,890,7jvKp6onXyWgwsFrFWj4hYTXJsYYD6ot5mn6rPFuJriy,J7N6HiozevJVTiY9hDEUs2ud5BwT5QSE7wnMBS1w5ie2,True,1141059590,285264897,1783302,891651,891651,GmqQKnMfFxkv6ChqGaZ2wmSFDow7R1x7WeRfU58GVvfw,71332086,354278587,-282946501,625
2021-12-13 14:35:01-05:00,891,6yw4GPvkqUbakcEWtqSCfjVLukty11xqjDpGxtEN9Km2,5ppEx7wkpqbG5nApCWMdRja3oRSheFmAAsNHUX7h2w2Y,True,31757776,7939444,48152,24076,24076,GmqQKnMfFxkv6ChqGaZ2wmSFDow7R1x7WeRfU58GVvfw,1926082,19881963,-17955881,606
2021-12-13 14:35:02-05:00,892,BhiAaiZu7fF8ndggJrLyiFVCRq526cNBw7VaeascEmNL,4en8MipPi7vq15NGhpPMQfptNdEyhp2j7fpgxBBtjyfz,True,41521390,10380347,64518,32259,32259,GmqQKnMfFxkv6ChqGaZ2wmSFDow7R1x7WeRfU58GVvfw,2580745,8826159,-6245414,621
2021-12-13 14:36:59-05:00,893,DTWFNeptqa59hRfBzQUVtVjto8fmRW7TvXcH8Tz8PXkT,67JFe2J2ZVJJWkGcYBeJUhXsScYAH2zTJbzfmFL1kGDb,True,130739214,32684803,204551,102275,102276,GmqQKnMfFxkv6ChqGaZ2wmSFDow7R1x7WeRfU58GVvfw,8182072,63051954,-54869882,625
2021-12-13 14:37:02-05:00,894,BQBQicboM5o25LihnffqxcJmoPoA3mgBKNeG4H8UTHVh,E8rJFAs7dbDmQA1o5aTeNqdmADxWMd5cDzvwAGMFFCix,True,29236731,7309182,45508,22754,22754,GmqQKnMfFxkv6ChqGaZ2wmSFDow7R1x7WeRfU58GVvfw,1820347,16288986,-14468639,622
2021-12-13 14:37:20-05:00,895,GqAS41YJssg9aaEp3hs3sG98APCsXhiQBQszXaSjZ2bN,2wodJ3AhrXdE1T4oVL95KvoBND7PubG5Wd5GWiLCMZJU,True,3670092028,917523007,5729028,2864514,2864514,GmqQKnMfFxkv6ChqGaZ2wmSFDow7R1x7WeRfU58GVvfw,229161137,2086261692,-1857100555,624
2021-12-13 14:37:21-05:00,896,4nEJqarcHzgizZsc11SYg3PP5E91nsjqzzNxUCSYA5sb,zayUU1osJ9byFsmsi9CZqvQAhtEenpmXv2UwN6YDt6B,True,129501384,32375346,201766,100883,100883,GmqQKnMfFxkv6ChqGaZ2wmSFDow7R1x7WeRfU58GVvfw,8070660,62490962,-54420302,623
2021-12-13 14:37:25-05:00,897,73PpLzJmAimmqtjGpRcYHua8t6wx3gYiiXFvQxnSDMJV,CRCpLcS8LNKX22co94spJBXEes9Fnh5rYBvbVEte4JXA,True,122378309,30594577,190847,95423,95424,GmqQKnMfFxkv6ChqGaZ2wmSFDow7R1x7WeRfU58GVvfw,7633910,59053056,-51419146,623
2021-12-13 14:37:26-05:00,898,6VBYUiLyQXvvsDmq1vh1oJ5VeA89tGgxtkgFfofc372m,35pyoeRA4duKX7njdYny3KffM2xaxuWUZGRUMQJ5iAiu,True,120013308,30003327,187715,93857,93858,GmqQKnMfFxkv6ChqGaZ2wmSFDow7R1x7WeRfU58GVvfw,7508620,57917977,-50409357,625
2021-12-13 14:37:31-05:00,899,6kt64nJRnYaWMi9GbpZaUuhbToAVRd7FUMTGASAAJrve,2Sdxv9ZtogNcVbJwBPxKmVjwAiKyX5GHEfnRmFcydQ1G,True,121195224,30298806,189592,94796,94796,GmqQKnMfFxkv6ChqGaZ2wmSFDow7R1x7WeRfU58GVvfw,7583685,58498512,-50914827,625
2021-12-13 14:37:45-05:00,900,Fw2e6jxKVeFcJSe9MyVhSz3dUdJQLs3XULHrT1mtMU9U,591U5bexgLRJXygtK5fpCRXcZEq89KgewFTdfPkti8bY,True,123422662,30855665,189399,94699,94700,GmqQKnMfFxkv6ChqGaZ2wmSFDow7R1x7WeRfU58GVvfw,7575977,59638152,-52062175,613
2021-12-13 14:37:50-05:00,901,29rwdfrBkccfAXJdN6rhW5JNpCzDhg4oWF9ntWtMpQvo,HCjTVhGTSSqJFwQY68vSXYF7dQ1QCtz4EZca4HqmkYuo,True,139094738,34773684,215699,107849,107850,GmqQKnMfFxkv6ChqGaZ2wmSFDow7R1x7WeRfU58GVvfw,8627988,67954341,-59326353,620
2021-12-13 14:37:57-05:00,902,BrHRMouGRz3LBNzd9anfdYMhWfg8yUPHL4PqJ8WdEDFS,4uzoLa3mC2VYHAPBoHLX4gTjPTC28rPf2fvEGtJWPYc,True,1174278570,293569642,1805819,902909,902910,GmqQKnMfFxkv6ChqGaZ2wmSFDow7R1x7WeRfU58GVvfw,72232772,663746898,-591514126,615
2021-12-13 14:37:57-05:00,903,Ggjn39zkoAcCcmDmmzqYw8RFsMqjQGtAX8myhB3p4WQ4,FWnftuAeU86mR8RMR9qQwLfkujqcfzEiupBPkvWre3RS,True,127003500,31750875,196522,98261,98261,GmqQKnMfFxkv6ChqGaZ2wmSFDow7R1x7WeRfU58GVvfw,7860896,61404361,-53543465,618
2021-12-13 14:37:57-05:00,904,4M7XECgNotuYef6fXsB659bgvA4LBYq9WrUFZP8jEZ8q,EjF9ZKUaBWZodjKy7ET7rEyK1uSsKX2cvcd4eJSYarF8,True,160976082,40244020,249302,124651,124651,GmqQKnMfFxkv6ChqGaZ2wmSFDow7R1x7WeRfU58GVvfw,9972092,39844911,-29872819,619
2021-12-13 14:37:57-05:00,905,Ad4hjpPdExRAqUATSvqZYLBVNBcmtB2Pqh6MWwc1XGj,6TnqcHDyBnSZMds1eUc28aKuBThwGjAPsnaFKeC2fGnK,True,125827668,31456917,194457,97228,97229,GmqQKnMfFxkv6ChqGaZ2wmSFDow7R1x7WeRfU58GVvfw,7778312,60810252,-53031940,618
2021-12-13 14:37:57-05:00,906,9bhB755nk1VKCFQ15knBRdXESNqN6T1o3Lp3u214mARe,FvZuSbYfVMwGg8UUurGDFe7VVtoUBghrPNFYTr2gKCFc,True,128135818,32033954,196170,98085,98085,GmqQKnMfFxkv6ChqGaZ2wmSFDow7R1x7WeRfU58GVvfw,7846823,61945303,-54098480,612
2021-12-13 14:37:58-05:00,907,DjbEch16uzdDtujFUeqxjquTTS3JXzEys8e9ogUv3aTy,6N8eKb3kfcbJEUZKZERiFiUR4hubB635D8Sotiji2TU8,True,124489006,31122251,188413,94206,94207,GmqQKnMfFxkv6ChqGaZ2wmSFDow7R1x7WeRfU58GVvfw,7536537,60219724,-52683187,605
2021-12-13 14:38:14-05:00,908,B4Uc39nKzz9wBRQsCkMR4A7RwTJ8rSuwpR6EQn2AesRb,H49bGZgatRZVpj6QufZRVgYrQtH7LpdbiqKBs23151m,True,499239240,124809810,763522,381761,381761,GmqQKnMfFxkv6ChqGaZ2wmSFDow7R1x7WeRfU58GVvfw,30540895,318820016,-288279121,611
2021-12-13 14:38:23-05:00,909,3VdSA9CED9f5swRwHX2U15U7J6Muaq8VPnCNy9CaGDHe,2YYstfnfdYic5NWmEbcUEHpccNUVd1EhuCkExvMsoMk8,True,458602560,114650640,711863,355931,355932,GmqQKnMfFxkv6ChqGaZ2wmSFDow7R1x7WeRfU58GVvfw,28474559,122549648,-94075089,620
2021-12-13 14:38:24-05:00,910,9KD2AifD5wFD4QkHYuawXbJgLWHrfj2QPF3fT8jhGVA5,Ga9gAqmkuHbqrr31sUFPqa1xa5WNxLWJWGPUaMxQqLdj,True,89022240,22255560,137909,68954,68955,GmqQKnMfFxkv6ChqGaZ2wmSFDow7R1x7WeRfU58GVvfw,5516375,24322966,-18806591,619
2021-12-13 14:38:34-05:00,911,HGAFdundf5voDqeh9g7d6Q9mgMf8eEg898QMRBqwPZ6C,deanBuZXWBHEe2TGfP37S9aMBEnEgmZoyRJjAvruzfA,True,81777649,20444411,127243,63621,63622,GmqQKnMfFxkv6ChqGaZ2wmSFDow7R1x7WeRfU58GVvfw,5089727,44329595,-39239868,622
2021-12-13 14:38:34-05:00,912,i7TcF4weYcqgrRdH3GpndbEYxCxfcSfr9JWYrAUg1CF,BkDfknUir7PnSEW8auoB87PytycEFwyX5kT2GY4SGJJL,True,82297761,20574440,128769,64384,64385,GmqQKnMfFxkv6ChqGaZ2wmSFDow7R1x7WeRfU58GVvfw,5150772,47840386,-42689614,625
2021-12-13 14:39:26-05:00,913,Gs3WP18hbzNpbBgiU39e6tfkggfCKRyNqPqJQcthuHFD,4XAY25YUma6gUdG2GdbXeivum3t21g93ZagfWGTZYkWZ,True,232061242,58015309,360412,180206,180206,GmqQKnMfFxkv6ChqGaZ2wmSFDow7R1x7WeRfU58GVvfw,14416495,61829736,-47413241,621
2021-12-13 14:39:36-05:00,914,5Rxuqgs4CaSKbfDXqBMFXkLTQ9dxrUjThXzoy3ouYVtK,BgvbKru66ebrGUcFFymGTmsaQv6GgcGMybiWaXqzBtwX,True,14152320,3538080,21891,10945,10946,GmqQKnMfFxkv6ChqGaZ2wmSFDow7R1x7WeRfU58GVvfw,875643,4125672,-3250029,618
2021-12-13 14:41:12-05:00,915,H6UTHgiUSkFbavHHZAfGB8R74SHcGDpQLeP1acduznG6,Gz56dyUAKnQ2WAHuCi8CWd5wsikowFvNAi4bzxPUpuyT,True,1168405957,292101489,1823879,911939,911940,GmqQKnMfFxkv6ChqGaZ2wmSFDow7R1x7WeRfU58GVvfw,72955185,310844325,-237889140,624
2021-12-13 14:41:13-05:00,916,4MmpDGUTyMcYEqJ1RoZ46AN2BhrBUseHaHqF8AmiTPyD,7HW2YZpYM349HMfW7u4h9ESZ1AXkwN8JcVDTNFzp9aTz,True,1866070357,466517589,2915868,1457934,1457934,GmqQKnMfFxkv6ChqGaZ2wmSFDow7R1x7WeRfU58GVvfw,116634724,624579067,-507944343,625
2021-12-13 14:41:21-05:00,917,2dSDhkCA6Z4wKwZV26EM7quSht4SPh7UakvWn553vs5i,5Yre8DiDyMc1u4SZH7MAHN8rbJ5qyipGXYN5WUkYzhmw,True,6843753153,1710938288,10688316,5344158,5344158,GmqQKnMfFxkv6ChqGaZ2wmSFDow7R1x7WeRfU58GVvfw,427532665,2048653657,-1621120992,624
2021-12-13 14:41:22-05:00,918,8eTH6eJyyVeMno3UQkffeBg32xofKsQfkhLhXdtaf87s,BCFC7CPXrQPsUfJb2eYSht8GhaApWHpc49AeCXqaYq13,True,35569361,8892339,54960,27480,27480,GmqQKnMfFxkv6ChqGaZ2wmSFDow7R1x7WeRfU58GVvfw,2198422,8321565,-6123143,618
2021-12-13 14:41:22-05:00,919,9YEzjb49Awvedv9yNc6LG54SkGBug2RYiJwiUV13mGsS,3H8w5WCD187NWWoZMNUCzUDdxTgqrRJLga8gDzUVXBgZ,True,17043257,4260814,26561,13280,13281,4BnQKPLuE3DMTtxp8MjUBytgnhvxqq3ZTqZHTVZo4JJh,1062457,6890961,-5828504,623
2021-12-13 14:42:21-05:00,920,84SgzR8J6DeqPJ1uXphP1BHMotYGKh3kS4owMMj9x58x,CL7Jkwe3NK4qaAVK2QjuftXnQ5YLqDT9qYeeEi7kJXrV,True,50978753096,12744688274,79248206,39624103,39624103,GmqQKnMfFxkv6ChqGaZ2wmSFDow7R1x7WeRfU58GVvfw,3169928269,22191175173,-19021246904,621
2021-12-13 14:42:33-05:00,921,7mYQ2DJZ1YYMpNbpA93hCDtzQDhEHjAGxLJt2g4KeYTW,8nTKeruC3wiPjT7VytdM2gX7msjwbHxTkyhsR88GJgpc,True,29673984,7418496,45560,22780,22780,GmqQKnMfFxkv6ChqGaZ2wmSFDow7R1x7WeRfU58GVvfw,1822414,7945731,-6123317,614
2021-12-13 14:42:33-05:00,922,Dng7By2saPu5TVxcvXidBe71ggBo8tiHkAXPi4kKL1tk,75ufEJmHbLHffphL7tvAXhGyftKLr1z2PXXoB2GGY5fG,True,33168358,8292089,51190,25595,25595,GmqQKnMfFxkv6ChqGaZ2wmSFDow7R1x7WeRfU58GVvfw,2047632,7899542,-5851910,617
2021-12-13 14:42:35-05:00,923,BpvWyveup3q7q6Cws5TWkFYiZ8bQXRrfdxvzrN9FnYo6,2CWjropYSn9fJ66FT4zqUcwTrEaPp3CjGgoRATixyca1,True,16844400,4211100,25377,12688,12689,72FwbpFGoLEazJEdpqNtPNefsadUrimUqma9wSoy4qiS,1015114,6116511,-5101397,602
2021-12-13 14:42:35-05:00,924,F7ZpqKKvip659597Jpy6dB91CXS1Cqvxu734GV8mrWFk,BeCPgg2XqH44ed2BYYDadJNZzYTFKBHWhC2oFgQGZTCc,True,1164082561,291020640,1734749,867374,867375,72FwbpFGoLEazJEdpqNtPNefsadUrimUqma9wSoy4qiS,69389993,311602691,-242212698,596
2021-12-13 14:42:35-05:00,925,8G2hAWXgJZRNMv32dcGkCrsMpqs1aTmGo2rsDm2VZ5Fn,4PMxnUH1oQQdtchAZ2sKDYkg8iiFCFxCS7yE9iP5bQyi,True,12468833,3117208,19298,9649,9649,72FwbpFGoLEazJEdpqNtPNefsadUrimUqma9wSoy4qiS,771926,6647922,-5875996,619
2021-12-13 14:42:44-05:00,926,EXP61AETWHw3kHSjrJH1jQBt6cXR9Zebz34Cueb3KAzg,2JT9GrgdUKjuQQtXvZqevbjFquUQBMYDoADmBjDKWXj3,True,1231050759,307762689,1833012,916506,916506,GmqQKnMfFxkv6ChqGaZ2wmSFDow7R1x7WeRfU58GVvfw,73320518,602701469,-529380951,595
2021-12-13 14:42:44-05:00,927,HqtTbC1LFreGvgfpZe7nCqkNnh8GHPQKosfmc19zb1yi,E39UNiHNkwQEd5GXkCtTPqSorQSB1kLx8kjzK4jdFoi3,True,4802304283,1200576070,6944243,3472121,3472122,GmqQKnMfFxkv6ChqGaZ2wmSFDow7R1x7WeRfU58GVvfw,277769723,1433639233,-1155869510,578
2021-12-13 14:42:44-05:00,928,EAUFD16wab8qRMJ4H6updHGt4xFqgRCDeRHVCsLCTSTL,8vkfYSyCyBY9g4TZrp52jUcQj6udy9xAaA4fioRE2RXx,True,354977855,88744463,535214,267607,267607,GmqQKnMfFxkv6ChqGaZ2wmSFDow7R1x7WeRfU58GVvfw,21408573,127454485,-106045912,603
2021-12-13 14:42:49-05:00,929,3njiRuSRMXRzKmamyiR72Hc38PU8UDDmWdfPhgxmGxEW,5WoF3gkgygyNNbwxWgVfqGWkExcDixuzgJQQjXEZQ6J5,True,7142196617,1785549154,10315099,5157549,5157550,GmqQKnMfFxkv6ChqGaZ2wmSFDow7R1x7WeRfU58GVvfw,412603993,3719936705,-3307332712,577
2021-12-13 14:43:04-05:00,930,4FazDUgfQ3AKoFcnWHr8E9Ht8jLA3tkxf75yrGZVHdmF,HzRMH6mbgEKydRCnnMvSsKgTEVNQi6nuzoR1xutYFdzg,True,873569,218392,1353,676,677,72FwbpFGoLEazJEdpqNtPNefsadUrimUqma9wSoy4qiS,54135,445145,-391010,619
2021-12-13 14:43:09-05:00,931,2ce2v2TCbjNH635NgbwTG3sqiRWYrRRaBpxPxBZJ929q,9cnoebT43FkWDFhidndGCVNiFD4NErv8DuL1Va4Jv9S8,True,85765134,21441283,133559,66779,66780,GmqQKnMfFxkv6ChqGaZ2wmSFDow7R1x7WeRfU58GVvfw,5342378,47407311,-42064933,622
2021-12-13 14:43:11-05:00,932,2XnLbeSYLmYWRhErrHMyaXTFtLGMZu6S5fDzp3KkFGC5,8zatCNqr7MQuJXeL7aUFSDGrrEEwa6fgviFu6M1WErHX,True,67674482,16918620,105825,52912,52913,72FwbpFGoLEazJEdpqNtPNefsadUrimUqma9wSoy4qiS,4233029,19578192,-15345163,625
2021-12-13 14:44:21-05:00,933,6QZamUpLHzSzJhj1XtzPP5dHQRvTUmaqRmntxcLfWwE3,D9F6yp639JKp473cZTsB5puUr1URdi18ZxZTFXE1p8py,True,24080941,6020235,37309,18654,18655,GmqQKnMfFxkv6ChqGaZ2wmSFDow7R1x7WeRfU58GVvfw,1492392,7678665,-6186273,619
2021-12-13 14:47:17-05:00,934,36ByQojnxEckWdQTjqHfxKqCx9yjqWQsPsZyqaN72UWR,AZoirtS1fjX61agRM64tqThVinnJTh3BWgiHyNHPTgZP,True,40203685,10050921,62912,31456,31456,GmqQKnMfFxkv6ChqGaZ2wmSFDow7R1x7WeRfU58GVvfw,2516509,11211627,-8695118,625
2021-12-13 15:08:38-05:00,935,FCrgF8s6BHP9Hho11yzZgbSaVXraUxJA3zSEzQK52DFQ,HAikgTkQvmKEseE5mXxVFKe1pyvVmTZePHh4M27YgFDg,True,2387658,596914,3420,1710,1710,3RdfgDvLvsdZG5Cf6hKiKMQMqfidyxHzjYvUx1FZpeHQ,136805,567455,-430650,572
2021-12-13 16:10:48-05:00,936,GKNBtZbwK4w9hyXD1r38NTGcTJhpjt8R9WFCzdXup9Tk,7RLaL2XoFuqrcCcPEB6FzPJzLnAhjQpwcRmDfdpRXFgB,True,1180469485,295117371,1833457,916728,916729,3RdfgDvLvsdZG5Cf6hKiKMQMqfidyxHzjYvUx1FZpeHQ,73338281,316818166,-243479885,621
2021-12-13 16:12:21-05:00,937,72L76qDRMK3M7X52zuuB9GVyvFFLDBZwFMpVjWjghXzA,4m2ZVuemUctu1edv4YJVAcjXzKwpbCmBujzoUmLDeA7h,True,36253185,9063296,56234,28117,28117,3RdfgDvLvsdZG5Cf6hKiKMQMqfidyxHzjYvUx1FZpeHQ,2249397,8521103,-6271706,620
2021-12-13 16:20:24-05:00,938,Cv5oVktxmqbU1SxraxH67NEWMKnjgA18R832Fhe9h74a,Cs7xBD4BDiohyopnaYDDChUtR9vmx7uwot6Qp9beQLzt,True,31088322,7772080,48362,24181,24181,3RdfgDvLvsdZG5Cf6hKiKMQMqfidyxHzjYvUx1FZpeHQ,1934480,7425204,-5490724,622
2021-12-13 18:52:14-05:00,939,F4hN7ecndZ8Gr5KQNSFaSrMGawMasz7jfWTLTMpk7gaB,AJ23FpXSGjipcqywk88WGsKfqfiiUjPzZLsvLtBAhB12,True,154416090,38604022,239541,119770,119771,4BnQKPLuE3DMTtxp8MjUBytgnhvxqq3ZTqZHTVZo4JJh,9581662,38315113,-28733451,620
1969-12-31 19:00:00-05:00,0,11111111111111111111111111111111,11111111111111111111111111111111,False,0,0,0,0,0,11111111111111111111111111111111,0,0,0,0
1969-12-31 19:00:00-05:00,0,11111111111111111111111111111111,11111111111111111111111111111111,False,0,0,0,0,0,11111111111111111111111111111111,0,0,0,0
1969-12-31 19:00:00-05:00,0,11111111111111111111111111111111,11111111111111111111111111111111,False,0,0,0,0,0,11111111111111111111111111111111,0,0,0,0
1969-12-31 19:00:00-05:00,0,11111111111111111111111111111111,11111111111111111111111111111111,False,0,0,0,0,0,11111111111111111111111111111111,0,0,0,0
1969-12-31 19:00:00-05:00,0,11111111111111111111111111111111,11111111111111111111111111111111,False,0,0,0,0,0,11111111111111111111111111111111,0,0,0,0
1969-12-31 19:00:00-05:00,0,11111111111111111111111111111111,11111111111111111111111111111111,False,0,0,0,0,0,11111111111111111111111111111111,0,0,0,0
1969-12-31 19:00:00-05:00,0,11111111111111111111111111111111,11111111111111111111111111111111,False,0,0,0,0,0,11111111111111111111111111111111,0,0,0,0
1969-12-31 19:00:00-05:00,0,11111111111111111111111111111111,11111111111111111111111111111111,False,0,0,0,0,0,11111111111111111111111111111111,0,0,0,0
1969-12-31 19:00:00-05:00,0,11111111111111111111111111111111,11111111111111111111111111111111,False,0,0,0,0,0,11111111111111111111111111111111,0,0,0,0
1969-12-31 19:00:00-05:00,0,11111111111111111111111111111111,11111111111111111111111111111111,False,0,0,0,0,0,11111111111111111111111111111111,0,0,0,0
1969-12-31 19:00:00-05:00,0,11111111111111111111111111111111,11111111111111111111111111111111,False,0,0,0,0,0,11111111111111111111111111111111,0,0,0,0
1969-12-31 19:00:00-05:00,0,11111111111111111111111111111111,11111111111111111111111111111111,False,0,0,0,0,0,11111111111111111111111111111111,0,0,0,0
1969-12-31 19:00:00-05:00,0,11111111111111111111111111111111,11111111111111111111111111111111,False,0,0,0,0,0,11111111111111111111111111111111,0,0,0,0
1969-12-31 19:00:00-05:00,0,11111111111111111111111111111111,11111111111111111111111111111111,False,0,0,0,0,0,11111111111111111111111111111111,0,0,0,0
1969-12-31 19:00:00-05:00,0,11111111111111111111111111111111,11111111111111111111111111111111,False,0,0,0,0,0,11111111111111111111111111111111,0,0,0,0
1969-12-31 19:00:00-05:00,0,11111111111111111111111111111111,11111111111111111111111111111111,False,0,0,0,0,0,11111111111111111111111111111111,0,0,0,0
1969-12-31 19:00:00-05:00,0,11111111111111111111111111111111,11111111111111111111111111111111,False,0,0,0,0,0,11111111111111111111111111111111,0,0,0,0
1969-12-31 19:00:00-05:00,0,11111111111111111111111111111111,11111111111111111111111111111111,False,0,0,0,0,0,11111111111111111111111111111111,0,0,0,0
1969-12-31 19:00:00-05:00,0,11111111111111111111111111111111,11111111111111111111111111111111,False,0,0,0,0,0,11111111111111111111111111111111,0,0,0,0
1969-12-31 19:00:00-05:00,0,11111111111111111111111111111111,11111111111111111111111111111111,False,0,0,0,0,0,11111111111111111111111111111111,0,0,0,0
1969-12-31 19:00:00-05:00,0,11111111111111111111111111111111,11111111111111111111111111111111,False,0,0,0,0,0,11111111111111111111111111111111,0,0,0,0
1969-12-31 19:00:00-05:00,0,11111111111111111111111111111111,11111111111111111111111111111111,False,0,0,0,0,0,11111111111111111111111111111111,0,0,0,0
1969-12-31 19:00:00-05:00,0,11111111111111111111111111111111,11111111111111111111111111111111,False,0,0,0,0,0,11111111111111111111111111111111,0,0,0,0
1969-12-31 19:00:00-05:00,0,11111111111111111111111111111111,11111111111111111111111111111111,False,0,0,0,0,0,11111111111111111111111111111111,0,0,0,0
1969-12-31 19:00:00-05:00,0,11111111111111111111111111111111,11111111111111111111111111111111,False,0,0,0,0,0,11111111111111111111111111111111,0,0,0,0
1969-12-31 19:00:00-05:00,0,11111111111111111111111111111111,11111111111111111111111111111111,False,0,0,0,0,0,11111111111111111111111111111111,0,0,0,0
1969-12-31 19:00:00-05:00,0,11111111111111111111111111111111,11111111111111111111111111111111,False,0,0,0,0,0,11111111111111111111111111111111,0,0,0,0
1969-12-31 19:00:00-05:00,0,11111111111111111111111111111111,11111111111111111111111111111111,False,0,0,0,0,0,11111111111111111111111111111111,0,0,0,0
1969-12-31 19:00:00-05:00,0,11111111111111111111111111111111,11111111111111111111111111111111,False,0,0,0,0,0,11111111111111111111111111111111,0,0,0,0
1969-12-31 19:00:00-05:00,0,11111111111111111111111111111111,11111111111111111111111111111111,False,0,0,0,0,0,11111111111111111111111111111111,0,0,0,0
1969-12-31 19:00:00-05:00,0,11111111111111111111111111111111,11111111111111111111111111111111,False,0,0,0,0,0,11111111111111111111111111111111,0,0,0,0
1969-12-31 19:00:00-05:00,0,11111111111111111111111111111111,11111111111111111111111111111111,False,0,0,0,0,0,11111111111111111111111111111111,0,0,0,0
1969-12-31 19:00:00-05:00,0,11111111111111111111111111111111,11111111111111111111111111111111,False,0,0,0,0,0,11111111111111111111111111111111,0,0,0,0
1969-12-31 19:00:00-05:00,0,11111111111111111111111111111111,11111111111111111111111111111111,False,0,0,0,0,0,11111111111111111111111111111111,0,0,0,0
1969-12-31 19:00:00-05:00,0,11111111111111111111111111111111,11111111111111111111111111111111,False,0,0,0,0,0,11111111111111111111111111111111,0,0,0,0
1969-12-31 19:00:00-05:00,0,11111111111111111111111111111111,11111111111111111111111111111111,False,0,0,0,0,0,11111111111111111111111111111111,0,0,0,0
1969-12-31 19:00:00-05:00,0,11111111111111111111111111111111,11111111111111111111111111111111,False,0,0,0,0,0,11111111111111111111111111111111,0,0,0,0
1969-12-31 19:00:00-05:00,0,11111111111111111111111111111111,11111111111111111111111111111111,False,0,0,0,0,0,11111111111111111111111111111111,0,0,0,0
1969-12-31 19:00:00-05:00,0,11111111111111111111111111111111,11111111111111111111111111111111,False,0,0,0,0,0,11111111111111111111111111111111,0,0,0,0
1969-12-31 19:00:00-05:00,0,11111111111111111111111111111111,11111111111111111111111111111111,False,0,0,0,0,0,11111111111111111111111111111111,0,0,0,0
1969-12-31 19:00:00-05:00,0,11111111111111111111111111111111,11111111111111111111111111111111,False,0,0,0,0,0,11111111111111111111111111111111,0,0,0,0
1969-12-31 19:00:00-05:00,0,11111111111111111111111111111111,11111111111111111111111111111111,False,0,0,0,0,0,11111111111111111111111111111111,0,0,0,0
1969-12-31 19:00:00-05:00,0,11111111111111111111111111111111,11111111111111111111111111111111,False,0,0,0,0,0,11111111111111111111111111111111,0,0,0,0
1969-12-31 19:00:00-05:00,0,11111111111111111111111111111111,11111111111111111111111111111111,False,0,0,0,0,0,11111111111111111111111111111111,0,0,0,0
1969-12-31 19:00:00-05:00,0,11111111111111111111111111111111,11111111111111111111111111111111,False,0,0,0,0,0,11111111111111111111111111111111,0,0,0,0
1969-12-31 19:00:00-05:00,0,11111111111111111111111111111111,11111111111111111111111111111111,False,0,0,0,0,0,11111111111111111111111111111111,0,0,0,0
1969-12-31 19:00:00-05:00,0,11111111111111111111111111111111,11111111111111111111111111111111,False,0,0,0,0,0,11111111111111111111111111111111,0,0,0,0
1969-12-31 19:00:00-05:00,0,11111111111111111111111111111111,11111111111111111111111111111111,False,0,0,0,0,0,11111111111111111111111111111111,0,0,0,0
1969-12-31 19:00:00-05:00,0,11111111111111111111111111111111,11111111111111111111111111111111,False,0,0,0,0,0,11111111111111111111111111111111,0,0,0,0
1969-12-31 19:00:00-05:00,0,11111111111111111111111111111111,11111111111111111111111111111111,False,0,0,0,0,0,11111111111111111111111111111111,0,0,0,0
1969-12-31 19:00:00-05:00,0,11111111111111111111111111111111,11111111111111111111111111111111,False,0,0,0,0,0,11111111111111111111111111111111,0,0,0,0
1969-12-31 19:00:00-05:00,0,11111111111111111111111111111111,11111111111111111111111111111111,False,0,0,0,0,0,11111111111111111111111111111111,0,0,0,0
1969-12-31 19:00:00-05:00,0,11111111111111111111111111111111,11111111111111111111111111111111,False,0,0,0,0,0,11111111111111111111111111111111,0,0,0,0
1969-12-31 19:00:00-05:00,0,11111111111111111111111111111111,11111111111111111111111111111111,False,0,0,0,0,0,11111111111111111111111111111111,0,0,0,0
1969-12-31 19:00:00-05:00,0,11111111111111111111111111111111,11111111111111111111111111111111,False,0,0,0,0,0,11111111111111111111111111111111,0,0,0,0
1969-12-31 19:00:00-05:00,0,11111111111111111111111111111111,11111111111111111111111111111111,False,0,0,0,0,0,11111111111111111111111111111111,0,0,0,0
1969-12-31 19:00:00-05:00,0,11111111111111111111111111111111,11111111111111111111111111111111,False,0,0,0,0,0,11111111111111111111111111111111,0,0,0,0
1969-12-31 19:00:00-05:00,0,11111111111111111111111111111111,11111111111111111111111111111111,False,0,0,0,0,0,11111111111111111111111111111111,0,0,0,0
1969-12-31 19:00:00-05:00,0,11111111111111111111111111111111,11111111111111111111111111111111,False,0,0,0,0,0,11111111111111111111111111111111,0,0,0,0
1969-12-31 19:00:00-05:00,0,11111111111111111111111111111111,11111111111111111111111111111111,False,0,0,0,0,0,11111111111111111111111111111111,0,0,0,0
1969-12-31 19:00:00-05:00,0,11111111111111111111111111111111,11111111111111111111111111111111,False,0,0,0,0,0,11111111111111111111111111111111,0,0,0,0
1969-12-31 19:00:00-05:00,0,11111111111111111111111111111111,11111111111111111111111111111111,False,0,0,0,0,0,11111111111111111111111111111111,0,0,0,0
1969-12-31 19:00:00-05:00,0,11111111111111111111111111111111,11111111111111111111111111111111,False,0,0,0,0,0,11111111111111111111111111111111,0,0,0,0
1969-12-31 19:00:00-05:00,0,11111111111111111111111111111111,11111111111111111111111111111111,False,0,0,0,0,0,11111111111111111111111111111111,0,0,0,0
1969-12-31 19:00:00-05:00,0,11111111111111111111111111111111,11111111111111111111111111111111,False,0,0,0,0,0,11111111111111111111111111111111,0,0,0,0
1969-12-31 19:00:00-05:00,0,11111111111111111111111111111111,11111111111111111111111111111111,False,0,0,0,0,0,11111111111111111111111111111111,0,0,0,0
1969-12-31 19:00:00-05:00,0,11111111111111111111111111111111,11111111111111111111111111111111,False,0,0,0,0,0,11111111111111111111111111111111,0,0,0,0
1969-12-31 19:00:00-05:00,0,11111111111111111111111111111111,11111111111111111111111111111111,False,0,0,0,0,0,11111111111111111111111111111111,0,0,0,0
1969-12-31 19:00:00-05:00,0,11111111111111111111111111111111,11111111111111111111111111111111,False,0,0,0,0,0,11111111111111111111111111111111,0,0,0,0
1969-12-31 19:00:00-05:00,0,11111111111111111111111111111111,11111111111111111111111111111111,False,0,0,0,0,0,11111111111111111111111111111111,0,0,0,0
1969-12-31 19:00:00-05:00,0,11111111111111111111111111111111,11111111111111111111111111111111,False,0,0,0,0,0,11111111111111111111111111111111,0,0,0,0
1969-12-31 19:00:00-05:00,0,11111111111111111111111111111111,11111111111111111111111111111111,False,0,0,0,0,0,11111111111111111111111111111111,0,0,0,0
1969-12-31 19:00:00-05:00,0,11111111111111111111111111111111,11111111111111111111111111111111,False,0,0,0,0,0,11111111111111111111111111111111,0,0,0,0
1969-12-31 19:00:00-05:00,0,11111111111111111111111111111111,11111111111111111111111111111111,False,0,0,0,0,0,11111111111111111111111111111111,0,0,0,0
1969-12-31 19:00:00-05:00,0,11111111111111111111111111111111,11111111111111111111111111111111,False,0,0,0,0,0,11111111111111111111111111111111,0,0,0,0
1969-12-31 19:00:00-05:00,0,11111111111111111111111111111111,11111111111111111111111111111111,False,0,0,0,0,0,11111111111111111111111111111111,0,0,0,0
1969-12-31 19:00:00-05:00,0,11111111111111111111111111111111,11111111111111111111111111111111,False,0,0,0,0,0,11111111111111111111111111111111,0,0,0,0
1969-12-31 19:00:00-05:00,0,11111111111111111111111111111111,11111111111111111111111111111111,False,0,0,0,0,0,11111111111111111111111111111111,0,0,0,0
1969-12-31 19:00:00-05:00,0,11111111111111111111111111111111,11111111111111111111111111111111,False,0,0,0,0,0,11111111111111111111111111111111,0,0,0,0
1969-12-31 19:00:00-05:00,0,11111111111111111111111111111111,11111111111111111111111111111111,False,0,0,0,0,0,11111111111111111111111111111111,0,0,0,0
1969-12-31 19:00:00-05:00,0,11111111111111111111111111111111,11111111111111111111111111111111,False,0,0,0,0,0,11111111111111111111111111111111,0,0,0,0
1969-12-31 19:00:00-05:00,0,11111111111111111111111111111111,11111111111111111111111111111111,False,0,0,0,0,0,11111111111111111111111111111111,0,0,0,0
1969-12-31 19:00:00-05:00,0,11111111111111111111111111111111,11111111111111111111111111111111,False,0,0,0,0,0,11111111111111111111111111111111,0,0,0,0
1969-12-31 19:00:00-05:00,0,11111111111111111111111111111111,11111111111111111111111111111111,False,0,0,0,0,0,11111111111111111111111111111111,0,0,0,0
1969-12-31 19:00:00-05:00,0,11111111111111111111111111111111,11111111111111111111111111111111,False,0,0,0,0,0,11111111111111111111111111111111,0,0,0,0
