ts,record_id,user_authority,user,partial,base_asset_value,base_asset_value_closed,liquidation_fee,fee_to_liquidator,fee_to_insurance_fund,liquidator,total_collateral,collateral,unrealized_pnl,margin_ratio
2022-05-07 22:05:23-04:00,18433,9qGz5Mh1XNUXqY1vEg5S1ZEMzPFvBLRbp1qaXwxSFMby,D8KnbVXStSUz3QhZGzY5o853ASocjkyu9x682oHgVoZh,True,41509851074,4141486081,16007169,8003584,8003585,A2p75MbAbeUdHkPLkAjgGeiwuu9WPrkMHzjCkDXF1Xr3,1604388368,9286613519,-7682225151,386
2022-05-07 22:05:23-04:00,18434,442usWu6XpJZvU25bqXeynRrQ15jAzWwU9DWMgHpTn3Q,CtvADKp39bjJf3cPKWNL3wxnhq273fVM4fC5DmEcg5cC,True,346238011,28680299,111885,55942,55943,2a35JJeTUW1pm6M3e8DHCjp8qr4vbc2cRPhuzZWyFzYd,13507251,123942100,-110434849,390
2022-05-07 22:05:23-04:00,18435,BKmKy8n1MpB1sdSfuWy7P3c6ReSW8TEWZRsyriz3ujYo,FgRpiZFPz43vDWStgCwRJACiGKtMLkWbTGeTLPeKnnaY,True,82508388,20627097,58722,29361,29361,C4UnXuShCvjSMgBAgVNMy1oakxCNk1et27A82fywU112,2348894,28609362,-26260468,284
2022-05-07 22:05:23-04:00,18436,DHfy6B2AYsqMCxPLBCXMDfQn3Gr2VwJaLFHUZKqpCjsb,EPZpYaY1gCAb8pMtri5veRowBmCrCpTHBMa3Rmgt6S29,True,499950367,124987591,353438,176719,176719,C4UnXuShCvjSMgBAgVNMy1oakxCNk1et27A82fywU112,14137547,42707205,-28569658,282
2022-05-07 22:05:23-04:00,18437,9h2Cbmb3j55jT648W1hANxFTJuCp8it78MQEF4Qvtfj,FzCtU5XMvPEpoyyYgZXPkHMTiCAX2M4QZnqtz9tSbRH4,False,42669,42669,1290,64,1226,Hu94aiQWvce6THeGyCFqGRPM1pQrK3ihzkcXo1EpJcJL,1290,0,1290,302
2022-05-07 22:05:23-04:00,18438,4hZG7dM716SxDagiFGwt1gSC99B2QK1emGLV9TJmmuR8,7vjfUWySkyx4Z5qAaRr2VWnVvxHHNsvPj1PirGNSjM6,True,123950962,30987740,193141,96570,96571,8sEswn3kzEhnYjAZVvCQnHEUvYd7pFVvc2Xc2Kd1BpbC,7725649,95659461,-87933812,623
2022-05-07 22:05:24-04:00,18439,EVMrznfJS54BZiywDD2WhUtxzicDtbEpm2a5yLrtCgRF,CpzsMYVYvKg8ihrX1cKRw7TDEYwD3kAyiX92hsf2KiTz,True,2619627350,204132492,979020,489510,489510,A2p75MbAbeUdHkPLkAjgGeiwuu9WPrkMHzjCkDXF1Xr3,125637450,1534010867,-1408373417,479
2022-05-07 22:05:24-04:00,18440,EHi1UBG8wMUFZECktsFUZkGjJPaBNEedswS62hyYn6jC,Drx9ErQhAjnPuJ83LPYFnY5ZV5XDzGuXDuSf16VqWayp,True,4504339077,554466076,1866715,933357,933358,DA18qE9qesbBqpwNv1M4befYcNQkbSBSeLPTmQzrmbJw,151647179,2399206293,-2247559114,336
2022-05-07 22:05:24-04:00,18441,9XmuJX8mFX29c5uh68kK7ff1mPdvs1orJAgEP6BsVKnq,HfPpizwUoK6uEmMb9LWi464BnvjHQY9cuPppFMp1DKDA,True,44810192,11202548,32207,16103,16104,2a35JJeTUW1pm6M3e8DHCjp8qr4vbc2cRPhuzZWyFzYd,1288316,7744807,-6456491,287
2022-05-07 22:05:25-04:00,18442,BAkPsWHtpVcEGqUgKTKjwZ6d5aaUcaUhdgYxBnpSTDW2,BDwDmVaZnXh22sf8nsDtjVfgxMAswbM3PW3si3k4nbRK,True,1462294803,365573700,1090137,545068,545069,2xTUy2RS74GJMMDnmFaegMzFLn19RVfYG4CibhBmjP1i,43605518,486660909,-443055391,298
2022-05-07 22:05:27-04:00,18443,5NVJU6YoZuuEjGNUUUJcGwS2Qd8b8CH7QSgMV7UWL5E7,8ZUq3o1nSkEvSfmiTz4anUpSMECCnX38MRwV7E5AGYSt,True,450563384,112640846,331678,165839,165839,2xTUy2RS74GJMMDnmFaegMzFLn19RVfYG4CibhBmjP1i,13267138,72235004,-58967866,294
2022-05-07 22:05:27-04:00,18444,6pUtYz474QrpATEZnfb3iFbTKYA65pNyKAo4TQZAjtqe,8dipRUXvxJiDLdHEtCPkso4vErbVwshHQiRfvSngBS9J,True,2699704275,299809118,1059338,529669,529669,A2p75MbAbeUdHkPLkAjgGeiwuu9WPrkMHzjCkDXF1Xr3,95390712,1070221270,-974830558,353
2022-05-07 22:05:27-04:00,18445,7tFD53kPTqrzjCu1Wji78gUqhoRtCUhsP1pM3DQKT7uG,BJvgPLYBDJrQJdQVowrsMwUGMurq4zTihoFwWoEokfu3,True,1108458907,155222142,469972,234986,234986,2a35JJeTUW1pm6M3e8DHCjp8qr4vbc2cRPhuzZWyFzYd,33561294,219795721,-186234427,302
2022-05-07 22:05:27-04:00,18446,7GpG8k6hM27vK1R5Sx1v5xUBuF6vybP41dcymjXDi5P7,7Aip6HDcbZ5mvoSucNupRS9enRdGx37F8L432K7V81do,True,266710481,66677620,400164,200082,200082,6L1WYrPiCMyi7XemPww4B4hvpKD1LQKD4RpiSKmrmgSC,16006566,153888181,-137881615,600
2022-05-07 22:05:27-04:00,18447,Gf5g7HMy73aPnXXvgQZEiBArL7wXzx7TpivmMRDU8RJS,8ok76N32AxEocuGo7RqeZJ9a45MezH6L1My16N9UfkdA,True,5512546212,641708983,2277965,1138982,1138983,3zqXX6kzhkbW3d4TwD2CNjMRwxTbREXySekvq37kfCNk,195686675,836856324,-641169649,354
2022-05-07 22:05:28-04:00,18448,EuMiyjSBs2ZKaPjN3FhaATvnSZG6Ak6aqdVUSApW6zM8,Hgw8jKxLXrB5G7Hk6Mh3sWZ3nHoa6Z2DzNDZGyMm4uoL,True,43616042,4166203,15826,7913,7913,Hu94aiQWvce6THeGyCFqGRPM1pQrK3ihzkcXo1EpJcJL,1656842,11445214,-9788372,379
2022-05-07 22:05:28-04:00,18449,HT2SuCbePhjNZaar24uVwihYowCNvSjdvhJ8BRSVw9nX,98Ts4LCnapHVoCJ5PW3Armvh4jvDtpfs3SYRLRxiAgzZ,True,145329804,9554487,47185,23592,23593,8sEswn3kzEhnYjAZVvCQnHEUvYd7pFVvc2Xc2Kd1BpbC,7177178,62763192,-55586014,493
2022-05-07 22:05:28-04:00,18450,HCAGpyYM2NYudMd55Geta13tUbS6eiygnJY5ULHsHAVa,3PPyWhqXrmifWPieLV34bZ1rzi8eEnrDDAF7ifXkXspn,True,60324740,11229957,45517,22758,22759,Hu94aiQWvce6THeGyCFqGRPM1pQrK3ihzkcXo1EpJcJL,2445117,27529779,-25084662,405
2022-05-07 22:05:28-04:00,18451,68gVM4kjmSYxT1uJW13rYSway8uVLUdcLa7sJuqHQaAf,DshroBQ3da7BcAiQpiFREsLKWbUDrBRmmZRw3Zu2Qfs9,True,1321977699,330494424,752849,376424,376425,6L1WYrPiCMyi7XemPww4B4hvpKD1LQKD4RpiSKmrmgSC,30113971,247735557,-217621586,227
2022-05-07 22:05:29-04:00,18452,68gVM4kjmSYxT1uJW13rYSway8uVLUdcLa7sJuqHQaAf,DshroBQ3da7BcAiQpiFREsLKWbUDrBRmmZRw3Zu2Qfs9,True,991483275,247870818,734028,367014,367014,2xTUy2RS74GJMMDnmFaegMzFLn19RVfYG4CibhBmjP1i,29361122,192645152,-163284030,296
2022-05-07 22:05:29-04:00,18453,Apqv5iu4bJ6pVg2NxjfwuvnfxDK6navHhhU1CVJEHeMa,7pDPJrxndRsLq983bEwvd3MKYnnqyQzQNMhEaC5NZYN1,True,434047297,108511824,279164,139582,139582,DA18qE9qesbBqpwNv1M4befYcNQkbSBSeLPTmQzrmbJw,11166586,70544313,-59377727,257
2022-05-07 22:05:30-04:00,18454,HXQXfEQe7aCpr6WKh37XaDZsjZcuQPk5t8tWNFgEoK6U,5ufXkCEDwgiXwtyPye4wYVVA3oLW54JVzz4tnXFofto4,True,6584644739,1646161184,4318191,2159095,2159096,A2p75MbAbeUdHkPLkAjgGeiwuu9WPrkMHzjCkDXF1Xr3,172727655,2354415227,-2181687572,262
2022-05-07 22:05:31-04:00,18455,HqtTbC1LFreGvgfpZe7nCqkNnh8GHPQKosfmc19zb1yi,E39UNiHNkwQEd5GXkCtTPqSorQSB1kLx8kjzK4jdFoi3,True,78334351,19583587,51483,25741,25742,2a35JJeTUW1pm6M3e8DHCjp8qr4vbc2cRPhuzZWyFzYd,2059357,18760898,-16701541,262
2022-05-07 22:05:31-04:00,18456,EuMiyjSBs2ZKaPjN3FhaATvnSZG6Ak6aqdVUSApW6zM8,Hgw8jKxLXrB5G7Hk6Mh3sWZ3nHoa6Z2DzNDZGyMm4uoL,True,39446633,1827428,7587,3793,3794,6L1WYrPiCMyi7XemPww4B4hvpKD1LQKD4RpiSKmrmgSC,1637810,10595592,-8957782,415
2022-05-07 22:05:31-04:00,18457,CDVtXFbo4Rg2aHsXKv5P3uRJq9ZTgsRd7GXPTxgH5xv9,6zj37qQnaiJT7xGEZmSKx5yQvisQFcs5KhGsG43SGd5y,True,54670345,5597402,19254,9627,9627,2a35JJeTUW1pm6M3e8DHCjp8qr4vbc2cRPhuzZWyFzYd,1880702,20570397,-18689695,344
2022-05-07 22:05:31-04:00,18458,9qGz5Mh1XNUXqY1vEg5S1ZEMzPFvBLRbp1qaXwxSFMby,D8KnbVXStSUz3QhZGzY5o853ASocjkyu9x682oHgVoZh,True,37284611818,1749787328,7061301,3530650,3530651,Hu94aiQWvce6THeGyCFqGRPM1pQrK3ihzkcXo1EpJcJL,1504628024,8560186836,-7055558812,403
2022-05-07 22:05:31-04:00,18459,E3LF7ohKS87kHLW78ViuRuyw7EMuiW3nVn5PRdhU7iBj,DMVXNy2NLb8jMuznjx2syKqvzctrNmQ3PfiUA83CeQR4,False,35916370,35916370,895593,44779,850814,5HnvdJnCCcmRsm4GkXnYWd4q9RpwuvYDGEUMPkYR3Ts9,895593,12705568,-11809975,249
2022-05-07 22:05:32-04:00,18460,GcwFXxcxRF2xwbgFbQZoYEDreimd3J3UJ9sPfuwYVKtS,7uXjmKS8RxP2qSS7ataBH5hkfpgsFcpSBWUEBuV5zgyZ,True,745723227,186430806,550135,275067,275068,2xTUy2RS74GJMMDnmFaegMzFLn19RVfYG4CibhBmjP1i,22005429,163777309,-141771880,295
2022-05-07 22:05:32-04:00,18461,Ai6G7vosJfmkRqtDAkqxRtbzELp6P5xe9r2RH3LYcLZt,8SUpKXakmhi4rYiFKnHYpgaAopomfDqEX6Efew9iM6nk,True,190326344,17553965,70142,35071,35071,Hu94aiQWvce6THeGyCFqGRPM1pQrK3ihzkcXo1EpJcJL,7605146,100373107,-92767961,399
2022-05-07 22:05:33-04:00,18462,93Jp2cnKVsSUcpoNEXmuq3K17MWt7JkW3jx6v5v2UAvN,5bos8dvpCKDxeYbXxRXwEdY8tAMZoL2XhNKUdFKxTrd6,True,80112077,6671927,26068,13034,13034,8sEswn3kzEhnYjAZVvCQnHEUvYd7pFVvc2Xc2Kd1BpbC,3130122,54848684,-51718562,390
2022-05-07 22:05:33-04:00,18463,442usWu6XpJZvU25bqXeynRrQ15jAzWwU9DWMgHpTn3Q,CtvADKp39bjJf3cPKWNL3wxnhq273fVM4fC5DmEcg5cC,True,316487615,57614141,224371,112185,112186,2a35JJeTUW1pm6M3e8DHCjp8qr4vbc2cRPhuzZWyFzYd,12325269,107752937,-95427668,389
2022-05-07 22:05:33-04:00,18464,BePQMfbkFe8vQ54rFkkf2dzXunPq2Xwpibrm1JVzSHLz,8R6rnjVUnMGUxx5sRjnuuyEnfyBGeet7y2jSJwVswyT3,True,89532141048,11587974238,34151243,17075621,17075622,A2p75MbAbeUdHkPLkAjgGeiwuu9WPrkMHzjCkDXF1Xr3,2638626809,14778951551,-12140324742,294
2022-05-07 22:05:33-04:00,18465,GtDk7DkAB2jvQynR57z8mjg6UoaTqYDr8Z4wsFX6KGSr,tAPvp4fscJZySZUVG2GZWZwSRVhfnNvkjCC6ZvmxqDQ,True,932435603,233108900,667542,333771,333771,A2p75MbAbeUdHkPLkAjgGeiwuu9WPrkMHzjCkDXF1Xr3,26701685,98269011,-71567326,286
2022-05-07 22:05:33-04:00,18466,djW9rVm1v4nW64QiVqgFUCRza24VqthDcSfVEyRHPed,EsXvQmXVXECqZPtmSdiuwieHPP5jsmyn67p78vHaJcqq,True,665531300,166382825,472597,236298,236299,2xTUy2RS74GJMMDnmFaegMzFLn19RVfYG4CibhBmjP1i,18903906,51030281,-32126375,284
2022-05-07 22:05:33-04:00,18467,EHi1UBG8wMUFZECktsFUZkGjJPaBNEedswS62hyYn6jC,Drx9ErQhAjnPuJ83LPYFnY5ZV5XDzGuXDuSf16VqWayp,True,3935955727,433836990,1497538,748769,748769,3zqXX6kzhkbW3d4TwD2CNjMRwxTbREXySekvq37kfCNk,135863190,2089670399,-1953807209,345
2022-05-07 22:05:33-04:00,18468,DX6DNEePMPiHBVFX2rDuFoy1fznGYDx6bUQB6qL6UAAb,FM9PNZ9HFZNPZDmg5mQRuMo9t49kDJEHM2CuZmNo6TnD,True,1958365131,489591282,1390111,695055,695056,A2p75MbAbeUdHkPLkAjgGeiwuu9WPrkMHzjCkDXF1Xr3,55604467,208068480,-152464013,283
2022-05-07 22:05:35-04:00,18469,CKK8bNCGjTn8qR6JoY5woqo2rrQHPMRawDGNfDsrg4Zd,46jXZ7r4uPrHnRJsnRnXHdDWjjjAbi8smmHbxxLhuwVg,False,26367714,26367714,670641,33532,637109,Hu94aiQWvce6THeGyCFqGRPM1pQrK3ihzkcXo1EpJcJL,670641,2795097,-2124456,254
2022-05-07 22:05:35-04:00,18470,GpDhvRRae2uiRZ6MnJYnVR2hANNLGFGUDnsQmGjfK8AP,B2pgJ4gPdgzvx2HMJ1wagtthpZebtBk7RD3cF1zqSyT8,True,250284133,62571033,189275,94637,94638,3zqXX6kzhkbW3d4TwD2CNjMRwxTbREXySekvq37kfCNk,7571032,93680509,-86109477,302
2022-05-07 22:05:35-04:00,18471,FRbeFwhUYCiHW5oP26mad8KND7CCYDbfnoNxX7GuXVp8,GrzXKxPX2WDka8i2D8sunMUsrsThKasQi8NYLwuCGygV,True,838311838,144961762,578040,289020,289020,Hu94aiQWvce6THeGyCFqGRPM1pQrK3ihzkcXo1EpJcJL,33428036,314603289,-281175253,398
2022-05-07 22:05:35-04:00,18472,Fczxdc24Eav8xcaKRDwWMEwPEzkGyEJ7qGcXYyGZFKVz,8GqweYpec4cnpaJvueF3FGWoaz72BAzpLYXBX7tuuqEt,True,519650682,129912670,369908,184954,184954,A2p75MbAbeUdHkPLkAjgGeiwuu9WPrkMHzjCkDXF1Xr3,14796324,325053747,-310257423,284
2022-05-07 22:05:36-04:00,18473,DxmkdZiygge1YAwbL8U6LudY3QJkSnZMHThQXkE4Z5qy,Gi8oNcSDphbtosjFudeEPtX88bUnYid1tL9FnXnLfASU,True,110562957,27640739,74368,37184,37184,Hu94aiQWvce6THeGyCFqGRPM1pQrK3ihzkcXo1EpJcJL,2974732,14879939,-11905207,269
2022-05-07 22:05:37-04:00,18474,6pUtYz474QrpATEZnfb3iFbTKYA65pNyKAo4TQZAjtqe,8dipRUXvxJiDLdHEtCPkso4vErbVwshHQiRfvSngBS9J,True,2394981190,137591303,513701,256850,256851,DQCvC9mR68hJ3tJsUiddh6JwcBJAmntqGJR2nUsEq7yj,89417407,1001693744,-912276337,373
2022-05-07 22:05:37-04:00,18475,H4rTN5pSgWQYdgpEXs79UN96nSKGQ7gkfEyS8B2Fqhyk,GttqEEtxJMkyKi2dRiUrdRyqiCyYXRj91EVzjRB6Uf5d,True,109626562,27406640,69619,34809,34810,2a35JJeTUW1pm6M3e8DHCjp8qr4vbc2cRPhuzZWyFzYd,2784797,7593616,-4808819,254
2022-05-07 22:05:37-04:00,18476,CDVtXFbo4Rg2aHsXKv5P3uRJq9ZTgsRd7GXPTxgH5xv9,6zj37qQnaiJT7xGEZmSKx5yQvisQFcs5KhGsG43SGd5y,True,49022648,3526447,13028,6514,6514,2a35JJeTUW1pm6M3e8DHCjp8qr4vbc2cRPhuzZWyFzYd,1811153,19294188,-17483035,369
2022-05-07 22:05:38-04:00,18477,E4VzeJLsf5Y6t3yNi8VpS8QxhJbJGPhnkNBmU2XoCBs9,63CXyYfevXtrL1QcfQtAhz29xeea5BwWcj6d6BWb4qiB,True,10714500604,2678625151,8099248,4049624,4049624,A2p75MbAbeUdHkPLkAjgGeiwuu9WPrkMHzjCkDXF1Xr3,323969953,3933158056,-3609188103,302
2022-05-07 22:05:38-04:00,18478,7A1A93jqxV65F7XwvBarhgfTm3iFh3s75jFNzVCtFnez,8Z6QWdy4zGUzuMdKhkdxzq7RaLHhJmrpYEKeqsw8bopx,True,433577167,108394291,273079,136539,136540,A2p75MbAbeUdHkPLkAjgGeiwuu9WPrkMHzjCkDXF1Xr3,10923162,70706805,-59783643,251
2022-05-07 22:05:39-04:00,18479,AL8JFS4gjaQx89f9j8wtaNJgV76K8bw1ugvNtgvhgAnb,HJYvG2kGKe8kXgtZSWTWwTmSjxA3XUeCvyT7acoKtS1C,True,62293548923,7983423491,23881833,11940916,11940917,A2p75MbAbeUdHkPLkAjgGeiwuu9WPrkMHzjCkDXF1Xr3,1863466413,12219807304,-10356340891,299
2022-05-07 22:05:39-04:00,18480,9qGz5Mh1XNUXqY1vEg5S1ZEMzPFvBLRbp1qaXwxSFMby,D8KnbVXStSUz3QhZGzY5o853ASocjkyu9x682oHgVoZh,True,35437321157,3195206315,12623672,6311836,6311836,A2p75MbAbeUdHkPLkAjgGeiwuu9WPrkMHzjCkDXF1Xr3,1400063390,7918037206,-6517973816,395
2022-05-07 22:05:39-04:00,18481,A7j77tzgnQVGtHTa65VtVZqJRYeJvQk7am8NW6e66379,4vJGwEvXU2tGWoWWGwbsYcfKQAMCHbrBMRk4ZVFzneLs,True,5290918378,1322729594,3655922,1827961,1827961,A2p75MbAbeUdHkPLkAjgGeiwuu9WPrkMHzjCkDXF1Xr3,146236894,1183564443,-1037327549,276
2022-05-07 22:05:39-04:00,18482,Bzp3ZUxzRWqW4QoLq9PtKN1HQeSaKXFQrX1G3a4ocrre,H12B3p4v1ZtZ9gaSgpxCJsKXmmEjiqaRZQzexjzAhevo,True,2514429076,202848534,963411,481705,481706,2xTUy2RS74GJMMDnmFaegMzFLn19RVfYG4CibhBmjP1i,119420615,1125916175,-1006495560,474
2022-05-07 22:05:42-04:00,18483,7A1A93jqxV65F7XwvBarhgfTm3iFh3s75jFNzVCtFnez,8Z6QWdy4zGUzuMdKhkdxzq7RaLHhJmrpYEKeqsw8bopx,True,324261906,81065476,243227,121613,121614,2xTUy2RS74GJMMDnmFaegMzFLn19RVfYG4CibhBmjP1i,9729113,55494950,-45765837,300
2022-05-07 22:05:44-04:00,18484,4oMasDRj8HWfknmdwt6Mkz3eonr8J2byoiSTRo4sCnFQ,3emcATkEFvDVETiK97eVET2Z2jzkgiiSxX3gu5wsUKPe,True,2362284877,333992157,2169866,1084933,1084933,2xTUy2RS74GJMMDnmFaegMzFLn19RVfYG4CibhBmjP1i,153471938,1051441598,-897969660,649
2022-05-07 22:05:44-04:00,18485,AsRi72uQLsBnyQxMBnPEhyQNM7XyNk2RV9GzPMe8PysA,9MqsYTBn6P9zCi5bGCrZurWWysW8XQZJwndHsb227rEW,True,56842446,14210611,38905,19452,19453,3zqXX6kzhkbW3d4TwD2CNjMRwxTbREXySekvq37kfCNk,1556239,20045074,-18488835,273
2022-05-07 22:05:44-04:00,18486,82EMpA1hwF9KNQy2ZB2A1HdoEowBu2CoYhW3VmohkSnk,hn67zsTzsAs2aqk6ZjfEeoRygd3CdMeCuR82h9yuiz3,True,138479050,34619762,102796,51398,51398,2a35JJeTUW1pm6M3e8DHCjp8qr4vbc2cRPhuzZWyFzYd,4111875,47384715,-43272840,296
2022-05-07 22:05:46-04:00,18487,BSDeCyJsPs6y1pbDVHNq5rs6tdxcrbY3NDjXPBxwRjHz,DjHD3jawBVikzjcQ5dXBRLdUmEeBHKt6JZLhvmjScDku,True,239765994,59301813,144398,72199,72199,6L1WYrPiCMyi7XemPww4B4hvpKD1LQKD4RpiSKmrmgSC,5838301,110077060,-104238759,243
2022-05-07 22:05:47-04:00,18488,BEuVsj9KuYBTaxrLpKwrQtHxmhRtB16siNfPXsAvf6rz,BTjWitiLbteuKMzaFj1daYyM2v9rZygESDktu8cuzC8g,True,403649411,100912352,270406,135203,135203,5HnvdJnCCcmRsm4GkXnYWd4q9RpwuvYDGEUMPkYR3Ts9,10816249,27577488,-16761239,267
2022-05-07 22:05:50-04:00,18489,5nALef7nAfNkSQSuTBLwewDby4pUx74Gzqib33Znmmt6,8xNTWK2xNK2xZPpgXfcE4QxPT2i6YvNYakiLgdQ2FqEt,True,182092838,45523209,135630,67815,67815,2a35JJeTUW1pm6M3e8DHCjp8qr4vbc2cRPhuzZWyFzYd,5425219,17605287,-12180068,297
2022-05-07 22:05:54-04:00,18490,8DSiP9CwJm3AEcH6uuAYFpArRRDLYpDQgjHEvjkUgfg2,ERJ8kuhPRRmUAhSM4oxUheh39YUVVYNgaTt6AdMXcCvL,True,194831467,48707866,145368,72684,72684,Hu94aiQWvce6THeGyCFqGRPM1pQrK3ihzkcXo1EpJcJL,5814749,68832579,-63017830,298
2022-05-07 22:05:54-04:00,18491,rTizTweTeG3Li3BFLmtr6GmcHBs9FTcwsPKCWezWmnR,76CqzaphEXgjo9pzBKttaErJ5e9xoZaRKp5ZNB5JCf4x,True,220438520,55109630,160269,80134,80135,2a35JJeTUW1pm6M3e8DHCjp8qr4vbc2cRPhuzZWyFzYd,6410784,30977415,-24566631,290
2022-05-07 22:05:54-04:00,18492,7frvVhg1eWJpsvG7ndjppb8Bmd1tFq5H1g26UiKZxqTP,3Ugo9b53e6e8PLnvKjqRP8pvvoubSPV6qiKtxey7mrGt,False,33500447,33500447,825549,41277,784272,2a35JJeTUW1pm6M3e8DHCjp8qr4vbc2cRPhuzZWyFzYd,825549,11212768,-10387219,246
2022-05-07 22:05:54-04:00,18493,5zqXqEjg95BnghcVbHRhYkSTYnzZjUBichgccv1BpS3d,9SuqSxrKpHh9NcNePe4Q3jXvpCmhNnoQv8YAFih3CqMX,True,231115980,57778995,159431,79715,79716,2a35JJeTUW1pm6M3e8DHCjp8qr4vbc2cRPhuzZWyFzYd,6377250,82246338,-75869088,275
2022-05-07 22:05:54-04:00,18494,6pAs5S7zGX77DHSYUuCxvxbf2FQQHQhbBmAYLd3iJvWS,HNTWEhsrnEe8FeVDpEcxuoD5PnuveB5BwSf3gdBmhzxv,False,24872015,24872015,694027,34701,659326,2a35JJeTUW1pm6M3e8DHCjp8qr4vbc2cRPhuzZWyFzYd,694027,4871364,-4177337,279
2022-05-07 22:05:55-04:00,18495,9RtNbEZ4ZR8T1HFF4cujPVy2kejVBKFo3CPQi8psSa1q,7zwaGb71jKc9y2HKCKy5q2XV2YUphkyU1hkDaab1GBas,True,152403120,36177868,97112,48556,48556,6L1WYrPiCMyi7XemPww4B4hvpKD1LQKD4RpiSKmrmgSC,4090996,56270716,-52179720,268
2022-05-07 22:05:55-04:00,18496,EdCSJVDrgnE7PN9GK7t1t7hB79mBrJzyy1mMZL9u5nvM,GTy9uEWcCx4odtr1GLPpntNbdR7wJRYr3wE9P5rAaMw6,False,28801577,28801577,791583,39579,752004,2a35JJeTUW1pm6M3e8DHCjp8qr4vbc2cRPhuzZWyFzYd,791583,4798296,-4006713,274
2022-05-07 22:05:56-04:00,18497,Af5aSkdtYSRqdSfK3mPBK3Grq33PDCLCASBdsMo5cmkm,9PvGthPurjNkCoTUVDBW9nNNmvAdrwK8tk4hknK7Wydg,True,346533181,86633295,252481,126240,126241,A2p75MbAbeUdHkPLkAjgGeiwuu9WPrkMHzjCkDXF1Xr3,10099274,67424561,-57325287,291
2022-05-07 22:05:56-04:00,18498,4nj9fNW5K5hZebNaCP8PDTismTb5HK4MsJLUPLsnfN7P,B4UmvQqxb4Sc35L3YzuGR8BSQC2qKd6e4Byxni7ncYkf,True,39054424,9763606,28446,14223,14223,2a35JJeTUW1pm6M3e8DHCjp8qr4vbc2cRPhuzZWyFzYd,1137874,6573926,-5436052,291
2022-05-07 22:05:57-04:00,18499,5QxR9QPTADFys9VQNm473RgprTikCXC23vhsBc9ojyAQ,H9zdf8nJ4JCF7jrwGsxiuiFoa14gzDmYsZ5N5ig3UGna,True,144548578,36137144,103471,51735,51736,6L1WYrPiCMyi7XemPww4B4hvpKD1LQKD4RpiSKmrmgSC,4138862,20313626,-16174764,286
2022-05-07 22:05:57-04:00,18500,gCNpMXEHPTLvMvyyaYCLJrd8RRGnKAHz7sBD5j7yyBt,9cRU1ZAZRT5Ei4YAmCrPJZMHGsWspcYXTuZH58iexwDv,True,61481036,15370259,45769,22884,22885,2a35JJeTUW1pm6M3e8DHCjp8qr4vbc2cRPhuzZWyFzYd,1830793,12993883,-11163090,297
2022-05-07 22:05:59-04:00,18501,J6ndjmic8buVqwa4URRRgv2iTc4ekbYUHdcpa3DUCufN,7qvvczUw8ngwdQae49BiQwQmdV2SSWsAVV2tmZYL7gw6,True,28636823,7159205,44346,22173,22173,8sEswn3kzEhnYjAZVvCQnHEUvYd7pFVvc2Xc2Kd1BpbC,1773869,20343570,-18569701,619
2022-05-07 22:05:59-04:00,18502,Cb6MEn1MN9XQcVVd3o9J8QdK3cFWxSNETsFzhVJ8jmdh,A6yTKbggUftjbjAVu5YR1M7rg7h78ghbfofmTSnmKNGz,True,168125186,42031296,126224,63112,63112,2a35JJeTUW1pm6M3e8DHCjp8qr4vbc2cRPhuzZWyFzYd,5048973,12580218,-7531245,300
2022-05-07 22:06:04-04:00,18503,BDJNQYGXMb8zSNmBJPWtaoAYH36uRTChuAGjrNcaA2AG,2mRdgipHSd5Q96ZQ2kJLez2YyVVG6mS75ET4Nr7eLkrX,True,75130073,18782518,51875,25937,25938,2a35JJeTUW1pm6M3e8DHCjp8qr4vbc2cRPhuzZWyFzYd,2075036,5047041,-2972005,276
2022-05-07 22:06:25-04:00,18504,Gwj6CMXQeoWVsmD775Knsm6BmWuysFvSKo78FRLQByb4,6cvChMYj7TfDcnc8hG9H89PABJr2svspqjJSdSGD4RUt,True,16189567,1521416,9489,4744,4745,8sEswn3kzEhnYjAZVvCQnHEUvYd7pFVvc2Xc2Kd1BpbC,1009764,3745809,-2736045,623
2022-05-07 22:13:37-04:00,18505,13GT6eaKWuaLe7wFcybCnUaYgd9DfyzYRN2FcXWgFwpC,CbwmJ7YpnvcqDyUw3L9b7dqXcA8Ju3rYrTdegeaJJbWC,True,43251779,10812944,67096,33548,33548,8sEswn3kzEhnYjAZVvCQnHEUvYd7pFVvc2Xc2Kd1BpbC,2683840,30694512,-28010672,620
2022-05-07 22:14:20-04:00,18506,DLwEaZipqHmVBD5hc5v1NZtDStHyG4hAMwxywDTGGc2e,28GtwJw67UWfrSKxtuvpzoKzPyKXLgP3GKLm3fHdR566,True,157662820,39415705,243439,121719,121720,5HnvdJnCCcmRsm4GkXnYWd4q9RpwuvYDGEUMPkYR3Ts9,9737589,64463811,-54726222,617
2022-05-07 22:14:21-04:00,18507,DEYX42wznBAqmhpLTbKKDQfGEaMALvoM5j8VmJ4sjvFH,AVjTq6EpANT28hdqnei1m4N5bKsCcADCoKJT3No4kwL3,True,25115168,6278792,39024,19512,19512,2a35JJeTUW1pm6M3e8DHCjp8qr4vbc2cRPhuzZWyFzYd,1560978,13945885,-12384907,621
2022-05-07 22:14:28-04:00,18508,4Siq98BDakELWP5BzVoEN5tcg1ywRxTYs1aUcfW8spCt,2EBXLTVz1Gk9gS5JcVqCKAP5PatFGw1Vnww65Moz3SUn,True,59515964,14878991,92556,46278,46278,2a35JJeTUW1pm6M3e8DHCjp8qr4vbc2cRPhuzZWyFzYd,3702277,28909574,-25207297,622
2022-05-07 22:14:32-04:00,18509,3CPsqvzeuQAH1V5m3FDFDwNgGUPUHkU1q4jn781sPxWu,vbqWE3N9QXgEwwp4HVukJp9eyCnT33kVMAqCS9AMBxU,True,62840124,3830847,17273,8636,8637,8sEswn3kzEhnYjAZVvCQnHEUvYd7pFVvc2Xc2Kd1BpbC,2833552,19999610,-17166058,450
2022-05-07 22:14:42-04:00,18510,4oMasDRj8HWfknmdwt6Mkz3eonr8J2byoiSTRo4sCnFQ,3emcATkEFvDVETiK97eVET2Z2jzkgiiSxX3gu5wsUKPe,True,2009497010,254198130,1676184,838092,838092,A9TwRM1BMxqb8DCC7YNAMV6zPenEJm3HTZBy7wJKK58U,132506362,911464526,-778958164,659
2022-05-07 22:14:45-04:00,18511,Fn6J1eMQJoA5rXCwX2HjAF86AowsJfULLuYXVfzgb8aX,6Ett2WPmz4HoWVSVEZD73UzFetd3oFSh7C676MEVYd36,True,89224192,22306048,138402,69201,69201,gjBMZYVujDjD1ECG4i97M8Q3gV9ESnwwTSUGropkusj,5536113,45632758,-40096645,620
2022-05-07 22:14:51-04:00,18512,QAeXX77JVKu25JE3uWoad8TxaC6ikQREB9YXmPu2WBn,4VN6uVqqH54i8JVcMJM2SVokgAe2RbsYCrrsTLotM4Fd,True,25274925,6318731,39098,19549,19549,5HnvdJnCCcmRsm4GkXnYWd4q9RpwuvYDGEUMPkYR3Ts9,1563944,7881311,-6317367,618
2022-05-07 22:14:51-04:00,18513,CXppCp4b4npkAzw175YNy6Ei8nF7jCmNbqsbVosHS6fE,FSEchHNYxt7WdBYjyuS2Ft2yUnfk56TCkY8SXdSs8hfe,True,93312009,23328002,145612,72806,72806,Hu94aiQWvce6THeGyCFqGRPM1pQrK3ihzkcXo1EpJcJL,5824497,57732340,-51907843,624
2022-05-07 22:14:56-04:00,18514,EVMrznfJS54BZiywDD2WhUtxzicDtbEpm2a5yLrtCgRF,CpzsMYVYvKg8ihrX1cKRw7TDEYwD3kAyiX92hsf2KiTz,True,2403462537,157787226,739389,369694,369695,Hu94aiQWvce6THeGyCFqGRPM1pQrK3ihzkcXo1EpJcJL,112626109,1398958182,-1286332073,468
2022-05-07 22:14:56-04:00,18515,ETbDcnYMv5nwauExRwHHdHpChMBhD8FNgNszUE2CAdVx,2VEs3EouQ4fkdhmuehz7Jy7RW8LonkM3WpAVz7KfmydP,True,62759974,3817829,17148,8574,8574,Hu94aiQWvce6THeGyCFqGRPM1pQrK3ihzkcXo1EpJcJL,2818925,20057155,-17238230,449
2022-05-07 22:15:10-04:00,18516,2EcKNNHjAgZGnMhmRg98XGHFTAnM24gpAMsJA6FkdqHp,D6xW3oLCh9DP18E4wFNbVanbZyJUwhPVU3GsZEUEAjv3,True,62772252,3827575,17161,8580,8581,3zqXX6kzhkbW3d4TwD2CNjMRwxTbREXySekvq37kfCNk,2814550,20042446,-17227896,448
2022-05-07 22:15:13-04:00,18517,EuMiyjSBs2ZKaPjN3FhaATvnSZG6Ak6aqdVUSApW6zM8,Hgw8jKxLXrB5G7Hk6Mh3sWZ3nHoa6Z2DzNDZGyMm4uoL,True,37507266,1623490,6571,3285,3286,6L1WYrPiCMyi7XemPww4B4hvpKD1LQKD4RpiSKmrmgSC,1518284,9923728,-8405444,404
2022-05-07 22:15:13-04:00,18518,CDVtXFbo4Rg2aHsXKv5P3uRJq9ZTgsRd7GXPTxgH5xv9,6zj37qQnaiJT7xGEZmSKx5yQvisQFcs5KhGsG43SGd5y,True,45437253,1520310,5819,2909,2910,2a35JJeTUW1pm6M3e8DHCjp8qr4vbc2cRPhuzZWyFzYd,1739177,18171199,-16432022,382
2022-05-07 22:15:14-04:00,18519,Hyh93pAbHGME7rUUFPXXPJVUba1cjgJK6Udw2D8yW4nf,A8VCG5wfCEQGgUbwtjq2xh47RKbwaV7RvVuuj3C9bKPu,True,62755362,3823038,17229,8614,8615,5HnvdJnCCcmRsm4GkXnYWd4q9RpwuvYDGEUMPkYR3Ts9,2828237,20073016,-17244779,450
2022-05-07 22:15:17-04:00,18520,Gf5g7HMy73aPnXXvgQZEiBArL7wXzx7TpivmMRDU8RJS,8ok76N32AxEocuGo7RqeZJ9a45MezH6L1My16N9UfkdA,True,4856135355,246660465,907715,453857,453858,2a35JJeTUW1pm6M3e8DHCjp8qr4vbc2cRPhuzZWyFzYd,178706836,804545716,-625838880,368
2022-05-07 22:15:19-04:00,18521,AK8KFprmWXtUTpgruZZX7YvQMKybkNV18FGoWdqndEEj,3Nz7CzTMfSs1XcFxACXRo8XUDgBTzTXq8fk6ZbKBYoMS,True,101570027,25392506,158557,79278,79279,5HnvdJnCCcmRsm4GkXnYWd4q9RpwuvYDGEUMPkYR3Ts9,6342317,28302175,-21959858,624
2022-05-07 22:15:24-04:00,18522,9eWpSyu71Z6dmx7yTh7WrbVScdrrZN14d5tfmqEGFgXt,2r89PFKSD9zmSp2Wyx4CQ75HAtmUgwhAS2oG5MuYuiV6,True,1868413517,358501765,1345124,672562,672562,A2p75MbAbeUdHkPLkAjgGeiwuu9WPrkMHzjCkDXF1Xr3,70104219,540474192,-470369973,375
2022-05-07 22:15:28-04:00,18523,3atA8mjJH2GxCpXxoiDsizEvPtJctaVDAfwyxj4koJmJ,5Sr5fFo455uSbM3nwKfvziPM9eaCarsJEhCa9wzPU8Ct,True,62779230,3841118,17130,8565,8565,3zqXX6kzhkbW3d4TwD2CNjMRwxTbREXySekvq37kfCNk,2799793,20020684,-17220891,445
2022-05-07 22:15:28-04:00,18524,4Kr2N2ePqWvyDp9n5ey7MW8J34BvJYC3pcHzvEqRLjcU,H9DoqL8DddZiWRwusQQcS8vHmEGvkkukfiLf7r3Kqcj7,True,62775115,3842268,17125,8562,8563,8sEswn3kzEhnYjAZVvCQnHEUvYd7pFVvc2Xc2Kd1BpbC,2798079,20023084,-17225005,445
2022-05-07 22:15:30-04:00,18525,C6TnjCL81NkSp5GTkqPwzAwerpsGtnQzs8LqRAd7PMoi,66DYSdSzH8h5p6eeSZE3eZHXkuBC6EYjbGxHEqb9f5zb,True,62785871,3842523,17183,8591,8592,2a35JJeTUW1pm6M3e8DHCjp8qr4vbc2cRPhuzZWyFzYd,2807765,20022593,-17214828,447
2022-05-07 22:16:31-04:00,18526,5Y7MpvBDW2jVq5SwkJQrVjqMSBEfwvB7dF9N1dD6s9bk,5KvuS6ew8J4KCeX46ZZmvpuSBzK2DatDJmpm7cMwMKnp,True,200605645,50151411,140773,70386,70387,6L1WYrPiCMyi7XemPww4B4hvpKD1LQKD4RpiSKmrmgSC,5630950,71820275,-66189325,280
2022-05-07 22:16:37-04:00,18527,FuhTkUxSaJ7kvuu9LHZaPVfdbKAQSh9W8Zzso1XPKGZp,FLoqPzREreKfRCwqtXs3CJwpTSudmXrVYCRZadWvob7j,True,450698382,112674595,338936,169468,169468,3zqXX6kzhkbW3d4TwD2CNjMRwxTbREXySekvq37kfCNk,13557449,171229686,-157672237,300
2022-05-07 22:16:39-04:00,18528,CDVtXFbo4Rg2aHsXKv5P3uRJq9ZTgsRd7GXPTxgH5xv9,6zj37qQnaiJT7xGEZmSKx5yQvisQFcs5KhGsG43SGd5y,True,43781473,3003758,10962,5481,5481,Hu94aiQWvce6THeGyCFqGRPM1pQrK3ihzkcXo1EpJcJL,1597888,17576314,-15978426,364
2022-05-07 22:16:39-04:00,18529,Gf5g7HMy73aPnXXvgQZEiBArL7wXzx7TpivmMRDU8RJS,8ok76N32AxEocuGo7RqeZJ9a45MezH6L1My16N9UfkdA,True,4594397739,484691799,1716655,858327,858328,DQCvC9mR68hJ3tJsUiddh6JwcBJAmntqGJR2nUsEq7yj,162721970,710842067,-548120097,354
2022-05-07 22:16:39-04:00,18530,BWta2HTjCwDidjsgv1vPoD3gCHSGf679N1xijEj5jzD3,JEFa5ojXJ95W2NsV5j8qBENTm5n1uGfPDFwLRvebHDVn,False,15782338,15782338,970400,48520,921880,2a35JJeTUW1pm6M3e8DHCjp8qr4vbc2cRPhuzZWyFzYd,970400,9491784,-8521384,614
2022-05-07 22:16:39-04:00,18531,DHfy6B2AYsqMCxPLBCXMDfQn3Gr2VwJaLFHUZKqpCjsb,EPZpYaY1gCAb8pMtri5veRowBmCrCpTHBMa3Rmgt6S29,True,371924852,92981213,268654,134327,134327,2a35JJeTUW1pm6M3e8DHCjp8qr4vbc2cRPhuzZWyFzYd,10746185,35213642,-24467457,288
2022-05-07 22:16:40-04:00,18532,2HtcCr92gzqZEmnEYKrsC2d2euFz7djLYzqnbDSbhd82,3wKxFATyaQK6kZd2UahQjvL9tzMGuN2767EguLmj1bot,False,15048714,15048714,926010,46300,879710,6L1WYrPiCMyi7XemPww4B4hvpKD1LQKD4RpiSKmrmgSC,926011,5307532,-4381521,615
2022-05-07 22:16:40-04:00,18533,BKmKy8n1MpB1sdSfuWy7P3c6ReSW8TEWZRsyriz3ujYo,FgRpiZFPz43vDWStgCwRJACiGKtMLkWbTGeTLPeKnnaY,True,61378691,15344672,44689,22344,22345,8sEswn3kzEhnYjAZVvCQnHEUvYd7pFVvc2Xc2Kd1BpbC,1787572,21985602,-20198030,291
2022-05-07 22:16:40-04:00,18534,BSDeCyJsPs6y1pbDVHNq5rs6tdxcrbY3NDjXPBxwRjHz,DjHD3jawBVikzjcQ5dXBRLdUmEeBHKt6JZLhvmjScDku,True,180181252,22876488,68699,34349,34350,2a35JJeTUW1pm6M3e8DHCjp8qr4vbc2cRPhuzZWyFzYd,5410974,83957472,-78546498,300
2022-05-07 22:16:40-04:00,18535,H4rTN5pSgWQYdgpEXs79UN96nSKGQ7gkfEyS8B2Fqhyk,GttqEEtxJMkyKi2dRiUrdRyqiCyYXRj91EVzjRB6Uf5d,True,81942439,20485609,60942,30471,30471,2a35JJeTUW1pm6M3e8DHCjp8qr4vbc2cRPhuzZWyFzYd,2437695,6321902,-3884207,297
2022-05-07 22:16:42-04:00,18536,7PzGZgzieFyyFs1dbajkNQgVxooFUNZrj1bUsQvrSwbp,A2gDREmSmJTBPPw3sbKVY3smC9wbHMDdv87gr4Tr2ES7,True,1487017697,371754424,1103018,551509,551509,3zqXX6kzhkbW3d4TwD2CNjMRwxTbREXySekvq37kfCNk,44120735,126333783,-82213048,296
2022-05-07 22:16:43-04:00,18537,EHi1UBG8wMUFZECktsFUZkGjJPaBNEedswS62hyYn6jC,Drx9ErQhAjnPuJ83LPYFnY5ZV5XDzGuXDuSf16VqWayp,True,3490800638,412498537,1454019,727009,727010,2xTUy2RS74GJMMDnmFaegMzFLn19RVfYG4CibhBmjP1i,123047553,1946296126,-1823248573,352
2022-05-07 22:16:43-04:00,18538,EMFbiJWcw1YdjiDmxj5CsHMyswXyyHeL7cfWKa8dMzHh,2LjnVQF8WSwL8XSNVypW9SouYSRbyH9A7gcw7BFtxuXS,True,61175869,15293967,42756,21378,21378,5HnvdJnCCcmRsm4GkXnYWd4q9RpwuvYDGEUMPkYR3Ts9,1710256,22121290,-20411034,279
2022-05-07 22:16:45-04:00,18539,5FewDaMC9U7n5EHcto98GaAmDVxDh5SYimuTP6AtfakM,7DAULUoqV7f9hsBzKEhjQPnWaHSqiMWcBqWcdcadaQv4,True,934639183,233659795,1454814,727407,727407,2xTUy2RS74GJMMDnmFaegMzFLn19RVfYG4CibhBmjP1i,58192597,96507985,-38315388,622
2022-05-07 22:16:45-04:00,18540,9XmuJX8mFX29c5uh68kK7ff1mPdvs1orJAgEP6BsVKnq,HfPpizwUoK6uEmMb9LWi464BnvjHQY9cuPppFMp1DKDA,False,33335526,33335526,983991,49199,934792,2a35JJeTUW1pm6M3e8DHCjp8qr4vbc2cRPhuzZWyFzYd,983991,6098498,-5114507,295
2022-05-07 22:16:52-04:00,18541,4SQQdHTJUDv8taPXQRvEVJpUu91iCWQsv9su8tfehaQG,33CJXj1pmmatAofRvgt5in9E6SLEuy7tq4jqSwnUWP2A,False,13766721,13766721,851123,42556,808567,6L1WYrPiCMyi7XemPww4B4hvpKD1LQKD4RpiSKmrmgSC,851123,17999130,-17148007,618
2022-05-07 22:17:01-04:00,18542,E56pqwjJ773ovVX4fNf5YACoqMTspgSh5YjGNvwTam5h,6sUwG5onnHCjwaff4nrBXxMqJ7tMrA5DYYFF8YdEp6TJ,False,32843958,32843958,992777,49638,943139,2a35JJeTUW1pm6M3e8DHCjp8qr4vbc2cRPhuzZWyFzYd,992777,4376866,-3384089,302
2022-05-07 22:17:27-04:00,18543,9qGz5Mh1XNUXqY1vEg5S1ZEMzPFvBLRbp1qaXwxSFMby,D8KnbVXStSUz3QhZGzY5o853ASocjkyu9x682oHgVoZh,True,32156912536,3088328088,12506599,6253299,6253300,AmTrMPzuTp2BjnjqGNKqz9FTTCdpoKcPAJLwFc8ozcbh,1302237412,7558661471,-6256424059,404
2022-05-07 22:17:28-04:00,18544,HAiBRAw8ahBFB5WacCzRfycQgEYC53TJ1YmXBcHjFLmf,7hjAT4L9n7LY33YTvw79xngMfxsfv3bQkypRmBaDxMhk,True,62781779,3829152,17219,8609,8610,2a35JJeTUW1pm6M3e8DHCjp8qr4vbc2cRPhuzZWyFzYd,2823348,20041719,-17218371,449
2022-05-07 22:17:31-04:00,18545,3CPsqvzeuQAH1V5m3FDFDwNgGUPUHkU1q4jn781sPxWu,vbqWE3N9QXgEwwp4HVukJp9eyCnT33kVMAqCS9AMBxU,True,58773766,3375360,14821,7410,7411,8sEswn3kzEhnYjAZVvCQnHEUvYd7pFVvc2Xc2Kd1BpbC,2580768,18813186,-16232418,439
2022-05-07 22:17:44-04:00,18546,36C7WZ1ufgJ5vSBPMpPVRsv4EoS9AsGAp5wx5LiRTvjx,DRBttFFwyyqZwK8fn5W1xc59iHxV7JZkR76d1DDnEng3,True,62787050,3841158,17194,8597,8597,8sEswn3kzEhnYjAZVvCQnHEUvYd7pFVvc2Xc2Kd1BpbC,2810644,20023956,-17213312,447
2022-05-07 22:17:47-04:00,18547,EuMiyjSBs2ZKaPjN3FhaATvnSZG6Ak6aqdVUSApW6zM8,Hgw8jKxLXrB5G7Hk6Mh3sWZ3nHoa6Z2DzNDZGyMm4uoL,True,35784295,3276326,12929,6464,6465,2a35JJeTUW1pm6M3e8DHCjp8qr4vbc2cRPhuzZWyFzYd,1412232,9431269,-8019037,394
2022-05-07 22:17:48-04:00,18548,ETbDcnYMv5nwauExRwHHdHpChMBhD8FNgNszUE2CAdVx,2VEs3EouQ4fkdhmuehz7Jy7RW8LonkM3WpAVz7KfmydP,True,58706705,3384329,14794,7397,7397,2a35JJeTUW1pm6M3e8DHCjp8qr4vbc2cRPhuzZWyFzYd,2566337,18858315,-16291978,437
2022-05-07 22:17:49-04:00,18549,CDVtXFbo4Rg2aHsXKv5P3uRJq9ZTgsRd7GXPTxgH5xv9,6zj37qQnaiJT7xGEZmSKx5yQvisQFcs5KhGsG43SGd5y,True,40735354,2873487,10895,5447,5448,8sEswn3kzEhnYjAZVvCQnHEUvYd7pFVvc2Xc2Kd1BpbC,1544565,15829263,-14284698,379
2022-05-07 22:29:33-04:00,18550,Ai6G7vosJfmkRqtDAkqxRtbzELp6P5xe9r2RH3LYcLZt,8SUpKXakmhi4rYiFKnHYpgaAopomfDqEX6Efew9iM6nk,True,172080848,29946471,119093,59546,59547,Hu94aiQWvce6THeGyCFqGRPM1pQrK3ihzkcXo1EpJcJL,6843473,83587529,-76744056,397
2022-05-07 22:29:39-04:00,18551,Apqv5iu4bJ6pVg2NxjfwuvnfxDK6navHhhU1CVJEHeMa,7pDPJrxndRsLq983bEwvd3MKYnnqyQzQNMhEaC5NZYN1,True,324456586,81114146,245213,122606,122607,5HnvdJnCCcmRsm4GkXnYWd4q9RpwuvYDGEUMPkYR3Ts9,9808535,55427857,-45619322,302
2022-05-07 22:32:04-04:00,18552,5NVJU6YoZuuEjGNUUUJcGwS2Qd8b8CH7QSgMV7UWL5E7,8ZUq3o1nSkEvSfmiTz4anUpSMECCnX38MRwV7E5AGYSt,True,335094307,83773576,252680,126340,126340,2a35JJeTUW1pm6M3e8DHCjp8qr4vbc2cRPhuzZWyFzYd,10107229,57168995,-47061766,301
2022-05-07 22:32:14-04:00,18553,93Jp2cnKVsSUcpoNEXmuq3K17MWt7JkW3jx6v5v2UAvN,5bos8dvpCKDxeYbXxRXwEdY8tAMZoL2XhNKUdFKxTrd6,True,73183620,13304370,51766,25883,25883,Hu94aiQWvce6THeGyCFqGRPM1pQrK3ihzkcXo1EpJcJL,2847524,49629220,-46781696,389
2022-05-07 22:32:48-04:00,18554,BePQMfbkFe8vQ54rFkkf2dzXunPq2Xwpibrm1JVzSHLz,8R6rnjVUnMGUxx5sRjnuuyEnfyBGeet7y2jSJwVswyT3,True,77675569156,10743269602,32307411,16153705,16153706,GXyFXZMNk2NFyEzw6JetVqsujqcz2yCixH7n8EpDJYWD,2335877912,13073376167,-10737498255,300
2022-05-07 22:32:48-04:00,18555,6pUtYz474QrpATEZnfb3iFbTKYA65pNyKAo4TQZAjtqe,8dipRUXvxJiDLdHEtCPkso4vErbVwshHQiRfvSngBS9J,True,2247177015,223806927,783718,391859,391859,AmTrMPzuTp2BjnjqGNKqz9FTTCdpoKcPAJLwFc8ozcbh,78690834,904107426,-825416592,350
2022-05-07 22:32:50-04:00,18556,442usWu6XpJZvU25bqXeynRrQ15jAzWwU9DWMgHpTn3Q,CtvADKp39bjJf3cPKWNL3wxnhq273fVM4fC5DmEcg5cC,True,256525368,21293342,80954,40477,40477,68sueyVfmy5ToEGtLFGDkwebX47xAmzyXE29z8JrmcWv,9752792,95734958,-85982166,380
2022-05-07 22:32:51-04:00,18557,FRbeFwhUYCiHW5oP26mad8KND7CCYDbfnoNxX7GuXVp8,GrzXKxPX2WDka8i2D8sunMUsrsThKasQi8NYLwuCGygV,True,688268370,64276690,259325,129662,129663,5HnvdJnCCcmRsm4GkXnYWd4q9RpwuvYDGEUMPkYR3Ts9,27768290,271497419,-243729129,403
2022-05-07 22:32:51-04:00,18558,68gVM4kjmSYxT1uJW13rYSway8uVLUdcLa7sJuqHQaAf,DshroBQ3da7BcAiQpiFREsLKWbUDrBRmmZRw3Zu2Qfs9,True,737157044,184289261,554292,277146,277146,A9TwRM1BMxqb8DCC7YNAMV6zPenEJm3HTZBy7wJKK58U,22171681,151128281,-128956600,300
2022-05-07 22:32:55-04:00,18559,8J4BZXZzkK4SmWxc2YoaJRg9ivuuXbdVe5XpEhVds1ZM,3pirVwiye9NftvMpX5F7WpfcGZy5uV3c11xCdkkZbL9D,True,3763977641,940994410,2579091,1289545,1289546,72XWPCtRYEDZbddP7d6dHtUBRRDLSJsB2xZTAfefoEVZ,103163655,400125978,-296962323,274
2022-05-07 22:32:55-04:00,18560,5QxR9QPTADFys9VQNm473RgprTikCXC23vhsBc9ojyAQ,H9zdf8nJ4JCF7jrwGsxiuiFoa14gzDmYsZ5N5ig3UGna,True,107578223,26894555,80054,40027,40027,5HnvdJnCCcmRsm4GkXnYWd4q9RpwuvYDGEUMPkYR3Ts9,3202180,16167240,-12965060,297
2022-05-07 22:32:55-04:00,18561,BSDeCyJsPs6y1pbDVHNq5rs6tdxcrbY3NDjXPBxwRjHz,DjHD3jawBVikzjcQ5dXBRLdUmEeBHKt6JZLhvmjScDku,True,156798509,21565929,66513,33256,33257,5HnvdJnCCcmRsm4GkXnYWd4q9RpwuvYDGEUMPkYR3Ts9,4836020,77443875,-72607855,308
2022-05-07 22:32:57-04:00,18562,9RtNbEZ4ZR8T1HFF4cujPVy2kejVBKFo3CPQi8psSa1q,7zwaGb71jKc9y2HKCKy5q2XV2YUphkyU1hkDaab1GBas,True,115363807,26923983,73104,36552,36552,5HnvdJnCCcmRsm4GkXnYWd4q9RpwuvYDGEUMPkYR3Ts9,3132439,43613471,-40481032,271
2022-05-07 22:33:02-04:00,18563,DxmkdZiygge1YAwbL8U6LudY3QJkSnZMHThQXkE4Z5qy,Gi8oNcSDphbtosjFudeEPtX88bUnYid1tL9FnXnLfASU,True,82178317,20544579,53911,26955,26956,2a35JJeTUW1pm6M3e8DHCjp8qr4vbc2cRPhuzZWyFzYd,2156463,11829721,-9673258,262
2022-05-07 22:33:04-04:00,18564,BDJNQYGXMb8zSNmBJPWtaoAYH36uRTChuAGjrNcaA2AG,2mRdgipHSd5Q96ZQ2kJLez2YyVVG6mS75ET4Nr7eLkrX,True,55913080,13978270,39717,19858,19859,Hu94aiQWvce6THeGyCFqGRPM1pQrK3ihzkcXo1EpJcJL,1588686,4252361,-2663675,284
2022-05-07 22:33:24-04:00,18565,HT2SuCbePhjNZaar24uVwihYowCNvSjdvhJ8BRSVw9nX,98Ts4LCnapHVoCJ5PW3Armvh4jvDtpfs3SYRLRxiAgzZ,True,135143384,9543947,45889,22944,22945,68sueyVfmy5ToEGtLFGDkwebX47xAmzyXE29z8JrmcWv,6498060,62207792,-55709732,480
2022-05-07 22:34:03-04:00,18566,6pUtYz474QrpATEZnfb3iFbTKYA65pNyKAo4TQZAjtqe,8dipRUXvxJiDLdHEtCPkso4vErbVwshHQiRfvSngBS9J,True,2018454965,214748313,776579,388289,388290,6UQfSsLooL4pQKQfLtXCutQS2BnF7A7F7ewJopDLmUpc,72991993,851662987,-778670994,361
2022-05-07 22:34:04-04:00,18567,AL8JFS4gjaQx89f9j8wtaNJgV76K8bw1ugvNtgvhgAnb,HJYvG2kGKe8kXgtZSWTWwTmSjxA3XUeCvyT7acoKtS1C,True,53961524950,7532098813,20811567,10405783,10405784,72XWPCtRYEDZbddP7d6dHtUBRRDLSJsB2xZTAfefoEVZ,1490984098,10964227074,-9473242976,276
2022-05-07 22:34:04-04:00,18568,9qGz5Mh1XNUXqY1vEg5S1ZEMzPFvBLRbp1qaXwxSFMby,D8KnbVXStSUz3QhZGzY5o853ASocjkyu9x682oHgVoZh,True,28956163822,1303609527,5300262,2650131,2650131,DA18qE9qesbBqpwNv1M4befYcNQkbSBSeLPTmQzrmbJw,1177310187,6993788521,-5816478334,406
2022-05-07 22:34:06-04:00,18569,7tFD53kPTqrzjCu1Wji78gUqhoRtCUhsP1pM3DQKT7uG,BJvgPLYBDJrQJdQVowrsMwUGMurq4zTihoFwWoEokfu3,True,946112365,121469857,333385,166692,166693,3zqXX6kzhkbW3d4TwD2CNjMRwxTbREXySekvq37kfCNk,25966922,196999623,-171032701,274
2022-05-07 22:34:06-04:00,18570,FS5xx53Bo65G21gJLta7LEEiS132VJM1kGpUzuqyfzoy,2kbTLjdBBA9K1coxKmwmYbjq2heSnuNg4Nh2EfVNYgwj,False,493725,493725,14491,724,13767,C4UnXuShCvjSMgBAgVNMy1oakxCNk1et27A82fywU112,14492,312412,-297920,293
2022-05-07 22:34:06-04:00,18571,9AJH82vT5qffJDaufA827gZ3Za7bJcUoL6kLXCV2QfMX,78AU7GRaKkx98LcwijwUiZeYHPuEcKGpY8HWqDLgA6pX,True,102942326,25735581,70965,35482,35483,C4UnXuShCvjSMgBAgVNMy1oakxCNk1et27A82fywU112,2838624,33648134,-30809510,275
2022-05-07 22:34:08-04:00,18572,GNkEoVMpNAgfyDBZ986MR9BEVc485xpLuZWwSCyZk5zJ,AT2eiaMyZNHZGqgTdie8QjLWCTrWSdkRmQxU2vZNgtDs,False,1148430,1148430,28713,1435,27278,5HnvdJnCCcmRsm4GkXnYWd4q9RpwuvYDGEUMPkYR3Ts9,28713,423423,-394710,250
2022-05-07 22:34:08-04:00,18573,Af5aSkdtYSRqdSfK3mPBK3Grq33PDCLCASBdsMo5cmkm,9PvGthPurjNkCoTUVDBW9nNNmvAdrwK8tk4hknK7Wydg,True,257766074,64441518,192824,96412,96412,C4UnXuShCvjSMgBAgVNMy1oakxCNk1et27A82fywU112,7712981,52842512,-45129531,299
2022-05-07 22:34:08-04:00,18574,4nj9fNW5K5hZebNaCP8PDTismTb5HK4MsJLUPLsnfN7P,B4UmvQqxb4Sc35L3YzuGR8BSQC2qKd6e4Byxni7ncYkf,False,29050121,29050121,868731,43436,825295,C4UnXuShCvjSMgBAgVNMy1oakxCNk1et27A82fywU112,868731,5186489,-4317758,299
2022-05-07 22:34:08-04:00,18575,djW9rVm1v4nW64QiVqgFUCRza24VqthDcSfVEyRHPed,EsXvQmXVXECqZPtmSdiuwieHPP5jsmyn67p78vHaJcqq,True,495389470,123847367,366807,183403,183404,C4UnXuShCvjSMgBAgVNMy1oakxCNk1et27A82fywU112,14672304,42531907,-27859603,296
2022-05-07 22:34:09-04:00,18576,2mfcg17QocKKvDcqDH88TwxHRiS8dAQiJAGoAh1brns9,8aQLELBgaA9eXsxSciMjxWv8B1hpbUPfLwqVjEnasZbe,False,3196051,3196051,82766,4138,78628,Hu94aiQWvce6THeGyCFqGRPM1pQrK3ihzkcXo1EpJcJL,82766,1396541,-1313775,258
2022-05-07 22:34:10-04:00,18577,DX6DNEePMPiHBVFX2rDuFoy1fznGYDx6bUQB6qL6UAAb,FM9PNZ9HFZNPZDmg5mQRuMo9t49kDJEHM2CuZmNo6TnD,True,1457868128,364467032,1082715,541357,541358,DQCvC9mR68hJ3tJsUiddh6JwcBJAmntqGJR2nUsEq7yj,43308635,168614148,-125305513,297
2022-05-07 22:34:10-04:00,18578,5gcF5a6vf5iHAnhKHhcfceXicrefXZ9L7PzqjjrzRm48,5VE1AGgChUAW2iR4iKiznUCqtu87q8R2cdWeSuFYXjYo,False,10884394,10884394,277290,13864,263426,2a35JJeTUW1pm6M3e8DHCjp8qr4vbc2cRPhuzZWyFzYd,277290,4375328,-4098038,254
2022-05-07 22:34:10-04:00,18579,iEXYXt9JNg6tud7wsHcTe349MNWHBgAoRptNpasAGwb,DNCFSLLWNWEVfsqht6EuiQ7PwCdzhHjDk9i4UpgnDTxB,True,725616603,159310368,455229,227614,227615,gjBMZYVujDjD1ECG4i97M8Q3gV9ESnwwTSUGropkusj,20734498,110802007,-90067509,285
2022-05-07 22:34:12-04:00,18580,H3x9b27yHVdCxvtDf7mmJxkNeubcmQMwfAkLTYADPWNv,HGVCCz23rWx78vrTB2wvm2aesbLZuYFhhNuznGiSSAyA,True,65458807,16364701,47566,23783,23783,C4UnXuShCvjSMgBAgVNMy1oakxCNk1et27A82fywU112,1902678,25579752,-23677074,290
2022-05-07 22:34:12-04:00,18581,GtDk7DkAB2jvQynR57z8mjg6UoaTqYDr8Z4wsFX6KGSr,tAPvp4fscJZySZUVG2GZWZwSRVhfnNvkjCC6ZvmxqDQ,True,694107751,173526937,520379,260189,260190,C4UnXuShCvjSMgBAgVNMy1oakxCNk1et27A82fywU112,20815191,79721364,-58906173,299
2022-05-07 22:34:12-04:00,18582,F6wpqqx576XRuYo8y6XPLYphojrQtK4VvdY79Jk6My5N,38VbNLaQzLFcVqHuSR9zn9UX3Yv9SCVy1mrwmxX9PpVQ,False,13911137,13911137,396452,19822,376630,C4UnXuShCvjSMgBAgVNMy1oakxCNk1et27A82fywU112,396452,3449897,-3053445,284
2022-05-07 22:34:12-04:00,18583,9Ft21UZ66egkMCtZprBPc72WF1aj2fQwLs6XJWPXUbUV,6DGSgHegc23W5MQ6hqSsSSdwNvRqU3piR9GBoZ6fU23f,False,15694788,15694788,430996,21549,409447,C4UnXuShCvjSMgBAgVNMy1oakxCNk1et27A82fywU112,430996,7037188,-6606192,274
2022-05-07 22:34:17-04:00,18584,FncFHJooh1hy9Gc2y5sKdcYkZ5uHzsxHG4vHT9cVZGcK,BkFa4b5Jyv4ZJCCpwDYv355ezVFiZfAtn18AV7kstd2v,True,516963747,129240936,379926,189963,189963,C4UnXuShCvjSMgBAgVNMy1oakxCNk1et27A82fywU112,15197075,90088347,-74891272,293
2022-05-07 22:34:17-04:00,18585,CYQr97qwLjGnmEy6vVgs3eL7omwG6UfFbhTv7gBty5z9,DJJ9UqSZUTgyt2yWAkUnGFDuox3xYFQUuorLa7qPdM88,False,5271408,5271408,157913,7895,150018,C4UnXuShCvjSMgBAgVNMy1oakxCNk1et27A82fywU112,157913,2004234,-1846321,299
2022-05-07 22:41:48-04:00,18586,GNohZMtk1VAuhLAgNGT8J3HYCKDCiyjvLeAWr64d7Duy,6soTLVj9DzFht8DzvjRfNPAWhZuiDBS5fDE1fpeuDSSz,True,102641169,25660292,160176,80088,80088,6L1WYrPiCMyi7XemPww4B4hvpKD1LQKD4RpiSKmrmgSC,6407046,58440615,-52033569,624
2022-05-07 22:43:19-04:00,18587,Ai6G7vosJfmkRqtDAkqxRtbzELp6P5xe9r2RH3LYcLZt,8SUpKXakmhi4rYiFKnHYpgaAopomfDqEX6Efew9iM6nk,True,141366837,13014590,54840,27420,27420,5HnvdJnCCcmRsm4GkXnYWd4q9RpwuvYDGEUMPkYR3Ts9,5956840,76911510,-70954670,421
2022-05-07 22:43:34-04:00,18588,HCAGpyYM2NYudMd55Geta13tUbS6eiygnJY5ULHsHAVa,3PPyWhqXrmifWPieLV34bZ1rzi8eEnrDDAF7ifXkXspn,True,48796011,3813270,16417,8208,8209,6L1WYrPiCMyi7XemPww4B4hvpKD1LQKD4RpiSKmrmgSC,2100828,22223962,-20123134,430
2022-05-07 22:54:52-04:00,18589,E4VzeJLsf5Y6t3yNi8VpS8QxhJbJGPhnkNBmU2XoCBs9,63CXyYfevXtrL1QcfQtAhz29xeea5BwWcj6d6BWb4qiB,True,7960371613,1990092903,6009171,3004585,3004586,3zqXX6kzhkbW3d4TwD2CNjMRwxTbREXySekvq37kfCNk,240366865,3027880216,-2787513351,301
2022-05-07 22:54:58-04:00,18590,HXQXfEQe7aCpr6WKh37XaDZsjZcuQPk5t8tWNFgEoK6U,5ufXkCEDwgiXwtyPye4wYVVA3oLW54JVzz4tnXFofto4,True,4908880892,1227220223,3470170,1735085,1735085,2xTUy2RS74GJMMDnmFaegMzFLn19RVfYG4CibhBmjP1i,138806801,1805176347,-1666369546,282
2022-05-07 22:55:00-04:00,18591,3pRKRd4i6jepz5HPbSsSFj2YKwYBjgVAk2v7ZMBYZVNR,Fzf7Gx6KJam5A1eny5G49cRS2zZHFt7XMxCx8N1Ej2Jd,True,261740491,65435122,186860,93430,93430,5HnvdJnCCcmRsm4GkXnYWd4q9RpwuvYDGEUMPkYR3Ts9,7474414,95697842,-88223428,285
2022-05-07 22:55:01-04:00,18592,BAkPsWHtpVcEGqUgKTKjwZ6d5aaUcaUhdgYxBnpSTDW2,BDwDmVaZnXh22sf8nsDtjVfgxMAswbM3PW3si3k4nbRK,True,1084596145,271149036,759760,379880,379880,DQCvC9mR68hJ3tJsUiddh6JwcBJAmntqGJR2nUsEq7yj,30390423,374831061,-344440638,280
2022-05-07 22:55:02-04:00,18593,HqtTbC1LFreGvgfpZe7nCqkNnh8GHPQKosfmc19zb1yi,E39UNiHNkwQEd5GXkCtTPqSorQSB1kLx8kjzK4jdFoi3,True,58369466,14592366,40664,20332,20332,6L1WYrPiCMyi7XemPww4B4hvpKD1LQKD4RpiSKmrmgSC,1626576,14534095,-12907519,278
2022-05-07 22:55:02-04:00,18594,A7j77tzgnQVGtHTa65VtVZqJRYeJvQk7am8NW6e66379,4vJGwEvXU2tGWoWWGwbsYcfKQAMCHbrBMRk4ZVFzneLs,True,3943082223,985770555,2936860,1468430,1468430,6UQfSsLooL4pQKQfLtXCutQS2BnF7A7F7ewJopDLmUpc,117474411,920867381,-803392970,297
2022-05-07 22:55:03-04:00,18595,AsRi72uQLsBnyQxMBnPEhyQNM7XyNk2RV9GzPMe8PysA,9MqsYTBn6P9zCi5bGCrZurWWysW8XQZJwndHsb227rEW,True,42348793,10587198,30857,15428,15429,Hu94aiQWvce6THeGyCFqGRPM1pQrK3ihzkcXo1EpJcJL,1234292,15383998,-14149706,291
2022-05-07 22:55:04-04:00,18596,FU3fRyQxk6rwtD9Db1nTvTAjSwgSW9vi1q7SjZ92ijyM,7c3maBK3hpb1exxqcvnwiUfhhUBgLgCs5exANSZ7m494,True,1526836075,381709018,1138608,569304,569304,A9TwRM1BMxqb8DCC7YNAMV6zPenEJm3HTZBy7wJKK58U,45544332,98149738,-52605406,298
2022-05-07 22:55:11-04:00,18597,BEuVsj9KuYBTaxrLpKwrQtHxmhRtB16siNfPXsAvf6rz,BTjWitiLbteuKMzaFj1daYyM2v9rZygESDktu8cuzC8g,True,300694014,75173503,212569,106284,106285,C5o4TfkUfECutAWsDELjhsZX6PYyYgK3XeKvx6p4FphM,8502798,23118246,-14615448,282
2022-05-07 22:55:11-04:00,18598,EHi1UBG8wMUFZECktsFUZkGjJPaBNEedswS62hyYn6jC,Drx9ErQhAjnPuJ83LPYFnY5ZV5XDzGuXDuSf16VqWayp,True,3066990763,323503949,1163248,581624,581624,A2p75MbAbeUdHkPLkAjgGeiwuu9WPrkMHzjCkDXF1Xr3,110282196,1710710065,-1600427869,359
2022-05-07 22:55:19-04:00,18599,EVMrznfJS54BZiywDD2WhUtxzicDtbEpm2a5yLrtCgRF,CpzsMYVYvKg8ihrX1cKRw7TDEYwD3kAyiX92hsf2KiTz,True,2236251542,151274603,693125,346562,346563,AmTrMPzuTp2BjnjqGNKqz9FTTCdpoKcPAJLwFc8ozcbh,102462951,1262239235,-1159776284,458
2022-05-07 22:55:31-04:00,18600,442usWu6XpJZvU25bqXeynRrQ15jAzWwU9DWMgHpTn3Q,CtvADKp39bjJf3cPKWNL3wxnhq273fVM4fC5DmEcg5cC,True,234726748,42688727,166708,83354,83354,5HnvdJnCCcmRsm4GkXnYWd4q9RpwuvYDGEUMPkYR3Ts9,9166560,83378831,-74212271,390
2022-05-07 22:55:31-04:00,18601,5zqXqEjg95BnghcVbHRhYkSTYnzZjUBichgccv1BpS3d,9SuqSxrKpHh9NcNePe4Q3jXvpCmhNnoQv8YAFih3CqMX,True,172032946,43008236,122844,61422,61422,gjBMZYVujDjD1ECG4i97M8Q3gV9ESnwwTSUGropkusj,4913780,63120252,-58206472,285
2022-05-07 22:55:42-04:00,18602,CLVUzXSNsQnX7n5cvxMuTjyMSjy1pNpPnWejFaeuonvb,BXZzBujr8DAUcGJcHQBaz1ZSwkATAHg3NX3bLnrjQpLh,False,3816650,3816650,115603,5780,109823,C4UnXuShCvjSMgBAgVNMy1oakxCNk1et27A82fywU112,115603,1087881,-972278,302
2022-05-07 23:08:18-04:00,18603,2QjY7TNRyWX4wYbh2LY1i3Cx4AWjFftZCETwnPU3QKfz,D2JH6gjpzR8ZuZW5ZuUDrN5NtCVAVp2ESdcBpbXZnE2v,False,9174,9174,568,28,540,6L1WYrPiCMyi7XemPww4B4hvpKD1LQKD4RpiSKmrmgSC,568,1942,-1374,619
2022-05-07 23:08:40-04:00,18604,BePQMfbkFe8vQ54rFkkf2dzXunPq2Xwpibrm1JVzSHLz,8R6rnjVUnMGUxx5sRjnuuyEnfyBGeet7y2jSJwVswyT3,True,66625091626,8621665772,25813131,12906565,12906566,GXyFXZMNk2NFyEzw6JetVqsujqcz2yCixH7n8EpDJYWD,1994744759,11724658864,-9729914105,299
2022-05-07 23:08:44-04:00,18605,cXqFkCF4gaT9vAcZYMgwLXmmuD5w4hwgxT8YXE8JuBw,5Wtf4ZBL6R1afLeC4WfhFGkfi42TagtNAg6EZWn7gKhg,True,345069360,86267340,243867,121933,121934,C4UnXuShCvjSMgBAgVNMy1oakxCNk1et27A82fywU112,9754704,86527915,-76773211,282
2022-05-07 23:08:45-04:00,18606,AL8JFS4gjaQx89f9j8wtaNJgV76K8bw1ugvNtgvhgAnb,HJYvG2kGKe8kXgtZSWTWwTmSjxA3XUeCvyT7acoKtS1C,True,46358248386,5942314931,17918205,8959102,8959103,6UQfSsLooL4pQKQfLtXCutQS2BnF7A7F7ewJopDLmUpc,1397867112,9580024228,-8182157116,301
2022-05-07 23:08:46-04:00,18607,GcwFXxcxRF2xwbgFbQZoYEDreimd3J3UJ9sPfuwYVKtS,7uXjmKS8RxP2qSS7ataBH5hkfpgsFcpSBWUEBuV5zgyZ,True,553329262,138332315,386980,193490,193490,A2p75MbAbeUdHkPLkAjgGeiwuu9WPrkMHzjCkDXF1Xr3,15479225,127779578,-112300353,279
2022-05-07 23:08:46-04:00,18608,49hagnoMSB3ozBBMaTgeZ2nwEbKKS3NZWUuPShMBUwp9,6ivAhvY6bUr98jqBp4ye1w8Vz8NesEubqKDSn1jeqxmr,False,7978933,7978933,234587,11729,222858,C4UnXuShCvjSMgBAgVNMy1oakxCNk1et27A82fywU112,234587,2452483,-2217896,294
2022-05-07 23:08:52-04:00,18609,EToREv5PrDmMUqRH43RdhooZMpmzXdic79KSoBatakPp,4ZTacQQnxq89V64pELPFkmvwJgkVY7m29g2sXfnn3mPD,False,4493954,4493954,129562,6478,123084,68sueyVfmy5ToEGtLFGDkwebX47xAmzyXE29z8JrmcWv,129562,1353189,-1223627,288
2022-05-07 23:08:55-04:00,18610,FRbeFwhUYCiHW5oP26mad8KND7CCYDbfnoNxX7GuXVp8,GrzXKxPX2WDka8i2D8sunMUsrsThKasQi8NYLwuCGygV,True,621125231,107247541,424867,212433,212434,AmTrMPzuTp2BjnjqGNKqz9FTTCdpoKcPAJLwFc8ozcbh,24606250,243112818,-218506568,396
2022-05-07 23:09:02-04:00,18611,7A1A93jqxV65F7XwvBarhgfTm3iFh3s75jFNzVCtFnez,8Z6QWdy4zGUzuMdKhkdxzq7RaLHhJmrpYEKeqsw8bopx,True,240811384,60202846,177369,88684,88685,5HnvdJnCCcmRsm4GkXnYWd4q9RpwuvYDGEUMPkYR3Ts9,7094775,43808207,-36713432,294
2022-05-07 23:09:07-04:00,18612,7aM6r3HXMKzhj1hoDWjjkVCVy2y1rhDx2QV8Sdgr9DoM,4yBtGoYqo6dX4T3NMVbgMN3731hEnugL1dsR1A5vXF8f,False,4361314,4361314,127917,6395,121522,72FwbpFGoLEazJEdpqNtPNefsadUrimUqma9wSoy4qiS,127917,1809411,-1681494,293
2022-05-07 23:09:08-04:00,18613,Apqv5iu4bJ6pVg2NxjfwuvnfxDK6navHhhU1CVJEHeMa,7pDPJrxndRsLq983bEwvd3MKYnnqyQzQNMhEaC5NZYN1,True,240806199,60201549,175525,87762,87763,72FwbpFGoLEazJEdpqNtPNefsadUrimUqma9wSoy4qiS,7021016,43775758,-36754742,291
2022-05-07 23:09:10-04:00,18614,DxmkdZiygge1YAwbL8U6LudY3QJkSnZMHThQXkE4Z5qy,Gi8oNcSDphbtosjFudeEPtX88bUnYid1tL9FnXnLfASU,True,61342441,15335610,45242,22621,22621,C5o4TfkUfECutAWsDELjhsZX6PYyYgK3XeKvx6p4FphM,1809710,9356204,-7546494,295
2022-05-07 23:09:11-04:00,18615,5NVJU6YoZuuEjGNUUUJcGwS2Qd8b8CH7QSgMV7UWL5E7,8ZUq3o1nSkEvSfmiTz4anUpSMECCnX38MRwV7E5AGYSt,True,248826778,62206694,183858,91929,91929,72FwbpFGoLEazJEdpqNtPNefsadUrimUqma9wSoy4qiS,7354329,45148884,-37794555,295
2022-05-07 23:10:16-04:00,18616,9RtNbEZ4ZR8T1HFF4cujPVy2kejVBKFo3CPQi8psSa1q,7zwaGb71jKc9y2HKCKy5q2XV2YUphkyU1hkDaab1GBas,True,88050725,20096831,60889,30444,30445,C4UnXuShCvjSMgBAgVNMy1oakxCNk1et27A82fywU112,2667767,33907966,-31240199,302
2022-05-07 23:12:24-04:00,18617,7tFD53kPTqrzjCu1Wji78gUqhoRtCUhsP1pM3DQKT7uG,BJvgPLYBDJrQJdQVowrsMwUGMurq4zTihoFwWoEokfu3,True,823450268,115065490,341086,170543,170543,C4UnXuShCvjSMgBAgVNMy1oakxCNk1et27A82fywU112,24409434,171987152,-147577718,296
2022-05-07 23:12:25-04:00,18618,8J4BZXZzkK4SmWxc2YoaJRg9ivuuXbdVe5XpEhVds1ZM,3pirVwiye9NftvMpX5F7WpfcGZy5uV3c11xCdkkZbL9D,True,2806206320,701551580,2093421,1046710,1046711,5HnvdJnCCcmRsm4GkXnYWd4q9RpwuvYDGEUMPkYR3Ts9,83736853,323747341,-240010488,298
2022-05-07 23:12:28-04:00,18619,6pUtYz474QrpATEZnfb3iFbTKYA65pNyKAo4TQZAjtqe,8dipRUXvxJiDLdHEtCPkso4vErbVwshHQiRfvSngBS9J,True,1799156199,102832291,386332,193166,193166,3zqXX6kzhkbW3d4TwD2CNjMRwxTbREXySekvq37kfCNk,67592778,789092665,-721499887,375
2022-05-07 23:12:28-04:00,18620,CDVtXFbo4Rg2aHsXKv5P3uRJq9ZTgsRd7GXPTxgH5xv9,6zj37qQnaiJT7xGEZmSKx5yQvisQFcs5KhGsG43SGd5y,True,37771614,1332502,5087,2543,2544,5HnvdJnCCcmRsm4GkXnYWd4q9RpwuvYDGEUMPkYR3Ts9,1442097,14736289,-13294192,381
2022-05-07 23:12:32-04:00,18621,BSDeCyJsPs6y1pbDVHNq5rs6tdxcrbY3NDjXPBxwRjHz,DjHD3jawBVikzjcQ5dXBRLdUmEeBHKt6JZLhvmjScDku,True,134556853,16907406,51371,25685,25686,68sueyVfmy5ToEGtLFGDkwebX47xAmzyXE29z8JrmcWv,4088413,64301197,-60212784,303
2022-05-07 23:13:27-04:00,18622,BDJNQYGXMb8zSNmBJPWtaoAYH36uRTChuAGjrNcaA2AG,2mRdgipHSd5Q96ZQ2kJLez2YyVVG6mS75ET4Nr7eLkrX,True,41627085,10406771,31004,15502,15502,68sueyVfmy5ToEGtLFGDkwebX47xAmzyXE29z8JrmcWv,1240193,3545785,-2305592,297
2022-05-07 23:13:29-04:00,18623,93Jp2cnKVsSUcpoNEXmuq3K17MWt7JkW3jx6v5v2UAvN,5bos8dvpCKDxeYbXxRXwEdY8tAMZoL2XhNKUdFKxTrd6,True,59522076,5027172,20560,10280,10280,68sueyVfmy5ToEGtLFGDkwebX47xAmzyXE29z8JrmcWv,2434428,41785511,-39351083,408
2022-05-07 23:13:33-04:00,18624,Ai6G7vosJfmkRqtDAkqxRtbzELp6P5xe9r2RH3LYcLZt,8SUpKXakmhi4rYiFKnHYpgaAopomfDqEX6Efew9iM6nk,True,127537369,22152762,88248,44124,44124,C4UnXuShCvjSMgBAgVNMy1oakxCNk1et27A82fywU112,5080625,64162628,-59082003,398
2022-05-07 23:24:01-04:00,18625,DveCRMXe4oGq4nfsNmfabw37euBwqxqNUH5svSCkYjwD,BWJvLCXqju7J2PqPcy4xd5z42VJCFzTMXAhd17Ng25sQ,True,19801994799,4950498699,30838362,15419181,15419181,A2p75MbAbeUdHkPLkAjgGeiwuu9WPrkMHzjCkDXF1Xr3,1233534503,2425839243,-1192304740,622
2022-05-07 23:26:26-04:00,18626,7PzGZgzieFyyFs1dbajkNQgVxooFUNZrj1bUsQvrSwbp,A2gDREmSmJTBPPw3sbKVY3smC9wbHMDdv87gr4Tr2ES7,True,1104337404,276084351,801650,400825,400825,6L1WYrPiCMyi7XemPww4B4hvpKD1LQKD4RpiSKmrmgSC,32066016,104680926,-72614910,290
2022-05-07 23:26:26-04:00,18627,2C5SAHJKnhp9rwjNw829Qxx7ceBc4xGYGvjBZrwFtT8X,24QLP8Fo3FW8bTLQtz3oZRfytbQiyiMpTD8ikMqzkCuf,False,15907848,15907848,475395,23769,451626,68sueyVfmy5ToEGtLFGDkwebX47xAmzyXE29z8JrmcWv,475395,6342647,-5867252,298
2022-05-07 23:26:26-04:00,18628,3idUQDMPAN9f6F6BipHAYFZyhG5JADey1y7JcFYx5BRh,D6UMk8WsSRahs4nGyi9DLt2HyZQy4wAywDwL31sL8BVj,False,734154,734154,21018,1050,19968,68sueyVfmy5ToEGtLFGDkwebX47xAmzyXE29z8JrmcWv,21018,303476,-282458,286
2022-05-07 23:26:27-04:00,18629,JE6YNDmKQsxj4zsURyr1eh5cJjNCR2CvLmawufXWMCKx,2ctukoNZQ4BwabFZBJfhK2ic67ChHnGSBJyiSnmiCpAW,True,63280691,15820172,46460,23230,23230,5HnvdJnCCcmRsm4GkXnYWd4q9RpwuvYDGEUMPkYR3Ts9,1858427,12987766,-11129339,293
2022-05-07 23:26:27-04:00,18630,5gN3624v6n1zQ1BKtZi1e9ZLpbCa4MEfhgHySFB81Qfm,UXT3oB5ud18rBsygsfxwA93kQYdSNbbzTCjt4gtU2jP,False,6330287,6330287,183001,9150,173851,6L1WYrPiCMyi7XemPww4B4hvpKD1LQKD4RpiSKmrmgSC,183001,1960807,-1777806,289
2022-05-07 23:26:28-04:00,18631,Cb6MEn1MN9XQcVVd3o9J8QdK3cFWxSNETsFzhVJ8jmdh,A6yTKbggUftjbjAVu5YR1M7rg7h78ghbfofmTSnmKNGz,True,124703120,31175780,88226,44113,44113,Hu94aiQWvce6THeGyCFqGRPM1pQrK3ihzkcXo1EpJcJL,3529063,10568637,-7039574,282
2022-05-07 23:31:24-04:00,18632,iEXYXt9JNg6tud7wsHcTe349MNWHBgAoRptNpasAGwb,DNCFSLLWNWEVfsqht6EuiQ7PwCdzhHjDk9i4UpgnDTxB,True,564334041,118917027,373366,186683,186683,C4UnXuShCvjSMgBAgVNMy1oakxCNk1et27A82fywU112,17718531,81818449,-64099918,313
2022-05-07 23:31:25-04:00,18633,9tt8Hp2uzgmuv9fHSZDH299ytZGpqQuqA4arrksvpncJ,J1Y4k1hkmxncznXCdgNSmH7aW2Zdppe9QPWZZmanXrAL,True,109519579,27379894,75777,37888,37889,C4UnXuShCvjSMgBAgVNMy1oakxCNk1et27A82fywU112,3031091,34511870,-31480779,276
2022-05-07 23:31:26-04:00,18634,71DcjZY2Fd1Jg9YkDXUH5usC9QcHeQqSxoEk7tH3fhzo,3o4iDHXNpNVAHaHzVirbcNevP6YfoP2EqddBNoSRU4hn,False,5138043,5138043,145377,7268,138109,5HnvdJnCCcmRsm4GkXnYWd4q9RpwuvYDGEUMPkYR3Ts9,145377,2042446,-1897069,282
2022-05-07 23:31:38-04:00,18635,FU7X4DWnGTbxwXULBq3v9SACzYhQyFGqsXjUDzyFqiem,925BaEnWxTfEv4oQb9Xf1wyyEEWEr8kXeSdXTtRfShfw,True,19289958,4822489,27986,13993,13993,5HnvdJnCCcmRsm4GkXnYWd4q9RpwuvYDGEUMPkYR3Ts9,1119476,8158737,-7039261,580
2022-05-07 23:31:38-04:00,18636,AXBfrbCpYAWKN5jgDVVMiKXscQ96YtotKV3DT6XSzm9o,Dh3SiHAqrQzPQnTLRMxtBn2EFyHNgyfnYGpgcuNGTvyL,True,99755358,24938839,147668,73834,73834,6L1WYrPiCMyi7XemPww4B4hvpKD1LQKD4RpiSKmrmgSC,5906742,49354291,-43447549,592
2022-05-05 11:29:56-04:00,17613,26wo1RqwKXrNnfgMdZEmkGhnDbURpZcp2hasB5EA5QtD,34gwTVGRrdoaBzLUG6SBwRwBovkjBjCebqVUBan6GDnB,True,16342094693,4085523673,28745962,14372981,14372981,AmTrMPzuTp2BjnjqGNKqz9FTTCdpoKcPAJLwFc8ozcbh,1149838504,6536792477,-5386953973,703
2022-05-05 11:29:59-04:00,17614,DZnaFtxiEHUv3geRGsKufTnCUhkSMbN2M7W4Bwu2LgkM,A38xXBMxA13qQnVB1tcd5USxpfdaUGmkp31FeTmCyb52,True,98869080,13262844,90917,45458,45459,C4UnXuShCvjSMgBAgVNMy1oakxCNk1et27A82fywU112,6777564,47789754,-41012190,685
2022-05-05 11:31:45-04:00,17615,BaFWQSYQQikWywyGiHgG25hEons9nW5zhvUTzp8oAcYU,7WyiB5TBMB49ctd4cZBExSJyD51JMYnokScjSWixoPdk,True,23608543,1680853,11113,5556,5557,2a35JJeTUW1pm6M3e8DHCjp8qr4vbc2cRPhuzZWyFzYd,1561003,3212103,-1651100,661
2022-05-05 11:45:58-04:00,17616,7DTi299NL6owDJEkjWY6SZX6MhLB72oU1xr9d5DPUzZp,F8YWvNb45pdhgkfCtrFiPNeS4rtjkjTkBkvL5EoPzYXM,True,273892396,68473099,487464,243732,243732,68sueyVfmy5ToEGtLFGDkwebX47xAmzyXE29z8JrmcWv,19498580,41439966,-21941386,711
2022-05-05 11:49:45-04:00,17617,FRbeFwhUYCiHW5oP26mad8KND7CCYDbfnoNxX7GuXVp8,GrzXKxPX2WDka8i2D8sunMUsrsThKasQi8NYLwuCGygV,True,5045616807,869745636,3461537,1730768,1730769,C4UnXuShCvjSMgBAgVNMy1oakxCNk1et27A82fywU112,200812677,1442872072,-1242059395,397
2022-05-05 11:50:24-04:00,17618,CDVtXFbo4Rg2aHsXKv5P3uRJq9ZTgsRd7GXPTxgH5xv9,6zj37qQnaiJT7xGEZmSKx5yQvisQFcs5KhGsG43SGd5y,True,459469954,50240895,166032,83016,83016,3zqXX6kzhkbW3d4TwD2CNjMRwxTbREXySekvq37kfCNk,15184252,145197559,-130013307,330
2022-05-05 11:50:33-04:00,17619,Hgs1Lk2ESxULpgcbgayhLdHSDyw5Yr6RiNYhP8q9CHwC,42prjFMA3G8DGZxkgXRDupGkz9GFSxB2mu1ccnEqPhjv,True,244264202,61066050,183998,91999,91999,72XWPCtRYEDZbddP7d6dHtUBRRDLSJsB2xZTAfefoEVZ,7359955,27911421,-20551466,301
2022-05-05 11:50:34-04:00,17620,B6Wc3euMqUf6QjzCqDtNeAEUM7MvADFaiReEq9VYH2Qg,2pzhsqXYd5u7h4xTN8bMS3GbicVnJ6KY3MQn7spSXroA,True,45175944,6408698,19403,9701,9702,C4UnXuShCvjSMgBAgVNMy1oakxCNk1et27A82fywU112,1367778,12531644,-11163866,302
2022-05-05 11:50:36-04:00,17621,BhhVhLVZkSd3aHDMd6ojTgtJtbgAdMCA9Xj8jL2GMXoL,G8HUQp2yGSw9T6it5ej91cqkd82naca8heji453g2jEH,True,281361424,38489395,181968,90984,90984,6UQfSsLooL4pQKQfLtXCutQS2BnF7A7F7ewJopDLmUpc,13302157,103554155,-90251998,472
2022-05-05 11:50:59-04:00,17622,3CxwyEadyRMxq6XyjjVAK4TB3we6dcLZf3GVCQLSDEPM,Bp12mixLHgc3L6CvzqzsyV4GLMrmxGiydZE4buJwsHmr,False,20848092,20848092,956373,47818,908555,68sueyVfmy5ToEGtLFGDkwebX47xAmzyXE29z8JrmcWv,956375,3015002,-2058627,458
2022-05-05 11:52:18-04:00,17623,4oMasDRj8HWfknmdwt6Mkz3eonr8J2byoiSTRo4sCnFQ,3emcATkEFvDVETiK97eVET2Z2jzkgiiSxX3gu5wsUKPe,True,39538152915,5149271618,33935687,16967843,16967844,3zqXX6kzhkbW3d4TwD2CNjMRwxTbREXySekvq37kfCNk,2605716926,8748688568,-6142971642,659
2022-05-05 11:52:19-04:00,17624,HqtTbC1LFreGvgfpZe7nCqkNnh8GHPQKosfmc19zb1yi,E39UNiHNkwQEd5GXkCtTPqSorQSB1kLx8kjzK4jdFoi3,True,2057387197,514346799,1523161,761580,761581,2a35JJeTUW1pm6M3e8DHCjp8qr4vbc2cRPhuzZWyFzYd,60926467,253508297,-192581830,296
2022-05-05 11:52:19-04:00,17625,SEndYVMCKAeZUKSqGrMUSqXFmxtA9M1t4eXsUhVsTBF,3fcQQcbkpqodakamn82pFnMxBEPL2Drsg4jJNZ6dx72M,True,358529461,30421987,189591,94795,94796,2a35JJeTUW1pm6M3e8DHCjp8qr4vbc2cRPhuzZWyFzYd,22343796,54737178,-32393382,623
2022-05-05 11:52:20-04:00,17626,DZnaFtxiEHUv3geRGsKufTnCUhkSMbN2M7W4Bwu2LgkM,A38xXBMxA13qQnVB1tcd5USxpfdaUGmkp31FeTmCyb52,True,84953126,11315224,80362,40181,40181,C4UnXuShCvjSMgBAgVNMy1oakxCNk1et27A82fywU112,6033537,44258882,-38225345,710
2022-05-05 11:52:24-04:00,17627,CDVtXFbo4Rg2aHsXKv5P3uRJq9ZTgsRd7GXPTxgH5xv9,6zj37qQnaiJT7xGEZmSKx5yQvisQFcs5KhGsG43SGd5y,True,407861668,44496817,148927,74463,74464,2a35JJeTUW1pm6M3e8DHCjp8qr4vbc2cRPhuzZWyFzYd,13650829,133526819,-119875990,334
2022-05-05 11:52:29-04:00,17628,AggAFLRnGWU7X97a3sWRKV7wDDRiAGn9Q4azmEYXAo1k,Dj4DzvpxgQiRoad1zTXoNTrgGTDHG9NvMeCzzRZSxkvs,True,516092942,86972236,353094,176547,176547,2a35JJeTUW1pm6M3e8DHCjp8qr4vbc2cRPhuzZWyFzYd,20952664,95154966,-74202302,405
2022-05-05 11:52:34-04:00,17629,HEFpdWLZaiQnjftmXgxs6RNzhH72YiMjortxPkKekkvb,5Q8mmxBgVTijNGrWsnoA3VMArLHZEX5MkaigYXHpgXHE,False,252611,252611,10710,535,10175,68sueyVfmy5ToEGtLFGDkwebX47xAmzyXE29z8JrmcWv,10711,171254,-160543,424
2022-05-05 11:52:35-04:00,17630,4PZZxNrWLhNCuT5VJ1DQe3XxQVVwMPrjfUpdeAY8qS7U,A7CvKre7y5VbUN1HneNHmuBv7jWtayV78oozAqaVbQrv,False,25391536,25391536,738782,36939,701843,C4UnXuShCvjSMgBAgVNMy1oakxCNk1et27A82fywU112,738782,12555198,-11816416,290
2022-05-05 11:52:36-04:00,17631,7tFD53kPTqrzjCu1Wji78gUqhoRtCUhsP1pM3DQKT7uG,BJvgPLYBDJrQJdQVowrsMwUGMurq4zTihoFwWoEokfu3,True,18351921563,2389863963,7208511,3604255,3604256,6UQfSsLooL4pQKQfLtXCutQS2BnF7A7F7ewJopDLmUpc,553546335,2030481686,-1476935351,301
2022-05-05 11:52:36-04:00,17632,5xkW7wHTcF5WadNtBBqKPKctVwyQtTqqscivAmxzseCk,7m31ZMZdCn5Gz2q5sETWA7uKA5LsKD7pJHBBqU3g7tCn,True,558153988,139538497,412880,206440,206440,68sueyVfmy5ToEGtLFGDkwebX47xAmzyXE29z8JrmcWv,16515239,70577419,-54062180,295
2022-05-05 11:52:38-04:00,17633,BmFSXZx3HWaTtD7vp7AkUk5DUNjwK1qgLPod13EJz6No,DtLMfV3Xs7AAAQqC1PwL7YAfV6fig8yAMxr9MMxmyCKc,True,228825284,57206321,172817,86408,86409,C4UnXuShCvjSMgBAgVNMy1oakxCNk1et27A82fywU112,6912690,24973998,-18061308,302
2022-05-05 11:52:39-04:00,17634,B6Wc3euMqUf6QjzCqDtNeAEUM7MvADFaiReEq9VYH2Qg,2pzhsqXYd5u7h4xTN8bMS3GbicVnJ6KY3MQn7spSXroA,True,38586015,4878506,14756,7378,7378,C4UnXuShCvjSMgBAgVNMy1oakxCNk1et27A82fywU112,1167144,10856548,-9689404,302
2022-05-05 11:52:56-04:00,17635,CeoZ82imadaXaJHLw597HxGfaHvefRtAErFLLtcpEYe3,C7Rf33dms1PLrASt1nPWqFiiaX7ZBq76h8RS3JMTR6yX,False,13634369,13634369,971606,48580,923026,68sueyVfmy5ToEGtLFGDkwebX47xAmzyXE29z8JrmcWv,971607,4199316,-3227709,712
2022-05-05 11:53:00-04:00,17636,FtF3PVw8YNJseWPMcA2GEuQZ6nni1mq5kYPa2LrSzfkW,4yr1TM2dXrBvLNMpSaoryuGU2P8D3WG1ZCkvVzWFiQRH,True,24390385,1157683,5333,2666,2667,C4UnXuShCvjSMgBAgVNMy1oakxCNk1et27A82fywU112,1123793,14090108,-12966315,460
2022-05-05 11:53:13-04:00,17637,AQr9mVmcXCNQhBVCfx63MwR6c4WqDSC9K2BZqr7N8LCx,CB7TWUaL381ounsLw6neAUaKRxJL9P1HC9uGX5e1Uxod,True,20214921,1131171,5704,2852,2852,2a35JJeTUW1pm6M3e8DHCjp8qr4vbc2cRPhuzZWyFzYd,1019363,8535341,-7515978,504
2022-05-05 11:53:22-04:00,17638,8fVwuVA2CL5sZoHh6Dg4MBpcX3cvoUm7mnitnpQSdPBD,4F4ccaNm1KQu29XvsKvdjFkmpsbWqNvXkV41851EYQyu,False,20272325,20272325,929283,46464,882819,68sueyVfmy5ToEGtLFGDkwebX47xAmzyXE29z8JrmcWv,929284,7838961,-6909677,458
2022-05-05 11:53:22-04:00,17639,3Dc89y1Z6ViLFDoY3vwcJewSjMQam2mSTqPtpxsPZVz5,4NfXm5CTgNUTQd6NPj2hKwjMYDr7a8d5yVC9rV2uTcjA,True,814758301,203689575,1423201,711600,711601,C4UnXuShCvjSMgBAgVNMy1oakxCNk1et27A82fywU112,56928064,211686544,-154758480,698
2022-05-05 11:53:46-04:00,17640,HmspGdpobjC5Vbmo3FcKdw4RLPN7wJKxv3uKqDjVhLee,3YEX8TzdyJyuHo76Kw76imVCJjzrC9m188YuRKvwwSwD,False,5358564,5358564,328249,16412,311837,68sueyVfmy5ToEGtLFGDkwebX47xAmzyXE29z8JrmcWv,328249,3046524,-2718275,612
2022-05-05 11:53:47-04:00,17641,Cb6MEn1MN9XQcVVd3o9J8QdK3cFWxSNETsFzhVJ8jmdh,A6yTKbggUftjbjAVu5YR1M7rg7h78ghbfofmTSnmKNGz,True,295994015,73998503,455225,227612,227613,C4UnXuShCvjSMgBAgVNMy1oakxCNk1et27A82fywU112,18209024,62730744,-44521720,615
2022-05-05 11:54:14-04:00,17642,DZnaFtxiEHUv3geRGsKufTnCUhkSMbN2M7W4Bwu2LgkM,A38xXBMxA13qQnVB1tcd5USxpfdaUGmkp31FeTmCyb52,True,72730384,9748948,67632,33816,33816,C4UnXuShCvjSMgBAgVNMy1oakxCNk1et27A82fywU112,5045657,37226742,-32181085,693
2022-05-05 11:54:36-04:00,17643,FRbeFwhUYCiHW5oP26mad8KND7CCYDbfnoNxX7GuXVp8,GrzXKxPX2WDka8i2D8sunMUsrsThKasQi8NYLwuCGygV,True,4154100492,386912777,1635355,817677,817678,A2p75MbAbeUdHkPLkAjgGeiwuu9WPrkMHzjCkDXF1Xr3,175580461,1256621629,-1081041168,422
2022-05-05 11:54:36-04:00,17644,26wo1RqwKXrNnfgMdZEmkGhnDbURpZcp2hasB5EA5QtD,34gwTVGRrdoaBzLUG6SBwRwBovkjBjCebqVUBan6GDnB,True,11896044083,2974011020,19014140,9507070,9507070,gjBMZYVujDjD1ECG4i97M8Q3gV9ESnwwTSUGropkusj,760565605,5184023241,-4423457636,639
2022-05-05 11:54:41-04:00,17645,8sQzUoiFfBUsfVKdUjUh3xUjwnaCP1Qmw9BGwtH768ZR,8wZxijgcyRwqxiRKMMZhoREAb6iHhRGCgjgZRd5Yp6RP,True,3245232264,652907739,4563526,2281763,2281763,2xTUy2RS74GJMMDnmFaegMzFLn19RVfYG4CibhBmjP1i,226826917,353781837,-126954920,698
2022-05-05 11:54:49-04:00,17646,SEndYVMCKAeZUKSqGrMUSqXFmxtA9M1t4eXsUhVsTBF,3fcQQcbkpqodakamn82pFnMxBEPL2Drsg4jJNZ6dx72M,True,325525352,29095554,182459,91229,91230,DQCvC9mR68hJ3tJsUiddh6JwcBJAmntqGJR2nUsEq7yj,20413911,42193674,-21779763,627
2022-05-05 11:54:55-04:00,17647,5tW54mXQxtM7vGc91HrDeDtWkxJeH2uM4yAviqZnMZCN,7Kg5Zwx5afFdLbTifeyKJLSNVj2p9Xf5anbbqQozNzmY,True,1300608705,140494413,874116,437058,437058,3zqXX6kzhkbW3d4TwD2CNjMRwxTbREXySekvq37kfCNk,80920168,152432162,-71511994,622
2022-05-05 11:54:59-04:00,17648,DZnaFtxiEHUv3geRGsKufTnCUhkSMbN2M7W4Bwu2LgkM,A38xXBMxA13qQnVB1tcd5USxpfdaUGmkp31FeTmCyb52,True,62442469,8378421,59562,29781,29781,68sueyVfmy5ToEGtLFGDkwebX47xAmzyXE29z8JrmcWv,4439058,34380859,-29941801,710
2022-05-05 11:55:04-04:00,17649,4oMasDRj8HWfknmdwt6Mkz3eonr8J2byoiSTRo4sCnFQ,3emcATkEFvDVETiK97eVET2Z2jzkgiiSxX3gu5wsUKPe,True,34045776614,4726113494,30937693,15468846,15468847,3zqXX6kzhkbW3d4TwD2CNjMRwxTbREXySekvq37kfCNk,2228676556,7865814666,-5637138110,654
2022-05-05 11:55:07-04:00,17650,5QxR9QPTADFys9VQNm473RgprTikCXC23vhsBc9ojyAQ,H9zdf8nJ4JCF7jrwGsxiuiFoa14gzDmYsZ5N5ig3UGna,True,1155974102,288993525,873484,436742,436742,A2p75MbAbeUdHkPLkAjgGeiwuu9WPrkMHzjCkDXF1Xr3,34939362,82824944,-47885582,302
2022-05-05 11:55:07-04:00,17651,D8BtQirMEk3W9Pq29B6KkKWrwPfmsUNpwz5npx7aGMLY,J7LMZwaSoh5hbGcwee6oPsnN4ZFD7Zp3LQWkJGNUHRfJ,True,313432204,78358051,541282,270641,270641,C4UnXuShCvjSMgBAgVNMy1oakxCNk1et27A82fywU112,21651317,108047016,-86395699,690
2022-05-05 11:55:10-04:00,17652,68zbVKnneMQqngbNkeLtPEP2ayNhawc1B2hPgqAEqgXK,HqiFpLr4NC7xJz9bEFusq8bCKaoxAQG1xsLxdUAzg8aa,True,202370579,9540894,40290,20145,20145,GXyFXZMNk2NFyEzw6JetVqsujqcz2yCixH7n8EpDJYWD,8546031,90905665,-82359634,422
2022-05-05 11:55:21-04:00,17653,BjCNaM7YbE9SjFi7tzi4677zg1fKXGJwtecz2GWwWuhd,6rNsSrKZezQrLb2whToNjnizpnurDXrobHqfEK3QqU1M,True,45742995,3303163,15253,7626,7627,2a35JJeTUW1pm6M3e8DHCjp8qr4vbc2cRPhuzZWyFzYd,2112337,23814859,-21702522,461
2022-05-05 11:56:27-04:00,17654,BaFWQSYQQikWywyGiHgG25hEons9nW5zhvUTzp8oAcYU,7WyiB5TBMB49ctd4cZBExSJyD51JMYnokScjSWixoPdk,True,21317184,1412078,9357,4678,4679,68sueyVfmy5ToEGtLFGDkwebX47xAmzyXE29z8JrmcWv,1412706,2990452,-1577746,662
2022-05-05 11:57:21-04:00,17655,26wo1RqwKXrNnfgMdZEmkGhnDbURpZcp2hasB5EA5QtD,34gwTVGRrdoaBzLUG6SBwRwBovkjBjCebqVUBan6GDnB,True,8806720345,2201680086,15655968,7827984,7827984,68sueyVfmy5ToEGtLFGDkwebX47xAmzyXE29z8JrmcWv,626238747,4071763612,-3445524865,711
2022-05-05 11:58:58-04:00,17656,DZnaFtxiEHUv3geRGsKufTnCUhkSMbN2M7W4Bwu2LgkM,A38xXBMxA13qQnVB1tcd5USxpfdaUGmkp31FeTmCyb52,True,53484468,7079569,50297,25148,25149,2a35JJeTUW1pm6M3e8DHCjp8qr4vbc2cRPhuzZWyFzYd,3799916,28999340,-25199424,710
2022-05-05 12:01:40-04:00,17657,BaFWQSYQQikWywyGiHgG25hEons9nW5zhvUTzp8oAcYU,7WyiB5TBMB49ctd4cZBExSJyD51JMYnokScjSWixoPdk,True,19946473,1588454,10537,5268,5269,2a35JJeTUW1pm6M3e8DHCjp8qr4vbc2cRPhuzZWyFzYd,1323235,3198683,-1875448,663
2022-05-05 12:09:00-04:00,17658,9ZyfJ3h3FBWxiFxQRNKb376GTeHUfagdqLkGH6gd8qtm,5hFfXHM23QzxHTE6YXvbaJFBQdLpPwX2Ex5N679V1JTw,True,16080676597,1843497349,11839066,5919533,5919533,2xTUy2RS74GJMMDnmFaegMzFLn19RVfYG4CibhBmjP1i,1032712148,3032585345,-1999873197,642
2022-05-05 12:09:24-04:00,17659,BaFWQSYQQikWywyGiHgG25hEons9nW5zhvUTzp8oAcYU,7WyiB5TBMB49ctd4cZBExSJyD51JMYnokScjSWixoPdk,True,18281188,1080917,7131,3565,3566,5HnvdJnCCcmRsm4GkXnYWd4q9RpwuvYDGEUMPkYR3Ts9,1206135,2975093,-1768958,659
2022-05-05 12:11:56-04:00,17660,64Diz8zzEv1jDWnBQPTHPpXwaWf7vjM19RyJmkPy1viQ,G8wkGHRHMtT3mvXBkH3zgsKNs8wbpdiPUS17y4cozhkZ,True,373134580,93283645,581763,290881,290882,2a35JJeTUW1pm6M3e8DHCjp8qr4vbc2cRPhuzZWyFzYd,23270524,38383000,-15112476,623
2022-05-05 12:41:31-04:00,17661,7DTi299NL6owDJEkjWY6SZX6MhLB72oU1xr9d5DPUzZp,F8YWvNb45pdhgkfCtrFiPNeS4rtjkjTkBkvL5EoPzYXM,True,200684859,50171214,357249,178624,178625,2a35JJeTUW1pm6M3e8DHCjp8qr4vbc2cRPhuzZWyFzYd,14289988,35488147,-21198159,712
2022-05-05 13:26:28-04:00,17662,26wo1RqwKXrNnfgMdZEmkGhnDbURpZcp2hasB5EA5QtD,34gwTVGRrdoaBzLUG6SBwRwBovkjBjCebqVUBan6GDnB,True,6453287242,1613321810,11409846,5704923,5704923,72XWPCtRYEDZbddP7d6dHtUBRRDLSJsB2xZTAfefoEVZ,456393864,3199355422,-2742961558,707
2022-05-05 13:44:11-04:00,17663,4ZF1wtHKAnxmEZGACgbgphHvuo5aK4wC4MCNJzLYVkMX,5UXyhRP3Rjsc1RbV8BouJVQoTbWWbuPtVJY15KcHJFCN,True,563983817,140995954,423508,211754,211754,C4UnXuShCvjSMgBAgVNMy1oakxCNk1et27A82fywU112,16940339,132912875,-115972536,300
2022-05-05 13:45:15-04:00,17664,kn4CMFEGiFu6Sw8v7GAZaBNHKe5Mst4Bj2kds1B6Daw,4FAjghUCswqbD6SKVr7Mu9aLcSLxDofiBvxgkZeiVz32,False,33181537,33181537,998640,49932,948708,2a35JJeTUW1pm6M3e8DHCjp8qr4vbc2cRPhuzZWyFzYd,998641,5512189,-4513548,300
2022-05-05 13:45:15-04:00,17665,Hgs1Lk2ESxULpgcbgayhLdHSDyw5Yr6RiNYhP8q9CHwC,42prjFMA3G8DGZxkgXRDupGkz9GFSxB2mu1ccnEqPhjv,True,181410367,45352591,133879,66939,66940,2a35JJeTUW1pm6M3e8DHCjp8qr4vbc2cRPhuzZWyFzYd,5355185,22557102,-17201917,295
2022-05-05 13:45:23-04:00,17666,9XmuJX8mFX29c5uh68kK7ff1mPdvs1orJAgEP6BsVKnq,HfPpizwUoK6uEmMb9LWi464BnvjHQY9cuPppFMp1DKDA,True,872475077,218118769,644858,322429,322429,68sueyVfmy5ToEGtLFGDkwebX47xAmzyXE29z8JrmcWv,25794338,63666216,-37871878,295
2022-05-05 13:45:24-04:00,17667,87yYQuRW91LAqEmqEyYah7obsr4KijRrqsKdK7DGA9w,EJzredSumMNBMTYxMMHocKayWKg3A3621QJ3ArJqro8r,True,475149696,118787424,340431,170215,170216,2a35JJeTUW1pm6M3e8DHCjp8qr4vbc2cRPhuzZWyFzYd,13617268,110264115,-96646847,286
2022-05-05 13:45:36-04:00,17668,5zqXqEjg95BnghcVbHRhYkSTYnzZjUBichgccv1BpS3d,9SuqSxrKpHh9NcNePe4Q3jXvpCmhNnoQv8YAFih3CqMX,True,4510343939,1127585984,3414926,1707463,1707463,3zqXX6kzhkbW3d4TwD2CNjMRwxTbREXySekvq37kfCNk,136597065,1076597011,-939999946,302
2022-05-05 13:45:36-04:00,17669,HqtTbC1LFreGvgfpZe7nCqkNnh8GHPQKosfmc19zb1yi,E39UNiHNkwQEd5GXkCtTPqSorQSB1kLx8kjzK4jdFoi3,True,1530224970,382556242,1157718,578859,578859,2py1FiYeL2f7J3HU36qiJz6TD6HCmiTN36RyxYtapQCZ,46308753,203598714,-157289961,302
2022-05-05 13:48:25-04:00,17670,B6Wc3euMqUf6QjzCqDtNeAEUM7MvADFaiReEq9VYH2Qg,2pzhsqXYd5u7h4xTN8bMS3GbicVnJ6KY3MQn7spSXroA,True,33578792,4733444,14337,7168,7169,68sueyVfmy5ToEGtLFGDkwebX47xAmzyXE29z8JrmcWv,1017139,9693219,-8676080,302
2022-05-05 13:49:07-04:00,17671,5xkW7wHTcF5WadNtBBqKPKctVwyQtTqqscivAmxzseCk,7m31ZMZdCn5Gz2q5sETWA7uKA5LsKD7pJHBBqU3g7tCn,True,414980872,103745218,309793,154896,154897,YQC4EUcgeBi9431viwvzvBbZJW3szeHX4dFmowRDyDw,12391752,56575829,-44184077,298
2022-05-05 13:49:13-04:00,17672,7tFD53kPTqrzjCu1Wji78gUqhoRtCUhsP1pM3DQKT7uG,BJvgPLYBDJrQJdQVowrsMwUGMurq4zTihoFwWoEokfu3,True,15897338599,2199484002,6619910,3309955,3309955,3zqXX6kzhkbW3d4TwD2CNjMRwxTbREXySekvq37kfCNk,478471161,1817074482,-1338603321,300
2022-05-05 13:49:13-04:00,17673,4ZF1wtHKAnxmEZGACgbgphHvuo5aK4wC4MCNJzLYVkMX,5UXyhRP3Rjsc1RbV8BouJVQoTbWWbuPtVJY15KcHJFCN,True,419032998,104758249,314049,157024,157025,5HnvdJnCCcmRsm4GkXnYWd4q9RpwuvYDGEUMPkYR3Ts9,12561966,103499401,-90937435,299
2022-05-05 13:49:15-04:00,17674,BmFSXZx3HWaTtD7vp7AkUk5DUNjwK1qgLPod13EJz6No,DtLMfV3Xs7AAAQqC1PwL7YAfV6fig8yAMxr9MMxmyCKc,True,169939950,42484987,125742,62871,62871,gjBMZYVujDjD1ECG4i97M8Q3gV9ESnwwTSUGropkusj,5029708,20255169,-15225461,295
2022-05-05 13:49:39-04:00,17675,Hgs1Lk2ESxULpgcbgayhLdHSDyw5Yr6RiNYhP8q9CHwC,42prjFMA3G8DGZxkgXRDupGkz9GFSxB2mu1ccnEqPhjv,True,134916318,33729079,101996,50998,50998,68sueyVfmy5ToEGtLFGDkwebX47xAmzyXE29z8JrmcWv,4079848,18123042,-14043194,302
2022-05-05 13:50:10-04:00,17676,FtF3PVw8YNJseWPMcA2GEuQZ6nni1mq5kYPa2LrSzfkW,4yr1TM2dXrBvLNMpSaoryuGU2P8D3WG1ZCkvVzWFiQRH,True,23184506,1157843,5322,2661,2661,2a35JJeTUW1pm6M3e8DHCjp8qr4vbc2cRPhuzZWyFzYd,1065800,13453703,-12387903,459
2022-05-05 13:50:10-04:00,17677,CDVtXFbo4Rg2aHsXKv5P3uRJq9ZTgsRd7GXPTxgH5xv9,6zj37qQnaiJT7xGEZmSKx5yQvisQFcs5KhGsG43SGd5y,True,362085732,37778382,126904,63452,63452,Hu94aiQWvce6THeGyCFqGRPM1pQrK3ihzkcXo1EpJcJL,12163179,114689223,-102526044,335
2022-05-05 13:50:12-04:00,17678,87yYQuRW91LAqEmqEyYah7obsr4KijRrqsKdK7DGA9w,EJzredSumMNBMTYxMMHocKayWKg3A3621QJ3ArJqro8r,True,353725120,88431280,265992,132996,132996,C4UnXuShCvjSMgBAgVNMy1oakxCNk1et27A82fywU112,10639685,85764222,-75124537,300
2022-05-05 13:50:19-04:00,17679,9XmuJX8mFX29c5uh68kK7ff1mPdvs1orJAgEP6BsVKnq,HfPpizwUoK6uEmMb9LWi464BnvjHQY9cuPppFMp1DKDA,True,648798053,162199513,489780,244890,244890,2py1FiYeL2f7J3HU36qiJz6TD6HCmiTN36RyxYtapQCZ,19591225,53559960,-33968735,301
2022-05-05 13:50:33-04:00,17680,9ZyfJ3h3FBWxiFxQRNKb376GTeHUfagdqLkGH6gd8qtm,5hFfXHM23QzxHTE6YXvbaJFBQdLpPwX2Ex5N679V1JTw,True,14127466481,1391234062,8952287,4476143,4476144,68sueyVfmy5ToEGtLFGDkwebX47xAmzyXE29z8JrmcWv,909071681,2879371952,-1970300271,643
2022-05-05 13:50:55-04:00,17681,68zbVKnneMQqngbNkeLtPEP2ayNhawc1B2hPgqAEqgXK,HqiFpLr4NC7xJz9bEFusq8bCKaoxAQG1xsLxdUAzg8aa,True,192304292,9178046,37912,18956,18956,Hu94aiQWvce6THeGyCFqGRPM1pQrK3ihzkcXo1EpJcJL,7943636,87647982,-79704346,413
2022-05-05 13:56:07-04:00,17682,HqtTbC1LFreGvgfpZe7nCqkNnh8GHPQKosfmc19zb1yi,E39UNiHNkwQEd5GXkCtTPqSorQSB1kLx8kjzK4jdFoi3,True,1136903575,284225893,859647,429823,429824,DQCvC9mR68hJ3tJsUiddh6JwcBJAmntqGJR2nUsEq7yj,34385882,163139883,-128754001,302
2022-05-05 13:56:07-04:00,17683,5zqXqEjg95BnghcVbHRhYkSTYnzZjUBichgccv1BpS3d,9SuqSxrKpHh9NcNePe4Q3jXvpCmhNnoQv8YAFih3CqMX,True,3350831504,837707876,2531392,1265696,1265696,6UQfSsLooL4pQKQfLtXCutQS2BnF7A7F7ewJopDLmUpc,101255688,838385598,-737129910,302
2022-05-05 13:56:10-04:00,17684,E3LF7ohKS87kHLW78ViuRuyw7EMuiW3nVn5PRdhU7iBj,DMVXNy2NLb8jMuznjx2syKqvzctrNmQ3PfiUA83CeQR4,True,520781722,130195430,383433,191716,191717,A2p75MbAbeUdHkPLkAjgGeiwuu9WPrkMHzjCkDXF1Xr3,15337325,130175638,-114838313,294
2022-05-05 13:56:13-04:00,17685,BjCNaM7YbE9SjFi7tzi4677zg1fKXGJwtecz2GWwWuhd,6rNsSrKZezQrLb2whToNjnizpnurDXrobHqfEK3QqU1M,True,42267963,5528169,25089,12544,12545,68sueyVfmy5ToEGtLFGDkwebX47xAmzyXE29z8JrmcWv,1918368,21244117,-19325749,453
2022-05-05 13:56:41-04:00,17686,B6Wc3euMqUf6QjzCqDtNeAEUM7MvADFaiReEq9VYH2Qg,2pzhsqXYd5u7h4xTN8bMS3GbicVnJ6KY3MQn7spSXroA,False,28709272,28709272,866725,43336,823389,68sueyVfmy5ToEGtLFGDkwebX47xAmzyXE29z8JrmcWv,866726,8364030,-7497304,301
2022-05-05 13:56:51-04:00,17687,FtF3PVw8YNJseWPMcA2GEuQZ6nni1mq5kYPa2LrSzfkW,4yr1TM2dXrBvLNMpSaoryuGU2P8D3WG1ZCkvVzWFiQRH,False,21955877,21955877,989689,49484,940205,68sueyVfmy5ToEGtLFGDkwebX47xAmzyXE29z8JrmcWv,989692,12570856,-11581164,450
2022-05-05 13:57:12-04:00,17688,GvSTkcR23Yo2or1Di39kGc6zPe9ynBvE3nGbVzWD2Nt3,3L1LohQaKuexSDvXToK8CkrHG5NfhrPC914asuLSSTze,True,38869594,9717398,29393,14696,14697,Hu94aiQWvce6THeGyCFqGRPM1pQrK3ihzkcXo1EpJcJL,1175739,9991385,-8815646,302
2022-05-05 13:57:17-04:00,17689,4TnEB3hdCiM8ZzHLyY9uC84K7Ri7N6KMXEaZDiG44m8C,2fnFP93pDobi9upuPxHTz3gYXwu4yfRxYiFf6d8EAcbD,False,13057202,13057202,395587,19779,375808,68sueyVfmy5ToEGtLFGDkwebX47xAmzyXE29z8JrmcWv,395587,3014074,-2618487,302
2022-05-05 13:58:38-04:00,17690,CDVtXFbo4Rg2aHsXKv5P3uRJq9ZTgsRd7GXPTxgH5xv9,6zj37qQnaiJT7xGEZmSKx5yQvisQFcs5KhGsG43SGd5y,True,323368302,32747757,112382,56191,56191,68sueyVfmy5ToEGtLFGDkwebX47xAmzyXE29z8JrmcWv,11097227,106030800,-94933573,343
2022-05-05 13:58:39-04:00,17691,BhhVhLVZkSd3aHDMd6ojTgtJtbgAdMCA9Xj8jL2GMXoL,G8HUQp2yGSw9T6it5ej91cqkd82naca8heji453g2jEH,True,240818971,29115152,133525,66762,66763,2a35JJeTUW1pm6M3e8DHCjp8qr4vbc2cRPhuzZWyFzYd,11044275,94482471,-83438196,458
2022-05-05 13:58:43-04:00,17692,69MG5oJ1EhRXG1NqiNu3H8dUyAzbJQBmkCGbBnVF8CmQ,EdEAnDujxBwoxX1wdMnFNWAbxv7SzhHv8F2z6dtUtT7M,False,12306341,12306341,371254,18562,352692,2a35JJeTUW1pm6M3e8DHCjp8qr4vbc2cRPhuzZWyFzYd,371254,2671025,-2299771,301
2022-05-05 13:58:56-04:00,17693,AggAFLRnGWU7X97a3sWRKV7wDDRiAGn9Q4azmEYXAo1k,Dj4DzvpxgQiRoad1zTXoNTrgGTDHG9NvMeCzzRZSxkvs,True,426744796,41458212,176250,88125,88125,68sueyVfmy5ToEGtLFGDkwebX47xAmzyXE29z8JrmcWv,18142158,87211689,-69069531,425
2022-05-05 14:00:16-04:00,17694,68zbVKnneMQqngbNkeLtPEP2ayNhawc1B2hPgqAEqgXK,HqiFpLr4NC7xJz9bEFusq8bCKaoxAQG1xsLxdUAzg8aa,True,182580643,16392886,65951,32975,32976,68sueyVfmy5ToEGtLFGDkwebX47xAmzyXE29z8JrmcWv,7345574,82695824,-75350250,402
2022-05-05 14:02:34-04:00,17695,DZnaFtxiEHUv3geRGsKufTnCUhkSMbN2M7W4Bwu2LgkM,A38xXBMxA13qQnVB1tcd5USxpfdaUGmkp31FeTmCyb52,True,45863416,6332096,44221,22110,22111,C4UnXuShCvjSMgBAgVNMy1oakxCNk1et27A82fywU112,3203026,26628045,-23425019,698
2022-05-05 14:02:44-04:00,17696,7tFD53kPTqrzjCu1Wji78gUqhoRtCUhsP1pM3DQKT7uG,BJvgPLYBDJrQJdQVowrsMwUGMurq4zTihoFwWoEokfu3,True,13639096281,1762467359,5314599,2657299,2657300,GXyFXZMNk2NFyEzw6JetVqsujqcz2yCixH7n8EpDJYWD,411277617,1645651202,-1234373585,301
2022-05-05 14:03:39-04:00,17697,BjCNaM7YbE9SjFi7tzi4677zg1fKXGJwtecz2GWwWuhd,6rNsSrKZezQrLb2whToNjnizpnurDXrobHqfEK3QqU1M,True,36605321,2534725,12150,6075,6075,2a35JJeTUW1pm6M3e8DHCjp8qr4vbc2cRPhuzZWyFzYd,1754748,19082360,-17327612,479
2022-05-05 14:03:39-04:00,17698,5xkW7wHTcF5WadNtBBqKPKctVwyQtTqqscivAmxzseCk,7m31ZMZdCn5Gz2q5sETWA7uKA5LsKD7pJHBBqU3g7tCn,True,308272659,77068164,226822,113411,113411,5HnvdJnCCcmRsm4GkXnYWd4q9RpwuvYDGEUMPkYR3Ts9,9072919,45175553,-36102634,294
2022-05-05 14:06:06-04:00,17699,gCNpMXEHPTLvMvyyaYCLJrd8RRGnKAHz7sBD5j7yyBt,9cRU1ZAZRT5Ei4YAmCrPJZMHGsWspcYXTuZH58iexwDv,True,887258761,221814690,663753,331876,331877,2a35JJeTUW1pm6M3e8DHCjp8qr4vbc2cRPhuzZWyFzYd,26550125,106752281,-80202156,299
2022-05-05 14:06:06-04:00,17700,BmFSXZx3HWaTtD7vp7AkUk5DUNjwK1qgLPod13EJz6No,DtLMfV3Xs7AAAQqC1PwL7YAfV6fig8yAMxr9MMxmyCKc,True,126372102,31593025,95055,47527,47528,2a35JJeTUW1pm6M3e8DHCjp8qr4vbc2cRPhuzZWyFzYd,3802228,16304446,-12502218,300
2022-05-05 14:06:06-04:00,17701,CDVtXFbo4Rg2aHsXKv5P3uRJq9ZTgsRd7GXPTxgH5xv9,6zj37qQnaiJT7xGEZmSKx5yQvisQFcs5KhGsG43SGd5y,True,289730591,28170774,97853,48926,48927,Hu94aiQWvce6THeGyCFqGRPM1pQrK3ihzkcXo1EpJcJL,10064095,91290804,-81226709,347
2022-05-05 14:06:08-04:00,17702,HCAGpyYM2NYudMd55Geta13tUbS6eiygnJY5ULHsHAVa,3PPyWhqXrmifWPieLV34bZ1rzi8eEnrDDAF7ifXkXspn,True,251265597,41162865,234892,117446,117446,Hu94aiQWvce6THeGyCFqGRPM1pQrK3ihzkcXo1EpJcJL,14338319,74585709,-60247390,570
2022-05-05 14:06:18-04:00,17703,GsfMt94sB6ATRG3sqN1hxGNoqVbX7U92XoCDxBQ1jfjh,AEwLnKbHYb4eWTPAiXKx56jxStSwCJ3pxhkhfWmjUMAq,False,8783308,8783308,266108,13305,252803,5HnvdJnCCcmRsm4GkXnYWd4q9RpwuvYDGEUMPkYR3Ts9,266109,1857804,-1591695,302
2022-05-05 14:06:19-04:00,17704,4ZF1wtHKAnxmEZGACgbgphHvuo5aK4wC4MCNJzLYVkMX,5UXyhRP3Rjsc1RbV8BouJVQoTbWWbuPtVJY15KcHJFCN,True,311459584,77864896,234655,117327,117328,Hu94aiQWvce6THeGyCFqGRPM1pQrK3ihzkcXo1EpJcJL,9386206,80406221,-71020015,301
2022-05-05 14:06:20-04:00,17705,3pRKRd4i6jepz5HPbSsSFj2YKwYBjgVAk2v7ZMBYZVNR,Fzf7Gx6KJam5A1eny5G49cRS2zZHFt7XMxCx8N1Ej2Jd,True,507900874,126975218,384604,192302,192302,A2p75MbAbeUdHkPLkAjgGeiwuu9WPrkMHzjCkDXF1Xr3,15384177,129635245,-114251068,302
2022-05-05 14:06:22-04:00,17706,68zbVKnneMQqngbNkeLtPEP2ayNhawc1B2hPgqAEqgXK,HqiFpLr4NC7xJz9bEFusq8bCKaoxAQG1xsLxdUAzg8aa,True,165740403,15097488,62203,31101,31102,5HnvdJnCCcmRsm4GkXnYWd4q9RpwuvYDGEUMPkYR3Ts9,6828726,73543325,-66714599,412
2022-05-05 14:06:23-04:00,17707,AQr9mVmcXCNQhBVCfx63MwR6c4WqDSC9K2BZqr7N8LCx,CB7TWUaL381ounsLw6neAUaKRxJL9P1HC9uGX5e1Uxod,False,19020892,19020892,945602,47280,898322,68sueyVfmy5ToEGtLFGDkwebX47xAmzyXE29z8JrmcWv,945604,8277360,-7331756,497
2022-05-05 14:06:29-04:00,17708,9ZyfJ3h3FBWxiFxQRNKb376GTeHUfagdqLkGH6gd8qtm,5hFfXHM23QzxHTE6YXvbaJFBQdLpPwX2Ex5N679V1JTw,True,12653670444,1376049850,8876282,4438141,4438141,A2p75MbAbeUdHkPLkAjgGeiwuu9WPrkMHzjCkDXF1Xr3,816231760,2667897488,-1851665728,645
2022-05-05 14:06:47-04:00,17709,26wo1RqwKXrNnfgMdZEmkGhnDbURpZcp2hasB5EA5QtD,34gwTVGRrdoaBzLUG6SBwRwBovkjBjCebqVUBan6GDnB,True,4715789997,1178947499,8017246,4008623,4008623,2xTUy2RS74GJMMDnmFaegMzFLn19RVfYG4CibhBmjP1i,320689863,2506019866,-2185330003,680
2022-05-05 14:06:51-04:00,17710,Eps7NSYQhiSzaTpTLzx5aoDykXSKtQ6w1JBFuucC8hQp,EeNkTwr26mYEBqYHqoHaBZfybPS2PwcbJsgmQGJY6g89,True,513036310,128259077,388008,194004,194004,3zqXX6kzhkbW3d4TwD2CNjMRwxTbREXySekvq37kfCNk,15520338,129571837,-114051499,302
2022-05-05 14:07:14-04:00,17711,Hgs1Lk2ESxULpgcbgayhLdHSDyw5Yr6RiNYhP8q9CHwC,42prjFMA3G8DGZxkgXRDupGkz9GFSxB2mu1ccnEqPhjv,True,100260932,25065233,75913,37956,37957,68sueyVfmy5ToEGtLFGDkwebX47xAmzyXE29z8JrmcWv,3036554,14495424,-11458870,302
2022-05-05 14:11:16-04:00,17712,7cZhiH7iRxUVTL8x3jnbyj7nDoiEDK2oau86vBa8gfrZ,37BuBSA8thTnab7piguETKrE649E2GPAiiZvLVpkXp5B,False,1556083,1556083,46405,2320,44085,Hu94aiQWvce6THeGyCFqGRPM1pQrK3ihzkcXo1EpJcJL,46405,987824,-941419,298
2022-05-05 14:11:21-04:00,17713,A7j77tzgnQVGtHTa65VtVZqJRYeJvQk7am8NW6e66379,4vJGwEvXU2tGWoWWGwbsYcfKQAMCHbrBMRk4ZVFzneLs,True,56962697474,14240674368,42462000,21231000,21231000,2xTUy2RS74GJMMDnmFaegMzFLn19RVfYG4CibhBmjP1i,1698480005,7804041479,-6105561474,298
2022-05-05 14:11:21-04:00,17714,GpDhvRRae2uiRZ6MnJYnVR2hANNLGFGUDnsQmGjfK8AP,B2pgJ4gPdgzvx2HMJ1wagtthpZebtBk7RD3cF1zqSyT8,True,2027219260,506804815,1455018,727509,727509,68sueyVfmy5ToEGtLFGDkwebX47xAmzyXE29z8JrmcWv,58200745,550893282,-492692537,287
2022-05-05 14:11:23-04:00,17715,87yYQuRW91LAqEmqEyYah7obsr4KijRrqsKdK7DGA9w,EJzredSumMNBMTYxMMHocKayWKg3A3621QJ3ArJqro8r,True,262574094,65643523,190364,95182,95182,68sueyVfmy5ToEGtLFGDkwebX47xAmzyXE29z8JrmcWv,7614576,66678986,-59064410,289
2022-05-05 14:11:27-04:00,17716,9XmuJX8mFX29c5uh68kK7ff1mPdvs1orJAgEP6BsVKnq,HfPpizwUoK6uEmMb9LWi464BnvjHQY9cuPppFMp1DKDA,True,481659938,120414984,352265,176132,176133,C4UnXuShCvjSMgBAgVNMy1oakxCNk1et27A82fywU112,14090614,44509448,-30418834,292
2022-05-05 14:11:27-04:00,17717,CnNbPk9YL7y2PiqMfVvS1789stfDA7ZDk3sArJSw6FwP,9oamN33gGnx3tU9Mnn53yhi6F2Du5AAaSV6uAi69rbib,True,534177186,133544296,380499,190249,190250,C4UnXuShCvjSMgBAgVNMy1oakxCNk1et27A82fywU112,15219976,135945160,-120725184,284
2022-05-05 14:11:38-04:00,17718,BhhVhLVZkSd3aHDMd6ojTgtJtbgAdMCA9Xj8jL2GMXoL,G8HUQp2yGSw9T6it5ej91cqkd82naca8heji453g2jEH,True,209933927,21586550,93807,46903,46904,68sueyVfmy5ToEGtLFGDkwebX47xAmzyXE29z8JrmcWv,9122995,87928956,-78805961,434
2022-05-05 14:11:56-04:00,17719,BjCNaM7YbE9SjFi7tzi4677zg1fKXGJwtecz2GWwWuhd,6rNsSrKZezQrLb2whToNjnizpnurDXrobHqfEK3QqU1M,True,33903815,2472744,11492,5746,5746,Hu94aiQWvce6THeGyCFqGRPM1pQrK3ihzkcXo1EpJcJL,1575817,18256156,-16680339,464
2022-05-05 14:12:04-04:00,17720,1EH82ta3wXUyUwW8VWQnVzSG3r1rHcSj2DvDeTKmp3F,B6aMfucYPbCzWBtauLtgTpwR45wKSK8yqscHJR3F5usu,True,829901363,207475340,616924,308462,308462,GXyFXZMNk2NFyEzw6JetVqsujqcz2yCixH7n8EpDJYWD,24676990,50872539,-26195549,297
2022-05-05 14:12:07-04:00,17721,5zqXqEjg95BnghcVbHRhYkSTYnzZjUBichgccv1BpS3d,9SuqSxrKpHh9NcNePe4Q3jXvpCmhNnoQv8YAFih3CqMX,True,2490174646,622543661,1885034,942517,942517,2xTUy2RS74GJMMDnmFaegMzFLn19RVfYG4CibhBmjP1i,75401371,651311723,-575910352,302
2022-05-05 14:12:08-04:00,17722,E3LF7ohKS87kHLW78ViuRuyw7EMuiW3nVn5PRdhU7iBj,DMVXNy2NLb8jMuznjx2syKqvzctrNmQ3PfiUA83CeQR4,True,387313583,96828395,290575,145287,145288,68sueyVfmy5ToEGtLFGDkwebX47xAmzyXE29z8JrmcWv,11623019,101027218,-89404199,300
2022-05-05 14:12:10-04:00,17723,HqtTbC1LFreGvgfpZe7nCqkNnh8GHPQKosfmc19zb1yi,E39UNiHNkwQEd5GXkCtTPqSorQSB1kLx8kjzK4jdFoi3,True,844699427,211174856,635528,317764,317764,2xTUy2RS74GJMMDnmFaegMzFLn19RVfYG4CibhBmjP1i,25421124,129976849,-104555725,300
2022-05-05 14:13:13-04:00,17724,68zbVKnneMQqngbNkeLtPEP2ayNhawc1B2hPgqAEqgXK,HqiFpLr4NC7xJz9bEFusq8bCKaoxAQG1xsLxdUAzg8aa,True,150205329,7139272,30081,15040,15041,5HnvdJnCCcmRsm4GkXnYWd4q9RpwuvYDGEUMPkYR3Ts9,6328937,69671561,-63342624,421
2022-05-05 14:13:23-04:00,17725,CDVtXFbo4Rg2aHsXKv5P3uRJq9ZTgsRd7GXPTxgH5xv9,6zj37qQnaiJT7xGEZmSKx5yQvisQFcs5KhGsG43SGd5y,True,260715049,24341821,85162,42581,42581,Hu94aiQWvce6THeGyCFqGRPM1pQrK3ihzkcXo1EpJcJL,9121474,84630903,-75509429,349
2022-05-05 14:13:26-04:00,17726,GvSTkcR23Yo2or1Di39kGc6zPe9ynBvE3nGbVzWD2Nt3,3L1LohQaKuexSDvXToK8CkrHG5NfhrPC914asuLSSTze,False,28883929,28883929,873736,43686,830050,Hu94aiQWvce6THeGyCFqGRPM1pQrK3ihzkcXo1EpJcJL,873736,7753754,-6880018,302
2022-05-05 14:13:26-04:00,17727,7tFD53kPTqrzjCu1Wji78gUqhoRtCUhsP1pM3DQKT7uG,BJvgPLYBDJrQJdQVowrsMwUGMurq4zTihoFwWoEokfu3,True,11825204298,1645147671,4932413,2466206,2466207,2py1FiYeL2f7J3HU36qiJz6TD6HCmiTN36RyxYtapQCZ,354538394,1457755613,-1103217219,299
2022-05-05 14:14:18-04:00,17728,AsRi72uQLsBnyQxMBnPEhyQNM7XyNk2RV9GzPMe8PysA,9MqsYTBn6P9zCi5bGCrZurWWysW8XQZJwndHsb227rEW,True,611333845,152833461,450572,225286,225286,3zqXX6kzhkbW3d4TwD2CNjMRwxTbREXySekvq37kfCNk,18022912,159133906,-141110994,294
2022-05-05 14:24:15-04:00,17729,HJ9xavBvosqusXkhsuQNtaKZfWo7wsuNW4v61NmuTpup,Dw4VWUv2B3wsSxsY3U2fAad7ewokgjiFPzigXRDTTDqa,False,25612737,25612737,690245,34512,655733,Hu94aiQWvce6THeGyCFqGRPM1pQrK3ihzkcXo1EpJcJL,690246,3850379,-3160133,269
2022-05-05 14:24:16-04:00,17730,GPeALajYLrgVJgYb65PQUkFJxzeh4APUesZjy77sMy9j,Hnmv48N2jFXN2TYmyPxTsZf9JtnRoz2PfMEzL67UigXx,False,37666218,37666218,929096,46454,882642,Hu94aiQWvce6THeGyCFqGRPM1pQrK3ihzkcXo1EpJcJL,929096,7172197,-6243101,246
2022-05-05 14:24:16-04:00,17731,68gVM4kjmSYxT1uJW13rYSway8uVLUdcLa7sJuqHQaAf,DshroBQ3da7BcAiQpiFREsLKWbUDrBRmmZRw3Zu2Qfs9,True,7848806359,1962201589,5032421,2516210,2516211,A9TwRM1BMxqb8DCC7YNAMV6zPenEJm3HTZBy7wJKK58U,201296851,993385983,-792089132,256
2022-05-05 14:24:18-04:00,17732,9RtNbEZ4ZR8T1HFF4cujPVy2kejVBKFo3CPQi8psSa1q,7zwaGb71jKc9y2HKCKy5q2XV2YUphkyU1hkDaab1GBas,True,1157040546,287190661,714084,357042,357042,3zqXX6kzhkbW3d4TwD2CNjMRwxTbREXySekvq37kfCNk,28769228,341625237,-312856009,248
2022-05-05 14:24:19-04:00,17733,CDVtXFbo4Rg2aHsXKv5P3uRJq9ZTgsRd7GXPTxgH5xv9,6zj37qQnaiJT7xGEZmSKx5yQvisQFcs5KhGsG43SGd5y,True,235490143,20974090,72617,36308,36309,5HnvdJnCCcmRsm4GkXnYWd4q9RpwuvYDGEUMPkYR3Ts9,8153227,73379040,-65225813,346
2022-05-05 14:24:20-04:00,17734,FRbeFwhUYCiHW5oP26mad8KND7CCYDbfnoNxX7GuXVp8,GrzXKxPX2WDka8i2D8sunMUsrsThKasQi8NYLwuCGygV,True,3738207822,645021494,2483878,1241939,1241939,GXyFXZMNk2NFyEzw6JetVqsujqcz2yCixH7n8EpDJYWD,143952642,1122039232,-978086590,385
2022-05-05 14:24:20-04:00,17735,7frvVhg1eWJpsvG7ndjppb8Bmd1tFq5H1g26UiKZxqTP,3Ugo9b53e6e8PLnvKjqRP8pvvoubSPV6qiKtxey7mrGt,True,199087820,49771955,138192,69096,69096,gjBMZYVujDjD1ECG4i97M8Q3gV9ESnwwTSUGropkusj,5527717,53022627,-47494910,277
2022-05-05 14:24:20-04:00,17736,68zbVKnneMQqngbNkeLtPEP2ayNhawc1B2hPgqAEqgXK,HqiFpLr4NC7xJz9bEFusq8bCKaoxAQG1xsLxdUAzg8aa,True,142470112,6870036,27499,13749,13750,C4UnXuShCvjSMgBAgVNMy1oakxCNk1et27A82fywU112,5702911,67239565,-61536654,400
2022-05-05 14:24:20-04:00,17737,7zDNgPFeomS1hdQhuY8iGF3nnGMNnx1YrinZJetrefje,AKyG5R6Bac6Fu83ruL9FGpjKCfDKxbP6QfEGbCgqegiV,True,46476741,11619185,27280,13640,13640,3zqXX6kzhkbW3d4TwD2CNjMRwxTbREXySekvq37kfCNk,1091272,6356424,-5265152,234
2022-05-05 14:24:22-04:00,17738,BePQMfbkFe8vQ54rFkkf2dzXunPq2Xwpibrm1JVzSHLz,8R6rnjVUnMGUxx5sRjnuuyEnfyBGeet7y2jSJwVswyT3,True,140810735955,21744245239,65352153,32676076,32676077,2xTUy2RS74GJMMDnmFaegMzFLn19RVfYG4CibhBmjP1i,4232055311,15454822863,-11222767552,300
2022-05-05 14:24:22-04:00,17739,AggAFLRnGWU7X97a3sWRKV7wDDRiAGn9Q4azmEYXAo1k,Dj4DzvpxgQiRoad1zTXoNTrgGTDHG9NvMeCzzRZSxkvs,True,382473114,64484658,254781,127390,127391,Hu94aiQWvce6THeGyCFqGRPM1pQrK3ihzkcXo1EpJcJL,15111653,75364903,-60253250,395
2022-05-05 14:24:22-04:00,17740,DZnaFtxiEHUv3geRGsKufTnCUhkSMbN2M7W4Bwu2LgkM,A38xXBMxA13qQnVB1tcd5USxpfdaUGmkp31FeTmCyb52,True,39023107,5063516,34392,17196,17196,2a35JJeTUW1pm6M3e8DHCjp8qr4vbc2cRPhuzZWyFzYd,2650592,22640567,-19989975,679
2022-05-05 14:24:22-04:00,17741,CKK8bNCGjTn8qR6JoY5woqo2rrQHPMRawDGNfDsrg4Zd,46jXZ7r4uPrHnRJsnRnXHdDWjjjAbi8smmHbxxLhuwVg,True,156490773,39122693,105384,52692,52692,3zqXX6kzhkbW3d4TwD2CNjMRwxTbREXySekvq37kfCNk,4215382,7808744,-3593362,269
2022-05-05 14:24:22-04:00,17742,EdCSJVDrgnE7PN9GK7t1t7hB79mBrJzyy1mMZL9u5nvM,GTy9uEWcCx4odtr1GLPpntNbdR7wJRYr3wE9P5rAaMw6,True,171159032,42789758,125443,62721,62722,C4UnXuShCvjSMgBAgVNMy1oakxCNk1et27A82fywU112,5017735,18192713,-13174978,293
2022-05-05 14:24:22-04:00,17743,9RtNbEZ4ZR8T1HFF4cujPVy2kejVBKFo3CPQi8psSa1q,7zwaGb71jKc9y2HKCKy5q2XV2YUphkyU1hkDaab1GBas,True,868062135,214946089,650421,325210,325211,A9TwRM1BMxqb8DCC7YNAMV6zPenEJm3HTZBy7wJKK58U,26267394,263088793,-236821399,302
2022-05-05 14:24:26-04:00,17744,4oMasDRj8HWfknmdwt6Mkz3eonr8J2byoiSTRo4sCnFQ,3emcATkEFvDVETiK97eVET2Z2jzkgiiSxX3gu5wsUKPe,True,31930819932,3796173538,25041481,12520740,12520741,A2p75MbAbeUdHkPLkAjgGeiwuu9WPrkMHzjCkDXF1Xr3,2106318485,7184579633,-5078261148,659
2022-05-05 14:24:26-04:00,17745,DZnaFtxiEHUv3geRGsKufTnCUhkSMbN2M7W4Bwu2LgkM,A38xXBMxA13qQnVB1tcd5USxpfdaUGmkp31FeTmCyb52,True,33729893,4675585,33081,16540,16541,Hu94aiQWvce6THeGyCFqGRPM1pQrK3ihzkcXo1EpJcJL,2386502,20623068,-18236566,707
2022-05-05 14:24:28-04:00,17746,GpDhvRRae2uiRZ6MnJYnVR2hANNLGFGUDnsQmGjfK8AP,B2pgJ4gPdgzvx2HMJ1wagtthpZebtBk7RD3cF1zqSyT8,True,1509095216,377273804,1135662,567831,567831,C4UnXuShCvjSMgBAgVNMy1oakxCNk1et27A82fywU112,45426498,426307786,-380881288,301
2022-05-05 14:24:28-04:00,17747,BjCNaM7YbE9SjFi7tzi4677zg1fKXGJwtecz2GWwWuhd,6rNsSrKZezQrLb2whToNjnizpnurDXrobHqfEK3QqU1M,True,31265156,4086897,18279,9139,9140,C4UnXuShCvjSMgBAgVNMy1oakxCNk1et27A82fywU112,1398410,16328551,-14930141,447
2022-05-05 14:24:28-04:00,17748,7tFD53kPTqrzjCu1Wji78gUqhoRtCUhsP1pM3DQKT7uG,BJvgPLYBDJrQJdQVowrsMwUGMurq4zTihoFwWoEokfu3,True,10131618774,1305200061,3879781,1939890,1939891,C4UnXuShCvjSMgBAgVNMy1oakxCNk1et27A82fywU112,301168128,1325675138,-1024507010,297
2022-05-05 14:24:28-04:00,17749,Eps7NSYQhiSzaTpTLzx5aoDykXSKtQ6w1JBFuucC8hQp,EeNkTwr26mYEBqYHqoHaBZfybPS2PwcbJsgmQGJY6g89,True,380769431,95192357,278113,139056,139057,C4UnXuShCvjSMgBAgVNMy1oakxCNk1et27A82fywU112,11124528,100673637,-89549109,292
2022-05-05 14:24:28-04:00,17750,gCNpMXEHPTLvMvyyaYCLJrd8RRGnKAHz7sBD5j7yyBt,9cRU1ZAZRT5Ei4YAmCrPJZMHGsWspcYXTuZH58iexwDv,True,657890114,164472528,458310,229155,229155,C4UnXuShCvjSMgBAgVNMy1oakxCNk1et27A82fywU112,18332415,86045144,-67712729,278
2022-05-05 14:24:29-04:00,17751,DLwEaZipqHmVBD5hc5v1NZtDStHyG4hAMwxywDTGGc2e,28GtwJw67UWfrSKxtuvpzoKzPyKXLgP3GKLm3fHdR566,True,6567611896,1641902974,9577461,4788730,4788731,A2p75MbAbeUdHkPLkAjgGeiwuu9WPrkMHzjCkDXF1Xr3,383098456,899671084,-516572628,583
2022-05-05 14:24:29-04:00,17752,5QxR9QPTADFys9VQNm473RgprTikCXC23vhsBc9ojyAQ,H9zdf8nJ4JCF7jrwGsxiuiFoa14gzDmYsZ5N5ig3UGna,True,858239923,214559980,628251,314125,314126,A9TwRM1BMxqb8DCC7YNAMV6zPenEJm3HTZBy7wJKK58U,25130046,69829810,-44699764,292
2022-05-05 14:24:30-04:00,17753,CDVtXFbo4Rg2aHsXKv5P3uRJq9ZTgsRd7GXPTxgH5xv9,6zj37qQnaiJT7xGEZmSKx5yQvisQFcs5KhGsG43SGd5y,True,213582377,33856843,113291,56645,56646,2a35JJeTUW1pm6M3e8DHCjp8qr4vbc2cRPhuzZWyFzYd,7146934,68230675,-61083741,334
2022-05-05 14:24:31-04:00,17754,3pRKRd4i6jepz5HPbSsSFj2YKwYBjgVAk2v7ZMBYZVNR,Fzf7Gx6KJam5A1eny5G49cRS2zZHFt7XMxCx8N1Ej2Jd,True,376776391,94194097,271257,135628,135629,A9TwRM1BMxqb8DCC7YNAMV6zPenEJm3HTZBy7wJKK58U,10850308,100690509,-89840201,287
2022-05-05 14:24:33-04:00,17755,7zDNgPFeomS1hdQhuY8iGF3nnGMNnx1YrinZJetrefje,AKyG5R6Bac6Fu83ruL9FGpjKCfDKxbP6QfEGbCgqegiV,True,34827728,8540306,25359,12679,12680,3zqXX6kzhkbW3d4TwD2CNjMRwxTbREXySekvq37kfCNk,1034164,5012932,-3978768,296
2022-05-05 14:24:33-04:00,17756,BaFWQSYQQikWywyGiHgG25hEons9nW5zhvUTzp8oAcYU,7WyiB5TBMB49ctd4cZBExSJyD51JMYnokScjSWixoPdk,True,16770655,1219145,7669,3834,3835,C4UnXuShCvjSMgBAgVNMy1oakxCNk1et27A82fywU112,1055083,2733541,-1678458,629
2022-05-05 14:24:33-04:00,17757,68zbVKnneMQqngbNkeLtPEP2ayNhawc1B2hPgqAEqgXK,HqiFpLr4NC7xJz9bEFusq8bCKaoxAQG1xsLxdUAzg8aa,True,135026610,23340929,88192,44096,44096,C4UnXuShCvjSMgBAgVNMy1oakxCNk1et27A82fywU112,5101946,63523763,-58421817,377
2022-05-05 14:24:33-04:00,17758,4ZF1wtHKAnxmEZGACgbgphHvuo5aK4wC4MCNJzLYVkMX,5UXyhRP3Rjsc1RbV8BouJVQoTbWWbuPtVJY15KcHJFCN,True,231045425,57761356,165057,82528,82529,C4UnXuShCvjSMgBAgVNMy1oakxCNk1et27A82fywU112,6602288,62417556,-55815268,285
2022-05-05 14:24:38-04:00,17759,8DSiP9CwJm3AEcH6uuAYFpArRRDLYpDQgjHEvjkUgfg2,ERJ8kuhPRRmUAhSM4oxUheh39YUVVYNgaTt6AdMXcCvL,True,2086140213,521535053,1457979,728989,728990,2xTUy2RS74GJMMDnmFaegMzFLn19RVfYG4CibhBmjP1i,58319167,547549380,-489230213,279
2022-05-05 14:24:38-04:00,17760,BmFSXZx3HWaTtD7vp7AkUk5DUNjwK1qgLPod13EJz6No,DtLMfV3Xs7AAAQqC1PwL7YAfV6fig8yAMxr9MMxmyCKc,True,93696196,23424049,65607,32803,32804,47z82br5WdW2DZajdnPDPSSRRKsyAggqXqK6oPUwTaLf,2624292,13083983,-10459691,280
2022-05-05 14:24:38-04:00,17761,CnNbPk9YL7y2PiqMfVvS1789stfDA7ZDk3sArJSw6FwP,9oamN33gGnx3tU9Mnn53yhi6F2Du5AAaSV6uAi69rbib,True,397602935,99400733,295238,147619,147619,A2p75MbAbeUdHkPLkAjgGeiwuu9WPrkMHzjCkDXF1Xr3,11809522,105386287,-93576765,297
2022-05-05 14:24:38-04:00,17762,9ZyfJ3h3FBWxiFxQRNKb376GTeHUfagdqLkGH6gd8qtm,5hFfXHM23QzxHTE6YXvbaJFBQdLpPwX2Ex5N679V1JTw,True,11176044069,1031825604,6516087,3258043,3258044,A2p75MbAbeUdHkPLkAjgGeiwuu9WPrkMHzjCkDXF1Xr3,705778953,2547467987,-1841689034,631
2022-05-05 14:24:40-04:00,17763,87yYQuRW91LAqEmqEyYah7obsr4KijRrqsKdK7DGA9w,EJzredSumMNBMTYxMMHocKayWKg3A3621QJ3ArJqro8r,True,195417194,48854298,147770,73885,73885,C4UnXuShCvjSMgBAgVNMy1oakxCNk1et27A82fywU112,5910835,51723225,-45812390,302
2022-05-05 14:24:46-04:00,17764,BjCNaM7YbE9SjFi7tzi4677zg1fKXGJwtecz2GWwWuhd,6rNsSrKZezQrLb2whToNjnizpnurDXrobHqfEK3QqU1M,True,27068644,1867657,8765,4382,4383,47z82br5WdW2DZajdnPDPSSRRKsyAggqXqK6oPUwTaLf,1270516,14651583,-13381067,469
2022-05-05 14:24:46-04:00,17765,Hgs1Lk2ESxULpgcbgayhLdHSDyw5Yr6RiNYhP8q9CHwC,42prjFMA3G8DGZxkgXRDupGkz9GFSxB2mu1ccnEqPhjv,True,74341965,18585491,52672,26336,26336,2a35JJeTUW1pm6M3e8DHCjp8qr4vbc2cRPhuzZWyFzYd,2106907,11554888,-9447981,283
2022-05-05 14:24:47-04:00,17766,29JVska5UEG3axs63EmtHpPvkswNEqYpZ3PKMSfupiAG,DCftNBUsuogxyaJe9G9m3eWipH6o3qo4Rn4TuQXdVaBF,True,907297647,226824411,1334619,667309,667310,5HnvdJnCCcmRsm4GkXnYWd4q9RpwuvYDGEUMPkYR3Ts9,53384788,98230789,-44846001,588
2022-05-05 14:24:51-04:00,17767,5xkW7wHTcF5WadNtBBqKPKctVwyQtTqqscivAmxzseCk,7m31ZMZdCn5Gz2q5sETWA7uKA5LsKD7pJHBBqU3g7tCn,True,228334010,57083502,149390,74695,74695,C4UnXuShCvjSMgBAgVNMy1oakxCNk1et27A82fywU112,5975612,35923958,-29948346,261
2022-05-05 14:24:51-04:00,17768,BhhVhLVZkSd3aHDMd6ojTgtJtbgAdMCA9Xj8jL2GMXoL,G8HUQp2yGSw9T6it5ej91cqkd82naca8heji453g2jEH,True,186556658,16001679,62086,31043,31043,68sueyVfmy5ToEGtLFGDkwebX47xAmzyXE29z8JrmcWv,7238469,82783688,-75545219,388
2022-05-05 14:24:51-04:00,17769,AggAFLRnGWU7X97a3sWRKV7wDDRiAGn9Q4azmEYXAo1k,Dj4DzvpxgQiRoad1zTXoNTrgGTDHG9NvMeCzzRZSxkvs,True,316697900,30850929,132155,66077,66078,5HnvdJnCCcmRsm4GkXnYWd4q9RpwuvYDGEUMPkYR3Ts9,13566316,68732223,-55165907,428
2022-05-05 14:24:52-04:00,17770,9XmuJX8mFX29c5uh68kK7ff1mPdvs1orJAgEP6BsVKnq,HfPpizwUoK6uEmMb9LWi464BnvjHQY9cuPppFMp1DKDA,True,357858052,89464513,258786,129393,129393,A9TwRM1BMxqb8DCC7YNAMV6zPenEJm3HTZBy7wJKK58U,10351447,36554535,-26203088,289
2022-05-05 14:24:52-04:00,17771,DX6DNEePMPiHBVFX2rDuFoy1fznGYDx6bUQB6qL6UAAb,FM9PNZ9HFZNPZDmg5mQRuMo9t49kDJEHM2CuZmNo6TnD,True,11613656494,2903414123,8456725,4228362,4228363,A9TwRM1BMxqb8DCC7YNAMV6zPenEJm3HTZBy7wJKK58U,338269021,577329925,-239060904,291
2022-05-05 14:24:53-04:00,17772,A7j77tzgnQVGtHTa65VtVZqJRYeJvQk7am8NW6e66379,4vJGwEvXU2tGWoWWGwbsYcfKQAMCHbrBMRk4ZVFzneLs,True,42315048421,10578762105,31226083,15613041,15613042,Hu94aiQWvce6THeGyCFqGRPM1pQrK3ihzkcXo1EpJcJL,1249043320,6265186659,-5016143339,295
2022-05-05 14:24:55-04:00,17773,BaFWQSYQQikWywyGiHgG25hEons9nW5zhvUTzp8oAcYU,7WyiB5TBMB49ctd4cZBExSJyD51JMYnokScjSWixoPdk,True,15536791,1041478,6922,3461,3461,68sueyVfmy5ToEGtLFGDkwebX47xAmzyXE29z8JrmcWv,1032695,2526473,-1493778,664
2022-05-05 14:25:02-04:00,17774,1EH82ta3wXUyUwW8VWQnVzSG3r1rHcSj2DvDeTKmp3F,B6aMfucYPbCzWBtauLtgTpwR45wKSK8yqscHJR3F5usu,True,616739528,154184882,459339,229669,229670,C4UnXuShCvjSMgBAgVNMy1oakxCNk1et27A82fywU112,18373571,43712665,-25339094,297
2022-05-05 14:25:10-04:00,17775,5tW54mXQxtM7vGc91HrDeDtWkxJeH2uM4yAviqZnMZCN,7Kg5Zwx5afFdLbTifeyKJLSNVj2p9Xf5anbbqQozNzmY,True,1150925488,139434346,852446,426223,426223,A9TwRM1BMxqb8DCC7YNAMV6zPenEJm3HTZBy7wJKK58U,70363026,143740442,-73377416,611
2022-05-05 14:25:14-04:00,17776,7tFD53kPTqrzjCu1Wji78gUqhoRtCUhsP1pM3DQKT7uG,BJvgPLYBDJrQJdQVowrsMwUGMurq4zTihoFwWoEokfu3,True,8794339182,1222441443,3686487,1843243,1843244,Hu94aiQWvce6THeGyCFqGRPM1pQrK3ihzkcXo1EpJcJL,265208816,1168007663,-902798847,301
2022-05-05 14:25:16-04:00,17777,9pzwKSceogMgCeZjstNqHbiLHeQb4mzD4j9kSmNxbe8x,93AY1zEbBweMV2ur9A65vzmSb79Mkrr2Wi1XuLYijSm9,True,94452329,23613082,68640,34320,34320,Hu94aiQWvce6THeGyCFqGRPM1pQrK3ihzkcXo1EpJcJL,2745608,24091961,-21346353,290
2022-05-05 14:25:18-04:00,17778,HqtTbC1LFreGvgfpZe7nCqkNnh8GHPQKosfmc19zb1yi,E39UNiHNkwQEd5GXkCtTPqSorQSB1kLx8kjzK4jdFoi3,True,627689805,156922451,473770,236885,236885,68sueyVfmy5ToEGtLFGDkwebX47xAmzyXE29z8JrmcWv,18950830,103209091,-84258261,301
2022-05-05 14:25:20-04:00,17779,E3LF7ohKS87kHLW78ViuRuyw7EMuiW3nVn5PRdhU7iBj,DMVXNy2NLb8jMuznjx2syKqvzctrNmQ3PfiUA83CeQR4,True,287800388,71950097,216191,108095,108096,68sueyVfmy5ToEGtLFGDkwebX47xAmzyXE29z8JrmcWv,8647644,78387137,-69739493,300
2022-05-05 14:25:21-04:00,17780,aTkGURJptmKNNP6RSXSWsmVbfcriSAJaMuUiT2eZEfb,5qoGxL83PLhrguyk27X8xE6jGitRg5BaQpXzrcfEvCfJ,False,15985653,15985653,976215,48810,927405,C4UnXuShCvjSMgBAgVNMy1oakxCNk1et27A82fywU112,976215,5934636,-4958421,610
2022-05-05 14:25:23-04:00,17781,6pAs5S7zGX77DHSYUuCxvxbf2FQQHQhbBmAYLd3iJvWS,HNTWEhsrnEe8FeVDpEcxuoD5PnuveB5BwSf3gdBmhzxv,True,147435974,36858993,107931,53965,53966,Hu94aiQWvce6THeGyCFqGRPM1pQrK3ihzkcXo1EpJcJL,4317259,20098295,-15781036,292
2022-05-05 14:25:28-04:00,17782,4nj9fNW5K5hZebNaCP8PDTismTb5HK4MsJLUPLsnfN7P,B4UmvQqxb4Sc35L3YzuGR8BSQC2qKd6e4Byxni7ncYkf,True,277850431,69462607,203421,101710,101711,Hu94aiQWvce6THeGyCFqGRPM1pQrK3ihzkcXo1EpJcJL,8136871,33192085,-25055214,292
2022-05-05 14:26:16-04:00,17783,5zqXqEjg95BnghcVbHRhYkSTYnzZjUBichgccv1BpS3d,9SuqSxrKpHh9NcNePe4Q3jXvpCmhNnoQv8YAFih3CqMX,True,1850007198,462501799,1397313,698656,698657,68sueyVfmy5ToEGtLFGDkwebX47xAmzyXE29z8JrmcWv,55892550,505512902,-449620352,302
2022-05-05 14:26:26-04:00,17784,9ZyfJ3h3FBWxiFxQRNKb376GTeHUfagdqLkGH6gd8qtm,5hFfXHM23QzxHTE6YXvbaJFBQdLpPwX2Ex5N679V1JTw,True,10100883238,1025547375,6659663,3329831,3329832,2xTUy2RS74GJMMDnmFaegMzFLn19RVfYG4CibhBmjP1i,655927639,2377908598,-1721980959,649
2022-05-05 14:26:31-04:00,17785,26wo1RqwKXrNnfgMdZEmkGhnDbURpZcp2hasB5EA5QtD,34gwTVGRrdoaBzLUG6SBwRwBovkjBjCebqVUBan6GDnB,True,3468636970,867159242,6111677,3055838,3055839,C4UnXuShCvjSMgBAgVNMy1oakxCNk1et27A82fywU112,244467089,1953856282,-1709389193,704
2022-05-05 14:27:04-04:00,17786,HDmtdNjr3UNmzXfmajyKASLz9wz4YzNrspTMABcr7tXV,bsQ5Ae5oD7dbNjnz49unSovEp4eDGiB2bfdihVZkAtE,True,37771760,9442940,28348,14174,14174,68sueyVfmy5ToEGtLFGDkwebX47xAmzyXE29z8JrmcWv,1133935,3712284,-2578349,300
2022-05-05 14:29:13-04:00,17787,3Dc89y1Z6ViLFDoY3vwcJewSjMQam2mSTqPtpxsPZVz5,4NfXm5CTgNUTQd6NPj2hKwjMYDr7a8d5yVC9rV2uTcjA,True,597555883,149388970,1051776,525888,525888,A2p75MbAbeUdHkPLkAjgGeiwuu9WPrkMHzjCkDXF1Xr3,42071046,171721868,-129650822,704
2022-05-05 14:29:18-04:00,17788,SEndYVMCKAeZUKSqGrMUSqXFmxtA9M1t4eXsUhVsTBF,3fcQQcbkpqodakamn82pFnMxBEPL2Drsg4jJNZ6dx72M,True,290211178,21978717,138366,69183,69183,2a35JJeTUW1pm6M3e8DHCjp8qr4vbc2cRPhuzZWyFzYd,18270241,33923860,-15653619,629
2022-05-05 14:29:19-04:00,17789,DZnaFtxiEHUv3geRGsKufTnCUhkSMbN2M7W4Bwu2LgkM,A38xXBMxA13qQnVB1tcd5USxpfdaUGmkp31FeTmCyb52,True,28729572,3733618,26364,13182,13182,Hu94aiQWvce6THeGyCFqGRPM1pQrK3ihzkcXo1EpJcJL,2028685,17559016,-15530331,706
2022-05-05 14:29:24-04:00,17790,7qxGLMg6ZAxkVjhuj2PY6a5F36k4Efo3aCa99kvTpSKw,wgWcmEebBLbcm9a2jyCiw8nzqbGbfj6zRou4ZZhfWp7,True,166663237,31548103,181849,90924,90925,C4UnXuShCvjSMgBAgVNMy1oakxCNk1et27A82fywU112,9606809,28918547,-19311738,576
2022-05-05 14:29:58-04:00,17791,A5NXadGWnFZRoHEn1dKTRjcXgWmfMLMyJdpF4rQPZyRR,ALs3Zfotc4c4A6TFDMbd5GM5whK1dTYSnGrHiMBWmApH,True,9788539851,2447134962,7273126,3636563,3636563,GXyFXZMNk2NFyEzw6JetVqsujqcz2yCixH7n8EpDJYWD,290925075,487327198,-196402123,297
2022-05-05 14:40:39-04:00,17792,4oMasDRj8HWfknmdwt6Mkz3eonr8J2byoiSTRo4sCnFQ,3emcATkEFvDVETiK97eVET2Z2jzkgiiSxX3gu5wsUKPe,True,27896249219,4175646642,27585123,13792561,13792562,68sueyVfmy5ToEGtLFGDkwebX47xAmzyXE29z8JrmcWv,1842879829,6437982928,-4595103099,660
2022-05-05 15:05:40-04:00,17793,D8BtQirMEk3W9Pq29B6KkKWrwPfmsUNpwz5npx7aGMLY,J7LMZwaSoh5hbGcwee6oPsnN4ZFD7Zp3LQWkJGNUHRfJ,True,230360397,57590099,410739,205369,205370,3zqXX6kzhkbW3d4TwD2CNjMRwxTbREXySekvq37kfCNk,16429569,85951124,-69521555,713
2022-05-05 15:06:52-04:00,17794,DX6DNEePMPiHBVFX2rDuFoy1fznGYDx6bUQB6qL6UAAb,FM9PNZ9HFZNPZDmg5mQRuMo9t49kDJEHM2CuZmNo6TnD,True,8643447863,2160861965,6539718,3269859,3269859,AmTrMPzuTp2BjnjqGNKqz9FTTCdpoKcPAJLwFc8ozcbh,261588732,509356532,-247767800,302
2022-05-05 15:07:33-04:00,17795,9pzwKSceogMgCeZjstNqHbiLHeQb4mzD4j9kSmNxbe8x,93AY1zEbBweMV2ur9A65vzmSb79Mkrr2Wi1XuLYijSm9,True,70302580,17575645,53216,26608,26608,Hu94aiQWvce6THeGyCFqGRPM1pQrK3ihzkcXo1EpJcJL,2128669,18675235,-16546566,302
2022-05-05 15:07:37-04:00,17796,CDVtXFbo4Rg2aHsXKv5P3uRJq9ZTgsRd7GXPTxgH5xv9,6zj37qQnaiJT7xGEZmSKx5yQvisQFcs5KhGsG43SGd5y,True,179423817,6951215,26009,13004,13005,2a35JJeTUW1pm6M3e8DHCjp8qr4vbc2cRPhuzZWyFzYd,6713560,55786914,-49073354,374
2022-05-05 15:07:40-04:00,17797,6pAs5S7zGX77DHSYUuCxvxbf2FQQHQhbBmAYLd3iJvWS,HNTWEhsrnEe8FeVDpEcxuoD5PnuveB5BwSf3gdBmhzxv,True,109695312,27423828,82737,41368,41369,gjBMZYVujDjD1ECG4i97M8Q3gV9ESnwwTSUGropkusj,3309501,16027241,-12717740,301
2022-05-05 15:07:40-04:00,17798,3Dc89y1Z6ViLFDoY3vwcJewSjMQam2mSTqPtpxsPZVz5,4NfXm5CTgNUTQd6NPj2hKwjMYDr7a8d5yVC9rV2uTcjA,True,437625825,109406456,762078,381039,381039,C4UnXuShCvjSMgBAgVNMy1oakxCNk1et27A82fywU112,30483135,138300793,-107817658,696
2022-05-05 15:07:42-04:00,17799,HCAGpyYM2NYudMd55Geta13tUbS6eiygnJY5ULHsHAVa,3PPyWhqXrmifWPieLV34bZ1rzi8eEnrDDAF7ifXkXspn,True,207221790,30460455,164496,82248,82248,2a35JJeTUW1pm6M3e8DHCjp8qr4vbc2cRPhuzZWyFzYd,11190661,66922647,-55731986,540
2022-05-05 15:07:42-04:00,17800,4nj9fNW5K5hZebNaCP8PDTismTb5HK4MsJLUPLsnfN7P,B4UmvQqxb4Sc35L3YzuGR8BSQC2qKd6e4Byxni7ncYkf,True,206617444,51654361,153221,76610,76611,Hu94aiQWvce6THeGyCFqGRPM1pQrK3ihzkcXo1EpJcJL,6128848,26691666,-20562818,296
2022-05-05 15:07:46-04:00,17801,5tW54mXQxtM7vGc91HrDeDtWkxJeH2uM4yAviqZnMZCN,7Kg5Zwx5afFdLbTifeyKJLSNVj2p9Xf5anbbqQozNzmY,True,1004815965,104321842,650018,325009,325009,2py1FiYeL2f7J3HU36qiJz6TD6HCmiTN36RyxYtapQCZ,62609107,135248256,-72639149,623
2022-05-05 15:07:50-04:00,17802,7tFD53kPTqrzjCu1Wji78gUqhoRtCUhsP1pM3DQKT7uG,BJvgPLYBDJrQJdQVowrsMwUGMurq4zTihoFwWoEokfu3,True,7539301882,976021018,2949045,1474522,1474523,GXyFXZMNk2NFyEzw6JetVqsujqcz2yCixH7n8EpDJYWD,227799890,1056164993,-828365103,302
2022-05-05 15:07:59-04:00,17803,5FewDaMC9U7n5EHcto98GaAmDVxDh5SYimuTP6AtfakM,7DAULUoqV7f9hsBzKEhjQPnWaHSqiMWcBqWcdcadaQv4,True,3066226777,335697743,1488325,744162,744163,Hu94aiQWvce6THeGyCFqGRPM1pQrK3ihzkcXo1EpJcJL,135942082,225166232,-89224150,443
2022-05-05 15:08:34-04:00,17804,SEndYVMCKAeZUKSqGrMUSqXFmxtA9M1t4eXsUhVsTBF,3fcQQcbkpqodakamn82pFnMxBEPL2Drsg4jJNZ6dx72M,True,266548594,24215341,150760,75380,75380,Hu94aiQWvce6THeGyCFqGRPM1pQrK3ihzkcXo1EpJcJL,16594907,23689811,-7094904,622
2022-05-05 15:08:43-04:00,17805,64Diz8zzEv1jDWnBQPTHPpXwaWf7vjM19RyJmkPy1viQ,G8wkGHRHMtT3mvXBkH3zgsKNs8wbpdiPUS17y4cozhkZ,True,273855041,68463760,414387,207193,207194,2a35JJeTUW1pm6M3e8DHCjp8qr4vbc2cRPhuzZWyFzYd,16575511,33910820,-17335309,605
2022-05-05 15:08:44-04:00,17806,HDmtdNjr3UNmzXfmajyKASLz9wz4YzNrspTMABcr7tXV,bsQ5Ae5oD7dbNjnz49unSovEp4eDGiB2bfdihVZkAtE,False,28078461,28078461,850572,42528,808044,Hu94aiQWvce6THeGyCFqGRPM1pQrK3ihzkcXo1EpJcJL,850572,3034712,-2184140,302
2022-05-05 15:10:32-04:00,17807,7qxGLMg6ZAxkVjhuj2PY6a5F36k4Efo3aCa99kvTpSKw,wgWcmEebBLbcm9a2jyCiw8nzqbGbfj6zRou4ZZhfWp7,True,133122903,23177432,131497,65748,65749,2a35JJeTUW1pm6M3e8DHCjp8qr4vbc2cRPhuzZWyFzYd,7552782,22791168,-15238386,567
2022-05-05 15:15:41-04:00,17808,FRbeFwhUYCiHW5oP26mad8KND7CCYDbfnoNxX7GuXVp8,GrzXKxPX2WDka8i2D8sunMUsrsThKasQi8NYLwuCGygV,True,3081714755,286747601,1206521,603260,603261,6UQfSsLooL4pQKQfLtXCutQS2BnF7A7F7ewJopDLmUpc,129666537,974637135,-844970598,420
2022-05-05 15:18:00-04:00,17809,68gVM4kjmSYxT1uJW13rYSway8uVLUdcLa7sJuqHQaAf,DshroBQ3da7BcAiQpiFREsLKWbUDrBRmmZRw3Zu2Qfs9,True,5867660530,1466915132,4423178,2211589,2211589,gjBMZYVujDjD1ECG4i97M8Q3gV9ESnwwTSUGropkusj,176927149,792135502,-615208353,301
2022-05-05 15:18:11-04:00,17810,CDVtXFbo4Rg2aHsXKv5P3uRJq9ZTgsRd7GXPTxgH5xv9,6zj37qQnaiJT7xGEZmSKx5yQvisQFcs5KhGsG43SGd5y,True,172012138,13568679,49120,24560,24560,68sueyVfmy5ToEGtLFGDkwebX47xAmzyXE29z8JrmcWv,6227087,57712125,-51485038,362
2022-05-05 15:18:16-04:00,17811,CKK8bNCGjTn8qR6JoY5woqo2rrQHPMRawDGNfDsrg4Zd,46jXZ7r4uPrHnRJsnRnXHdDWjjjAbi8smmHbxxLhuwVg,True,116790117,29197529,88104,44052,44052,3zqXX6kzhkbW3d4TwD2CNjMRwxTbREXySekvq37kfCNk,3524190,6797988,-3273798,301
2022-05-05 15:18:23-04:00,17812,DZnaFtxiEHUv3geRGsKufTnCUhkSMbN2M7W4Bwu2LgkM,A38xXBMxA13qQnVB1tcd5USxpfdaUGmkp31FeTmCyb52,True,24699888,3370515,23286,11643,11643,2a35JJeTUW1pm6M3e8DHCjp8qr4vbc2cRPhuzZWyFzYd,1706542,15981572,-14275030,690
2022-05-05 15:18:58-04:00,17813,AsRi72uQLsBnyQxMBnPEhyQNM7XyNk2RV9GzPMe8PysA,9MqsYTBn6P9zCi5bGCrZurWWysW8XQZJwndHsb227rEW,True,454702634,113675658,342835,171417,171418,Hu94aiQWvce6THeGyCFqGRPM1pQrK3ihzkcXo1EpJcJL,13713429,123348274,-109634845,301
2022-05-05 15:18:58-04:00,17814,Fczxdc24Eav8xcaKRDwWMEwPEzkGyEJ7qGcXYyGZFKVz,8GqweYpec4cnpaJvueF3FGWoaz72BAzpLYXBX7tuuqEt,True,4155949236,1038987309,3143907,1571953,1571954,2xTUy2RS74GJMMDnmFaegMzFLn19RVfYG4CibhBmjP1i,125756298,2186103181,-2060346883,302
2022-05-05 15:18:59-04:00,17815,5xkW7wHTcF5WadNtBBqKPKctVwyQtTqqscivAmxzseCk,7m31ZMZdCn5Gz2q5sETWA7uKA5LsKD7pJHBBqU3g7tCn,True,170576118,42644029,128222,64111,64111,5HnvdJnCCcmRsm4GkXnYWd4q9RpwuvYDGEUMPkYR3Ts9,5128886,28265031,-23136145,300
2022-05-05 15:19:12-04:00,17816,DX6DNEePMPiHBVFX2rDuFoy1fznGYDx6bUQB6qL6UAAb,FM9PNZ9HFZNPZDmg5mQRuMo9t49kDJEHM2CuZmNo6TnD,True,6418880876,1604720219,4783599,2391799,2391800,GXyFXZMNk2NFyEzw6JetVqsujqcz2yCixH7n8EpDJYWD,191343992,441815208,-250471216,298
2022-05-05 15:19:12-04:00,17817,7tFD53kPTqrzjCu1Wji78gUqhoRtCUhsP1pM3DQKT7uG,BJvgPLYBDJrQJdQVowrsMwUGMurq4zTihoFwWoEokfu3,True,6528535091,901726847,2625747,1312873,1312874,AmTrMPzuTp2BjnjqGNKqz9FTTCdpoKcPAJLwFc8ozcbh,190105072,934884202,-744779130,291
2022-05-05 15:19:18-04:00,17818,52Fpixjd4WYTgHTJhMAjZM2WfK1FnvgTBvZnTAtdQS3,FuyHHnw7DJ5ywPedp3kvdNBrNJ2Beyou1VNaP3eeFkK6,False,8816137,8816137,263801,13190,250611,3zqXX6kzhkbW3d4TwD2CNjMRwxTbREXySekvq37kfCNk,263801,1399873,-1136072,299
2022-05-05 20:54:44-04:00,17819,5nALef7nAfNkSQSuTBLwewDby4pUx74Gzqib33Znmmt6,8xNTWK2xNK2xZPpgXfcE4QxPT2i6YvNYakiLgdQ2FqEt,True,2324393706,581098426,1759861,879930,879931,5HnvdJnCCcmRsm4GkXnYWd4q9RpwuvYDGEUMPkYR3Ts9,70394463,116158326,-45763863,302
2022-05-06 00:05:05-04:00,17820,5nALef7nAfNkSQSuTBLwewDby4pUx74Gzqib33Znmmt6,8xNTWK2xNK2xZPpgXfcE4QxPT2i6YvNYakiLgdQ2FqEt,True,1726354501,431588625,1290345,645172,645173,2py1FiYeL2f7J3HU36qiJz6TD6HCmiTN36RyxYtapQCZ,51613807,102923417,-51309610,298
2022-05-06 00:11:39-04:00,17821,DF7yTsT1XTNjTiSadopuDnKdAt4P7Qc4jeY2tAUGk18F,6z2GLxexqxWvGa4vdc3jLMYyMx71PMoa6M4wHoqpeVEB,True,3704559145,926139786,2771629,1385814,1385815,GXyFXZMNk2NFyEzw6JetVqsujqcz2yCixH7n8EpDJYWD,110865175,185176376,-74311201,299
2022-05-06 00:15:10-04:00,17822,gCNpMXEHPTLvMvyyaYCLJrd8RRGnKAHz7sBD5j7yyBt,9cRU1ZAZRT5Ei4YAmCrPJZMHGsWspcYXTuZH58iexwDv,True,490569795,122642448,371577,185788,185789,gjBMZYVujDjD1ECG4i97M8Q3gV9ESnwwTSUGropkusj,14863090,68499430,-53636340,302
2022-05-06 00:22:42-04:00,17823,8DSiP9CwJm3AEcH6uuAYFpArRRDLYpDQgjHEvjkUgfg2,ERJ8kuhPRRmUAhSM4oxUheh39YUVVYNgaTt6AdMXcCvL,True,1554554373,388638593,1157319,578659,578660,2py1FiYeL2f7J3HU36qiJz6TD6HCmiTN36RyxYtapQCZ,46292766,423311249,-377018483,297
2022-05-06 00:22:42-04:00,17824,BmFSXZx3HWaTtD7vp7AkUk5DUNjwK1qgLPod13EJz6No,DtLMfV3Xs7AAAQqC1PwL7YAfV6fig8yAMxr9MMxmyCKc,True,69818318,17454579,52040,26020,26020,2a35JJeTUW1pm6M3e8DHCjp8qr4vbc2cRPhuzZWyFzYd,2081609,10380289,-8298680,298
2022-05-06 00:22:47-04:00,17825,4ZF1wtHKAnxmEZGACgbgphHvuo5aK4wC4MCNJzLYVkMX,5UXyhRP3Rjsc1RbV8BouJVQoTbWWbuPtVJY15KcHJFCN,True,171916451,42979112,125307,62653,62654,2a35JJeTUW1pm6M3e8DHCjp8qr4vbc2cRPhuzZWyFzYd,5012290,48241915,-43229625,291
2022-05-06 00:22:54-04:00,17826,Hgs1Lk2ESxULpgcbgayhLdHSDyw5Yr6RiNYhP8q9CHwC,42prjFMA3G8DGZxkgXRDupGkz9GFSxB2mu1ccnEqPhjv,True,55366831,13841707,41153,20576,20577,2a35JJeTUW1pm6M3e8DHCjp8qr4vbc2cRPhuzZWyFzYd,1646130,9121812,-7475682,297
2022-05-06 00:26:24-04:00,17827,EMFbiJWcw1YdjiDmxj5CsHMyswXyyHeL7cfWKa8dMzHh,2LjnVQF8WSwL8XSNVypW9SouYSRbyH9A7gcw7BFtxuXS,True,489227194,122306798,368305,184152,184153,A2p75MbAbeUdHkPLkAjgGeiwuu9WPrkMHzjCkDXF1Xr3,14732203,136705068,-121972865,301
2022-05-06 00:27:11-04:00,17828,9XmuJX8mFX29c5uh68kK7ff1mPdvs1orJAgEP6BsVKnq,HfPpizwUoK6uEmMb9LWi464BnvjHQY9cuPppFMp1DKDA,True,266451387,66612846,201538,100769,100769,68sueyVfmy5ToEGtLFGDkwebX47xAmzyXE29z8JrmcWv,8061557,29657179,-21595622,302
2022-05-06 00:27:12-04:00,17829,87yYQuRW91LAqEmqEyYah7obsr4KijRrqsKdK7DGA9w,EJzredSumMNBMTYxMMHocKayWKg3A3621QJ3ArJqro8r,True,145225124,36306281,109420,54710,54710,Hu94aiQWvce6THeGyCFqGRPM1pQrK3ihzkcXo1EpJcJL,4376807,40074267,-35697460,301
2022-05-06 00:29:27-04:00,17830,A7j77tzgnQVGtHTa65VtVZqJRYeJvQk7am8NW6e66379,4vJGwEvXU2tGWoWWGwbsYcfKQAMCHbrBMRk4ZVFzneLs,True,31454184024,7863546006,23129297,11564648,11564649,3zqXX6kzhkbW3d4TwD2CNjMRwxTbREXySekvq37kfCNk,925171883,4986193422,-4061021539,294
2022-05-06 00:29:28-04:00,17831,BhhVhLVZkSd3aHDMd6ojTgtJtbgAdMCA9Xj8jL2GMXoL,G8HUQp2yGSw9T6it5ej91cqkd82naca8heji453g2jEH,True,170069467,30287721,118651,59325,59326,Hu94aiQWvce6THeGyCFqGRPM1pQrK3ihzkcXo1EpJcJL,6662475,78716348,-72053873,391
2022-05-06 00:29:28-04:00,17832,1EH82ta3wXUyUwW8VWQnVzSG3r1rHcSj2DvDeTKmp3F,B6aMfucYPbCzWBtauLtgTpwR45wKSK8yqscHJR3F5usu,True,458121075,114530268,333180,166590,166590,68sueyVfmy5ToEGtLFGDkwebX47xAmzyXE29z8JrmcWv,13327210,36768426,-23441216,290
2022-05-06 00:29:30-04:00,17833,HqtTbC1LFreGvgfpZe7nCqkNnh8GHPQKosfmc19zb1yi,E39UNiHNkwQEd5GXkCtTPqSorQSB1kLx8kjzK4jdFoi3,True,466404024,116601006,348937,174468,174469,C4UnXuShCvjSMgBAgVNMy1oakxCNk1et27A82fywU112,13957503,81518281,-67560778,299
2022-05-06 00:29:32-04:00,17834,E3LF7ohKS87kHLW78ViuRuyw7EMuiW3nVn5PRdhU7iBj,DMVXNy2NLb8jMuznjx2syKqvzctrNmQ3PfiUA83CeQR4,True,213848796,53462199,158958,79479,79479,68sueyVfmy5ToEGtLFGDkwebX47xAmzyXE29z8JrmcWv,6358327,60665306,-54306979,297
2022-05-06 00:29:33-04:00,17835,5zqXqEjg95BnghcVbHRhYkSTYnzZjUBichgccv1BpS3d,9SuqSxrKpHh9NcNePe4Q3jXvpCmhNnoQv8YAFih3CqMX,True,1374817424,343704356,1033668,516834,516834,72XWPCtRYEDZbddP7d6dHtUBRRDLSJsB2xZTAfefoEVZ,41346725,391285684,-349938959,300
2022-05-06 00:36:31-04:00,17836,29JVska5UEG3axs63EmtHpPvkswNEqYpZ3PKMSfupiAG,DCftNBUsuogxyaJe9G9m3eWipH6o3qo4Rn4TuQXdVaBF,True,670480646,167620161,1045554,522777,522777,2py1FiYeL2f7J3HU36qiJz6TD6HCmiTN36RyxYtapQCZ,41822198,85479657,-43657459,623
2022-05-06 00:40:35-04:00,17837,BaFWQSYQQikWywyGiHgG25hEons9nW5zhvUTzp8oAcYU,7WyiB5TBMB49ctd4cZBExSJyD51JMYnokScjSWixoPdk,False,14504825,14504825,960925,48046,912879,2a35JJeTUW1pm6M3e8DHCjp8qr4vbc2cRPhuzZWyFzYd,960926,2699260,-1738334,662
2022-05-06 03:36:54-04:00,17838,DLwEaZipqHmVBD5hc5v1NZtDStHyG4hAMwxywDTGGc2e,28GtwJw67UWfrSKxtuvpzoKzPyKXLgP3GKLm3fHdR566,True,6337263258,1584315814,9886876,4943438,4943438,A9TwRM1BMxqb8DCC7YNAMV6zPenEJm3HTZBy7wJKK58U,395475079,761679531,-366204452,624
2022-05-06 03:39:02-04:00,17839,64Diz8zzEv1jDWnBQPTHPpXwaWf7vjM19RyJmkPy1viQ,G8wkGHRHMtT3mvXBkH3zgsKNs8wbpdiPUS17y4cozhkZ,True,201831772,50457943,313078,156539,156539,68sueyVfmy5ToEGtLFGDkwebX47xAmzyXE29z8JrmcWv,12523132,29086938,-16563806,620
2022-05-06 03:39:14-04:00,17840,68zbVKnneMQqngbNkeLtPEP2ayNhawc1B2hPgqAEqgXK,HqiFpLr4NC7xJz9bEFusq8bCKaoxAQG1xsLxdUAzg8aa,True,111388135,5362122,22587,11293,11294,68sueyVfmy5ToEGtLFGDkwebX47xAmzyXE29z8JrmcWv,4692166,53465163,-48772997,421
2022-05-06 03:39:31-04:00,17841,3qaXKaNNT8mpC4KnA868wYkDCojg8ukUVxN19dtfYbPM,5o21p7NCXgv5cYPtBqQVvR3Ses6mHceYgCNmd5VL3tkG,False,20325368,20325368,945712,47285,898427,5HnvdJnCCcmRsm4GkXnYWd4q9RpwuvYDGEUMPkYR3Ts9,945713,7179034,-6233321,465
2022-05-06 03:39:56-04:00,17842,26wo1RqwKXrNnfgMdZEmkGhnDbURpZcp2hasB5EA5QtD,34gwTVGRrdoaBzLUG6SBwRwBovkjBjCebqVUBan6GDnB,True,2542373662,635593415,4487090,2243545,2243545,GXyFXZMNk2NFyEzw6JetVqsujqcz2yCixH7n8EpDJYWD,179483624,1521848291,-1342364667,705
2022-05-06 03:39:56-04:00,17843,442usWu6XpJZvU25bqXeynRrQ15jAzWwU9DWMgHpTn3Q,CtvADKp39bjJf3cPKWNL3wxnhq273fVM4fC5DmEcg5cC,True,1280141144,127659047,549089,274544,274545,2a35JJeTUW1pm6M3e8DHCjp8qr4vbc2cRPhuzZWyFzYd,55061710,406709196,-351647486,430
2022-05-06 03:40:02-04:00,17844,68zbVKnneMQqngbNkeLtPEP2ayNhawc1B2hPgqAEqgXK,HqiFpLr4NC7xJz9bEFusq8bCKaoxAQG1xsLxdUAzg8aa,True,105702986,4948617,20348,10174,10174,Hu94aiQWvce6THeGyCFqGRPM1pQrK3ihzkcXo1EpJcJL,4346552,51648805,-47302253,411
2022-05-06 03:40:29-04:00,17845,29JVska5UEG3axs63EmtHpPvkswNEqYpZ3PKMSfupiAG,DCftNBUsuogxyaJe9G9m3eWipH6o3qo4Rn4TuQXdVaBF,True,492843945,123210986,767447,383723,383724,3zqXX6kzhkbW3d4TwD2CNjMRwxTbREXySekvq37kfCNk,30697899,73474491,-42776592,622
2022-05-06 03:40:29-04:00,17846,HCAGpyYM2NYudMd55Geta13tUbS6eiygnJY5ULHsHAVa,3PPyWhqXrmifWPieLV34bZ1rzi8eEnrDDAF7ifXkXspn,True,174752890,22461629,115339,57669,57670,Hu94aiQWvce6THeGyCFqGRPM1pQrK3ihzkcXo1EpJcJL,8973535,60753680,-51780145,513
2022-05-06 03:40:49-04:00,17847,68zbVKnneMQqngbNkeLtPEP2ayNhawc1B2hPgqAEqgXK,HqiFpLr4NC7xJz9bEFusq8bCKaoxAQG1xsLxdUAzg8aa,True,100396657,9001197,35579,17789,17790,68sueyVfmy5ToEGtLFGDkwebX47xAmzyXE29z8JrmcWv,3968492,48658301,-44689809,395
2022-05-06 03:41:07-04:00,17848,H7wVZszBQdmFuwMUYAw4SSYbjxeFY1QvNBuT8QiqTxZS,CUm235keNKnVd2BaCNp5a6HePtWGMo8dq8S1KXf2KRR4,True,74814830,18703707,51497,25748,25749,68sueyVfmy5ToEGtLFGDkwebX47xAmzyXE29z8JrmcWv,2059900,3748457,-1688557,275
2022-05-06 03:41:07-04:00,17849,7tFD53kPTqrzjCu1Wji78gUqhoRtCUhsP1pM3DQKT7uG,BJvgPLYBDJrQJdQVowrsMwUGMurq4zTihoFwWoEokfu3,True,5608357691,723780498,2152217,1076108,1076109,A2p75MbAbeUdHkPLkAjgGeiwuu9WPrkMHzjCkDXF1Xr3,166768845,834481860,-667713015,297
2022-05-06 03:41:08-04:00,17850,DF7yTsT1XTNjTiSadopuDnKdAt4P7Qc4jeY2tAUGk18F,6z2GLxexqxWvGa4vdc3jLMYyMx71PMoa6M4wHoqpeVEB,True,2752597852,688149463,2053279,1026639,1026640,72XWPCtRYEDZbddP7d6dHtUBRRDLSJsB2xZTAfefoEVZ,82131194,163803741,-81672547,298
2022-05-06 03:41:08-04:00,17851,DZnaFtxiEHUv3geRGsKufTnCUhkSMbN2M7W4Bwu2LgkM,A38xXBMxA13qQnVB1tcd5USxpfdaUGmkp31FeTmCyb52,True,21141940,2697337,19130,9565,9565,C4UnXuShCvjSMgBAgVNMy1oakxCNk1et27A82fywU112,1499495,13552535,-12053040,709
2022-05-06 03:41:11-04:00,17852,BhhVhLVZkSd3aHDMd6ojTgtJtbgAdMCA9Xj8jL2GMXoL,G8HUQp2yGSw9T6it5ej91cqkd82naca8heji453g2jEH,True,138874331,12047515,48874,24437,24437,5HnvdJnCCcmRsm4GkXnYWd4q9RpwuvYDGEUMPkYR3Ts9,5633948,63336249,-57702301,405
2022-05-06 03:41:11-04:00,17853,Fczxdc24Eav8xcaKRDwWMEwPEzkGyEJ7qGcXYyGZFKVz,8GqweYpec4cnpaJvueF3FGWoaz72BAzpLYXBX7tuuqEt,True,3087410309,771852577,2307145,1153572,1153573,AmTrMPzuTp2BjnjqGNKqz9FTTCdpoKcPAJLwFc8ozcbh,92285819,1667314683,-1575028864,298
2022-05-06 03:41:13-04:00,17854,BjCNaM7YbE9SjFi7tzi4677zg1fKXGJwtecz2GWwWuhd,6rNsSrKZezQrLb2whToNjnizpnurDXrobHqfEK3QqU1M,True,25119583,1852844,8643,4321,4322,2a35JJeTUW1pm6M3e8DHCjp8qr4vbc2cRPhuzZWyFzYd,1171863,13990406,-12818543,466
2022-05-06 03:41:14-04:00,17855,AsRi72uQLsBnyQxMBnPEhyQNM7XyNk2RV9GzPMe8PysA,9MqsYTBn6P9zCi5bGCrZurWWysW8XQZJwndHsb227rEW,True,337738600,84434650,249936,124968,124968,3zqXX6kzhkbW3d4TwD2CNjMRwxTbREXySekvq37kfCNk,9997449,95514116,-85516667,296
2022-05-06 03:41:17-04:00,17856,5xkW7wHTcF5WadNtBBqKPKctVwyQtTqqscivAmxzseCk,7m31ZMZdCn5Gz2q5sETWA7uKA5LsKD7pJHBBqU3g7tCn,True,126711990,31677997,93719,46859,46860,2a35JJeTUW1pm6M3e8DHCjp8qr4vbc2cRPhuzZWyFzYd,3748762,22321248,-18572486,295
2022-05-06 03:41:22-04:00,17857,FRbeFwhUYCiHW5oP26mad8KND7CCYDbfnoNxX7GuXVp8,GrzXKxPX2WDka8i2D8sunMUsrsThKasQi8NYLwuCGygV,True,2778256157,481983856,1921855,960927,960928,72XWPCtRYEDZbddP7d6dHtUBRRDLSJsB2xZTAfefoEVZ,110779817,870045045,-759265228,398
2022-05-06 03:41:27-04:00,17858,68zbVKnneMQqngbNkeLtPEP2ayNhawc1B2hPgqAEqgXK,HqiFpLr4NC7xJz9bEFusq8bCKaoxAQG1xsLxdUAzg8aa,True,91186840,8381229,34230,17115,17115,Hu94aiQWvce6THeGyCFqGRPM1pQrK3ihzkcXo1EpJcJL,3724293,43293699,-39569406,408
2022-05-06 03:41:33-04:00,17859,GKbDACVE2yR8WwrMeGfSQuSXLqXR3B1N5YzZ93i5xyeB,B5EEB6xDf7fwwaE6CaJjwsgCNNdUc29tjW1gY2pHiKxq,True,3278572741,478108585,3395590,1697795,1697795,DQCvC9mR68hJ3tJsUiddh6JwcBJAmntqGJR2nUsEq7yj,232848637,1397957433,-1165108796,710
2022-05-06 03:41:33-04:00,17860,CDVtXFbo4Rg2aHsXKv5P3uRJq9ZTgsRd7GXPTxgH5xv9,6zj37qQnaiJT7xGEZmSKx5yQvisQFcs5KhGsG43SGd5y,True,158084514,11722288,42901,21450,21451,C4UnXuShCvjSMgBAgVNMy1oakxCNk1et27A82fywU112,5785660,51224712,-45439052,365
2022-05-06 03:41:37-04:00,17861,gCNpMXEHPTLvMvyyaYCLJrd8RRGnKAHz7sBD5j7yyBt,9cRU1ZAZRT5Ei4YAmCrPJZMHGsWspcYXTuZH58iexwDv,True,364345571,91086392,272276,136138,136138,Hu94aiQWvce6THeGyCFqGRPM1pQrK3ihzkcXo1EpJcJL,10891074,54702350,-43811276,298
2022-05-06 03:41:37-04:00,17862,8DSiP9CwJm3AEcH6uuAYFpArRRDLYpDQgjHEvjkUgfg2,ERJ8kuhPRRmUAhSM4oxUheh39YUVVYNgaTt6AdMXcCvL,True,1155414073,288853518,864363,432181,432182,2a35JJeTUW1pm6M3e8DHCjp8qr4vbc2cRPhuzZWyFzYd,34574553,327865375,-293290822,299
2022-05-06 03:41:48-04:00,17863,GKbDACVE2yR8WwrMeGfSQuSXLqXR3B1N5YzZ93i5xyeB,B5EEB6xDf7fwwaE6CaJjwsgCNNdUc29tjW1gY2pHiKxq,True,2758296054,355519703,2413935,1206967,1206968,Hu94aiQWvce6THeGyCFqGRPM1pQrK3ihzkcXo1EpJcJL,187284945,1137317650,-950032705,678
2022-05-06 03:41:51-04:00,17864,26wo1RqwKXrNnfgMdZEmkGhnDbURpZcp2hasB5EA5QtD,34gwTVGRrdoaBzLUG6SBwRwBovkjBjCebqVUBan6GDnB,True,1840151700,460037925,2709199,1354599,1354600,DA18qE9qesbBqpwNv1M4befYcNQkbSBSeLPTmQzrmbJw,108367987,1182448099,-1074080112,588
2022-05-06 03:41:53-04:00,17865,DZnaFtxiEHUv3geRGsKufTnCUhkSMbN2M7W4Bwu2LgkM,A38xXBMxA13qQnVB1tcd5USxpfdaUGmkp31FeTmCyb52,True,18082378,4520594,27952,13976,13976,5HnvdJnCCcmRsm4GkXnYWd4q9RpwuvYDGEUMPkYR3Ts9,1118140,12266995,-11148855,618
2022-05-06 03:42:01-04:00,17866,BmFSXZx3HWaTtD7vp7AkUk5DUNjwK1qgLPod13EJz6No,DtLMfV3Xs7AAAQqC1PwL7YAfV6fig8yAMxr9MMxmyCKc,True,51901543,12975385,39117,19558,19559,2a35JJeTUW1pm6M3e8DHCjp8qr4vbc2cRPhuzZWyFzYd,1564715,8250968,-6686253,301
2022-05-06 03:42:09-04:00,17867,442usWu6XpJZvU25bqXeynRrQ15jAzWwU9DWMgHpTn3Q,CtvADKp39bjJf3cPKWNL3wxnhq273fVM4fC5DmEcg5cC,True,1144781642,94772772,387542,193771,193771,3zqXX6kzhkbW3d4TwD2CNjMRwxTbREXySekvq37kfCNk,46812166,345235559,-298423393,408
2022-05-06 03:44:11-04:00,17868,9VojCEgzn99QRVPGKn6euGRQbM7Q86GZ6yHJQa7N3gv4,GW4GVNnUtEt68avsowddpmjoUTUyMvxV4c5kY3Gzz9fT,True,29452342,2567972,16035,8017,8018,5HnvdJnCCcmRsm4GkXnYWd4q9RpwuvYDGEUMPkYR3Ts9,1839171,20101676,-18262505,624
2022-05-06 03:45:42-04:00,17869,7frvVhg1eWJpsvG7ndjppb8Bmd1tFq5H1g26UiKZxqTP,3Ugo9b53e6e8PLnvKjqRP8pvvoubSPV6qiKtxey7mrGt,True,148429841,37107460,111814,55907,55907,68sueyVfmy5ToEGtLFGDkwebX47xAmzyXE29z8JrmcWv,4472566,40981365,-36508799,301
2022-05-06 03:47:16-04:00,17870,F5vnN191nY9kUJBtFcm6fUhPDJvUSrSHLvfstesb68rH,9DtiZh3FsVmZA9MRqZhonAN2Pk4rQdcWw8As76DnQ6ee,True,5893594522,1473398630,4455348,2227674,2227674,DQCvC9mR68hJ3tJsUiddh6JwcBJAmntqGJR2nUsEq7yj,178213955,294982163,-116768208,302
2022-05-06 04:44:52-04:00,17871,26wo1RqwKXrNnfgMdZEmkGhnDbURpZcp2hasB5EA5QtD,34gwTVGRrdoaBzLUG6SBwRwBovkjBjCebqVUBan6GDnB,True,1371996869,342999217,2440198,1220099,1220099,A9TwRM1BMxqb8DCC7YNAMV6zPenEJm3HTZBy7wJKK58U,97607933,911659765,-814051832,711
2022-05-06 06:42:10-04:00,17872,GKbDACVE2yR8WwrMeGfSQuSXLqXR3B1N5YzZ93i5xyeB,B5EEB6xDf7fwwaE6CaJjwsgCNNdUc29tjW1gY2pHiKxq,True,2387657220,325693473,2318341,1159170,1159171,2xTUy2RS74GJMMDnmFaegMzFLn19RVfYG4CibhBmjP1i,169957488,938893800,-768936312,711
2022-05-06 06:51:28-04:00,17873,26wo1RqwKXrNnfgMdZEmkGhnDbURpZcp2hasB5EA5QtD,34gwTVGRrdoaBzLUG6SBwRwBovkjBjCebqVUBan6GDnB,True,1005154020,251288505,1783567,891783,891784,Hu94aiQWvce6THeGyCFqGRPM1pQrK3ihzkcXo1EpJcJL,71342704,705935501,-634592797,709
2022-05-06 06:56:48-04:00,17874,EdCSJVDrgnE7PN9GK7t1t7hB79mBrJzyy1mMZL9u5nvM,GTy9uEWcCx4odtr1GLPpntNbdR7wJRYr3wE9P5rAaMw6,True,127332386,31833096,95700,47850,47850,5HnvdJnCCcmRsm4GkXnYWd4q9RpwuvYDGEUMPkYR3Ts9,3828038,14747183,-10919145,300
2022-05-06 06:56:56-04:00,17875,5QxR9QPTADFys9VQNm473RgprTikCXC23vhsBc9ojyAQ,H9zdf8nJ4JCF7jrwGsxiuiFoa14gzDmYsZ5N5ig3UGna,True,638521577,159630394,480152,240076,240076,2a35JJeTUW1pm6M3e8DHCjp8qr4vbc2cRPhuzZWyFzYd,19206087,57914420,-38708333,300
2022-05-06 06:56:59-04:00,17876,7zDNgPFeomS1hdQhuY8iGF3nnGMNnx1YrinZJetrefje,AKyG5R6Bac6Fu83ruL9FGpjKCfDKxbP6QfEGbCgqegiV,False,26077737,26077737,793294,39664,753630,3zqXX6kzhkbW3d4TwD2CNjMRwxTbREXySekvq37kfCNk,793295,4007973,-3214678,304
2022-05-06 06:57:02-04:00,17877,9RtNbEZ4ZR8T1HFF4cujPVy2kejVBKFo3CPQi8psSa1q,7zwaGb71jKc9y2HKCKy5q2XV2YUphkyU1hkDaab1GBas,True,646893603,159674053,475244,237622,237622,gjBMZYVujDjD1ECG4i97M8Q3gV9ESnwwTSUGropkusj,19253789,203460148,-184206359,297
2022-05-06 06:57:04-04:00,17878,AggAFLRnGWU7X97a3sWRKV7wDDRiAGn9Q4azmEYXAo1k,Dj4DzvpxgQiRoad1zTXoNTrgGTDHG9NvMeCzzRZSxkvs,True,284068012,47895238,194756,97378,97378,Hu94aiQWvce6THeGyCFqGRPM1pQrK3ihzkcXo1EpJcJL,11551092,59530612,-47979520,406
2022-05-06 06:57:43-04:00,17879,FRbeFwhUYCiHW5oP26mad8KND7CCYDbfnoNxX7GuXVp8,GrzXKxPX2WDka8i2D8sunMUsrsThKasQi8NYLwuCGygV,True,2283596276,211743346,890476,445238,445238,DA18qE9qesbBqpwNv1M4befYcNQkbSBSeLPTmQzrmbJw,96035590,757637994,-661602404,420
2022-05-06 06:57:52-04:00,17880,3WcJUt8jQ1ngL3ZCGo6dFrc3GmTMTYtzeDva7mri2Tqx,HeG1Pz2oMjqtkfsRMsbqP3VpatnVEQzcWmKDVoFp4Htr,True,18763208,4690802,29245,14622,14623,68sueyVfmy5ToEGtLFGDkwebX47xAmzyXE29z8JrmcWv,1169818,8848598,-7678780,623
2022-05-06 06:57:54-04:00,17881,E4VzeJLsf5Y6t3yNi8VpS8QxhJbJGPhnkNBmU2XoCBs9,63CXyYfevXtrL1QcfQtAhz29xeea5BwWcj6d6BWb4qiB,True,35014681042,8753670260,24853504,12426752,12426752,6UQfSsLooL4pQKQfLtXCutQS2BnF7A7F7ewJopDLmUpc,994140181,11061638662,-10067498481,283
2022-05-06 06:57:54-04:00,17882,DZnaFtxiEHUv3geRGsKufTnCUhkSMbN2M7W4Bwu2LgkM,A38xXBMxA13qQnVB1tcd5USxpfdaUGmkp31FeTmCyb52,False,13425482,13425482,955115,47755,907360,C4UnXuShCvjSMgBAgVNMy1oakxCNk1et27A82fywU112,955116,9453084,-8497968,711
2022-05-06 06:57:54-04:00,17883,68gVM4kjmSYxT1uJW13rYSway8uVLUdcLa7sJuqHQaAf,DshroBQ3da7BcAiQpiFREsLKWbUDrBRmmZRw3Zu2Qfs9,True,4337240467,1084310116,2708838,1354419,1354419,5HnvdJnCCcmRsm4GkXnYWd4q9RpwuvYDGEUMPkYR3Ts9,108353556,634499455,-526145899,249
2022-05-06 06:57:59-04:00,17884,442usWu6XpJZvU25bqXeynRrQ15jAzWwU9DWMgHpTn3Q,CtvADKp39bjJf3cPKWNL3wxnhq273fVM4fC5DmEcg5cC,True,1042549702,189161239,706216,353108,353108,C4UnXuShCvjSMgBAgVNMy1oakxCNk1et27A82fywU112,38922653,298134233,-259211580,373
2022-05-06 06:57:59-04:00,17885,7frvVhg1eWJpsvG7ndjppb8Bmd1tFq5H1g26UiKZxqTP,3Ugo9b53e6e8PLnvKjqRP8pvvoubSPV6qiKtxey7mrGt,True,110145101,27536275,79570,39785,39785,C4UnXuShCvjSMgBAgVNMy1oakxCNk1et27A82fywU112,3182801,31742574,-28559773,288
2022-05-06 06:58:01-04:00,17886,F5vnN191nY9kUJBtFcm6fUhPDJvUSrSHLvfstesb68rH,9DtiZh3FsVmZA9MRqZhonAN2Pk4rQdcWw8As76DnQ6ee,True,4378883042,1094720760,3310476,1655238,1655238,C4UnXuShCvjSMgBAgVNMy1oakxCNk1et27A82fywU112,132419061,262460993,-130041932,302
2022-05-06 06:58:05-04:00,17887,CKK8bNCGjTn8qR6JoY5woqo2rrQHPMRawDGNfDsrg4Zd,46jXZ7r4uPrHnRJsnRnXHdDWjjjAbi8smmHbxxLhuwVg,True,86558160,21639540,59719,29859,29860,2a35JJeTUW1pm6M3e8DHCjp8qr4vbc2cRPhuzZWyFzYd,2388777,5879010,-3490233,275
2022-05-06 06:58:07-04:00,17888,9pzwKSceogMgCeZjstNqHbiLHeQb4mzD4j9kSmNxbe8x,93AY1zEbBweMV2ur9A65vzmSb79Mkrr2Wi1XuLYijSm9,True,52240073,13060018,38811,19405,19406,2a35JJeTUW1pm6M3e8DHCjp8qr4vbc2cRPhuzZWyFzYd,1552443,14449305,-12896862,297
2022-05-06 06:58:16-04:00,17889,4nj9fNW5K5hZebNaCP8PDTismTb5HK4MsJLUPLsnfN7P,B4UmvQqxb4Sc35L3YzuGR8BSQC2qKd6e4Byxni7ncYkf,True,153682734,38420683,114723,57361,57362,2a35JJeTUW1pm6M3e8DHCjp8qr4vbc2cRPhuzZWyFzYd,4588932,21291970,-16703038,298
2022-05-06 06:58:19-04:00,17890,6pAs5S7zGX77DHSYUuCxvxbf2FQQHQhbBmAYLd3iJvWS,HNTWEhsrnEe8FeVDpEcxuoD5PnuveB5BwSf3gdBmhzxv,True,81544935,20386233,61094,30547,30547,C4UnXuShCvjSMgBAgVNMy1oakxCNk1et27A82fywU112,2443788,12708807,-10265019,299
2022-05-06 07:11:14-04:00,17891,AggAFLRnGWU7X97a3sWRKV7wDDRiAGn9Q4azmEYXAo1k,Dj4DzvpxgQiRoad1zTXoNTrgGTDHG9NvMeCzzRZSxkvs,True,234750598,22864275,96714,48357,48357,YQC4EUcgeBi9431viwvzvBbZJW3szeHX4dFmowRDyDw,9929761,54078733,-44148972,422
2022-05-06 07:12:19-04:00,17892,CDVtXFbo4Rg2aHsXKv5P3uRJq9ZTgsRd7GXPTxgH5xv9,6zj37qQnaiJT7xGEZmSKx5yQvisQFcs5KhGsG43SGd5y,True,145964864,5213084,19068,9534,9534,5HnvdJnCCcmRsm4GkXnYWd4q9RpwuvYDGEUMPkYR3Ts9,5339071,48244576,-42905505,365
2022-05-06 07:12:24-04:00,17893,E56pqwjJ773ovVX4fNf5YACoqMTspgSh5YjGNvwTam5h,6sUwG5onnHCjwaff4nrBXxMqJ7tMrA5DYYFF8YdEp6TJ,True,107350404,26837601,79363,39681,39682,C4UnXuShCvjSMgBAgVNMy1oakxCNk1et27A82fywU112,3174541,10322094,-7147553,295
2022-05-06 07:12:40-04:00,17894,HT2SuCbePhjNZaar24uVwihYowCNvSjdvhJ8BRSVw9nX,98Ts4LCnapHVoCJ5PW3Armvh4jvDtpfs3SYRLRxiAgzZ,True,484015270,31738052,157162,78581,78581,2a35JJeTUW1pm6M3e8DHCjp8qr4vbc2cRPhuzZWyFzYd,23967832,174935614,-150967782,495
2022-05-06 07:12:44-04:00,17895,68zbVKnneMQqngbNkeLtPEP2ayNhawc1B2hPgqAEqgXK,HqiFpLr4NC7xJz9bEFusq8bCKaoxAQG1xsLxdUAzg8aa,True,82575569,4014268,16807,8403,8404,5HnvdJnCCcmRsm4GkXnYWd4q9RpwuvYDGEUMPkYR3Ts9,3457473,41002850,-37545377,418
2022-05-06 07:12:46-04:00,17896,GNohZMtk1VAuhLAgNGT8J3HYCKDCiyjvLeAWr64d7Duy,6soTLVj9DzFht8DzvjRfNPAWhZuiDBS5fDE1fpeuDSSz,True,189392881,47348220,294489,147244,147245,C4UnXuShCvjSMgBAgVNMy1oakxCNk1et27A82fywU112,11779581,97361618,-85582037,621
2022-05-06 07:12:53-04:00,17897,7tFD53kPTqrzjCu1Wji78gUqhoRtCUhsP1pM3DQKT7uG,BJvgPLYBDJrQJdQVowrsMwUGMurq4zTihoFwWoEokfu3,True,4867000756,672657520,2024773,1012386,1012387,72XWPCtRYEDZbddP7d6dHtUBRRDLSJsB2xZTAfefoEVZ,146502144,734744298,-588242154,301
2022-05-06 07:12:57-04:00,17898,64Diz8zzEv1jDWnBQPTHPpXwaWf7vjM19RyJmkPy1viQ,G8wkGHRHMtT3mvXBkH3zgsKNs8wbpdiPUS17y4cozhkZ,True,147748604,36937151,213932,106966,106966,Hu94aiQWvce6THeGyCFqGRPM1pQrK3ihzkcXo1EpJcJL,8557302,24606952,-16049650,579
2022-05-06 07:12:57-04:00,17899,HooxSzasW3HMoFJ6sAvRQ75Char1J5aBdJtsqfDV6myp,BCmsWwpGeV4NNfeKZKKydty2uueLGHYTJDk1WErpXsVT,True,853850741,213462685,1332196,666098,666098,3zqXX6kzhkbW3d4TwD2CNjMRwxTbREXySekvq37kfCNk,53287844,131858643,-78570799,624
2022-05-06 07:12:59-04:00,17900,442usWu6XpJZvU25bqXeynRrQ15jAzWwU9DWMgHpTn3Q,CtvADKp39bjJf3cPKWNL3wxnhq273fVM4fC5DmEcg5cC,True,849875527,70499580,287698,143849,143849,C4UnXuShCvjSMgBAgVNMy1oakxCNk1et27A82fywU112,34682168,267239829,-232557661,408
2022-05-06 07:26:25-04:00,17901,CDVtXFbo4Rg2aHsXKv5P3uRJq9ZTgsRd7GXPTxgH5xv9,6zj37qQnaiJT7xGEZmSKx5yQvisQFcs5KhGsG43SGd5y,True,140549528,10081339,36708,18354,18354,5HnvdJnCCcmRsm4GkXnYWd4q9RpwuvYDGEUMPkYR3Ts9,5117751,49688594,-44570843,364
2022-05-06 07:26:51-04:00,17902,4ZF1wtHKAnxmEZGACgbgphHvuo5aK4wC4MCNJzLYVkMX,5UXyhRP3Rjsc1RbV8BouJVQoTbWWbuPtVJY15KcHJFCN,True,127905938,31976484,96164,48082,48082,C4UnXuShCvjSMgBAgVNMy1oakxCNk1et27A82fywU112,3846560,37300492,-33453932,300
2022-05-06 07:26:51-04:00,17903,68zbVKnneMQqngbNkeLtPEP2ayNhawc1B2hPgqAEqgXK,HqiFpLr4NC7xJz9bEFusq8bCKaoxAQG1xsLxdUAzg8aa,True,78348285,3659761,15076,7538,7538,C4UnXuShCvjSMgBAgVNMy1oakxCNk1et27A82fywU112,3227650,39633389,-36405739,411
2022-05-06 07:27:00-04:00,17904,FRbeFwhUYCiHW5oP26mad8KND7CCYDbfnoNxX7GuXVp8,GrzXKxPX2WDka8i2D8sunMUsrsThKasQi8NYLwuCGygV,True,2058852666,356430658,1421128,710564,710564,A2p75MbAbeUdHkPLkAjgGeiwuu9WPrkMHzjCkDXF1Xr3,82088724,676545771,-594457047,398
2022-05-06 07:27:03-04:00,17905,5QxR9QPTADFys9VQNm473RgprTikCXC23vhsBc9ojyAQ,H9zdf8nJ4JCF7jrwGsxiuiFoa14gzDmYsZ5N5ig3UGna,True,474538783,118634695,359192,179596,179596,3zqXX6kzhkbW3d4TwD2CNjMRwxTbREXySekvq37kfCNk,14367686,47765424,-33397738,302
2022-05-06 07:27:03-04:00,17906,4hZG7dM716SxDagiFGwt1gSC99B2QK1emGLV9TJmmuR8,7vjfUWySkyx4Z5qAaRr2VWnVvxHHNsvPj1PirGNSjM6,True,311735323,77933830,487047,243523,243524,3zqXX6kzhkbW3d4TwD2CNjMRwxTbREXySekvq37kfCNk,19481909,209987130,-190505221,624
2022-05-06 07:27:04-04:00,17907,HT2SuCbePhjNZaar24uVwihYowCNvSjdvhJ8BRSVw9nX,98Ts4LCnapHVoCJ5PW3Armvh4jvDtpfs3SYRLRxiAgzZ,True,449828582,31722362,150646,75323,75323,Hu94aiQWvce6THeGyCFqGRPM1pQrK3ihzkcXo1EpJcJL,21362034,174715903,-153353869,474
2022-05-06 07:27:05-04:00,17908,HCAGpyYM2NYudMd55Geta13tUbS6eiygnJY5ULHsHAVa,3PPyWhqXrmifWPieLV34bZ1rzi8eEnrDDAF7ifXkXspn,True,150673822,16621631,79838,39919,39919,68sueyVfmy5ToEGtLFGDkwebX47xAmzyXE29z8JrmcWv,7237342,55780252,-48542910,480
2022-05-06 07:27:06-04:00,17909,Ht5tqGiAf5tF8nRVDnpdvj7B9vNot6ijzykEDtQypxYC,2C7i83GfaXauAsZH3WMFofJdzNCpxeaQvVJ72iQb4fQM,False,14692988,14692988,908637,45431,863206,5HnvdJnCCcmRsm4GkXnYWd4q9RpwuvYDGEUMPkYR3Ts9,908637,7328904,-6420267,618
2022-05-06 07:27:07-04:00,17910,EdCSJVDrgnE7PN9GK7t1t7hB79mBrJzyy1mMZL9u5nvM,GTy9uEWcCx4odtr1GLPpntNbdR7wJRYr3wE9P5rAaMw6,True,94556448,23639112,69708,34854,34854,5HnvdJnCCcmRsm4GkXnYWd4q9RpwuvYDGEUMPkYR3Ts9,2788331,11921106,-9132775,294
2022-05-06 07:27:07-04:00,17911,CDVtXFbo4Rg2aHsXKv5P3uRJq9ZTgsRd7GXPTxgH5xv9,6zj37qQnaiJT7xGEZmSKx5yQvisQFcs5KhGsG43SGd5y,True,130212918,9394124,34815,17407,17408,2a35JJeTUW1pm6M3e8DHCjp8qr4vbc2cRPhuzZWyFzYd,4825772,44753001,-39927229,370
2022-05-06 07:27:07-04:00,17912,Hgs1Lk2ESxULpgcbgayhLdHSDyw5Yr6RiNYhP8q9CHwC,42prjFMA3G8DGZxkgXRDupGkz9GFSxB2mu1ccnEqPhjv,True,41153687,10288421,30765,15382,15383,C4UnXuShCvjSMgBAgVNMy1oakxCNk1et27A82fywU112,1230634,7208863,-5978229,299
2022-05-06 07:27:15-04:00,17913,EVMrznfJS54BZiywDD2WhUtxzicDtbEpm2a5yLrtCgRF,CpzsMYVYvKg8ihrX1cKRw7TDEYwD3kAyiX92hsf2KiTz,True,7780506421,910373846,5224377,2612188,2612189,AmTrMPzuTp2BjnjqGNKqz9FTTCdpoKcPAJLwFc8ozcbh,446501229,4816980925,-4370479696,573
2022-05-06 07:27:16-04:00,17914,EMFbiJWcw1YdjiDmxj5CsHMyswXyyHeL7cfWKa8dMzHh,2LjnVQF8WSwL8XSNVypW9SouYSRbyH9A7gcw7BFtxuXS,True,363211371,90802842,265729,132864,132865,Hu94aiQWvce6THeGyCFqGRPM1pQrK3ihzkcXo1EpJcJL,10629179,105820371,-95191192,292
2022-05-06 07:27:18-04:00,17915,87yYQuRW91LAqEmqEyYah7obsr4KijRrqsKdK7DGA9w,EJzredSumMNBMTYxMMHocKayWKg3A3621QJ3ArJqro8r,True,107870778,26967694,80292,40146,40146,C4UnXuShCvjSMgBAgVNMy1oakxCNk1et27A82fywU112,3211690,31033072,-27821382,297
2022-05-06 07:27:19-04:00,17916,5o4EAqBTiUKn41QhPL5kRjrGTgQVdP7xLtxC7xNxjkwn,E8gDreu3LxW1EHJ8hnqChK9QdffGh5GocJYKdrbYat8E,True,29353021,7338255,45452,22726,22726,YQC4EUcgeBi9431viwvzvBbZJW3szeHX4dFmowRDyDw,1818099,15951862,-14133763,619
2022-05-06 07:27:20-04:00,17917,BKmKy8n1MpB1sdSfuWy7P3c6ReSW8TEWZRsyriz3ujYo,FgRpiZFPz43vDWStgCwRJACiGKtMLkWbTGeTLPeKnnaY,True,364355041,91088760,270659,135329,135330,3zqXX6kzhkbW3d4TwD2CNjMRwxTbREXySekvq37kfCNk,10826369,104816667,-93990298,297
2022-05-06 07:27:22-04:00,17918,BjCNaM7YbE9SjFi7tzi4677zg1fKXGJwtecz2GWwWuhd,6rNsSrKZezQrLb2whToNjnizpnurDXrobHqfEK3QqU1M,True,23146354,3007274,13545,6772,6773,2a35JJeTUW1pm6M3e8DHCjp8qr4vbc2cRPhuzZWyFzYd,1042609,12542737,-11500128,450
2022-05-06 07:27:23-04:00,17919,8sUHtr1dGhr9xBUiUYNknaFnHRW3Xyp2dPEviRia5NTL,CA4Zfp28QYkjaBz4JKKjn8Qrm5qn4VVS75MAxSAqLDqN,False,12899821,12899821,798172,39908,758264,YQC4EUcgeBi9431viwvzvBbZJW3szeHX4dFmowRDyDw,798172,8992197,-8194025,618
2022-05-06 07:27:24-04:00,17920,9RtNbEZ4ZR8T1HFF4cujPVy2kejVBKFo3CPQi8psSa1q,7zwaGb71jKc9y2HKCKy5q2XV2YUphkyU1hkDaab1GBas,True,483080875,118747219,359720,179860,179860,2a35JJeTUW1pm6M3e8DHCjp8qr4vbc2cRPhuzZWyFzYd,14633962,157301927,-142667965,302
2022-05-06 07:27:25-04:00,17921,9XmuJX8mFX29c5uh68kK7ff1mPdvs1orJAgEP6BsVKnq,HfPpizwUoK6uEmMb9LWi464BnvjHQY9cuPppFMp1DKDA,True,197893846,49473461,147533,73766,73767,C4UnXuShCvjSMgBAgVNMy1oakxCNk1et27A82fywU112,5901323,24043381,-18142058,298
2022-05-06 07:27:52-04:00,17922,9VojCEgzn99QRVPGKn6euGRQbM7Q86GZ6yHJQa7N3gv4,GW4GVNnUtEt68avsowddpmjoUTUyMvxV4c5kY3Gzz9fT,True,26734365,2515926,15707,7853,7854,2a35JJeTUW1pm6M3e8DHCjp8qr4vbc2cRPhuzZWyFzYd,1669100,18689853,-17020753,624
2022-05-06 07:28:06-04:00,17923,68zbVKnneMQqngbNkeLtPEP2ayNhawc1B2hPgqAEqgXK,HqiFpLr4NC7xJz9bEFusq8bCKaoxAQG1xsLxdUAzg8aa,True,74459637,6689629,26806,13403,13403,Hu94aiQWvce6THeGyCFqGRPM1pQrK3ihzkcXo1EpJcJL,2983687,37338984,-34355297,400
2022-05-06 07:28:10-04:00,17924,68gVM4kjmSYxT1uJW13rYSway8uVLUdcLa7sJuqHQaAf,DshroBQ3da7BcAiQpiFREsLKWbUDrBRmmZRw3Zu2Qfs9,True,3245465703,811366425,2453500,1226750,1226750,68sueyVfmy5ToEGtLFGDkwebX47xAmzyXE29z8JrmcWv,98140017,500903889,-402763872,302
2022-05-06 07:28:10-04:00,17925,Ga6hKu2mWpMqDboq3ZajdiittrTvDqX9kqMDt2fi3t29,3zUEyHaYdzLGMZxDj2EZLCA6NzL7Ub9BGpE5PGGnw2GD,True,23565618,5891404,36641,18320,18321,C4UnXuShCvjSMgBAgVNMy1oakxCNk1et27A82fywU112,1465670,15400522,-13934852,621
2022-05-06 07:28:11-04:00,17926,93Jp2cnKVsSUcpoNEXmuq3K17MWt7JkW3jx6v5v2UAvN,5bos8dvpCKDxeYbXxRXwEdY8tAMZoL2XhNKUdFKxTrd6,True,253689771,30613699,139206,69603,69603,YQC4EUcgeBi9431viwvzvBbZJW3szeHX4dFmowRDyDw,11535825,157829757,-146293932,454
2022-05-06 07:28:13-04:00,17927,9BjYvRf5A9UK99LvPTHd5DRvxMn2FWYKb5fpDxYDL48S,4kMo5gLVscVqwx6xQTLrn9JaEq1dFqq5Vfiq3Vb15vhi,True,24322171,6080542,37828,18914,18914,5HnvdJnCCcmRsm4GkXnYWd4q9RpwuvYDGEUMPkYR3Ts9,1513125,14691167,-13178042,622
2022-05-06 07:28:15-04:00,17928,H7wVZszBQdmFuwMUYAw4SSYbjxeFY1QvNBuT8QiqTxZS,CUm235keNKnVd2BaCNp5a6HePtWGMo8dq8S1KXf2KRR4,True,55790237,13947559,42160,21080,21080,Hu94aiQWvce6THeGyCFqGRPM1pQrK3ihzkcXo1EpJcJL,1686436,3273789,-1587353,302
2022-05-06 07:28:19-04:00,17929,EvyJwXTqP5N4qPKwDiDTCfjLYgLWz1qEREsarcsZdhYD,CbnajpQJxW3fWpH9dohsipVnZJyUvqy5dYSRDBBaDeEp,True,24322140,6080535,37835,18917,18918,Hu94aiQWvce6THeGyCFqGRPM1pQrK3ihzkcXo1EpJcJL,1513419,14691809,-13178390,622
2022-05-06 07:28:26-04:00,17930,7tFD53kPTqrzjCu1Wji78gUqhoRtCUhsP1pM3DQKT7uG,BJvgPLYBDJrQJdQVowrsMwUGMurq4zTihoFwWoEokfu3,True,4175544407,539765681,1624625,812312,812313,72XWPCtRYEDZbddP7d6dHtUBRRDLSJsB2xZTAfefoEVZ,125678542,657366721,-531688179,300
2022-05-06 07:28:26-04:00,17931,BhhVhLVZkSd3aHDMd6ojTgtJtbgAdMCA9Xj8jL2GMXoL,G8HUQp2yGSw9T6it5ej91cqkd82naca8heji453g2jEH,True,126220855,22543156,88941,44470,44471,5HnvdJnCCcmRsm4GkXnYWd4q9RpwuvYDGEUMPkYR3Ts9,4979946,60351805,-55371859,394
2022-05-06 07:28:36-04:00,17932,CDVtXFbo4Rg2aHsXKv5P3uRJq9ZTgsRd7GXPTxgH5xv9,6zj37qQnaiJT7xGEZmSKx5yQvisQFcs5KhGsG43SGd5y,True,120563894,8662069,32589,16294,16295,2a35JJeTUW1pm6M3e8DHCjp8qr4vbc2cRPhuzZWyFzYd,4536057,41614978,-37078921,376
2022-05-06 07:28:56-04:00,17933,GCNi25P1Ywvfx5JpyxFVV68sRkio7LEhFgY85ZqveKR3,34mxz8fCss7KNAbEi2Wj9z5dTgXCGxuq2vyqzBPChtmq,True,5771764438,1442941109,4364933,2182466,2182467,A2p75MbAbeUdHkPLkAjgGeiwuu9WPrkMHzjCkDXF1Xr3,174597345,1454858596,-1280261251,302
2022-05-06 07:32:09-04:00,17934,A7j77tzgnQVGtHTa65VtVZqJRYeJvQk7am8NW6e66379,4vJGwEvXU2tGWoWWGwbsYcfKQAMCHbrBMRk4ZVFzneLs,True,23380273058,5845068264,17250437,8625218,8625219,DQCvC9mR68hJ3tJsUiddh6JwcBJAmntqGJR2nUsEq7yj,690017513,3955570930,-3265553417,295
2022-05-06 07:32:11-04:00,17935,E3LF7ohKS87kHLW78ViuRuyw7EMuiW3nVn5PRdhU7iBj,DMVXNy2NLb8jMuznjx2syKqvzctrNmQ3PfiUA83CeQR4,True,158876177,39719044,116941,58470,58471,Hu94aiQWvce6THeGyCFqGRPM1pQrK3ihzkcXo1EpJcJL,4677674,46918812,-42241138,294
2022-05-06 07:32:11-04:00,17936,HqtTbC1LFreGvgfpZe7nCqkNnh8GHPQKosfmc19zb1yi,E39UNiHNkwQEd5GXkCtTPqSorQSB1kLx8kjzK4jdFoi3,True,346499631,86624907,257014,128507,128507,68sueyVfmy5ToEGtLFGDkwebX47xAmzyXE29z8JrmcWv,10280588,64256660,-53976072,296
2022-05-06 07:32:11-04:00,17937,HT2SuCbePhjNZaar24uVwihYowCNvSjdvhJ8BRSVw9nX,98Ts4LCnapHVoCJ5PW3Armvh4jvDtpfs3SYRLRxiAgzZ,True,416244527,56778145,263940,131970,131970,2a35JJeTUW1pm6M3e8DHCjp8qr4vbc2cRPhuzZWyFzYd,19349695,161780271,-142430576,464
2022-05-06 07:32:11-04:00,17938,5zqXqEjg95BnghcVbHRhYkSTYnzZjUBichgccv1BpS3d,9SuqSxrKpHh9NcNePe4Q3jXvpCmhNnoQv8YAFih3CqMX,True,1021399090,255349772,763164,381582,381582,5HnvdJnCCcmRsm4GkXnYWd4q9RpwuvYDGEUMPkYR3Ts9,30526588,302714787,-272188199,298
2022-05-06 07:33:35-04:00,17939,AggAFLRnGWU7X97a3sWRKV7wDDRiAGn9Q4azmEYXAo1k,Dj4DzvpxgQiRoad1zTXoNTrgGTDHG9NvMeCzzRZSxkvs,True,210516637,35540016,142880,71440,71440,gjBMZYVujDjD1ECG4i97M8Q3gV9ESnwwTSUGropkusj,8463361,46983918,-38520557,402
2022-05-06 08:31:30-04:00,17940,5XcrJqz4M3F7d5SruWRSWLH8zY6cDVwTXbqcA2Y5YLBS,6gJ1xLxAQ1HW4WRpBx7LhHiQuqqdMvLxSdeeNUS5NFsi,True,234603295,58650823,412116,206058,206058,68sueyVfmy5ToEGtLFGDkwebX47xAmzyXE29z8JrmcWv,16484665,22621575,-6136910,702
2022-05-06 09:35:41-04:00,17941,HT2SuCbePhjNZaar24uVwihYowCNvSjdvhJ8BRSVw9nX,98Ts4LCnapHVoCJ5PW3Armvh4jvDtpfs3SYRLRxiAgzZ,True,357464864,23100409,110299,55149,55150,2a35JJeTUW1pm6M3e8DHCjp8qr4vbc2cRPhuzZWyFzYd,17068129,135843359,-118775230,477
2022-05-06 09:35:44-04:00,17942,DHv4AsHMRZ6DuPaKEr2cLMNsX2ezT75T9haNgsDngS2b,5pMurvHHPdPKg3R96o1fKBbJh2Mc2tBP6P1e3acB31vQ,True,103133089,25783272,159627,79813,79814,68sueyVfmy5ToEGtLFGDkwebX47xAmzyXE29z8JrmcWv,6385116,15095340,-8710224,619
2022-05-06 09:36:00-04:00,17943,CKK8bNCGjTn8qR6JoY5woqo2rrQHPMRawDGNfDsrg4Zd,46jXZ7r4uPrHnRJsnRnXHdDWjjjAbi8smmHbxxLhuwVg,True,64530585,16132646,48518,24259,24259,68sueyVfmy5ToEGtLFGDkwebX47xAmzyXE29z8JrmcWv,1940754,4946719,-3005965,300
2022-05-06 09:36:06-04:00,17944,BSDeCyJsPs6y1pbDVHNq5rs6tdxcrbY3NDjXPBxwRjHz,DjHD3jawBVikzjcQ5dXBRLdUmEeBHKt6JZLhvmjScDku,True,694777156,132767776,399746,199873,199873,DA18qE9qesbBqpwNv1M4befYcNQkbSBSeLPTmQzrmbJw,20918860,234285737,-213366877,301
2022-05-06 09:36:07-04:00,17945,DX6DNEePMPiHBVFX2rDuFoy1fznGYDx6bUQB6qL6UAAb,FM9PNZ9HFZNPZDmg5mQRuMo9t49kDJEHM2CuZmNo6TnD,True,4772451231,1193112807,3515215,1757607,1757608,72XWPCtRYEDZbddP7d6dHtUBRRDLSJsB2xZTAfefoEVZ,140608602,370697908,-230089306,294
2022-05-06 09:36:10-04:00,17946,4oMasDRj8HWfknmdwt6Mkz3eonr8J2byoiSTRo4sCnFQ,3emcATkEFvDVETiK97eVET2Z2jzkgiiSxX3gu5wsUKPe,True,23447121274,2751169410,18207093,9103546,9103547,68sueyVfmy5ToEGtLFGDkwebX47xAmzyXE29z8JrmcWv,1551718063,5887907264,-4336189201,661
2022-05-06 09:36:14-04:00,17947,BjCNaM7YbE9SjFi7tzi4677zg1fKXGJwtecz2GWwWuhd,6rNsSrKZezQrLb2whToNjnizpnurDXrobHqfEK3QqU1M,False,20071037,20071037,960442,48022,912420,5HnvdJnCCcmRsm4GkXnYWd4q9RpwuvYDGEUMPkYR3Ts9,960444,11226697,-10266253,478
2022-05-06 09:36:18-04:00,17948,E4VzeJLsf5Y6t3yNi8VpS8QxhJbJGPhnkNBmU2XoCBs9,63CXyYfevXtrL1QcfQtAhz29xeea5BwWcj6d6BWb4qiB,True,26041421609,6510355402,18739703,9369851,9369852,6UQfSsLooL4pQKQfLtXCutQS2BnF7A7F7ewJopDLmUpc,749588159,8571412270,-7821824111,287
2022-05-06 09:36:18-04:00,17949,FRbeFwhUYCiHW5oP26mad8KND7CCYDbfnoNxX7GuXVp8,GrzXKxPX2WDka8i2D8sunMUsrsThKasQi8NYLwuCGygV,True,1690204658,157568304,637350,318675,318675,2a35JJeTUW1pm6M3e8DHCjp8qr4vbc2cRPhuzZWyFzYd,68367403,587164900,-518797497,404
2022-05-06 09:36:20-04:00,17950,442usWu6XpJZvU25bqXeynRrQ15jAzWwU9DWMgHpTn3Q,CtvADKp39bjJf3cPKWNL3wxnhq273fVM4fC5DmEcg5cC,True,773723898,140423776,521416,260708,260708,2a35JJeTUW1pm6M3e8DHCjp8qr4vbc2cRPhuzZWyFzYd,28729665,231352755,-202623090,371
2022-05-06 09:36:21-04:00,17951,CDVtXFbo4Rg2aHsXKv5P3uRJq9ZTgsRd7GXPTxgH5xv9,6zj37qQnaiJT7xGEZmSKx5yQvisQFcs5KhGsG43SGd5y,True,111595350,3855033,14485,7242,7243,C4UnXuShCvjSMgBAgVNMy1oakxCNk1et27A82fywU112,4193213,39250742,-35057529,375
2022-05-06 09:36:22-04:00,17952,4SQQdHTJUDv8taPXQRvEVJpUu91iCWQsv9su8tfehaQG,33CJXj1pmmatAofRvgt5in9E6SLEuy7tq4jqSwnUWP2A,True,34607035,8651758,53653,26826,26827,C4UnXuShCvjSMgBAgVNMy1oakxCNk1et27A82fywU112,2146138,40818370,-38672232,620
2022-05-06 09:36:25-04:00,17953,F5vnN191nY9kUJBtFcm6fUhPDJvUSrSHLvfstesb68rH,9DtiZh3FsVmZA9MRqZhonAN2Pk4rQdcWw8As76DnQ6ee,True,3251387750,812846937,2408010,1204005,1204005,2a35JJeTUW1pm6M3e8DHCjp8qr4vbc2cRPhuzZWyFzYd,96320424,227272178,-130951754,296
2022-05-06 09:36:25-04:00,17954,7frvVhg1eWJpsvG7ndjppb8Bmd1tFq5H1g26UiKZxqTP,3Ugo9b53e6e8PLnvKjqRP8pvvoubSPV6qiKtxey7mrGt,True,81739599,20434899,55841,27920,27921,C4UnXuShCvjSMgBAgVNMy1oakxCNk1et27A82fywU112,2233662,24523219,-22289557,273
2022-05-06 09:36:26-04:00,17955,DxmkdZiygge1YAwbL8U6LudY3QJkSnZMHThQXkE4Z5qy,Gi8oNcSDphbtosjFudeEPtX88bUnYid1tL9FnXnLfASU,True,269422651,67355662,186692,93346,93346,2a35JJeTUW1pm6M3e8DHCjp8qr4vbc2cRPhuzZWyFzYd,7467716,28332062,-20864346,277
2022-05-06 09:36:27-04:00,17956,gCNpMXEHPTLvMvyyaYCLJrd8RRGnKAHz7sBD5j7yyBt,9cRU1ZAZRT5Ei4YAmCrPJZMHGsWspcYXTuZH58iexwDv,True,270536386,67634096,197061,98530,98531,C4UnXuShCvjSMgBAgVNMy1oakxCNk1et27A82fywU112,7882449,43464956,-35582507,291
2022-05-06 09:36:27-04:00,17957,68zbVKnneMQqngbNkeLtPEP2ayNhawc1B2hPgqAEqgXK,HqiFpLr4NC7xJz9bEFusq8bCKaoxAQG1xsLxdUAzg8aa,True,67366566,9112082,34525,17262,17263,2a35JJeTUW1pm6M3e8DHCjp8qr4vbc2cRPhuzZWyFzYd,2552609,33253303,-30700694,378
2022-05-06 09:36:29-04:00,17958,4ZF1wtHKAnxmEZGACgbgphHvuo5aK4wC4MCNJzLYVkMX,5UXyhRP3Rjsc1RbV8BouJVQoTbWWbuPtVJY15KcHJFCN,True,95009800,23752450,70695,35347,35348,C4UnXuShCvjSMgBAgVNMy1oakxCNk1et27A82fywU112,2827833,28838111,-26010278,297
2022-05-06 09:36:29-04:00,17959,Fczxdc24Eav8xcaKRDwWMEwPEzkGyEJ7qGcXYyGZFKVz,8GqweYpec4cnpaJvueF3FGWoaz72BAzpLYXBX7tuuqEt,True,2290017605,572504401,1608094,804047,804047,2xTUy2RS74GJMMDnmFaegMzFLn19RVfYG4CibhBmjP1i,64323780,1271257095,-1206933315,280
2022-05-06 09:36:31-04:00,17960,DF7yTsT1XTNjTiSadopuDnKdAt4P7Qc4jeY2tAUGk18F,6z2GLxexqxWvGa4vdc3jLMYyMx71PMoa6M4wHoqpeVEB,True,2041430066,510357516,1423931,711965,711966,DA18qE9qesbBqpwNv1M4befYcNQkbSBSeLPTmQzrmbJw,56957279,141295881,-84338602,279
2022-05-06 09:36:31-04:00,17961,EdCSJVDrgnE7PN9GK7t1t7hB79mBrJzyy1mMZL9u5nvM,GTy9uEWcCx4odtr1GLPpntNbdR7wJRYr3wE9P5rAaMw6,True,70274156,17568539,51900,25950,25950,YQC4EUcgeBi9431viwvzvBbZJW3szeHX4dFmowRDyDw,2076022,9569105,-7493083,295
2022-05-06 09:36:33-04:00,17962,8DSiP9CwJm3AEcH6uuAYFpArRRDLYpDQgjHEvjkUgfg2,ERJ8kuhPRRmUAhSM4oxUheh39YUVVYNgaTt6AdMXcCvL,True,857857237,214464309,624096,312048,312048,Hu94aiQWvce6THeGyCFqGRPM1pQrK3ihzkcXo1EpJcJL,24963878,253649454,-228685576,291
2022-05-06 09:36:34-04:00,17963,5xkW7wHTcF5WadNtBBqKPKctVwyQtTqqscivAmxzseCk,7m31ZMZdCn5Gz2q5sETWA7uKA5LsKD7pJHBBqU3g7tCn,True,93975677,23493919,64800,32400,32400,C4UnXuShCvjSMgBAgVNMy1oakxCNk1et27A82fywU112,2592018,17579855,-14987837,275
2022-05-06 09:36:36-04:00,17964,BhhVhLVZkSd3aHDMd6ojTgtJtbgAdMCA9Xj8jL2GMXoL,G8HUQp2yGSw9T6it5ej91cqkd82naca8heji453g2jEH,True,103024562,8943537,36783,18391,18392,47z82br5WdW2DZajdnPDPSSRRKsyAggqXqK6oPUwTaLf,4237244,48645284,-44408040,411
2022-05-06 09:36:40-04:00,17965,5nALef7nAfNkSQSuTBLwewDby4pUx74Gzqib33Znmmt6,8xNTWK2xNK2xZPpgXfcE4QxPT2i6YvNYakiLgdQ2FqEt,True,802320158,200580039,593359,296679,296680,GXyFXZMNk2NFyEzw6JetVqsujqcz2yCixH7n8EpDJYWD,23734372,40056095,-16321723,295
2022-05-06 09:36:41-04:00,17966,CDVtXFbo4Rg2aHsXKv5P3uRJq9ZTgsRd7GXPTxgH5xv9,6zj37qQnaiJT7xGEZmSKx5yQvisQFcs5KhGsG43SGd5y,True,107534955,7470948,27604,13802,13802,Hu94aiQWvce6THeGyCFqGRPM1pQrK3ihzkcXo1EpJcJL,3973366,40278790,-36305424,369
2022-05-06 09:36:41-04:00,17967,7tFD53kPTqrzjCu1Wji78gUqhoRtCUhsP1pM3DQKT7uG,BJvgPLYBDJrQJdQVowrsMwUGMurq4zTihoFwWoEokfu3,True,3620554093,502593635,1506359,753179,753180,2xTUy2RS74GJMMDnmFaegMzFLn19RVfYG4CibhBmjP1i,108514235,579536641,-471022406,299
2022-05-06 09:36:42-04:00,17968,9pzwKSceogMgCeZjstNqHbiLHeQb4mzD4j9kSmNxbe8x,93AY1zEbBweMV2ur9A65vzmSb79Mkrr2Wi1XuLYijSm9,True,38822630,9705657,28719,14359,14360,3zqXX6kzhkbW3d4TwD2CNjMRwxTbREXySekvq37kfCNk,1148794,11178908,-10030114,295
2022-05-06 09:36:43-04:00,17969,82EMpA1hwF9KNQy2ZB2A1HdoEowBu2CoYhW3VmohkSnk,hn67zsTzsAs2aqk6ZjfEeoRygd3CdMeCuR82h9yuiz3,True,610192729,152548182,452426,226213,226213,3zqXX6kzhkbW3d4TwD2CNjMRwxTbREXySekvq37kfCNk,18097055,173789240,-155692185,296
2022-05-06 09:36:43-04:00,17970,GKbDACVE2yR8WwrMeGfSQuSXLqXR3B1N5YzZ93i5xyeB,B5EEB6xDf7fwwaE6CaJjwsgCNNdUc29tjW1gY2pHiKxq,True,2037383766,265795664,1866796,933398,933398,DA18qE9qesbBqpwNv1M4befYcNQkbSBSeLPTmQzrmbJw,143094184,887376470,-744282286,702
2022-05-06 09:36:44-04:00,17971,AsRi72uQLsBnyQxMBnPEhyQNM7XyNk2RV9GzPMe8PysA,9MqsYTBn6P9zCi5bGCrZurWWysW8XQZJwndHsb227rEW,True,250472429,62618107,172585,86292,86293,72FwbpFGoLEazJEdpqNtPNefsadUrimUqma9wSoy4qiS,6903439,73873668,-66970229,275
2022-05-06 09:36:46-04:00,17972,6pAs5S7zGX77DHSYUuCxvxbf2FQQHQhbBmAYLd3iJvWS,HNTWEhsrnEe8FeVDpEcxuoD5PnuveB5BwSf3gdBmhzxv,True,60601564,15150391,45349,22674,22675,C4UnXuShCvjSMgBAgVNMy1oakxCNk1et27A82fywU112,1813984,10069979,-8255995,299
2022-05-06 09:36:47-04:00,17973,BmFSXZx3HWaTtD7vp7AkUk5DUNjwK1qgLPod13EJz6No,DtLMfV3Xs7AAAQqC1PwL7YAfV6fig8yAMxr9MMxmyCKc,True,38524825,9631206,28058,14029,14029,47z82br5WdW2DZajdnPDPSSRRKsyAggqXqK6oPUwTaLf,1122335,6538384,-5416049,291
2022-05-06 09:36:49-04:00,17974,HCAGpyYM2NYudMd55Geta13tUbS6eiygnJY5ULHsHAVa,3PPyWhqXrmifWPieLV34bZ1rzi8eEnrDDAF7ifXkXspn,True,132901761,12362730,55836,27918,27918,2a35JJeTUW1pm6M3e8DHCjp8qr4vbc2cRPhuzZWyFzYd,6002539,51829867,-45827328,451
2022-05-06 09:36:54-04:00,17975,Gwj6CMXQeoWVsmD775Knsm6BmWuysFvSKo78FRLQByb4,6cvChMYj7TfDcnc8hG9H89PABJr2svspqjJSdSGD4RUt,True,30594955,4144699,25783,12891,12892,68sueyVfmy5ToEGtLFGDkwebX47xAmzyXE29z8JrmcWv,1903255,8424725,-6521470,622
2022-05-06 09:36:54-04:00,17976,HT2SuCbePhjNZaar24uVwihYowCNvSjdvhJ8BRSVw9nX,98Ts4LCnapHVoCJ5PW3Armvh4jvDtpfs3SYRLRxiAgzZ,True,333368144,23604310,113016,56508,56508,3zqXX6kzhkbW3d4TwD2CNjMRwxTbREXySekvq37kfCNk,15961519,134982316,-119020797,478
2022-05-06 09:36:54-04:00,17977,Hgs1Lk2ESxULpgcbgayhLdHSDyw5Yr6RiNYhP8q9CHwC,42prjFMA3G8DGZxkgXRDupGkz9GFSxB2mu1ccnEqPhjv,False,30587499,30587499,921165,46058,875107,C4UnXuShCvjSMgBAgVNMy1oakxCNk1et27A82fywU112,921165,5682621,-4761456,301
2022-05-06 09:36:57-04:00,17978,AL8JFS4gjaQx89f9j8wtaNJgV76K8bw1ugvNtgvhgAnb,HJYvG2kGKe8kXgtZSWTWwTmSjxA3XUeCvyT7acoKtS1C,True,121171194102,22079164648,64103343,32051671,32051672,3zqXX6kzhkbW3d4TwD2CNjMRwxTbREXySekvq37kfCNk,3518012976,20852052373,-17334039397,290
2022-05-06 09:36:57-04:00,17979,9qGz5Mh1XNUXqY1vEg5S1ZEMzPFvBLRbp1qaXwxSFMby,D8KnbVXStSUz3QhZGzY5o853ASocjkyu9x682oHgVoZh,True,98771460711,17632559470,56070404,28035202,28035202,72XWPCtRYEDZbddP7d6dHtUBRRDLSJsB2xZTAfefoEVZ,3140868882,18877711525,-15736842643,317
2022-05-06 09:36:57-04:00,17980,DX6DNEePMPiHBVFX2rDuFoy1fznGYDx6bUQB6qL6UAAb,FM9PNZ9HFZNPZDmg5mQRuMo9t49kDJEHM2CuZmNo6TnD,True,3549748523,887437130,2687587,1343793,1343794,DA18qE9qesbBqpwNv1M4befYcNQkbSBSeLPTmQzrmbJw,107503486,309955274,-202451788,302
2022-05-06 09:36:57-04:00,17981,qDomXCaxa3BBJSuLnKRAHvBLMbMcWAzUNXtGDZTSD8F,57ch9yViUFJCGJcWUvNEDU1yGzC6AvPh4Ac3ynWZzLf1,True,17503376,4375844,25757,12878,12879,C4UnXuShCvjSMgBAgVNMy1oakxCNk1et27A82fywU112,1030302,11652119,-10621817,588
2022-05-06 09:36:58-04:00,17982,7BEY9qatFJomsayFmky3h3dAbKhY5XkRGwMobJuxXYhQ,J8MK3tAQKreBUG2reXY6gqr1uhbHhcAZEcxsLQmG5Ntt,True,855410778,213852694,1499045,749522,749523,DA18qE9qesbBqpwNv1M4befYcNQkbSBSeLPTmQzrmbJw,59961805,266088824,-206127019,700
2022-05-06 09:37:01-04:00,17983,BAe9q4b1UwvQi5BHTmVh2GRguY3f9a5fbzXV2WiB93Ag,9uSCD3c3vHYC1i6odskxdugUaoSE5QYA1e8wkkW6aX5W,True,24258587,6064646,36205,18102,18103,C4UnXuShCvjSMgBAgVNMy1oakxCNk1et27A82fywU112,1448232,14689839,-13241607,596
2022-05-06 09:37:01-04:00,17984,9VojCEgzn99QRVPGKn6euGRQbM7Q86GZ6yHJQa7N3gv4,GW4GVNnUtEt68avsowddpmjoUTUyMvxV4c5kY3Gzz9fT,True,24020913,2240326,13556,6778,6778,Hu94aiQWvce6THeGyCFqGRPM1pQrK3ihzkcXo1EpJcJL,1453590,17228103,-15774513,605
2022-05-06 09:37:02-04:00,17985,2pcVNktE3dbyybTuEBSkdwWJS5sFcvYLMEKRQMwZy6eh,61GaKj6fDApZF9B3aTBxTzYk8e22XLFPsQ21pJdvDhBL,True,24241887,6060471,35716,17858,17858,C4UnXuShCvjSMgBAgVNMy1oakxCNk1et27A82fywU112,1428648,14686903,-13258255,589
2022-05-06 09:37:05-04:00,17986,E56pqwjJ773ovVX4fNf5YACoqMTspgSh5YjGNvwTam5h,6sUwG5onnHCjwaff4nrBXxMqJ7tMrA5DYYFF8YdEp6TJ,True,79522757,19880689,52363,26181,26182,C4UnXuShCvjSMgBAgVNMy1oakxCNk1et27A82fywU112,2094539,8445402,-6350863,263
2022-05-06 09:37:06-04:00,17987,Cb6MEn1MN9XQcVVd3o9J8QdK3cFWxSNETsFzhVJ8jmdh,A6yTKbggUftjbjAVu5YR1M7rg7h78ghbfofmTSnmKNGz,True,406439073,101609768,254811,127405,127406,2py1FiYeL2f7J3HU36qiJz6TD6HCmiTN36RyxYtapQCZ,10192453,20117713,-9925260,250
2022-05-06 09:37:07-04:00,17988,4nj9fNW5K5hZebNaCP8PDTismTb5HK4MsJLUPLsnfN7P,B4UmvQqxb4Sc35L3YzuGR8BSQC2qKd6e4Byxni7ncYkf,True,113318836,28329709,62729,31364,31365,C4UnXuShCvjSMgBAgVNMy1oakxCNk1et27A82fywU112,2509184,16980000,-14470816,221
2022-05-06 09:37:08-04:00,17989,DkKumyFA6dGw77wcwd16nWzTEC9McvmasAbmGfQXLkB7,9u6QyrruYFjhyLV5AXYUKkrBggzrxXfNH57smUAap5Ro,True,62234675,13253530,41497,20748,20749,C4UnXuShCvjSMgBAgVNMy1oakxCNk1et27A82fywU112,1948632,13101908,-11153276,313
2022-05-06 09:37:08-04:00,17990,5QxR9QPTADFys9VQNm473RgprTikCXC23vhsBc9ojyAQ,H9zdf8nJ4JCF7jrwGsxiuiFoa14gzDmYsZ5N5ig3UGna,True,352249774,88062443,258927,129463,129464,DA18qE9qesbBqpwNv1M4befYcNQkbSBSeLPTmQzrmbJw,10357088,39067595,-28710507,294
2022-05-06 09:37:09-04:00,17991,CDVtXFbo4Rg2aHsXKv5P3uRJq9ZTgsRd7GXPTxgH5xv9,6zj37qQnaiJT7xGEZmSKx5yQvisQFcs5KhGsG43SGd5y,True,99739598,6960889,25273,12636,12637,68sueyVfmy5ToEGtLFGDkwebX47xAmzyXE29z8JrmcWv,3621353,36486957,-32865604,363
2022-05-06 09:37:12-04:00,17992,4nj9fNW5K5hZebNaCP8PDTismTb5HK4MsJLUPLsnfN7P,B4UmvQqxb4Sc35L3YzuGR8BSQC2qKd6e4Byxni7ncYkf,True,84988899,21247224,61155,30577,30578,YQC4EUcgeBi9431viwvzvBbZJW3szeHX4dFmowRDyDw,2446227,13299747,-10853520,287
2022-05-06 09:37:13-04:00,17993,G85GTorkDswyxv8uxgpP1tr6DbXktiXjjX14VA4L2VVu,3EJ5raXpu6eveda4FjxAeWFNbDbQkgjyKfoFq183UeLC,True,24217594,6054398,36461,18230,18231,72FwbpFGoLEazJEdpqNtPNefsadUrimUqma9wSoy4qiS,1458465,14683928,-13225463,602
2022-05-06 09:37:15-04:00,17994,EneQUyUwfKFNwfdgNRdZBdX2frHixmVDK2GxDRU78QB,Gk8BVo53foZz1tMdLf85ZKpAPeLFZbCqwM6KYhmN6WNc,True,17503284,4375821,26311,13155,13156,72FwbpFGoLEazJEdpqNtPNefsadUrimUqma9wSoy4qiS,1052453,11674594,-10622141,601
2022-05-06 09:37:18-04:00,17995,EVMrznfJS54BZiywDD2WhUtxzicDtbEpm2a5yLrtCgRF,CpzsMYVYvKg8ihrX1cKRw7TDEYwD3kAyiX92hsf2KiTz,True,6812380318,722572202,4060478,2030239,2030239,3zqXX6kzhkbW3d4TwD2CNjMRwxTbREXySekvq37kfCNk,382820194,4296601512,-3913781318,561
2022-05-06 09:37:18-04:00,17996,4YNWVEq2F3gR8XEbUQxJRqzi6i5KSfwf6mVMLPJrnpEd,EE5uomX5guX4ZeHiP6wcoH5C8k3tRGXo18JTWgNDqs1C,True,24238107,6059526,35617,17808,17809,72FwbpFGoLEazJEdpqNtPNefsadUrimUqma9wSoy4qiS,1424708,14687062,-13262354,587
2022-05-06 09:37:19-04:00,17997,GpDhvRRae2uiRZ6MnJYnVR2hANNLGFGUDnsQmGjfK8AP,B2pgJ4gPdgzvx2HMJ1wagtthpZebtBk7RD3cF1zqSyT8,True,1100855915,275213978,795965,397982,397983,2xTUy2RS74GJMMDnmFaegMzFLn19RVfYG4CibhBmjP1i,31838618,348488987,-316650369,289
2022-05-06 09:37:20-04:00,17998,7tFD53kPTqrzjCu1Wji78gUqhoRtCUhsP1pM3DQKT7uG,BJvgPLYBDJrQJdQVowrsMwUGMurq4zTihoFwWoEokfu3,True,3103140563,401793141,1193645,596822,596823,DA18qE9qesbBqpwNv1M4befYcNQkbSBSeLPTmQzrmbJw,92187981,519572632,-427384651,297
2022-05-06 09:37:20-04:00,17999,12GjTFcAZ5rnnR9DwXDUMmjFoyuFa3txDF4PPA4YoAQq,Ebm7YVYTYyMtEBM4STgbyyLuSFTwnnuFDQ1Wysvtj2vR,True,43639704,10909926,66983,33491,33492,2a35JJeTUW1pm6M3e8DHCjp8qr4vbc2cRPhuzZWyFzYd,2679351,12614983,-9935632,613
2022-05-06 09:37:20-04:00,18000,9RtNbEZ4ZR8T1HFF4cujPVy2kejVBKFo3CPQi8psSa1q,7zwaGb71jKc9y2HKCKy5q2XV2YUphkyU1hkDaab1GBas,True,360396843,88093785,252748,126374,126374,DA18qE9qesbBqpwNv1M4befYcNQkbSBSeLPTmQzrmbJw,10340094,121671227,-111331133,286
2022-05-06 09:37:20-04:00,18001,7FL3AxJZcTiCG6Ux7CVc82Nqo4msgmQASGvjfMEgQddc,EzcAwNya2eA7GD8ezmi49bEUP57Fq3w9SwN3uAG4HA2b,True,24240441,6060110,36104,18052,18052,68sueyVfmy5ToEGtLFGDkwebX47xAmzyXE29z8JrmcWv,1444175,14688277,-13244102,595
2022-05-06 09:37:24-04:00,18002,DLwEaZipqHmVBD5hc5v1NZtDStHyG4hAMwxywDTGGc2e,28GtwJw67UWfrSKxtuvpzoKzPyKXLgP3GKLm3fHdR566,True,4655790184,1163947546,7223891,3611945,3611946,DA18qE9qesbBqpwNv1M4befYcNQkbSBSeLPTmQzrmbJw,288955678,661065085,-372109407,620
2022-05-06 09:37:24-04:00,18003,9V7DXwq3RnVnLqRmtWXQJZgU3nHyVMteXAvaVaW3g1b6,94zfTWn693sbx9aaxamLUSHsbXdYxLpZVTvnetJ3SnhT,True,24254700,6063675,35866,17933,17933,C4UnXuShCvjSMgBAgVNMy1oakxCNk1et27A82fywU112,1434678,14680490,-13245812,591
2022-05-06 09:37:26-04:00,18004,68gVM4kjmSYxT1uJW13rYSway8uVLUdcLa7sJuqHQaAf,DshroBQ3da7BcAiQpiFREsLKWbUDrBRmmZRw3Zu2Qfs9,True,2409679085,602419771,1782156,891078,891078,2xTUy2RS74GJMMDnmFaegMzFLn19RVfYG4CibhBmjP1i,71286245,398167037,-326880792,295
2022-05-06 09:37:28-04:00,18005,AggAFLRnGWU7X97a3sWRKV7wDDRiAGn9Q4azmEYXAo1k,Dj4DzvpxgQiRoad1zTXoNTrgGTDHG9NvMeCzzRZSxkvs,True,173926808,17064160,71273,35636,35637,68sueyVfmy5ToEGtLFGDkwebX47xAmzyXE29z8JrmcWv,7264598,42513428,-35248830,417
2022-05-06 09:37:30-04:00,18006,68zbVKnneMQqngbNkeLtPEP2ayNhawc1B2hPgqAEqgXK,HqiFpLr4NC7xJz9bEFusq8bCKaoxAQG1xsLxdUAzg8aa,True,58127347,2737768,11261,5630,5631,C4UnXuShCvjSMgBAgVNMy1oakxCNk1et27A82fywU112,2390947,30329171,-27938224,411
2022-05-06 09:37:31-04:00,18007,93Jp2cnKVsSUcpoNEXmuq3K17MWt7JkW3jx6v5v2UAvN,5bos8dvpCKDxeYbXxRXwEdY8tAMZoL2XhNKUdFKxTrd6,True,221075190,22796142,96803,48401,48402,2a35JJeTUW1pm6M3e8DHCjp8qr4vbc2cRPhuzZWyFzYd,9387999,138296996,-128908997,424
2022-05-06 09:37:37-04:00,18008,CDVtXFbo4Rg2aHsXKv5P3uRJq9ZTgsRd7GXPTxgH5xv9,6zj37qQnaiJT7xGEZmSKx5yQvisQFcs5KhGsG43SGd5y,True,92635000,6432672,23973,11986,11987,2a35JJeTUW1pm6M3e8DHCjp8qr4vbc2cRPhuzZWyFzYd,3452371,34049563,-30597192,372
2022-05-06 09:37:38-04:00,18009,DkKumyFA6dGw77wcwd16nWzTEC9McvmasAbmGfQXLkB7,9u6QyrruYFjhyLV5AXYUKkrBggzrxXfNH57smUAap5Ro,True,48828697,9903404,35588,17794,17794,2a35JJeTUW1pm6M3e8DHCjp8qr4vbc2cRPhuzZWyFzYd,1754687,11978544,-10223857,359
2022-05-06 09:37:39-04:00,18010,Cb6MEn1MN9XQcVVd3o9J8QdK3cFWxSNETsFzhVJ8jmdh,A6yTKbggUftjbjAVu5YR1M7rg7h78ghbfofmTSnmKNGz,True,303700459,75925114,220219,110109,110110,2a35JJeTUW1pm6M3e8DHCjp8qr4vbc2cRPhuzZWyFzYd,8808796,17383687,-8574891,290
2022-05-06 09:37:39-04:00,18011,9qGz5Mh1XNUXqY1vEg5S1ZEMzPFvBLRbp1qaXwxSFMby,D8KnbVXStSUz3QhZGzY5o853ASocjkyu9x682oHgVoZh,True,80900181796,13173643781,46345051,23172525,23172526,gjBMZYVujDjD1ECG4i97M8Q3gV9ESnwwTSUGropkusj,2846079033,16135345353,-13289266320,351
2022-05-06 09:37:42-04:00,18012,7pSnDcmWQwSn6MfHFoAVEwgo7tZvrg2YkToH1hgSr4sT,5jj8izGNSZDY6S7sR5sWp8npcgXPTcTLjeU7mkhtBmqs,True,501342384,91303799,267026,133513,133513,3zqXX6kzhkbW3d4TwD2CNjMRwxTbREXySekvq37kfCNk,14662204,84489335,-69827131,292
2022-05-06 09:37:45-04:00,18013,E56pqwjJ773ovVX4fNf5YACoqMTspgSh5YjGNvwTam5h,6sUwG5onnHCjwaff4nrBXxMqJ7tMrA5DYYFF8YdEp6TJ,True,59315755,14828938,42896,21448,21448,68sueyVfmy5ToEGtLFGDkwebX47xAmzyXE29z8JrmcWv,1715863,6805409,-5089546,289
2022-05-06 09:37:47-04:00,18014,6pAs5S7zGX77DHSYUuCxvxbf2FQQHQhbBmAYLd3iJvWS,HNTWEhsrnEe8FeVDpEcxuoD5PnuveB5BwSf3gdBmhzxv,True,44849415,11212353,29171,14585,14586,YQC4EUcgeBi9431viwvzvBbZJW3szeHX4dFmowRDyDw,1166877,7960684,-6793807,260
2022-05-06 09:37:48-04:00,18015,9pzwKSceogMgCeZjstNqHbiLHeQb4mzD4j9kSmNxbe8x,93AY1zEbBweMV2ur9A65vzmSb79Mkrr2Wi1XuLYijSm9,False,28823198,28823198,826300,41315,784985,3zqXX6kzhkbW3d4TwD2CNjMRwxTbREXySekvq37kfCNk,826300,8642685,-7816385,286
2022-05-06 09:38:21-04:00,18016,3WcJUt8jQ1ngL3ZCGo6dFrc3GmTMTYtzeDva7mri2Tqx,HeG1Pz2oMjqtkfsRMsbqP3VpatnVEQzcWmKDVoFp4Htr,False,13776774,13776774,842185,42109,800076,5HnvdJnCCcmRsm4GkXnYWd4q9RpwuvYDGEUMPkYR3Ts9,842185,6896908,-6054723,611
2022-05-06 09:39:30-04:00,18017,HooxSzasW3HMoFJ6sAvRQ75Char1J5aBdJtsqfDV6myp,BCmsWwpGeV4NNfeKZKKydty2uueLGHYTJDk1WErpXsVT,True,627707547,156926886,979620,489810,489810,YQC4EUcgeBi9431viwvzvBbZJW3szeHX4dFmowRDyDw,39184811,110801450,-71616639,624
2022-05-06 09:40:15-04:00,18018,3S97kmJCtH7xQsdt7jsSyncXZiDQ9W8D8Pe3eT98Xopo,TvE4rh5GFsaAYo4MpkueYkuDPjbbuFmsBCdYyfAikLg,True,17925351,4481337,27870,13935,13935,2a35JJeTUW1pm6M3e8DHCjp8qr4vbc2cRPhuzZWyFzYd,1114830,11314665,-10199835,621
2022-05-06 09:40:39-04:00,18019,87yYQuRW91LAqEmqEyYah7obsr4KijRrqsKdK7DGA9w,EJzredSumMNBMTYxMMHocKayWKg3A3621QJ3ArJqro8r,True,80182169,20045542,60200,30100,30100,2a35JJeTUW1pm6M3e8DHCjp8qr4vbc2cRPhuzZWyFzYd,2408022,23995098,-21587076,300
2022-05-06 09:40:39-04:00,18020,BKmKy8n1MpB1sdSfuWy7P3c6ReSW8TEWZRsyriz3ujYo,FgRpiZFPz43vDWStgCwRJACiGKtMLkWbTGeTLPeKnnaY,True,270832993,67708248,202852,101426,101426,C4UnXuShCvjSMgBAgVNMy1oakxCNk1et27A82fywU112,8114110,81041535,-72927425,299
2022-05-06 09:40:39-04:00,18021,EMFbiJWcw1YdjiDmxj5CsHMyswXyyHeL7cfWKa8dMzHh,2LjnVQF8WSwL8XSNVypW9SouYSRbyH9A7gcw7BFtxuXS,True,269947625,67486906,197356,98678,98678,68sueyVfmy5ToEGtLFGDkwebX47xAmzyXE29z8JrmcWv,7894261,81749969,-73855708,292
2022-05-06 09:40:41-04:00,18022,9XmuJX8mFX29c5uh68kK7ff1mPdvs1orJAgEP6BsVKnq,HfPpizwUoK6uEmMb9LWi464BnvjHQY9cuPppFMp1DKDA,True,147098528,36774632,110685,55342,55343,2a35JJeTUW1pm6M3e8DHCjp8qr4vbc2cRPhuzZWyFzYd,4427418,19356181,-14928763,300
2022-05-06 09:47:15-04:00,18023,4hZG7dM716SxDagiFGwt1gSC99B2QK1emGLV9TJmmuR8,7vjfUWySkyx4Z5qAaRr2VWnVvxHHNsvPj1PirGNSjM6,True,229116428,57279107,356916,178458,178458,Hu94aiQWvce6THeGyCFqGRPM1pQrK3ihzkcXo1EpJcJL,14276679,161842243,-147565564,623
2022-05-06 09:47:29-04:00,18024,5g5EaEMiM2WQcfDpL3R3caYziX9xvGCFs9eVmmQdcgzS,J71CftCqiK1873fkVx9NGc7v7nvRZMYVBkGN3GhSPyeX,True,35930705,8982676,62848,31424,31424,5HnvdJnCCcmRsm4GkXnYWd4q9RpwuvYDGEUMPkYR3Ts9,2513952,12824928,-10310976,699
2022-05-06 09:48:13-04:00,18025,Ai6G7vosJfmkRqtDAkqxRtbzELp6P5xe9r2RH3LYcLZt,8SUpKXakmhi4rYiFKnHYpgaAopomfDqEX6Efew9iM6nk,True,346570163,31862422,133609,66804,66805,gjBMZYVujDjD1ECG4i97M8Q3gV9ESnwwTSUGropkusj,14532867,171235688,-156702821,419
2022-05-06 09:51:40-04:00,18026,D8BtQirMEk3W9Pq29B6KkKWrwPfmsUNpwz5npx7aGMLY,J7LMZwaSoh5hbGcwee6oPsnN4ZFD7Zp3LQWkJGNUHRfJ,True,167300457,41825114,265509,132754,132755,Hu94aiQWvce6THeGyCFqGRPM1pQrK3ihzkcXo1EpJcJL,10620394,68237541,-57617147,634
2022-05-06 09:51:42-04:00,18027,4oMasDRj8HWfknmdwt6Mkz3eonr8J2byoiSTRo4sCnFQ,3emcATkEFvDVETiK97eVET2Z2jzkgiiSxX3gu5wsUKPe,True,20514749276,3097932243,20421208,10210604,10210604,DQCvC9mR68hJ3tJsUiddh6JwcBJAmntqGJR2nUsEq7yj,1352308382,5221762285,-3869453903,659
2022-05-06 09:53:09-04:00,18028,5o4EAqBTiUKn41QhPL5kRjrGTgQVdP7xLtxC7xNxjkwn,E8gDreu3LxW1EHJ8hnqChK9QdffGh5GocJYKdrbYat8E,True,21592580,5398145,33683,16841,16842,Hu94aiQWvce6THeGyCFqGRPM1pQrK3ihzkcXo1EpJcJL,1347333,12369855,-11022522,623
2022-05-06 09:53:12-04:00,18029,5vp63gpRmA7mzAj8czoQsMsNHg1773XwYdwi4f5XC4nE,wqgmuTgVubuFucijWBVJU9tqMgGKHy61DVLEDC46q3H,True,84400306,21100076,125859,62929,62930,68sueyVfmy5ToEGtLFGDkwebX47xAmzyXE29z8JrmcWv,5034362,21507251,-16472889,596
2022-05-06 11:22:32-04:00,18030,5XcrJqz4M3F7d5SruWRSWLH8zY6cDVwTXbqcA2Y5YLBS,6gJ1xLxAQ1HW4WRpBx7LhHiQuqqdMvLxSdeeNUS5NFsi,True,179282032,44820508,318574,159287,159287,68sueyVfmy5ToEGtLFGDkwebX47xAmzyXE29z8JrmcWv,12742989,20678944,-7935955,710
2022-05-06 11:23:26-04:00,18031,31TiU5VAiR77Zec49S5x2Y9EqdyMqi8Gx5T2bLxAazhU,iZkdEaFdSoYXBFEp3GPVJZvg5ZbiVdjNvHaTEvXxUmp,True,88368214230,22092053557,63602091,31801045,31801046,68sueyVfmy5ToEGtLFGDkwebX47xAmzyXE29z8JrmcWv,2544083640,4210858022,-1666774382,287
2022-05-06 11:24:12-04:00,18032,fAJK1wrBhSW297AtFWX2U4rUBf2gkzfQ6UrQL9yHEYW,5pyTFpanSyUCHxeMhJMKtpdrcMSAWc8bFadbyM7q4q4B,True,391250097,97812524,657005,328502,328503,68sueyVfmy5ToEGtLFGDkwebX47xAmzyXE29z8JrmcWv,26280218,40574739,-14294521,671
2022-05-06 11:24:12-04:00,18033,5XcrJqz4M3F7d5SruWRSWLH8zY6cDVwTXbqcA2Y5YLBS,6gJ1xLxAQ1HW4WRpBx7LhHiQuqqdMvLxSdeeNUS5NFsi,True,137206023,34301505,241997,120998,120999,2a35JJeTUW1pm6M3e8DHCjp8qr4vbc2cRPhuzZWyFzYd,9679916,18378489,-8698573,705
2022-05-06 20:03:35-04:00,18034,7GpG8k6hM27vK1R5Sx1v5xUBuF6vybP41dcymjXDi5P7,7Aip6HDcbZ5mvoSucNupRS9enRdGx37F8L432K7V81do,True,5798474630,1449618657,9059136,4529568,4529568,5HnvdJnCCcmRsm4GkXnYWd4q9RpwuvYDGEUMPkYR3Ts9,362365465,1747064435,-1384698970,624
2022-05-06 20:19:38-04:00,18035,DHv4AsHMRZ6DuPaKEr2cLMNsX2ezT75T9haNgsDngS2b,5pMurvHHPdPKg3R96o1fKBbJh2Mc2tBP6P1e3acB31vQ,True,75812941,18953235,117464,58732,58732,68sueyVfmy5ToEGtLFGDkwebX47xAmzyXE29z8JrmcWv,4698597,12768223,-8069626,619
2022-05-06 20:27:41-04:00,18036,DLwEaZipqHmVBD5hc5v1NZtDStHyG4hAMwxywDTGGc2e,28GtwJw67UWfrSKxtuvpzoKzPyKXLgP3GKLm3fHdR566,True,3420704541,855176135,5276193,2638096,2638097,AmTrMPzuTp2BjnjqGNKqz9FTTCdpoKcPAJLwFc8ozcbh,211047750,561434273,-350386523,616
2022-05-06 20:27:41-04:00,18037,12GjTFcAZ5rnnR9DwXDUMmjFoyuFa3txDF4PPA4YoAQq,Ebm7YVYTYyMtEBM4STgbyyLuSFTwnnuFDQ1Wysvtj2vR,True,32054006,8013501,48521,24260,24261,2a35JJeTUW1pm6M3e8DHCjp8qr4vbc2cRPhuzZWyFzYd,1940845,10068358,-8127513,605
2022-05-06 21:25:43-04:00,18038,4T2MDxf43fxhNe8A2aF7G8hFFpPnkeWkMGPRiYVcBo9h,4cjUvZRpju4xAdS8b5CjxhVEk3o52KBGwjkH9hq23u8A,True,154649889,38662472,240192,120096,120096,6L1WYrPiCMyi7XemPww4B4hvpKD1LQKD4RpiSKmrmgSC,9607687,37595810,-27988123,621
2022-05-06 21:27:47-04:00,18039,5vp63gpRmA7mzAj8czoQsMsNHg1773XwYdwi4f5XC4nE,wqgmuTgVubuFucijWBVJU9tqMgGKHy61DVLEDC46q3H,True,62274873,15568718,97248,48624,48624,5HnvdJnCCcmRsm4GkXnYWd4q9RpwuvYDGEUMPkYR3Ts9,3889928,17270013,-13380085,624
2022-05-06 22:36:53-04:00,18040,Bzp3ZUxzRWqW4QoLq9PtKN1HQeSaKXFQrX1G3a4ocrre,H12B3p4v1ZtZ9gaSgpxCJsKXmmEjiqaRZQzexjzAhevo,True,3314979752,378346392,1933830,966915,966915,2xTUy2RS74GJMMDnmFaegMzFLn19RVfYG4CibhBmjP1i,169437565,1030629523,-861191958,511
2022-05-06 23:10:19-04:00,18041,4oMasDRj8HWfknmdwt6Mkz3eonr8J2byoiSTRo4sCnFQ,3emcATkEFvDVETiK97eVET2Z2jzkgiiSxX3gu5wsUKPe,True,17226861504,2034869955,13517796,6758898,6758898,3zqXX6kzhkbW3d4TwD2CNjMRwxTbREXySekvq37kfCNk,1144393570,4769724679,-3625331109,664
2022-05-06 23:28:23-04:00,18042,13GT6eaKWuaLe7wFcybCnUaYgd9DfyzYRN2FcXWgFwpC,CbwmJ7YpnvcqDyUw3L9b7dqXcA8Ju3rYrTdegeaJJbWC,True,147765510,36941377,228234,114117,114117,5HnvdJnCCcmRsm4GkXnYWd4q9RpwuvYDGEUMPkYR3Ts9,9129387,86586026,-77456639,617
2022-05-06 23:28:30-04:00,18043,E6aP64uFjkpvGaWYCAzW95RuURXmGGiCr63yzT8D8Bch,AVLR8LDxMvpjSU4XP7J5JoY8XwFyVu3YqEU45hzp2r8Z,True,17456445,4364111,26864,13432,13432,68sueyVfmy5ToEGtLFGDkwebX47xAmzyXE29z8JrmcWv,1074572,11743264,-10668692,615
2022-05-06 23:29:08-04:00,18044,HDMvxWha3zz9uPwZMRXWJYZNhTHxzwHMoYX4Raog1i31,4erL3sEBdK32eYY5w8vaeih9r1uC1vCrbsV8NxR4asEa,False,12720609,12720609,789201,39460,749741,YQC4EUcgeBi9431viwvzvBbZJW3szeHX4dFmowRDyDw,789201,9162611,-8373410,620
2022-05-06 23:29:26-04:00,18045,5XaryzRdShE48K6xMLJop7ieQVC7gp55MLG5UJ5C6mHA,BpessMA9vcqZMZKdAnR5JsDy6Y4qNpGNnPEc3nKDZLNY,True,17844897,4461224,27802,13901,13901,68sueyVfmy5ToEGtLFGDkwebX47xAmzyXE29z8JrmcWv,1112093,11392305,-10280212,623
2022-05-06 23:31:20-04:00,18046,D8BtQirMEk3W9Pq29B6KkKWrwPfmsUNpwz5npx7aGMLY,J7LMZwaSoh5hbGcwee6oPsnN4ZFD7Zp3LQWkJGNUHRfJ,True,123348801,30837200,206487,103243,103244,6L1WYrPiCMyi7XemPww4B4hvpKD1LQKD4RpiSKmrmgSC,8259502,53602303,-45342801,669
2022-05-06 23:31:26-04:00,18047,4oMasDRj8HWfknmdwt6Mkz3eonr8J2byoiSTRo4sCnFQ,3emcATkEFvDVETiK97eVET2Z2jzkgiiSxX3gu5wsUKPe,True,15051969154,2265242045,14911820,7455910,7455910,72XWPCtRYEDZbddP7d6dHtUBRRDLSJsB2xZTAfefoEVZ,990853379,4235820092,-3244966713,658
2022-05-06 23:31:29-04:00,18048,7qxGLMg6ZAxkVjhuj2PY6a5F36k4Efo3aCa99kvTpSKw,wgWcmEebBLbcm9a2jyCiw8nzqbGbfj6zRou4ZZhfWp7,True,106800595,16796623,93325,46662,46663,5HnvdJnCCcmRsm4GkXnYWd4q9RpwuvYDGEUMPkYR3Ts9,5934095,17772099,-11838004,555
2022-05-06 23:31:50-04:00,18049,BhhVhLVZkSd3aHDMd6ojTgtJtbgAdMCA9Xj8jL2GMXoL,G8HUQp2yGSw9T6it5ej91cqkd82naca8heji453g2jEH,True,93549919,16880031,66047,33023,33024,68sueyVfmy5ToEGtLFGDkwebX47xAmzyXE29z8JrmcWv,3660431,46305167,-42644736,391
2022-05-06 23:58:00-04:00,18050,7GpG8k6hM27vK1R5Sx1v5xUBuF6vybP41dcymjXDi5P7,7Aip6HDcbZ5mvoSucNupRS9enRdGx37F8L432K7V81do,True,4257359032,1064339758,6536092,3268046,3268046,6UQfSsLooL4pQKQfLtXCutQS2BnF7A7F7ewJopDLmUpc,261443701,1391762400,-1130318699,614
2022-05-06 23:58:04-04:00,18051,DHv4AsHMRZ6DuPaKEr2cLMNsX2ezT75T9haNgsDngS2b,5pMurvHHPdPKg3R96o1fKBbJh2Mc2tBP6P1e3acB31vQ,True,55717906,13929476,85863,42931,42932,5HnvdJnCCcmRsm4GkXnYWd4q9RpwuvYDGEUMPkYR3Ts9,3434540,10628606,-7194066,616
2022-05-06 23:58:05-04:00,18052,G7QeYEH5Et1mB2imz2J7ne8MeVhXzYxpdFee6yRD8MeJ,9K1u2L1cidicuNFqQjJnEwzVjEjG81Ka5bEKCkWxCkjT,True,33900886,8475221,51815,25907,25908,68sueyVfmy5ToEGtLFGDkwebX47xAmzyXE29z8JrmcWv,2072602,9805052,-7732450,611
2022-05-07 00:07:01-04:00,18053,9BjYvRf5A9UK99LvPTHd5DRvxMn2FWYKb5fpDxYDL48S,4kMo5gLVscVqwx6xQTLrn9JaEq1dFqq5Vfiq3Vb15vhi,True,17899773,4474943,27946,13973,13973,5HnvdJnCCcmRsm4GkXnYWd4q9RpwuvYDGEUMPkYR3Ts9,1117853,11343260,-10225407,624
2022-05-07 00:07:02-04:00,18054,EvyJwXTqP5N4qPKwDiDTCfjLYgLWz1qEREsarcsZdhYD,CbnajpQJxW3fWpH9dohsipVnZJyUvqy5dYSRDBBaDeEp,True,17899756,4474939,27953,13976,13977,6L1WYrPiCMyi7XemPww4B4hvpKD1LQKD4RpiSKmrmgSC,1118147,11343807,-10225660,624
2022-05-07 00:07:03-04:00,18055,Ga6hKu2mWpMqDboq3ZajdiittrTvDqX9kqMDt2fi3t29,3zUEyHaYdzLGMZxDj2EZLCA6NzL7Ub9BGpE5PGGnw2GD,True,17333095,4333273,26820,13410,13410,YQC4EUcgeBi9431viwvzvBbZJW3szeHX4dFmowRDyDw,1072815,11865091,-10792276,618
2022-05-07 00:08:52-04:00,18056,12GjTFcAZ5rnnR9DwXDUMmjFoyuFa3txDF4PPA4YoAQq,Ebm7YVYTYyMtEBM4STgbyyLuSFTwnnuFDQ1Wysvtj2vR,True,23627323,5906830,36905,18452,18453,68sueyVfmy5ToEGtLFGDkwebX47xAmzyXE29z8JrmcWv,1476227,7985054,-6508827,624
2022-05-07 00:09:13-04:00,18057,BhhVhLVZkSd3aHDMd6ojTgtJtbgAdMCA9Xj8jL2GMXoL,G8HUQp2yGSw9T6it5ej91cqkd82naca8heji453g2jEH,True,76206249,6432190,26406,13203,13203,6L1WYrPiCMyi7XemPww4B4hvpKD1LQKD4RpiSKmrmgSC,3128593,37496869,-34368276,410
2022-05-07 00:10:24-04:00,18058,4oMasDRj8HWfknmdwt6Mkz3eonr8J2byoiSTRo4sCnFQ,3emcATkEFvDVETiK97eVET2Z2jzkgiiSxX3gu5wsUKPe,True,12652723358,1488077207,9899894,4949947,4949947,GXyFXZMNk2NFyEzw6JetVqsujqcz2yCixH7n8EpDJYWD,841761655,3836413195,-2994651540,665
2022-05-07 00:10:35-04:00,18059,DLwEaZipqHmVBD5hc5v1NZtDStHyG4hAMwxywDTGGc2e,28GtwJw67UWfrSKxtuvpzoKzPyKXLgP3GKLm3fHdR566,True,2517137109,629284277,3926718,1963359,1963359,3zqXX6kzhkbW3d4TwD2CNjMRwxTbREXySekvq37kfCNk,157068747,468342569,-311273822,623
2022-05-07 00:12:11-04:00,18060,D8BtQirMEk3W9Pq29B6KkKWrwPfmsUNpwz5npx7aGMLY,J7LMZwaSoh5hbGcwee6oPsnN4ZFD7Zp3LQWkJGNUHRfJ,True,90777099,22694274,157990,78995,78995,C4UnXuShCvjSMgBAgVNMy1oakxCNk1et27A82fywU112,6319628,42063127,-35743499,696
2022-05-07 00:12:12-04:00,18061,EVMrznfJS54BZiywDD2WhUtxzicDtbEpm2a5yLrtCgRF,CpzsMYVYvKg8ihrX1cKRw7TDEYwD3kAyiX92hsf2KiTz,True,6053155473,674191059,3774500,1887250,1887250,gjBMZYVujDjD1ECG4i97M8Q3gV9ESnwwTSUGropkusj,338889640,3774467316,-3435577676,559
2022-05-07 00:12:13-04:00,18062,4T2MDxf43fxhNe8A2aF7G8hFFpPnkeWkMGPRiYVcBo9h,4cjUvZRpju4xAdS8b5CjxhVEk3o52KBGwjkH9hq23u8A,True,113701767,28425441,176763,88381,88382,5HnvdJnCCcmRsm4GkXnYWd4q9RpwuvYDGEUMPkYR3Ts9,7070545,30347491,-23276946,621
2022-05-07 00:12:23-04:00,18063,qDomXCaxa3BBJSuLnKRAHvBLMbMcWAzUNXtGDZTSD8F,57ch9yViUFJCGJcWUvNEDU1yGzC6AvPh4Ac3ynWZzLf1,False,12940857,12940857,807848,40392,767456,5HnvdJnCCcmRsm4GkXnYWd4q9RpwuvYDGEUMPkYR3Ts9,807848,8960896,-8153048,624
2022-05-07 00:12:25-04:00,18064,4YNWVEq2F3gR8XEbUQxJRqzi6i5KSfwf6mVMLPJrnpEd,EE5uomX5guX4ZeHiP6wcoH5C8k3tRGXo18JTWgNDqs1C,True,17903457,4475864,27502,13751,13751,5HnvdJnCCcmRsm4GkXnYWd4q9RpwuvYDGEUMPkYR3Ts9,1100087,11321996,-10221909,614
2022-05-07 00:12:27-04:00,18065,2pcVNktE3dbyybTuEBSkdwWJS5sFcvYLMEKRQMwZy6eh,61GaKj6fDApZF9B3aTBxTzYk8e22XLFPsQ21pJdvDhBL,True,17903439,4475859,27526,13763,13763,68sueyVfmy5ToEGtLFGDkwebX47xAmzyXE29z8JrmcWv,1101075,11322762,-10221687,615
2022-05-07 00:12:27-04:00,18066,9V7DXwq3RnVnLqRmtWXQJZgU3nHyVMteXAvaVaW3g1b6,94zfTWn693sbx9aaxamLUSHsbXdYxLpZVTvnetJ3SnhT,True,17915724,4478931,27740,13870,13870,C4UnXuShCvjSMgBAgVNMy1oakxCNk1et27A82fywU112,1109621,11319300,-10209679,619
2022-05-07 00:12:29-04:00,18067,7FL3AxJZcTiCG6Ux7CVc82Nqo4msgmQASGvjfMEgQddc,EzcAwNya2eA7GD8ezmi49bEUP57Fq3w9SwN3uAG4HA2b,True,17902161,4475540,27900,13950,13950,C4UnXuShCvjSMgBAgVNMy1oakxCNk1et27A82fywU112,1116019,11327284,-10211265,623
2022-05-07 00:12:31-04:00,18068,BAe9q4b1UwvQi5BHTmVh2GRguY3f9a5fbzXV2WiB93Ag,9uSCD3c3vHYC1i6odskxdugUaoSE5QYA1e8wkkW6aX5W,True,17911970,4477992,27904,13952,13952,6L1WYrPiCMyi7XemPww4B4hvpKD1LQKD4RpiSKmrmgSC,1116166,11329361,-10213195,623
2022-05-07 00:12:34-04:00,18069,5vp63gpRmA7mzAj8czoQsMsNHg1773XwYdwi4f5XC4nE,wqgmuTgVubuFucijWBVJU9tqMgGKHy61DVLEDC46q3H,True,45777832,11444458,71495,35747,35748,5HnvdJnCCcmRsm4GkXnYWd4q9RpwuvYDGEUMPkYR3Ts9,2859801,13823222,-10963421,624
2022-05-07 00:12:36-04:00,18070,68zbVKnneMQqngbNkeLtPEP2ayNhawc1B2hPgqAEqgXK,HqiFpLr4NC7xJz9bEFusq8bCKaoxAQG1xsLxdUAzg8aa,True,55217934,4984067,19847,9923,9924,5HnvdJnCCcmRsm4GkXnYWd4q9RpwuvYDGEUMPkYR3Ts9,2198907,28592221,-26393314,398
2022-05-07 00:12:51-04:00,18071,EneQUyUwfKFNwfdgNRdZBdX2frHixmVDK2GxDRU78QB,Gk8BVo53foZz1tMdLf85ZKpAPeLFZbCqwM6KYhmN6WNc,False,12914729,12914729,803386,40169,763217,5HnvdJnCCcmRsm4GkXnYWd4q9RpwuvYDGEUMPkYR3Ts9,803386,8982736,-8179350,622
2022-05-07 00:12:51-04:00,18072,G85GTorkDswyxv8uxgpP1tr6DbXktiXjjX14VA4L2VVu,3EJ5raXpu6eveda4FjxAeWFNbDbQkgjyKfoFq183UeLC,True,17868793,4467198,27843,13921,13922,YQC4EUcgeBi9431viwvzvBbZJW3szeHX4dFmowRDyDw,1113734,11327253,-10213519,623
2022-05-07 00:16:59-04:00,18073,7GpG8k6hM27vK1R5Sx1v5xUBuF6vybP41dcymjXDi5P7,7Aip6HDcbZ5mvoSucNupRS9enRdGx37F8L432K7V81do,True,3133696047,783424011,4886667,2443333,2443334,GXyFXZMNk2NFyEzw6JetVqsujqcz2yCixH7n8EpDJYWD,195466712,1102694571,-907227859,623
2022-05-07 00:17:09-04:00,18074,BhhVhLVZkSd3aHDMd6ojTgtJtbgAdMCA9Xj8jL2GMXoL,G8HUQp2yGSw9T6it5ej91cqkd82naca8heji453g2jEH,True,69383530,12592062,49212,24606,24606,6L1WYrPiCMyi7XemPww4B4hvpKD1LQKD4RpiSKmrmgSC,2711658,35474187,-32762529,390
2022-05-07 00:17:12-04:00,18075,DHv4AsHMRZ6DuPaKEr2cLMNsX2ezT75T9haNgsDngS2b,5pMurvHHPdPKg3R96o1fKBbJh2Mc2tBP6P1e3acB31vQ,True,40979524,10244881,63455,31727,31728,C4UnXuShCvjSMgBAgVNMy1oakxCNk1et27A82fywU112,2538229,8742711,-6204482,619
2022-05-07 00:17:12-04:00,18076,G7QeYEH5Et1mB2imz2J7ne8MeVhXzYxpdFee6yRD8MeJ,9K1u2L1cidicuNFqQjJnEwzVjEjG81Ka5bEKCkWxCkjT,True,24961631,6240407,38895,19447,19448,C4UnXuShCvjSMgBAgVNMy1oakxCNk1et27A82fywU112,1555814,7819196,-6263382,623
2022-05-07 00:17:13-04:00,18077,4oMasDRj8HWfknmdwt6Mkz3eonr8J2byoiSTRo4sCnFQ,3emcATkEFvDVETiK97eVET2Z2jzkgiiSxX3gu5wsUKPe,True,11063172824,1652356809,10908825,5454412,5454413,GXyFXZMNk2NFyEzw6JetVqsujqcz2yCixH7n8EpDJYWD,730388434,3394803537,-2664415103,660
2022-05-07 00:17:15-04:00,18078,68zbVKnneMQqngbNkeLtPEP2ayNhawc1B2hPgqAEqgXK,HqiFpLr4NC7xJz9bEFusq8bCKaoxAQG1xsLxdUAzg8aa,True,50091618,4635062,18846,9423,9423,5HnvdJnCCcmRsm4GkXnYWd4q9RpwuvYDGEUMPkYR3Ts9,2036811,25495682,-23458871,406
2022-05-07 00:17:44-04:00,18079,9VojCEgzn99QRVPGKn6euGRQbM7Q86GZ6yHJQa7N3gv4,GW4GVNnUtEt68avsowddpmjoUTUyMvxV4c5kY3Gzz9fT,True,21715548,1905412,11899,5949,5950,6L1WYrPiCMyi7XemPww4B4hvpKD1LQKD4RpiSKmrmgSC,1356238,15426841,-14070603,624
2022-05-07 00:17:44-04:00,18080,12GjTFcAZ5rnnR9DwXDUMmjFoyuFa3txDF4PPA4YoAQq,Ebm7YVYTYyMtEBM4STgbyyLuSFTwnnuFDQ1Wysvtj2vR,True,17365387,4341346,27105,13552,13553,5HnvdJnCCcmRsm4GkXnYWd4q9RpwuvYDGEUMPkYR3Ts9,1084216,6320948,-5236732,624
2022-05-07 00:18:25-04:00,18081,29JVska5UEG3axs63EmtHpPvkswNEqYpZ3PKMSfupiAG,DCftNBUsuogxyaJe9G9m3eWipH6o3qo4Rn4TuQXdVaBF,True,361502356,90375589,538684,269342,269342,6L1WYrPiCMyi7XemPww4B4hvpKD1LQKD4RpiSKmrmgSC,21547382,61769873,-40222491,596
2022-05-07 00:19:28-04:00,18082,DLwEaZipqHmVBD5hc5v1NZtDStHyG4hAMwxywDTGGc2e,28GtwJw67UWfrSKxtuvpzoKzPyKXLgP3GKLm3fHdR566,True,1849997904,462499476,2882177,1441088,1441089,72XWPCtRYEDZbddP7d6dHtUBRRDLSJsB2xZTAfefoEVZ,115287101,386649011,-271361910,623
2022-05-07 00:21:02-04:00,18083,68zbVKnneMQqngbNkeLtPEP2ayNhawc1B2hPgqAEqgXK,HqiFpLr4NC7xJz9bEFusq8bCKaoxAQG1xsLxdUAzg8aa,True,45336931,2090089,8751,4375,4376,6L1WYrPiCMyi7XemPww4B4hvpKD1LQKD4RpiSKmrmgSC,1898340,24129516,-22231176,418
2022-05-07 00:21:11-04:00,18084,FuhTkUxSaJ7kvuu9LHZaPVfdbKAQSh9W8Zzso1XPKGZp,FLoqPzREreKfRCwqtXs3CJwpTSudmXrVYCRZadWvob7j,True,1988393656,497098414,1502430,751215,751215,A2p75MbAbeUdHkPLkAjgGeiwuu9WPrkMHzjCkDXF1Xr3,60097224,635197294,-575100070,302
2022-05-07 00:27:16-04:00,18085,4T2MDxf43fxhNe8A2aF7G8hFFpPnkeWkMGPRiYVcBo9h,4cjUvZRpju4xAdS8b5CjxhVEk3o52KBGwjkH9hq23u8A,True,83605030,20901257,130562,65281,65281,68sueyVfmy5ToEGtLFGDkwebX47xAmzyXE29z8JrmcWv,5222486,24351605,-19129119,624
2022-05-07 00:39:47-04:00,18086,5vp63gpRmA7mzAj8czoQsMsNHg1773XwYdwi4f5XC4nE,wqgmuTgVubuFucijWBVJU9tqMgGKHy61DVLEDC46q3H,True,33647982,8411995,52572,26286,26286,5HnvdJnCCcmRsm4GkXnYWd4q9RpwuvYDGEUMPkYR3Ts9,2102914,11010891,-8907977,624
2022-05-07 00:40:35-04:00,18087,3S97kmJCtH7xQsdt7jsSyncXZiDQ9W8D8Pe3eT98Xopo,TvE4rh5GFsaAYo4MpkueYkuDPjbbuFmsBCdYyfAikLg,False,13185790,13185790,818441,40922,777519,2a35JJeTUW1pm6M3e8DHCjp8qr4vbc2cRPhuzZWyFzYd,818441,8726552,-7908111,620
2022-05-07 00:47:31-04:00,18088,HXQXfEQe7aCpr6WKh37XaDZsjZcuQPk5t8tWNFgEoK6U,5ufXkCEDwgiXwtyPye4wYVVA3oLW54JVzz4tnXFofto4,True,21657319415,5414329853,16312839,8156419,8156420,A9TwRM1BMxqb8DCC7YNAMV6zPenEJm3HTZBy7wJKK58U,652513564,6682631447,-6030117883,301
2022-05-07 00:47:34-04:00,18089,H7wVZszBQdmFuwMUYAw4SSYbjxeFY1QvNBuT8QiqTxZS,CUm235keNKnVd2BaCNp5a6HePtWGMo8dq8S1KXf2KRR4,True,41444718,10361179,30943,15471,15472,5HnvdJnCCcmRsm4GkXnYWd4q9RpwuvYDGEUMPkYR3Ts9,1237759,2826262,-1588503,298
2022-05-07 00:49:16-04:00,18090,BhhVhLVZkSd3aHDMd6ojTgtJtbgAdMCA9Xj8jL2GMXoL,G8HUQp2yGSw9T6it5ej91cqkd82naca8heji453g2jEH,True,56440416,4690523,19208,9604,9604,5HnvdJnCCcmRsm4GkXnYWd4q9RpwuvYDGEUMPkYR3Ts9,2311394,28801914,-26490520,409
2022-05-07 00:50:24-04:00,18091,A7j77tzgnQVGtHTa65VtVZqJRYeJvQk7am8NW6e66379,4vJGwEvXU2tGWoWWGwbsYcfKQAMCHbrBMRk4ZVFzneLs,True,17392646869,4348161717,13165330,6582665,6582665,6UQfSsLooL4pQKQfLtXCutQS2BnF7A7F7ewJopDLmUpc,526613221,3123615844,-2597002623,302
2022-05-07 00:50:25-04:00,18092,E3LF7ohKS87kHLW78ViuRuyw7EMuiW3nVn5PRdhU7iBj,DMVXNy2NLb8jMuznjx2syKqvzctrNmQ3PfiUA83CeQR4,True,118141813,29535453,88024,44012,44012,C4UnXuShCvjSMgBAgVNMy1oakxCNk1et27A82fywU112,3520997,36217442,-32696445,298
2022-05-07 00:50:26-04:00,18093,HqtTbC1LFreGvgfpZe7nCqkNnh8GHPQKosfmc19zb1yi,E39UNiHNkwQEd5GXkCtTPqSorQSB1kLx8kjzK4jdFoi3,True,257666364,64416591,194049,97024,97025,6L1WYrPiCMyi7XemPww4B4hvpKD1LQKD4RpiSKmrmgSC,7761962,50453553,-42691591,301
2022-05-07 00:50:58-04:00,18094,5zqXqEjg95BnghcVbHRhYkSTYnzZjUBichgccv1BpS3d,9SuqSxrKpHh9NcNePe4Q3jXvpCmhNnoQv8YAFih3CqMX,True,759340881,189835220,572450,286225,286225,72XWPCtRYEDZbddP7d6dHtUBRRDLSJsB2xZTAfefoEVZ,22898004,233758789,-210860785,301
2022-05-07 00:57:26-04:00,18095,EVMrznfJS54BZiywDD2WhUtxzicDtbEpm2a5yLrtCgRF,CpzsMYVYvKg8ihrX1cKRw7TDEYwD3kAyiX92hsf2KiTz,True,5338594295,529286856,2922204,1461102,1461102,AmTrMPzuTp2BjnjqGNKqz9FTTCdpoKcPAJLwFc8ozcbh,294745021,3376172885,-3081427864,552
2022-05-07 00:57:26-04:00,18096,AsRi72uQLsBnyQxMBnPEhyQNM7XyNk2RV9GzPMe8PysA,9MqsYTBn6P9zCi5bGCrZurWWysW8XQZJwndHsb227rEW,True,186813682,46703420,141433,70716,70717,C4UnXuShCvjSMgBAgVNMy1oakxCNk1et27A82fywU112,5657329,56926317,-51268988,302
2022-05-07 00:57:26-04:00,18097,13GT6eaKWuaLe7wFcybCnUaYgd9DfyzYRN2FcXWgFwpC,CbwmJ7YpnvcqDyUw3L9b7dqXcA8Ju3rYrTdegeaJJbWC,True,108674117,27168529,168298,84149,84149,5HnvdJnCCcmRsm4GkXnYWd4q9RpwuvYDGEUMPkYR3Ts9,6731957,66975113,-60243156,619
2022-05-07 00:57:28-04:00,18098,5xkW7wHTcF5WadNtBBqKPKctVwyQtTqqscivAmxzseCk,7m31ZMZdCn5Gz2q5sETWA7uKA5LsKD7pJHBBqU3g7tCn,True,70087978,17521994,53027,26513,26514,5HnvdJnCCcmRsm4GkXnYWd4q9RpwuvYDGEUMPkYR3Ts9,2121101,13755846,-11634745,302
2022-05-07 00:57:47-04:00,18099,Fczxdc24Eav8xcaKRDwWMEwPEzkGyEJ7qGcXYyGZFKVz,8GqweYpec4cnpaJvueF3FGWoaz72BAzpLYXBX7tuuqEt,True,1706712148,426678037,1290349,645174,645175,A9TwRM1BMxqb8DCC7YNAMV6zPenEJm3HTZBy7wJKK58U,51613974,967683009,-916069035,302
2022-05-07 00:58:06-04:00,18100,rTizTweTeG3Li3BFLmtr6GmcHBs9FTcwsPKCWezWmnR,76CqzaphEXgjo9pzBKttaErJ5e9xoZaRKp5ZNB5JCf4x,True,722733142,180683285,533218,266609,266609,A9TwRM1BMxqb8DCC7YNAMV6zPenEJm3HTZBy7wJKK58U,21328736,72915556,-51586820,295
2022-05-07 00:58:10-04:00,18101,4oMasDRj8HWfknmdwt6Mkz3eonr8J2byoiSTRo4sCnFQ,3emcATkEFvDVETiK97eVET2Z2jzkgiiSxX3gu5wsUKPe,True,9299438273,1100911840,7198999,3599499,3599500,GXyFXZMNk2NFyEzw6JetVqsujqcz2yCixH7n8EpDJYWD,608101867,3048773077,-2440671210,653
2022-05-07 00:58:11-04:00,18102,BWta2HTjCwDidjsgv1vPoD3gCHSGf679N1xijEj5jzD3,JEFa5ojXJ95W2NsV5j8qBENTm5n1uGfPDFwLRvebHDVn,True,29207287,7301821,45573,22786,22787,5HnvdJnCCcmRsm4GkXnYWd4q9RpwuvYDGEUMPkYR3Ts9,1822936,15822154,-13999218,624
2022-05-07 00:58:19-04:00,18103,8DSiP9CwJm3AEcH6uuAYFpArRRDLYpDQgjHEvjkUgfg2,ERJ8kuhPRRmUAhSM4oxUheh39YUVVYNgaTt6AdMXcCvL,True,637970463,159492615,470117,235058,235059,2py1FiYeL2f7J3HU36qiJz6TD6HCmiTN36RyxYtapQCZ,18804688,195749250,-176944562,294
2022-05-07 00:58:19-04:00,18104,2HtcCr92gzqZEmnEYKrsC2d2euFz7djLYzqnbDSbhd82,3wKxFATyaQK6kZd2UahQjvL9tzMGuN2767EguLmj1bot,True,27825355,6956333,43049,21524,21525,6L1WYrPiCMyi7XemPww4B4hvpKD1LQKD4RpiSKmrmgSC,1722003,8439200,-6717197,618
2022-05-07 00:58:20-04:00,18105,BmFSXZx3HWaTtD7vp7AkUk5DUNjwK1qgLPod13EJz6No,DtLMfV3Xs7AAAQqC1PwL7YAfV6fig8yAMxr9MMxmyCKc,False,28626581,28626581,822181,41109,781072,5HnvdJnCCcmRsm4GkXnYWd4q9RpwuvYDGEUMPkYR3Ts9,822181,5151271,-4329090,287
2022-05-07 00:58:21-04:00,18106,68zbVKnneMQqngbNkeLtPEP2ayNhawc1B2hPgqAEqgXK,HqiFpLr4NC7xJz9bEFusq8bCKaoxAQG1xsLxdUAzg8aa,True,43095590,2030450,8190,4095,4095,68sueyVfmy5ToEGtLFGDkwebX47xAmzyXE29z8JrmcWv,1738337,23191959,-21453622,403
2022-05-07 00:58:21-04:00,18107,gCNpMXEHPTLvMvyyaYCLJrd8RRGnKAHz7sBD5j7yyBt,9cRU1ZAZRT5Ei4YAmCrPJZMHGsWspcYXTuZH58iexwDv,True,200993157,50248289,143518,71759,71759,5HnvdJnCCcmRsm4GkXnYWd4q9RpwuvYDGEUMPkYR3Ts9,5740741,34337458,-28596717,285
2022-05-07 00:58:22-04:00,18108,GpDhvRRae2uiRZ6MnJYnVR2hANNLGFGUDnsQmGjfK8AP,B2pgJ4gPdgzvx2HMJ1wagtthpZebtBk7RD3cF1zqSyT8,True,819519342,204879835,619381,309690,309691,AmTrMPzuTp2BjnjqGNKqz9FTTCdpoKcPAJLwFc8ozcbh,24775249,268398884,-243623635,302
2022-05-07 00:58:22-04:00,18109,5nALef7nAfNkSQSuTBLwewDby4pUx74Gzqib33Znmmt6,8xNTWK2xNK2xZPpgXfcE4QxPT2i6YvNYakiLgdQ2FqEt,True,596150908,149037727,436161,218080,218081,3zqXX6kzhkbW3d4TwD2CNjMRwxTbREXySekvq37kfCNk,17446462,35282543,-17836081,292
2022-05-07 00:58:22-04:00,18110,82EMpA1hwF9KNQy2ZB2A1HdoEowBu2CoYhW3VmohkSnk,hn67zsTzsAs2aqk6ZjfEeoRygd3CdMeCuR82h9yuiz3,True,453394164,113348541,332853,166426,166427,DA18qE9qesbBqpwNv1M4befYcNQkbSBSeLPTmQzrmbJw,13314130,134337621,-121023491,293
2022-05-07 00:58:26-04:00,18111,4ZF1wtHKAnxmEZGACgbgphHvuo5aK4wC4MCNJzLYVkMX,5UXyhRP3Rjsc1RbV8BouJVQoTbWWbuPtVJY15KcHJFCN,True,70583707,17645926,51775,25887,25888,C4UnXuShCvjSMgBAgVNMy1oakxCNk1et27A82fywU112,2071023,22252473,-20181450,293
2022-05-07 00:58:27-04:00,18112,Gwj6CMXQeoWVsmD775Knsm6BmWuysFvSKo78FRLQByb4,6cvChMYj7TfDcnc8hG9H89PABJr2svspqjJSdSGD4RUt,True,26184867,3114867,19409,9704,9705,68sueyVfmy5ToEGtLFGDkwebX47xAmzyXE29z8JrmcWv,1631714,7023463,-5391749,623
2022-05-07 00:58:45-04:00,18113,EMFbiJWcw1YdjiDmxj5CsHMyswXyyHeL7cfWKa8dMzHh,2LjnVQF8WSwL8XSNVypW9SouYSRbyH9A7gcw7BFtxuXS,True,200827322,50206830,150699,75349,75350,2a35JJeTUW1pm6M3e8DHCjp8qr4vbc2cRPhuzZWyFzYd,6027991,63053959,-57025968,300
2022-05-07 00:58:47-04:00,18114,HT2SuCbePhjNZaar24uVwihYowCNvSjdvhJ8BRSVw9nX,98Ts4LCnapHVoCJ5PW3Armvh4jvDtpfs3SYRLRxiAgzZ,True,308386255,41992062,195637,97818,97819,5HnvdJnCCcmRsm4GkXnYWd4q9RpwuvYDGEUMPkYR3Ts9,14367469,124989383,-110621914,465
2022-05-07 00:59:20-04:00,18115,E6aP64uFjkpvGaWYCAzW95RuURXmGGiCr63yzT8D8Bch,AVLR8LDxMvpjSU4XP7J5JoY8XwFyVu3YqEU45hzp2r8Z,False,12843066,12843066,796172,39808,756364,68sueyVfmy5ToEGtLFGDkwebX47xAmzyXE29z8JrmcWv,796172,9046970,-8250798,619
2022-05-07 00:59:47-04:00,18116,9VojCEgzn99QRVPGKn6euGRQbM7Q86GZ6yHJQa7N3gv4,GW4GVNnUtEt68avsowddpmjoUTUyMvxV4c5kY3Gzz9fT,True,19696037,1866193,11656,5828,5828,68sueyVfmy5ToEGtLFGDkwebX47xAmzyXE29z8JrmcWv,1230240,14350555,-13120315,624
2022-05-07 01:00:27-04:00,18117,87yYQuRW91LAqEmqEyYah7obsr4KijRrqsKdK7DGA9w,EJzredSumMNBMTYxMMHocKayWKg3A3621QJ3ArJqro8r,True,59598891,14899722,44926,22463,22463,68sueyVfmy5ToEGtLFGDkwebX47xAmzyXE29z8JrmcWv,1797047,18525160,-16728113,301
2022-05-07 01:00:27-04:00,18118,BhhVhLVZkSd3aHDMd6ojTgtJtbgAdMCA9Xj8jL2GMXoL,G8HUQp2yGSw9T6it5ej91cqkd82naca8heji453g2jEH,True,51454426,9352480,36251,18125,18126,6L1WYrPiCMyi7XemPww4B4hvpKD1LQKD4RpiSKmrmgSC,1994449,27149606,-25155157,387
2022-05-07 01:00:27-04:00,18119,5XaryzRdShE48K6xMLJop7ieQVC7gp55MLG5UJ5C6mHA,BpessMA9vcqZMZKdAnR5JsDy6Y4qNpGNnPEc3nKDZLNY,False,13114228,13114228,809574,40478,769096,68sueyVfmy5ToEGtLFGDkwebX47xAmzyXE29z8JrmcWv,809574,8789189,-7979615,617
2022-05-07 01:00:28-04:00,18120,9XmuJX8mFX29c5uh68kK7ff1mPdvs1orJAgEP6BsVKnq,HfPpizwUoK6uEmMb9LWi464BnvjHQY9cuPppFMp1DKDA,True,109338854,27334713,82694,41347,41347,68sueyVfmy5ToEGtLFGDkwebX47xAmzyXE29z8JrmcWv,3307770,15489588,-12181818,302
2022-05-07 01:00:28-04:00,18121,BKmKy8n1MpB1sdSfuWy7P3c6ReSW8TEWZRsyriz3ujYo,FgRpiZFPz43vDWStgCwRJACiGKtMLkWbTGeTLPeKnnaY,True,201308717,50327179,151279,75639,75640,gjBMZYVujDjD1ECG4i97M8Q3gV9ESnwwTSUGropkusj,6051187,62563576,-56512389,300
2022-05-07 01:00:32-04:00,18122,FuhTkUxSaJ7kvuu9LHZaPVfdbKAQSh9W8Zzso1XPKGZp,FLoqPzREreKfRCwqtXs3CJwpTSudmXrVYCRZadWvob7j,True,1476684404,369171101,1098055,549027,549028,6L1WYrPiCMyi7XemPww4B4hvpKD1LQKD4RpiSKmrmgSC,43922211,489901428,-445979217,297
2022-05-07 01:00:32-04:00,18123,64Diz8zzEv1jDWnBQPTHPpXwaWf7vjM19RyJmkPy1viQ,G8wkGHRHMtT3mvXBkH3zgsKNs8wbpdiPUS17y4cozhkZ,True,109282703,27320675,168759,84379,84380,5HnvdJnCCcmRsm4GkXnYWd4q9RpwuvYDGEUMPkYR3Ts9,6750373,20317233,-13566860,617
2022-05-07 01:00:34-04:00,18124,HCAGpyYM2NYudMd55Geta13tUbS6eiygnJY5ULHsHAVa,3PPyWhqXrmifWPieLV34bZ1rzi8eEnrDDAF7ifXkXspn,True,119753224,9324542,40018,20009,20009,68sueyVfmy5ToEGtLFGDkwebX47xAmzyXE29z8JrmcWv,5139541,48749442,-43609901,429
2022-05-07 01:00:34-04:00,18125,68zbVKnneMQqngbNkeLtPEP2ayNhawc1B2hPgqAEqgXK,HqiFpLr4NC7xJz9bEFusq8bCKaoxAQG1xsLxdUAzg8aa,True,40967749,3696463,14717,7358,7359,6L1WYrPiCMyi7XemPww4B4hvpKD1LQKD4RpiSKmrmgSC,1631134,21871852,-20240718,398
2022-05-07 02:50:27-04:00,18126,7GpG8k6hM27vK1R5Sx1v5xUBuF6vybP41dcymjXDi5P7,7Aip6HDcbZ5mvoSucNupRS9enRdGx37F8L432K7V81do,True,2303309981,575827495,3584118,1792059,1792059,A2p75MbAbeUdHkPLkAjgGeiwuu9WPrkMHzjCkDXF1Xr3,143364721,870839962,-727475241,622
2022-05-07 02:51:18-04:00,18127,DHv4AsHMRZ6DuPaKEr2cLMNsX2ezT75T9haNgsDngS2b,5pMurvHHPdPKg3R96o1fKBbJh2Mc2tBP6P1e3acB31vQ,True,30144013,7536003,47020,23510,23510,6L1WYrPiCMyi7XemPww4B4hvpKD1LQKD4RpiSKmrmgSC,1880825,7124831,-5244006,623
2022-05-07 02:52:27-04:00,18128,G7QeYEH5Et1mB2imz2J7ne8MeVhXzYxpdFee6yRD8MeJ,9K1u2L1cidicuNFqQjJnEwzVjEjG81Ka5bEKCkWxCkjT,True,18352581,4588145,28656,14328,14328,5HnvdJnCCcmRsm4GkXnYWd4q9RpwuvYDGEUMPkYR3Ts9,1146255,6212441,-5066186,624
2022-05-07 02:56:50-04:00,18129,12GjTFcAZ5rnnR9DwXDUMmjFoyuFa3txDF4PPA4YoAQq,Ebm7YVYTYyMtEBM4STgbyyLuSFTwnnuFDQ1Wysvtj2vR,False,12762716,12762716,794374,39718,754656,2a35JJeTUW1pm6M3e8DHCjp8qr4vbc2cRPhuzZWyFzYd,794374,4983252,-4188878,622
2022-05-07 02:57:09-04:00,18130,4hyYkR4vX3HuybAHHKyLgfseU7qBB5r5xYZ3Ye4ssNaM,8EKhsSKPiaueXNNgPqpyNkAy64bVYaRqiJE1CdryT9wW,False,7225728,7225728,449616,22480,427136,5HnvdJnCCcmRsm4GkXnYWd4q9RpwuvYDGEUMPkYR3Ts9,449616,1576460,-1126844,622
2022-05-07 03:42:46-04:00,18131,GKbDACVE2yR8WwrMeGfSQuSXLqXR3B1N5YzZ93i5xyeB,B5EEB6xDf7fwwaE6CaJjwsgCNNdUc29tjW1gY2pHiKxq,True,1877928558,223030774,1482515,741257,741258,6L1WYrPiCMyi7XemPww4B4hvpKD1LQKD4RpiSKmrmgSC,124828461,189680522,-64852061,664
2022-05-07 03:46:02-04:00,18132,GKbDACVE2yR8WwrMeGfSQuSXLqXR3B1N5YzZ93i5xyeB,B5EEB6xDf7fwwaE6CaJjwsgCNNdUc29tjW1gY2pHiKxq,True,1679940693,248042492,1639383,819691,819692,68sueyVfmy5ToEGtLFGDkwebX47xAmzyXE29z8JrmcWv,111032055,175479920,-64447865,660
2022-05-07 04:15:08-04:00,18133,7ZYFuMZx2mPLo7MBQC6wGmar8zhrC326eiPS3kogSiYb,X2Ng1YJqAdXRLii2SuczPys6kxjbbw77JPU52SDk3P4,True,577393655,144348413,1029995,514997,514998,2a35JJeTUW1pm6M3e8DHCjp8qr4vbc2cRPhuzZWyFzYd,41199813,34819901,6379912,713
2022-05-07 05:27:06-04:00,18134,4nqsW3XCJxzSsDdQzvE3zeM9nqBv8xVdUG8GxFWn6Edf,6eVvNs2rckFeTGkXZgPEGLYg4rmz3MFtoVNPRNmktcrY,True,1229919775,307479943,2189649,1094824,1094825,2py1FiYeL2f7J3HU36qiJz6TD6HCmiTN36RyxYtapQCZ,87585981,118695016,-31109035,712
2022-05-07 06:16:52-04:00,18135,jLcMvWkdEDweLB1otEdmsnL48kQPF5esSKx5WDzrdei,3VtwkSQaVnPv8MFuyDDj6dGQGnuY5GDUY2wYkBFRkfdF,True,25341529023,6335382255,42871245,21435622,21435623,A9TwRM1BMxqb8DCC7YNAMV6zPenEJm3HTZBy7wJKK58U,1714849836,2873505284,-1158655448,676
2022-05-07 07:15:48-04:00,18136,7ZYFuMZx2mPLo7MBQC6wGmar8zhrC326eiPS3kogSiYb,X2Ng1YJqAdXRLii2SuczPys6kxjbbw77JPU52SDk3P4,True,441910229,110477557,782311,391155,391156,6L1WYrPiCMyi7XemPww4B4hvpKD1LQKD4RpiSKmrmgSC,31292476,35403001,-4110525,708
2022-05-07 07:55:25-04:00,18137,5FewDaMC9U7n5EHcto98GaAmDVxDh5SYimuTP6AtfakM,7DAULUoqV7f9hsBzKEhjQPnWaHSqiMWcBqWcdcadaQv4,True,1710318068,427579517,2637326,1318663,1318663,72XWPCtRYEDZbddP7d6dHtUBRRDLSJsB2xZTAfefoEVZ,105493065,163675910,-58182845,616
2022-05-07 08:13:39-04:00,18138,GKbDACVE2yR8WwrMeGfSQuSXLqXR3B1N5YzZ93i5xyeB,B5EEB6xDf7fwwaE6CaJjwsgCNNdUc29tjW1gY2pHiKxq,True,1067494278,178853113,1223599,611799,611800,5HnvdJnCCcmRsm4GkXnYWd4q9RpwuvYDGEUMPkYR3Ts9,73031166,174346415,-101315249,684
2022-05-07 13:33:31-04:00,18139,6cyefDEH1EqWn2RYGMtLj9CPhjXg5eECHsrm3C8fxurr,4o3XrjY3LA63KkjPtNGbwEuq59qXh8WmuEDsD5mfbtMD,True,1257303094,314325773,1933353,966676,966677,2xTUy2RS74GJMMDnmFaegMzFLn19RVfYG4CibhBmjP1i,77334132,170048492,-92714360,615
2022-05-07 16:03:36-04:00,18140,DLwEaZipqHmVBD5hc5v1NZtDStHyG4hAMwxywDTGGc2e,28GtwJw67UWfrSKxtuvpzoKzPyKXLgP3GKLm3fHdR566,True,1359090809,339772702,2101412,1050706,1050706,2xTUy2RS74GJMMDnmFaegMzFLn19RVfYG4CibhBmjP1i,84056484,316014278,-231957794,618
2022-05-07 16:03:36-04:00,18141,4T2MDxf43fxhNe8A2aF7G8hFFpPnkeWkMGPRiYVcBo9h,4cjUvZRpju4xAdS8b5CjxhVEk3o52KBGwjkH9hq23u8A,True,61447251,15361812,95951,47975,47976,Hu94aiQWvce6THeGyCFqGRPM1pQrK3ihzkcXo1EpJcJL,3838079,19441504,-15603425,624
2022-05-07 16:03:40-04:00,18142,5vp63gpRmA7mzAj8czoQsMsNHg1773XwYdwi4f5XC4nE,wqgmuTgVubuFucijWBVJU9tqMgGKHy61DVLEDC46q3H,True,24727174,6181793,38565,19282,19283,6L1WYrPiCMyi7XemPww4B4hvpKD1LQKD4RpiSKmrmgSC,1542608,8732415,-7189807,623
2022-05-07 16:31:39-04:00,18143,4oMasDRj8HWfknmdwt6Mkz3eonr8J2byoiSTRo4sCnFQ,3emcATkEFvDVETiK97eVET2Z2jzkgiiSxX3gu5wsUKPe,True,8132840490,1196312507,7884222,3942111,3942111,AmTrMPzuTp2BjnjqGNKqz9FTTCdpoKcPAJLwFc8ozcbh,535989773,2701570236,-2165580463,659
2022-05-07 16:32:27-04:00,18144,7GpG8k6hM27vK1R5Sx1v5xUBuF6vybP41dcymjXDi5P7,7Aip6HDcbZ5mvoSucNupRS9enRdGx37F8L432K7V81do,True,1692751265,423187816,2632844,1316422,1316422,A9TwRM1BMxqb8DCC7YNAMV6zPenEJm3HTZBy7wJKK58U,105313799,685702847,-580389048,622
2022-05-07 16:33:37-04:00,18145,DHv4AsHMRZ6DuPaKEr2cLMNsX2ezT75T9haNgsDngS2b,5pMurvHHPdPKg3R96o1fKBbJh2Mc2tBP6P1e3acB31vQ,True,22150318,5537579,34489,17244,17245,5HnvdJnCCcmRsm4GkXnYWd4q9RpwuvYDGEUMPkYR3Ts9,1379578,5770283,-4390705,622
2022-05-07 16:33:45-04:00,18146,G7QeYEH5Et1mB2imz2J7ne8MeVhXzYxpdFee6yRD8MeJ,9K1u2L1cidicuNFqQjJnEwzVjEjG81Ka5bEKCkWxCkjT,False,13480182,13480182,835455,41772,793683,2a35JJeTUW1pm6M3e8DHCjp8qr4vbc2cRPhuzZWyFzYd,835455,4919352,-4083897,619
2022-05-07 16:47:00-04:00,18147,DLwEaZipqHmVBD5hc5v1NZtDStHyG4hAMwxywDTGGc2e,28GtwJw67UWfrSKxtuvpzoKzPyKXLgP3GKLm3fHdR566,True,999807346,249951836,1561107,780553,780554,2a35JJeTUW1pm6M3e8DHCjp8qr4vbc2cRPhuzZWyFzYd,62444311,255939420,-193495109,624
2022-05-07 16:49:03-04:00,18148,Fn6J1eMQJoA5rXCwX2HjAF86AowsJfULLuYXVfzgb8aX,6Ett2WPmz4HoWVSVEZD73UzFetd3oFSh7C676MEVYd36,True,565005048,141251262,882520,441260,441260,5HnvdJnCCcmRsm4GkXnYWd4q9RpwuvYDGEUMPkYR3Ts9,35300824,196891780,-161590956,624
2022-05-07 16:49:27-04:00,18149,4Siq98BDakELWP5BzVoEN5tcg1ywRxTYs1aUcfW8spCt,2EBXLTVz1Gk9gS5JcVqCKAP5PatFGw1Vnww65Moz3SUn,True,376137350,94034337,587471,293735,293736,2a35JJeTUW1pm6M3e8DHCjp8qr4vbc2cRPhuzZWyFzYd,23498841,123386527,-99887686,624
2022-05-07 16:49:27-04:00,18150,5vp63gpRmA7mzAj8czoQsMsNHg1773XwYdwi4f5XC4nE,wqgmuTgVubuFucijWBVJU9tqMgGKHy61DVLEDC46q3H,True,18169160,4542290,28195,14097,14098,68sueyVfmy5ToEGtLFGDkwebX47xAmzyXE29z8JrmcWv,1127822,6896405,-5768583,620
2022-05-07 16:49:36-04:00,18151,4oMasDRj8HWfknmdwt6Mkz3eonr8J2byoiSTRo4sCnFQ,3emcATkEFvDVETiK97eVET2Z2jzkgiiSxX3gu5wsUKPe,True,6865874620,833976083,5556526,2778263,2778263,AmTrMPzuTp2BjnjqGNKqz9FTTCdpoKcPAJLwFc8ozcbh,457452188,2399218158,-1941765970,666
2022-05-07 17:11:45-04:00,18152,7GpG8k6hM27vK1R5Sx1v5xUBuF6vybP41dcymjXDi5P7,7Aip6HDcbZ5mvoSucNupRS9enRdGx37F8L432K7V81do,True,1244137209,311034302,1931687,965843,965844,6L1WYrPiCMyi7XemPww4B4hvpKD1LQKD4RpiSKmrmgSC,77267494,538014139,-460746645,621
2022-05-07 17:11:56-04:00,18153,5XcrJqz4M3F7d5SruWRSWLH8zY6cDVwTXbqcA2Y5YLBS,6gJ1xLxAQ1HW4WRpBx7LhHiQuqqdMvLxSdeeNUS5NFsi,True,92305314,23076328,150870,75435,75435,Hu94aiQWvce6THeGyCFqGRPM1pQrK3ihzkcXo1EpJcJL,6034811,9507275,-3472464,653
2022-05-07 17:12:11-04:00,18154,DHv4AsHMRZ6DuPaKEr2cLMNsX2ezT75T9haNgsDngS2b,5pMurvHHPdPKg3R96o1fKBbJh2Mc2tBP6P1e3acB31vQ,True,16283256,4070814,25394,12697,12697,Hu94aiQWvce6THeGyCFqGRPM1pQrK3ihzkcXo1EpJcJL,1015773,4638290,-3622517,623
2022-05-07 17:12:38-04:00,18155,BhhVhLVZkSd3aHDMd6ojTgtJtbgAdMCA9Xj8jL2GMXoL,G8HUQp2yGSw9T6it5ej91cqkd82naca8heji453g2jEH,True,41830059,7104011,28613,14306,14307,2a35JJeTUW1pm6M3e8DHCjp8qr4vbc2cRPhuzZWyFzYd,1684819,22052985,-20368166,402
2022-05-07 17:13:19-04:00,18156,4oMasDRj8HWfknmdwt6Mkz3eonr8J2byoiSTRo4sCnFQ,3emcATkEFvDVETiK97eVET2Z2jzkgiiSxX3gu5wsUKPe,True,5973138583,871782299,5738382,2869191,2869191,2a35JJeTUW1pm6M3e8DHCjp8qr4vbc2cRPhuzZWyFzYd,393173359,2145390240,-1752216881,658
2022-05-07 17:13:56-04:00,18157,Gwj6CMXQeoWVsmD775Knsm6BmWuysFvSKo78FRLQByb4,6cvChMYj7TfDcnc8hG9H89PABJr2svspqjJSdSGD4RUt,True,23057290,2330045,14521,7260,7261,2a35JJeTUW1pm6M3e8DHCjp8qr4vbc2cRPhuzZWyFzYd,1437027,5972306,-4535279,623
2022-05-07 17:13:58-04:00,18158,EvyJwXTqP5N4qPKwDiDTCfjLYgLWz1qEREsarcsZdhYD,CbnajpQJxW3fWpH9dohsipVnZJyUvqy5dYSRDBBaDeEp,False,13173477,13173477,822487,41124,781363,C4UnXuShCvjSMgBAgVNMy1oakxCNk1et27A82fywU112,822487,8743083,-7920596,624
2022-05-07 17:13:58-04:00,18159,Ga6hKu2mWpMqDboq3ZajdiittrTvDqX9kqMDt2fi3t29,3zUEyHaYdzLGMZxDj2EZLCA6NzL7Ub9BGpE5PGGnw2GD,False,12756415,12756415,786739,39336,747403,C4UnXuShCvjSMgBAgVNMy1oakxCNk1et27A82fywU112,786739,9124364,-8337625,616
2022-05-07 17:14:01-04:00,18160,9BjYvRf5A9UK99LvPTHd5DRvxMn2FWYKb5fpDxYDL48S,4kMo5gLVscVqwx6xQTLrn9JaEq1dFqq5Vfiq3Vb15vhi,False,13173405,13173405,822115,41105,781010,C4UnXuShCvjSMgBAgVNMy1oakxCNk1et27A82fywU112,822115,8742606,-7920491,624
2022-05-07 17:14:19-04:00,18161,DHfy6B2AYsqMCxPLBCXMDfQn3Gr2VwJaLFHUZKqpCjsb,EPZpYaY1gCAb8pMtri5veRowBmCrCpTHBMa3Rmgt6S29,True,1638752393,409688098,1169120,584560,584560,2a35JJeTUW1pm6M3e8DHCjp8qr4vbc2cRPhuzZWyFzYd,46764837,78312238,-31547401,285
2022-05-07 17:14:19-04:00,18162,68zbVKnneMQqngbNkeLtPEP2ayNhawc1B2hPgqAEqgXK,HqiFpLr4NC7xJz9bEFusq8bCKaoxAQG1xsLxdUAzg8aa,True,37162130,3478982,14057,7028,7029,2a35JJeTUW1pm6M3e8DHCjp8qr4vbc2cRPhuzZWyFzYd,1501629,19502393,-18000764,404
2022-05-07 17:17:27-04:00,18163,93Jp2cnKVsSUcpoNEXmuq3K17MWt7JkW3jx6v5v2UAvN,5bos8dvpCKDxeYbXxRXwEdY8tAMZoL2XhNKUdFKxTrd6,True,197062935,16578415,66525,33262,33263,Hu94aiQWvce6THeGyCFqGRPM1pQrK3ihzkcXo1EpJcJL,7907644,123329047,-115421403,401
2022-05-07 17:22:52-04:00,18164,4nj9fNW5K5hZebNaCP8PDTismTb5HK4MsJLUPLsnfN7P,B4UmvQqxb4Sc35L3YzuGR8BSQC2qKd6e4Byxni7ncYkf,True,70772260,17693065,53017,26508,26509,6L1WYrPiCMyi7XemPww4B4hvpKD1LQKD4RpiSKmrmgSC,2120703,10442457,-8321754,299
2022-05-07 17:22:55-04:00,18165,DkKumyFA6dGw77wcwd16nWzTEC9McvmasAbmGfQXLkB7,9u6QyrruYFjhyLV5AXYUKkrBggzrxXfNH57smUAap5Ro,True,38697586,7439844,27664,13832,13832,6L1WYrPiCMyi7XemPww4B4hvpKD1LQKD4RpiSKmrmgSC,1438970,11042374,-9603404,371
2022-05-07 17:22:59-04:00,18166,7PzGZgzieFyyFs1dbajkNQgVxooFUNZrj1bUsQvrSwbp,A2gDREmSmJTBPPw3sbKVY3smC9wbHMDdv87gr4Tr2ES7,True,2689399860,672349965,1927188,963594,963594,GXyFXZMNk2NFyEzw6JetVqsujqcz2yCixH7n8EpDJYWD,77087520,177213963,-100126443,286
2022-05-07 17:44:31-04:00,18167,BhhVhLVZkSd3aHDMd6ojTgtJtbgAdMCA9Xj8jL2GMXoL,G8HUQp2yGSw9T6it5ej91cqkd82naca8heji453g2jEH,True,34546587,3340451,14279,7139,7140,5HnvdJnCCcmRsm4GkXnYWd4q9RpwuvYDGEUMPkYR3Ts9,1476745,18319858,-16843113,427
2022-05-07 17:47:18-04:00,18168,DLwEaZipqHmVBD5hc5v1NZtDStHyG4hAMwxywDTGGc2e,28GtwJw67UWfrSKxtuvpzoKzPyKXLgP3GKLm3fHdR566,True,734600244,183650061,1140888,570444,570444,A9TwRM1BMxqb8DCC7YNAMV6zPenEJm3HTZBy7wJKK58U,45635555,206021068,-160385513,621
2022-05-07 17:47:25-04:00,18169,36CK34jG3VwGCfJDrwN47DHhPWKFZhzUTPs89b9qJyq8,CM8WoBGF5JLtf9auBMBfvedhywpJJKpUfTtAPrW1Rab3,False,3555605,3555605,194118,9705,184413,Hu94aiQWvce6THeGyCFqGRPM1pQrK3ihzkcXo1EpJcJL,194120,958064,-763944,545
2022-05-07 17:47:28-04:00,18170,5vp63gpRmA7mzAj8czoQsMsNHg1773XwYdwi4f5XC4nE,wqgmuTgVubuFucijWBVJU9tqMgGKHy61DVLEDC46q3H,False,13358869,13358869,831764,41588,790176,6L1WYrPiCMyi7XemPww4B4hvpKD1LQKD4RpiSKmrmgSC,831764,5426206,-4594442,622
2022-05-07 17:47:28-04:00,18171,68zbVKnneMQqngbNkeLtPEP2ayNhawc1B2hPgqAEqgXK,HqiFpLr4NC7xJz9bEFusq8bCKaoxAQG1xsLxdUAzg8aa,True,33594809,1533009,6384,3192,3192,8sEswn3kzEhnYjAZVvCQnHEUvYd7pFVvc2Xc2Kd1BpbC,1399233,18480524,-17081291,416
2022-05-07 17:47:28-04:00,18172,Fn6J1eMQJoA5rXCwX2HjAF86AowsJfULLuYXVfzgb8aX,6Ett2WPmz4HoWVSVEZD73UzFetd3oFSh7C676MEVYd36,True,415133592,103783398,645060,322530,322530,6L1WYrPiCMyi7XemPww4B4hvpKD1LQKD4RpiSKmrmgSC,25802428,155618912,-129816484,621
2022-05-07 17:47:34-04:00,18173,4Siq98BDakELWP5BzVoEN5tcg1ywRxTYs1aUcfW8spCt,2EBXLTVz1Gk9gS5JcVqCKAP5PatFGw1Vnww65Moz3SUn,True,276089246,69022311,422511,211255,211256,Hu94aiQWvce6THeGyCFqGRPM1pQrK3ihzkcXo1EpJcJL,16900479,97831352,-80930873,612
2022-05-07 17:48:34-04:00,18174,EuMiyjSBs2ZKaPjN3FhaATvnSZG6Ak6aqdVUSApW6zM8,Hgw8jKxLXrB5G7Hk6Mh3sWZ3nHoa6Z2DzNDZGyMm4uoL,True,84380948,8379514,41136,20568,20568,6L1WYrPiCMyi7XemPww4B4hvpKD1LQKD4RpiSKmrmgSC,4142386,21761606,-17619220,490
2022-05-07 17:48:39-04:00,18175,4YNWVEq2F3gR8XEbUQxJRqzi6i5KSfwf6mVMLPJrnpEd,EE5uomX5guX4ZeHiP6wcoH5C8k3tRGXo18JTWgNDqs1C,False,13195793,13195793,824366,41218,783148,8sEswn3kzEhnYjAZVvCQnHEUvYd7pFVvc2Xc2Kd1BpbC,824366,8722609,-7898243,624
2022-05-07 17:48:42-04:00,18176,2pcVNktE3dbyybTuEBSkdwWJS5sFcvYLMEKRQMwZy6eh,61GaKj6fDApZF9B3aTBxTzYk8e22XLFPsQ21pJdvDhBL,False,13192857,13192857,822407,41120,781287,8sEswn3kzEhnYjAZVvCQnHEUvYd7pFVvc2Xc2Kd1BpbC,822407,8723407,-7901000,623
2022-05-07 17:48:50-04:00,18177,68zbVKnneMQqngbNkeLtPEP2ayNhawc1B2hPgqAEqgXK,HqiFpLr4NC7xJz9bEFusq8bCKaoxAQG1xsLxdUAzg8aa,True,31968758,1461541,5942,2971,2971,68sueyVfmy5ToEGtLFGDkwebX47xAmzyXE29z8JrmcWv,1299807,17501588,-16201781,406
2022-05-07 17:48:54-04:00,18178,7FL3AxJZcTiCG6Ux7CVc82Nqo4msgmQASGvjfMEgQddc,EzcAwNya2eA7GD8ezmi49bEUP57Fq3w9SwN3uAG4HA2b,False,13174922,13174922,819999,40999,779000,Hu94aiQWvce6THeGyCFqGRPM1pQrK3ihzkcXo1EpJcJL,819999,8730158,-7910159,622
2022-05-07 17:48:55-04:00,18179,9V7DXwq3RnVnLqRmtWXQJZgU3nHyVMteXAvaVaW3g1b6,94zfTWn693sbx9aaxamLUSHsbXdYxLpZVTvnetJ3SnhT,False,13182651,13182651,811309,40565,770744,2a35JJeTUW1pm6M3e8DHCjp8qr4vbc2cRPhuzZWyFzYd,811309,8722721,-7911412,615
2022-05-07 17:48:57-04:00,18180,BAe9q4b1UwvQi5BHTmVh2GRguY3f9a5fbzXV2WiB93Ag,9uSCD3c3vHYC1i6odskxdugUaoSE5QYA1e8wkkW6aX5W,False,13176592,13176592,814446,40722,773724,2a35JJeTUW1pm6M3e8DHCjp8qr4vbc2cRPhuzZWyFzYd,814446,8731739,-7917293,618
2022-05-07 17:48:58-04:00,18181,G85GTorkDswyxv8uxgpP1tr6DbXktiXjjX14VA4L2VVu,3EJ5raXpu6eveda4FjxAeWFNbDbQkgjyKfoFq183UeLC,False,13153622,13153622,821515,41075,780440,8sEswn3kzEhnYjAZVvCQnHEUvYd7pFVvc2Xc2Kd1BpbC,821515,8729638,-7908123,624
2022-05-07 17:49:03-04:00,18182,7tFD53kPTqrzjCu1Wji78gUqhoRtCUhsP1pM3DQKT7uG,BJvgPLYBDJrQJdQVowrsMwUGMurq4zTihoFwWoEokfu3,True,2693237755,373513482,1120277,560138,560139,3zqXX6kzhkbW3d4TwD2CNjMRwxTbREXySekvq37kfCNk,80778228,456303831,-375525603,299
2022-05-07 17:49:09-04:00,18183,442usWu6XpJZvU25bqXeynRrQ15jAzWwU9DWMgHpTn3Q,CtvADKp39bjJf3cPKWNL3wxnhq273fVM4fC5DmEcg5cC,True,631272961,52337634,214293,107146,107147,8sEswn3kzEhnYjAZVvCQnHEUvYd7pFVvc2Xc2Kd1BpbC,25847182,206415578,-180568396,409
2022-05-07 17:49:13-04:00,18184,7GpG8k6hM27vK1R5Sx1v5xUBuF6vybP41dcymjXDi5P7,7Aip6HDcbZ5mvoSucNupRS9enRdGx37F8L432K7V81do,True,914849162,228712290,1427051,713525,713526,2py1FiYeL2f7J3HU36qiJz6TD6HCmiTN36RyxYtapQCZ,57082062,420911728,-363829666,623
2022-05-07 17:49:57-04:00,18185,BhhVhLVZkSd3aHDMd6ojTgtJtbgAdMCA9Xj8jL2GMXoL,G8HUQp2yGSw9T6it5ej91cqkd82naca8heji453g2jEH,True,30986739,5276728,21167,10583,10584,8sEswn3kzEhnYjAZVvCQnHEUvYd7pFVvc2Xc2Kd1BpbC,1243069,16905015,-15661946,401
2022-05-07 17:50:05-04:00,18186,DHv4AsHMRZ6DuPaKEr2cLMNsX2ezT75T9haNgsDngS2b,5pMurvHHPdPKg3R96o1fKBbJh2Mc2tBP6P1e3acB31vQ,False,11952885,11952885,730822,36541,694281,8sEswn3kzEhnYjAZVvCQnHEUvYd7pFVvc2Xc2Kd1BpbC,730822,3707270,-2976448,611
2022-05-07 17:50:52-04:00,18187,68zbVKnneMQqngbNkeLtPEP2ayNhawc1B2hPgqAEqgXK,HqiFpLr4NC7xJz9bEFusq8bCKaoxAQG1xsLxdUAzg8aa,True,30420679,2783168,11045,5522,5523,2a35JJeTUW1pm6M3e8DHCjp8qr4vbc2cRPhuzZWyFzYd,1207327,16693016,-15485689,396
2022-05-07 17:52:04-04:00,18188,93Jp2cnKVsSUcpoNEXmuq3K17MWt7JkW3jx6v5v2UAvN,5bos8dvpCKDxeYbXxRXwEdY8tAMZoL2XhNKUdFKxTrd6,True,179669294,32575598,127385,63692,63693,6L1WYrPiCMyi7XemPww4B4hvpKD1LQKD4RpiSKmrmgSC,7025893,111715929,-104690036,391
2022-05-07 17:52:06-04:00,18189,DLwEaZipqHmVBD5hc5v1NZtDStHyG4hAMwxywDTGGc2e,28GtwJw67UWfrSKxtuvpzoKzPyKXLgP3GKLm3fHdR566,True,539573074,134893268,827938,413969,413969,2a35JJeTUW1pm6M3e8DHCjp8qr4vbc2cRPhuzZWyFzYd,33117558,164788765,-131671207,613
2022-05-07 17:52:09-04:00,18190,Gf5g7HMy73aPnXXvgQZEiBArL7wXzx7TpivmMRDU8RJS,8ok76N32AxEocuGo7RqeZJ9a45MezH6L1My16N9UfkdA,True,13140660766,846710228,3256413,1628206,1628207,6L1WYrPiCMyi7XemPww4B4hvpKD1LQKD4RpiSKmrmgSC,505384528,1772524546,-1267140018,384
2022-05-07 17:52:09-04:00,18191,4oMasDRj8HWfknmdwt6Mkz3eonr8J2byoiSTRo4sCnFQ,3emcATkEFvDVETiK97eVET2Z2jzkgiiSxX3gu5wsUKPe,True,5051500595,625531560,4180272,2090136,2090136,2xTUy2RS74GJMMDnmFaegMzFLn19RVfYG4CibhBmjP1i,337579288,1893254454,-1555675166,668
2022-05-07 17:52:19-04:00,18192,9VojCEgzn99QRVPGKn6euGRQbM7Q86GZ6yHJQa7N3gv4,GW4GVNnUtEt68avsowddpmjoUTUyMvxV4c5kY3Gzz9fT,True,17740501,1614906,10089,5044,5045,2a35JJeTUW1pm6M3e8DHCjp8qr4vbc2cRPhuzZWyFzYd,1108423,13214504,-12106081,624
2022-05-07 17:52:22-04:00,18193,Fn6J1eMQJoA5rXCwX2HjAF86AowsJfULLuYXVfzgb8aX,6Ett2WPmz4HoWVSVEZD73UzFetd3oFSh7C676MEVYd36,True,305243704,76310926,476271,238135,238136,8sEswn3kzEhnYjAZVvCQnHEUvYd7pFVvc2Xc2Kd1BpbC,19050878,122521442,-103470564,624
2022-05-07 17:52:27-04:00,18194,EuMiyjSBs2ZKaPjN3FhaATvnSZG6Ak6aqdVUSApW6zM8,Hgw8jKxLXrB5G7Hk6Mh3sWZ3nHoa6Z2DzNDZGyMm4uoL,True,75493660,6189394,29461,14730,14731,2a35JJeTUW1pm6M3e8DHCjp8qr4vbc2cRPhuzZWyFzYd,3593476,19599976,-16006500,475
2022-05-07 17:52:29-04:00,18195,BSDeCyJsPs6y1pbDVHNq5rs6tdxcrbY3NDjXPBxwRjHz,DjHD3jawBVikzjcQ5dXBRLdUmEeBHKt6JZLhvmjScDku,True,558602655,99182003,301157,150578,150579,2xTUy2RS74GJMMDnmFaegMzFLn19RVfYG4CibhBmjP1i,16961515,201778123,-184816608,303
2022-05-07 17:52:33-04:00,18196,BhhVhLVZkSd3aHDMd6ojTgtJtbgAdMCA9Xj8jL2GMXoL,G8HUQp2yGSw9T6it5ej91cqkd82naca8heji453g2jEH,True,25568242,2441203,10312,5156,5156,2a35JJeTUW1pm6M3e8DHCjp8qr4vbc2cRPhuzZWyFzYd,1080133,14054178,-12974045,422
2022-05-07 17:52:38-04:00,18197,4Siq98BDakELWP5BzVoEN5tcg1ywRxTYs1aUcfW8spCt,2EBXLTVz1Gk9gS5JcVqCKAP5PatFGw1Vnww65Moz3SUn,True,202734894,50683723,303648,151824,151824,gjBMZYVujDjD1ECG4i97M8Q3gV9ESnwwTSUGropkusj,12145927,77176869,-65030942,599
2022-05-07 17:52:43-04:00,18198,CXppCp4b4npkAzw175YNy6Ei8nF7jCmNbqsbVosHS6fE,FSEchHNYxt7WdBYjyuS2Ft2yUnfk56TCkY8SXdSs8hfe,True,318644568,79661142,485537,242768,242769,Hu94aiQWvce6THeGyCFqGRPM1pQrK3ihzkcXo1EpJcJL,19421483,159739323,-140317840,609
2022-05-07 17:52:59-04:00,18199,68zbVKnneMQqngbNkeLtPEP2ayNhawc1B2hPgqAEqgXK,HqiFpLr4NC7xJz9bEFusq8bCKaoxAQG1xsLxdUAzg8aa,True,27557828,2591396,10499,5249,5250,C4UnXuShCvjSMgBAgVNMy1oakxCNk1et27A82fywU112,1116599,14930959,-13814360,405
2022-05-07 17:53:14-04:00,18200,EVMrznfJS54BZiywDD2WhUtxzicDtbEpm2a5yLrtCgRF,CpzsMYVYvKg8ihrX1cKRw7TDEYwD3kAyiX92hsf2KiTz,True,4779557716,503744993,2733966,1366983,1366983,2xTUy2RS74GJMMDnmFaegMzFLn19RVfYG4CibhBmjP1i,259400124,2971667512,-2712267388,542
2022-05-07 17:53:19-04:00,18201,DHfy6B2AYsqMCxPLBCXMDfQn3Gr2VwJaLFHUZKqpCjsb,EPZpYaY1gCAb8pMtri5veRowBmCrCpTHBMa3Rmgt6S29,True,1220344333,305086083,921893,460946,460947,A2p75MbAbeUdHkPLkAjgGeiwuu9WPrkMHzjCkDXF1Xr3,36875755,69279550,-32403795,302
2022-05-07 17:53:38-04:00,18202,13GT6eaKWuaLe7wFcybCnUaYgd9DfyzYRN2FcXWgFwpC,CbwmJ7YpnvcqDyUw3L9b7dqXcA8Ju3rYrTdegeaJJbWC,True,80042824,20010706,125009,62504,62505,Hu94aiQWvce6THeGyCFqGRPM1pQrK3ihzkcXo1EpJcJL,5000380,51645879,-46645499,624
2022-05-07 17:54:17-04:00,18203,GMpoV2jRyLdf2V3Gb5TQZ5gEs5ftMjD3JhFUzkA6fWVz,5bi814d5gdToTLVWCmbdB6J15kMdsTQk74cZTRd62p81,True,864698242,216174560,1501878,750939,750939,A9TwRM1BMxqb8DCC7YNAMV6zPenEJm3HTZBy7wJKK58U,60075133,199334805,-139259672,694
2022-05-07 17:54:41-04:00,18204,7tFD53kPTqrzjCu1Wji78gUqhoRtCUhsP1pM3DQKT7uG,BJvgPLYBDJrQJdQVowrsMwUGMurq4zTihoFwWoEokfu3,True,2309913678,298448543,902450,451225,451225,3zqXX6kzhkbW3d4TwD2CNjMRwxTbREXySekvq37kfCNk,69847356,407884040,-338036684,302
2022-05-07 17:54:51-04:00,18205,5XcrJqz4M3F7d5SruWRSWLH8zY6cDVwTXbqcA2Y5YLBS,6gJ1xLxAQ1HW4WRpBx7LhHiQuqqdMvLxSdeeNUS5NFsi,True,68171686,17042921,120666,60333,60333,C4UnXuShCvjSMgBAgVNMy1oakxCNk1et27A82fywU112,4826641,8488890,-3662249,708
2022-05-07 17:54:59-04:00,18206,HT2SuCbePhjNZaar24uVwihYowCNvSjdvhJ8BRSVw9nX,98Ts4LCnapHVoCJ5PW3Armvh4jvDtpfs3SYRLRxiAgzZ,True,265450058,17340222,85862,42931,42931,Hu94aiQWvce6THeGyCFqGRPM1pQrK3ihzkcXo1EpJcJL,13144087,104875661,-91731574,495
2022-05-07 17:55:10-04:00,18207,5UDGqNpkcMDjByBNi7WYMg8VJ81EzNJu48zsXbW9irSd,FmtUoQNiG25v8sn4pveM6wAWvja9u6FvZ2gdxWHSRjur,True,35505224,8876306,55228,27614,27614,68sueyVfmy5ToEGtLFGDkwebX47xAmzyXE29z8JrmcWv,2209125,19880434,-17671309,622
2022-05-07 17:57:13-04:00,18208,J6ndjmic8buVqwa4URRRgv2iTc4ekbYUHdcpa3DUCufN,7qvvczUw8ngwdQae49BiQwQmdV2SSWsAVV2tmZYL7gw6,True,38963452,9740863,60773,30386,30387,C4UnXuShCvjSMgBAgVNMy1oakxCNk1et27A82fywU112,2430922,26409383,-23978461,623
2022-05-07 17:57:53-04:00,18209,FU7X4DWnGTbxwXULBq3v9SACzYhQyFGqsXjUDzyFqiem,925BaEnWxTfEv4oQb9Xf1wyyEEWEr8kXeSdXTtRfShfw,True,26353122,6588280,41141,20570,20571,8sEswn3kzEhnYjAZVvCQnHEUvYd7pFVvc2Xc2Kd1BpbC,1645665,10398133,-8752468,624
2022-05-07 17:59:27-04:00,18210,Gf5g7HMy73aPnXXvgQZEiBArL7wXzx7TpivmMRDU8RJS,8ok76N32AxEocuGo7RqeZJ9a45MezH6L1My16N9UfkdA,True,12242447219,1538411077,5662643,2831321,2831322,A2p75MbAbeUdHkPLkAjgGeiwuu9WPrkMHzjCkDXF1Xr3,450624796,1543305763,-1092680967,368
2022-05-07 17:59:29-04:00,18211,7GpG8k6hM27vK1R5Sx1v5xUBuF6vybP41dcymjXDi5P7,7Aip6HDcbZ5mvoSucNupRS9enRdGx37F8L432K7V81do,True,671780554,167945138,1032467,516233,516234,A9TwRM1BMxqb8DCC7YNAMV6zPenEJm3HTZBy7wJKK58U,41298693,328536138,-287237445,614
2022-05-07 17:59:31-04:00,18212,H7wVZszBQdmFuwMUYAw4SSYbjxeFY1QvNBuT8QiqTxZS,CUm235keNKnVd2BaCNp5a6HePtWGMo8dq8S1KXf2KRR4,False,30814562,30814562,933315,46665,886650,2a35JJeTUW1pm6M3e8DHCjp8qr4vbc2cRPhuzZWyFzYd,933315,2393685,-1460370,302
2022-05-07 17:59:31-04:00,18213,68zbVKnneMQqngbNkeLtPEP2ayNhawc1B2hPgqAEqgXK,HqiFpLr4NC7xJz9bEFusq8bCKaoxAQG1xsLxdUAzg8aa,True,24898245,1132328,4720,2360,2360,Hu94aiQWvce6THeGyCFqGRPM1pQrK3ihzkcXo1EpJcJL,1037913,14146757,-13108844,416
2022-05-07 17:59:32-04:00,18214,DkKumyFA6dGw77wcwd16nWzTEC9McvmasAbmGfQXLkB7,9u6QyrruYFjhyLV5AXYUKkrBggzrxXfNH57smUAap5Ro,True,31071517,5562982,21933,10966,10967,8sEswn3kzEhnYjAZVvCQnHEUvYd7pFVvc2Xc2Kd1BpbC,1225081,10390873,-9165792,394
2022-05-07 17:59:37-04:00,18215,9qGz5Mh1XNUXqY1vEg5S1ZEMzPFvBLRbp1qaXwxSFMby,D8KnbVXStSUz3QhZGzY5o853ASocjkyu9x682oHgVoZh,True,67479774570,9873528558,36443672,18221836,18221836,gjBMZYVujDjD1ECG4i97M8Q3gV9ESnwwTSUGropkusj,2490711199,13930031135,-11439319936,369
2022-05-07 17:59:37-04:00,18216,EuMiyjSBs2ZKaPjN3FhaATvnSZG6Ak6aqdVUSApW6zM8,Hgw8jKxLXrB5G7Hk6Mh3sWZ3nHoa6Z2DzNDZGyMm4uoL,True,68920254,4592910,21191,10595,10596,Hu94aiQWvce6THeGyCFqGRPM1pQrK3ihzkcXo1EpJcJL,3180003,17884899,-14704896,461
2022-05-07 17:59:38-04:00,18217,HXQXfEQe7aCpr6WKh37XaDZsjZcuQPk5t8tWNFgEoK6U,5ufXkCEDwgiXwtyPye4wYVVA3oLW54JVzz4tnXFofto4,True,16089854563,4022463640,12017487,6008743,6008744,A9TwRM1BMxqb8DCC7YNAMV6zPenEJm3HTZBy7wJKK58U,480699487,5161524112,-4680824625,298
2022-05-07 17:59:40-04:00,18218,FRbeFwhUYCiHW5oP26mad8KND7CCYDbfnoNxX7GuXVp8,GrzXKxPX2WDka8i2D8sunMUsrsThKasQi8NYLwuCGygV,True,1526165023,264234702,1048258,524129,524129,2py1FiYeL2f7J3HU36qiJz6TD6HCmiTN36RyxYtapQCZ,60545259,524456783,-463911524,396
2022-05-07 17:59:41-04:00,18219,GcwFXxcxRF2xwbgFbQZoYEDreimd3J3UJ9sPfuwYVKtS,7uXjmKS8RxP2qSS7ataBH5hkfpgsFcpSBWUEBuV5zgyZ,True,1004404562,251101140,759969,379984,379985,C4UnXuShCvjSMgBAgVNMy1oakxCNk1et27A82fywU112,30398789,209301301,-178902512,302
2022-05-07 17:59:43-04:00,18220,BhhVhLVZkSd3aHDMd6ojTgtJtbgAdMCA9Xj8jL2GMXoL,G8HUQp2yGSw9T6it5ej91cqkd82naca8heji453g2jEH,False,22985509,22985509,928290,46414,881876,8sEswn3kzEhnYjAZVvCQnHEUvYd7pFVvc2Xc2Kd1BpbC,928291,12929307,-12001016,403
2022-05-07 17:59:44-04:00,18221,HqtTbC1LFreGvgfpZe7nCqkNnh8GHPQKosfmc19zb1yi,E39UNiHNkwQEd5GXkCtTPqSorQSB1kLx8kjzK4jdFoi3,True,191502728,47875682,144817,72408,72409,C4UnXuShCvjSMgBAgVNMy1oakxCNk1et27A82fywU112,5792711,39559108,-33766397,302
2022-05-07 17:59:45-04:00,18222,A7j77tzgnQVGtHTa65VtVZqJRYeJvQk7am8NW6e66379,4vJGwEvXU2tGWoWWGwbsYcfKQAMCHbrBMRk4ZVFzneLs,True,12922294599,3230573649,9733889,4866944,4866945,2py1FiYeL2f7J3HU36qiJz6TD6HCmiTN36RyxYtapQCZ,389355591,2462257180,-2072901589,301
2022-05-07 17:59:51-04:00,18223,5zqXqEjg95BnghcVbHRhYkSTYnzZjUBichgccv1BpS3d,9SuqSxrKpHh9NcNePe4Q3jXvpCmhNnoQv8YAFih3CqMX,True,564172873,141043218,422744,211372,211372,A9TwRM1BMxqb8DCC7YNAMV6zPenEJm3HTZBy7wJKK58U,16909760,180394409,-163484649,299
2022-05-07 17:59:51-04:00,18224,4oMasDRj8HWfknmdwt6Mkz3eonr8J2byoiSTRo4sCnFQ,3emcATkEFvDVETiK97eVET2Z2jzkgiiSxX3gu5wsUKPe,True,4376322509,627845496,4070831,2035415,2035416,DA18qE9qesbBqpwNv1M4befYcNQkbSBSeLPTmQzrmbJw,283752490,1702311560,-1418559070,648
2022-05-07 17:59:52-04:00,18225,CDVtXFbo4Rg2aHsXKv5P3uRJq9ZTgsRd7GXPTxgH5xv9,6zj37qQnaiJT7xGEZmSKx5yQvisQFcs5KhGsG43SGd5y,True,86173103,3572580,13951,6975,6976,Hu94aiQWvce6THeGyCFqGRPM1pQrK3ihzkcXo1EpJcJL,3365148,32181763,-28816615,390
2022-05-07 17:59:52-04:00,18226,Gf5g7HMy73aPnXXvgQZEiBArL7wXzx7TpivmMRDU8RJS,8ok76N32AxEocuGo7RqeZJ9a45MezH6L1My16N9UfkdA,True,10661591720,625496260,2361498,1180749,1180749,2py1FiYeL2f7J3HU36qiJz6TD6HCmiTN36RyxYtapQCZ,402517731,1484435979,-1081918248,377
2022-05-07 17:59:52-04:00,18227,Fczxdc24Eav8xcaKRDwWMEwPEzkGyEJ7qGcXYyGZFKVz,8GqweYpec4cnpaJvueF3FGWoaz72BAzpLYXBX7tuuqEt,True,1267119107,316779776,930545,465272,465273,A9TwRM1BMxqb8DCC7YNAMV6zPenEJm3HTZBy7wJKK58U,37221829,737226737,-700004908,293
2022-05-07 17:59:54-04:00,18228,E3LF7ohKS87kHLW78ViuRuyw7EMuiW3nVn5PRdhU7iBj,DMVXNy2NLb8jMuznjx2syKqvzctrNmQ3PfiUA83CeQR4,True,87579512,21894878,59830,29915,29915,C4UnXuShCvjSMgBAgVNMy1oakxCNk1et27A82fywU112,2393215,27942549,-25549334,273
2022-05-07 17:59:54-04:00,18229,442usWu6XpJZvU25bqXeynRrQ15jAzWwU9DWMgHpTn3Q,CtvADKp39bjJf3cPKWNL3wxnhq273fVM4fC5DmEcg5cC,True,575195903,104971235,399547,199773,199774,2a35JJeTUW1pm6M3e8DHCjp8qr4vbc2cRPhuzZWyFzYd,21893465,178972370,-157078905,380
2022-05-07 17:59:57-04:00,18230,AsRi72uQLsBnyQxMBnPEhyQNM7XyNk2RV9GzPMe8PysA,9MqsYTBn6P9zCi5bGCrZurWWysW8XQZJwndHsb227rEW,True,138594974,34648743,99504,49752,49752,C4UnXuShCvjSMgBAgVNMy1oakxCNk1et27A82fywU112,3980177,43947585,-39967408,287
2022-05-07 17:59:58-04:00,18231,rTizTweTeG3Li3BFLmtr6GmcHBs9FTcwsPKCWezWmnR,76CqzaphEXgjo9pzBKttaErJ5e9xoZaRKp5ZNB5JCf4x,True,537045259,134261314,392793,196396,196397,2a35JJeTUW1pm6M3e8DHCjp8qr4vbc2cRPhuzZWyFzYd,15711749,59411231,-43699482,292
2022-05-07 18:00:02-04:00,18232,gCNpMXEHPTLvMvyyaYCLJrd8RRGnKAHz7sBD5j7yyBt,9cRU1ZAZRT5Ei4YAmCrPJZMHGsWspcYXTuZH58iexwDv,True,149130816,37282704,98934,49467,49467,C4UnXuShCvjSMgBAgVNMy1oakxCNk1et27A82fywU112,3957377,27019361,-23061984,265
2022-05-07 18:00:03-04:00,18233,8DSiP9CwJm3AEcH6uuAYFpArRRDLYpDQgjHEvjkUgfg2,ERJ8kuhPRRmUAhSM4oxUheh39YUVVYNgaTt6AdMXcCvL,True,472946041,118236510,318023,159011,159012,DA18qE9qesbBqpwNv1M4befYcNQkbSBSeLPTmQzrmbJw,12720959,150965621,-138244662,268
2022-05-07 18:00:06-04:00,18234,68zbVKnneMQqngbNkeLtPEP2ayNhawc1B2hPgqAEqgXK,HqiFpLr4NC7xJz9bEFusq8bCKaoxAQG1xsLxdUAzg8aa,False,23626842,23626842,893648,44682,848966,C4UnXuShCvjSMgBAgVNMy1oakxCNk1et27A82fywU112,893650,13394726,-12501076,378
2022-05-07 18:00:25-04:00,18235,82EMpA1hwF9KNQy2ZB2A1HdoEowBu2CoYhW3VmohkSnk,hn67zsTzsAs2aqk6ZjfEeoRygd3CdMeCuR82h9yuiz3,True,336413971,84103492,232285,116142,116143,8sEswn3kzEhnYjAZVvCQnHEUvYd7pFVvc2Xc2Kd1BpbC,9291435,103692928,-94401493,276
2022-05-07 18:00:25-04:00,18236,5NVJU6YoZuuEjGNUUUJcGwS2Qd8b8CH7QSgMV7UWL5E7,8ZUq3o1nSkEvSfmiTz4anUpSMECCnX38MRwV7E5AGYSt,True,814579213,203644803,579465,289732,289733,A9TwRM1BMxqb8DCC7YNAMV6zPenEJm3HTZBy7wJKK58U,23178631,114376067,-91197436,284
2022-05-07 18:00:25-04:00,18237,GpDhvRRae2uiRZ6MnJYnVR2hANNLGFGUDnsQmGjfK8AP,B2pgJ4gPdgzvx2HMJ1wagtthpZebtBk7RD3cF1zqSyT8,True,608056066,152014016,436681,218340,218341,2xTUy2RS74GJMMDnmFaegMzFLn19RVfYG4CibhBmjP1i,17467249,206775849,-189308600,287
2022-05-07 18:00:26-04:00,18238,Apqv5iu4bJ6pVg2NxjfwuvnfxDK6navHhhU1CVJEHeMa,7pDPJrxndRsLq983bEwvd3MKYnnqyQzQNMhEaC5NZYN1,True,788249643,197062410,568066,284033,284033,A9TwRM1BMxqb8DCC7YNAMV6zPenEJm3HTZBy7wJKK58U,22722676,111619955,-88897279,288
2022-05-07 18:00:27-04:00,18239,5nALef7nAfNkSQSuTBLwewDby4pUx74Gzqib33Znmmt6,8xNTWK2xNK2xZPpgXfcE4QxPT2i6YvNYakiLgdQ2FqEt,True,442323954,110580988,303614,151807,151807,A9TwRM1BMxqb8DCC7YNAMV6zPenEJm3HTZBy7wJKK58U,12144563,30313974,-18169411,274
2022-05-07 18:00:27-04:00,18240,AXBfrbCpYAWKN5jgDVVMiKXscQ96YtotKV3DT6XSzm9o,Dh3SiHAqrQzPQnTLRMxtBn2EFyHNgyfnYGpgcuNGTvyL,True,135634133,33908533,203270,101635,101635,Hu94aiQWvce6THeGyCFqGRPM1pQrK3ihzkcXo1EpJcJL,8130831,63432959,-55302128,599
2022-05-07 18:00:30-04:00,18241,DHfy6B2AYsqMCxPLBCXMDfQn3Gr2VwJaLFHUZKqpCjsb,EPZpYaY1gCAb8pMtri5veRowBmCrCpTHBMa3Rmgt6S29,True,906620029,226655007,682323,341161,341162,A2p75MbAbeUdHkPLkAjgGeiwuu9WPrkMHzjCkDXF1Xr3,27292959,60247077,-32954118,301
2022-05-07 18:00:32-04:00,18242,BKmKy8n1MpB1sdSfuWy7P3c6ReSW8TEWZRsyriz3ujYo,FgRpiZFPz43vDWStgCwRJACiGKtMLkWbTGeTLPeKnnaY,True,149623536,37405884,113058,56529,56529,5HnvdJnCCcmRsm4GkXnYWd4q9RpwuvYDGEUMPkYR3Ts9,4522332,48265070,-43742738,302
2022-05-07 18:00:32-04:00,18243,4ZF1wtHKAnxmEZGACgbgphHvuo5aK4wC4MCNJzLYVkMX,5UXyhRP3Rjsc1RbV8BouJVQoTbWWbuPtVJY15KcHJFCN,True,52369566,13092391,36049,18024,18025,68sueyVfmy5ToEGtLFGDkwebX47xAmzyXE29z8JrmcWv,1441975,17146333,-15704358,275
2022-05-07 18:00:41-04:00,18244,7frvVhg1eWJpsvG7ndjppb8Bmd1tFq5H1g26UiKZxqTP,3Ugo9b53e6e8PLnvKjqRP8pvvoubSPV6qiKtxey7mrGt,True,60927874,15231968,44578,22289,22289,5HnvdJnCCcmRsm4GkXnYWd4q9RpwuvYDGEUMPkYR3Ts9,1783145,18877419,-17094274,292
2022-05-07 18:00:42-04:00,18245,EVMrznfJS54BZiywDD2WhUtxzicDtbEpm2a5yLrtCgRF,CpzsMYVYvKg8ihrX1cKRw7TDEYwD3kAyiX92hsf2KiTz,True,4243103812,388384949,2048170,1024085,1024085,A2p75MbAbeUdHkPLkAjgGeiwuu9WPrkMHzjCkDXF1Xr3,223762486,2670899048,-2447136562,527
2022-05-07 18:00:43-04:00,18246,6pAs5S7zGX77DHSYUuCxvxbf2FQQHQhbBmAYLd3iJvWS,HNTWEhsrnEe8FeVDpEcxuoD5PnuveB5BwSf3gdBmhzxv,True,33549760,8387440,25273,12636,12637,Hu94aiQWvce6THeGyCFqGRPM1pQrK3ihzkcXo1EpJcJL,1010954,6193641,-5182687,301
2022-05-07 18:00:51-04:00,18247,7tFD53kPTqrzjCu1Wji78gUqhoRtCUhsP1pM3DQKT7uG,BJvgPLYBDJrQJdQVowrsMwUGMurq4zTihoFwWoEokfu3,True,2001491605,278254228,819267,409633,409634,68sueyVfmy5ToEGtLFGDkwebX47xAmzyXE29z8JrmcWv,58930237,359056497,-300126260,294
2022-05-07 18:00:52-04:00,18248,CBEv8v9XZrgFT8UdEdd813XnRVv9R7GB5PLMyG8UWGC8,4uNcMEcQpJdThpisgNrttkQJTUFTsjEr25qgjkm4titC,True,53081138,13270284,36672,18336,18336,5HnvdJnCCcmRsm4GkXnYWd4q9RpwuvYDGEUMPkYR3Ts9,1466896,11657859,-10190963,276
2022-05-07 18:00:52-04:00,18249,EMFbiJWcw1YdjiDmxj5CsHMyswXyyHeL7cfWKa8dMzHh,2LjnVQF8WSwL8XSNVypW9SouYSRbyH9A7gcw7BFtxuXS,True,149264585,37316146,112389,56194,56195,2a35JJeTUW1pm6M3e8DHCjp8qr4vbc2cRPhuzZWyFzYd,4495588,48621414,-44125826,301
2022-05-07 18:00:52-04:00,18250,CKK8bNCGjTn8qR6JoY5woqo2rrQHPMRawDGNfDsrg4Zd,46jXZ7r4uPrHnRJsnRnXHdDWjjjAbi8smmHbxxLhuwVg,True,47913327,11978331,34839,17419,17420,2a35JJeTUW1pm6M3e8DHCjp8qr4vbc2cRPhuzZWyFzYd,1393593,4132822,-2739229,290
2022-05-07 18:00:57-04:00,18251,HCAGpyYM2NYudMd55Geta13tUbS6eiygnJY5ULHsHAVa,3PPyWhqXrmifWPieLV34bZ1rzi8eEnrDDAF7ifXkXspn,True,109596506,20464705,79445,39722,39723,5HnvdJnCCcmRsm4GkXnYWd4q9RpwuvYDGEUMPkYR3Ts9,4254663,46496680,-42242017,388
2022-05-07 18:01:10-04:00,18252,7A1A93jqxV65F7XwvBarhgfTm3iFh3s75jFNzVCtFnez,8Z6QWdy4zGUzuMdKhkdxzq7RaLHhJmrpYEKeqsw8bopx,True,788576165,197144041,584535,292267,292268,68sueyVfmy5ToEGtLFGDkwebX47xAmzyXE29z8JrmcWv,23381423,111838036,-88456613,296
2022-05-07 18:01:12-04:00,18253,HT2SuCbePhjNZaar24uVwihYowCNvSjdvhJ8BRSVw9nX,98Ts4LCnapHVoCJ5PW3Armvh4jvDtpfs3SYRLRxiAgzZ,True,246800216,17505482,83282,41641,41641,C4UnXuShCvjSMgBAgVNMy1oakxCNk1et27A82fywU112,11741526,104234196,-92492670,475
2022-05-07 18:01:17-04:00,18254,93Jp2cnKVsSUcpoNEXmuq3K17MWt7JkW3jx6v5v2UAvN,5bos8dvpCKDxeYbXxRXwEdY8tAMZoL2XhNKUdFKxTrd6,True,146084955,12250468,49334,24667,24667,C4UnXuShCvjSMgBAgVNMy1oakxCNk1et27A82fywU112,5883090,94162397,-88279307,402
2022-05-07 18:01:38-04:00,18255,BSDeCyJsPs6y1pbDVHNq5rs6tdxcrbY3NDjXPBxwRjHz,DjHD3jawBVikzjcQ5dXBRLdUmEeBHKt6JZLhvmjScDku,True,456538496,73952473,222936,111468,111468,68sueyVfmy5ToEGtLFGDkwebX47xAmzyXE29z8JrmcWv,13762833,177094987,-163332154,301
2022-05-07 18:12:59-04:00,18256,9VojCEgzn99QRVPGKn6euGRQbM7Q86GZ6yHJQa7N3gv4,GW4GVNnUtEt68avsowddpmjoUTUyMvxV4c5kY3Gzz9fT,False,16026627,16026627,998091,49904,948187,68sueyVfmy5ToEGtLFGDkwebX47xAmzyXE29z8JrmcWv,998092,11811090,-10812998,622
2022-05-07 18:21:27-04:00,18257,DxmkdZiygge1YAwbL8U6LudY3QJkSnZMHThQXkE4Z5qy,Gi8oNcSDphbtosjFudeEPtX88bUnYid1tL9FnXnLfASU,True,200882102,50220525,150932,75466,75466,Hu94aiQWvce6THeGyCFqGRPM1pQrK3ihzkcXo1EpJcJL,6037298,22873016,-16835718,300
2022-05-07 18:22:56-04:00,18258,Gwj6CMXQeoWVsmD775Knsm6BmWuysFvSKo78FRLQByb4,6cvChMYj7TfDcnc8hG9H89PABJr2svspqjJSdSGD4RUt,True,20399933,2095542,13095,6547,6548,68sueyVfmy5ToEGtLFGDkwebX47xAmzyXE29z8JrmcWv,1274886,5189445,-3914559,624
2022-05-07 18:24:42-04:00,18259,Ai6G7vosJfmkRqtDAkqxRtbzELp6P5xe9r2RH3LYcLZt,8SUpKXakmhi4rYiFKnHYpgaAopomfDqEX6Efew9iM6nk,True,313053230,54513835,217657,108828,108829,2a35JJeTUW1pm6M3e8DHCjp8qr4vbc2cRPhuzZWyFzYd,12499316,141796320,-129297004,399
2022-05-07 18:24:48-04:00,18260,4SQQdHTJUDv8taPXQRvEVJpUu91iCWQsv9su8tfehaQG,33CJXj1pmmatAofRvgt5in9E6SLEuy7tq4jqSwnUWP2A,True,25430018,6357504,38654,19327,19327,5HnvdJnCCcmRsm4GkXnYWd4q9RpwuvYDGEUMPkYR3Ts9,1546182,31075642,-29529460,608
2022-05-07 18:25:13-04:00,18261,E4VzeJLsf5Y6t3yNi8VpS8QxhJbJGPhnkNBmU2XoCBs9,63CXyYfevXtrL1QcfQtAhz29xeea5BwWcj6d6BWb4qiB,True,19392808549,4848202137,14672159,7336079,7336080,2a35JJeTUW1pm6M3e8DHCjp8qr4vbc2cRPhuzZWyFzYd,586886378,6620499172,-6033612794,302
2022-05-07 18:25:13-04:00,18262,FRbeFwhUYCiHW5oP26mad8KND7CCYDbfnoNxX7GuXVp8,GrzXKxPX2WDka8i2D8sunMUsrsThKasQi8NYLwuCGygV,True,1255035379,116749008,488750,244375,244375,8sEswn3kzEhnYjAZVvCQnHEUvYd7pFVvc2Xc2Kd1BpbC,52540007,454313955,-401773948,418
2022-05-07 18:25:16-04:00,18263,9RtNbEZ4ZR8T1HFF4cujPVy2kejVBKFo3CPQi8psSa1q,7zwaGb71jKc9y2HKCKy5q2XV2YUphkyU1hkDaab1GBas,True,270477847,65643893,198579,99289,99290,C4UnXuShCvjSMgBAgVNMy1oakxCNk1et27A82fywU112,8182258,93912520,-85730262,302
2022-05-07 18:25:19-04:00,18264,EdCSJVDrgnE7PN9GK7t1t7hB79mBrJzyy1mMZL9u5nvM,GTy9uEWcCx4odtr1GLPpntNbdR7wJRYr3wE9P5rAaMw6,True,52260951,13065237,39102,19551,19551,8sEswn3kzEhnYjAZVvCQnHEUvYd7pFVvc2Xc2Kd1BpbC,1564110,7628769,-6064659,299
2022-05-07 18:39:22-04:00,18265,HooxSzasW3HMoFJ6sAvRQ75Char1J5aBdJtsqfDV6myp,BCmsWwpGeV4NNfeKZKKydty2uueLGHYTJDk1WErpXsVT,True,461721822,115430455,719064,359532,359532,3zqXX6kzhkbW3d4TwD2CNjMRwxTbREXySekvq37kfCNk,28762583,91538374,-62775791,622
2022-05-07 18:39:28-04:00,18266,7sgoB9mHcUoNFFdQSsBvyC4tXYzYR86ct11WQsS1FvAp,5k2QtQPgMUvj88Tmizf1pABHtC3VHJDc6BYNkB9gp19M,True,81901843,20475460,127580,63790,63790,5HnvdJnCCcmRsm4GkXnYWd4q9RpwuvYDGEUMPkYR3Ts9,5103204,27453011,-22349807,623
2022-05-07 18:42:13-04:00,18267,DLwEaZipqHmVBD5hc5v1NZtDStHyG4hAMwxywDTGGc2e,28GtwJw67UWfrSKxtuvpzoKzPyKXLgP3GKLm3fHdR566,True,397191450,99297862,620123,310061,310062,2a35JJeTUW1pm6M3e8DHCjp8qr4vbc2cRPhuzZWyFzYd,24804957,131049482,-106244525,624
2022-05-07 18:44:27-04:00,18268,4Siq98BDakELWP5BzVoEN5tcg1ywRxTYs1aUcfW8spCt,2EBXLTVz1Gk9gS5JcVqCKAP5PatFGw1Vnww65Moz3SUn,True,149355812,37338953,228707,114353,114354,gjBMZYVujDjD1ECG4i97M8Q3gV9ESnwwTSUGropkusj,9148314,60617295,-51468981,612
2022-05-07 18:44:27-04:00,18269,Fn6J1eMQJoA5rXCwX2HjAF86AowsJfULLuYXVfzgb8aX,6Ett2WPmz4HoWVSVEZD73UzFetd3oFSh7C676MEVYd36,True,224197141,56049285,346026,173013,173013,5HnvdJnCCcmRsm4GkXnYWd4q9RpwuvYDGEUMPkYR3Ts9,13841063,96180576,-82339513,617
2022-05-07 18:44:35-04:00,18270,CXppCp4b4npkAzw175YNy6Ei8nF7jCmNbqsbVosHS6fE,FSEchHNYxt7WdBYjyuS2Ft2yUnfk56TCkY8SXdSs8hfe,True,234713377,58678344,366702,183351,183351,2a35JJeTUW1pm6M3e8DHCjp8qr4vbc2cRPhuzZWyFzYd,14668089,124177637,-109509548,624
2022-05-07 18:47:02-04:00,18271,EVMrznfJS54BZiywDD2WhUtxzicDtbEpm2a5yLrtCgRF,CpzsMYVYvKg8ihrX1cKRw7TDEYwD3kAyiX92hsf2KiTz,True,3832015133,370488168,1924080,962040,962040,3zqXX6kzhkbW3d4TwD2CNjMRwxTbREXySekvq37kfCNk,199010586,2361018230,-2162007644,519
2022-05-07 18:47:06-04:00,18272,4hZG7dM716SxDagiFGwt1gSC99B2QK1emGLV9TJmmuR8,7vjfUWySkyx4Z5qAaRr2VWnVvxHHNsvPj1PirGNSjM6,True,168550934,42137733,262316,131158,131158,2a35JJeTUW1pm6M3e8DHCjp8qr4vbc2cRPhuzZWyFzYd,10492672,124454114,-113961442,622
2022-05-07 18:47:11-04:00,18273,3RpbaFEL5ZYrQBPpaAeCUXs43Ssdr5Tm4ScMGtp6XbYF,CpKGwcVZrd3vKTNhdF8xNsd77FT3QxQWb7xFQxiyPB5p,True,3062754679,765688669,4777042,2388521,2388521,68sueyVfmy5ToEGtLFGDkwebX47xAmzyXE29z8JrmcWv,191081703,1206906803,-1015825100,623
2022-05-07 18:47:12-04:00,18274,EuMiyjSBs2ZKaPjN3FhaATvnSZG6Ak6aqdVUSApW6zM8,Hgw8jKxLXrB5G7Hk6Mh3sWZ3nHoa6Z2DzNDZGyMm4uoL,True,64054871,3921241,17657,8828,8829,Hu94aiQWvce6THeGyCFqGRPM1pQrK3ihzkcXo1EpJcJL,2884434,16548453,-13664019,450
2022-05-07 18:47:43-04:00,18275,87yYQuRW91LAqEmqEyYah7obsr4KijRrqsKdK7DGA9w,EJzredSumMNBMTYxMMHocKayWKg3A3621QJ3ArJqro8r,True,44294855,11073713,33550,16775,16775,2a35JJeTUW1pm6M3e8DHCjp8qr4vbc2cRPhuzZWyFzYd,1342012,14292450,-12950438,302
2022-05-07 18:47:44-04:00,18276,FuhTkUxSaJ7kvuu9LHZaPVfdbKAQSh9W8Zzso1XPKGZp,FLoqPzREreKfRCwqtXs3CJwpTSudmXrVYCRZadWvob7j,True,1098048965,274512241,830402,415201,415201,2a35JJeTUW1pm6M3e8DHCjp8qr4vbc2cRPhuzZWyFzYd,33216094,377189097,-343973003,302
2022-05-07 18:47:45-04:00,18277,HT2SuCbePhjNZaar24uVwihYowCNvSjdvhJ8BRSVw9nX,98Ts4LCnapHVoCJ5PW3Armvh4jvDtpfs3SYRLRxiAgzZ,True,228312810,31168713,145750,72875,72875,2a35JJeTUW1pm6M3e8DHCjp8qr4vbc2cRPhuzZWyFzYd,10676320,96620671,-85944351,467
2022-05-07 18:47:45-04:00,18278,9XmuJX8mFX29c5uh68kK7ff1mPdvs1orJAgEP6BsVKnq,HfPpizwUoK6uEmMb9LWi464BnvjHQY9cuPppFMp1DKDA,True,81227094,20306773,60934,30467,30467,8sEswn3kzEhnYjAZVvCQnHEUvYd7pFVvc2Xc2Kd1BpbC,2437398,12350923,-9913525,300
2022-05-07 18:47:49-04:00,18279,Fbkv2mPSqXEAPZnuPHYYDRoshcC2a7eRvwPnSqK2sqv8,7Nha3zQkJsReUU1pzdNKHeSEb3a2xYExwAfr16cxQzRH,False,428720,428720,26620,1331,25289,8sEswn3kzEhnYjAZVvCQnHEUvYd7pFVvc2Xc2Kd1BpbC,26620,84883,-58263,620
2022-05-07 18:48:24-04:00,18280,Cgga7cjzsiecXRFLLf4jnEaGGwzr6qroh36G7kz3tV2t,AhUKdVt6jf8L2p5DbxkYPMAZUFqpz1uKBgPMUBJqEcnz,False,1951749,1951749,121662,6083,115579,2a35JJeTUW1pm6M3e8DHCjp8qr4vbc2cRPhuzZWyFzYd,121662,797139,-675477,623
2022-05-07 18:48:26-04:00,18281,CDVtXFbo4Rg2aHsXKv5P3uRJq9ZTgsRd7GXPTxgH5xv9,6zj37qQnaiJT7xGEZmSKx5yQvisQFcs5KhGsG43SGd5y,True,82386300,2680724,10202,5101,5101,Hu94aiQWvce6THeGyCFqGRPM1pQrK3ihzkcXo1EpJcJL,3135408,30738835,-27603427,380
2022-05-07 18:48:26-04:00,18282,H4rTN5pSgWQYdgpEXs79UN96nSKGQ7gkfEyS8B2Fqhyk,GttqEEtxJMkyKi2dRiUrdRyqiCyYXRj91EVzjRB6Uf5d,True,199451189,49862797,149387,74693,74694,2a35JJeTUW1pm6M3e8DHCjp8qr4vbc2cRPhuzZWyFzYd,5975489,9964163,-3988674,299
2022-05-07 18:48:32-04:00,18283,E3LF7ohKS87kHLW78ViuRuyw7EMuiW3nVn5PRdhU7iBj,DMVXNy2NLb8jMuznjx2syKqvzctrNmQ3PfiUA83CeQR4,True,65307438,16326859,48863,24431,24432,6L1WYrPiCMyi7XemPww4B4hvpKD1LQKD4RpiSKmrmgSC,1954552,21493834,-19539282,299
2022-05-07 18:48:34-04:00,18284,HCAGpyYM2NYudMd55Geta13tUbS6eiygnJY5ULHsHAVa,3PPyWhqXrmifWPieLV34bZ1rzi8eEnrDDAF7ifXkXspn,True,88709442,6895276,29170,14585,14585,8sEswn3kzEhnYjAZVvCQnHEUvYd7pFVvc2Xc2Kd1BpbC,3752859,37566011,-33813152,423
2022-05-07 18:48:34-04:00,18285,BAkPsWHtpVcEGqUgKTKjwZ6d5aaUcaUhdgYxBnpSTDW2,BDwDmVaZnXh22sf8nsDtjVfgxMAswbM3PW3si3k4nbRK,True,2642490639,660622659,1915307,957653,957654,Hu94aiQWvce6THeGyCFqGRPM1pQrK3ihzkcXo1EpJcJL,76612283,821231855,-744619572,289
2022-05-07 18:48:34-04:00,18286,Gf5g7HMy73aPnXXvgQZEiBArL7wXzx7TpivmMRDU8RJS,8ok76N32AxEocuGo7RqeZJ9a45MezH6L1My16N9UfkdA,True,9998451591,1154279957,4183328,2091664,2091664,8sEswn3kzEhnYjAZVvCQnHEUvYd7pFVvc2Xc2Kd1BpbC,362362836,1302867769,-940504933,362
2022-05-07 18:48:35-04:00,18287,HXQXfEQe7aCpr6WKh37XaDZsjZcuQPk5t8tWNFgEoK6U,5ufXkCEDwgiXwtyPye4wYVVA3oLW54JVzz4tnXFofto4,True,11947599732,2986899933,8714766,4357383,4357383,2a35JJeTUW1pm6M3e8DHCjp8qr4vbc2cRPhuzZWyFzYd,348590677,3981857442,-3633266765,291
2022-05-07 18:48:37-04:00,18288,A7j77tzgnQVGtHTa65VtVZqJRYeJvQk7am8NW6e66379,4vJGwEvXU2tGWoWWGwbsYcfKQAMCHbrBMRk4ZVFzneLs,True,9600348516,2400087129,7200201,3600100,3600101,2py1FiYeL2f7J3HU36qiJz6TD6HCmiTN36RyxYtapQCZ,288008061,1935713923,-1647705862,299
2022-05-07 18:48:38-04:00,18289,AsRi72uQLsBnyQxMBnPEhyQNM7XyNk2RV9GzPMe8PysA,9MqsYTBn6P9zCi5bGCrZurWWysW8XQZJwndHsb227rEW,True,103146768,25786692,76965,38482,38483,C4UnXuShCvjSMgBAgVNMy1oakxCNk1et27A82fywU112,3078620,33853852,-30775232,298
2022-05-07 18:48:40-04:00,18290,7GpG8k6hM27vK1R5Sx1v5xUBuF6vybP41dcymjXDi5P7,7Aip6HDcbZ5mvoSucNupRS9enRdGx37F8L432K7V81do,True,493889211,123472302,758116,379058,379058,6L1WYrPiCMyi7XemPww4B4hvpKD1LQKD4RpiSKmrmgSC,30324668,255703898,-225379230,613
2022-05-07 18:48:40-04:00,18291,5o4EAqBTiUKn41QhPL5kRjrGTgQVdP7xLtxC7xNxjkwn,E8gDreu3LxW1EHJ8hnqChK9QdffGh5GocJYKdrbYat8E,False,15882285,15882285,988210,49410,938800,68sueyVfmy5ToEGtLFGDkwebX47xAmzyXE29z8JrmcWv,988210,9567259,-8579049,622
2022-05-07 18:48:41-04:00,18292,BEuVsj9KuYBTaxrLpKwrQtHxmhRtB16siNfPXsAvf6rz,BTjWitiLbteuKMzaFj1daYyM2v9rZygESDktu8cuzC8g,True,732385364,183096341,540362,270181,270181,DA18qE9qesbBqpwNv1M4befYcNQkbSBSeLPTmQzrmbJw,21614513,36614907,-15000394,295
2022-05-07 18:48:42-04:00,18293,5zqXqEjg95BnghcVbHRhYkSTYnzZjUBichgccv1BpS3d,9SuqSxrKpHh9NcNePe4Q3jXvpCmhNnoQv8YAFih3CqMX,True,419048613,104762153,309886,154943,154943,Hu94aiQWvce6THeGyCFqGRPM1pQrK3ihzkcXo1EpJcJL,12395448,139093489,-126698041,295
2022-05-07 18:48:47-04:00,18294,CDVtXFbo4Rg2aHsXKv5P3uRJq9ZTgsRd7GXPTxgH5xv9,6zj37qQnaiJT7xGEZmSKx5yQvisQFcs5KhGsG43SGd5y,True,79552207,5468737,20429,10214,10215,8sEswn3kzEhnYjAZVvCQnHEUvYd7pFVvc2Xc2Kd1BpbC,2971837,29659360,-26687523,373
2022-05-07 18:48:48-04:00,18295,HqtTbC1LFreGvgfpZe7nCqkNnh8GHPQKosfmc19zb1yi,E39UNiHNkwQEd5GXkCtTPqSorQSB1kLx8kjzK4jdFoi3,True,142137509,35534377,103869,51934,51935,Hu94aiQWvce6THeGyCFqGRPM1pQrK3ihzkcXo1EpJcJL,4154787,30969491,-26814704,292
2022-05-07 18:48:57-04:00,18296,gCNpMXEHPTLvMvyyaYCLJrd8RRGnKAHz7sBD5j7yyBt,9cRU1ZAZRT5Ei4YAmCrPJZMHGsWspcYXTuZH58iexwDv,True,111304594,27826148,82873,41436,41437,C4UnXuShCvjSMgBAgVNMy1oakxCNk1et27A82fywU112,3314925,21155152,-17840227,297
2022-05-07 18:48:57-04:00,18297,Fczxdc24Eav8xcaKRDwWMEwPEzkGyEJ7qGcXYyGZFKVz,8GqweYpec4cnpaJvueF3FGWoaz72BAzpLYXBX7tuuqEt,True,942268719,235567179,704924,352462,352462,6L1WYrPiCMyi7XemPww4B4hvpKD1LQKD4RpiSKmrmgSC,28196984,561292617,-533095633,299
2022-05-07 18:48:57-04:00,18298,BSDeCyJsPs6y1pbDVHNq5rs6tdxcrbY3NDjXPBxwRjHz,DjHD3jawBVikzjcQ5dXBRLdUmEeBHKt6JZLhvmjScDku,True,380603759,55325242,168003,84001,84002,8sEswn3kzEhnYjAZVvCQnHEUvYd7pFVvc2Xc2Kd1BpbC,11557633,158160235,-146602602,303
2022-05-07 18:49:01-04:00,18299,8DSiP9CwJm3AEcH6uuAYFpArRRDLYpDQgjHEvjkUgfg2,ERJ8kuhPRRmUAhSM4oxUheh39YUVVYNgaTt6AdMXcCvL,True,352981147,88245286,266863,133431,133432,2a35JJeTUW1pm6M3e8DHCjp8qr4vbc2cRPhuzZWyFzYd,10674552,116088912,-105414360,302
2022-05-07 18:49:02-04:00,18300,8KzrbHiup39X7Zw9grvh7gS9ZcA1zuhLGqgYguSjwnD6,A2EPmTs73YiS15ZKcjom55huNYaJY3WeP7NBDar1VE3R,True,10197294357,2549323589,15917428,7958714,7958714,8sEswn3kzEhnYjAZVvCQnHEUvYd7pFVvc2Xc2Kd1BpbC,636697149,10639218792,-10002521643,624
2022-05-07 18:49:02-04:00,18301,rTizTweTeG3Li3BFLmtr6GmcHBs9FTcwsPKCWezWmnR,76CqzaphEXgjo9pzBKttaErJ5e9xoZaRKp5ZNB5JCf4x,True,399371922,99842980,297422,148711,148711,2a35JJeTUW1pm6M3e8DHCjp8qr4vbc2cRPhuzZWyFzYd,11896893,48086198,-36189305,297
2022-05-07 18:49:19-04:00,18302,EuMiyjSBs2ZKaPjN3FhaATvnSZG6Ak6aqdVUSApW6zM8,Hgw8jKxLXrB5G7Hk6Mh3sWZ3nHoa6Z2DzNDZGyMm4uoL,True,59887792,3366628,14733,7366,7367,8sEswn3kzEhnYjAZVvCQnHEUvYd7pFVvc2Xc2Kd1BpbC,2620939,15452037,-12831098,437
2022-05-07 18:49:20-04:00,18303,4oMasDRj8HWfknmdwt6Mkz3eonr8J2byoiSTRo4sCnFQ,3emcATkEFvDVETiK97eVET2Z2jzkgiiSxX3gu5wsUKPe,True,3716370925,467328099,3113436,1556718,1556718,2a35JJeTUW1pm6M3e8DHCjp8qr4vbc2cRPhuzZWyFzYd,247592368,1487415497,-1239823129,666
2022-05-07 18:49:22-04:00,18304,CBEv8v9XZrgFT8UdEdd813XnRVv9R7GB5PLMyG8UWGC8,4uNcMEcQpJdThpisgNrttkQJTUFTsjEr25qgjkm4titC,True,39579621,9894905,29974,14987,14987,8sEswn3kzEhnYjAZVvCQnHEUvYd7pFVvc2Xc2Kd1BpbC,1198991,9073476,-7874485,302
2022-05-07 18:49:26-04:00,18305,9qGz5Mh1XNUXqY1vEg5S1ZEMzPFvBLRbp1qaXwxSFMby,D8KnbVXStSUz3QhZGzY5o853ASocjkyu9x682oHgVoZh,True,57347190603,7414553517,28360054,14180027,14180027,2a35JJeTUW1pm6M3e8DHCjp8qr4vbc2cRPhuzZWyFzYd,2193482654,12295086598,-10101603944,382
2022-05-07 18:49:34-04:00,18306,93Jp2cnKVsSUcpoNEXmuq3K17MWt7JkW3jx6v5v2UAvN,5bos8dvpCKDxeYbXxRXwEdY8tAMZoL2XhNKUdFKxTrd6,True,133178009,24193547,94051,47025,47026,Hu94aiQWvce6THeGyCFqGRPM1pQrK3ihzkcXo1EpJcJL,5177278,85269709,-80092431,388
2022-05-07 18:49:51-04:00,18307,CDVtXFbo4Rg2aHsXKv5P3uRJq9ZTgsRd7GXPTxgH5xv9,6zj37qQnaiJT7xGEZmSKx5yQvisQFcs5KhGsG43SGd5y,True,73929886,5181458,19608,9804,9804,6L1WYrPiCMyi7XemPww4B4hvpKD1LQKD4RpiSKmrmgSC,2797824,26681280,-23883456,378
2022-05-07 18:49:58-04:00,18308,5QxR9QPTADFys9VQNm473RgprTikCXC23vhsBc9ojyAQ,H9zdf8nJ4JCF7jrwGsxiuiFoa14gzDmYsZ5N5ig3UGna,True,262043872,65510968,196941,98470,98471,68sueyVfmy5ToEGtLFGDkwebX47xAmzyXE29z8JrmcWv,7877679,31558433,-23680754,300
2022-05-07 18:50:04-04:00,18309,EVMrznfJS54BZiywDD2WhUtxzicDtbEpm2a5yLrtCgRF,CpzsMYVYvKg8ihrX1cKRw7TDEYwD3kAyiX92hsf2KiTz,True,3440903771,288196858,1477988,738994,738994,Hu94aiQWvce6THeGyCFqGRPM1pQrK3ihzkcXo1EpJcJL,176463312,2128364570,-1951901258,512
2022-05-07 18:50:13-04:00,18310,GNohZMtk1VAuhLAgNGT8J3HYCKDCiyjvLeAWr64d7Duy,6soTLVj9DzFht8DzvjRfNPAWhZuiDBS5fDE1fpeuDSSz,True,139424959,34856239,214568,107284,107284,2a35JJeTUW1pm6M3e8DHCjp8qr4vbc2cRPhuzZWyFzYd,8582726,75389985,-66807259,615
2022-05-07 18:50:21-04:00,18311,442usWu6XpJZvU25bqXeynRrQ15jAzWwU9DWMgHpTn3Q,CtvADKp39bjJf3cPKWNL3wxnhq273fVM4fC5DmEcg5cC,True,467918931,38783041,158877,79438,79439,68sueyVfmy5ToEGtLFGDkwebX47xAmzyXE29z8JrmcWv,19168649,160139975,-140971326,409
2022-05-07 18:50:43-04:00,18312,DLwEaZipqHmVBD5hc5v1NZtDStHyG4hAMwxywDTGGc2e,28GtwJw67UWfrSKxtuvpzoKzPyKXLgP3GKLm3fHdR566,True,291848139,72962034,453484,226742,226742,6L1WYrPiCMyi7XemPww4B4hvpKD1LQKD4RpiSKmrmgSC,18139385,103869768,-85730383,621
2022-05-07 18:50:51-04:00,18313,djW9rVm1v4nW64QiVqgFUCRza24VqthDcSfVEyRHPed,EsXvQmXVXECqZPtmSdiuwieHPP5jsmyn67p78vHaJcqq,True,897082613,224270653,672324,336162,336162,A2p75MbAbeUdHkPLkAjgGeiwuu9WPrkMHzjCkDXF1Xr3,26892994,60006752,-33113758,299
2022-05-07 18:50:51-04:00,18314,Gf5g7HMy73aPnXXvgQZEiBArL7wXzx7TpivmMRDU8RJS,8ok76N32AxEocuGo7RqeZJ9a45MezH6L1My16N9UfkdA,True,8808768774,458379057,1679622,839811,839811,A2p75MbAbeUdHkPLkAjgGeiwuu9WPrkMHzjCkDXF1Xr3,322776648,1259037639,-936260991,366
2022-05-07 18:50:51-04:00,18315,DX6DNEePMPiHBVFX2rDuFoy1fznGYDx6bUQB6qL6UAAb,FM9PNZ9HFZNPZDmg5mQRuMo9t49kDJEHM2CuZmNo6TnD,True,2639697499,659924374,1977403,988701,988702,Hu94aiQWvce6THeGyCFqGRPM1pQrK3ihzkcXo1EpJcJL,79096122,253714079,-174617957,299
2022-05-07 18:50:54-04:00,18316,DkKumyFA6dGw77wcwd16nWzTEC9McvmasAbmGfQXLkB7,9u6QyrruYFjhyLV5AXYUKkrBggzrxXfNH57smUAap5Ro,True,25342966,2178127,8910,4455,4455,68sueyVfmy5ToEGtLFGDkwebX47xAmzyXE29z8JrmcWv,1036777,9883353,-8846576,409
2022-05-07 18:51:09-04:00,18317,29JVska5UEG3axs63EmtHpPvkswNEqYpZ3PKMSfupiAG,DCftNBUsuogxyaJe9G9m3eWipH6o3qo4Rn4TuQXdVaBF,True,266906546,66726636,414975,207487,207488,6L1WYrPiCMyi7XemPww4B4hvpKD1LQKD4RpiSKmrmgSC,16599005,50991348,-34392343,621
2022-05-07 18:51:09-04:00,18318,HT2SuCbePhjNZaar24uVwihYowCNvSjdvhJ8BRSVw9nX,98Ts4LCnapHVoCJ5PW3Armvh4jvDtpfs3SYRLRxiAgzZ,True,196312317,12862030,63544,31772,31772,8sEswn3kzEhnYjAZVvCQnHEUvYd7pFVvc2Xc2Kd1BpbC,9698790,81273575,-71574785,494
2022-05-07 18:51:15-04:00,18319,7tFD53kPTqrzjCu1Wji78gUqhoRtCUhsP1pM3DQKT7uG,BJvgPLYBDJrQJdQVowrsMwUGMurq4zTihoFwWoEokfu3,True,1717017318,220663089,666877,333438,333439,3zqXX6kzhkbW3d4TwD2CNjMRwxTbREXySekvq37kfCNk,51890911,320867994,-268977083,302
2022-05-07 18:51:15-04:00,18320,4ZF1wtHKAnxmEZGACgbgphHvuo5aK4wC4MCNJzLYVkMX,5UXyhRP3Rjsc1RbV8BouJVQoTbWWbuPtVJY15KcHJFCN,True,39052360,9763090,29527,14763,14764,2a35JJeTUW1pm6M3e8DHCjp8qr4vbc2cRPhuzZWyFzYd,1181111,13184226,-12003115,302
2022-05-07 18:51:18-04:00,18321,5nALef7nAfNkSQSuTBLwewDby4pUx74Gzqib33Znmmt6,8xNTWK2xNK2xZPpgXfcE4QxPT2i6YvNYakiLgdQ2FqEt,True,329673388,82418347,244284,122142,122142,C4UnXuShCvjSMgBAgVNMy1oakxCNk1et27A82fywU112,9771371,25469755,-15698384,296
2022-05-07 18:51:19-04:00,18322,82EMpA1hwF9KNQy2ZB2A1HdoEowBu2CoYhW3VmohkSnk,hn67zsTzsAs2aqk6ZjfEeoRygd3CdMeCuR82h9yuiz3,True,250728518,62682129,186929,93464,93465,8sEswn3kzEhnYjAZVvCQnHEUvYd7pFVvc2Xc2Kd1BpbC,7477189,79861514,-72384325,298
2022-05-07 18:51:21-04:00,18323,Ai6G7vosJfmkRqtDAkqxRtbzELp6P5xe9r2RH3LYcLZt,8SUpKXakmhi4rYiFKnHYpgaAopomfDqEX6Efew9iM6nk,True,257025369,23545167,98638,49319,49319,8sEswn3kzEhnYjAZVvCQnHEUvYd7pFVvc2Xc2Kd1BpbC,10767633,131199486,-120431853,418
2022-05-07 18:51:23-04:00,18324,68gVM4kjmSYxT1uJW13rYSway8uVLUdcLa7sJuqHQaAf,DshroBQ3da7BcAiQpiFREsLKWbUDrBRmmZRw3Zu2Qfs9,True,1791627230,447906807,1333611,666805,666806,2py1FiYeL2f7J3HU36qiJz6TD6HCmiTN36RyxYtapQCZ,53344453,314354167,-261009714,297
2022-05-07 18:51:23-04:00,18325,BePQMfbkFe8vQ54rFkkf2dzXunPq2Xwpibrm1JVzSHLz,8R6rnjVUnMGUxx5sRjnuuyEnfyBGeet7y2jSJwVswyT3,True,120479703372,15561453575,47036988,23518494,23518494,2py1FiYeL2f7J3HU36qiJz6TD6HCmiTN36RyxYtapQCZ,3641692235,18486396650,-14844704415,302
2022-05-07 18:51:24-04:00,18326,4nj9fNW5K5hZebNaCP8PDTismTb5HK4MsJLUPLsnfN7P,B4UmvQqxb4Sc35L3YzuGR8BSQC2qKd6e4Byxni7ncYkf,True,52545170,13136292,38319,19159,19160,5HnvdJnCCcmRsm4GkXnYWd4q9RpwuvYDGEUMPkYR3Ts9,1532766,8308177,-6775411,291
2022-05-07 18:51:27-04:00,18327,Cb6MEn1MN9XQcVVd3o9J8QdK3cFWxSNETsFzhVJ8jmdh,A6yTKbggUftjbjAVu5YR1M7rg7h78ghbfofmTSnmKNGz,True,226222304,56555576,169221,84610,84611,C4UnXuShCvjSMgBAgVNMy1oakxCNk1et27A82fywU112,6768859,14754248,-7985389,299
2022-05-07 18:51:38-04:00,18328,CDVtXFbo4Rg2aHsXKv5P3uRJq9ZTgsRd7GXPTxgH5xv9,6zj37qQnaiJT7xGEZmSKx5yQvisQFcs5KhGsG43SGd5y,True,68527447,2400722,8958,4479,4479,8sEswn3kzEhnYjAZVvCQnHEUvYd7pFVvc2Xc2Kd1BpbC,2557235,24813366,-22256131,373
2022-05-07 18:51:39-04:00,18329,EMFbiJWcw1YdjiDmxj5CsHMyswXyyHeL7cfWKa8dMzHh,2LjnVQF8WSwL8XSNVypW9SouYSRbyH9A7gcw7BFtxuXS,True,110622562,27655640,76433,38216,38217,Hu94aiQWvce6THeGyCFqGRPM1pQrK3ihzkcXo1EpJcJL,3057322,37477817,-34420495,276
2022-05-07 18:51:39-04:00,18330,GpDhvRRae2uiRZ6MnJYnVR2hANNLGFGUDnsQmGjfK8AP,B2pgJ4gPdgzvx2HMJ1wagtthpZebtBk7RD3cF1zqSyT8,True,451014894,112753723,300085,150042,150043,C4UnXuShCvjSMgBAgVNMy1oakxCNk1et27A82fywU112,12003412,159016177,-147012765,266
2022-05-07 18:51:40-04:00,18331,HeSm2zBvQqagjHtopvNSWjsJ3VMp2fT8jJ32mUdmEetQ,ASZrniQV3Ej9aaBe2bwt5FMk5ZKuebwTXJ3UMGnsoSot,False,4762825,4762825,143357,7167,136190,Hu94aiQWvce6THeGyCFqGRPM1pQrK3ihzkcXo1EpJcJL,143357,1807220,-1663863,300
2022-05-07 18:51:40-04:00,18332,EuMiyjSBs2ZKaPjN3FhaATvnSZG6Ak6aqdVUSApW6zM8,Hgw8jKxLXrB5G7Hk6Mh3sWZ3nHoa6Z2DzNDZGyMm4uoL,True,56282583,2923751,12299,6149,6150,Hu94aiQWvce6THeGyCFqGRPM1pQrK3ihzkcXo1EpJcJL,2367625,14374236,-12006611,420
2022-05-07 18:51:40-04:00,18333,Gf5g7HMy73aPnXXvgQZEiBArL7wXzx7TpivmMRDU8RJS,8ok76N32AxEocuGo7RqeZJ9a45MezH6L1My16N9UfkdA,True,8320704440,876239244,3068807,1534403,1534404,8sEswn3kzEhnYjAZVvCQnHEUvYd7pFVvc2Xc2Kd1BpbC,291411749,1112294499,-820882750,350
2022-05-07 18:51:46-04:00,18334,87yYQuRW91LAqEmqEyYah7obsr4KijRrqsKdK7DGA9w,EJzredSumMNBMTYxMMHocKayWKg3A3621QJ3ArJqro8r,False,32854253,32854253,941573,47078,894495,C4UnXuShCvjSMgBAgVNMy1oakxCNk1et27A82fywU112,941573,11021313,-10079740,286
2022-05-07 18:51:46-04:00,18335,DHfy6B2AYsqMCxPLBCXMDfQn3Gr2VwJaLFHUZKqpCjsb,EPZpYaY1gCAb8pMtri5veRowBmCrCpTHBMa3Rmgt6S29,True,672423913,168105978,476738,238369,238369,C4UnXuShCvjSMgBAgVNMy1oakxCNk1et27A82fywU112,19069527,51333531,-32264004,283
2022-05-07 18:51:48-04:00,18336,FuhTkUxSaJ7kvuu9LHZaPVfdbKAQSh9W8Zzso1XPKGZp,FLoqPzREreKfRCwqtXs3CJwpTSudmXrVYCRZadWvob7j,True,814780345,203695086,590732,295366,295366,DA18qE9qesbBqpwNv1M4befYcNQkbSBSeLPTmQzrmbJw,23629313,290379029,-266749716,290
2022-05-07 18:51:48-04:00,18337,CDVtXFbo4Rg2aHsXKv5P3uRJq9ZTgsRd7GXPTxgH5xv9,6zj37qQnaiJT7xGEZmSKx5yQvisQFcs5KhGsG43SGd5y,True,66043808,4775609,17826,8913,8913,Hu94aiQWvce6THeGyCFqGRPM1pQrK3ihzkcXo1EpJcJL,2465360,25095755,-22630395,373
2022-05-07 18:51:48-04:00,18338,4Siq98BDakELWP5BzVoEN5tcg1ywRxTYs1aUcfW8spCt,2EBXLTVz1Gk9gS5JcVqCKAP5PatFGw1Vnww65Moz3SUn,True,109405849,27351462,157714,78857,78857,8sEswn3kzEhnYjAZVvCQnHEUvYd7pFVvc2Xc2Kd1BpbC,6308597,47521575,-41212978,576
2022-05-07 18:51:48-04:00,18339,Fn6J1eMQJoA5rXCwX2HjAF86AowsJfULLuYXVfzgb8aX,6Ett2WPmz4HoWVSVEZD73UzFetd3oFSh7C676MEVYd36,True,164228872,41057218,239401,119700,119701,Hu94aiQWvce6THeGyCFqGRPM1pQrK3ihzkcXo1EpJcJL,9576053,75250203,-65674150,583
2022-05-07 18:51:48-04:00,18340,HCAGpyYM2NYudMd55Geta13tUbS6eiygnJY5ULHsHAVa,3PPyWhqXrmifWPieLV34bZ1rzi8eEnrDDAF7ifXkXspn,True,81279160,15164721,59493,29746,29747,C4UnXuShCvjSMgBAgVNMy1oakxCNk1et27A82fywU112,3188683,35788592,-32599909,392
2022-05-07 18:51:49-04:00,18341,BSDeCyJsPs6y1pbDVHNq5rs6tdxcrbY3NDjXPBxwRjHz,DjHD3jawBVikzjcQ5dXBRLdUmEeBHKt6JZLhvmjScDku,True,323590607,41327075,123904,61952,61952,C4UnXuShCvjSMgBAgVNMy1oakxCNk1et27A82fywU112,9701720,143817673,-134115953,299
2022-05-07 18:51:52-04:00,18342,CXppCp4b4npkAzw175YNy6Ei8nF7jCmNbqsbVosHS6fE,FSEchHNYxt7WdBYjyuS2Ft2yUnfk56TCkY8SXdSs8hfe,True,171966100,42991525,255811,127905,127906,2a35JJeTUW1pm6M3e8DHCjp8qr4vbc2cRPhuzZWyFzYd,10232454,96434172,-86201718,595
2022-05-07 18:51:54-04:00,18343,BKmKy8n1MpB1sdSfuWy7P3c6ReSW8TEWZRsyriz3ujYo,FgRpiZFPz43vDWStgCwRJACiGKtMLkWbTGeTLPeKnnaY,True,110969522,27742380,79028,39514,39514,C4UnXuShCvjSMgBAgVNMy1oakxCNk1et27A82fywU112,3161144,37216576,-34055432,284
2022-05-07 18:51:55-04:00,18344,9XmuJX8mFX29c5uh68kK7ff1mPdvs1orJAgEP6BsVKnq,HfPpizwUoK6uEmMb9LWi464BnvjHQY9cuPppFMp1DKDA,True,60294410,15073602,43763,21881,21882,5HnvdJnCCcmRsm4GkXnYWd4q9RpwuvYDGEUMPkYR3Ts9,1750553,9811672,-8061119,290
2022-05-07 18:51:55-04:00,18345,4SQQdHTJUDv8taPXQRvEVJpUu91iCWQsv9su8tfehaQG,33CJXj1pmmatAofRvgt5in9E6SLEuy7tq4jqSwnUWP2A,True,18733449,4683362,29211,14605,14606,6L1WYrPiCMyi7XemPww4B4hvpKD1LQKD4RpiSKmrmgSC,1168463,23654638,-22486175,623
2022-05-07 18:51:55-04:00,18346,H4rTN5pSgWQYdgpEXs79UN96nSKGQ7gkfEyS8B2Fqhyk,GttqEEtxJMkyKi2dRiUrdRyqiCyYXRj91EVzjRB6Uf5d,True,148203483,37050870,111029,55514,55515,C4UnXuShCvjSMgBAgVNMy1oakxCNk1et27A82fywU112,4441193,8817956,-4376763,299
2022-05-07 18:52:31-04:00,18347,D5VZNThkv6XD6bimPshD2J3PvbPXgCbivZuPfkVxgdjc,8C77LmMk4C3KvyEb1N3scdbAgwN7J45nAcv9tkL5namB,True,564703886,141175971,880511,440255,440256,2a35JJeTUW1pm6M3e8DHCjp8qr4vbc2cRPhuzZWyFzYd,35220450,225568787,-190348337,623
2022-05-07 18:52:49-04:00,18348,AK8KFprmWXtUTpgruZZX7YvQMKybkNV18FGoWdqndEEj,3Nz7CzTMfSs1XcFxACXRo8XUDgBTzTXq8fk6ZbKBYoMS,True,138076132,34519033,214412,107206,107206,6L1WYrPiCMyi7XemPww4B4hvpKD1LQKD4RpiSKmrmgSC,8576504,35205778,-26629274,621
2022-05-07 18:53:28-04:00,18349,9qGz5Mh1XNUXqY1vEg5S1ZEMzPFvBLRbp1qaXwxSFMby,D8KnbVXStSUz3QhZGzY5o853ASocjkyu9x682oHgVoZh,True,49742318198,5548214317,22026786,11013393,11013393,5HnvdJnCCcmRsm4GkXnYWd4q9RpwuvYDGEUMPkYR3Ts9,1974803712,11068687585,-9093883873,397
2022-05-07 18:53:30-04:00,18350,4oMasDRj8HWfknmdwt6Mkz3eonr8J2byoiSTRo4sCnFQ,3emcATkEFvDVETiK97eVET2Z2jzkgiiSxX3gu5wsUKPe,True,3217652356,456624131,3023984,1511992,1511992,2py1FiYeL2f7J3HU36qiJz6TD6HCmiTN36RyxYtapQCZ,213088462,1342081929,-1128993467,662
2022-05-07 18:53:37-04:00,18351,7GpG8k6hM27vK1R5Sx1v5xUBuF6vybP41dcymjXDi5P7,7Aip6HDcbZ5mvoSucNupRS9enRdGx37F8L432K7V81do,True,363006909,90751727,553913,276956,276957,3zqXX6kzhkbW3d4TwD2CNjMRwxTbREXySekvq37kfCNk,22156552,198603727,-176447175,610
2022-05-07 18:53:39-04:00,18352,FRbeFwhUYCiHW5oP26mad8KND7CCYDbfnoNxX7GuXVp8,GrzXKxPX2WDka8i2D8sunMUsrsThKasQi8NYLwuCGygV,True,1131464601,195932536,783226,391613,391613,8sEswn3kzEhnYjAZVvCQnHEUvYd7pFVvc2Xc2Kd1BpbC,45229487,406375016,-361145529,399
2022-05-07 18:53:39-04:00,18353,5NVJU6YoZuuEjGNUUUJcGwS2Qd8b8CH7QSgMV7UWL5E7,8ZUq3o1nSkEvSfmiTz4anUpSMECCnX38MRwV7E5AGYSt,True,606146301,151536575,445276,222638,222638,Hu94aiQWvce6THeGyCFqGRPM1pQrK3ihzkcXo1EpJcJL,17811057,91021576,-73210519,293
2022-05-07 18:53:43-04:00,18354,Apqv5iu4bJ6pVg2NxjfwuvnfxDK6navHhhU1CVJEHeMa,7pDPJrxndRsLq983bEwvd3MKYnnqyQzQNMhEaC5NZYN1,True,586563152,146640788,438263,219131,219132,C4UnXuShCvjSMgBAgVNMy1oakxCNk1et27A82fywU112,17530529,88850372,-71319843,298
2022-05-07 18:53:43-04:00,18355,CKK8bNCGjTn8qR6JoY5woqo2rrQHPMRawDGNfDsrg4Zd,46jXZ7r4uPrHnRJsnRnXHdDWjjjAbi8smmHbxxLhuwVg,True,35634830,8908707,26464,13232,13232,C4UnXuShCvjSMgBAgVNMy1oakxCNk1et27A82fywU112,1058588,3413257,-2354669,297
2022-05-07 18:53:48-04:00,18356,HT2SuCbePhjNZaar24uVwihYowCNvSjdvhJ8BRSVw9nX,98Ts4LCnapHVoCJ5PW3Armvh4jvDtpfs3SYRLRxiAgzZ,True,182501114,12852445,61170,30585,30585,C4UnXuShCvjSMgBAgVNMy1oakxCNk1et27A82fywU112,8686073,80655285,-71969212,475
2022-05-07 18:53:49-04:00,18357,7A1A93jqxV65F7XwvBarhgfTm3iFh3s75jFNzVCtFnez,8Z6QWdy4zGUzuMdKhkdxzq7RaLHhJmrpYEKeqsw8bopx,True,585848727,146462181,430337,215168,215169,2a35JJeTUW1pm6M3e8DHCjp8qr4vbc2cRPhuzZWyFzYd,17213491,89162152,-71948661,293
2022-05-07 18:53:49-04:00,18358,EuMiyjSBs2ZKaPjN3FhaATvnSZG6Ak6aqdVUSApW6zM8,Hgw8jKxLXrB5G7Hk6Mh3sWZ3nHoa6Z2DzNDZGyMm4uoL,True,53182525,2487145,10190,5095,5095,C4UnXuShCvjSMgBAgVNMy1oakxCNk1et27A82fywU112,2179019,13535686,-11356667,409
2022-05-07 18:53:49-04:00,18359,93Jp2cnKVsSUcpoNEXmuq3K17MWt7JkW3jx6v5v2UAvN,5bos8dvpCKDxeYbXxRXwEdY8tAMZoL2XhNKUdFKxTrd6,True,108345420,9058585,37156,18578,18578,C4UnXuShCvjSMgBAgVNMy1oakxCNk1et27A82fywU112,4444185,71872527,-67428342,410
2022-05-07 18:53:49-04:00,18360,7PzGZgzieFyyFs1dbajkNQgVxooFUNZrj1bUsQvrSwbp,A2gDREmSmJTBPPw3sbKVY3smC9wbHMDdv87gr4Tr2ES7,True,2002486615,500621653,1514072,757036,757036,C4UnXuShCvjSMgBAgVNMy1oakxCNk1et27A82fywU112,60562889,150314246,-89751357,302
2022-05-07 18:53:57-04:00,18361,7tFD53kPTqrzjCu1Wji78gUqhoRtCUhsP1pM3DQKT7uG,BJvgPLYBDJrQJdQVowrsMwUGMurq4zTihoFwWoEokfu3,True,1488303106,208021032,603429,301714,301715,3zqXX6kzhkbW3d4TwD2CNjMRwxTbREXySekvq37kfCNk,43172911,281108596,-237935685,290
2022-05-07 18:53:57-04:00,18362,Gwj6CMXQeoWVsmD775Knsm6BmWuysFvSKo78FRLQByb4,6cvChMYj7TfDcnc8hG9H89PABJr2svspqjJSdSGD4RUt,True,18019358,1692555,10549,5274,5275,2a35JJeTUW1pm6M3e8DHCjp8qr4vbc2cRPhuzZWyFzYd,1123194,4391891,-3268697,623
2022-05-07 18:53:57-04:00,18363,DxmkdZiygge1YAwbL8U6LudY3QJkSnZMHThQXkE4Z5qy,Gi8oNcSDphbtosjFudeEPtX88bUnYid1tL9FnXnLfASU,True,149246660,37311665,111786,55893,55893,5HnvdJnCCcmRsm4GkXnYWd4q9RpwuvYDGEUMPkYR3Ts9,4471449,18514597,-14043148,299
2022-05-07 18:53:59-04:00,18364,EVMrznfJS54BZiywDD2WhUtxzicDtbEpm2a5yLrtCgRF,CpzsMYVYvKg8ihrX1cKRw7TDEYwD3kAyiX92hsf2KiTz,True,3131847374,274318889,1349989,674994,674995,8sEswn3kzEhnYjAZVvCQnHEUvYd7pFVvc2Xc2Kd1BpbC,154125785,1892881671,-1738755886,492
2022-05-07 18:53:59-04:00,18365,HabA6MLjygaKE6i9Sad4c6B8rnyobMYbtFext51rCmHj,516FG8YJxZmnGfvzWiV3TcwSF7UDdwWefjZkmi3R2SPX,False,7306213,7306213,260917,13045,247872,Hu94aiQWvce6THeGyCFqGRPM1pQrK3ihzkcXo1EpJcJL,260918,5213429,-4952511,357
2022-05-07 18:54:02-04:00,18366,7frvVhg1eWJpsvG7ndjppb8Bmd1tFq5H1g26UiKZxqTP,3Ugo9b53e6e8PLnvKjqRP8pvvoubSPV6qiKtxey7mrGt,True,45277415,11319353,33001,16500,16501,68sueyVfmy5ToEGtLFGDkwebX47xAmzyXE29z8JrmcWv,1320076,14559430,-13239354,291
2022-05-07 18:54:03-04:00,18367,CDVtXFbo4Rg2aHsXKv5P3uRJq9ZTgsRd7GXPTxgH5xv9,6zj37qQnaiJT7xGEZmSKx5yQvisQFcs5KhGsG43SGd5y,True,61134155,2000715,7571,3785,3786,Hu94aiQWvce6THeGyCFqGRPM1pQrK3ihzkcXo1EpJcJL,2313490,23671669,-21358179,378
2022-05-07 18:54:05-04:00,18368,Gf5g7HMy73aPnXXvgQZEiBArL7wXzx7TpivmMRDU8RJS,8ok76N32AxEocuGo7RqeZJ9a45MezH6L1My16N9UfkdA,True,7418470892,859905594,3040990,1520495,1520495,8sEswn3kzEhnYjAZVvCQnHEUvYd7pFVvc2Xc2Kd1BpbC,262348638,1048517102,-786168464,353
2022-05-07 18:54:05-04:00,18369,BAkPsWHtpVcEGqUgKTKjwZ6d5aaUcaUhdgYxBnpSTDW2,BDwDmVaZnXh22sf8nsDtjVfgxMAswbM3PW3si3k4nbRK,True,1960261820,490065455,1327270,663635,663635,3zqXX6kzhkbW3d4TwD2CNjMRwxTbREXySekvq37kfCNk,53090816,633238557,-580147741,270
2022-05-07 18:54:07-04:00,18370,E3LF7ohKS87kHLW78ViuRuyw7EMuiW3nVn5PRdhU7iBj,DMVXNy2NLb8jMuznjx2syKqvzctrNmQ3PfiUA83CeQR4,True,48371418,12092854,32413,16206,16207,C4UnXuShCvjSMgBAgVNMy1oakxCNk1et27A82fywU112,1296528,16560199,-15263671,268
2022-05-07 18:54:07-04:00,18371,rTizTweTeG3Li3BFLmtr6GmcHBs9FTcwsPKCWezWmnR,76CqzaphEXgjo9pzBKttaErJ5e9xoZaRKp5ZNB5JCf4x,True,296632468,74158117,217574,108787,108787,C4UnXuShCvjSMgBAgVNMy1oakxCNk1et27A82fywU112,8702997,38742946,-30039949,293
2022-05-07 18:54:07-04:00,18372,442usWu6XpJZvU25bqXeynRrQ15jAzWwU9DWMgHpTn3Q,CtvADKp39bjJf3cPKWNL3wxnhq273fVM4fC5DmEcg5cC,True,426755942,77761854,303021,151510,151511,Hu94aiQWvce6THeGyCFqGRPM1pQrK3ihzkcXo1EpJcJL,16629824,139088163,-122458339,389
2022-05-07 18:54:07-04:00,18373,Fczxdc24Eav8xcaKRDwWMEwPEzkGyEJ7qGcXYyGZFKVz,8GqweYpec4cnpaJvueF3FGWoaz72BAzpLYXBX7tuuqEt,True,699850877,174962719,516034,258017,258017,DA18qE9qesbBqpwNv1M4befYcNQkbSBSeLPTmQzrmbJw,20641397,427325738,-406684341,294
2022-05-07 18:54:11-04:00,18374,AsRi72uQLsBnyQxMBnPEhyQNM7XyNk2RV9GzPMe8PysA,9MqsYTBn6P9zCi5bGCrZurWWysW8XQZJwndHsb227rEW,True,76547852,19136963,54735,27367,27368,C4UnXuShCvjSMgBAgVNMy1oakxCNk1et27A82fywU112,2189431,26083198,-23893767,286
2022-05-07 18:54:12-04:00,18375,HXQXfEQe7aCpr6WKh37XaDZsjZcuQPk5t8tWNFgEoK6U,5ufXkCEDwgiXwtyPye4wYVVA3oLW54JVzz4tnXFofto4,True,8864651368,2216162842,6095687,3047843,3047844,C4UnXuShCvjSMgBAgVNMy1oakxCNk1et27A82fywU112,243827480,3066425624,-2822598144,275
2022-05-07 18:54:13-04:00,18376,A7j77tzgnQVGtHTa65VtVZqJRYeJvQk7am8NW6e66379,4vJGwEvXU2tGWoWWGwbsYcfKQAMCHbrBMRk4ZVFzneLs,True,7123192010,1780798002,5093462,2546731,2546731,2a35JJeTUW1pm6M3e8DHCjp8qr4vbc2cRPhuzZWyFzYd,203738483,1517515287,-1313776804,286
2022-05-07 18:54:14-04:00,18377,CBEv8v9XZrgFT8UdEdd813XnRVv9R7GB5PLMyG8UWGC8,4uNcMEcQpJdThpisgNrttkQJTUFTsjEr25qgjkm4titC,False,29389371,29389371,873672,43683,829989,8sEswn3kzEhnYjAZVvCQnHEUvYd7pFVvc2Xc2Kd1BpbC,873672,7074898,-6201226,297
2022-05-07 18:54:15-04:00,18378,5zqXqEjg95BnghcVbHRhYkSTYnzZjUBichgccv1BpS3d,9SuqSxrKpHh9NcNePe4Q3jXvpCmhNnoQv8YAFih3CqMX,True,310879261,77719815,216959,108479,108480,5HnvdJnCCcmRsm4GkXnYWd4q9RpwuvYDGEUMPkYR3Ts9,8678363,107111059,-98432696,279
2022-05-07 18:54:16-04:00,18379,E56pqwjJ773ovVX4fNf5YACoqMTspgSh5YjGNvwTam5h,6sUwG5onnHCjwaff4nrBXxMqJ7tMrA5DYYFF8YdEp6TJ,True,44199899,11049974,33346,16673,16673,68sueyVfmy5ToEGtLFGDkwebX47xAmzyXE29z8JrmcWv,1333874,5438000,-4104126,301
2022-05-07 18:54:16-04:00,18380,5nALef7nAfNkSQSuTBLwewDby4pUx74Gzqib33Znmmt6,8xNTWK2xNK2xZPpgXfcE4QxPT2i6YvNYakiLgdQ2FqEt,True,245107622,61276905,184491,92245,92246,Hu94aiQWvce6THeGyCFqGRPM1pQrK3ihzkcXo1EpJcJL,7379668,21301855,-13922187,301
2022-05-07 18:54:19-04:00,18381,BEuVsj9KuYBTaxrLpKwrQtHxmhRtB16siNfPXsAvf6rz,BTjWitiLbteuKMzaFj1daYyM2v9rZygESDktu8cuzC8g,True,543322001,135830500,377678,188839,188839,C4UnXuShCvjSMgBAgVNMy1oakxCNk1et27A82fywU112,15107129,32329151,-17222022,278
2022-05-07 18:54:19-04:00,18382,HqtTbC1LFreGvgfpZe7nCqkNnh8GHPQKosfmc19zb1yi,E39UNiHNkwQEd5GXkCtTPqSorQSB1kLx8kjzK4jdFoi3,True,105454298,26363574,72552,36276,36276,gjBMZYVujDjD1ECG4i97M8Q3gV9ESnwwTSUGropkusj,2902084,24162153,-21260069,275
2022-05-07 18:54:26-04:00,18383,iEXYXt9JNg6tud7wsHcTe349MNWHBgAoRptNpasAGwb,DNCFSLLWNWEVfsqht6EuiQ7PwCdzhHjDk9i4UpgnDTxB,True,951255209,215357321,651744,325872,325872,3zqXX6kzhkbW3d4TwD2CNjMRwxTbREXySekvq37kfCNk,28788262,146554749,-117766487,302
2022-05-07 18:54:31-04:00,18384,BePQMfbkFe8vQ54rFkkf2dzXunPq2Xwpibrm1JVzSHLz,8R6rnjVUnMGUxx5sRjnuuyEnfyBGeet7y2jSJwVswyT3,True,104488379789,14481534910,43862243,21931121,21931122,A2p75MbAbeUdHkPLkAjgGeiwuu9WPrkMHzjCkDXF1Xr3,3164785239,16353751240,-13188966001,302
2022-05-07 18:54:31-04:00,18385,FRbeFwhUYCiHW5oP26mad8KND7CCYDbfnoNxX7GuXVp8,GrzXKxPX2WDka8i2D8sunMUsrsThKasQi8NYLwuCGygV,True,930370888,86738709,366255,183127,183128,2py1FiYeL2f7J3HU36qiJz6TD6HCmiTN36RyxYtapQCZ,39285084,351553470,-312268386,422
2022-05-07 18:54:31-04:00,18386,9qGz5Mh1XNUXqY1vEg5S1ZEMzPFvBLRbp1qaXwxSFMby,D8KnbVXStSUz3QhZGzY5o853ASocjkyu9x682oHgVoZh,True,43995905230,2351651496,9378501,4689250,4689251,DA18qE9qesbBqpwNv1M4befYcNQkbSBSeLPTmQzrmbJw,1754578275,10129855594,-8375277319,398
2022-05-07 18:54:31-04:00,18387,BSDeCyJsPs6y1pbDVHNq5rs6tdxcrbY3NDjXPBxwRjHz,DjHD3jawBVikzjcQ5dXBRLdUmEeBHKt6JZLhvmjScDku,True,281090994,38908651,116345,58172,58173,68sueyVfmy5ToEGtLFGDkwebX47xAmzyXE29z8JrmcWv,8405278,132895102,-124489824,299
2022-05-07 18:54:35-04:00,18388,5QxR9QPTADFys9VQNm473RgprTikCXC23vhsBc9ojyAQ,H9zdf8nJ4JCF7jrwGsxiuiFoa14gzDmYsZ5N5ig3UGna,True,194391218,48597804,138476,69238,69238,3zqXX6kzhkbW3d4TwD2CNjMRwxTbREXySekvq37kfCNk,5539052,25443777,-19904725,284
2022-05-07 18:54:36-04:00,18389,E4VzeJLsf5Y6t3yNi8VpS8QxhJbJGPhnkNBmU2XoCBs9,63CXyYfevXtrL1QcfQtAhz29xeea5BwWcj6d6BWb4qiB,True,14372460437,3593115109,10001706,5000853,5000853,3zqXX6kzhkbW3d4TwD2CNjMRwxTbREXySekvq37kfCNk,400068244,5113703747,-4713635503,278
2022-05-07 18:54:37-04:00,18390,Bzp3ZUxzRWqW4QoLq9PtKN1HQeSaKXFQrX1G3a4ocrre,H12B3p4v1ZtZ9gaSgpxCJsKXmmEjiqaRZQzexjzAhevo,True,2814212283,272138140,1336825,668412,668413,3zqXX6kzhkbW3d4TwD2CNjMRwxTbREXySekvq37kfCNk,138242672,1078395543,-940152871,491
2022-05-07 18:54:38-04:00,18391,Ai6G7vosJfmkRqtDAkqxRtbzELp6P5xe9r2RH3LYcLZt,8SUpKXakmhi4rYiFKnHYpgaAopomfDqEX6Efew9iM6nk,True,231331508,40275061,148338,74169,74169,8sEswn3kzEhnYjAZVvCQnHEUvYd7pFVvc2Xc2Kd1BpbC,8520301,108953682,-100433381,368
2022-05-07 18:54:43-04:00,18392,BWta2HTjCwDidjsgv1vPoD3gCHSGf679N1xijEj5jzD3,JEFa5ojXJ95W2NsV5j8qBENTm5n1uGfPDFwLRvebHDVn,True,21480399,5370099,33422,16711,16711,Hu94aiQWvce6THeGyCFqGRPM1pQrK3ihzkcXo1EpJcJL,1336883,12261410,-10924527,622
2022-05-07 18:54:45-04:00,18393,9RtNbEZ4ZR8T1HFF4cujPVy2kejVBKFo3CPQi8psSa1q,7zwaGb71jKc9y2HKCKy5q2XV2YUphkyU1hkDaab1GBas,True,202555065,48693542,137140,68570,68570,8sEswn3kzEhnYjAZVvCQnHEUvYd7pFVvc2Xc2Kd1BpbC,5704790,72715580,-67010790,281
2022-05-07 18:54:53-04:00,18394,EuMiyjSBs2ZKaPjN3FhaATvnSZG6Ak6aqdVUSApW6zM8,Hgw8jKxLXrB5G7Hk6Mh3sWZ3nHoa6Z2DzNDZGyMm4uoL,True,50544181,2185603,8724,4362,4362,68sueyVfmy5ToEGtLFGDkwebX47xAmzyXE29z8JrmcWv,2017630,12690367,-10672737,399
2022-05-07 18:54:53-04:00,18395,EdCSJVDrgnE7PN9GK7t1t7hB79mBrJzyy1mMZL9u5nvM,GTy9uEWcCx4odtr1GLPpntNbdR7wJRYr3wE9P5rAaMw6,True,38765804,9691451,27377,13688,13689,6L1WYrPiCMyi7XemPww4B4hvpKD1LQKD4RpiSKmrmgSC,1095098,6073604,-4978506,282
2022-05-07 18:54:53-04:00,18396,BDJNQYGXMb8zSNmBJPWtaoAYH36uRTChuAGjrNcaA2AG,2mRdgipHSd5Q96ZQ2kJLez2YyVVG6mS75ET4Nr7eLkrX,True,101123129,25280782,71694,35847,35847,8sEswn3kzEhnYjAZVvCQnHEUvYd7pFVvc2Xc2Kd1BpbC,2867776,5880284,-3012508,283
2022-05-07 18:54:59-04:00,18397,2HtcCr92gzqZEmnEYKrsC2d2euFz7djLYzqnbDSbhd82,3wKxFATyaQK6kZd2UahQjvL9tzMGuN2767EguLmj1bot,True,20474697,5118668,31747,15873,15874,Hu94aiQWvce6THeGyCFqGRPM1pQrK3ihzkcXo1EpJcJL,1269933,6702188,-5432255,620
2022-05-07 18:55:06-04:00,18398,GMpoV2jRyLdf2V3Gb5TQZ5gEs5ftMjD3JhFUzkA6fWVz,5bi814d5gdToTLVWCmbdB6J15kMdsTQk74cZTRd62p81,True,635159849,158789962,1128923,564461,564462,8sEswn3kzEhnYjAZVvCQnHEUvYd7pFVvc2Xc2Kd1BpbC,45156940,163051626,-117894686,710
2022-05-07 18:55:12-04:00,18399,8DSiP9CwJm3AEcH6uuAYFpArRRDLYpDQgjHEvjkUgfg2,ERJ8kuhPRRmUAhSM4oxUheh39YUVVYNgaTt6AdMXcCvL,True,262166882,65541720,195967,97983,97984,72FwbpFGoLEazJEdpqNtPNefsadUrimUqma9wSoy4qiS,7838710,89469851,-81631141,298
2022-05-07 18:55:25-04:00,18400,gCNpMXEHPTLvMvyyaYCLJrd8RRGnKAHz7sBD5j7yyBt,9cRU1ZAZRT5Ei4YAmCrPJZMHGsWspcYXTuZH58iexwDv,True,82670249,20667562,60596,30298,30298,2a35JJeTUW1pm6M3e8DHCjp8qr4vbc2cRPhuzZWyFzYd,2423855,16612347,-14188492,293
2022-05-07 18:55:26-04:00,18401,CDVtXFbo4Rg2aHsXKv5P3uRJq9ZTgsRd7GXPTxgH5xv9,6zj37qQnaiJT7xGEZmSKx5yQvisQFcs5KhGsG43SGd5y,True,59038347,4059147,15200,7600,7600,8sEswn3kzEhnYjAZVvCQnHEUvYd7pFVvc2Xc2Kd1BpbC,2210826,22852313,-20641487,374
2022-05-07 18:58:39-04:00,18402,64Diz8zzEv1jDWnBQPTHPpXwaWf7vjM19RyJmkPy1viQ,G8wkGHRHMtT3mvXBkH3zgsKNs8wbpdiPUS17y4cozhkZ,True,80420782,20105195,124711,62355,62356,C4UnXuShCvjSMgBAgVNMy1oakxCNk1et27A82fywU112,4988472,16705351,-11716879,620
2022-05-07 21:21:07-04:00,18403,13GT6eaKWuaLe7wFcybCnUaYgd9DfyzYRN2FcXWgFwpC,CbwmJ7YpnvcqDyUw3L9b7dqXcA8Ju3rYrTdegeaJJbWC,True,58849113,14712278,91684,45842,45842,8sEswn3kzEhnYjAZVvCQnHEUvYd7pFVvc2Xc2Kd1BpbC,3667366,39834701,-36167335,623
2022-05-07 21:48:46-04:00,18404,DLwEaZipqHmVBD5hc5v1NZtDStHyG4hAMwxywDTGGc2e,28GtwJw67UWfrSKxtuvpzoKzPyKXLgP3GKLm3fHdR566,True,214582527,53645631,333949,166974,166975,5HnvdJnCCcmRsm4GkXnYWd4q9RpwuvYDGEUMPkYR3Ts9,13357971,81960194,-68602223,622
2022-05-07 21:48:48-04:00,18405,DEYX42wznBAqmhpLTbKKDQfGEaMALvoM5j8VmJ4sjvFH,AVjTq6EpANT28hdqnei1m4N5bKsCcADCoKJT3No4kwL3,True,34178403,8544600,53373,26686,26687,68sueyVfmy5ToEGtLFGDkwebX47xAmzyXE29z8JrmcWv,2134954,17956631,-15821677,624
2022-05-07 21:49:09-04:00,18406,4Siq98BDakELWP5BzVoEN5tcg1ywRxTYs1aUcfW8spCt,2EBXLTVz1Gk9gS5JcVqCKAP5PatFGw1Vnww65Moz3SUn,True,80914939,20228734,125055,62527,62528,gjBMZYVujDjD1ECG4i97M8Q3gV9ESnwwTSUGropkusj,5002239,37051550,-32049311,618
2022-05-07 21:49:12-04:00,18407,Fn6J1eMQJoA5rXCwX2HjAF86AowsJfULLuYXVfzgb8aX,6Ett2WPmz4HoWVSVEZD73UzFetd3oFSh7C676MEVYd36,True,121428937,30357234,189503,94751,94752,5HnvdJnCCcmRsm4GkXnYWd4q9RpwuvYDGEUMPkYR3Ts9,7580131,58578756,-50998625,624
2022-05-07 21:49:25-04:00,18408,7sgoB9mHcUoNFFdQSsBvyC4tXYzYR86ct11WQsS1FvAp,5k2QtQPgMUvj88Tmizf1pABHtC3VHJDc6BYNkB9gp19M,True,60219152,15054788,93823,46911,46912,C4UnXuShCvjSMgBAgVNMy1oakxCNk1et27A82fywU112,3752956,21722631,-17969675,623
2022-05-07 21:49:28-04:00,18409,HooxSzasW3HMoFJ6sAvRQ75Char1J5aBdJtsqfDV6myp,BCmsWwpGeV4NNfeKZKKydty2uueLGHYTJDk1WErpXsVT,True,339414294,84853573,526985,263492,263493,Hu94aiQWvce6THeGyCFqGRPM1pQrK3ihzkcXo1EpJcJL,21079433,75040841,-53961408,621
2022-05-07 21:49:44-04:00,18410,QAeXX77JVKu25JE3uWoad8TxaC6ikQREB9YXmPu2WBn,4VN6uVqqH54i8JVcMJM2SVokgAe2RbsYCrrsTLotM4Fd,True,34406893,8601723,53748,26874,26874,8sEswn3kzEhnYjAZVvCQnHEUvYd7pFVvc2Xc2Kd1BpbC,2149923,9866069,-7716146,624
2022-05-07 21:51:17-04:00,18411,DkKumyFA6dGw77wcwd16nWzTEC9McvmasAbmGfQXLkB7,9u6QyrruYFjhyLV5AXYUKkrBggzrxXfNH57smUAap5Ro,False,23045537,23045537,905660,45283,860377,2a35JJeTUW1pm6M3e8DHCjp8qr4vbc2cRPhuzZWyFzYd,905661,8038117,-7132456,392
2022-05-07 21:51:21-04:00,18412,CXppCp4b4npkAzw175YNy6Ei8nF7jCmNbqsbVosHS6fE,FSEchHNYxt7WdBYjyuS2Ft2yUnfk56TCkY8SXdSs8hfe,True,126919548,31729887,197679,98839,98840,2a35JJeTUW1pm6M3e8DHCjp8qr4vbc2cRPhuzZWyFzYd,7907162,74613825,-66706663,623
2022-05-07 21:51:30-04:00,18413,4oMasDRj8HWfknmdwt6Mkz3eonr8J2byoiSTRo4sCnFQ,3emcATkEFvDVETiK97eVET2Z2jzkgiiSxX3gu5wsUKPe,True,2727103388,344644971,2223906,1111953,1111953,6L1WYrPiCMyi7XemPww4B4hvpKD1LQKD4RpiSKmrmgSC,175973103,1166470992,-990497889,645
2022-05-07 21:52:04-04:00,18414,Gf5g7HMy73aPnXXvgQZEiBArL7wXzx7TpivmMRDU8RJS,8ok76N32AxEocuGo7RqeZJ9a45MezH6L1My16N9UfkdA,True,6540472214,335156808,1233215,616607,616608,A9TwRM1BMxqb8DCC7YNAMV6zPenEJm3HTZBy7wJKK58U,240657776,1009259381,-768601605,367
2022-05-07 21:52:05-04:00,18415,EVMrznfJS54BZiywDD2WhUtxzicDtbEpm2a5yLrtCgRF,CpzsMYVYvKg8ihrX1cKRw7TDEYwD3kAyiX92hsf2KiTz,True,2845085850,212704472,1044167,522083,522084,6UQfSsLooL4pQKQfLtXCutQS2BnF7A7F7ewJopDLmUpc,139665445,1714253346,-1574587901,490
2022-05-07 21:53:35-04:00,18416,8KzrbHiup39X7Zw9grvh7gS9ZcA1zuhLGqgYguSjwnD6,A2EPmTs73YiS15ZKcjom55huNYaJY3WeP7NBDar1VE3R,True,7491852356,1872963089,11547274,5773637,5773637,DA18qE9qesbBqpwNv1M4befYcNQkbSBSeLPTmQzrmbJw,461890986,8124086225,-7662195239,616
2022-05-07 22:00:12-04:00,18417,GpDhvRRae2uiRZ6MnJYnVR2hANNLGFGUDnsQmGjfK8AP,B2pgJ4gPdgzvx2HMJ1wagtthpZebtBk7RD3cF1zqSyT8,True,336613892,84153473,249931,124965,124966,Hu94aiQWvce6THeGyCFqGRPM1pQrK3ihzkcXo1EpJcJL,9997249,121906429,-111909180,296
2022-05-07 22:00:13-04:00,18418,EHi1UBG8wMUFZECktsFUZkGjJPaBNEedswS62hyYn6jC,Drx9ErQhAjnPuJ83LPYFnY5ZV5XDzGuXDuSf16VqWayp,True,5103509536,582641907,1942587,971293,971294,3zqXX6kzhkbW3d4TwD2CNjMRwxTbREXySekvq37kfCNk,170156253,2586110870,-2415954617,333
2022-05-07 22:00:13-04:00,18419,4ZF1wtHKAnxmEZGACgbgphHvuo5aK4wC4MCNJzLYVkMX,5UXyhRP3Rjsc1RbV8BouJVQoTbWWbuPtVJY15KcHJFCN,False,28991804,28991804,849054,42452,806602,Hu94aiQWvce6THeGyCFqGRPM1pQrK3ihzkcXo1EpJcJL,849054,10148874,-9299820,292
2022-05-07 22:00:13-04:00,18420,82EMpA1hwF9KNQy2ZB2A1HdoEowBu2CoYhW3VmohkSnk,hn67zsTzsAs2aqk6ZjfEeoRygd3CdMeCuR82h9yuiz3,True,186230078,46557519,136035,68017,68018,gjBMZYVujDjD1ECG4i97M8Q3gV9ESnwwTSUGropkusj,5441419,61546672,-56105253,292
2022-05-07 22:00:29-04:00,18421,5UDGqNpkcMDjByBNi7WYMg8VJ81EzNJu48zsXbW9irSd,FmtUoQNiG25v8sn4pveM6wAWvja9u6FvZ2gdxWHSRjur,True,26094884,6523721,40257,20128,20129,68sueyVfmy5ToEGtLFGDkwebX47xAmzyXE29z8JrmcWv,1610300,15397885,-13787585,617
2022-05-07 22:00:35-04:00,18422,93Jp2cnKVsSUcpoNEXmuq3K17MWt7JkW3jx6v5v2UAvN,5bos8dvpCKDxeYbXxRXwEdY8tAMZoL2XhNKUdFKxTrd6,True,98725023,17989884,69660,34830,34830,2a35JJeTUW1pm6M3e8DHCjp8qr4vbc2cRPhuzZWyFzYd,3822844,65051180,-61228336,387
2022-05-07 22:00:43-04:00,18423,D8BtQirMEk3W9Pq29B6KkKWrwPfmsUNpwz5npx7aGMLY,J7LMZwaSoh5hbGcwee6oPsnN4ZFD7Zp3LQWkJGNUHRfJ,True,66635843,16658960,118139,59069,59070,5HnvdJnCCcmRsm4GkXnYWd4q9RpwuvYDGEUMPkYR3Ts9,4725572,32981235,-28255663,709
2022-05-07 22:05:06-04:00,18424,HT2SuCbePhjNZaar24uVwihYowCNvSjdvhJ8BRSVw9nX,98Ts4LCnapHVoCJ5PW3Armvh4jvDtpfs3SYRLRxiAgzZ,True,168940687,23012874,107375,53687,53688,Hu94aiQWvce6THeGyCFqGRPM1pQrK3ihzkcXo1EpJcJL,7882562,74635325,-66752763,466
2022-05-07 22:05:13-04:00,18425,EuMiyjSBs2ZKaPjN3FhaATvnSZG6Ak6aqdVUSApW6zM8,Hgw8jKxLXrB5G7Hk6Mh3sWZ3nHoa6Z2DzNDZGyMm4uoL,True,48259437,4414819,17406,8703,8703,6L1WYrPiCMyi7XemPww4B4hvpKD1LQKD4RpiSKmrmgSC,1902824,12047801,-10144977,394
2022-05-07 22:05:17-04:00,18426,5Y7MpvBDW2jVq5SwkJQrVjqMSBEfwvB7dF9N1dD6s9bk,5KvuS6ew8J4KCeX46ZZmvpuSBzK2DatDJmpm7cMwMKnp,True,270089076,67522269,194669,97334,97335,6L1WYrPiCMyi7XemPww4B4hvpKD1LQKD4RpiSKmrmgSC,7786781,93423222,-85636441,288
2022-05-07 22:05:17-04:00,18427,HCAGpyYM2NYudMd55Geta13tUbS6eiygnJY5ULHsHAVa,3PPyWhqXrmifWPieLV34bZ1rzi8eEnrDDAF7ifXkXspn,True,65729717,5138068,21366,10683,10683,2a35JJeTUW1pm6M3e8DHCjp8qr4vbc2cRPhuzZWyFzYd,2733392,28895762,-26162370,415
2022-05-07 22:05:18-04:00,18428,7tFD53kPTqrzjCu1Wji78gUqhoRtCUhsP1pM3DQKT7uG,BJvgPLYBDJrQJdQVowrsMwUGMurq4zTihoFwWoEokfu3,True,1276117095,163453038,490012,245006,245006,6L1WYrPiCMyi7XemPww4B4hvpKD1LQKD4RpiSKmrmgSC,38256456,251652881,-213396425,299
2022-05-07 22:05:18-04:00,18429,EMFbiJWcw1YdjiDmxj5CsHMyswXyyHeL7cfWKa8dMzHh,2LjnVQF8WSwL8XSNVypW9SouYSRbyH9A7gcw7BFtxuXS,True,82377020,20594255,59414,29707,29707,2a35JJeTUW1pm6M3e8DHCjp8qr4vbc2cRPhuzZWyFzYd,2376566,28781979,-26405413,288
2022-05-07 22:05:20-04:00,18430,Gf5g7HMy73aPnXXvgQZEiBArL7wXzx7TpivmMRDU8RJS,8ok76N32AxEocuGo7RqeZJ9a45MezH6L1My16N9UfkdA,True,6176791375,651522815,2221715,1110857,1110858,2xTUy2RS74GJMMDnmFaegMzFLn19RVfYG4CibhBmjP1i,210630738,890315941,-679685203,341
2022-05-07 22:05:20-04:00,18431,FuhTkUxSaJ7kvuu9LHZaPVfdbKAQSh9W8Zzso1XPKGZp,FLoqPzREreKfRCwqtXs3CJwpTSudmXrVYCRZadWvob7j,True,605814047,151453511,441528,220764,220764,3zqXX6kzhkbW3d4TwD2CNjMRwxTbREXySekvq37kfCNk,17661131,223002231,-205341100,291
2022-05-07 22:05:23-04:00,18432,FncFHJooh1hy9Gc2y5sKdcYkZ5uHzsxHG4vHT9cVZGcK,BkFa4b5Jyv4ZJCCpwDYv355ezVFiZfAtn18AV7kstd2v,True,696362346,174090586,525771,262885,262886,2xTUy2RS74GJMMDnmFaegMzFLn19RVfYG4CibhBmjP1i,21030859,113799380,-92768521,302
