ts,record_id,user_authority,user,partial,base_asset_value,base_asset_value_closed,liquidation_fee,fee_to_liquidator,fee_to_insurance_fund,liquidator,total_collateral,collateral,unrealized_pnl,margin_ratio
2022-01-06 22:27:58-05:00,2049,EeUACm9TkjHKES5U7Yj1oPhYmcp7R3tvesGBiP8txEzq,3qkmm4aS6EDirEDejmbm5PDw2jpYkC7zKqrMkmgeE5BA,True,1074617,268654,1678,839,839,3zqXX6kzhkbW3d4TwD2CNjMRwxTbREXySekvq37kfCNk,67155,275482,-208327,624
2022-01-06 22:28:00-05:00,2050,6XHt7CrURSomkQrtVXV5JuKSZY4tQRpUyQKfCDaSTYaD,GCgcmPSDDBsn2smYbpiX3PJybDkQWtufPu4YRsbEEU8X,True,1569257212,392314303,2452785,1226392,1226393,3zqXX6kzhkbW3d4TwD2CNjMRwxTbREXySekvq37kfCNk,98111404,772144231,-674032827,625
2022-01-06 22:28:00-05:00,2051,EQUZQWk4WLT6LFeWZs3P9AQufFcoZouFETfhyxvuS2JM,Byc2mLXArmkjQPWaxCJksHZD2XpZyCQ2FRtDJyztU81V,True,442052411,110513102,688933,344466,344467,3zqXX6kzhkbW3d4TwD2CNjMRwxTbREXySekvq37kfCNk,27557342,196504295,-168946953,623
2022-01-06 22:28:05-05:00,2052,AtKuDfcFXqWUMnRqQpjedUMTb5CQKLc2zoqEAcQpysKQ,9bPFLYp5TDZruLLDXDYYCiPYcD982iF8xt5rfTkqwNsL,True,51765,12941,80,40,40,DddJ7EWCmYEEZETCBNgAUSg81Ls6fZtiAaY5ekJ5sXx1,3237,15389,-12152,625
2022-01-06 22:28:21-05:00,2053,EV21gv8jEvXtmGDoGRNm5LJEvTBccLMZyVDCLsp54jP3,DGxxoU52aQNoUQcxdvQtv2H5q2PhK6TGkLgNSaFgnZrb,True,20712543,5178135,31681,15840,15841,3zqXX6kzhkbW3d4TwD2CNjMRwxTbREXySekvq37kfCNk,1267246,6809500,-5542254,611
2022-01-06 22:28:24-05:00,2054,7LRBswSEDBjJzQ4YurfTxLydh7tFS2jVn5V95Z6wL7ci,fD41VYGmk66MW46KKb23vAqQvUSDScgXnVdsHhJBZzu,True,547195,136798,851,425,426,72FwbpFGoLEazJEdpqNtPNefsadUrimUqma9wSoy4qiS,34071,207694,-173623,622
2022-01-06 22:28:27-05:00,2055,8VT2nxz5ZYDJFd9uL2XZwEXxChd9pjuMJNMAcutZubL1,EhAkiRbouzUAWtqQFsN8HEEfi46UVN8H8tyBP7CbgeLe,True,42605,10651,66,33,33,3zqXX6kzhkbW3d4TwD2CNjMRwxTbREXySekvq37kfCNk,2647,15492,-12845,621
2022-01-06 22:28:30-05:00,2056,Mcbzp1LhZwpfmXTv1pqe9D1jCKHw443j9QKp6tUpzgM,8uforSMAKEih5jHfHp3gCqCvaugtCmhzVfVHA63Akz7F,True,9265036,2316259,14277,7138,7139,3zqXX6kzhkbW3d4TwD2CNjMRwxTbREXySekvq37kfCNk,571106,3818962,-3247856,616
2022-01-06 22:28:58-05:00,2057,Dc11Q7yj9HoSfndRUB8Ffaz5BcYNFnvbVWuRn8v7Zs7C,BC35JUb1znJxJhcaivpyUPt8Ydojec2ohC1TrFv7TntJ,True,2035221579,508805394,3180146,1590073,1590073,DddJ7EWCmYEEZETCBNgAUSg81Ls6fZtiAaY5ekJ5sXx1,127205851,677714824,-550508973,625
2022-01-06 22:29:02-05:00,2058,EanSXRkJu91FKUhPCzYxWkmM3PQUWcovEnoZXcd6vQ9E,Fg4EzAzHStoLRDPmoBUczdWnWrhAb7jKEujqAujLFT8,True,1596908669,399227167,2479734,1239867,1239867,GAUsoe8ZTCiGPm2hYxRPGxcPe5ShNzHK9eE3G2zgRjxd,99189365,447311710,-348122345,621
2022-01-06 22:29:10-05:00,2059,FSduW743jAGyyn8HTifEJitgb89Spp5gEeMXDE59aEHF,HjojGNpR3ACtLCP2mP8DKGyXj6SeqWPKjcCAofcyQpsm,True,856302754,214075688,1304292,652146,652146,3zqXX6kzhkbW3d4TwD2CNjMRwxTbREXySekvq37kfCNk,52171690,231167751,-178996061,609
2022-01-06 22:29:11-05:00,2060,CAkknoa9UFPMEZ1KWSfqtmnL7ArVNV3HRETLwecuuXP,4cHJYv3dxA6qjcuxUkGRuL7STWobGPKtoHFD4ACUbiWq,True,48526241,12131560,73911,36955,36956,DddJ7EWCmYEEZETCBNgAUSg81Ls6fZtiAaY5ekJ5sXx1,2956469,14892951,-11936482,609
2022-01-06 22:29:12-05:00,2061,Dn916KSmX3HqxT53hrxrbCrV3tdRMCPdaoiRLqetMrth,ATCXRiXgnjRRUbSTPBvtBXMENCqsViexSZbZ6aDaXXWA,True,5531222,1382804,8601,4300,4301,3zqXX6kzhkbW3d4TwD2CNjMRwxTbREXySekvq37kfCNk,344056,1927803,-1583747,622
2022-01-06 22:29:15-05:00,2062,CFFpbRxYEP18rqEGxxyG3bzSV13Lv7nfSmZvtUK17kCP,824UwqH2JcFsqYBk9MZ8tTnpka9udTL6WGX35YFtAJQk,True,16435297,4108824,25234,12617,12617,DddJ7EWCmYEEZETCBNgAUSg81Ls6fZtiAaY5ekJ5sXx1,1009363,5062688,-4053325,614
2022-01-06 22:29:15-05:00,2063,93ho4cgnpAJiJsG6uu2udkLVNU7rkz4QjCYfsqvpbPA5,45ouQn9gGwXqnTGfaP5CvU8fCKadBRA5kPwtfvJzykRU,True,271049887,67762471,423526,211763,211763,3zqXX6kzhkbW3d4TwD2CNjMRwxTbREXySekvq37kfCNk,16941053,69741927,-52800874,625
2022-01-06 22:29:15-05:00,2064,5hUZ9uQFcYnjAQVVaGLJWdKyg7y1XMpoo8osQ9DeY7Xd,BdYiKWsjuzJLcHh3814mJ4xQ9JxoQKKcr7AHZ7Vxoavq,True,187985,46996,288,144,144,GAUsoe8ZTCiGPm2hYxRPGxcPe5ShNzHK9eE3G2zgRjxd,11531,60817,-49286,613
2022-01-06 22:29:15-05:00,2065,Buioe5v3DyFwD9nquW5XdYeVYbSABCyg79eUHEvtvfaW,7T9gi7prCcZJkYJMSB5Ef6Bu4pAuBw4XLvumSFnqKDSi,True,3021874,755468,4655,2327,2328,DddJ7EWCmYEEZETCBNgAUSg81Ls6fZtiAaY5ekJ5sXx1,186230,1325910,-1139680,616
2022-01-06 22:29:18-05:00,2066,FjDp4bWCtqehFD7FunCrjrcdxMezTJj5aqh2VnBvHDQU,HRYeZqcqhP1RPiAGXziR1qCWwk4sF6c5ZYbvSDhX7foN,True,34258676,8564669,53227,26613,26614,3zqXX6kzhkbW3d4TwD2CNjMRwxTbREXySekvq37kfCNk,2129083,10053759,-7924676,621
2022-01-06 22:29:18-05:00,2067,CEbGTNX6WpaoKp4RBGSn9LzYM6yAYyeiMrgVYgJxA4zb,AiXUcGAFFm4tc7vKBscSNjZawV5YJqbv7D1KpxD3Zufg,True,84664323,21166080,130583,65291,65292,GAUsoe8ZTCiGPm2hYxRPGxcPe5ShNzHK9eE3G2zgRjxd,5223342,37042293,-31818951,616
2022-01-06 22:29:29-05:00,2068,3zH1b58jqbNU37y9kDTZZrotSeT8XzS1tuyAHPKWrbah,4trxDWV16x6sVcz7bxHehYHkjjyKebh3S9fyJf8txzK5,True,32330,8082,50,25,25,3zqXX6kzhkbW3d4TwD2CNjMRwxTbREXySekvq37kfCNk,2006,9749,-7743,620
2022-01-06 22:29:31-05:00,2069,8mbMH9EKd9kQDyFrYiDJCV9VaWxWCzpZBQZLyYN2yNVx,J9gT39dF1egMeQvweXYWeRAX3kpmBABijYZhfj6M2UqU,True,104180962,26045240,160182,80091,80091,3zqXX6kzhkbW3d4TwD2CNjMRwxTbREXySekvq37kfCNk,6407317,25961503,-19554186,615
2022-01-06 22:29:40-05:00,2070,4FazDUgfQ3AKoFcnWHr8E9Ht8jLA3tkxf75yrGZVHdmF,HzRMH6mbgEKydRCnnMvSsKgTEVNQi6nuzoR1xutYFdzg,True,261822,65455,408,204,204,3zqXX6kzhkbW3d4TwD2CNjMRwxTbREXySekvq37kfCNk,16327,154659,-138332,623
2022-01-06 22:29:41-05:00,2071,EgU9hX6VK7YXeCgCHVaJAMekCcyZa2MVWdKra5pN7Gwv,7y8Ad9XY34bqREvheXHT2tr8Jy11D6X3pu7yLVtjU4QV,True,42308266,10577066,66062,33031,33031,DddJ7EWCmYEEZETCBNgAUSg81Ls6fZtiAaY5ekJ5sXx1,2642496,16273397,-13630901,624
2022-01-06 22:30:01-05:00,2072,921FBgLS3A1wA77uWitsnTvW737Q2jY7tzvgWtWLXNC7,E4eJ9H7cqP9zNpMH5xRBTAp9yaBCBihuJBNd6pqzteDG,True,624106,156026,976,488,488,3zqXX6kzhkbW3d4TwD2CNjMRwxTbREXySekvq37kfCNk,39041,157436,-118395,625
2022-01-06 22:30:02-05:00,2073,ECuu1L4QGdemZ7FjAjVAAxYN6piinweY7Fuk5csVovfT,Amd8WGcpdtB8yoA83R1BUT5uryuqoKbcBexYacbrbGVX,True,13011378,3252844,20064,10032,10032,3zqXX6kzhkbW3d4TwD2CNjMRwxTbREXySekvq37kfCNk,802569,3551416,-2748847,616
2022-01-06 22:30:02-05:00,2074,H6tDNj9cHac223ckAnNfnC4bAJuNLBnf2pFk2iQdMzMP,28UL9dqgayCqCAexScXjdpobYGVDN44SGBVNAfBByk8C,True,285201652,71300413,436940,218470,218470,DddJ7EWCmYEEZETCBNgAUSg81Ls6fZtiAaY5ekJ5sXx1,17477600,127511007,-110033407,612
2022-01-06 22:30:02-05:00,2075,CCHzYXr5zMXFu8MMZNkfUWGyUcF8xy7Vvhq7tNCtZg2L,AuEXkCJTTJ3HK8iP4qTWpQr4vp6HPRJZyZwfRjF8zjfp,True,624103,156025,975,487,488,3zqXX6kzhkbW3d4TwD2CNjMRwxTbREXySekvq37kfCNk,39038,157436,-118398,625
2022-01-06 22:30:02-05:00,2076,BxXXWywnC3dSyLPJHt7owfBhgSiBWzkuD3T8hGYLqCH6,4vuwEBXXbXFMPmbJJJRop4FCWGyKR1sXhBc3EWF6MiB8,True,405608291,101402072,629119,314559,314560,DddJ7EWCmYEEZETCBNgAUSg81Ls6fZtiAaY5ekJ5sXx1,25164794,182463005,-157298211,620
2022-01-06 22:30:02-05:00,2077,3g1debT8Z2efQPuMNSDPUNZzDqarBG2acErsZ4HP7QGA,42wDHagxr5Nno3mUx6kyYGDjwR98aedRbh3ByB468agB,True,80630,20157,122,61,61,3zqXX6kzhkbW3d4TwD2CNjMRwxTbREXySekvq37kfCNk,4912,25119,-20207,609
2022-01-06 22:30:05-05:00,2078,7MSzV5yy5FmrM4j1BcYSRiTGWfit1AJahheRUaXzz349,aPSTZLxBpVr3sucjbj95emRV2J1GrUWr7wbARYqJkQZ,True,18981787,4745446,29187,14593,14594,GAUsoe8ZTCiGPm2hYxRPGxcPe5ShNzHK9eE3G2zgRjxd,1167485,4715704,-3548219,615
2022-01-06 22:30:05-05:00,2079,9gYrMXAGmGSV4VFjXzYP5WwH2aFpB1TxA6CqpYsosKLv,Dh8aH6RK48wu4fkT9xKw5XL7itxnPDuw3SDwPwvL5sva,True,112884,28221,173,86,87,3zqXX6kzhkbW3d4TwD2CNjMRwxTbREXySekvq37kfCNk,6935,34995,-28060,614
2022-01-06 22:30:05-05:00,2080,7W6ih2ZGXaE6tvuQFUPCvc7NvEJHy7UffgoVX3ZPdLXt,6uQCkeMjEXHBQxE2HD33RM1zyTsSko1fYZA1mWUggJ5B,True,109540,27385,169,84,85,3zqXX6kzhkbW3d4TwD2CNjMRwxTbREXySekvq37kfCNk,6771,35506,-28735,618
2022-01-06 22:30:05-05:00,2081,2bikYf33ZxxDmvkMNjWDGGqEpbYJPvWv5At3hzyeLEQK,5FtirUBjRAZ3k5arFFVwKz42ixWzhkEBLkaK9PraRZ78,True,624077,156019,975,487,488,3zqXX6kzhkbW3d4TwD2CNjMRwxTbREXySekvq37kfCNk,39013,157437,-118424,625
2022-01-06 22:30:05-05:00,2082,HhwiZPKZBGa16oVi739s4qtMDMTwzWXc7iwNfX63t2UP,5AnbMbAFKy85yHt5y2M5S38nNkA1vT4ejY5NjGbRNUqn,True,5895490,1473872,9173,4586,4587,3zqXX6kzhkbW3d4TwD2CNjMRwxTbREXySekvq37kfCNk,366959,2917716,-2550757,622
2022-01-06 22:30:07-05:00,2083,2ce2v2TCbjNH635NgbwTG3sqiRWYrRRaBpxPxBZJ929q,9cnoebT43FkWDFhidndGCVNiFD4NErv8DuL1Va4Jv9S8,True,25647669,6411917,39026,19513,19513,GAUsoe8ZTCiGPm2hYxRPGxcPe5ShNzHK9eE3G2zgRjxd,1561064,16359819,-14798755,608
2022-01-06 22:30:11-05:00,2084,DJiXXW7sjNsAAxWupDKBUsFhXSgPoerVYaAtJqqNgVbn,2MsqvNuJw1xQhJ3UnXt9i7oNHDuZpR9w7iE1WQcGqt5m,True,624077,156019,975,487,488,3zqXX6kzhkbW3d4TwD2CNjMRwxTbREXySekvq37kfCNk,39006,157430,-118424,625
2022-01-06 22:30:11-05:00,2085,EEcTbsFTUEifcdbPyjBLkS943daEx1RpR8F3uZxKRZbT,8V3JzDQ1VWYQLas8fxUsWJZZHe4gEmn74RehtUwLw3k5,True,22815078,5703769,34789,17394,17395,GAUsoe8ZTCiGPm2hYxRPGxcPe5ShNzHK9eE3G2zgRjxd,1391560,8725003,-7333443,609
2022-01-06 22:30:23-05:00,2086,AvwHizRhHUSahmvSg4jmTUErc7vAFSmkRAEsiKhXfW1m,3UrWYx8y9N5o9GYneSe6zyyHRTZzxwvcipQfHHYh7tEs,True,21341200,5335300,33142,16571,16571,3zqXX6kzhkbW3d4TwD2CNjMRwxTbREXySekvq37kfCNk,1325680,4974380,-3648700,621
2022-01-06 22:30:26-05:00,2087,AGhvB6x3gmvAJSnr9UVtvhKqVg3Qgh1k4roHzrNHhAaa,HhhjXT6WJnz1HQfHcwKdBppuAhc8ncUcq1mkJ4EHqgpe,True,26893,6723,42,21,21,3zqXX6kzhkbW3d4TwD2CNjMRwxTbREXySekvq37kfCNk,1682,8783,-7101,625
2022-01-06 22:31:01-05:00,2088,46TNhGwBVzedW8xSb9UY94HNeSom9iGiZzAjrKHiRM2G,7JVTiqNYeKHbyzRkKtvSEpqLPKykZso8cGUr3sX1j7QF,True,256289949,64072487,395656,197828,197828,3zqXX6kzhkbW3d4TwD2CNjMRwxTbREXySekvq37kfCNk,15826275,67787587,-51961312,617
2022-01-06 22:31:47-05:00,2089,9jeqT7xKb8hr5VRuQEFxnf93Y3zHsvmYDHz64nyE7Wte,9NqYMu528mFG2M7RYL1NuEvR9aiNAW13WwXDKuprQa7h,True,222092728,55523182,338859,169429,169430,GAUsoe8ZTCiGPm2hYxRPGxcPe5ShNzHK9eE3G2zgRjxd,13554393,85493417,-71939024,610
2022-01-06 22:31:47-05:00,2090,8trkirSQNdMmAcJdeswxs5cPjH8dD6U4eJtWiAdMsrDB,HaSzpQ45x2MipfN17U6jGBxX8tXboomVDhXNSrnEfLDr,True,19865426,4966356,30960,15480,15480,72FwbpFGoLEazJEdpqNtPNefsadUrimUqma9wSoy4qiS,1238424,5929015,-4690591,623
2022-01-06 22:31:50-05:00,2091,5jin5wXjQQ25nGM2ECrCXcg1a95vquh6kM7rMRru6Ke7,EKM657EQ8HWWgf4cssByoYHoXGjFfTspTKXAGmygAPQG,True,159952064,39988016,249853,124926,124927,GAUsoe8ZTCiGPm2hYxRPGxcPe5ShNzHK9eE3G2zgRjxd,9994136,61600500,-51606364,624
2022-01-06 22:31:52-05:00,2092,GjQQ2fQ7mrGjWZwjVYFUKp9NM1LmfkhEo675ovU5SPa8,ECgVUMRY5nB4MALs5drDyipF7YohCPuJpj2UegCs7HMn,True,131299924,32824981,205006,102503,102503,3zqXX6kzhkbW3d4TwD2CNjMRwxTbREXySekvq37kfCNk,8200249,37152926,-28952677,624
2022-01-06 22:31:57-05:00,2093,GH6Q9E1jZPTTp46aDd57UNZPNS2D6PBSwyLL3EHSjGn2,2XvwZXNsrPWx4EfPvhTP933bzCC3SJHDQ8xARfrXdVY9,True,83979849,20994962,130199,65099,65100,3zqXX6kzhkbW3d4TwD2CNjMRwxTbREXySekvq37kfCNk,5207985,60131362,-54923377,620
2022-01-06 22:31:57-05:00,2094,5RvNKzSeJ1fvqsKpcQu25evEZGmKjyEDgwsMZkykoT3P,BRqSGfE4XHXu4HrinwetWumfVTmr82iuF6Y5oSV6eMiK,True,623896,155974,975,487,488,3zqXX6kzhkbW3d4TwD2CNjMRwxTbREXySekvq37kfCNk,39016,157621,-118605,625
2022-01-06 22:32:04-05:00,2095,HAk9c831TRUhvpoK4d7PTqfJuJhSjnJUXWpnYsH85bDJ,DVSa3CJrVLTHAeFYjEF89ZjWRm86QwruUk2Y8RvGpjsr,True,139890,34971,218,109,109,GAUsoe8ZTCiGPm2hYxRPGxcPe5ShNzHK9eE3G2zgRjxd,8730,49454,-40724,624
2022-01-06 22:32:11-05:00,2096,ES1MDwRUa3hoToPKQiiZkzMYe9PDVnAQwMrEvZrzvnc1,C4wBG3xTDkmDQneB28xYnf1aBNEeq7UB8oR7NuEfLkFg,True,116974241,29243560,180678,90339,90339,3zqXX6kzhkbW3d4TwD2CNjMRwxTbREXySekvq37kfCNk,7227149,29303095,-22075946,617
2022-01-06 22:32:13-05:00,2097,gMjmD7WioyUdQdwNqE5fobLcxPwoJv5rAvLmJaf8Jjw,5n77euFjVJiwKrnbYq1KpcENW1mzBZj2BuDGyzazrkJ8,True,3928151,982037,6017,3008,3009,3zqXX6kzhkbW3d4TwD2CNjMRwxTbREXySekvq37kfCNk,240696,1367972,-1127276,612
2022-01-06 22:32:17-05:00,2098,2jDRvE3pQNjWy1NRFa4tzB3KmU5UkbUCHw8sQRFujo66,C4zNi2szDrEEh4coTF3WRUghfP4ZwAVVSYTLWfkejQRu,True,2875193350,718798337,4453569,2226784,2226785,GAUsoe8ZTCiGPm2hYxRPGxcPe5ShNzHK9eE3G2zgRjxd,178142769,714417652,-536274883,619
2022-01-06 22:32:21-05:00,2099,F9s8a7Cpiw5dw3a2aNFMofqwyDWNXvDLnSdJzoj1gRiV,GpKsQKJD79KBRWdCTkyi4zX7NaoCWsLUjrKxAwJB6o6s,True,173422990,43355747,271138,135569,135569,GAUsoe8ZTCiGPm2hYxRPGxcPe5ShNzHK9eE3G2zgRjxd,10845523,18276158,-7430635,625
2022-01-06 22:32:21-05:00,2100,6u6bPgAmK8ufACrQV99A1Y5nhGkue3KEUHmQQkcNkxwP,7636yXT5w4DcVpc7LJdN46aiggzSq6U2GXHXL5kyy9F3,True,503914211,125978552,781079,390539,390540,DddJ7EWCmYEEZETCBNgAUSg81Ls6fZtiAaY5ekJ5sXx1,31243194,193782171,-162538977,620
2022-01-06 22:32:21-05:00,2101,5PbrpM9kjzF4R2eW2UTcRVXnhqWdRQWHZJXKLN43N8WC,6ip4ocbyHusy8CsVvcrpiRCUp2nq9cY8bHpTcUU3Wztq,True,33643547,8410886,52598,26299,26299,3zqXX6kzhkbW3d4TwD2CNjMRwxTbREXySekvq37kfCNk,2103926,11171075,-9067149,625
2022-01-06 22:32:22-05:00,2102,2QStaRnbSnDhA891Lb1bxjVeMYpJUpNdqaVkw3rqU45V,DakRWPnttPoRcjY5V7WLwiwBx39BapCo9Atog8dL17Ku,True,9620053,2405013,14922,7461,7461,DddJ7EWCmYEEZETCBNgAUSg81Ls6fZtiAaY5ekJ5sXx1,596918,2226867,-1629949,620
2022-01-06 22:32:22-05:00,2103,JDeYjCLpfnzcfxDFgHf4aBcHsajwdR14GUaKAA9euzVf,EJbvKoyMZcoCx4vWa61uMbW2vr6mUhrgEuECdteVBuZZ,True,46851376,11712844,71393,35696,35697,3zqXX6kzhkbW3d4TwD2CNjMRwxTbREXySekvq37kfCNk,2855751,20738338,-17882587,609
2022-01-06 22:32:23-05:00,2104,3njiRuSRMXRzKmamyiR72Hc38PU8UDDmWdfPhgxmGxEW,5WoF3gkgygyNNbwxWgVfqGWkExcDixuzgJQQjXEZQ6J5,True,1083629766,270907441,1689228,844614,844614,DddJ7EWCmYEEZETCBNgAUSg81Ls6fZtiAaY5ekJ5sXx1,67569124,616998622,-549429498,623
2022-01-06 22:32:23-05:00,2105,J2gTwrYpzezkRupgBtgudQn5D33x6WjeBhTHnrA1qgqa,FBzoHRwqGRjnMvPEpiZVjtGZYJmAbneE4dpToXPzy8bv,True,146858233368,36714558342,228536438,114268219,114268219,3zqXX6kzhkbW3d4TwD2CNjMRwxTbREXySekvq37kfCNk,9141457524,40963710746,-31822253222,622
2022-01-06 22:32:31-05:00,2106,AHm7zF4rpaxaayBLn5QDHgJSp8KAr647s4cNvQ9wLgd7,FDM33WngED24pukBvSDpPAzinW6afVAeGReum5nyLRiC,True,3509976,877494,5462,2731,2731,DddJ7EWCmYEEZETCBNgAUSg81Ls6fZtiAaY5ekJ5sXx1,218500,1413396,-1194896,622
2022-01-06 22:32:31-05:00,2107,8MKNsuGVaoYpdQy6NNyxDvRzh2DAquBUtri4nDsixUxs,D7M1SDmpZAs8vdPCCCa96UbDF15YQDxHmoGWB57tHiir,True,17540273,4385068,26572,13286,13286,GAUsoe8ZTCiGPm2hYxRPGxcPe5ShNzHK9eE3G2zgRjxd,1062914,7243570,-6180656,605
2022-01-06 22:32:31-05:00,2108,FpqCxvTkSiwDwD5qEt6hXJxzFDLFLAQ8VevK8zwRqYun,A3p6YQisCJKpNkF7vkjZRbEfbnUt7vTZdR2zPBUSdTkk,True,1739151177,434787794,2636976,1318488,1318488,DddJ7EWCmYEEZETCBNgAUSg81Ls6fZtiAaY5ekJ5sXx1,105479072,475877684,-370398612,606
2022-01-06 22:32:31-05:00,2109,C2Dmfw4G8KKzFq38aRH2pLCRngnGZDvUUN3fHDMjFkoG,7kzJk3BTNvY3hGFNj7nDy9L5CAYus6eNiCAxWH8dSioX,True,1572668,393167,2396,1198,1198,DddJ7EWCmYEEZETCBNgAUSg81Ls6fZtiAaY5ekJ5sXx1,95850,777519,-681669,609
2022-01-06 22:32:31-05:00,2110,HdfQweV1KuYSpWdycZbpGrUc8yMcY3ZczLn1agKXMJaf,G1Ae1PZHkANkwFnhUKS1tvdFEv8dAFeojBkezh6rUNMh,True,32085391,8021347,48946,24473,24473,DddJ7EWCmYEEZETCBNgAUSg81Ls6fZtiAaY5ekJ5sXx1,1957844,11442281,-9484437,610
2022-01-06 22:32:31-05:00,2111,Fd2HrzBAr4JobRPARZwpQHHVoSCEoog32A6tKMWAC1sK,BYappsar5sQf8VLem4wrLuTtrDFH9y8pEx1aMxfuU4Pq,True,127617377,31904344,197041,98520,98521,3zqXX6kzhkbW3d4TwD2CNjMRwxTbREXySekvq37kfCNk,7881657,49295845,-41414188,617
2022-01-06 22:32:31-05:00,2112,8RmB8o4zux2sD48dEsKpsX475KRxTwdk8QULUDU9xx8R,AKSiZnb4YKVB6B86aPPqvyXquhvN9xqt45bexBCZ7nx,True,268500876,67125219,415308,207654,207654,DddJ7EWCmYEEZETCBNgAUSg81Ls6fZtiAaY5ekJ5sXx1,16612339,122988436,-106376097,618
2022-01-06 22:32:31-05:00,2113,4D7mDXe7SdmbAx7kaD1mBNuEa7DzMi6TAwXURxtLEazk,5pSnT91PHoLdN6uhPnUtoD7cboLmndn26y1XouPx8vwW,True,6284465,1571116,9345,4672,4673,3zqXX6kzhkbW3d4TwD2CNjMRwxTbREXySekvq37kfCNk,373816,1587853,-1214037,594
2022-01-06 22:32:32-05:00,2114,7CSCMFa9W52tBDVUbXbc3woAy3GByeA1wPJdp3MgznPa,3447ptuVFu6G8B6N63RmS8mRv4n9PfHneypHLvbeaGLn,True,637744643,159436159,965491,482745,482746,3zqXX6kzhkbW3d4TwD2CNjMRwxTbREXySekvq37kfCNk,38619667,213386053,-174766386,605
2022-01-06 22:32:32-05:00,2115,F2v1YwVAwXLiUgsJ5uwn4qAAkTXitn1E75fJcPnGuAcy,5rdJ4H5GxPg4Juu77mGc7uya5LwEqLzDSRyG8mQ2mDbK,True,81725915,20431478,126008,63004,63004,3zqXX6kzhkbW3d4TwD2CNjMRwxTbREXySekvq37kfCNk,5040321,31581636,-26541315,616
2022-01-06 22:32:33-05:00,2116,Bsr6kx1B6BSEd5UnJ7Z61M49iUb3bFrDVhiEtMVtPDF2,3CFd1pUJAJPA9fobwn4Jj2mRju1CWmoop4Mh4znypNWT,True,176092102,44023025,272351,136175,136176,DddJ7EWCmYEEZETCBNgAUSg81Ls6fZtiAaY5ekJ5sXx1,10894079,43923785,-33029706,618
2022-01-06 22:32:34-05:00,2117,DAku12iueL13vRoTpKLyqdGaLQ2rWF6REe8Dr8soFvNs,H2vVH3LxkhGe6x6Mdwy67BYwTKNQM6XayKx7mhrwyfJM,True,1887667,471916,2828,1414,1414,DddJ7EWCmYEEZETCBNgAUSg81Ls6fZtiAaY5ekJ5sXx1,113151,756737,-643586,599
2022-01-06 22:32:34-05:00,2118,6yw4GPvkqUbakcEWtqSCfjVLukty11xqjDpGxtEN9Km2,5ppEx7wkpqbG5nApCWMdRja3oRSheFmAAsNHUX7h2w2Y,True,6991921,1747980,10687,5343,5344,DddJ7EWCmYEEZETCBNgAUSg81Ls6fZtiAaY5ekJ5sXx1,427480,5232879,-4805399,611
2022-01-06 22:32:37-05:00,2119,ANQkPUoMjLHyRtypeKzxsKW1DFauQsh9SnB3rRgRXM1Y,7RHAExWpG8Q3PXwKhJs2yXmYK9WogGydvFYpx28p6pgr,True,307380856,76845214,471044,235522,235522,DddJ7EWCmYEEZETCBNgAUSg81Ls6fZtiAaY5ekJ5sXx1,18841792,143239518,-124397726,612
2022-01-06 22:32:37-05:00,2120,6eBSLXDMVoW2nG3n7s42RXDH8byY3C6n1RsUuegBLSrG,37dYrKnTXYer7Bu9xFfpArA4ZNo2B9bycFw9HywDtTRx,True,41979613,10494903,63333,31666,31667,DddJ7EWCmYEEZETCBNgAUSg81Ls6fZtiAaY5ekJ5sXx1,2533325,15625745,-13092420,603
2022-01-06 22:32:41-05:00,2121,6tFQaTqqffino9kwMZTL2xVNBG8k9VREFhXqVi2si3A3,3w3wGxBbS4bmXeqmvd595SAWFeXekVpnH4UdbeEs8Sx5,True,18556402,4639100,28351,14175,14176,GAUsoe8ZTCiGPm2hYxRPGxcPe5ShNzHK9eE3G2zgRjxd,1134042,5072028,-3937986,611
2022-01-06 22:32:41-05:00,2122,2FrqGFZjbiNykJyo9BZ5S9FguQJPJiTi681rJJsQ5dta,3QUncYP92NKrfpaTvuF9iQg11PXKgZAgEngwh6BbnCCj,True,3496516,874129,5309,2654,2655,GAUsoe8ZTCiGPm2hYxRPGxcPe5ShNzHK9eE3G2zgRjxd,212382,1109453,-897071,607
2022-01-06 22:32:42-05:00,2123,6dr65yANjSMmfBeKAuSxG3i16S9vMgF1CQ3zDyzh55Pn,EhrE5QpnshD41S4zPEBy2A5q2Gs2mwUrbHGo6WnT9zDP,True,1416011,354002,2096,1048,1048,3zqXX6kzhkbW3d4TwD2CNjMRwxTbREXySekvq37kfCNk,83876,566307,-482431,592
2022-01-06 22:32:43-05:00,2124,E8ifvhmyJGBGVQomo3AnZw2UcaLHcpGsTtuoCid8voU3,FMQUWTbTAfSLfrc6GTrz4DM2ZSgoxF3KtqGn8AyjVtsf,True,30140590,7535147,46700,23350,23350,DddJ7EWCmYEEZETCBNgAUSg81Ls6fZtiAaY5ekJ5sXx1,1868019,8083973,-6215954,619
2022-01-06 22:32:43-05:00,2125,3Lv2XpiD4KBUHq7Zx6u3zNhpXoySodXHH8o8f5yaaPxG,H6TN4rhpBXkEH3mZnymYNcKfmnxRH2uzfwzeLH2q6ahP,True,790488,197622,1174,587,587,DddJ7EWCmYEEZETCBNgAUSg81Ls6fZtiAaY5ekJ5sXx1,46971,264130,-217159,594
2022-01-06 22:32:44-05:00,2126,2F45BX9mRmtNCHPejKFknN5aNgGvR4vVLFjMaY1a7dR8,ALdSutsvEFRUEQGGBbi31QywTL1pdXSDWrNJzvNTaoXL,True,106195252,26548813,165342,82671,82671,DddJ7EWCmYEEZETCBNgAUSg81Ls6fZtiAaY5ekJ5sXx1,6613715,39290422,-32676707,622
2022-01-06 22:32:45-05:00,2127,6CeKxTJvFqhyNEyzySiBBKEwYVMe7j3A6nkMes4BW6o2,DzDR9XvwY1z7ygQ8YrCXrwDGHSf67JZF8BzUnuFE2fxQ,True,18525742,4631435,27601,13800,13801,3zqXX6kzhkbW3d4TwD2CNjMRwxTbREXySekvq37kfCNk,1104042,5072688,-3968646,595
2022-01-06 22:32:47-05:00,2128,9UyQC8vc6zJJaSdnjvTAzgmcsw4fC3xFBBiCC1w9Sbjx,3ppBfboe6FPmt7f6WrivspMUoAznZKWQMeh3rCgw7vjQ,True,37959153,9489788,59016,29508,29508,GAUsoe8ZTCiGPm2hYxRPGxcPe5ShNzHK9eE3G2zgRjxd,2360655,9397006,-7036351,621
2022-01-06 22:32:47-05:00,2129,8NdcaYUC1X5CP7FMDip78uqtqmCt8GcZdCzLRTYTihmb,9Ei1K9bXWXSXcBfeX5exPSXGCAu62WSKzvnnd4wHvyVh,True,556213,139053,844,422,422,DddJ7EWCmYEEZETCBNgAUSg81Ls6fZtiAaY5ekJ5sXx1,33771,189342,-155571,607
2022-01-06 22:32:50-05:00,2130,EmGW2aAG69ssWqCtbfDocRaM2u3TJsczn2HHP9jdmRvD,aypkDKsp9uqAB4F6mwvm5LofpsrFBuZT2MMWtE2eHdB,True,2734843,683710,4201,2100,2101,3zqXX6kzhkbW3d4TwD2CNjMRwxTbREXySekvq37kfCNk,168044,992417,-824373,614
2022-01-06 22:32:50-05:00,2131,GGGyesjbt7h2XHHp9u8vpiWGugFwEbrtYaKrNQSDhQd7,8tydo1ZjGHmPBSqU33tywB3f9szdsHk1ckGFe4Ay5pgs,True,213738158,53434539,318071,159035,159036,3zqXX6kzhkbW3d4TwD2CNjMRwxTbREXySekvq37kfCNk,12722875,135215658,-122492783,595
2022-01-06 22:32:50-05:00,2132,9zpPiboHF5HW7NfCx7hYdmJGwUomVMTiUFc4Um5KrDi3,8q3eBpuwV6dMNkib9N8XQAq2tBUcjSANRe5SXpd4dFhZ,True,34786480,8696620,54193,27096,27097,GAUsoe8ZTCiGPm2hYxRPGxcPe5ShNzHK9eE3G2zgRjxd,2167740,8623778,-6456038,623
2022-01-06 22:32:51-05:00,2133,8VnGmfop6qcUezAJ2M15jz2Nn6mPQgehDcJPvypq4XJn,6F6sqXNhgkW9ev8QNMm4ydywUUmemhwgydRQYNeqyUmi,True,44848135,11212033,67583,33791,33792,3zqXX6kzhkbW3d4TwD2CNjMRwxTbREXySekvq37kfCNk,2703326,32855230,-30151904,602
2022-01-06 22:33:14-05:00,2134,6NJFN855M3Q3RLTDNo57gTgAmwPD6G2E3WvMb1m5eNCN,3YpqNnonsvXaRT4nCC3G5FZx1jjVtbDPc36LiR6WK5jR,True,457150424,114287606,709718,354859,354859,3zqXX6kzhkbW3d4TwD2CNjMRwxTbREXySekvq37kfCNk,28388746,197956855,-169568109,620
2022-01-06 22:33:23-05:00,2135,GxFxvEUdWofneMmVvhCSScH9V6Zia5WJ2J9q6CpPnaq3,ATLykiHDii3Lw53MoZXwqu1FbBNPJbVNVGe2SoQMjVmY,True,26369806,6592451,41100,20550,20550,72FwbpFGoLEazJEdpqNtPNefsadUrimUqma9wSoy4qiS,1644029,9016723,-7372694,623
2022-01-06 22:34:36-05:00,2136,8swGZMrPrLAxZd7MxTbkCL13k3DmAJUw41jCp6Xo6awW,3fKnX7yTNXAT4uMmXVdTy47ALJT8h8YSD3WiBb4BGuzH,True,1394614360,348653590,2170936,1085468,1085468,3zqXX6kzhkbW3d4TwD2CNjMRwxTbREXySekvq37kfCNk,86837457,433795228,-346957771,622
2022-01-06 22:34:36-05:00,2137,D64rDiWT3YG28fCgXCmbNjYa2JakZbpKQ1D2XuLChUfV,8WmMWq8cTsGQym5pUbHm9dPCpJugBeWUMVERYFGLxWHj,True,214444465,53611116,330897,165448,165449,3zqXX6kzhkbW3d4TwD2CNjMRwxTbREXySekvq37kfCNk,13235917,48761452,-35525535,617
2022-01-06 22:35:44-05:00,2138,8E3K7vCHJ2xjdFofPRGLbMxrkm8UYEi926QmXPAFwsqe,4qHUDA1c43Dg4qi1ZPKqmpGYiEMUZ6r4UuzB5ftHCEhW,True,8514050494,2128512623,13305718,6652859,6652859,DddJ7EWCmYEEZETCBNgAUSg81Ls6fZtiAaY5ekJ5sXx1,532228735,3252564903,-2720336168,625
2022-01-06 22:35:58-05:00,2139,FhAt6pZW3k8StP9VLeWUfidpXfRLoKWdV7Wgxdh9cRy9,Guk93pTo3KcG8konHjJ52oi9rgexmmKhPQAkxZS1BtCG,True,1050728651,262682161,1640749,820374,820375,3zqXX6kzhkbW3d4TwD2CNjMRwxTbREXySekvq37kfCNk,65629996,347903258,-282273262,624
2022-01-06 22:37:56-05:00,2140,DMgPzJnMQfvpk6LWscs9V9CwnYDj4CEUgKB9S65WsTaY,BZRSLH1Vw1BQwXTZtBcgUYqmFF7TuzYxAaZ8TXUKwLUQ,True,37130,9282,57,28,29,3zqXX6kzhkbW3d4TwD2CNjMRwxTbREXySekvq37kfCNk,2312,15611,-13299,622
2022-01-06 22:37:57-05:00,2141,BAzH5niE2GX9CHGn3jK6Wv8Dd59PT95dX4dgfZXWoLPT,YNRnuEoNBPFsr7W91gc85TXAdA4ZnXfF2x951zbeRKF,True,130264,32565,202,101,101,GAUsoe8ZTCiGPm2hYxRPGxcPe5ShNzHK9eE3G2zgRjxd,8089,46914,-38825,620
2022-01-06 22:37:57-05:00,2142,Hy3kzXneDN6FUkiZctU1vWe97BYvj6yZ7QvQzehfWmNr,EhXgQg8BTniANV525RpY76z7Hrh6DuqrMChjqEoXfVJe,True,5489634,1372408,8586,4293,4293,GAUsoe8ZTCiGPm2hYxRPGxcPe5ShNzHK9eE3G2zgRjxd,343464,2229197,-1885733,625
2022-01-06 22:37:57-05:00,2143,864zY9zuCktUurPTtdGeLvUATnDqHZpT1GeWUApsXh2m,CzatBrNJUi7MeyfbNhszRaPMidgt8Xkcmy5ZwFMP9RCs,True,119037368,29759342,185202,92601,92601,3zqXX6kzhkbW3d4TwD2CNjMRwxTbREXySekvq37kfCNk,7408102,40917228,-33509126,622
2022-01-06 22:38:46-05:00,2144,G25vsB3sDqRhHoSK4KwR1TywfrJDtpejVbbevEG9sQ9a,5xFC3Hm13magnAA9GD1EnwC9PrPoEfQ7omEa9p9zCrB1,True,5339237,1334808,8255,4127,4128,3zqXX6kzhkbW3d4TwD2CNjMRwxTbREXySekvq37kfCNk,330215,1750381,-1420166,618
2022-01-06 22:39:06-05:00,2145,8WHDaiE6LqFFmCVMnPeLEQ99R6ft8b74UfmP9BqzjcE8,CGmoDGsdnjo3zMNrW78n2xxQr1aDPAiBYiXbyciLXYMu,True,1166607005,291651750,1820495,910247,910248,DddJ7EWCmYEEZETCBNgAUSg81Ls6fZtiAaY5ekJ5sXx1,72819831,355598533,-282778702,624
2022-01-06 22:39:07-05:00,2146,2VyFcgZDH1HTEvD1XaWhwqBCMmZ1k6TmZ3fEpPcBZR9E,G1wFJETTpdoc7CfypGCzkq1jssXPfUkiuLjK2cwVZ9dJ,True,341551,85387,534,267,267,DddJ7EWCmYEEZETCBNgAUSg81Ls6fZtiAaY5ekJ5sXx1,21378,136909,-115531,625
2022-01-06 22:39:27-05:00,2147,BWtXpiXn1bomr28mGfQFTx1Kd58CQipEnKmeweYowDEC,9jws1qkXvWAdEtBvURVEeGcGJzt4zG2gh8AJESvjKKrx,True,620484968,155121242,970843,485421,485422,DddJ7EWCmYEEZETCBNgAUSg81Ls6fZtiAaY5ekJ5sXx1,38833722,262279569,-223445847,625
2022-01-06 22:39:40-05:00,2148,5SwL5U5hhQXPW1HXFf4GuU4xkmXoAKx58pjY53NPHqWS,7zB7JvYFzEEwawJy7k7NXvBSG3UsbQte7JxgwvBNbS7U,True,1135670371,283917592,1776526,888263,888263,3zqXX6kzhkbW3d4TwD2CNjMRwxTbREXySekvq37kfCNk,71061069,476367994,-405306925,625
2022-01-06 22:39:43-05:00,2149,67Z7ZGhNu5xxEh9BYKWcXp9m1T4tFiE1o1M16hCzUWQA,CT7YKWixz7BhTbvg5F6M5HCyPGnHoFLNFuDV9GhoLTo3,True,13836145,3459036,21612,10806,10806,3zqXX6kzhkbW3d4TwD2CNjMRwxTbREXySekvq37kfCNk,864517,6454784,-5590267,624
2022-01-06 22:39:46-05:00,2150,CvZssqscu2dm35mwcE3zg9zedavbRjVJjWD59Py5ExUK,7pXaoR6aHKYofCmg1eHipygNYDteEaf8rbbS8BDYGQK6,True,2980136,745034,4651,2325,2326,3zqXX6kzhkbW3d4TwD2CNjMRwxTbREXySekvq37kfCNk,186041,813699,-627658,624
2022-01-06 22:40:06-05:00,2151,pgzvXpnUYiY7hLrfjmwScqLd8oj9vYcXpFvpm4y4JvG,GdqdQgoyBAFuXdbvoZyDhB3jyqJzVo4nkGh7EPFxkBF2,True,8976374,2244093,14045,7022,7023,DddJ7EWCmYEEZETCBNgAUSg81Ls6fZtiAaY5ekJ5sXx1,561800,6756517,-6194717,625
2022-01-06 22:40:26-05:00,2152,DdYgcyV1T2CDYiQVr4VL9Ym8RdKm93a7SKy8HxuyaoMW,GPdAeqeXb1UJ56AttcwwY1CyFhRyfptDC4BAX2Tc8MpE,True,2238282,559570,3502,1751,1751,3zqXX6kzhkbW3d4TwD2CNjMRwxTbREXySekvq37kfCNk,140082,901497,-761415,625
2022-01-06 22:40:26-05:00,2153,6nJyqvFKprwaVCE1gAa2P4RHKc6Pa6XFSJymx654zZ9K,4e7iJmdwzAPxp1Zi8Azo38YyPQdPKqqY4VLJyQ5rpdYP,True,10607998,2651999,16588,8294,8294,3zqXX6kzhkbW3d4TwD2CNjMRwxTbREXySekvq37kfCNk,663539,4312672,-3649133,625
2022-01-06 22:41:12-05:00,2154,BZxJ6CtrVoiU86DMMieMeDFLNWtMpHGTvZfM7nyay6o4,6CRxRR8bisRLHFJBFWjyumYuy7j4C4PkjYH1K8gXhdWD,True,12168644,3042159,19042,9521,9521,3zqXX6kzhkbW3d4TwD2CNjMRwxTbREXySekvq37kfCNk,761684,2936807,-2175123,625
2022-01-06 22:41:34-05:00,2155,Ckqos6cdncPKj13DnCmDVZsZTqp6eS7277CRrT9WhcEr,AtUV8m7VQJvZq7GLCAHMf3jV7iamKEPnWVZHWuuVZQp1,True,5279660,1319915,8199,4099,4100,3zqXX6kzhkbW3d4TwD2CNjMRwxTbREXySekvq37kfCNk,327986,2615374,-2287388,621
2022-01-06 22:41:34-05:00,2156,9vcKW1GfrDZ3KLPh2pEVFF8ZyKqD1pJW1hiE8H98Av7S,C6Ki27mo4sCHu6u8UnR1p7WSgsTjFQxGGR9Lk9n5Rhjq,True,11813483,2953370,18331,9165,9166,3zqXX6kzhkbW3d4TwD2CNjMRwxTbREXySekvq37kfCNk,733245,4501926,-3768681,620
2022-01-06 22:41:35-05:00,2157,zLTuMVfVswjMkhyvjaXnvjcKXv5xNk3iSWSjRGpVqXf,J3D8NHUJCiSjvFYfJ5Es4YDhF1KcPZWRUmCQ5L92t8eB,True,517612018,129403004,807041,403520,403521,DddJ7EWCmYEEZETCBNgAUSg81Ls6fZtiAaY5ekJ5sXx1,32281651,160755345,-128473694,623
2022-01-06 22:41:35-05:00,2158,2jPxG5FL6D6XEJsRszJ9cmQ54AWSpZyPFSbn3DpWBSuM,3toQou4UVNvyWYvMvkuv379RVEF2aN2TzCpKKBUqeQV6,True,821192343,205298085,1282044,641022,641022,3zqXX6kzhkbW3d4TwD2CNjMRwxTbREXySekvq37kfCNk,51281799,266851856,-215570057,624
2022-01-06 22:41:37-05:00,2159,Gbxc51WERLLeCtiHv7rDvE52aqF541RoQWG5n5aqErq6,4ngBoHbfXijLMqGKxFMNht9sbmxy2g5eqBmn8QsBmbx1,True,3213404,803350,5009,2504,2505,4BnQKPLuE3DMTtxp8MjUBytgnhvxqq3ZTqZHTVZo4JJh,200386,1194230,-993844,623
2022-01-06 22:41:37-05:00,2160,CBL2NbekJrXvBiAcoj4fzQ4PfLDwTntW7Zt4nruHFYEw,59EvfgYTdKkfjUJz5LddLUAqbEdLaihcMzjcrTZsyzyS,True,39783,9945,61,30,31,4BnQKPLuE3DMTtxp8MjUBytgnhvxqq3ZTqZHTVZo4JJh,2472,12884,-10412,621
2022-01-06 22:41:37-05:00,2161,6cnA7PeqQgpZdA7jBg4yMzTusm8JJHRWBMup84ywJfYo,FLqcukY7RehqY6ACrwVJnGH3eRgRDe93K1jLYCQN2F3U,True,464426888,116106722,725307,362653,362654,3zqXX6kzhkbW3d4TwD2CNjMRwxTbREXySekvq37kfCNk,29012296,198943722,-169931426,624
2022-01-06 22:41:38-05:00,2162,CRaKcudjkQiSw5YPVjTLVdXvJskeGiHSYtq5ZcMPJhgQ,AgqTg3b3bAcaBmRidhNC4Uf9ZwNbeH52RQEqumWyuUs7,True,3681381,920345,5674,2837,2837,3zqXX6kzhkbW3d4TwD2CNjMRwxTbREXySekvq37kfCNk,226997,1824516,-1597519,616
2022-01-06 22:41:39-05:00,2163,M69XSefqeum2arinvHEqmA3L2XHWNFN17p4msRhRZXf,2vK15yYUANLSbAoiBfgJ9VLyqsmtEpd2iNytQjms8GaQ,True,1152042072,288010518,1787864,893932,893932,GAUsoe8ZTCiGPm2hYxRPGxcPe5ShNzHK9eE3G2zgRjxd,71514588,601962189,-530447601,620
2022-01-06 22:41:39-05:00,2164,HVZkXeDR3mc8oB9qFFwCK4RXpPojdcHk9tRGep6xtKGK,Bh3py7awPejWqeTMxtAgF7mPotL2Asxf8YrYJykq9nBt,True,28038777,7009694,43611,21805,21806,GAUsoe8ZTCiGPm2hYxRPGxcPe5ShNzHK9eE3G2zgRjxd,1744478,9304066,-7559588,622
2022-01-06 22:41:41-05:00,2165,3qnPsgqW11AcDEmyjmJquPcPLyE3EdJQuVLJ5kinDrd3,86rZadBB7emKio76aFTahpbrFtxd9tqZ4Mxgzaavq2xU,True,671832,167958,1049,524,525,3zqXX6kzhkbW3d4TwD2CNjMRwxTbREXySekvq37kfCNk,41988,224456,-182468,624
2022-01-06 22:41:41-05:00,2166,6oroGB3mvzK3tDfiB9X2NJuL3x476pxhgRnt7VxqhdLo,2SoK8tKkLn2ppKURpTVazKsCEis4uahkHMsac1m85J4r,True,7616904,1904226,11831,5915,5916,3zqXX6kzhkbW3d4TwD2CNjMRwxTbREXySekvq37kfCNk,473270,5511342,-5038072,621
2022-01-06 22:41:53-05:00,2167,5rW9kqXB9feGSKSvSMNJF1FCsBYV3vGmTmc8MvzaZ3pi,7AjnjcfPJevW5521hXw4VtgRCfHSsAqyzyArukKfNcHo,True,46764183,11691045,72977,36488,36489,4BnQKPLuE3DMTtxp8MjUBytgnhvxqq3ZTqZHTVZo4JJh,2919104,19148558,-16229454,624
2022-01-06 22:41:57-05:00,2168,BrHRMouGRz3LBNzd9anfdYMhWfg8yUPHL4PqJ8WdEDFS,4uzoLa3mC2VYHAPBoHLX4gTjPTC28rPf2fvEGtJWPYc,True,258651050,64662762,402005,201002,201003,3zqXX6kzhkbW3d4TwD2CNjMRwxTbREXySekvq37kfCNk,16080232,176486018,-160405786,621
2022-01-06 22:41:57-05:00,2169,8sneA6wAg6geVDJ1g7YWg4R1PfjuRVzeHp1nUBJinhZa,14i1uWtmcTjrdbg3DSr9vzd5NBnxqsn1A4QdgFBZqeYM,True,514527,128631,803,401,402,3zqXX6kzhkbW3d4TwD2CNjMRwxTbREXySekvq37kfCNk,32128,175270,-143142,624
2022-01-06 22:41:57-05:00,2170,DmEVzPyCKnm89v481V2ic57vyikwwMja75uVZ2rjvjfp,38fPZzP4NwTtx7Qu6DLSqx9Sv8e5CQbSrr2BMvVmSy4J,True,136601287,34150321,213090,106545,106545,3zqXX6kzhkbW3d4TwD2CNjMRwxTbREXySekvq37kfCNk,8523628,59597368,-51073740,623
2022-01-06 22:41:57-05:00,2171,2FEbsetZMkRqLjSC8GBbgecKgX5T1T1fci2sLQux29p8,H722Fcd6DkTFRZxqQWbPDufBfXEgmFfhiEpQZWhxwYv1,True,20535203,5133800,32006,16003,16003,3zqXX6kzhkbW3d4TwD2CNjMRwxTbREXySekvq37kfCNk,1280263,6053368,-4773105,623
2022-01-06 22:41:57-05:00,2172,U3vvMQ4X4aKzVYfhMw1V1p58HRqaLnuXozqmmefYeD9,7JA94MArkNCFRhBq8f5a32DgMF6aPdFsoC5HvXDQ6NuR,True,1334841213,333710303,2080296,1040148,1040148,3zqXX6kzhkbW3d4TwD2CNjMRwxTbREXySekvq37kfCNk,83211846,557107728,-473895882,623
2022-01-06 22:41:59-05:00,2173,CagSUfZLwXuCdypC4KzU6FSNdmCj9dKDroPcNeaRtsyt,yxw5d1ztZuEUY2QjL7eLpr72QJAj5rJd6ERvg91cy1m,True,6874908,1718727,10659,5329,5330,GAUsoe8ZTCiGPm2hYxRPGxcPe5ShNzHK9eE3G2zgRjxd,426389,1984725,-1558336,620
2022-01-06 22:42:00-05:00,2174,DC4UVUDFWL3gVtgkX9hPtFgtxaA8DH5p94i4k9U3wyWv,3HCWqVvQQfRgSKitsTjGTduJ82ointZUSNtj13uea4kD,True,10680296858,2670074214,16608119,8304059,8304060,3zqXX6kzhkbW3d4TwD2CNjMRwxTbREXySekvq37kfCNk,664324785,2576157563,-1911832778,622
2022-01-06 22:42:00-05:00,2175,HGJoZvLakWfSDFwuvShNBc4kCf7nP7VqzyM3mELpbFEf,12Qn5jin7QvsBngXqYAv4UstyG3b6nRf1jsLp9Dp8G7k,True,68933024,17233256,107307,53653,53654,4BnQKPLuE3DMTtxp8MjUBytgnhvxqq3ZTqZHTVZo4JJh,4292294,24340550,-20048256,622
2022-01-06 22:42:00-05:00,2176,GqAS41YJssg9aaEp3hs3sG98APCsXhiQBQszXaSjZ2bN,2wodJ3AhrXdE1T4oVL95KvoBND7PubG5Wd5GWiLCMZJU,True,807265491,201816372,1255329,627664,627665,3zqXX6kzhkbW3d4TwD2CNjMRwxTbREXySekvq37kfCNk,50213170,554829916,-504616746,622
2022-01-06 22:42:05-05:00,2177,7PzGZgzieFyyFs1dbajkNQgVxooFUNZrj1bUsQvrSwbp,A2gDREmSmJTBPPw3sbKVY3smC9wbHMDdv87gr4Tr2ES7,True,12085615,3021403,18784,9392,9392,GAUsoe8ZTCiGPm2hYxRPGxcPe5ShNzHK9eE3G2zgRjxd,751398,4044718,-3293320,621
2022-01-06 22:42:07-05:00,2178,B4Uc39nKzz9wBRQsCkMR4A7RwTJ8rSuwpR6EQn2AesRb,H49bGZgatRZVpj6QufZRVgYrQtH7LpdbiqKBs23151m,True,109993369,27498342,171506,85753,85753,GAUsoe8ZTCiGPm2hYxRPGxcPe5ShNzHK9eE3G2zgRjxd,6860277,83753650,-76893373,623
2022-01-06 22:42:07-05:00,2179,ymyzGH4Qc7HH5PbKpVphCbsQgLLXyGkPcXamQJuNj5C,8oTLHaV2XzbKXNWRuUjCfHjUn61Pw93LYK14m9q2VDpZ,True,58454945,14613736,91077,45538,45539,DddJ7EWCmYEEZETCBNgAUSg81Ls6fZtiAaY5ekJ5sXx1,3643097,16898667,-13255570,623
2022-01-06 22:42:07-05:00,2180,9WJBnVi84E926j7xEd566WzrZJkPJWRgmEnYj9vyjuad,4dLaFS5F7TGyLdwuJLMGkz3bSL53aHzd9ZfpNmhHxXeF,True,92091867,23022966,141430,70715,70715,3zqXX6kzhkbW3d4TwD2CNjMRwxTbREXySekvq37kfCNk,5657228,34888871,-29231643,614
2022-01-06 22:42:07-05:00,2181,DvuRmJkfn6FQczUKgYeaSCqwy2NTMunuAKNrnmxMvnzS,7LpWTX9dgBtW75kfEoB5WuNsDwEdw5s8CYSHh3J4qagM,True,517463740,129365935,799296,399648,399648,DddJ7EWCmYEEZETCBNgAUSg81Ls6fZtiAaY5ekJ5sXx1,31971840,185344754,-153372914,617
2022-01-06 22:42:10-05:00,2182,3C2MZQKh9x4zNTCMbhhvoafGaFMwUooqfy9MCgPyXs6E,AHjgWKpYPWe6ketjDHDKFBFsKQiRJ41jnkuo39MVYxZo,True,899716166,224929041,1399614,699807,699807,3zqXX6kzhkbW3d4TwD2CNjMRwxTbREXySekvq37kfCNk,55984597,418690241,-362705644,622
2022-01-06 22:42:10-05:00,2183,4uygLJDk9DFCifJ56YwMrEsvd3oQNq8tYSLnMCyWorS6,GimL4uKGvg3FFmFQSWzAcjstv3Vmk5NMgDGMKTuXYVpB,True,3107403747,776850936,4748078,2374039,2374039,DddJ7EWCmYEEZETCBNgAUSg81Ls6fZtiAaY5ekJ5sXx1,189923142,909027835,-719104693,611
2022-01-06 22:42:10-05:00,2184,DYCYiQFH9QHzCo3eAw1pFoDu7pzwFMo1E2WDZjVFRz5w,CPh4FWsGak1kd1WFEH9qBjNhnun3R2tHtZA57zW8ugn5,True,220358009,55089501,339026,169513,169513,DddJ7EWCmYEEZETCBNgAUSg81Ls6fZtiAaY5ekJ5sXx1,13561047,90930553,-77369506,615
2022-01-06 22:42:14-05:00,2185,AUH6YGBV8tDVX1E1WTo92Mubfx1DGsqfGeyUBqxo4fSr,33QZgMwmW32WuvmxD8XNbmF9ea88bLe3YTtNwHV73Wwu,True,1252255239,313063809,1948482,974241,974241,3zqXX6kzhkbW3d4TwD2CNjMRwxTbREXySekvq37kfCNk,77939285,285534046,-207594761,622
2022-01-06 22:42:14-05:00,2186,8kJu5aqVSmW8FSZR9h6F75ftn9V2U9uMLBEKeqRaC855,FhVHByujkvwwtjTVpZ4mqSUqoMoBgeLUc5H7rbz3FgAt,True,529602910,132400727,812173,406086,406087,4BnQKPLuE3DMTtxp8MjUBytgnhvxqq3ZTqZHTVZo4JJh,32486954,234189070,-201702116,613
2022-01-06 22:42:15-05:00,2187,399591e8XgY52yCMorCQ2WL6dQZTC485ZooHtmGuirhZ,JCiXAooFmKmEPQ2S7C8iSk6CLcTyrPEe1SsPSLyUGySe,True,6414578,1603644,9819,4909,4910,DddJ7EWCmYEEZETCBNgAUSg81Ls6fZtiAaY5ekJ5sXx1,392765,2836683,-2443918,612
2022-01-06 22:42:24-05:00,2188,FsMiJiJZibohKoV5QRisWCjzuFd86xSxFb4m73AQmu93,7p3TSKBaG9SV2YNDnhutQKacPKpTTmgsEfzmK51t6sYb,True,1250126552,312531638,1949676,974838,974838,3zqXX6kzhkbW3d4TwD2CNjMRwxTbREXySekvq37kfCNk,77987043,277740491,-199753448,623
2022-01-06 22:42:24-05:00,2189,A4tDE948CPFPh1UwHb8sXryfKktbxZ8BCkqXgA5DJHA8,3zXeKMrsEpCe5fQumLNzCgpxcG1kLJFEAtJuqxLsC6ZG,True,518679330,129669832,801147,400573,400574,3zqXX6kzhkbW3d4TwD2CNjMRwxTbREXySekvq37kfCNk,32045915,166255594,-134209679,617
2022-01-06 22:42:24-05:00,2190,D9VKhnfLLCrntDGFYSfoxFaY76VnHmYZ1ZbyFXdKdibz,2hRCRH2pMDyQGYcXHa8Y6BZo6FbcGZf5VJC1v8Bp6tGa,True,550556319,137639079,850269,425134,425135,4BnQKPLuE3DMTtxp8MjUBytgnhvxqq3ZTqZHTVZo4JJh,34010785,145318156,-111307371,617
2022-01-06 22:42:24-05:00,2191,FnAT8HKGgisYfeAbxKU2gSbCp8KbZHULRpaJX1NVijHy,2u637Crc2QzfSJmCnRNqeib3aZQVn4NGncpgM3Ph6jvm,True,205325382,51331345,318567,159283,159284,3zqXX6kzhkbW3d4TwD2CNjMRwxTbREXySekvq37kfCNk,12742687,45627305,-32884618,620
2022-01-06 22:42:24-05:00,2192,BPsM1um9ZJf7eNoVMsQCRSwgARMuLCGGSDxf9tZeNeEy,BpzDdXfxVygiSYSmsHV6uPxQMeTFtrURMCCqhswQjd5X,True,5124017,1281004,8018,4009,4009,3zqXX6kzhkbW3d4TwD2CNjMRwxTbREXySekvq37kfCNk,320740,1524214,-1203474,625
2022-01-06 22:42:47-05:00,2193,7iUx7JBwqUvPVPeCqMEXQdLccZJmaFYm1DUQiu3ouHa3,3EVZzhRmJnX9ZiBZZo9tenDtMogAyuA1yf2cKzvUWiuu,True,3638968,909741,5690,2845,2845,3zqXX6kzhkbW3d4TwD2CNjMRwxTbREXySekvq37kfCNk,227611,1378598,-1150987,625
2022-01-06 22:42:47-05:00,2194,DMgD2KCEhTGFLUZ5GnfNcwfiiwKYbyVpoWiN6knMkCAf,5KU2vgBkPTNVHsSULjgX7ZkZS56U3Dy3xqLTxL5sUZJ3,True,6058199100,1514549775,9480337,4740168,4740169,4BnQKPLuE3DMTtxp8MjUBytgnhvxqq3ZTqZHTVZo4JJh,379213489,2998846952,-2619633463,625
2022-01-06 22:42:53-05:00,2195,EanSXRkJu91FKUhPCzYxWkmM3PQUWcovEnoZXcd6vQ9E,Fg4EzAzHStoLRDPmoBUczdWnWrhAb7jKEujqAujLFT8,True,1173143505,293285876,1804290,902145,902145,DddJ7EWCmYEEZETCBNgAUSg81Ls6fZtiAaY5ekJ5sXx1,72171634,357890722,-285719088,615
2022-01-06 22:42:55-05:00,2196,Dc11Q7yj9HoSfndRUB8Ffaz5BcYNFnvbVWuRn8v7Zs7C,BC35JUb1znJxJhcaivpyUPt8Ydojec2ohC1TrFv7TntJ,True,1493978301,373494575,2289695,1144847,1144848,3zqXX6kzhkbW3d4TwD2CNjMRwxTbREXySekvq37kfCNk,91587821,537058757,-445470936,613
2022-01-06 22:43:09-05:00,2197,3VdSA9CED9f5swRwHX2U15U7J6Muaq8VPnCNy9CaGDHe,2YYstfnfdYic5NWmEbcUEHpccNUVd1EhuCkExvMsoMk8,True,29995653,7498913,46639,23319,23320,3zqXX6kzhkbW3d4TwD2CNjMRwxTbREXySekvq37kfCNk,1865595,13371327,-11505732,621
2022-01-06 22:43:10-05:00,2198,AvwHizRhHUSahmvSg4jmTUErc7vAFSmkRAEsiKhXfW1m,3UrWYx8y9N5o9GYneSe6zyyHRTZzxwvcipQfHHYh7tEs,True,15688310,3922077,24373,12186,12187,3zqXX6kzhkbW3d4TwD2CNjMRwxTbREXySekvq37kfCNk,974948,4029079,-3054131,621
2022-01-06 22:43:12-05:00,2199,9KD2AifD5wFD4QkHYuawXbJgLWHrfj2QPF3fT8jhGVA5,Ga9gAqmkuHbqrr31sUFPqa1xa5WNxLWJWGPUaMxQqLdj,True,5821287,1455321,8963,4481,4482,3zqXX6kzhkbW3d4TwD2CNjMRwxTbREXySekvq37kfCNk,358552,2634057,-2275505,615
2022-01-06 22:43:12-05:00,2200,36ByQojnxEckWdQTjqHfxKqCx9yjqWQsPsZyqaN72UWR,AZoirtS1fjX61agRM64tqThVinnJTh3BWgiHyNHPTgZP,True,3555651,888912,5473,2736,2737,3zqXX6kzhkbW3d4TwD2CNjMRwxTbREXySekvq37kfCNk,218946,1558878,-1339932,615
2022-01-06 22:43:19-05:00,2201,6uZobpBuFcQeYgZ4dApFi6iy4DB9GLHP1AAsQcCj6212,SGGFiPjjhscwroiWMqY4jTAHFw8eakpsEv35wNoHUPY,True,571665187,142916295,884767,442383,442384,3zqXX6kzhkbW3d4TwD2CNjMRwxTbREXySekvq37kfCNk,35390706,161068827,-125678121,619
2022-01-06 22:43:20-05:00,2202,8xQ3tsWVUe75EG1HmocULJ3kh52utveoFMEPotTGrKno,i3SKW3ywrwYucX9ySEx1C4zaUKGnzLerP3V38437NyV,True,261436594,65359147,405423,202711,202712,DddJ7EWCmYEEZETCBNgAUSg81Ls6fZtiAaY5ekJ5sXx1,16216927,94211292,-77994365,620
2022-01-06 22:43:20-05:00,2203,BYvjENe16Ta77PqGV7JKEWrsqCTfkMGYwTSG5gXneDvd,EvxAXgvhPC6QkNurbK7vWyTApGo8J2R4EgMAknkHVU3d,True,13129614,3282403,20450,10225,10225,4BnQKPLuE3DMTtxp8MjUBytgnhvxqq3ZTqZHTVZo4JJh,818019,6670884,-5852865,623
2022-01-06 22:43:22-05:00,2204,5Rxuqgs4CaSKbfDXqBMFXkLTQ9dxrUjThXzoy3ouYVtK,BgvbKru66ebrGUcFFymGTmsaQv6GgcGMybiWaXqzBtwX,True,925771,231442,1445,722,723,3zqXX6kzhkbW3d4TwD2CNjMRwxTbREXySekvq37kfCNk,57820,439066,-381246,624
2022-01-06 22:43:28-05:00,2205,Cs2YxkuqBK1kjoYZbUZdUcxapPbv8oC75trwGgWoCPfG,2PgHQM1GhHykE4bQ1ggueAw2Zs1BFUW5hxvMvr8DojKM,True,241296413,60324103,376318,188159,188159,4BnQKPLuE3DMTtxp8MjUBytgnhvxqq3ZTqZHTVZo4JJh,15052739,111224434,-96171695,623
2022-01-06 22:43:28-05:00,2206,6rb3fRVWJ5cSzFcmuC1YwdrNxiNctvboDF7HwsfyGoCA,H6JaYfFZkRk6iSJrA4nVeuFpMVQtVwQZHVgK1TyaupTE,True,184249,46062,287,143,144,4BnQKPLuE3DMTtxp8MjUBytgnhvxqq3ZTqZHTVZo4JJh,11496,121023,-109527,623
2022-01-06 22:43:30-05:00,2207,DR7XL3qweFyTKDatQYS2LacqGLv2368cnGuWpEpk4hSL,Fd3BYCiiQfThDJsxBUNwYTMP8eNCrnXMVzE1wpejJqXa,True,20256,5064,31,15,16,GAUsoe8ZTCiGPm2hYxRPGxcPe5ShNzHK9eE3G2zgRjxd,1260,8448,-7188,622
2022-01-06 22:43:31-05:00,2208,FFoYoBmkfEsCWVXQf3BhKeaFMZD3YVKvfhPWkXdnCZS9,8yW6WApAuN43brF1HioTLdyxvQTQJzt875E26QqrWWFk,True,2352303,588075,3662,1831,1831,3zqXX6kzhkbW3d4TwD2CNjMRwxTbREXySekvq37kfCNk,146491,494188,-347697,622
2022-01-06 22:43:32-05:00,2209,CwTus4FyoXYqyTKAYDp69NLhA1joYZ3tarzY6FFTr6fn,6ivuvYWU6i25MzJSY8rG9rPDKiq38E6QtrV1jvRubLGr,True,44446,11111,69,34,35,GAUsoe8ZTCiGPm2hYxRPGxcPe5ShNzHK9eE3G2zgRjxd,2770,15194,-12424,623
2022-01-06 22:43:32-05:00,2210,FV9CBGGTbppLnBKh79f2LzD1diTiS5g6u89FcpZHZmnK,Fe7mtmCUziFqbbYTvrhAcAq1Ub7YLfTJRtQ1hG7GzJD1,True,23096868,5774217,35857,17928,17929,3zqXX6kzhkbW3d4TwD2CNjMRwxTbREXySekvq37kfCNk,1434287,6822453,-5388166,620
2022-01-06 22:43:37-05:00,2211,3ogBPSRcKfmwzgumVDHBkXLi1eCsEFG2xzSJgD4LQDNy,7TXyqWgJqfe71MSWFA2n7ufZbUdzf7JJoWej8FNNtMXo,True,93808155,23452038,146067,73033,73034,GAUsoe8ZTCiGPm2hYxRPGxcPe5ShNzHK9eE3G2zgRjxd,5842703,25767856,-19925153,622
2022-01-06 22:43:37-05:00,2212,Br1j5Ftafei7ysu5SmqVZSoRe4uS4qCPeKSPHg55pyiE,G8fc7QvXjfkgBFvAVUgJFQS3VaF1biL9rktBExGa87Ks,True,11767326918,2941831728,18393760,9196880,9196880,4BnQKPLuE3DMTtxp8MjUBytgnhvxqq3ZTqZHTVZo4JJh,735750408,3880883143,-3145132735,625
2022-01-06 22:43:40-05:00,2213,3WcJUt8jQ1ngL3ZCGo6dFrc3GmTMTYtzeDva7mri2Tqx,HeG1Pz2oMjqtkfsRMsbqP3VpatnVEQzcWmKDVoFp4Htr,True,68912905,17228226,107190,53595,53595,DddJ7EWCmYEEZETCBNgAUSg81Ls6fZtiAaY5ekJ5sXx1,4287600,24355976,-20068376,622
2022-01-06 22:43:48-05:00,2214,GjQQ2fQ7mrGjWZwjVYFUKp9NM1LmfkhEo675ovU5SPa8,ECgVUMRY5nB4MALs5drDyipF7YohCPuJpj2UegCs7HMn,True,96415063,24103765,148384,74192,74192,3zqXX6kzhkbW3d4TwD2CNjMRwxTbREXySekvq37kfCNk,5935363,29710358,-23774995,615
2022-01-06 22:43:51-05:00,2215,G5NLYTLxDZfJFKsJdMeWS8Ez95ZFwR5AX4hKhnfVJvoE,AwrC3pKhTeEDr1HCTWoKWjadteZccvqcisbC7vxTjn7w,True,56569866,14142466,88136,44068,44068,DddJ7EWCmYEEZETCBNgAUSg81Ls6fZtiAaY5ekJ5sXx1,3525468,24976223,-21450755,623
2022-01-06 22:43:54-05:00,2216,F9s8a7Cpiw5dw3a2aNFMofqwyDWNXvDLnSdJzoj1gRiV,GpKsQKJD79KBRWdCTkyi4zX7NaoCWsLUjrKxAwJB6o6s,True,127406093,31851523,197830,98915,98915,4BnQKPLuE3DMTtxp8MjUBytgnhvxqq3ZTqZHTVZo4JJh,7913235,16148266,-8235031,621
2022-01-06 22:43:59-05:00,2217,6Bq55LtGCEeGqh4JrFLCmmGc2iJfTTBJixivqH78aGSE,DSNrCgWJeNe2P9tAQu5FvCueTzNKDKds7wzuwTQSMRG,True,29154736,7288684,45540,22770,22770,DddJ7EWCmYEEZETCBNgAUSg81Ls6fZtiAaY5ekJ5sXx1,1821634,8450387,-6628753,624
2022-01-06 22:44:00-05:00,2218,8xvLGVeDmhVYQhN2ZpWkVG9jCrukRsNQ4926a4TMiZqa,9ciBySSjvADwp47WkETiFWZKVTFL8Hf1XvK7aSxhcgQS,True,110805116,27701279,171386,85693,85693,GAUsoe8ZTCiGPm2hYxRPGxcPe5ShNzHK9eE3G2zgRjxd,6855443,34142526,-27287083,618
2022-01-06 22:44:07-05:00,2219,5Z3ZFCA65WoWhm3okRuuziEMi7ajGAEHWUFchzBNba5S,FcomdrWidygkxMKzcsY5xELbmwC652uMci648LMTv7AB,True,42555,10638,66,33,33,3zqXX6kzhkbW3d4TwD2CNjMRwxTbREXySekvq37kfCNk,2646,13977,-11331,621
2022-01-06 22:44:07-05:00,2220,2PzBAkdXkrwH9VuoMALumQz86qkW7sSBQtCrHw14JUp3,D5vwWAMHVooobG2sCWv9EwtJrAFZG6cwKH4dfmA98tbt,True,8900968,2225242,13772,6886,6886,GAUsoe8ZTCiGPm2hYxRPGxcPe5ShNzHK9eE3G2zgRjxd,550891,3039409,-2488518,618
2022-01-06 22:44:07-05:00,2221,F1JT1p2VuwK4L7zj7NNnZtYiZiNUCcTGKDkgdoX3BZdZ,3BKe4yzTwnnBnvTWP3britpPJ4oAWL7JZJzNLCxjUufS,True,22234,5558,34,17,17,3zqXX6kzhkbW3d4TwD2CNjMRwxTbREXySekvq37kfCNk,1371,3754,-2383,616
2022-01-06 22:44:08-05:00,2222,EhANPABkSw9x9WnsDEi8pCg67iQTX2UGTTUpyjADTwdN,4FKLi98hyg9ZjM4MY6ctJsv7B6vPUnTYWdhrnNoYsztX,True,34331976,8582994,53500,26750,26750,4BnQKPLuE3DMTtxp8MjUBytgnhvxqq3ZTqZHTVZo4JJh,2140031,14996558,-12856527,623
2022-01-06 22:44:09-05:00,2223,i7TcF4weYcqgrRdH3GpndbEYxCxfcSfr9JWYrAUg1CF,BkDfknUir7PnSEW8auoB87PytycEFwyX5kT2GY4SGJJL,True,18093540,4523385,28186,14093,14093,3zqXX6kzhkbW3d4TwD2CNjMRwxTbREXySekvq37kfCNk,1127455,12694159,-11566704,623
2022-01-06 22:44:09-05:00,2224,7D4rFmGMPKNAF75VRPxHAhSn2wTjiW8jmth1UD22Xqq9,GQ7BrT6vsXu8tHCMm75YdxFR2r9QTCrCUbdPEZBSAg9w,True,164032462,41008115,254027,127013,127014,GAUsoe8ZTCiGPm2hYxRPGxcPe5ShNzHK9eE3G2zgRjxd,10161082,45255044,-35093962,619
2022-01-06 22:44:24-05:00,2225,7vKmhLV45Q5etXhJL5ng8rxWhYSiUCDmAbGnwBPr7zcx,cP6xPeuHLnjr858QK1F9qYn7rJpEbPy7wEJHoju6oV7,True,148107130,37026782,229186,114593,114593,3zqXX6kzhkbW3d4TwD2CNjMRwxTbREXySekvq37kfCNk,9167463,49979406,-40811943,618
2022-01-06 22:44:42-05:00,2226,DrzTARa7RK8RXoxHZPKCBqYtMC8TAUHRw8SznXRKTa5M,FYANet92VhyXkKZqqBJR4sFxuCftWb68sgQU9VHCdTJk,True,112761,28190,170,85,85,3zqXX6kzhkbW3d4TwD2CNjMRwxTbREXySekvq37kfCNk,6835,36476,-29641,606
2022-01-06 22:44:49-05:00,2227,HutRztBianNUgm9sJDWKUQBmoVyy8y7CfnNk4hHjSkEW,EtVfvPyiy5bizbCZxR19TNUgETf3QcmziBvMtc6o5zjr,True,842301756,210575439,1305406,652703,652703,GAUsoe8ZTCiGPm2hYxRPGxcPe5ShNzHK9eE3G2zgRjxd,52216275,618581770,-566365495,619
2022-01-06 22:44:49-05:00,2228,CK3ocyWzXQkJJZQmM6bBK4Nv6Rh3UEufjY6DvNU6gJZy,C924o4GY3p2BHLeAbFbe9SEysXqCUyD8sFu2d4NzkAV7,True,22251103,5562775,33827,16913,16914,DddJ7EWCmYEEZETCBNgAUSg81Ls6fZtiAaY5ekJ5sXx1,1353089,6519674,-5166585,608
2022-01-06 22:44:49-05:00,2229,4MmpDGUTyMcYEqJ1RoZ46AN2BhrBUseHaHqF8AmiTPyD,7HW2YZpYM349HMfW7u4h9ESZ1AXkwN8JcVDTNFzp9aTz,True,410376718,102594179,638135,319067,319068,DddJ7EWCmYEEZETCBNgAUSg81Ls6fZtiAaY5ekJ5sXx1,25525427,178569046,-153043619,621
2022-01-06 22:44:49-05:00,2230,AKxRtcdpi7gWhAuL8ENj7zhgeQezzEXe9TSANE6bQoRA,2YH4vrU9deP8Cu6E8Hzf8GqKG1yVjv5pdz4FE7r5YKir,True,23383921,5845980,35935,17967,17968,DddJ7EWCmYEEZETCBNgAUSg81Ls6fZtiAaY5ekJ5sXx1,1437430,7808880,-6371450,614
2022-01-06 22:44:49-05:00,2231,9jdfc9GFTecsdRuTjWFGX13niKKmeBxRgtv5j86uhSnU,HLWMShobjSkaLyXrNjgwVaUGVtbtdUSnr1XjqpXn1bLR,True,1001285,250321,1555,777,778,3zqXX6kzhkbW3d4TwD2CNjMRwxTbREXySekvq37kfCNk,62200,378975,-316775,621
2022-01-06 22:44:49-05:00,2232,8vva9SmKpMGW8wjpkvydQczxVK6VtN79qzH2i4JQSwg4,F8a3GLicsSapt4aLURoU4qHxJaxCij4LS6JVxoMF3YHT,True,3280340,820085,5081,2540,2541,3zqXX6kzhkbW3d4TwD2CNjMRwxTbREXySekvq37kfCNk,203247,692907,-489660,619
2022-01-06 22:44:49-05:00,2233,8BMDSWFtzq9fu1ubVGtSFw8fEaMg1uvJiECuJnN8e1pd,FwkETAXL296CirvQ2AJuSHHtdKsxkZkmXSwZVVHXVDhA,True,444996014,111249003,694020,347010,347010,3zqXX6kzhkbW3d4TwD2CNjMRwxTbREXySekvq37kfCNk,27760807,145267673,-117506866,623
2022-01-06 22:44:50-05:00,2234,Ar5QB4VBcUyzSCG23z2QNAbrWY55NbHCr1MNN6P2GAmh,BusFGTiDrJmxzwGUxWz9b3SFF3eseqtgh2DRHqyAwyVe,True,1580361,395090,2442,1221,1221,DddJ7EWCmYEEZETCBNgAUSg81Ls6fZtiAaY5ekJ5sXx1,97715,562295,-464580,618
2022-01-06 22:44:50-05:00,2235,E1wp3bmkcY3eiEYyGYwhTCsr7BZ7RfPa5DJTZFupcFwj,452hVdYkD5SDDrA6hv6DLPFvyS8PvR2P6DPNScGxWTsW,True,2753209,688302,4184,2092,2092,3zqXX6kzhkbW3d4TwD2CNjMRwxTbREXySekvq37kfCNk,167396,973403,-806007,608
2022-01-06 22:44:50-05:00,2236,EeUACm9TkjHKES5U7Yj1oPhYmcp7R3tvesGBiP8txEzq,3qkmm4aS6EDirEDejmbm5PDw2jpYkC7zKqrMkmgeE5BA,True,789816,197454,1233,616,617,GAUsoe8ZTCiGPm2hYxRPGxcPe5ShNzHK9eE3G2zgRjxd,49330,221723,-172393,624
2022-01-06 22:44:50-05:00,2237,HqtTbC1LFreGvgfpZe7nCqkNnh8GHPQKosfmc19zb1yi,E39UNiHNkwQEd5GXkCtTPqSorQSB1kLx8kjzK4jdFoi3,True,1062331234,265582808,1645980,822990,822990,4BnQKPLuE3DMTtxp8MjUBytgnhvxqq3ZTqZHTVZo4JJh,65839223,417770478,-351931255,619
2022-01-06 22:44:50-05:00,2238,D3mXrJzhHf8qRaoCKLschUxAFoijFCFuT6bmNZH4W7Cj,9E3Xtqw7TncXWnbhAbFJMtuNmP6WS3ooGuptzyzw7UpA,True,197678,49419,306,153,153,3zqXX6kzhkbW3d4TwD2CNjMRwxTbREXySekvq37kfCNk,12242,93294,-81052,619
2022-01-06 22:44:50-05:00,2239,EV21gv8jEvXtmGDoGRNm5LJEvTBccLMZyVDCLsp54jP3,DGxxoU52aQNoUQcxdvQtv2H5q2PhK6TGkLgNSaFgnZrb,True,15250235,3812558,23784,11892,11892,4BnQKPLuE3DMTtxp8MjUBytgnhvxqq3ZTqZHTVZo4JJh,951392,5392260,-4440868,623
2022-01-06 22:44:50-05:00,2240,6XHt7CrURSomkQrtVXV5JuKSZY4tQRpUyQKfCDaSTYaD,GCgcmPSDDBsn2smYbpiX3PJybDkQWtufPu4YRsbEEU8X,True,1153373214,288343303,1802223,901111,901112,3zqXX6kzhkbW3d4TwD2CNjMRwxTbREXySekvq37kfCNk,72088924,601205561,-529116637,625
2022-01-06 22:44:50-05:00,2241,2rCRdyfi65rpxRRmg7knaSb8t55FuPt3h8wF4Fzhy8MM,CLVY5nSG3jTdRo7tRSKgK9DJgW6aswfWKe4tLxzsENmb,True,2152516,538129,3325,1662,1663,4BnQKPLuE3DMTtxp8MjUBytgnhvxqq3ZTqZHTVZo4JJh,133019,629880,-496861,617
2022-01-06 22:44:50-05:00,2242,D58t4uTjFumsUeYFaKnpV8BRTEQEqKXBreFTdwGrott7,67p6kHDfVqQijfcwugvZK59c3aRRH9x3eHxruqH8WEqF,True,3203860,800964,4993,2496,2497,4BnQKPLuE3DMTtxp8MjUBytgnhvxqq3ZTqZHTVZo4JJh,199740,1188353,-988613,623
2022-01-06 22:44:50-05:00,2243,Cb4zhnvig11U4GcC4kqKrnDicGgPhUpfDQB1U7hP3nPa,DiRAMrKqaevGXeXg38KnhaYBERj8tNKU7oWFJvhS32kw,True,688665,172166,1045,522,523,72FwbpFGoLEazJEdpqNtPNefsadUrimUqma9wSoy4qiS,41812,196899,-155087,607
2022-01-06 22:44:51-05:00,2244,46TNhGwBVzedW8xSb9UY94HNeSom9iGiZzAjrKHiRM2G,7JVTiqNYeKHbyzRkKtvSEpqLPKykZso8cGUr3sX1j7QF,True,188488200,47122049,292533,146266,146267,GAUsoe8ZTCiGPm2hYxRPGxcPe5ShNzHK9eE3G2zgRjxd,11701357,54402309,-42700952,620
2022-01-06 22:44:51-05:00,2245,89CkXnSZnr52Zsoh48efv9MQacrkB6GMtrbEpNJSyA2H,HcvRBS4Z22CpYgDNgm4TVF4AVXFDuYzBUAFcdHAwdpg4,True,10241097,2560274,15790,7895,7895,DddJ7EWCmYEEZETCBNgAUSg81Ls6fZtiAaY5ekJ5sXx1,631628,3426849,-2795221,616
2022-01-06 22:44:51-05:00,2246,9YEzjb49Awvedv9yNc6LG54SkGBug2RYiJwiUV13mGsS,3H8w5WCD187NWWoZMNUCzUDdxTgqrRJLga8gDzUVXBgZ,True,3748667,937166,5820,2910,2910,DddJ7EWCmYEEZETCBNgAUSg81Ls6fZtiAaY5ekJ5sXx1,232824,1911753,-1678929,621
2022-01-06 22:44:51-05:00,2247,GaEpNGa8jnwSRvjzzEMYkZe1pKcr2eiZtePrqFxpABjB,5CFZHuyWbJv14zPdX5dSQDREgHrCb4vsFvB6hLiEe3Ji,True,520417,130104,803,401,402,GAUsoe8ZTCiGPm2hYxRPGxcPe5ShNzHK9eE3G2zgRjxd,32124,176164,-144040,617
2022-01-06 22:44:51-05:00,2248,75ycx5sUFBxDhY1uwuPCW22s2C6BydkJTje7q7zEQFGT,FpEgrVFRubjGK4DRjTqdVbxSECURpn16zfpoC31NbwnN,True,21778040,5444510,33347,16673,16674,DddJ7EWCmYEEZETCBNgAUSg81Ls6fZtiAaY5ekJ5sXx1,1333909,9552839,-8218930,612
2022-01-06 22:44:51-05:00,2249,2NHv3c4ufYGo3xNr6KXymAZJdpfURrNiCKbXZ7s82Vwo,E4NYpYgHTvSG6LqH2bBV9Q1XJ6pAzCp9FLSKMzJmYRrQ,True,88350837,22087709,135110,67555,67555,GAUsoe8ZTCiGPm2hYxRPGxcPe5ShNzHK9eE3G2zgRjxd,5404405,39595117,-34190712,611
2022-01-06 22:44:53-05:00,2250,GJ3PbEfPK8jjrPgMmZtvN5fMSSy2dtiiAtZ8wcfgxVuc,FCUDVFb2TjDvehHE8fVBofqSykpb9W6Afc9QeHtj7te7,True,262362935,65590733,405363,202681,202682,3zqXX6kzhkbW3d4TwD2CNjMRwxTbREXySekvq37kfCNk,16214524,122660325,-106445801,618
2022-01-06 22:44:54-05:00,2251,7jvKp6onXyWgwsFrFWj4hYTXJsYYD6ot5mn6rPFuJriy,J7N6HiozevJVTiY9hDEUs2ud5BwT5QSE7wnMBS1w5ie2,True,138343704,34585926,216263,108131,108132,3zqXX6kzhkbW3d4TwD2CNjMRwxTbREXySekvq37kfCNk,8650523,60396709,-51746186,625
2022-01-06 22:44:56-05:00,2252,JCBhqqPQxP1Xc41sSY6e1sQKRstHhe7D1v6rLz4hp3Qp,DWMUq2bMD1jqpxHtyXDFjcAwjA27yyMRe68hGcsK143m,True,23816,5954,36,18,18,GAUsoe8ZTCiGPm2hYxRPGxcPe5ShNzHK9eE3G2zgRjxd,1475,7870,-6395,619
2022-01-06 22:44:56-05:00,2253,AtKuDfcFXqWUMnRqQpjedUMTb5CQKLc2zoqEAcQpysKQ,9bPFLYp5TDZruLLDXDYYCiPYcD982iF8xt5rfTkqwNsL,True,38043,9510,59,29,30,3zqXX6kzhkbW3d4TwD2CNjMRwxTbREXySekvq37kfCNk,2376,12272,-9896,624
2022-01-06 22:44:56-05:00,2254,BzSJ77zKaqtBk2cEL1XqFL97zTXXMRHmxtkgtXwCc3C,2g4KXTwy2MPSRQ2khNp1o1rn7CradEr9H4ySYKDoSWN9,True,34527248,8631812,53665,26832,26833,3zqXX6kzhkbW3d4TwD2CNjMRwxTbREXySekvq37kfCNk,2146621,28908646,-26762025,621
2022-01-06 22:44:56-05:00,2255,EQUZQWk4WLT6LFeWZs3P9AQufFcoZouFETfhyxvuS2JM,Byc2mLXArmkjQPWaxCJksHZD2XpZyCQ2FRtDJyztU81V,True,324859163,81214790,504706,252353,252353,3zqXX6kzhkbW3d4TwD2CNjMRwxTbREXySekvq37kfCNk,20188263,153580337,-133392074,621
2022-01-06 22:45:00-05:00,2256,2NdwSLxsGok8PczpCZj9CVX2BymNU5MvHt7hWfGetg2M,8AQbDXeA6mD9QoZBFJcYbnHvZwKNxzA9CCHLAgdSfTA3,True,36410,9102,56,28,28,3zqXX6kzhkbW3d4TwD2CNjMRwxTbREXySekvq37kfCNk,2261,15900,-13639,620
2022-01-06 22:45:22-05:00,2257,aTkGURJptmKNNP6RSXSWsmVbfcriSAJaMuUiT2eZEfb,5qoGxL83PLhrguyk27X8xE6jGitRg5BaQpXzrcfEvCfJ,True,1224163868,306040967,1905967,952983,952984,4BnQKPLuE3DMTtxp8MjUBytgnhvxqq3ZTqZHTVZo4JJh,76238701,284740050,-208501349,622
2022-01-06 22:45:55-05:00,2258,243SAnGxchCVB1LQAUF4SsozR86yDwEdg2QQpbWGsMYe,5u8sNkb2oEQjUXJAB3yGStmv3Uwz16gBgExBo5myVK4b,True,63276051,15819012,98473,49236,49237,4BnQKPLuE3DMTtxp8MjUBytgnhvxqq3ZTqZHTVZo4JJh,3938934,15683654,-11744720,622
2022-01-06 23:00:06-05:00,2259,GxFxvEUdWofneMmVvhCSScH9V6Zia5WJ2J9q6CpPnaq3,ATLykiHDii3Lw53MoZXwqu1FbBNPJbVNVGe2SoQMjVmY,True,19382186,4845546,30121,15060,15061,3zqXX6kzhkbW3d4TwD2CNjMRwxTbREXySekvq37kfCNk,1204862,7129578,-5924716,621
2022-01-06 23:06:47-05:00,2260,EF6H6aW1p3qcAtiLFU9rbFYfsKfD683meHXDw8hLdaZK,8vfJbpnK7SQcjpEBCzZJRW8JosNbsmTeJ2YXZCbM225c,True,418800040,104700009,651273,325636,325637,GmqQKnMfFxkv6ChqGaZ2wmSFDow7R1x7WeRfU58GVvfw,26050944,116965240,-90914296,622
2022-01-06 23:06:53-05:00,2261,JDeYjCLpfnzcfxDFgHf4aBcHsajwdR14GUaKAA9euzVf,EJbvKoyMZcoCx4vWa61uMbW2vr6mUhrgEuECdteVBuZZ,True,34459691,8614922,52504,26252,26252,DddJ7EWCmYEEZETCBNgAUSg81Ls6fZtiAaY5ekJ5sXx1,2100160,16191044,-14090884,609
2022-01-06 23:07:07-05:00,2262,Bsr6kx1B6BSEd5UnJ7Z61M49iUb3bFrDVhiEtMVtPDF2,3CFd1pUJAJPA9fobwn4Jj2mRju1CWmoop4Mh4znypNWT,True,129543243,32385810,201893,100946,100947,3zqXX6kzhkbW3d4TwD2CNjMRwxTbREXySekvq37kfCNk,8075747,35375098,-27299351,623
2022-01-06 23:07:15-05:00,2263,Mcbzp1LhZwpfmXTv1pqe9D1jCKHw443j9QKp6tUpzgM,8uforSMAKEih5jHfHp3gCqCvaugtCmhzVfVHA63Akz7F,True,6820159,1705039,10671,5335,5336,3zqXX6kzhkbW3d4TwD2CNjMRwxTbREXySekvq37kfCNk,426875,2991387,-2564512,625
2022-01-06 23:07:16-05:00,2264,56488NdcUy6Hi6X5SLs2GFtW5pG4u5wJpH7vHdxTCx4z,tGgXjJeVr3W2m3T2NXPCqpBEd6HJKE2cRsgCyiDZQy4,True,92779054,23194763,144954,72477,72477,DddJ7EWCmYEEZETCBNgAUSg81Ls6fZtiAaY5ekJ5sXx1,5798191,39582834,-33784643,624
2022-01-06 23:08:02-05:00,2265,HAk9c831TRUhvpoK4d7PTqfJuJhSjnJUXWpnYsH85bDJ,DVSa3CJrVLTHAeFYjEF89ZjWRm86QwruUk2Y8RvGpjsr,True,102833,25707,160,80,80,GAUsoe8ZTCiGPm2hYxRPGxcPe5ShNzHK9eE3G2zgRjxd,6412,39046,-32634,623
2022-01-06 23:08:09-05:00,2266,6WNPf4rFCX74PuyvdmzRFqbxWhguuxTQqBSdnaTVBd5D,9N7a9aiHGQsxFMgVbmWoCF9w95d12xyT7XFAwpHGkTLA,True,5145395,1286348,8045,4022,4023,3zqXX6kzhkbW3d4TwD2CNjMRwxTbREXySekvq37kfCNk,321817,1076422,-754605,625
2022-01-06 23:08:15-05:00,2267,BWtXpiXn1bomr28mGfQFTx1Kd58CQipEnKmeweYowDEC,9jws1qkXvWAdEtBvURVEeGcGJzt4zG2gh8AJESvjKKrx,True,455849533,113962383,706996,353498,353498,4BnQKPLuE3DMTtxp8MjUBytgnhvxqq3ZTqZHTVZo4JJh,28279841,205393591,-177113750,620
2022-01-06 23:08:15-05:00,2268,7CSCMFa9W52tBDVUbXbc3woAy3GByeA1wPJdp3MgznPa,3447ptuVFu6G8B6N63RmS8mRv4n9PfHneypHLvbeaGLn,True,469552622,117388154,720466,360233,360233,3zqXX6kzhkbW3d4TwD2CNjMRwxTbREXySekvq37kfCNk,28818663,168653618,-139834955,613
2022-01-06 23:08:17-05:00,2269,5SwL5U5hhQXPW1HXFf4GuU4xkmXoAKx58pjY53NPHqWS,7zB7JvYFzEEwawJy7k7NXvBSG3UsbQte7JxgwvBNbS7U,True,834634925,208658731,1301015,650507,650508,3zqXX6kzhkbW3d4TwD2CNjMRwxTbREXySekvq37kfCNk,52040624,373189383,-321148759,623
2022-01-06 23:08:18-05:00,2270,7oxuCEhooUZ5z2nnZRD226rcqdZgAR75SamX9DD7ejUf,CPqBb5ptWUPUJhVjshxNZCHd5RDF3fve29z4vz72JhvM,True,579737,144932,899,449,450,GAUsoe8ZTCiGPm2hYxRPGxcPe5ShNzHK9eE3G2zgRjxd,35984,159470,-123486,620
2022-01-06 23:08:19-05:00,2271,DMgPzJnMQfvpk6LWscs9V9CwnYDj4CEUgKB9S65WsTaY,BZRSLH1Vw1BQwXTZtBcgUYqmFF7TuzYxAaZ8TXUKwLUQ,True,27288,6821,42,21,21,3zqXX6kzhkbW3d4TwD2CNjMRwxTbREXySekvq37kfCNk,1691,12227,-10536,619
2022-01-06 23:08:19-05:00,2272,864zY9zuCktUurPTtdGeLvUATnDqHZpT1GeWUApsXh2m,CzatBrNJUi7MeyfbNhszRaPMidgt8Xkcmy5ZwFMP9RCs,True,87297055,21824263,130718,65359,65359,GAUsoe8ZTCiGPm2hYxRPGxcPe5ShNzHK9eE3G2zgRjxd,5228745,32342087,-27113342,598
2022-01-06 23:08:28-05:00,2273,8trkirSQNdMmAcJdeswxs5cPjH8dD6U4eJtWiAdMsrDB,HaSzpQ45x2MipfN17U6jGBxX8tXboomVDhXNSrnEfLDr,True,14602366,3650591,22705,11352,11353,GAUsoe8ZTCiGPm2hYxRPGxcPe5ShNzHK9eE3G2zgRjxd,908239,4722893,-3814654,621
2022-01-06 23:08:29-05:00,2274,6NJFN855M3Q3RLTDNo57gTgAmwPD6G2E3WvMb1m5eNCN,3YpqNnonsvXaRT4nCC3G5FZx1jjVtbDPc36LiR6WK5jR,True,336035281,84008820,519978,259989,259989,3zqXX6kzhkbW3d4TwD2CNjMRwxTbREXySekvq37kfCNk,20799133,154812377,-134013244,618
2022-01-06 23:08:40-05:00,2275,D64rDiWT3YG28fCgXCmbNjYa2JakZbpKQ1D2XuLChUfV,8WmMWq8cTsGQym5pUbHm9dPCpJugBeWUMVERYFGLxWHj,True,157765315,39441328,245309,122654,122655,GAUsoe8ZTCiGPm2hYxRPGxcPe5ShNzHK9eE3G2zgRjxd,9812391,39526379,-29713988,621
2022-01-06 23:09:04-05:00,2276,8swGZMrPrLAxZd7MxTbkCL13k3DmAJUw41jCp6Xo6awW,3fKnX7yTNXAT4uMmXVdTy47ALJT8h8YSD3WiBb4BGuzH,True,1025198266,256299566,1593601,796800,796801,GAUsoe8ZTCiGPm2hYxRPGxcPe5ShNzHK9eE3G2zgRjxd,63744041,344806527,-281062486,621
2022-01-05 14:47:03-05:00,1253,BhiAaiZu7fF8ndggJrLyiFVCRq526cNBw7VaeascEmNL,4en8MipPi7vq15NGhpPMQfptNdEyhp2j7fpgxBBtjyfz,True,12820038,3205009,20048,10024,10024,3RdfgDvLvsdZG5Cf6hKiKMQMqfidyxHzjYvUx1FZpeHQ,801951,3123641,-2321690,625
2022-01-05 14:47:03-05:00,1254,8BTja7VnFPe6M9BHTqg5LTpX6vd4ugTeWLzpq3oFP8WM,pscjH4sPnNL6zQBmvHjEEbix6BTstnsrSwGysNWyPkd,True,587133,146781,907,453,454,DddJ7EWCmYEEZETCBNgAUSg81Ls6fZtiAaY5ekJ5sXx1,36296,140309,-104013,618
2022-01-05 14:47:09-05:00,1255,7iUx7JBwqUvPVPeCqMEXQdLccZJmaFYm1DUQiu3ouHa3,3EVZzhRmJnX9ZiBZZo9tenDtMogAyuA1yf2cKzvUWiuu,True,16828356,4207088,25935,12967,12968,4BnQKPLuE3DMTtxp8MjUBytgnhvxqq3ZTqZHTVZo4JJh,1037437,4393883,-3356446,616
2022-01-05 14:47:09-05:00,1256,7bnCuBLXnPS3wDBunrzoV5qm1GwfnPfRBwV2f9Xzo3Aj,9Xd7GNcFrx7z66DRW8kK3d1jN4tzuiwv9jyDFbHUx9vW,True,598701,149674,932,466,466,DddJ7EWCmYEEZETCBNgAUSg81Ls6fZtiAaY5ekJ5sXx1,37312,144652,-107340,623
2022-01-05 14:47:09-05:00,1257,DGbj8tnqECzM9FG8j225Ap7A4Fdm3J1Ksm32JBFG7igv,Cd3D2UVwoSZLygM2e3UQppQANsokpmx5CNBs1C5zueay,True,13522720,3380679,20534,10267,10267,DddJ7EWCmYEEZETCBNgAUSg81Ls6fZtiAaY5ekJ5sXx1,821390,3325278,-2503888,607
2022-01-05 14:47:11-05:00,1258,GWEfWJimTKDJuxSTAb7SxkT3L3FhPPu8wJzYYF8H4SgD,BdeMcj3cMyKVPeF7Mt9Jdpxgzq9P6c79qJR6ctiiDauL,True,983320945,245830236,1529908,764954,764954,DddJ7EWCmYEEZETCBNgAUSg81Ls6fZtiAaY5ekJ5sXx1,61196324,199229425,-138033101,622
2022-01-05 14:49:09-05:00,1259,A7SMcwnq3DewryUj1jScnAboKGnuDVcW15F3ubNcG66Y,5qLCE37FdeWLCQnkfNJViFMGNcDeiELgE3VgPbBUuDGF,True,675892713,168973178,1056617,528308,528309,4BnQKPLuE3DMTtxp8MjUBytgnhvxqq3ZTqZHTVZo4JJh,42264697,162125136,-119860439,625
2022-01-05 14:50:18-05:00,1260,2PHDkmat5jQ65XkJYhDSw6ZwHcKpSw85o8MaPFhfLBry,8NtkXoUPt4wkcqQJuPJYt5oq9hG4BdeY26dQrsybDWWX,True,329824347,82456086,512098,256049,256049,DddJ7EWCmYEEZETCBNgAUSg81Ls6fZtiAaY5ekJ5sXx1,20483941,62666918,-42182977,621
2022-01-05 14:50:32-05:00,1261,D3mXrJzhHf8qRaoCKLschUxAFoijFCFuT6bmNZH4W7Cj,9E3Xtqw7TncXWnbhAbFJMtuNmP6WS3ooGuptzyzw7UpA,True,1698436,424609,2654,1327,1327,4BnQKPLuE3DMTtxp8MjUBytgnhvxqq3ZTqZHTVZo4JJh,106194,495845,-389651,625
2022-01-05 14:50:47-05:00,1262,2NdwSLxsGok8PczpCZj9CVX2BymNU5MvHt7hWfGetg2M,8AQbDXeA6mD9QoZBFJcYbnHvZwKNxzA9CCHLAgdSfTA3,True,312710,78177,487,243,244,4BnQKPLuE3DMTtxp8MjUBytgnhvxqq3ZTqZHTVZo4JJh,19501,81699,-62198,623
2022-01-05 14:51:17-05:00,1263,GJ3PbEfPK8jjrPgMmZtvN5fMSSy2dtiiAtZ8wcfgxVuc,FCUDVFb2TjDvehHE8fVBofqSykpb9W6Afc9QeHtj7te7,True,2249983607,562495901,3487599,1743799,1743800,3RdfgDvLvsdZG5Cf6hKiKMQMqfidyxHzjYvUx1FZpeHQ,139503965,652297255,-512793290,620
2022-01-05 14:51:23-05:00,1264,Mcbzp1LhZwpfmXTv1pqe9D1jCKHw443j9QKp6tUpzgM,8uforSMAKEih5jHfHp3gCqCvaugtCmhzVfVHA63Akz7F,True,58505089,14626272,91549,45774,45775,DddJ7EWCmYEEZETCBNgAUSg81Ls6fZtiAaY5ekJ5sXx1,3661982,15462398,-11800416,625
2022-01-05 14:51:23-05:00,1265,9jdfc9GFTecsdRuTjWFGX13niKKmeBxRgtv5j86uhSnU,HLWMShobjSkaLyXrNjgwVaUGVtbtdUSnr1XjqpXn1bLR,True,8586900,2146725,13297,6648,6649,4BnQKPLuE3DMTtxp8MjUBytgnhvxqq3ZTqZHTVZo4JJh,531898,1819271,-1287373,619
2022-01-05 14:51:39-05:00,1266,G25vsB3sDqRhHoSK4KwR1TywfrJDtpejVbbevEG9sQ9a,5xFC3Hm13magnAA9GD1EnwC9PrPoEfQ7omEa9p9zCrB1,True,18171187,4542796,28221,14110,14111,3RdfgDvLvsdZG5Cf6hKiKMQMqfidyxHzjYvUx1FZpeHQ,1128855,4320689,-3191834,621
2022-01-05 14:51:45-05:00,1267,7LBZi7Ec4VKhtNJbFQYYY8CvFbsLPCvqmn8Rd5EVhn9n,CBgkKDhmsEa8Ug8nE9Yu95gLDbDQa9FNGpdjVRfEDXcq,True,1184886367,296221591,1841983,920991,920992,4BnQKPLuE3DMTtxp8MjUBytgnhvxqq3ZTqZHTVZo4JJh,73679338,273293020,-199613682,621
2022-01-05 14:51:48-05:00,1268,CUhCSd7jHvycC89L6EqMoDWcWVTXXHhAeXVyB4362qZg,J7B9JBV1xR8a7DKKrw3JwGusY4H2bSQuyHtod2Fzf4jq,True,26216201,6554050,40829,20414,20415,4BnQKPLuE3DMTtxp8MjUBytgnhvxqq3ZTqZHTVZo4JJh,1633187,6076986,-4443799,622
2022-01-05 14:51:48-05:00,1269,2YcB3QQGWho5oogDd1nK3cpLQzwwwXGxybrhe2xDkDxq,5DjAUp6CxKStYTaXSnzjvYkfqCXfG8Y61bWw5UwbbE3q,True,42100582,10525145,65635,32817,32818,4BnQKPLuE3DMTtxp8MjUBytgnhvxqq3ZTqZHTVZo4JJh,2625416,13706309,-11080893,623
2022-01-05 14:51:56-05:00,1270,4gzW9gBbEMnNm1epY6MMJ1XfxGMtvn2mKFyKPQ2Gyb79,G6x862hmMJ2PLpyyPDwVPGapXjvEeNkqFRTAS3jWVozB,True,64098465,16024616,98653,49326,49327,72FwbpFGoLEazJEdpqNtPNefsadUrimUqma9wSoy4qiS,3946139,21024755,-17078616,615
2022-01-05 14:52:17-05:00,1271,7LRBswSEDBjJzQ4YurfTxLydh7tFS2jVn5V95Z6wL7ci,fD41VYGmk66MW46KKb23vAqQvUSDScgXnVdsHhJBZzu,True,3452529,863132,5399,2699,2700,4BnQKPLuE3DMTtxp8MjUBytgnhvxqq3ZTqZHTVZo4JJh,215967,813442,-597475,625
2022-01-05 14:52:26-05:00,1272,Hy3kzXneDN6FUkiZctU1vWe97BYvj6yZ7QvQzehfWmNr,EhXgQg8BTniANV525RpY76z7Hrh6DuqrMChjqEoXfVJe,True,25488018,6372004,39886,19943,19943,3RdfgDvLvsdZG5Cf6hKiKMQMqfidyxHzjYvUx1FZpeHQ,1595467,7187148,-5591681,625
2022-01-05 14:53:29-05:00,1273,HAk9c831TRUhvpoK4d7PTqfJuJhSjnJUXWpnYsH85bDJ,DVSa3CJrVLTHAeFYjEF89ZjWRm86QwruUk2Y8RvGpjsr,True,647652,161911,1012,506,506,4BnQKPLuE3DMTtxp8MjUBytgnhvxqq3ZTqZHTVZo4JJh,40481,153875,-113394,625
2022-01-05 14:54:08-05:00,1274,EgU9hX6VK7YXeCgCHVaJAMekCcyZa2MVWdKra5pN7Gwv,7y8Ad9XY34bqREvheXHT2tr8Jy11D6X3pu7yLVtjU4QV,True,266967568,66741892,415946,207973,207973,HfEnetJ7uBSmZWCjBNxdvv9HEC5nsW4wDV7wu6WnhWan,16637861,63971024,-47333163,623
2022-01-05 14:54:08-05:00,1275,Buioe5v3DyFwD9nquW5XdYeVYbSABCyg79eUHEvtvfaW,7T9gi7prCcZJkYJMSB5Ef6Bu4pAuBw4XLvumSFnqKDSi,True,19066343,4766585,29399,14699,14700,4BnQKPLuE3DMTtxp8MjUBytgnhvxqq3ZTqZHTVZo4JJh,1175966,5491926,-4315960,616
2022-01-05 14:54:47-05:00,1276,7aKxZg1aoLuB51JUw7fruF77ts7SWoB7pcLBZKHZMynr,AAnbLY82UGULqaDNdyJHrYu7X3hGaBuiTkGWmh8qKTc,True,182012666565,45503166640,282829961,141414980,141414981,DddJ7EWCmYEEZETCBNgAUSg81Ls6fZtiAaY5ekJ5sXx1,11313198446,1026613000,10286585446,621
2022-01-05 14:54:51-05:00,1277,gMjmD7WioyUdQdwNqE5fobLcxPwoJv5rAvLmJaf8Jjw,5n77euFjVJiwKrnbYq1KpcENW1mzBZj2BuDGyzazrkJ8,True,13387534,3346883,20865,10432,10433,DddJ7EWCmYEEZETCBNgAUSg81Ls6fZtiAaY5ekJ5sXx1,834625,3424716,-2590091,623
2022-01-05 14:54:51-05:00,1278,BAzH5niE2GX9CHGn3jK6Wv8Dd59PT95dX4dgfZXWoLPT,YNRnuEoNBPFsr7W91gc85TXAdA4ZnXfF2x951zbeRKF,True,604431,151106,937,468,469,DddJ7EWCmYEEZETCBNgAUSg81Ls6fZtiAaY5ekJ5sXx1,37485,145518,-108033,620
2022-01-05 14:55:00-05:00,1279,EEcTbsFTUEifcdbPyjBLkS943daEx1RpR8F3uZxKRZbT,8V3JzDQ1VWYQLas8fxUsWJZZHe4gEmn74RehtUwLw3k5,True,144057246,36014311,222762,111381,111381,4BnQKPLuE3DMTtxp8MjUBytgnhvxqq3ZTqZHTVZo4JJh,8910481,34246741,-25336260,618
2022-01-05 14:55:04-05:00,1280,H6tDNj9cHac223ckAnNfnC4bAJuNLBnf2pFk2iQdMzMP,28UL9dqgayCqCAexScXjdpobYGVDN44SGBVNAfBByk8C,True,1800446066,450111516,2782132,1391066,1391066,4BnQKPLuE3DMTtxp8MjUBytgnhvxqq3ZTqZHTVZo4JJh,111285319,531425483,-420140164,618
2022-01-05 14:55:27-05:00,1281,Gs3WP18hbzNpbBgiU39e6tfkggfCKRyNqPqJQcthuHFD,4XAY25YUma6gUdG2GdbXeivum3t21g93ZagfWGTZYkWZ,True,145269518,36317379,227042,113521,113521,HfEnetJ7uBSmZWCjBNxdvv9HEC5nsW4wDV7wu6WnhWan,9081701,43680168,-34598467,625
2022-01-05 14:55:31-05:00,1282,HhwiZPKZBGa16oVi739s4qtMDMTwzWXc7iwNfX63t2UP,5AnbMbAFKy85yHt5y2M5S38nNkA1vT4ejY5NjGbRNUqn,True,37211486,9302871,58208,29104,29104,DddJ7EWCmYEEZETCBNgAUSg81Ls6fZtiAaY5ekJ5sXx1,2328328,12573336,-10245008,625
2022-01-05 14:57:00-05:00,1283,36ByQojnxEckWdQTjqHfxKqCx9yjqWQsPsZyqaN72UWR,AZoirtS1fjX61agRM64tqThVinnJTh3BWgiHyNHPTgZP,True,22451736,5612933,34682,17341,17341,DddJ7EWCmYEEZETCBNgAUSg81Ls6fZtiAaY5ekJ5sXx1,1387317,6442076,-5054759,617
2022-01-05 14:57:44-05:00,1284,5jin5wXjQQ25nGM2ECrCXcg1a95vquh6kM7rMRru6Ke7,EKM657EQ8HWWgf4cssByoYHoXGjFfTspTKXAGmygAPQG,True,1009219274,252304818,1575866,787933,787933,HfEnetJ7uBSmZWCjBNxdvv9HEC5nsW4wDV7wu6WnhWan,63034647,242458248,-179423601,624
2022-01-05 14:58:12-05:00,1285,3njiRuSRMXRzKmamyiR72Hc38PU8UDDmWdfPhgxmGxEW,5WoF3gkgygyNNbwxWgVfqGWkExcDixuzgJQQjXEZQ6J5,True,6840306938,1710076734,10680227,5340113,5340114,HfEnetJ7uBSmZWCjBNxdvv9HEC5nsW4wDV7wu6WnhWan,427209087,2760874243,-2333665156,624
2022-01-05 14:58:18-05:00,1286,J1sBDjpdBZcsSBS5eg95SSRjRqmQUR9cXJCsLJu8yCUt,F5wRpD2senMkGbL8Uquqo8W9x5NQDDa268dHuVFAZCww,True,28412966,7103241,43966,21983,21983,HfEnetJ7uBSmZWCjBNxdvv9HEC5nsW4wDV7wu6WnhWan,1758646,9404196,-7645550,618
2022-01-05 14:58:55-05:00,1287,8MKNsuGVaoYpdQy6NNyxDvRzh2DAquBUtri4nDsixUxs,D7M1SDmpZAs8vdPCCCa96UbDF15YQDxHmoGWB57tHiir,True,110970781,27742695,173430,86715,86715,HfEnetJ7uBSmZWCjBNxdvv9HEC5nsW4wDV7wu6WnhWan,6937202,29245751,-22308549,625
2022-01-05 14:59:38-05:00,1288,BgoKAyBNaJ1geeQ2FcGSHEQDWATVD3w3wmcNHtj8Awu3,8Haz7duE2ycueaJsGdrGNnK79KGHwnzKBpoafC8RZGg2,True,221085196,55271299,344724,172362,172362,HfEnetJ7uBSmZWCjBNxdvv9HEC5nsW4wDV7wu6WnhWan,13788979,74332236,-60543257,623
2022-01-05 15:00:07-05:00,1289,F2v1YwVAwXLiUgsJ5uwn4qAAkTXitn1E75fJcPnGuAcy,5rdJ4H5GxPg4Juu77mGc7uya5LwEqLzDSRyG8mQ2mDbK,True,516602335,129150583,806393,403196,403197,4BnQKPLuE3DMTtxp8MjUBytgnhvxqq3ZTqZHTVZo4JJh,32255729,123961513,-91705784,624
2022-01-05 15:00:11-05:00,1290,Fd2HrzBAr4JobRPARZwpQHHVoSCEoog32A6tKMWAC1sK,BYappsar5sQf8VLem4wrLuTtrDFH9y8pEx1aMxfuU4Pq,True,806661777,201665444,1262402,631201,631201,4BnQKPLuE3DMTtxp8MjUBytgnhvxqq3ZTqZHTVZo4JJh,50496115,193544626,-143048511,625
2022-01-05 15:00:12-05:00,1291,2VyFcgZDH1HTEvD1XaWhwqBCMmZ1k6TmZ3fEpPcBZR9E,G1wFJETTpdoc7CfypGCzkq1jssXPfUkiuLjK2cwVZ9dJ,True,2156573,539142,3358,1679,1679,72FwbpFGoLEazJEdpqNtPNefsadUrimUqma9wSoy4qiS,134333,545902,-411569,622
2022-01-05 15:00:16-05:00,1292,6eBSLXDMVoW2nG3n7s42RXDH8byY3C6n1RsUuegBLSrG,37dYrKnTXYer7Bu9xFfpArA4ZNo2B9bycFw9HywDtTRx,True,265643183,66410795,414680,207340,207340,HfEnetJ7uBSmZWCjBNxdvv9HEC5nsW4wDV7wu6WnhWan,16587215,60372671,-43785456,624
2022-01-05 15:06:12-05:00,1293,FtNFtrFpUxLGDP3KTusCxgWMiDqXErcBLzPHVXDwTvNH,FnJfrBQYt9arf1sY3MJn9r8ZWGgjG8mVt5X8pcond5p,True,592163,148039,921,460,461,HfEnetJ7uBSmZWCjBNxdvv9HEC5nsW4wDV7wu6WnhWan,36863,143988,-107125,622
2022-01-05 15:06:14-05:00,1294,56488NdcUy6Hi6X5SLs2GFtW5pG4u5wJpH7vHdxTCx4z,tGgXjJeVr3W2m3T2NXPCqpBEd6HJKE2cRsgCyiDZQy4,True,315867272,78966817,486476,243238,243238,DddJ7EWCmYEEZETCBNgAUSg81Ls6fZtiAaY5ekJ5sXx1,19459041,103591769,-84132728,616
2022-01-05 15:06:16-05:00,1295,6woJkgUd2cpQQQBEp1C2G9NsYAvPwYmZXXTd6AxhieMy,E6xCdLJbDq5qFsvHEffD1Qfqrsj19H81mbj7XMUXUPnr,True,153207695,38301923,237643,118821,118822,HfEnetJ7uBSmZWCjBNxdvv9HEC5nsW4wDV7wu6WnhWan,9505749,51528901,-42023152,620
2022-01-05 15:06:16-05:00,1296,AoPQqPjLPi8fZiLkhMGLRj6oD5k2asrvJtCkpW19DvGr,H5Sgmf1VuY13iHjPuLJ2q9wtSdkXG1AQsEv2eq6zzm8Y,True,10696916,2674228,16707,8353,8354,DddJ7EWCmYEEZETCBNgAUSg81Ls6fZtiAaY5ekJ5sXx1,668318,2874487,-2206169,624
2022-01-05 15:06:19-05:00,1297,BtnTjb4mghmBK9KnLp2JzyGqfKB8tHskrGL4MzjAdF6V,BLStL7zka6qakHMhY4V6jKJT5agS1LtWMdWBZ1eP1Vi7,True,668280,167068,1043,521,522,HfEnetJ7uBSmZWCjBNxdvv9HEC5nsW4wDV7wu6WnhWan,41754,164156,-122402,624
2022-01-05 15:06:24-05:00,1298,AaMCg49sJwNtdB5wHACg15TYAzzJXy8xtG4zuVXhKiVE,HbDYqDa9bewGPvsiaHRM9HmEvh1scPaUaGvqog66gYir,True,10791584,2697895,16884,8442,8442,4BnQKPLuE3DMTtxp8MjUBytgnhvxqq3ZTqZHTVZo4JJh,675392,2907264,-2231872,625
2022-01-05 15:06:49-05:00,1299,DH2tcZVt4nHQbph6znZRrwcyhjwiNYtgeamu72vcC6nR,ACsbP5BDFQEHQHTsdrWTBShhEUh9HeAKsE7iwyK72v2p,True,7405234,1851308,11231,5615,5616,4BnQKPLuE3DMTtxp8MjUBytgnhvxqq3ZTqZHTVZo4JJh,449261,2538762,-2089501,606
2022-01-05 15:07:13-05:00,1300,7mYQ2DJZ1YYMpNbpA93hCDtzQDhEHjAGxLJt2g4KeYTW,8nTKeruC3wiPjT7VytdM2gX7msjwbHxTkyhsR88GJgpc,True,212278932,53069733,325835,162917,162918,4BnQKPLuE3DMTtxp8MjUBytgnhvxqq3ZTqZHTVZo4JJh,13033412,45754480,-32721068,613
2022-01-05 15:07:13-05:00,1301,Dn916KSmX3HqxT53hrxrbCrV3tdRMCPdaoiRLqetMrth,ATCXRiXgnjRRUbSTPBvtBXMENCqsViexSZbZ6aDaXXWA,True,18828016,4707003,29356,14678,14678,4BnQKPLuE3DMTtxp8MjUBytgnhvxqq3ZTqZHTVZo4JJh,1174265,4833030,-3658765,623
2022-01-05 15:07:13-05:00,1302,8eTH6eJyyVeMno3UQkffeBg32xofKsQfkhLhXdtaf87s,BCFC7CPXrQPsUfJb2eYSht8GhaApWHpc49AeCXqaYq13,True,10953558,2738389,17087,8543,8544,4BnQKPLuE3DMTtxp8MjUBytgnhvxqq3ZTqZHTVZo4JJh,683512,2943461,-2259949,624
2022-01-05 15:07:13-05:00,1303,5gN3624v6n1zQ1BKtZi1e9ZLpbCa4MEfhgHySFB81Qfm,UXT3oB5ud18rBsygsfxwA93kQYdSNbbzTCjt4gtU2jP,True,12605446,3151361,19572,9786,9786,4BnQKPLuE3DMTtxp8MjUBytgnhvxqq3ZTqZHTVZo4JJh,782890,3421743,-2638853,621
2022-01-05 15:07:14-05:00,1304,FoYrQCyDQ75YMNvkgTULbVHYmdrsoFJHohBLPfeF5rEH,DUyVhESZMDUS6Rqsz92CnW2KbWzAs6soEzZqD59XAKzY,True,262487590,65621897,392279,196139,196140,4BnQKPLuE3DMTtxp8MjUBytgnhvxqq3ZTqZHTVZo4JJh,15691177,80170560,-64479383,597
2022-01-05 15:07:31-05:00,1305,67Z7ZGhNu5xxEh9BYKWcXp9m1T4tFiE1o1M16hCzUWQA,CT7YKWixz7BhTbvg5F6M5HCyPGnHoFLNFuDV9GhoLTo3,True,87387416,21846854,136540,68270,68270,4BnQKPLuE3DMTtxp8MjUBytgnhvxqq3ZTqZHTVZo4JJh,5461628,27224265,-21762637,624
2022-01-05 15:07:31-05:00,1306,EmGW2aAG69ssWqCtbfDocRaM2u3TJsczn2HHP9jdmRvD,aypkDKsp9uqAB4F6mwvm5LofpsrFBuZT2MMWtE2eHdB,True,17260610,4315152,26503,13251,13252,4BnQKPLuE3DMTtxp8MjUBytgnhvxqq3ZTqZHTVZo4JJh,1060146,3797516,-2737370,614
2022-01-05 15:07:31-05:00,1307,ANQkPUoMjLHyRtypeKzxsKW1DFauQsh9SnB3rRgRXM1Y,7RHAExWpG8Q3PXwKhJs2yXmYK9WogGydvFYpx28p6pgr,True,1940668508,485167127,2981094,1490547,1490547,HfEnetJ7uBSmZWCjBNxdvv9HEC5nsW4wDV7wu6WnhWan,119243765,604468201,-485224436,614
2022-01-05 15:07:35-05:00,1308,8RmB8o4zux2sD48dEsKpsX475KRxTwdk8QULUDU9xx8R,AKSiZnb4YKVB6B86aPPqvyXquhvN9xqt45bexBCZ7nx,True,1693283982,423320995,2585537,1292768,1292769,4BnQKPLuE3DMTtxp8MjUBytgnhvxqq3ZTqZHTVZo4JJh,103421506,516349533,-412928027,610
2022-01-05 15:07:59-05:00,1309,7jvKp6onXyWgwsFrFWj4hYTXJsYYD6ot5mn6rPFuJriy,J7N6HiozevJVTiY9hDEUs2ud5BwT5QSE7wnMBS1w5ie2,True,640245650,160061412,992146,496073,496073,4BnQKPLuE3DMTtxp8MjUBytgnhvxqq3ZTqZHTVZo4JJh,39685876,200469198,-160783322,619
2022-01-05 15:07:59-05:00,1310,D58t4uTjFumsUeYFaKnpV8BRTEQEqKXBreFTdwGrott7,67p6kHDfVqQijfcwugvZK59c3aRRH9x3eHxruqH8WEqF,True,10897846,2724461,16876,8438,8438,DddJ7EWCmYEEZETCBNgAUSg81Ls6fZtiAaY5ekJ5sXx1,675078,3027492,-2352414,619
2022-01-05 15:07:59-05:00,1311,4KMzwWHPeW51cxu4nMpbqCaqo96dMqaHWyRCGQktfQfd,F7q4GNYcbnZa8dJ4qovQwjmxpKpdEmdxQMXRPb9nQupa,True,10892187,2723046,16789,8394,8395,72FwbpFGoLEazJEdpqNtPNefsadUrimUqma9wSoy4qiS,671592,3026318,-2354726,616
2022-01-05 15:07:59-05:00,1312,72L76qDRMK3M7X52zuuB9GVyvFFLDBZwFMpVjWjghXzA,4m2ZVuemUctu1edv4YJVAcjXzKwpbCmBujzoUmLDeA7h,True,11144607,2786151,17436,8718,8718,4BnQKPLuE3DMTtxp8MjUBytgnhvxqq3ZTqZHTVZo4JJh,697440,3018967,-2321527,625
2022-01-05 15:08:05-05:00,1313,Dng7By2saPu5TVxcvXidBe71ggBo8tiHkAXPi4kKL1tk,75ufEJmHbLHffphL7tvAXhGyftKLr1z2PXXoB2GGY5fG,True,10205987,2551496,15885,7942,7943,4BnQKPLuE3DMTtxp8MjUBytgnhvxqq3ZTqZHTVZo4JJh,635431,2793282,-2157851,622
2022-01-05 15:08:08-05:00,1314,Cv5oVktxmqbU1SxraxH67NEWMKnjgA18R832Fhe9h74a,Cs7xBD4BDiohyopnaYDDChUtR9vmx7uwot6Qp9beQLzt,True,9557699,2389424,14802,7401,7401,4BnQKPLuE3DMTtxp8MjUBytgnhvxqq3ZTqZHTVZo4JJh,592095,2624971,-2032876,619
2022-01-05 15:08:08-05:00,1315,GKNBtZbwK4w9hyXD1r38NTGcTJhpjt8R9WFCzdXup9Tk,7RLaL2XoFuqrcCcPEB6FzPJzLnAhjQpwcRmDfdpRXFgB,True,198345311,49586327,307793,153896,153897,4BnQKPLuE3DMTtxp8MjUBytgnhvxqq3ZTqZHTVZo4JJh,12311747,67431347,-55119600,620
2022-01-05 15:08:11-05:00,1316,EBUcTqh9AYyRokZRzLbPKL9ZmTUx6KcDEbBeuCLGwqYC,B5WSXfHzYQhUFE2T97GaiqSkeejTWKKGVjMkcFrxEvyJ,True,609830202,152457550,926635,463317,463318,HfEnetJ7uBSmZWCjBNxdvv9HEC5nsW4wDV7wu6WnhWan,37065422,149105311,-112039889,607
2022-01-05 15:08:22-05:00,1317,6uZobpBuFcQeYgZ4dApFi6iy4DB9GLHP1AAsQcCj6212,SGGFiPjjhscwroiWMqY4jTAHFw8eakpsEv35wNoHUPY,True,1832647097,458161772,2832400,1416200,1416200,4BnQKPLuE3DMTtxp8MjUBytgnhvxqq3ZTqZHTVZo4JJh,113296031,399290182,-285994151,618
2022-01-05 15:08:28-05:00,1318,Gbxc51WERLLeCtiHv7rDvE52aqF541RoQWG5n5aqErq6,4ngBoHbfXijLMqGKxFMNht9sbmxy2g5eqBmn8QsBmbx1,True,10919893,2729973,16891,8445,8446,3RdfgDvLvsdZG5Cf6hKiKMQMqfidyxHzjYvUx1FZpeHQ,675651,3052719,-2377068,618
2022-01-05 15:08:29-05:00,1319,BhiAaiZu7fF8ndggJrLyiFVCRq526cNBw7VaeascEmNL,4en8MipPi7vq15NGhpPMQfptNdEyhp2j7fpgxBBtjyfz,True,9424179,2356044,14742,7371,7371,3RdfgDvLvsdZG5Cf6hKiKMQMqfidyxHzjYvUx1FZpeHQ,589703,2521823,-1932120,625
2022-01-05 15:08:45-05:00,1320,DGbj8tnqECzM9FG8j225Ap7A4Fdm3J1Ksm32JBFG7igv,Cd3D2UVwoSZLygM2e3UQppQANsokpmx5CNBs1C5zueay,True,9955141,2488785,15311,7655,7656,3RdfgDvLvsdZG5Cf6hKiKMQMqfidyxHzjYvUx1FZpeHQ,612451,2677270,-2064819,615
2022-01-05 15:08:59-05:00,1321,GWEfWJimTKDJuxSTAb7SxkT3L3FhPPu8wJzYYF8H4SgD,BdeMcj3cMyKVPeF7Mt9Jdpxgzq9P6c79qJR6ctiiDauL,True,722883314,180720828,1124384,562192,562192,4BnQKPLuE3DMTtxp8MjUBytgnhvxqq3ZTqZHTVZo4JJh,44975396,163120383,-118144987,622
2022-01-05 15:09:00-05:00,1322,8BTja7VnFPe6M9BHTqg5LTpX6vd4ugTeWLzpq3oFP8WM,pscjH4sPnNL6zQBmvHjEEbix6BTstnsrSwGysNWyPkd,True,431915,107977,672,336,336,HfEnetJ7uBSmZWCjBNxdvv9HEC5nsW4wDV7wu6WnhWan,26903,113353,-86450,622
2022-01-05 15:09:01-05:00,1323,CRaKcudjkQiSw5YPVjTLVdXvJskeGiHSYtq5ZcMPJhgQ,AgqTg3b3bAcaBmRidhNC4Uf9ZwNbeH52RQEqumWyuUs7,True,23275897,5818974,36339,18169,18170,HfEnetJ7uBSmZWCjBNxdvv9HEC5nsW4wDV7wu6WnhWan,1453582,7837967,-6384385,624
2022-01-05 15:09:22-05:00,1324,9vcKW1GfrDZ3KLPh2pEVFF8ZyKqD1pJW1hiE8H98Av7S,C6Ki27mo4sCHu6u8UnR1p7WSgsTjFQxGGR9Lk9n5Rhjq,True,74608724,18652181,115904,57952,57952,4BnQKPLuE3DMTtxp8MjUBytgnhvxqq3ZTqZHTVZo4JJh,4636173,17578069,-12941896,621
2022-01-05 15:09:27-05:00,1325,Ckqos6cdncPKj13DnCmDVZsZTqp6eS7277CRrT9WhcEr,AtUV8m7VQJvZq7GLCAHMf3jV7iamKEPnWVZHWuuVZQp1,True,33340612,8335153,51709,25854,25855,HfEnetJ7uBSmZWCjBNxdvv9HEC5nsW4wDV7wu6WnhWan,2068395,11244361,-9175966,620
2022-01-05 15:10:06-05:00,1326,HGJoZvLakWfSDFwuvShNBc4kCf7nP7VqzyM3mELpbFEf,12Qn5jin7QvsBngXqYAv4UstyG3b6nRf1jsLp9Dp8G7k,True,434887831,108721957,671278,335639,335639,4BnQKPLuE3DMTtxp8MjUBytgnhvxqq3ZTqZHTVZo4JJh,26851138,91912807,-65061669,617
2022-01-05 15:10:12-05:00,1327,4gzW9gBbEMnNm1epY6MMJ1XfxGMtvn2mKFyKPQ2Gyb79,G6x862hmMJ2PLpyyPDwVPGapXjvEeNkqFRTAS3jWVozB,True,47162813,11790703,73274,36637,36637,4BnQKPLuE3DMTtxp8MjUBytgnhvxqq3ZTqZHTVZo4JJh,2930991,16651050,-13720059,621
2022-01-05 15:10:17-05:00,1328,G25vsB3sDqRhHoSK4KwR1TywfrJDtpejVbbevEG9sQ9a,5xFC3Hm13magnAA9GD1EnwC9PrPoEfQ7omEa9p9zCrB1,True,13362836,3340708,20830,10415,10415,4BnQKPLuE3DMTtxp8MjUBytgnhvxqq3ZTqZHTVZo4JJh,833235,3492670,-2659435,623
2022-01-05 15:10:28-05:00,1329,7iUx7JBwqUvPVPeCqMEXQdLccZJmaFYm1DUQiu3ouHa3,3EVZzhRmJnX9ZiBZZo9tenDtMogAyuA1yf2cKzvUWiuu,True,12381428,3095356,19236,9618,9618,HfEnetJ7uBSmZWCjBNxdvv9HEC5nsW4wDV7wu6WnhWan,769446,3526623,-2757177,621
2022-01-05 15:10:48-05:00,1330,7bnCuBLXnPS3wDBunrzoV5qm1GwfnPfRBwV2f9Xzo3Aj,9Xd7GNcFrx7z66DRW8kK3d1jN4tzuiwv9jyDFbHUx9vW,True,440139,110033,686,343,343,HfEnetJ7uBSmZWCjBNxdvv9HEC5nsW4wDV7wu6WnhWan,27442,116838,-89396,623
2022-01-05 15:11:18-05:00,1331,3WcJUt8jQ1ngL3ZCGo6dFrc3GmTMTYtzeDva7mri2Tqx,HeG1Pz2oMjqtkfsRMsbqP3VpatnVEQzcWmKDVoFp4Htr,True,434619136,108654784,664336,332168,332168,4BnQKPLuE3DMTtxp8MjUBytgnhvxqq3ZTqZHTVZo4JJh,26573465,91903829,-65330364,611
2022-01-05 15:11:50-05:00,1332,A7SMcwnq3DewryUj1jScnAboKGnuDVcW15F3ubNcG66Y,5qLCE37FdeWLCQnkfNJViFMGNcDeiELgE3VgPbBUuDGF,True,496475849,124118962,765631,382815,382816,4BnQKPLuE3DMTtxp8MjUBytgnhvxqq3ZTqZHTVZo4JJh,30625271,130967501,-100342230,616
2022-01-05 15:11:59-05:00,1333,E1wp3bmkcY3eiEYyGYwhTCsr7BZ7RfPa5DJTZFupcFwj,452hVdYkD5SDDrA6hv6DLPFvyS8PvR2P6DPNScGxWTsW,True,17396362,4349090,26770,13385,13385,4BnQKPLuE3DMTtxp8MjUBytgnhvxqq3ZTqZHTVZo4JJh,1070824,3672442,-2601618,615
2022-01-05 15:56:09-05:00,1334,7LBZi7Ec4VKhtNJbFQYYY8CvFbsLPCvqmn8Rd5EVhn9n,CBgkKDhmsEa8Ug8nE9Yu95gLDbDQa9FNGpdjVRfEDXcq,True,871453704,217863426,1363133,681566,681567,HfEnetJ7uBSmZWCjBNxdvv9HEC5nsW4wDV7wu6WnhWan,54525359,221465700,-166940341,625
2022-01-05 15:56:33-05:00,1335,9WJBnVi84E926j7xEd566WzrZJkPJWRgmEnYj9vyjuad,4dLaFS5F7TGyLdwuJLMGkz3bSL53aHzd9ZfpNmhHxXeF,True,427985035,106996258,669051,334525,334526,4BnQKPLuE3DMTtxp8MjUBytgnhvxqq3ZTqZHTVZo4JJh,26762076,110005147,-83243071,625
2022-01-05 16:18:14-05:00,1336,D3mXrJzhHf8qRaoCKLschUxAFoijFCFuT6bmNZH4W7Cj,9E3Xtqw7TncXWnbhAbFJMtuNmP6WS3ooGuptzyzw7UpA,True,1249001,312250,1950,975,975,4BnQKPLuE3DMTtxp8MjUBytgnhvxqq3ZTqZHTVZo4JJh,78007,395072,-317065,624
2022-01-05 16:19:00-05:00,1337,EQUZQWk4WLT6LFeWZs3P9AQufFcoZouFETfhyxvuS2JM,Byc2mLXArmkjQPWaxCJksHZD2XpZyCQ2FRtDJyztU81V,True,2050813395,512703348,3186325,1593162,1593163,72FwbpFGoLEazJEdpqNtPNefsadUrimUqma9wSoy4qiS,127453035,651257952,-523804917,621
2022-01-05 16:19:00-05:00,1338,9jdfc9GFTecsdRuTjWFGX13niKKmeBxRgtv5j86uhSnU,HLWMShobjSkaLyXrNjgwVaUGVtbtdUSnr1XjqpXn1bLR,True,6320509,1580127,9883,4941,4942,4BnQKPLuE3DMTtxp8MjUBytgnhvxqq3ZTqZHTVZo4JJh,395354,1480551,-1085197,625
2022-01-05 16:19:00-05:00,1339,2NdwSLxsGok8PczpCZj9CVX2BymNU5MvHt7hWfGetg2M,8AQbDXeA6mD9QoZBFJcYbnHvZwKNxzA9CCHLAgdSfTA3,True,229872,57468,355,177,178,4BnQKPLuE3DMTtxp8MjUBytgnhvxqq3ZTqZHTVZo4JJh,14223,65533,-51310,618
2022-01-05 16:19:00-05:00,1340,Ar5QB4VBcUyzSCG23z2QNAbrWY55NbHCr1MNN6P2GAmh,BusFGTiDrJmxzwGUxWz9b3SFF3eseqtgh2DRHqyAwyVe,True,9975936,2493984,15453,7726,7727,72FwbpFGoLEazJEdpqNtPNefsadUrimUqma9wSoy4qiS,618125,2131980,-1513855,619
2022-01-05 16:19:02-05:00,1341,GJ3PbEfPK8jjrPgMmZtvN5fMSSy2dtiiAtZ8wcfgxVuc,FCUDVFb2TjDvehHE8fVBofqSykpb9W6Afc9QeHtj7te7,True,1656078075,414019518,2591706,1295853,1295853,DddJ7EWCmYEEZETCBNgAUSg81Ls6fZtiAaY5ekJ5sXx1,103668251,519710062,-416041811,625
2022-01-05 16:19:29-05:00,1342,Mcbzp1LhZwpfmXTv1pqe9D1jCKHw443j9QKp6tUpzgM,8uforSMAKEih5jHfHp3gCqCvaugtCmhzVfVHA63Akz7F,True,43017201,10754300,67110,33555,33555,HfEnetJ7uBSmZWCjBNxdvv9HEC5nsW4wDV7wu6WnhWan,2684416,12396369,-9711953,624
2022-01-05 16:20:06-05:00,1343,7LRBswSEDBjJzQ4YurfTxLydh7tFS2jVn5V95Z6wL7ci,fD41VYGmk66MW46KKb23vAqQvUSDScgXnVdsHhJBZzu,True,2538031,634507,3944,1972,1972,4BnQKPLuE3DMTtxp8MjUBytgnhvxqq3ZTqZHTVZo4JJh,157761,657234,-499473,621
2022-01-05 16:20:07-05:00,1344,8VT2nxz5ZYDJFd9uL2XZwEXxChd9pjuMJNMAcutZubL1,EhAkiRbouzUAWtqQFsN8HEEfi46UVN8H8tyBP7CbgeLe,True,197607,49401,306,153,153,4BnQKPLuE3DMTtxp8MjUBytgnhvxqq3ZTqZHTVZo4JJh,12262,48300,-36038,620
2022-01-05 16:20:38-05:00,1345,Buioe5v3DyFwD9nquW5XdYeVYbSABCyg79eUHEvtvfaW,7T9gi7prCcZJkYJMSB5Ef6Bu4pAuBw4XLvumSFnqKDSi,True,14035578,3508894,21860,10930,10930,4BnQKPLuE3DMTtxp8MjUBytgnhvxqq3ZTqZHTVZo4JJh,874412,4375565,-3501153,622
2022-01-05 16:20:50-05:00,1346,5hUZ9uQFcYnjAQVVaGLJWdKyg7y1XMpoo8osQ9DeY7Xd,BdYiKWsjuzJLcHh3814mJ4xQ9JxoQKKcr7AHZ7Vxoavq,True,873361,218340,1358,679,679,72FwbpFGoLEazJEdpqNtPNefsadUrimUqma9wSoy4qiS,54354,180839,-126485,622
2022-01-05 16:24:34-05:00,1347,Hy3kzXneDN6FUkiZctU1vWe97BYvj6yZ7QvQzehfWmNr,EhXgQg8BTniANV525RpY76z7Hrh6DuqrMChjqEoXfVJe,True,18734835,4683708,29158,14579,14579,3RdfgDvLvsdZG5Cf6hKiKMQMqfidyxHzjYvUx1FZpeHQ,1166344,5741288,-4574944,622
2022-01-05 16:25:26-05:00,1348,EEcTbsFTUEifcdbPyjBLkS943daEx1RpR8F3uZxKRZbT,8V3JzDQ1VWYQLas8fxUsWJZZHe4gEmn74RehtUwLw3k5,True,106011726,26502931,164904,82452,82452,3RdfgDvLvsdZG5Cf6hKiKMQMqfidyxHzjYvUx1FZpeHQ,6596165,27629716,-21033551,622
2022-01-05 16:25:28-05:00,1349,EgU9hX6VK7YXeCgCHVaJAMekCcyZa2MVWdKra5pN7Gwv,7y8Ad9XY34bqREvheXHT2tr8Jy11D6X3pu7yLVtjU4QV,True,196191141,49047785,301892,150946,150946,HfEnetJ7uBSmZWCjBNxdvv9HEC5nsW4wDV7wu6WnhWan,12075701,51610612,-39534911,615
2022-01-05 16:25:40-05:00,1350,H6tDNj9cHac223ckAnNfnC4bAJuNLBnf2pFk2iQdMzMP,28UL9dqgayCqCAexScXjdpobYGVDN44SGBVNAfBByk8C,True,1325140768,331285192,2063877,1031938,1031939,72FwbpFGoLEazJEdpqNtPNefsadUrimUqma9wSoy4qiS,82555098,422877990,-340322892,622
2022-01-05 16:27:56-05:00,1351,2YcB3QQGWho5oogDd1nK3cpLQzwwwXGxybrhe2xDkDxq,5DjAUp6CxKStYTaXSnzjvYkfqCXfG8Y61bWw5UwbbE3q,True,30950333,7737583,48162,24081,24081,HfEnetJ7uBSmZWCjBNxdvv9HEC5nsW4wDV7wu6WnhWan,1926505,10862306,-8935801,622
2022-01-05 16:28:55-05:00,1352,gMjmD7WioyUdQdwNqE5fobLcxPwoJv5rAvLmJaf8Jjw,5n77euFjVJiwKrnbYq1KpcENW1mzBZj2BuDGyzazrkJ8,True,9843442,2460860,15328,7664,7664,HfEnetJ7uBSmZWCjBNxdvv9HEC5nsW4wDV7wu6WnhWan,613152,2752932,-2139780,622
2022-01-05 16:29:02-05:00,1353,Gs3WP18hbzNpbBgiU39e6tfkggfCKRyNqPqJQcthuHFD,4XAY25YUma6gUdG2GdbXeivum3t21g93ZagfWGTZYkWZ,True,106808108,26702026,166715,83357,83358,4BnQKPLuE3DMTtxp8MjUBytgnhvxqq3ZTqZHTVZo4JJh,6668638,34761649,-28093011,624
2022-01-05 16:29:09-05:00,1354,HhwiZPKZBGa16oVi739s4qtMDMTwzWXc7iwNfX63t2UP,5AnbMbAFKy85yHt5y2M5S38nNkA1vT4ejY5NjGbRNUqn,True,27354254,6838563,42504,21252,21252,HfEnetJ7uBSmZWCjBNxdvv9HEC5nsW4wDV7wu6WnhWan,1700166,9938294,-8238128,621
2022-01-05 16:29:11-05:00,1355,2PHDkmat5jQ65XkJYhDSw6ZwHcKpSw85o8MaPFhfLBry,8NtkXoUPt4wkcqQJuPJYt5oq9hG4BdeY26dQrsybDWWX,True,242582521,60645630,377166,188583,188583,4BnQKPLuE3DMTtxp8MjUBytgnhvxqq3ZTqZHTVZo4JJh,15086672,51510286,-36423614,621
2022-01-05 16:29:11-05:00,1356,BxXXWywnC3dSyLPJHt7owfBhgSiBWzkuD3T8hGYLqCH6,4vuwEBXXbXFMPmbJJJRop4FCWGyKR1sXhBc3EWF6MiB8,True,1881367009,470341752,2910649,1455324,1455325,HfEnetJ7uBSmZWCjBNxdvv9HEC5nsW4wDV7wu6WnhWan,116425964,607033789,-490607825,618
2022-01-05 16:31:59-05:00,1357,BgoKAyBNaJ1geeQ2FcGSHEQDWATVD3w3wmcNHtj8Awu3,8Haz7duE2ycueaJsGdrGNnK79KGHwnzKBpoafC8RZGg2,True,162167715,40541928,243874,121937,121937,HfEnetJ7uBSmZWCjBNxdvv9HEC5nsW4wDV7wu6WnhWan,9754992,58809340,-49054348,601
2022-01-05 16:32:04-05:00,1358,J1sBDjpdBZcsSBS5eg95SSRjRqmQUR9cXJCsLJu8yCUt,F5wRpD2senMkGbL8Uquqo8W9x5NQDDa268dHuVFAZCww,True,20846108,5211527,31138,15569,15569,HfEnetJ7uBSmZWCjBNxdvv9HEC5nsW4wDV7wu6WnhWan,1245529,7443321,-6197792,597
2022-01-05 16:33:58-05:00,1359,6woJkgUd2cpQQQBEp1C2G9NsYAvPwYmZXXTd6AxhieMy,E6xCdLJbDq5qFsvHEffD1Qfqrsj19H81mbj7XMUXUPnr,True,112695325,28173831,176020,88010,88010,4BnQKPLuE3DMTtxp8MjUBytgnhvxqq3ZTqZHTVZo4JJh,7040835,40768995,-33728160,624
2022-01-05 16:34:02-05:00,1360,36ByQojnxEckWdQTjqHfxKqCx9yjqWQsPsZyqaN72UWR,AZoirtS1fjX61agRM64tqThVinnJTh3BWgiHyNHPTgZP,True,16499919,4124979,25199,12599,12600,HfEnetJ7uBSmZWCjBNxdvv9HEC5nsW4wDV7wu6WnhWan,1007998,5137966,-4129968,610
2022-01-05 16:34:28-05:00,1361,3VdSA9CED9f5swRwHX2U15U7J6Muaq8VPnCNy9CaGDHe,2YYstfnfdYic5NWmEbcUEHpccNUVd1EhuCkExvMsoMk8,True,138891541,34722885,213714,106857,106857,HfEnetJ7uBSmZWCjBNxdvv9HEC5nsW4wDV7wu6WnhWan,8548576,44540378,-35991802,615
2022-01-05 16:34:37-05:00,1362,9KD2AifD5wFD4QkHYuawXbJgLWHrfj2QPF3fT8jhGVA5,Ga9gAqmkuHbqrr31sUFPqa1xa5WNxLWJWGPUaMxQqLdj,True,26960211,6740052,41284,20642,20642,HfEnetJ7uBSmZWCjBNxdvv9HEC5nsW4wDV7wu6WnhWan,1651370,8810835,-7159465,612
2022-01-05 16:34:41-05:00,1363,8sneA6wAg6geVDJ1g7YWg4R1PfjuRVzeHp1nUBJinhZa,14i1uWtmcTjrdbg3DSr9vzd5NBnxqsn1A4QdgFBZqeYM,True,2390566,597640,3724,1862,1862,HfEnetJ7uBSmZWCjBNxdvv9HEC5nsW4wDV7wu6WnhWan,148984,529795,-380811,623
2022-01-05 16:35:30-05:00,1364,5Rxuqgs4CaSKbfDXqBMFXkLTQ9dxrUjThXzoy3ouYVtK,BgvbKru66ebrGUcFFymGTmsaQv6GgcGMybiWaXqzBtwX,True,4287988,1071997,6614,3307,3307,HfEnetJ7uBSmZWCjBNxdvv9HEC5nsW4wDV7wu6WnhWan,264581,1484334,-1219753,617
2022-01-05 16:36:10-05:00,1365,3njiRuSRMXRzKmamyiR72Hc38PU8UDDmWdfPhgxmGxEW,5WoF3gkgygyNNbwxWgVfqGWkExcDixuzgJQQjXEZQ6J5,True,5029261543,1257315385,7817179,3908589,3908590,4BnQKPLuE3DMTtxp8MjUBytgnhvxqq3ZTqZHTVZo4JJh,312687194,2164281661,-1851594467,621
2022-01-05 16:36:11-05:00,1366,5PbrpM9kjzF4R2eW2UTcRVXnhqWdRQWHZJXKLN43N8WC,6ip4ocbyHusy8CsVvcrpiRCUp2nq9cY8bHpTcUU3Wztq,True,156133363,39033340,241580,120790,120790,4BnQKPLuE3DMTtxp8MjUBytgnhvxqq3ZTqZHTVZo4JJh,9663216,33511673,-23848457,618
2022-01-05 16:36:11-05:00,1367,5jin5wXjQQ25nGM2ECrCXcg1a95vquh6kM7rMRru6Ke7,EKM657EQ8HWWgf4cssByoYHoXGjFfTspTKXAGmygAPQG,True,741489642,185372410,1140258,570129,570129,72FwbpFGoLEazJEdpqNtPNefsadUrimUqma9wSoy4qiS,45610354,195610073,-149999719,615
2022-01-05 16:36:23-05:00,1368,8MKNsuGVaoYpdQy6NNyxDvRzh2DAquBUtri4nDsixUxs,D7M1SDmpZAs8vdPCCCa96UbDF15YQDxHmoGWB57tHiir,True,81615820,20403955,127622,63811,63811,4BnQKPLuE3DMTtxp8MjUBytgnhvxqq3ZTqZHTVZo4JJh,5104880,23448647,-18343767,625
2022-01-05 16:36:34-05:00,1369,3Lv2XpiD4KBUHq7Zx6u3zNhpXoySodXHH8o8f5yaaPxG,H6TN4rhpBXkEH3mZnymYNcKfmnxRH2uzfwzeLH2q6ahP,True,3682048,920512,5759,2879,2880,72FwbpFGoLEazJEdpqNtPNefsadUrimUqma9wSoy4qiS,230376,794524,-564148,625
2022-01-05 16:37:12-05:00,1370,2VyFcgZDH1HTEvD1XaWhwqBCMmZ1k6TmZ3fEpPcBZR9E,G1wFJETTpdoc7CfypGCzkq1jssXPfUkiuLjK2cwVZ9dJ,True,1586036,396509,2477,1238,1239,4BnQKPLuE3DMTtxp8MjUBytgnhvxqq3ZTqZHTVZo4JJh,99118,439192,-340074,624
2022-01-05 16:37:59-05:00,1371,HAk9c831TRUhvpoK4d7PTqfJuJhSjnJUXWpnYsH85bDJ,DVSa3CJrVLTHAeFYjEF89ZjWRm86QwruUk2Y8RvGpjsr,True,475726,118930,733,366,367,HfEnetJ7uBSmZWCjBNxdvv9HEC5nsW4wDV7wu6WnhWan,29342,124406,-95064,616
2022-01-05 16:38:12-05:00,1372,F2v1YwVAwXLiUgsJ5uwn4qAAkTXitn1E75fJcPnGuAcy,5rdJ4H5GxPg4Juu77mGc7uya5LwEqLzDSRyG8mQ2mDbK,True,379723841,94930960,590293,295146,295147,4BnQKPLuE3DMTtxp8MjUBytgnhvxqq3ZTqZHTVZo4JJh,23611731,100120870,-76509139,621
2022-01-05 16:38:21-05:00,1373,AoPQqPjLPi8fZiLkhMGLRj6oD5k2asrvJtCkpW19DvGr,H5Sgmf1VuY13iHjPuLJ2q9wtSdkXG1AQsEv2eq6zzm8Y,True,7863726,1965931,12279,6139,6140,4BnQKPLuE3DMTtxp8MjUBytgnhvxqq3ZTqZHTVZo4JJh,491166,2304757,-1813591,624
2022-01-05 16:38:21-05:00,1374,8RmB8o4zux2sD48dEsKpsX475KRxTwdk8QULUDU9xx8R,AKSiZnb4YKVB6B86aPPqvyXquhvN9xqt45bexBCZ7nx,True,1247466030,311866507,1949465,974732,974733,HfEnetJ7uBSmZWCjBNxdvv9HEC5nsW4wDV7wu6WnhWan,77978632,410193072,-332214440,625
2022-01-05 16:38:21-05:00,1375,Fd2HrzBAr4JobRPARZwpQHHVoSCEoog32A6tKMWAC1sK,BYappsar5sQf8VLem4wrLuTtrDFH9y8pEx1aMxfuU4Pq,True,592921456,148230364,924688,462344,462344,4BnQKPLuE3DMTtxp8MjUBytgnhvxqq3ZTqZHTVZo4JJh,36987548,156353414,-119365866,623
2022-01-05 16:38:31-05:00,1376,8NdcaYUC1X5CP7FMDip78uqtqmCt8GcZdCzLRTYTihmb,9Ei1K9bXWXSXcBfeX5exPSXGCAu62WSKzvnnd4wHvyVh,True,2584084,646021,3981,1990,1991,4BnQKPLuE3DMTtxp8MjUBytgnhvxqq3ZTqZHTVZo4JJh,159262,574615,-415353,616
2022-01-05 16:38:32-05:00,1377,6eBSLXDMVoW2nG3n7s42RXDH8byY3C6n1RsUuegBLSrG,37dYrKnTXYer7Bu9xFfpArA4ZNo2B9bycFw9HywDtTRx,True,195042014,48760503,298143,149071,149072,HfEnetJ7uBSmZWCjBNxdvv9HEC5nsW4wDV7wu6WnhWan,11925755,48955716,-37029961,611
2022-01-05 16:38:35-05:00,1378,DH2tcZVt4nHQbph6znZRrwcyhjwiNYtgeamu72vcC6nR,ACsbP5BDFQEHQHTsdrWTBShhEUh9HeAKsE7iwyK72v2p,True,5452617,1363154,8397,4198,4199,72FwbpFGoLEazJEdpqNtPNefsadUrimUqma9wSoy4qiS,335906,2004342,-1668436,616
2022-01-05 16:38:44-05:00,1379,AaMCg49sJwNtdB5wHACg15TYAzzJXy8xtG4zuVXhKiVE,HbDYqDa9bewGPvsiaHRM9HmEvh1scPaUaGvqog66gYir,True,7929785,1982446,12326,6163,6163,4BnQKPLuE3DMTtxp8MjUBytgnhvxqq3ZTqZHTVZo4JJh,493057,2330868,-1837811,621
2022-01-05 16:38:44-05:00,1380,EmGW2aAG69ssWqCtbfDocRaM2u3TJsczn2HHP9jdmRvD,aypkDKsp9uqAB4F6mwvm5LofpsrFBuZT2MMWtE2eHdB,True,12700696,3175174,19630,9815,9815,4BnQKPLuE3DMTtxp8MjUBytgnhvxqq3ZTqZHTVZo4JJh,785208,3083000,-2297792,618
2022-01-05 16:38:48-05:00,1381,ANQkPUoMjLHyRtypeKzxsKW1DFauQsh9SnB3rRgRXM1Y,7RHAExWpG8Q3PXwKhJs2yXmYK9WogGydvFYpx28p6pgr,True,1428026711,357006677,2209374,1104687,1104687,HfEnetJ7uBSmZWCjBNxdvv9HEC5nsW4wDV7wu6WnhWan,88374993,479796321,-391421328,618
2022-01-05 16:38:59-05:00,1382,67Z7ZGhNu5xxEh9BYKWcXp9m1T4tFiE1o1M16hCzUWQA,CT7YKWixz7BhTbvg5F6M5HCyPGnHoFLNFuDV9GhoLTo3,True,64218109,16054527,99600,49800,49800,4BnQKPLuE3DMTtxp8MjUBytgnhvxqq3ZTqZHTVZo4JJh,3984039,21628528,-17644489,620
2022-01-05 16:39:04-05:00,1383,864zY9zuCktUurPTtdGeLvUATnDqHZpT1GeWUApsXh2m,CzatBrNJUi7MeyfbNhszRaPMidgt8Xkcmy5ZwFMP9RCs,True,407472930,101868232,631656,315828,315828,HfEnetJ7uBSmZWCjBNxdvv9HEC5nsW4wDV7wu6WnhWan,25266246,99895194,-74628948,620
2022-01-05 16:39:27-05:00,1384,CRaKcudjkQiSw5YPVjTLVdXvJskeGiHSYtq5ZcMPJhgQ,AgqTg3b3bAcaBmRidhNC4Uf9ZwNbeH52RQEqumWyuUs7,True,17112914,4278228,26706,13353,13353,4BnQKPLuE3DMTtxp8MjUBytgnhvxqq3ZTqZHTVZo4JJh,1068277,6200580,-5132303,624
2022-01-05 16:54:52-05:00,1385,HVZkXeDR3mc8oB9qFFwCK4RXpPojdcHk9tRGep6xtKGK,Bh3py7awPejWqeTMxtAgF7mPotL2Asxf8YrYJykq9nBt,True,130194521,32548630,202052,101026,101026,DddJ7EWCmYEEZETCBNgAUSg81Ls6fZtiAaY5ekJ5sXx1,8082099,27898300,-19816201,620
2022-01-05 16:54:52-05:00,1386,Ckqos6cdncPKj13DnCmDVZsZTqp6eS7277CRrT9WhcEr,AtUV8m7VQJvZq7GLCAHMf3jV7iamKEPnWVZHWuuVZQp1,True,24511950,6127987,37901,18950,18951,DddJ7EWCmYEEZETCBNgAUSg81Ls6fZtiAaY5ekJ5sXx1,1516068,8891561,-7375493,618
2022-01-05 16:54:52-05:00,1387,9vcKW1GfrDZ3KLPh2pEVFF8ZyKqD1pJW1hiE8H98Av7S,C6Ki27mo4sCHu6u8UnR1p7WSgsTjFQxGGR9Lk9n5Rhjq,True,54846531,13711632,84858,42429,42429,DddJ7EWCmYEEZETCBNgAUSg81Ls6fZtiAaY5ekJ5sXx1,3394349,14210823,-10816474,618
2022-01-05 16:54:52-05:00,1388,7PzGZgzieFyyFs1dbajkNQgVxooFUNZrj1bUsQvrSwbp,A2gDREmSmJTBPPw3sbKVY3smC9wbHMDdv87gr4Tr2ES7,True,56153797,14038449,87784,43892,43892,DddJ7EWCmYEEZETCBNgAUSg81Ls6fZtiAaY5ekJ5sXx1,3511398,12164205,-8652807,625
2022-01-05 16:55:16-05:00,1389,3qnPsgqW11AcDEmyjmJquPcPLyE3EdJQuVLJ5kinDrd3,86rZadBB7emKio76aFTahpbrFtxd9tqZ4Mxgzaavq2xU,True,3116421,779105,4804,2402,2402,DddJ7EWCmYEEZETCBNgAUSg81Ls6fZtiAaY5ekJ5sXx1,192198,675777,-483579,616
2022-01-05 16:55:21-05:00,1390,HGJoZvLakWfSDFwuvShNBc4kCf7nP7VqzyM3mELpbFEf,12Qn5jin7QvsBngXqYAv4UstyG3b6nRf1jsLp9Dp8G7k,True,319931239,79982809,496308,248154,248154,DddJ7EWCmYEEZETCBNgAUSg81Ls6fZtiAaY5ekJ5sXx1,19852334,74884532,-55032198,620
2022-01-05 17:00:15-05:00,1391,BAzH5niE2GX9CHGn3jK6Wv8Dd59PT95dX4dgfZXWoLPT,YNRnuEoNBPFsr7W91gc85TXAdA4ZnXfF2x951zbeRKF,True,444723,111179,695,347,348,DddJ7EWCmYEEZETCBNgAUSg81Ls6fZtiAaY5ekJ5sXx1,27836,117466,-89630,625
2022-01-05 17:01:21-05:00,1392,DR7XL3qweFyTKDatQYS2LacqGLv2368cnGuWpEpk4hSL,Fd3BYCiiQfThDJsxBUNwYTMP8eNCrnXMVzE1wpejJqXa,True,94117,23529,147,73,74,DddJ7EWCmYEEZETCBNgAUSg81Ls6fZtiAaY5ekJ5sXx1,5891,27404,-21513,625
2022-01-05 17:01:21-05:00,1393,3WcJUt8jQ1ngL3ZCGo6dFrc3GmTMTYtzeDva7mri2Tqx,HeG1Pz2oMjqtkfsRMsbqP3VpatnVEQzcWmKDVoFp4Htr,True,320256779,80064194,500439,250219,250220,DddJ7EWCmYEEZETCBNgAUSg81Ls6fZtiAaY5ekJ5sXx1,20017579,74724237,-54706658,625
2022-01-05 17:02:20-05:00,1394,Fcr4Y1XTnNv1xuGnAdssPRAxxu3gcdone44fBqvup7sB,JDjFXehdM1oz63wXop6pYpWoB4ptr7Dma8ZhTGH1HzTq,True,239011827375,59752956843,369124171,184562085,184562086,DddJ7EWCmYEEZETCBNgAUSg81Ls6fZtiAaY5ekJ5sXx1,14764966840,71580937355,-56815970515,617
2022-01-05 17:02:27-05:00,1395,CUhCSd7jHvycC89L6EqMoDWcWVTXXHhAeXVyB4362qZg,J7B9JBV1xR8a7DKKrw3JwGusY4H2bSQuyHtod2Fzf4jq,True,19129113,4782278,26486,13243,13243,DddJ7EWCmYEEZETCBNgAUSg81Ls6fZtiAaY5ekJ5sXx1,1059450,4925360,-3865910,553
2022-01-05 17:02:28-05:00,1396,GRve31SsUSCKaBMxgnLDfjWkp3cg6vB7NAZddTxgwmPS,7QjpYFUFhh1njvaevNzwr58ULBrvepXNGZ4LY9YzbKKn,True,876954773,219238693,1192913,596456,596457,4BnQKPLuE3DMTtxp8MjUBytgnhvxqq3ZTqZHTVZo4JJh,47716533,204871759,-157155226,544
2022-01-05 17:02:30-05:00,1397,FtNFtrFpUxLGDP3KTusCxgWMiDqXErcBLzPHVXDwTvNH,FnJfrBQYt9arf1sY3MJn9r8ZWGgjG8mVt5X8pcond5p,True,434904,108723,665,332,333,DddJ7EWCmYEEZETCBNgAUSg81Ls6fZtiAaY5ekJ5sXx1,26612,116180,-89568,611
2022-01-05 17:02:32-05:00,1398,56488NdcUy6Hi6X5SLs2GFtW5pG4u5wJpH7vHdxTCx4z,tGgXjJeVr3W2m3T2NXPCqpBEd6HJKE2cRsgCyiDZQy4,True,232242085,58060520,356615,178307,178308,DddJ7EWCmYEEZETCBNgAUSg81Ls6fZtiAaY5ekJ5sXx1,14264621,82023582,-67758961,614
2022-01-05 17:02:32-05:00,1399,BtnTjb4mghmBK9KnLp2JzyGqfKB8tHskrGL4MzjAdF6V,BLStL7zka6qakHMhY4V6jKJT5agS1LtWMdWBZ1eP1Vi7,True,491187,122795,764,382,382,DddJ7EWCmYEEZETCBNgAUSg81Ls6fZtiAaY5ekJ5sXx1,30562,132392,-101830,622
2022-01-05 17:02:54-05:00,1400,7aKxZg1aoLuB51JUw7fruF77ts7SWoB7pcLBZKHZMynr,AAnbLY82UGULqaDNdyJHrYu7X3hGaBuiTkGWmh8qKTc,True,133769432311,33442358076,206400481,103200240,103200241,72FwbpFGoLEazJEdpqNtPNefsadUrimUqma9wSoy4qiS,8256019246,3547657465,4708361781,617
2022-01-05 17:03:01-05:00,1401,BWtXpiXn1bomr28mGfQFTx1Kd58CQipEnKmeweYowDEC,9jws1qkXvWAdEtBvURVEeGcGJzt4zG2gh8AJESvjKKrx,True,2116301172,529075293,3147280,1573640,1573640,DddJ7EWCmYEEZETCBNgAUSg81Ls6fZtiAaY5ekJ5sXx1,125891230,676240849,-550349619,594
2022-01-05 17:03:16-05:00,1402,6cnA7PeqQgpZdA7jBg4yMzTusm8JJHRWBMup84ywJfYo,FLqcukY7RehqY6ACrwVJnGH3eRgRDe93K1jLYCQN2F3U,True,1588507338,397126834,2444282,1222141,1222141,HfEnetJ7uBSmZWCjBNxdvv9HEC5nsW4wDV7wu6WnhWan,97771311,513818548,-416047237,615
2022-01-05 17:03:33-05:00,1403,7vKmhLV45Q5etXhJL5ng8rxWhYSiUCDmAbGnwBPr7zcx,cP6xPeuHLnjr858QK1F9qYn7rJpEbPy7wEJHoju6oV7,True,687936476,171984119,1067018,533509,533509,HfEnetJ7uBSmZWCjBNxdvv9HEC5nsW4wDV7wu6WnhWan,42680730,150834270,-108153540,620
2022-01-05 17:07:57-05:00,1404,E1wp3bmkcY3eiEYyGYwhTCsr7BZ7RfPa5DJTZFupcFwj,452hVdYkD5SDDrA6hv6DLPFvyS8PvR2P6DPNScGxWTsW,True,12811791,3202947,20029,10014,10015,DddJ7EWCmYEEZETCBNgAUSg81Ls6fZtiAaY5ekJ5sXx1,801196,2987893,-2186697,625
2022-01-05 17:07:57-05:00,1405,A7SMcwnq3DewryUj1jScnAboKGnuDVcW15F3ubNcG66Y,5qLCE37FdeWLCQnkfNJViFMGNcDeiELgE3VgPbBUuDGF,True,365561689,91390422,571348,285674,285674,4BnQKPLuE3DMTtxp8MjUBytgnhvxqq3ZTqZHTVZo4JJh,22853937,104907598,-82053661,625
2022-01-05 17:07:57-05:00,1406,7jvKp6onXyWgwsFrFWj4hYTXJsYYD6ot5mn6rPFuJriy,J7N6HiozevJVTiY9hDEUs2ud5BwT5QSE7wnMBS1w5ie2,True,471168842,117792210,736550,368275,368275,4BnQKPLuE3DMTtxp8MjUBytgnhvxqq3ZTqZHTVZo4JJh,29462038,159066980,-129604942,625
2022-01-05 17:11:39-05:00,1407,FMdKLXhQEnNJtvM17ZX8jhaeMaSD9UgDuN3Kw7kMrd7K,5pURHYWB5LUGwJmWVBGH8p6oyR9NJvXnZk7uDVoiassv,True,69574835,17393708,108846,54423,54423,HfEnetJ7uBSmZWCjBNxdvv9HEC5nsW4wDV7wu6WnhWan,4353848,20755151,-16401303,625
2022-01-05 17:12:27-05:00,1408,DvuRmJkfn6FQczUKgYeaSCqwy2NTMunuAKNrnmxMvnzS,7LpWTX9dgBtW75kfEoB5WuNsDwEdw5s8CYSHh3J4qagM,True,1762659459,440664864,2681105,1340552,1340553,DddJ7EWCmYEEZETCBNgAUSg81Ls6fZtiAaY5ekJ5sXx1,107244238,464370659,-357126421,608
2022-01-05 17:12:32-05:00,1409,EBUcTqh9AYyRokZRzLbPKL9ZmTUx6KcDEbBeuCLGwqYC,B5WSXfHzYQhUFE2T97GaiqSkeejTWKKGVjMkcFrxEvyJ,True,448685464,112171366,685278,342639,342639,HfEnetJ7uBSmZWCjBNxdvv9HEC5nsW4wDV7wu6WnhWan,27411142,120140929,-92729787,610
2022-01-05 17:13:09-05:00,1410,GaEpNGa8jnwSRvjzzEMYkZe1pKcr2eiZtePrqFxpABjB,5CFZHuyWbJv14zPdX5dSQDREgHrCb4vsFvB6hLiEe3Ji,True,2418234,604558,3748,1874,1874,DddJ7EWCmYEEZETCBNgAUSg81Ls6fZtiAaY5ekJ5sXx1,149959,531725,-381766,620
2022-01-05 17:13:09-05:00,1411,AKxRtcdpi7gWhAuL8ENj7zhgeQezzEXe9TSANE6bQoRA,2YH4vrU9deP8Cu6E8Hzf8GqKG1yVjv5pdz4FE7r5YKir,True,108653119,27163279,168048,84024,84024,DddJ7EWCmYEEZETCBNgAUSg81Ls6fZtiAaY5ekJ5sXx1,6721935,23457361,-16735426,618
2022-01-05 17:13:09-05:00,1412,89CkXnSZnr52Zsoh48efv9MQacrkB6GMtrbEpNJSyA2H,HcvRBS4Z22CpYgDNgm4TVF4AVXFDuYzBUAFcdHAwdpg4,True,47587474,11896868,73683,36841,36842,4BnQKPLuE3DMTtxp8MjUBytgnhvxqq3ZTqZHTVZo4JJh,2947351,10294733,-7347382,619
2022-01-05 17:13:53-05:00,1413,Mcbzp1LhZwpfmXTv1pqe9D1jCKHw443j9QKp6tUpzgM,8uforSMAKEih5jHfHp3gCqCvaugtCmhzVfVHA63Akz7F,True,31633885,7908471,49481,24740,24741,DddJ7EWCmYEEZETCBNgAUSg81Ls6fZtiAaY5ekJ5sXx1,1979251,9892246,-7912995,625
2022-01-05 17:13:53-05:00,1414,GJ3PbEfPK8jjrPgMmZtvN5fMSSy2dtiiAtZ8wcfgxVuc,FCUDVFb2TjDvehHE8fVBofqSykpb9W6Afc9QeHtj7te7,True,1216604127,304151031,1881861,940930,940931,DddJ7EWCmYEEZETCBNgAUSg81Ls6fZtiAaY5ekJ5sXx1,75274465,412780991,-337506526,618
2022-01-05 17:13:53-05:00,1415,D3mXrJzhHf8qRaoCKLschUxAFoijFCFuT6bmNZH4W7Cj,9E3Xtqw7TncXWnbhAbFJMtuNmP6WS3ooGuptzyzw7UpA,True,916666,229166,1392,696,696,DddJ7EWCmYEEZETCBNgAUSg81Ls6fZtiAaY5ekJ5sXx1,55711,313595,-257884,607
2022-01-05 17:13:53-05:00,1416,Ar5QB4VBcUyzSCG23z2QNAbrWY55NbHCr1MNN6P2GAmh,BusFGTiDrJmxzwGUxWz9b3SFF3eseqtgh2DRHqyAwyVe,True,7328275,1832068,11172,5586,5586,DddJ7EWCmYEEZETCBNgAUSg81Ls6fZtiAaY5ekJ5sXx1,446901,1735971,-1289070,609
2022-01-05 17:13:54-05:00,1417,2NdwSLxsGok8PczpCZj9CVX2BymNU5MvHt7hWfGetg2M,8AQbDXeA6mD9QoZBFJcYbnHvZwKNxzA9CCHLAgdSfTA3,True,168863,42215,256,128,128,DddJ7EWCmYEEZETCBNgAUSg81Ls6fZtiAaY5ekJ5sXx1,10279,52303,-42024,608
2022-01-05 17:13:54-05:00,1418,EQUZQWk4WLT6LFeWZs3P9AQufFcoZouFETfhyxvuS2JM,Byc2mLXArmkjQPWaxCJksHZD2XpZyCQ2FRtDJyztU81V,True,1506517907,376629476,2306101,1153050,1153051,4BnQKPLuE3DMTtxp8MjUBytgnhvxqq3ZTqZHTVZo4JJh,92244064,516721799,-424477735,612
2022-01-05 17:13:55-05:00,1419,9jdfc9GFTecsdRuTjWFGX13niKKmeBxRgtv5j86uhSnU,HLWMShobjSkaLyXrNjgwVaUGVtbtdUSnr1XjqpXn1bLR,True,4642901,1160725,7166,3583,3583,4BnQKPLuE3DMTtxp8MjUBytgnhvxqq3ZTqZHTVZo4JJh,286664,1198044,-911380,617
2022-01-05 17:13:56-05:00,1420,EV21gv8jEvXtmGDoGRNm5LJEvTBccLMZyVDCLsp54jP3,DGxxoU52aQNoUQcxdvQtv2H5q2PhK6TGkLgNSaFgnZrb,True,70716115,17679028,110170,55085,55085,DddJ7EWCmYEEZETCBNgAUSg81Ls6fZtiAaY5ekJ5sXx1,4406836,16668708,-12261872,623
2022-01-05 17:14:00-05:00,1421,BZxJ6CtrVoiU86DMMieMeDFLNWtMpHGTvZfM7nyay6o4,6CRxRR8bisRLHFJBFWjyumYuy7j4C4PkjYH1K8gXhdWD,True,30440113,7610027,47249,23624,23625,4BnQKPLuE3DMTtxp8MjUBytgnhvxqq3ZTqZHTVZo4JJh,1889971,5449858,-3559887,620
2022-01-05 17:14:00-05:00,1422,5gN3624v6n1zQ1BKtZi1e9ZLpbCa4MEfhgHySFB81Qfm,UXT3oB5ud18rBsygsfxwA93kQYdSNbbzTCjt4gtU2jP,True,9269349,2317336,14376,7188,7188,DddJ7EWCmYEEZETCBNgAUSg81Ls6fZtiAaY5ekJ5sXx1,575063,2738941,-2163878,620
2022-01-05 17:14:02-05:00,1423,4KMzwWHPeW51cxu4nMpbqCaqo96dMqaHWyRCGQktfQfd,F7q4GNYcbnZa8dJ4qovQwjmxpKpdEmdxQMXRPb9nQupa,True,8018814,2004703,12533,6266,6267,DddJ7EWCmYEEZETCBNgAUSg81Ls6fZtiAaY5ekJ5sXx1,501334,2417707,-1916373,625
2022-01-05 17:14:17-05:00,1424,Dn916KSmX3HqxT53hrxrbCrV3tdRMCPdaoiRLqetMrth,ATCXRiXgnjRRUbSTPBvtBXMENCqsViexSZbZ6aDaXXWA,True,13829456,3457363,21199,10599,10600,HfEnetJ7uBSmZWCjBNxdvv9HEC5nsW4wDV7wu6WnhWan,847962,3883597,-3035635,613
2022-01-05 17:14:21-05:00,1425,6NJFN855M3Q3RLTDNo57gTgAmwPD6G2E3WvMb1m5eNCN,3YpqNnonsvXaRT4nCC3G5FZx1jjVtbDPc36LiR6WK5jR,True,1561074354,390268588,2438270,1219135,1219135,4BnQKPLuE3DMTtxp8MjUBytgnhvxqq3ZTqZHTVZo4JJh,97530800,516836344,-419305544,624
2022-01-05 17:14:42-05:00,1426,8BTja7VnFPe6M9BHTqg5LTpX6vd4ugTeWLzpq3oFP8WM,pscjH4sPnNL6zQBmvHjEEbix6BTstnsrSwGysNWyPkd,True,317444,79360,491,245,246,HfEnetJ7uBSmZWCjBNxdvv9HEC5nsW4wDV7wu6WnhWan,19660,90995,-71335,619
2022-01-05 17:14:45-05:00,1427,7LRBswSEDBjJzQ4YurfTxLydh7tFS2jVn5V95Z6wL7ci,fD41VYGmk66MW46KKb23vAqQvUSDScgXnVdsHhJBZzu,True,1865609,466402,2884,1442,1442,DddJ7EWCmYEEZETCBNgAUSg81Ls6fZtiAaY5ekJ5sXx1,115369,527890,-412521,618
2022-01-05 17:14:45-05:00,1428,2PHDkmat5jQ65XkJYhDSw6ZwHcKpSw85o8MaPFhfLBry,8NtkXoUPt4wkcqQJuPJYt5oq9hG4BdeY26dQrsybDWWX,True,178387979,44596994,278070,139035,139035,4BnQKPLuE3DMTtxp8MjUBytgnhvxqq3ZTqZHTVZo4JJh,11122813,41989793,-30866980,623
2022-01-05 17:14:45-05:00,1429,5hUZ9uQFcYnjAQVVaGLJWdKyg7y1XMpoo8osQ9DeY7Xd,BdYiKWsjuzJLcHh3814mJ4xQ9JxoQKKcr7AHZ7Vxoavq,True,642273,160568,1001,500,501,4BnQKPLuE3DMTtxp8MjUBytgnhvxqq3ZTqZHTVZo4JJh,40065,147677,-107612,623
2022-01-05 17:14:46-05:00,1430,8eTH6eJyyVeMno3UQkffeBg32xofKsQfkhLhXdtaf87s,BCFC7CPXrQPsUfJb2eYSht8GhaApWHpc49AeCXqaYq13,True,8047432,2011858,12392,6196,6196,4BnQKPLuE3DMTtxp8MjUBytgnhvxqq3ZTqZHTVZo4JJh,495694,2358395,-1862701,615
2022-01-05 17:14:51-05:00,1431,8VT2nxz5ZYDJFd9uL2XZwEXxChd9pjuMJNMAcutZubL1,EhAkiRbouzUAWtqQFsN8HEEfi46UVN8H8tyBP7CbgeLe,True,145254,36313,224,112,112,4BnQKPLuE3DMTtxp8MjUBytgnhvxqq3ZTqZHTVZo4JJh,8963,38944,-29981,617
2022-01-05 17:14:58-05:00,1432,Gbxc51WERLLeCtiHv7rDvE52aqF541RoQWG5n5aqErq6,4ngBoHbfXijLMqGKxFMNht9sbmxy2g5eqBmn8QsBmbx1,True,8034567,2008641,12505,6252,6253,DddJ7EWCmYEEZETCBNgAUSg81Ls6fZtiAaY5ekJ5sXx1,500233,2438389,-1938156,622
2022-01-05 17:14:59-05:00,1433,7bnCuBLXnPS3wDBunrzoV5qm1GwfnPfRBwV2f9Xzo3Aj,9Xd7GNcFrx7z66DRW8kK3d1jN4tzuiwv9jyDFbHUx9vW,True,323564,80889,503,251,252,DddJ7EWCmYEEZETCBNgAUSg81Ls6fZtiAaY5ekJ5sXx1,20137,93729,-73592,622
2022-01-05 17:15:00-05:00,1434,FoYrQCyDQ75YMNvkgTULbVHYmdrsoFJHohBLPfeF5rEH,DUyVhESZMDUS6Rqsz92CnW2KbWzAs6soEzZqD59XAKzY,True,193690894,48422723,301672,150836,150836,DddJ7EWCmYEEZETCBNgAUSg81Ls6fZtiAaY5ekJ5sXx1,12066898,63602236,-51535338,622
2022-01-05 17:15:07-05:00,1435,D58t4uTjFumsUeYFaKnpV8BRTEQEqKXBreFTdwGrott7,67p6kHDfVqQijfcwugvZK59c3aRRH9x3eHxruqH8WEqF,True,8013714,2003427,12386,6193,6193,HfEnetJ7uBSmZWCjBNxdvv9HEC5nsW4wDV7wu6WnhWan,495461,2419445,-1923984,618
2022-01-05 17:15:12-05:00,1436,EgU9hX6VK7YXeCgCHVaJAMekCcyZa2MVWdKra5pN7Gwv,7y8Ad9XY34bqREvheXHT2tr8Jy11D6X3pu7yLVtjU4QV,True,144425360,36106340,225361,112680,112681,HfEnetJ7uBSmZWCjBNxdvv9HEC5nsW4wDV7wu6WnhWan,9014444,41383904,-32369460,624
2022-01-05 17:15:12-05:00,1437,Buioe5v3DyFwD9nquW5XdYeVYbSABCyg79eUHEvtvfaW,7T9gi7prCcZJkYJMSB5Ef6Bu4pAuBw4XLvumSFnqKDSi,True,10314547,2578636,15936,7968,7968,HfEnetJ7uBSmZWCjBNxdvv9HEC5nsW4wDV7wu6WnhWan,637461,3475465,-2838004,618
2022-01-05 17:15:16-05:00,1438,CFFpbRxYEP18rqEGxxyG3bzSV13Lv7nfSmZvtUK17kCP,824UwqH2JcFsqYBk9MZ8tTnpka9udTL6WGX35YFtAJQk,True,56096239,14024059,86532,43266,43266,4BnQKPLuE3DMTtxp8MjUBytgnhvxqq3ZTqZHTVZo4JJh,3461307,12119142,-8657835,617
2022-01-05 17:15:27-05:00,1439,3g1debT8Z2efQPuMNSDPUNZzDqarBG2acErsZ4HP7QGA,42wDHagxr5Nno3mUx6kyYGDjwR98aedRbh3ByB468agB,True,275704,68926,429,214,215,DddJ7EWCmYEEZETCBNgAUSg81Ls6fZtiAaY5ekJ5sXx1,17188,60173,-42985,623
2022-01-05 17:15:54-05:00,1440,ASrkgcVQ9iMDvTbji6xdpzXU4G4hRNhZ4BzseVxGjDnp,3N8MqUxgfh6T7MQu3JQqYUHDiUYSy5AnXY1SmSMmpdBo,True,6694017710,1673504427,10309163,5154581,5154582,DddJ7EWCmYEEZETCBNgAUSg81Ls6fZtiAaY5ekJ5sXx1,412366552,1626997115,-1214630563,616
2022-01-05 17:16:12-05:00,1441,9WJBnVi84E926j7xEd566WzrZJkPJWRgmEnYj9vyjuad,4dLaFS5F7TGyLdwuJLMGkz3bSL53aHzd9ZfpNmhHxXeF,True,314477377,78619344,486704,243352,243352,HfEnetJ7uBSmZWCjBNxdvv9HEC5nsW4wDV7wu6WnhWan,19468180,88418904,-68950724,619
2022-01-05 17:16:16-05:00,1442,HdfQweV1KuYSpWdycZbpGrUc8yMcY3ZczLn1agKXMJaf,G1Ae1PZHkANkwFnhUKS1tvdFEv8dAFeojBkezh6rUNMh,True,109351636,27337908,164239,82119,82120,72FwbpFGoLEazJEdpqNtPNefsadUrimUqma9wSoy4qiS,6569576,28598470,-22028894,600
2022-01-05 17:16:19-05:00,1443,8swGZMrPrLAxZd7MxTbkCL13k3DmAJUw41jCp6Xo6awW,3fKnX7yTNXAT4uMmXVdTy47ALJT8h8YSD3WiBb4BGuzH,True,4735423201,1183855800,7021313,3510656,3510657,4BnQKPLuE3DMTtxp8MjUBytgnhvxqq3ZTqZHTVZo4JJh,280852558,1046608376,-765755818,593
2022-01-05 17:16:20-05:00,1444,Cv5oVktxmqbU1SxraxH67NEWMKnjgA18R832Fhe9h74a,Cs7xBD4BDiohyopnaYDDChUtR9vmx7uwot6Qp9beQLzt,True,7025288,1756321,10793,5396,5397,4BnQKPLuE3DMTtxp8MjUBytgnhvxqq3ZTqZHTVZo4JJh,431737,2099383,-1667646,614
2022-01-05 17:16:20-05:00,1445,Dng7By2saPu5TVxcvXidBe71ggBo8tiHkAXPi4kKL1tk,75ufEJmHbLHffphL7tvAXhGyftKLr1z2PXXoB2GGY5fG,True,7498833,1874708,11527,5763,5764,4BnQKPLuE3DMTtxp8MjUBytgnhvxqq3ZTqZHTVZo4JJh,461093,2235142,-1774049,614
2022-01-05 17:16:32-05:00,1446,72L76qDRMK3M7X52zuuB9GVyvFFLDBZwFMpVjWjghXzA,4m2ZVuemUctu1edv4YJVAcjXzKwpbCmBujzoUmLDeA7h,True,8190159,2047539,12716,6358,6358,HfEnetJ7uBSmZWCjBNxdvv9HEC5nsW4wDV7wu6WnhWan,508678,2418123,-1909445,621
2022-01-05 17:17:06-05:00,1447,H6tDNj9cHac223ckAnNfnC4bAJuNLBnf2pFk2iQdMzMP,28UL9dqgayCqCAexScXjdpobYGVDN44SGBVNAfBByk8C,True,972932187,243233046,1482210,741105,741105,4BnQKPLuE3DMTtxp8MjUBytgnhvxqq3ZTqZHTVZo4JJh,59288409,335467334,-276178925,609
2022-01-05 17:17:06-05:00,1448,EEcTbsFTUEifcdbPyjBLkS943daEx1RpR8F3uZxKRZbT,8V3JzDQ1VWYQLas8fxUsWJZZHe4gEmn74RehtUwLw3k5,True,77836480,19459120,118414,59207,59207,4BnQKPLuE3DMTtxp8MjUBytgnhvxqq3ZTqZHTVZo4JJh,4736592,22184153,-17447561,608
2022-01-05 17:17:06-05:00,1449,HhwiZPKZBGa16oVi739s4qtMDMTwzWXc7iwNfX63t2UP,5AnbMbAFKy85yHt5y2M5S38nNkA1vT4ejY5NjGbRNUqn,True,20113212,5028303,31235,15617,15618,4BnQKPLuE3DMTtxp8MjUBytgnhvxqq3ZTqZHTVZo4JJh,1249407,7830489,-6581082,621
2022-01-05 17:17:06-05:00,1450,BxXXWywnC3dSyLPJHt7owfBhgSiBWzkuD3T8hGYLqCH6,4vuwEBXXbXFMPmbJJJRop4FCWGyKR1sXhBc3EWF6MiB8,True,1383642487,345910621,2143378,1071689,1071689,4BnQKPLuE3DMTtxp8MjUBytgnhvxqq3ZTqZHTVZo4JJh,85735155,481100844,-395365689,619
2022-01-05 17:17:06-05:00,1451,7W6ih2ZGXaE6tvuQFUPCvc7NvEJHy7UffgoVX3ZPdLXt,6uQCkeMjEXHBQxE2HD33RM1zyTsSko1fYZA1mWUggJ5B,True,373697,93424,578,289,289,4BnQKPLuE3DMTtxp8MjUBytgnhvxqq3ZTqZHTVZo4JJh,23138,86449,-63311,619
2022-01-05 17:17:06-05:00,1452,ECuu1L4QGdemZ7FjAjVAAxYN6piinweY7Fuk5csVovfT,Amd8WGcpdtB8yoA83R1BUT5uryuqoKbcBexYacbrbGVX,True,44386852,11096713,68402,34201,34201,4BnQKPLuE3DMTtxp8MjUBytgnhvxqq3ZTqZHTVZo4JJh,2736117,8159298,-5423181,616
2022-01-05 17:17:06-05:00,1453,7iUx7JBwqUvPVPeCqMEXQdLccZJmaFYm1DUQiu3ouHa3,3EVZzhRmJnX9ZiBZZo9tenDtMogAyuA1yf2cKzvUWiuu,True,9105198,2276299,14141,7070,7071,4BnQKPLuE3DMTtxp8MjUBytgnhvxqq3ZTqZHTVZo4JJh,565649,2814408,-2248759,621
2022-01-05 17:17:31-05:00,1454,8sneA6wAg6geVDJ1g7YWg4R1PfjuRVzeHp1nUBJinhZa,14i1uWtmcTjrdbg3DSr9vzd5NBnxqsn1A4QdgFBZqeYM,True,1756998,439249,2723,1361,1362,72FwbpFGoLEazJEdpqNtPNefsadUrimUqma9wSoy4qiS,108943,430481,-321538,620
2022-01-05 17:17:33-05:00,1455,6dr65yANjSMmfBeKAuSxG3i16S9vMgF1CQ3zDyzh55Pn,EhrE5QpnshD41S4zPEBy2A5q2Gs2mwUrbHGo6WnT9zDP,True,4853615,1213403,7591,3795,3796,4BnQKPLuE3DMTtxp8MjUBytgnhvxqq3ZTqZHTVZo4JJh,303648,1450033,-1146385,625
2022-01-05 17:17:33-05:00,1456,GH6Q9E1jZPTTp46aDd57UNZPNS2D6PBSwyLL3EHSjGn2,2XvwZXNsrPWx4EfPvhTP933bzCC3SJHDQ8xARfrXdVY9,True,286465379,71616344,442337,221168,221169,4BnQKPLuE3DMTtxp8MjUBytgnhvxqq3ZTqZHTVZo4JJh,17693512,170228133,-152534621,617
2022-01-05 17:17:33-05:00,1457,5PbrpM9kjzF4R2eW2UTcRVXnhqWdRQWHZJXKLN43N8WC,6ip4ocbyHusy8CsVvcrpiRCUp2nq9cY8bHpTcUU3Wztq,True,114884790,28721197,179334,89667,89667,4BnQKPLuE3DMTtxp8MjUBytgnhvxqq3ZTqZHTVZo4JJh,7173362,27275109,-20101747,624
2022-01-05 17:17:37-05:00,1458,5jin5wXjQQ25nGM2ECrCXcg1a95vquh6kM7rMRru6Ke7,EKM657EQ8HWWgf4cssByoYHoXGjFfTspTKXAGmygAPQG,True,545598948,136399737,844872,422436,422436,72FwbpFGoLEazJEdpqNtPNefsadUrimUqma9wSoy4qiS,33794891,156816976,-123022085,619
2022-01-05 17:17:47-05:00,1459,864zY9zuCktUurPTtdGeLvUATnDqHZpT1GeWUApsXh2m,CzatBrNJUi7MeyfbNhszRaPMidgt8Xkcmy5ZwFMP9RCs,True,299740604,74935151,468831,234415,234416,4BnQKPLuE3DMTtxp8MjUBytgnhvxqq3ZTqZHTVZo4JJh,18753262,80594752,-61841490,625
2022-01-05 17:18:42-05:00,1460,F2v1YwVAwXLiUgsJ5uwn4qAAkTXitn1E75fJcPnGuAcy,5rdJ4H5GxPg4Juu77mGc7uya5LwEqLzDSRyG8mQ2mDbK,True,279274225,69818556,435557,217778,217779,4BnQKPLuE3DMTtxp8MjUBytgnhvxqq3ZTqZHTVZo4JJh,17422303,80323866,-62901563,623
2022-01-05 17:18:42-05:00,1461,Hy3kzXneDN6FUkiZctU1vWe97BYvj6yZ7QvQzehfWmNr,EhXgQg8BTniANV525RpY76z7Hrh6DuqrMChjqEoXfVJe,True,13774222,3443555,21430,10715,10715,HfEnetJ7uBSmZWCjBNxdvv9HEC5nsW4wDV7wu6WnhWan,857209,4565325,-3708116,622
2022-01-05 17:18:44-05:00,1462,GGGyesjbt7h2XHHp9u8vpiWGugFwEbrtYaKrNQSDhQd7,8tydo1ZjGHmPBSqU33tywB3f9szdsHk1ckGFe4Ay5pgs,True,730848250,182712062,1115848,557924,557924,4BnQKPLuE3DMTtxp8MjUBytgnhvxqq3ZTqZHTVZo4JJh,44633948,376424320,-331790372,610
2022-01-05 17:18:44-05:00,1463,6eBSLXDMVoW2nG3n7s42RXDH8byY3C6n1RsUuegBLSrG,37dYrKnTXYer7Bu9xFfpArA4ZNo2B9bycFw9HywDtTRx,True,143605832,35901458,222763,111381,111382,4BnQKPLuE3DMTtxp8MjUBytgnhvxqq3ZTqZHTVZo4JJh,8910550,39358976,-30448426,620
2022-01-05 17:18:44-05:00,1464,BWtXpiXn1bomr28mGfQFTx1Kd58CQipEnKmeweYowDEC,9jws1qkXvWAdEtBvURVEeGcGJzt4zG2gh8AJESvjKKrx,True,1561300182,390325045,2420456,1210228,1210228,4BnQKPLuE3DMTtxp8MjUBytgnhvxqq3ZTqZHTVZo4JJh,96818253,535669863,-438851610,620
2022-01-05 17:18:45-05:00,1465,DAku12iueL13vRoTpKLyqdGaLQ2rWF6REe8Dr8soFvNs,H2vVH3LxkhGe6x6Mdwy67BYwTKNQM6XayKx7mhrwyfJM,True,6457406,1614351,9990,4995,4995,72FwbpFGoLEazJEdpqNtPNefsadUrimUqma9wSoy4qiS,399611,1942205,-1542594,618
2022-01-05 17:18:53-05:00,1466,8MKNsuGVaoYpdQy6NNyxDvRzh2DAquBUtri4nDsixUxs,D7M1SDmpZAs8vdPCCCa96UbDF15YQDxHmoGWB57tHiir,True,59935704,14983926,92095,46047,46048,72FwbpFGoLEazJEdpqNtPNefsadUrimUqma9wSoy4qiS,3683825,18717861,-15034036,614
2022-01-05 17:18:55-05:00,1467,3Lv2XpiD4KBUHq7Zx6u3zNhpXoySodXHH8o8f5yaaPxG,H6TN4rhpBXkEH3mZnymYNcKfmnxRH2uzfwzeLH2q6ahP,True,2703963,675990,4156,2078,2078,4BnQKPLuE3DMTtxp8MjUBytgnhvxqq3ZTqZHTVZo4JJh,166265,646950,-480685,614
2022-01-05 17:19:07-05:00,1468,3njiRuSRMXRzKmamyiR72Hc38PU8UDDmWdfPhgxmGxEW,5WoF3gkgygyNNbwxWgVfqGWkExcDixuzgJQQjXEZQ6J5,True,3692772100,923193025,5615791,2807895,2807896,4BnQKPLuE3DMTtxp8MjUBytgnhvxqq3ZTqZHTVZo4JJh,224631659,1692711522,-1468079863,608
2022-01-05 17:19:20-05:00,1469,6cnA7PeqQgpZdA7jBg4yMzTusm8JJHRWBMup84ywJfYo,FLqcukY7RehqY6ACrwVJnGH3eRgRDe93K1jLYCQN2F3U,True,1168186810,292046702,1803333,901666,901667,4BnQKPLuE3DMTtxp8MjUBytgnhvxqq3ZTqZHTVZo4JJh,72133335,407454791,-335321456,617
2022-01-05 17:19:20-05:00,1470,DmEVzPyCKnm89v481V2ic57vyikwwMja75uVZ2rjvjfp,38fPZzP4NwTtx7Qu6DLSqx9Sv8e5CQbSrr2BMvVmSy4J,True,343789755,85947438,533363,266681,266682,72FwbpFGoLEazJEdpqNtPNefsadUrimUqma9wSoy4qiS,21334521,122390513,-101055992,620
2022-01-05 17:19:23-05:00,1471,DMgPzJnMQfvpk6LWscs9V9CwnYDj4CEUgKB9S65WsTaY,BZRSLH1Vw1BQwXTZtBcgUYqmFF7TuzYxAaZ8TXUKwLUQ,True,93391,23347,144,72,72,4BnQKPLuE3DMTtxp8MjUBytgnhvxqq3ZTqZHTVZo4JJh,5788,31918,-26130,619
2022-01-05 17:19:34-05:00,1472,D3o7CSh2zCAQ93BDomDCitZ4vuxC83wGPMwJEEyBJK4C,A4nDfpUZkdtuWRRWZkoNXc5Ux7JU1UJA2JTHgkHAfYyP,True,710192325908,177548081477,1110360150,555180075,555180075,DddJ7EWCmYEEZETCBNgAUSg81Ls6fZtiAaY5ekJ5sXx1,44414406027,93092246258,-48677840231,625
2022-01-05 17:19:39-05:00,1473,CRW3nidAs2C3irLsEMsnffCvcjZH3wMBoKXG8PRp1Ss8,GD2un4iqMrnZ1kKnGLbzaSQy5iKjGSHHDN58tKibtHN3,True,846041738,211510434,1304331,652165,652166,DddJ7EWCmYEEZETCBNgAUSg81Ls6fZtiAaY5ekJ5sXx1,52173259,206131521,-153958262,616
2022-01-05 17:19:39-05:00,1474,2WobKrHvenN7m5ctpit6rEH4F5xUFF59akTQPGvpDG8J,67np4AWjFMWZRuvNnW6tVVQqWfzT9X3nvMaEyn36ityr,False,3431577913,3431577913,141689911,7084495,134605416,DddJ7EWCmYEEZETCBNgAUSg81Ls6fZtiAaY5ekJ5sXx1,141689911,1090222964,-948533053,412
2022-01-05 17:19:39-05:00,1475,Fcr4Y1XTnNv1xuGnAdssPRAxxu3gcdone44fBqvup7sB,JDjFXehdM1oz63wXop6pYpWoB4ptr7Dma8ZhTGH1HzTq,True,173648692884,43412173221,219641625,109820812,109820813,HfEnetJ7uBSmZWCjBNxdvv9HEC5nsW4wDV7wu6WnhWan,8785665021,58997186055,-50211521034,505
2022-01-05 17:19:40-05:00,1476,GWEfWJimTKDJuxSTAb7SxkT3L3FhPPu8wJzYYF8H4SgD,BdeMcj3cMyKVPeF7Mt9Jdpxgzq9P6c79qJR6ctiiDauL,True,529644267,132411066,779363,389681,389682,4BnQKPLuE3DMTtxp8MjUBytgnhvxqq3ZTqZHTVZo4JJh,31174535,132308604,-101134069,588
2022-01-05 17:19:40-05:00,1477,Gs3WP18hbzNpbBgiU39e6tfkggfCKRyNqPqJQcthuHFD,4XAY25YUma6gUdG2GdbXeivum3t21g93ZagfWGTZYkWZ,True,78365401,19591349,118626,59313,59313,DddJ7EWCmYEEZETCBNgAUSg81Ls6fZtiAaY5ekJ5sXx1,4745050,27555562,-22810512,605
2022-01-05 17:19:40-05:00,1478,7g3w8AzDms9SfbLDmgaH12toMFUHUd3Stx5c8KebUKxm,12wPjZucRWRH1nEBju4J1D9iAc93H1dDQtcEJzYRbZVN,False,32181128,32181128,891084,44554,846530,DddJ7EWCmYEEZETCBNgAUSg81Ls6fZtiAaY5ekJ5sXx1,891084,8414956,-7523872,276
2022-01-05 17:19:40-05:00,1479,FT8vMZ46cTViEsKNLGWKCiLxW74XZaEaT9tZSYyhnoj4,C6KGHMjDtokQubok3Cve2WGVA2jo8RZfuFdSEunp7PYK,False,1943487524,1943487524,41379347,2068967,39310380,4BnQKPLuE3DMTtxp8MjUBytgnhvxqq3ZTqZHTVZo4JJh,41379347,516651277,-475271930,212
2022-01-05 17:19:40-05:00,1480,872kcnRQ6wXcqDyqveM7qfuzhpKUtvzbX6E8gjYStB8H,4sZWxT7Lgr6WsAGFXSRKi7iTcX9iCYzmLQaPBQdgxtWC,False,25657282300,25657282300,1201827580,60091379,1141736201,4BnQKPLuE3DMTtxp8MjUBytgnhvxqq3ZTqZHTVZo4JJh,1201827580,6207958726,-5006131146,468
2022-01-05 17:19:40-05:00,1481,J1sBDjpdBZcsSBS5eg95SSRjRqmQUR9cXJCsLJu8yCUt,F5wRpD2senMkGbL8Uquqo8W9x5NQDDa268dHuVFAZCww,True,15380814,3845203,23958,11979,11979,4BnQKPLuE3DMTtxp8MjUBytgnhvxqq3ZTqZHTVZo4JJh,958358,5860476,-4902118,623
2022-01-05 17:19:40-05:00,1482,7LBZi7Ec4VKhtNJbFQYYY8CvFbsLPCvqmn8Rd5EVhn9n,CBgkKDhmsEa8Ug8nE9Yu95gLDbDQa9FNGpdjVRfEDXcq,True,639235314,159808828,965406,482703,482703,4BnQKPLuE3DMTtxp8MjUBytgnhvxqq3ZTqZHTVZo4JJh,38616266,178187074,-139570808,604
2022-01-05 17:19:40-05:00,1483,EYt1Pzqfwnd4iXSmcpw4T3Edmm1y3GnRhCjcQEEK4Atj,EHqporfvvfg7UQPsjv5tsgZE8u9yyRuEU2DdLpQeXy85,False,40197624388,40197624388,902998671,45149933,857848738,4BnQKPLuE3DMTtxp8MjUBytgnhvxqq3ZTqZHTVZo4JJh,902998671,9739572291,-8836573620,224
2022-01-05 17:19:40-05:00,1484,56488NdcUy6Hi6X5SLs2GFtW5pG4u5wJpH7vHdxTCx4z,tGgXjJeVr3W2m3T2NXPCqpBEd6HJKE2cRsgCyiDZQy4,True,169353636,42338408,227001,113500,113501,4BnQKPLuE3DMTtxp8MjUBytgnhvxqq3ZTqZHTVZo4JJh,9080077,64727810,-55647733,536
2022-01-05 17:19:40-05:00,1485,BAzH5niE2GX9CHGn3jK6Wv8Dd59PT95dX4dgfZXWoLPT,YNRnuEoNBPFsr7W91gc85TXAdA4ZnXfF2x951zbeRKF,True,324367,81090,448,224,224,4BnQKPLuE3DMTtxp8MjUBytgnhvxqq3ZTqZHTVZo4JJh,17924,94327,-76403,552
2022-01-05 17:19:40-05:00,1486,7mYQ2DJZ1YYMpNbpA93hCDtzQDhEHjAGxLJt2g4KeYTW,8nTKeruC3wiPjT7VytdM2gX7msjwbHxTkyhsR88GJgpc,True,154826447,38706611,206964,103482,103482,4BnQKPLuE3DMTtxp8MjUBytgnhvxqq3ZTqZHTVZo4JJh,8278565,37202725,-28924160,534
2022-01-05 17:19:40-05:00,1487,GKNBtZbwK4w9hyXD1r38NTGcTJhpjt8R9WFCzdXup9Tk,7RLaL2XoFuqrcCcPEB6FzPJzLnAhjQpwcRmDfdpRXFgB,True,144916270,36229067,202948,101474,101474,4BnQKPLuE3DMTtxp8MjUBytgnhvxqq3ZTqZHTVZo4JJh,8117941,53300943,-45183002,560
2022-01-05 17:19:40-05:00,1488,BhiAaiZu7fF8ndggJrLyiFVCRq526cNBw7VaeascEmNL,4en8MipPi7vq15NGhpPMQfptNdEyhp2j7fpgxBBtjyfz,True,6880537,1720133,9624,4812,4812,4BnQKPLuE3DMTtxp8MjUBytgnhvxqq3ZTqZHTVZo4JJh,384978,2021668,-1636690,559
2022-01-05 17:19:40-05:00,1489,FiEP5hTUpXeQadRim55G4Xfzht8KZQG8WpTuzLX4x5rD,GqXWAjECWr1X29tDHK1Pj3s9ecRXXXNrbaWmMYHCp5Pj,False,35000765,35000765,915329,45766,869563,4BnQKPLuE3DMTtxp8MjUBytgnhvxqq3ZTqZHTVZo4JJh,915329,9905764,-8990435,261
2022-01-05 17:19:40-05:00,1490,2YcB3QQGWho5oogDd1nK3cpLQzwwwXGxybrhe2xDkDxq,5DjAUp6CxKStYTaXSnzjvYkfqCXfG8Y61bWw5UwbbE3q,True,22711522,5677880,34344,17172,17172,4BnQKPLuE3DMTtxp8MjUBytgnhvxqq3ZTqZHTVZo4JJh,1373769,8576863,-7203094,604
2022-01-05 17:19:41-05:00,1491,CRW3nidAs2C3irLsEMsnffCvcjZH3wMBoKXG8PRp1Ss8,GD2un4iqMrnZ1kKnGLbzaSQy5iKjGSHHDN58tKibtHN3,True,614710588,153677647,776205,388102,388103,DddJ7EWCmYEEZETCBNgAUSg81Ls6fZtiAaY5ekJ5sXx1,31048212,166361803,-135313591,505
2022-01-05 17:19:41-05:00,1492,DGbj8tnqECzM9FG8j225Ap7A4Fdm3J1Ksm32JBFG7igv,Cd3D2UVwoSZLygM2e3UQppQANsokpmx5CNBs1C5zueay,True,7273381,1818344,10038,5019,5019,4BnQKPLuE3DMTtxp8MjUBytgnhvxqq3ZTqZHTVZo4JJh,401545,2143136,-1741591,552
2022-01-05 17:19:41-05:00,1493,CUhCSd7jHvycC89L6EqMoDWcWVTXXHhAeXVyB4362qZg,J7B9JBV1xR8a7DKKrw3JwGusY4H2bSQuyHtod2Fzf4jq,False,13472314,13472314,158443,7922,150521,4BnQKPLuE3DMTtxp8MjUBytgnhvxqq3ZTqZHTVZo4JJh,158443,3932410,-3773967,117
2022-01-05 17:19:41-05:00,1494,4gzW9gBbEMnNm1epY6MMJ1XfxGMtvn2mKFyKPQ2Gyb79,G6x862hmMJ2PLpyyPDwVPGapXjvEeNkqFRTAS3jWVozB,True,34578525,8644631,51345,25672,25673,DddJ7EWCmYEEZETCBNgAUSg81Ls6fZtiAaY5ekJ5sXx1,2053801,13137465,-11083664,593
2022-01-05 17:19:41-05:00,1495,gMjmD7WioyUdQdwNqE5fobLcxPwoJv5rAvLmJaf8Jjw,5n77euFjVJiwKrnbYq1KpcENW1mzBZj2BuDGyzazrkJ8,True,7224364,1806090,10956,5478,5478,4BnQKPLuE3DMTtxp8MjUBytgnhvxqq3ZTqZHTVZo4JJh,438272,2201327,-1763055,606
2022-01-05 17:19:41-05:00,1496,HAk9c831TRUhvpoK4d7PTqfJuJhSjnJUXWpnYsH85bDJ,DVSa3CJrVLTHAeFYjEF89ZjWRm86QwruUk2Y8RvGpjsr,True,346469,86616,455,227,228,4BnQKPLuE3DMTtxp8MjUBytgnhvxqq3ZTqZHTVZo4JJh,18234,99862,-81628,526
2022-01-05 17:19:41-05:00,1497,GRve31SsUSCKaBMxgnLDfjWkp3cg6vB7NAZddTxgwmPS,7QjpYFUFhh1njvaevNzwr58ULBrvepXNGZ4LY9YzbKKn,False,617664461,617664461,6472001,323600,6148401,4BnQKPLuE3DMTtxp8MjUBytgnhvxqq3ZTqZHTVZo4JJh,6472001,164415557,-157943556,104
2022-01-05 17:19:41-05:00,1498,Br1j5Ftafei7ysu5SmqVZSoRe4uS4qCPeKSPHg55pyiE,G8fc7QvXjfkgBFvAVUgJFQS3VaF1biL9rktBExGa87Ks,True,21888498515,5472124628,27685442,13842721,13842721,4BnQKPLuE3DMTtxp8MjUBytgnhvxqq3ZTqZHTVZo4JJh,1107417705,5723546585,-4616128880,505
2022-01-05 17:19:41-05:00,1499,DQpBbEYdqr6p17dbdej27TyK1feB7QRS79zBpWqDQmUC,Dk2kdrACai34GffFLvRPJkXDTovoHJ4BPpSbS3ghKU4g,False,34012267,34012267,1029129,51456,977673,4BnQKPLuE3DMTtxp8MjUBytgnhvxqq3ZTqZHTVZo4JJh,1029129,9908262,-8879133,302
2022-01-05 17:19:41-05:00,1500,Fcr4Y1XTnNv1xuGnAdssPRAxxu3gcdone44fBqvup7sB,JDjFXehdM1oz63wXop6pYpWoB4ptr7Dma8ZhTGH1HzTq,False,127935759767,127935759767,6265263500,313263175,5952000325,HfEnetJ7uBSmZWCjBNxdvv9HEC5nsW4wDV7wu6WnhWan,6265263500,47343553743,-41078290243,489
2022-01-05 17:19:41-05:00,1501,7aKxZg1aoLuB51JUw7fruF77ts7SWoB7pcLBZKHZMynr,AAnbLY82UGULqaDNdyJHrYu7X3hGaBuiTkGWmh8qKTc,False,95882732961,95882732961,3605277491,180263874,3425013617,4BnQKPLuE3DMTtxp8MjUBytgnhvxqq3ZTqZHTVZo4JJh,3605277491,4667640578,-1062363087,376
2022-01-05 17:19:48-05:00,1502,FMdKLXhQEnNJtvM17ZX8jhaeMaSD9UgDuN3Kw7kMrd7K,5pURHYWB5LUGwJmWVBGH8p6oyR9NJvXnZk7uDVoiassv,False,50344042,50344042,2407917,120395,2287522,4BnQKPLuE3DMTtxp8MjUBytgnhvxqq3ZTqZHTVZo4JJh,2407917,16546154,-14138237,478
2022-01-05 17:19:48-05:00,1503,EBUcTqh9AYyRokZRzLbPKL9ZmTUx6KcDEbBeuCLGwqYC,B5WSXfHzYQhUFE2T97GaiqSkeejTWKKGVjMkcFrxEvyJ,False,326053547,326053547,16265313,813265,15452048,HfEnetJ7uBSmZWCjBNxdvv9HEC5nsW4wDV7wu6WnhWan,16265313,96280270,-80014957,498
2022-01-05 17:19:50-05:00,1504,ANQkPUoMjLHyRtypeKzxsKW1DFauQsh9SnB3rRgRXM1Y,7RHAExWpG8Q3PXwKhJs2yXmYK9WogGydvFYpx28p6pgr,True,1049698154,262424538,1613518,806759,806759,4BnQKPLuE3DMTtxp8MjUBytgnhvxqq3ZTqZHTVZo4JJh,64540726,379444388,-314903662,614
2022-01-05 17:19:50-05:00,1505,G25vsB3sDqRhHoSK4KwR1TywfrJDtpejVbbevEG9sQ9a,5xFC3Hm13magnAA9GD1EnwC9PrPoEfQ7omEa9p9zCrB1,True,9805469,2451367,14811,7405,7406,72FwbpFGoLEazJEdpqNtPNefsadUrimUqma9wSoy4qiS,592449,2803688,-2211239,604
2022-01-05 17:19:50-05:00,1506,6yw4GPvkqUbakcEWtqSCfjVLukty11xqjDpGxtEN9Km2,5ppEx7wkpqbG5nApCWMdRja3oRSheFmAAsNHUX7h2w2Y,True,23877924,5969481,36677,18338,18339,HfEnetJ7uBSmZWCjBNxdvv9HEC5nsW4wDV7wu6WnhWan,1467091,14874495,-13407404,614
2022-01-05 17:19:50-05:00,1507,EanSXRkJu91FKUhPCzYxWkmM3PQUWcovEnoZXcd6vQ9E,Fg4EzAzHStoLRDPmoBUczdWnWrhAb7jKEujqAujLFT8,True,2908842872,727210718,3694538,1847269,1847269,4BnQKPLuE3DMTtxp8MjUBytgnhvxqq3ZTqZHTVZo4JJh,147781552,696078680,-548297128,508
2022-01-05 17:19:50-05:00,1508,2VyFcgZDH1HTEvD1XaWhwqBCMmZ1k6TmZ3fEpPcBZR9E,G1wFJETTpdoc7CfypGCzkq1jssXPfUkiuLjK2cwVZ9dJ,True,1165576,291393,1809,904,905,DddJ7EWCmYEEZETCBNgAUSg81Ls6fZtiAaY5ekJ5sXx1,72378,351386,-279008,620
2022-01-05 17:19:51-05:00,1509,gHv15388BYFZ6PS2p7XTvT9QViJ1rjevHdykD6Pmvzh,9YZPTB6d7St4TPpMY2vP4rZ56B2ZvzViB1DLWbPLK1hn,False,333917622,333917622,16077161,803858,15273303,DddJ7EWCmYEEZETCBNgAUSg81Ls6fZtiAaY5ekJ5sXx1,16077161,129968924,-113891763,481
2022-01-05 17:19:58-05:00,1510,EmGW2aAG69ssWqCtbfDocRaM2u3TJsczn2HHP9jdmRvD,aypkDKsp9uqAB4F6mwvm5LofpsrFBuZT2MMWtE2eHdB,True,9335504,2333876,14321,7160,7161,DddJ7EWCmYEEZETCBNgAUSg81Ls6fZtiAaY5ekJ5sXx1,572866,2486230,-1913364,613
2022-01-05 17:19:58-05:00,1511,BWtXpiXn1bomr28mGfQFTx1Kd58CQipEnKmeweYowDEC,9jws1qkXvWAdEtBvURVEeGcGJzt4zG2gh8AJESvjKKrx,True,1148168821,287042205,1789787,894893,894894,4BnQKPLuE3DMTtxp8MjUBytgnhvxqq3ZTqZHTVZo4JJh,71591481,423627844,-352036363,623
2022-01-05 17:20:00-05:00,1512,64nf6XvL2L7Tx4vZJkAsATE66fiDvgueHryriiesW3JF,2mXMvWYphTBSo1TJY7HJ5UM62r5q6t8bVmh6TMybCh2A,False,410292929,410292929,3860217,193010,3667207,4BnQKPLuE3DMTtxp8MjUBytgnhvxqq3ZTqZHTVZo4JJh,3860217,102578447,-98718230,94
2022-01-05 17:20:00-05:00,1513,GjQQ2fQ7mrGjWZwjVYFUKp9NM1LmfkhEo675ovU5SPa8,ECgVUMRY5nB4MALs5drDyipF7YohCPuJpj2UegCs7HMn,True,240230133,60057533,325473,162736,162737,4BnQKPLuE3DMTtxp8MjUBytgnhvxqq3ZTqZHTVZo4JJh,13018954,57677700,-44658746,541
2022-01-05 17:20:00-05:00,1514,864zY9zuCktUurPTtdGeLvUATnDqHZpT1GeWUApsXh2m,CzatBrNJUi7MeyfbNhszRaPMidgt8Xkcmy5ZwFMP9RCs,True,219916266,54979066,334881,167440,167441,4BnQKPLuE3DMTtxp8MjUBytgnhvxqq3ZTqZHTVZo4JJh,13395244,64668716,-51273472,609
2022-01-05 17:20:00-05:00,1515,A7eQLoPeQjr2e5KThoPuXEps8n1vrGxtwT72ynXY1NDn,EBSWSXy8cqYwTB6hW44C4SLUzeFE2xPSRMLfgk3pseey,False,27402788,27402788,0,0,0,4BnQKPLuE3DMTtxp8MjUBytgnhvxqq3ZTqZHTVZo4JJh,0,8822417,-8901012,0
2022-01-05 17:20:00-05:00,1516,FtNFtrFpUxLGDP3KTusCxgWMiDqXErcBLzPHVXDwTvNH,FnJfrBQYt9arf1sY3MJn9r8ZWGgjG8mVt5X8pcond5p,False,314753,314753,14519,725,13794,4BnQKPLuE3DMTtxp8MjUBytgnhvxqq3ZTqZHTVZo4JJh,14519,93127,-78608,461
2022-01-05 17:20:00-05:00,1517,CRW3nidAs2C3irLsEMsnffCvcjZH3wMBoKXG8PRp1Ss8,GD2un4iqMrnZ1kKnGLbzaSQy5iKjGSHHDN58tKibtHN3,False,439491354,439491354,8730420,436521,8293899,4BnQKPLuE3DMTtxp8MjUBytgnhvxqq3ZTqZHTVZo4JJh,8730420,131770588,-123040168,198
2022-01-05 17:20:03-05:00,1518,6uRrd6hWqGFtttnEnTPqxLCbnr77hjXVSx91RLWLJXiu,By4VK3CoUmszYoUhLHctHSvh7NYJ2hmuwT81pqzzbgr3,False,1184583158,1184583158,0,0,0,DddJ7EWCmYEEZETCBNgAUSg81Ls6fZtiAaY5ekJ5sXx1,0,328240275,-341155349,0
2022-01-05 17:20:05-05:00,1519,8RmB8o4zux2sD48dEsKpsX475KRxTwdk8QULUDU9xx8R,AKSiZnb4YKVB6B86aPPqvyXquhvN9xqt45bexBCZ7nx,True,915924295,228981073,1402238,701119,701119,4BnQKPLuE3DMTtxp8MjUBytgnhvxqq3ZTqZHTVZo4JJh,56089538,324937562,-268848024,612
2022-01-05 17:20:05-05:00,1520,8BTja7VnFPe6M9BHTqg5LTpX6vd4ugTeWLzpq3oFP8WM,pscjH4sPnNL6zQBmvHjEEbix6BTstnsrSwGysNWyPkd,True,230712,57676,294,147,147,72FwbpFGoLEazJEdpqNtPNefsadUrimUqma9wSoy4qiS,11797,72673,-60876,511
2022-01-05 17:20:05-05:00,1521,DvuRmJkfn6FQczUKgYeaSCqwy2NTMunuAKNrnmxMvnzS,7LpWTX9dgBtW75kfEoB5WuNsDwEdw5s8CYSHh3J4qagM,True,1282049328,320512332,1615446,807723,807723,HfEnetJ7uBSmZWCjBNxdvv9HEC5nsW4wDV7wu6WnhWan,64617866,372516607,-307898741,504
2022-01-05 17:20:05-05:00,1522,C9JiT1sQhakzmJuCPfGDq2RV2HjMtCW8CBXVp9shKSuG,4ko8VYv8RafkXbe9FqZrBDbBdF73EgUphzctWr8RrhQQ,False,2974517992,2974517992,0,0,0,HfEnetJ7uBSmZWCjBNxdvv9HEC5nsW4wDV7wu6WnhWan,0,998755073,-1025085374,0
2022-01-05 17:20:06-05:00,1523,8NdcaYUC1X5CP7FMDip78uqtqmCt8GcZdCzLRTYTihmb,9Ei1K9bXWXSXcBfeX5exPSXGCAu62WSKzvnnd4wHvyVh,True,1899367,474841,2900,1450,1450,HfEnetJ7uBSmZWCjBNxdvv9HEC5nsW4wDV7wu6WnhWan,116037,466248,-350211,610
2022-01-05 17:20:06-05:00,1524,2FrqGFZjbiNykJyo9BZ5S9FguQJPJiTi681rJJsQ5dta,3QUncYP92NKrfpaTvuF9iQg11PXKgZAgEngwh6BbnCCj,True,11940751,2985187,18234,9117,9117,4BnQKPLuE3DMTtxp8MjUBytgnhvxqq3ZTqZHTVZo4JJh,729382,2674518,-1945136,610
2022-01-05 17:20:06-05:00,1525,DLfNhCzgrUtFAFLWYyRNUBTmai8gDrfASodiRQ8cZcen,8LGumRJeVJrhfnRdNCVw46ZpPASDopYcLCCHd5Fncspb,False,538496004,538496004,420806,21040,399766,DddJ7EWCmYEEZETCBNgAUSg81Ls6fZtiAaY5ekJ5sXx1,420806,196898877,-196478071,7
2022-01-05 17:20:06-05:00,1526,HJ7BVAfDebv4BdidspqFq6xZrHHfGkjXFBXorjFHxc83,Btpv3KPy1quhFZGconD7sLA8pR9z9wTKivq154bcw9AQ,False,29467996,29467996,643863,32193,611670,DddJ7EWCmYEEZETCBNgAUSg81Ls6fZtiAaY5ekJ5sXx1,643863,4705361,-4061498,218
2022-01-05 17:20:06-05:00,1527,BAzH5niE2GX9CHGn3jK6Wv8Dd59PT95dX4dgfZXWoLPT,YNRnuEoNBPFsr7W91gc85TXAdA4ZnXfF2x951zbeRKF,True,240551,60136,368,184,184,HfEnetJ7uBSmZWCjBNxdvv9HEC5nsW4wDV7wu6WnhWan,14750,74783,-60033,613
2022-01-05 17:20:06-05:00,1528,7bnCuBLXnPS3wDBunrzoV5qm1GwfnPfRBwV2f9Xzo3Aj,9Xd7GNcFrx7z66DRW8kK3d1jN4tzuiwv9jyDFbHUx9vW,True,234885,58719,296,148,148,HfEnetJ7uBSmZWCjBNxdvv9HEC5nsW4wDV7wu6WnhWan,11844,74832,-62988,504
2022-01-05 17:20:06-05:00,1529,82UCLECeKk9tWXQgt5cyQGNT3FQc841dCmQeLUv8wp58,47aXWsk5kkVwmcQh9cc8vhxYin3BuGWtr8eQ1H8Tehcj,False,598407,598407,24410,1220,23190,DddJ7EWCmYEEZETCBNgAUSg81Ls6fZtiAaY5ekJ5sXx1,24410,145267,-120857,407
2022-01-05 17:20:06-05:00,1530,FuoFPNTdYVDkSHaBac6UC1aNJXafSNTvFJuBCdrgQQrH,ApBS1Fx83tcECMzDV6wEzEzEdg4e2hgj3djtjRUoSKK5,True,4145932199,1036483049,5912043,2956021,2956022,4BnQKPLuE3DMTtxp8MjUBytgnhvxqq3ZTqZHTVZo4JJh,236481735,956484902,-720003167,570
2022-01-05 17:20:09-05:00,1531,D3o7CSh2zCAQ93BDomDCitZ4vuxC83wGPMwJEEyBJK4C,A4nDfpUZkdtuWRRWZkoNXc5Ux7JU1UJA2JTHgkHAfYyP,False,511304531765,511304531765,21964333211,1098216660,20866116551,HfEnetJ7uBSmZWCjBNxdvv9HEC5nsW4wDV7wu6WnhWan,21964333211,85565707593,-63601374382,429
2022-01-05 17:20:16-05:00,1532,J1sBDjpdBZcsSBS5eg95SSRjRqmQUR9cXJCsLJu8yCUt,F5wRpD2senMkGbL8Uquqo8W9x5NQDDa268dHuVFAZCww,True,11221588,2805397,15509,7754,7755,DddJ7EWCmYEEZETCBNgAUSg81Ls6fZtiAaY5ekJ5sXx1,620377,4610993,-3990616,552
2022-01-05 17:20:16-05:00,1533,G25vsB3sDqRhHoSK4KwR1TywfrJDtpejVbbevEG9sQ9a,5xFC3Hm13magnAA9GD1EnwC9PrPoEfQ7omEa9p9zCrB1,True,7162655,1790663,9654,4827,4827,4BnQKPLuE3DMTtxp8MjUBytgnhvxqq3ZTqZHTVZo4JJh,386191,2236070,-1849879,539
2022-01-05 17:20:16-05:00,1534,BhiAaiZu7fF8ndggJrLyiFVCRq526cNBw7VaeascEmNL,4en8MipPi7vq15NGhpPMQfptNdEyhp2j7fpgxBBtjyfz,True,5042346,1260585,6432,3216,3216,DddJ7EWCmYEEZETCBNgAUSg81Ls6fZtiAaY5ekJ5sXx1,257296,1602874,-1345578,510
2022-01-05 17:20:17-05:00,1535,GWEfWJimTKDJuxSTAb7SxkT3L3FhPPu8wJzYYF8H4SgD,BdeMcj3cMyKVPeF7Mt9Jdpxgzq9P6c79qJR6ctiiDauL,True,386446317,96611579,490207,245103,245104,HfEnetJ7uBSmZWCjBNxdvv9HEC5nsW4wDV7wu6WnhWan,19608288,106249677,-86641389,507
2022-01-05 17:20:19-05:00,1536,DH2tcZVt4nHQbph6znZRrwcyhjwiNYtgeamu72vcC6nR,ACsbP5BDFQEHQHTsdrWTBShhEUh9HeAKsE7iwyK72v2p,False,3928294,3928294,165746,8287,157459,4BnQKPLuE3DMTtxp8MjUBytgnhvxqq3ZTqZHTVZo4JJh,165746,1578243,-1412497,421
2022-01-05 17:20:22-05:00,1537,D58t4uTjFumsUeYFaKnpV8BRTEQEqKXBreFTdwGrott7,67p6kHDfVqQijfcwugvZK59c3aRRH9x3eHxruqH8WEqF,True,5836170,1459042,7723,3861,3862,4BnQKPLuE3DMTtxp8MjUBytgnhvxqq3ZTqZHTVZo4JJh,308958,1926065,-1617107,529
2022-01-05 17:20:22-05:00,1538,5qsUv9aZs6vFuGvbEg9Q5aDSjC1oETnRCxZ86bj5RgAu,6fRReXL5giyRHB5NaZ3Br53wDtsmwMXAUQ8ysFdpGtWi,False,41869018619,41869018619,1590364652,79518232,1510846420,4BnQKPLuE3DMTtxp8MjUBytgnhvxqq3ZTqZHTVZo4JJh,1590364652,8492801675,-6902437023,379
2022-01-05 17:20:22-05:00,1539,3WN8GWa5LN3THWxvTpNB7r6gZmzGJ6kqbiGqdywjoRzz,8ZffpPH3CQsB8vPSW4nVzWL3GcZuLT6ZWgkBYJT5yaYi,False,2029518440,2029518440,74126999,3706349,70420650,4BnQKPLuE3DMTtxp8MjUBytgnhvxqq3ZTqZHTVZo4JJh,74126999,438683228,-364556229,365
2022-01-05 17:20:23-05:00,1540,AHm7zF4rpaxaayBLn5QDHgJSp8KAr647s4cNvQ9wLgd7,FDM33WngED24pukBvSDpPAzinW6afVAeGReum5nyLRiC,True,11973058,2993264,18389,9194,9195,4BnQKPLuE3DMTtxp8MjUBytgnhvxqq3ZTqZHTVZo4JJh,735578,3632225,-2896647,614
2022-01-05 17:20:24-05:00,1541,Dng7By2saPu5TVxcvXidBe71ggBo8tiHkAXPi4kKL1tk,75ufEJmHbLHffphL7tvAXhGyftKLr1z2PXXoB2GGY5fG,False,5440356,5440356,265797,13289,252508,HfEnetJ7uBSmZWCjBNxdvv9HEC5nsW4wDV7wu6WnhWan,265797,1780105,-1514308,488
2022-01-05 17:20:25-05:00,1542,BhiAaiZu7fF8ndggJrLyiFVCRq526cNBw7VaeascEmNL,4en8MipPi7vq15NGhpPMQfptNdEyhp2j7fpgxBBtjyfz,True,3764168,941041,5831,2915,2916,72FwbpFGoLEazJEdpqNtPNefsadUrimUqma9wSoy4qiS,233271,1260049,-1026778,619
2022-01-05 17:20:25-05:00,1543,Hy3kzXneDN6FUkiZctU1vWe97BYvj6yZ7QvQzehfWmNr,EhXgQg8BTniANV525RpY76z7Hrh6DuqrMChjqEoXfVJe,True,10120500,2530124,15640,7820,7820,4BnQKPLuE3DMTtxp8MjUBytgnhvxqq3ZTqZHTVZo4JJh,625612,3616868,-2991256,618
2022-01-05 17:20:25-05:00,1544,Fd2HrzBAr4JobRPARZwpQHHVoSCEoog32A6tKMWAC1sK,BYappsar5sQf8VLem4wrLuTtrDFH9y8pEx1aMxfuU4Pq,True,435326913,108831728,664325,332162,332163,4BnQKPLuE3DMTtxp8MjUBytgnhvxqq3ZTqZHTVZo4JJh,26573012,125464156,-98891144,610
2022-01-05 17:20:26-05:00,1545,BgoKAyBNaJ1geeQ2FcGSHEQDWATVD3w3wmcNHtj8Awu3,8Haz7duE2ycueaJsGdrGNnK79KGHwnzKBpoafC8RZGg2,False,115818872,115818872,3686563,184328,3502235,4BnQKPLuE3DMTtxp8MjUBytgnhvxqq3ZTqZHTVZo4JJh,3686563,46284642,-42598079,318
2022-01-05 17:20:27-05:00,1546,AoPQqPjLPi8fZiLkhMGLRj6oD5k2asrvJtCkpW19DvGr,H5Sgmf1VuY13iHjPuLJ2q9wtSdkXG1AQsEv2eq6zzm8Y,False,5668357,5668357,248364,12418,235946,4BnQKPLuE3DMTtxp8MjUBytgnhvxqq3ZTqZHTVZo4JJh,248364,1837997,-1589633,438
2022-01-05 17:20:27-05:00,1547,FoYrQCyDQ75YMNvkgTULbVHYmdrsoFJHohBLPfeF5rEH,DUyVhESZMDUS6Rqsz92CnW2KbWzAs6soEzZqD59XAKzY,False,138891690,138891690,5388745,269437,5119308,4BnQKPLuE3DMTtxp8MjUBytgnhvxqq3ZTqZHTVZo4JJh,5388745,50417289,-45028544,387
2022-01-05 17:20:27-05:00,1548,4KMzwWHPeW51cxu4nMpbqCaqo96dMqaHWyRCGQktfQfd,F7q4GNYcbnZa8dJ4qovQwjmxpKpdEmdxQMXRPb9nQupa,False,5814584,5814584,289274,14463,274811,72FwbpFGoLEazJEdpqNtPNefsadUrimUqma9wSoy4qiS,289274,1926082,-1636808,497
2022-01-05 17:20:28-05:00,1549,Gs3WP18hbzNpbBgiU39e6tfkggfCKRyNqPqJQcthuHFD,4XAY25YUma6gUdG2GdbXeivum3t21g93ZagfWGTZYkWZ,True,57621222,14405305,86839,43419,43420,4BnQKPLuE3DMTtxp8MjUBytgnhvxqq3ZTqZHTVZo4JJh,3473594,21734349,-18260755,602
2022-01-05 17:20:28-05:00,1550,AaMCg49sJwNtdB5wHACg15TYAzzJXy8xtG4zuVXhKiVE,HbDYqDa9bewGPvsiaHRM9HmEvh1scPaUaGvqog66gYir,False,5728897,5728897,261158,13057,248101,72FwbpFGoLEazJEdpqNtPNefsadUrimUqma9wSoy4qiS,261158,1857960,-1596802,455
2022-01-05 17:20:28-05:00,1551,4gzW9gBbEMnNm1epY6MMJ1XfxGMtvn2mKFyKPQ2Gyb79,G6x862hmMJ2PLpyyPDwVPGapXjvEeNkqFRTAS3jWVozB,False,25086075,25086075,1154637,57731,1096906,DddJ7EWCmYEEZETCBNgAUSg81Ls6fZtiAaY5ekJ5sXx1,1154637,10315223,-9160586,460
2022-01-05 17:20:28-05:00,1552,Cv5oVktxmqbU1SxraxH67NEWMKnjgA18R832Fhe9h74a,Cs7xBD4BDiohyopnaYDDChUtR9vmx7uwot6Qp9beQLzt,False,5092098,5092098,244075,12203,231872,4BnQKPLuE3DMTtxp8MjUBytgnhvxqq3ZTqZHTVZo4JJh,244075,1671680,-1427605,479
2022-01-05 17:20:29-05:00,1553,H3x9b27yHVdCxvtDf7mmJxkNeubcmQMwfAkLTYADPWNv,HGVCCz23rWx78vrTB2wvm2aesbLZuYFhhNuznGiSSAyA,True,7916479916,1979119979,12360145,6180072,6180073,DddJ7EWCmYEEZETCBNgAUSg81Ls6fZtiAaY5ekJ5sXx1,494405802,1467027996,-972622194,624
2022-01-05 17:20:29-05:00,1554,7mYQ2DJZ1YYMpNbpA93hCDtzQDhEHjAGxLJt2g4KeYTW,8nTKeruC3wiPjT7VytdM2gX7msjwbHxTkyhsR88GJgpc,False,112294016,112294016,4245781,212289,4033492,HfEnetJ7uBSmZWCjBNxdvv9HEC5nsW4wDV7wu6WnhWan,4245781,29765058,-25519277,378
2022-01-05 17:20:29-05:00,1555,6woJkgUd2cpQQQBEp1C2G9NsYAvPwYmZXXTd6AxhieMy,E6xCdLJbDq5qFsvHEffD1Qfqrsj19H81mbj7XMUXUPnr,False,80568658,80568658,2899704,144985,2754719,4BnQKPLuE3DMTtxp8MjUBytgnhvxqq3ZTqZHTVZo4JJh,2899704,32148855,-29249151,359
2022-01-05 17:20:29-05:00,1556,gMjmD7WioyUdQdwNqE5fobLcxPwoJv5rAvLmJaf8Jjw,5n77euFjVJiwKrnbYq1KpcENW1mzBZj2BuDGyzazrkJ8,True,5284593,1321148,7340,3670,3670,HfEnetJ7uBSmZWCjBNxdvv9HEC5nsW4wDV7wu6WnhWan,293635,1749610,-1455975,555
2022-01-05 17:20:29-05:00,1557,63a7SaSJr3AKiHEWJjfqZMQjshZpa2AKeSLN6JAnNRnq,2KkuFUWtLo53MPiVBKyPETAaZuf1xvxzy1ZwbEYdnf2a,False,4257939423,4257939423,142435419,7121770,135313649,4BnQKPLuE3DMTtxp8MjUBytgnhvxqq3ZTqZHTVZo4JJh,142435419,920903338,-778467919,334
2022-01-05 17:20:32-05:00,1558,7jvKp6onXyWgwsFrFWj4hYTXJsYYD6ot5mn6rPFuJriy,J7N6HiozevJVTiY9hDEUs2ud5BwT5QSE7wnMBS1w5ie2,True,343373284,85843321,468053,234026,234027,4BnQKPLuE3DMTtxp8MjUBytgnhvxqq3ZTqZHTVZo4JJh,18722140,125930341,-107208201,545
2022-01-05 17:20:32-05:00,1559,7iUx7JBwqUvPVPeCqMEXQdLccZJmaFYm1DUQiu3ouHa3,3EVZzhRmJnX9ZiBZZo9tenDtMogAyuA1yf2cKzvUWiuu,True,6633274,1658318,8897,4448,4449,4BnQKPLuE3DMTtxp8MjUBytgnhvxqq3ZTqZHTVZo4JJh,355883,2238080,-1882197,536
2022-01-05 17:20:32-05:00,1560,8gBsfVCJe6xDQSdTZY9ZVjpjc4JsEmfNBdWyu78PofEK,7kpHB2hhHKGEEJFamZ3CcJjMRnvZKyZLXm1dP8xqrnGu,False,4644385426,4644385426,140285558,7014277,133271281,4BnQKPLuE3DMTtxp8MjUBytgnhvxqq3ZTqZHTVZo4JJh,140285558,1009662736,-869377178,302
2022-01-05 17:20:32-05:00,1561,72L76qDRMK3M7X52zuuB9GVyvFFLDBZwFMpVjWjghXzA,4m2ZVuemUctu1edv4YJVAcjXzKwpbCmBujzoUmLDeA7h,False,5933105,5933105,286447,14322,272125,72FwbpFGoLEazJEdpqNtPNefsadUrimUqma9wSoy4qiS,286447,1928047,-1641600,482
2022-01-05 17:20:32-05:00,1562,Dn916KSmX3HqxT53hrxrbCrV3tdRMCPdaoiRLqetMrth,ATCXRiXgnjRRUbSTPBvtBXMENCqsViexSZbZ6aDaXXWA,True,10090662,2522664,13633,6816,6817,4BnQKPLuE3DMTtxp8MjUBytgnhvxqq3ZTqZHTVZo4JJh,545332,3103492,-2558160,540
2022-01-05 17:20:32-05:00,1563,7LBZi7Ec4VKhtNJbFQYYY8CvFbsLPCvqmn8Rd5EVhn9n,CBgkKDhmsEa8Ug8nE9Yu95gLDbDQa9FNGpdjVRfEDXcq,False,463083319,463083319,21307693,1065384,20242309,72FwbpFGoLEazJEdpqNtPNefsadUrimUqma9wSoy4qiS,21307693,142334857,-121027164,460
2022-01-05 17:20:32-05:00,1564,5gN3624v6n1zQ1BKtZi1e9ZLpbCa4MEfhgHySFB81Qfm,UXT3oB5ud18rBsygsfxwA93kQYdSNbbzTCjt4gtU2jP,False,6703964,6703964,312638,15631,297007,HfEnetJ7uBSmZWCjBNxdvv9HEC5nsW4wDV7wu6WnhWan,312638,2183597,-1870959,466
2022-01-05 17:20:32-05:00,1565,2YcB3QQGWho5oogDd1nK3cpLQzwwwXGxybrhe2xDkDxq,5DjAUp6CxKStYTaXSnzjvYkfqCXfG8Y61bWw5UwbbE3q,False,16452223,16452223,758006,37900,720106,72FwbpFGoLEazJEdpqNtPNefsadUrimUqma9wSoy4qiS,758006,6741754,-5983748,460
2022-01-05 17:20:33-05:00,1566,2mfcg17QocKKvDcqDH88TwxHRiS8dAQiJAGoAh1brns9,8aQLELBgaA9eXsxSciMjxWv8B1hpbUPfLwqVjEnasZbe,True,386358501,96589625,578377,289188,289189,4BnQKPLuE3DMTtxp8MjUBytgnhvxqq3ZTqZHTVZo4JJh,23135104,86731153,-63596049,598
2022-01-05 17:20:33-05:00,1567,Gbxc51WERLLeCtiHv7rDvE52aqF541RoQWG5n5aqErq6,4ngBoHbfXijLMqGKxFMNht9sbmxy2g5eqBmn8QsBmbx1,True,5830319,1457579,7303,3651,3652,4BnQKPLuE3DMTtxp8MjUBytgnhvxqq3ZTqZHTVZo4JJh,292121,1941347,-1649226,501
2022-01-05 17:20:33-05:00,1568,8eTH6eJyyVeMno3UQkffeBg32xofKsQfkhLhXdtaf87s,BCFC7CPXrQPsUfJb2eYSht8GhaApWHpc49AeCXqaYq13,False,5821722,5821722,269450,13472,255978,72FwbpFGoLEazJEdpqNtPNefsadUrimUqma9wSoy4qiS,269450,1880330,-1610880,462
2022-01-05 17:20:35-05:00,1569,8xQ3tsWVUe75EG1HmocULJ3kh52utveoFMEPotTGrKno,i3SKW3ywrwYucX9ySEx1C4zaUKGnzLerP3V38437NyV,True,893323221,223330804,1389282,694641,694641,4BnQKPLuE3DMTtxp8MjUBytgnhvxqq3ZTqZHTVZo4JJh,55571289,234975997,-179404708,622
2022-01-05 17:20:36-05:00,1570,BZxJ6CtrVoiU86DMMieMeDFLNWtMpHGTvZfM7nyay6o4,6CRxRR8bisRLHFJBFWjyumYuy7j4C4PkjYH1K8gXhdWD,True,22167053,5541762,29492,14746,14746,4BnQKPLuE3DMTtxp8MjUBytgnhvxqq3ZTqZHTVZo4JJh,1179689,4512645,-3332956,532
2022-01-05 17:20:36-05:00,1571,DGbj8tnqECzM9FG8j225Ap7A4Fdm3J1Ksm32JBFG7igv,Cd3D2UVwoSZLygM2e3UQppQANsokpmx5CNBs1C5zueay,False,5307550,5307550,244020,12201,231819,72FwbpFGoLEazJEdpqNtPNefsadUrimUqma9wSoy4qiS,244020,1697702,-1453682,459
2022-01-05 17:20:36-05:00,1572,GKNBtZbwK4w9hyXD1r38NTGcTJhpjt8R9WFCzdXup9Tk,7RLaL2XoFuqrcCcPEB6FzPJzLnAhjQpwcRmDfdpRXFgB,False,104989361,104989361,4217151,210857,4006294,72FwbpFGoLEazJEdpqNtPNefsadUrimUqma9wSoy4qiS,4217151,41802571,-37585420,401
2022-01-05 17:20:51-05:00,1573,GWEfWJimTKDJuxSTAb7SxkT3L3FhPPu8wJzYYF8H4SgD,BdeMcj3cMyKVPeF7Mt9Jdpxgzq9P6c79qJR6ctiiDauL,True,287831934,71957983,427881,213940,213941,HfEnetJ7uBSmZWCjBNxdvv9HEC5nsW4wDV7wu6WnhWan,17115277,84101316,-66986039,594
2022-01-05 17:21:50-05:00,1574,pgzvXpnUYiY7hLrfjmwScqLd8oj9vYcXpFvpm4y4JvG,GdqdQgoyBAFuXdbvoZyDhB3jyqJzVo4nkGh7EPFxkBF2,True,30631928,7657982,47482,23741,23741,HfEnetJ7uBSmZWCjBNxdvv9HEC5nsW4wDV7wu6WnhWan,1899300,19215469,-17316169,620
2022-01-05 17:21:50-05:00,1575,67Z7ZGhNu5xxEh9BYKWcXp9m1T4tFiE1o1M16hCzUWQA,CT7YKWixz7BhTbvg5F6M5HCyPGnHoFLNFuDV9GhoLTo3,True,47209427,11802356,72916,36458,36458,HfEnetJ7uBSmZWCjBNxdvv9HEC5nsW4wDV7wu6WnhWan,2916641,17104196,-14187555,617
2022-01-05 17:25:16-05:00,1576,CRaKcudjkQiSw5YPVjTLVdXvJskeGiHSYtq5ZcMPJhgQ,AgqTg3b3bAcaBmRidhNC4Uf9ZwNbeH52RQEqumWyuUs7,True,12583913,3145978,19679,9839,9840,4BnQKPLuE3DMTtxp8MjUBytgnhvxqq3ZTqZHTVZo4JJh,787161,4887164,-4100003,625
2022-01-05 17:25:56-05:00,1577,4QWcUDQ8Yf9nuftGoUdfWzBg6RkmuKW6yMGpakkiEWtG,5zgmZGdfmtjFZhtz7m352ycreWVmQijHKbmTCZj2zEYk,False,580799322,580799322,4966539,248326,4718213,HfEnetJ7uBSmZWCjBNxdvv9HEC5nsW4wDV7wu6WnhWan,4966539,146142065,-141175526,85
2022-01-05 17:26:13-05:00,1578,Br1j5Ftafei7ysu5SmqVZSoRe4uS4qCPeKSPHg55pyiE,G8fc7QvXjfkgBFvAVUgJFQS3VaF1biL9rktBExGa87Ks,True,16197448032,4049362007,21520160,10760080,10760080,72FwbpFGoLEazJEdpqNtPNefsadUrimUqma9wSoy4qiS,860806408,4544588186,-3683781778,531
2022-01-05 17:26:13-05:00,1579,CGk6y4qfTtENsgu7mNNYBFJqzDi3swKRwbwVJSZ4N8ZL,J6wKVACEZa6n3QFoh16BHi42ZJLunYywJi9qhY72rrwF,False,2034751417,2034751417,100576402,5028820,95547582,72FwbpFGoLEazJEdpqNtPNefsadUrimUqma9wSoy4qiS,100576402,566389958,-465813556,494
2022-01-05 17:26:14-05:00,1580,HAk9c831TRUhvpoK4d7PTqfJuJhSjnJUXWpnYsH85bDJ,DVSa3CJrVLTHAeFYjEF89ZjWRm86QwruUk2Y8RvGpjsr,True,256811,64201,368,184,184,72FwbpFGoLEazJEdpqNtPNefsadUrimUqma9wSoy4qiS,14737,79004,-64267,573
2022-01-05 17:26:14-05:00,1581,5zSoXxVZYYQAtq3urfcUQmJkjFDBXkUJYSNFdq759Tof,3C459gJnmj4EYTG3tDFJEEf1aAT915sxRLs2THEdQqha,False,797295752,797295752,8711954,435597,8276357,4BnQKPLuE3DMTtxp8MjUBytgnhvxqq3ZTqZHTVZo4JJh,8711954,197780589,-189068635,109
2022-01-05 17:26:17-05:00,1582,GLB9MTe5PHfs3vK1XVXxSbH9xAnTdnU9kL5jUZcVsmd3,GYg2mE56e4b26YQwZzk39nxiuvpMdR6BkvAsPwFnvZvu,False,195717691,195717691,0,0,0,72FwbpFGoLEazJEdpqNtPNefsadUrimUqma9wSoy4qiS,0,48796069,-49252309,0
2022-01-05 17:26:17-05:00,1583,2q6ZezY218nwaTpZhrUVqP31ffW3oxcgLd6LnV83tSkc,8UrAQzMbqt5zZhdU2srZFEWEtwZyU3DNqbbYcLrs3eni,False,6731371603,6731371603,17569965,878498,16691467,72FwbpFGoLEazJEdpqNtPNefsadUrimUqma9wSoy4qiS,17569965,1665626331,-1648056366,26
2022-01-05 17:26:17-05:00,1584,36ByQojnxEckWdQTjqHfxKqCx9yjqWQsPsZyqaN72UWR,AZoirtS1fjX61agRM64tqThVinnJTh3BWgiHyNHPTgZP,True,12154810,3038702,19005,9502,9503,HfEnetJ7uBSmZWCjBNxdvv9HEC5nsW4wDV7wu6WnhWan,760228,4077843,-3317615,625
2022-01-05 17:26:22-05:00,1585,BtnTjb4mghmBK9KnLp2JzyGqfKB8tHskrGL4MzjAdF6V,BLStL7zka6qakHMhY4V6jKJT5agS1LtWMdWBZ1eP1Vi7,False,355670,355670,17076,853,16223,72FwbpFGoLEazJEdpqNtPNefsadUrimUqma9wSoy4qiS,17076,106174,-89098,480
2022-01-05 17:26:22-05:00,1586,8sneA6wAg6geVDJ1g7YWg4R1PfjuRVzeHp1nUBJinhZa,14i1uWtmcTjrdbg3DSr9vzd5NBnxqsn1A4QdgFBZqeYM,True,1289151,322287,1940,970,970,72FwbpFGoLEazJEdpqNtPNefsadUrimUqma9wSoy4qiS,77622,347375,-269753,602
2022-01-05 17:26:23-05:00,1587,HyzMNjVJqyfyMKnuwvRTQvT4NeTBX9HjXgfCbDcDXGF,BrCNFRRi9Cx2hJEKp47CtN9TUa7VzLWkyLrs5TSX7w1i,False,24962435,24962435,722259,36112,686147,72FwbpFGoLEazJEdpqNtPNefsadUrimUqma9wSoy4qiS,722259,8689824,-7967565,289
2022-01-05 17:26:23-05:00,1588,4ytoBUwuhAL4YYSCa6AgwrpeVF4eeU8H9NfDxMPZKxPo,Pby2szzsxDrXt4gnbmmaMccXxctZALr8miRtKhGKjsD,True,23442624,5860656,33412,16706,16706,72FwbpFGoLEazJEdpqNtPNefsadUrimUqma9wSoy4qiS,1336515,8824091,-7487576,570
2022-01-05 17:26:25-05:00,1589,46TNhGwBVzedW8xSb9UY94HNeSom9iGiZzAjrKHiRM2G,7JVTiqNYeKHbyzRkKtvSEpqLPKykZso8cGUr3sX1j7QF,True,345831009,86457751,480558,240279,240279,HfEnetJ7uBSmZWCjBNxdvv9HEC5nsW4wDV7wu6WnhWan,19222321,84391312,-65168991,555
2022-01-05 17:26:25-05:00,1590,2uZeVkLSEXWbfJNf4VaMTnrWC77sGjMR665ssfYiuDUt,RXk9ohbGCP5kx6WxCZHbSGAdbqg46DsmoPJw83x6NUD,False,323887826,323887826,12903126,645156,12257970,72FwbpFGoLEazJEdpqNtPNefsadUrimUqma9wSoy4qiS,12903126,101015300,-88112174,398
2022-01-05 17:26:33-05:00,1591,ASrkgcVQ9iMDvTbji6xdpzXU4G4hRNhZ4BzseVxGjDnp,3N8MqUxgfh6T7MQu3JQqYUHDiUYSy5AnXY1SmSMmpdBo,False,4699305241,4699305241,80849347,4042467,76806880,72FwbpFGoLEazJEdpqNtPNefsadUrimUqma9wSoy4qiS,80849347,1313800078,-1232950731,172
2022-01-05 17:26:36-05:00,1592,56488NdcUy6Hi6X5SLs2GFtW5pG4u5wJpH7vHdxTCx4z,tGgXjJeVr3W2m3T2NXPCqpBEd6HJKE2cRsgCyiDZQy4,True,125810459,31452614,191207,95603,95604,HfEnetJ7uBSmZWCjBNxdvv9HEC5nsW4wDV7wu6WnhWan,7648307,50589200,-42940893,607
2022-01-05 17:26:46-05:00,1593,2PHDkmat5jQ65XkJYhDSw6ZwHcKpSw85o8MaPFhfLBry,8NtkXoUPt4wkcqQJuPJYt5oq9hG4BdeY26dQrsybDWWX,False,129199967,129199967,6253725,312686,5941039,HfEnetJ7uBSmZWCjBNxdvv9HEC5nsW4wDV7wu6WnhWan,6253725,33995178,-27741453,484
2022-01-05 17:30:00-05:00,1594,9vcKW1GfrDZ3KLPh2pEVFF8ZyKqD1pJW1hiE8H98Av7S,C6Ki27mo4sCHu6u8UnR1p7WSgsTjFQxGGR9Lk9n5Rhjq,True,40359754,10089938,63066,31533,31533,HfEnetJ7uBSmZWCjBNxdvv9HEC5nsW4wDV7wu6WnhWan,2522675,11410198,-8887523,625
2022-01-05 17:30:18-05:00,1595,Ckqos6cdncPKj13DnCmDVZsZTqp6eS7277CRrT9WhcEr,AtUV8m7VQJvZq7GLCAHMf3jV7iamKEPnWVZHWuuVZQp1,True,18036606,4509151,28139,14069,14070,72FwbpFGoLEazJEdpqNtPNefsadUrimUqma9wSoy4qiS,1125594,7004576,-5878982,624
2022-01-05 17:30:24-05:00,1596,6cnA7PeqQgpZdA7jBg4yMzTusm8JJHRWBMup84ywJfYo,FLqcukY7RehqY6ACrwVJnGH3eRgRDe93K1jLYCQN2F3U,True,858896526,214724131,1327160,663580,663580,HfEnetJ7uBSmZWCjBNxdvv9HEC5nsW4wDV7wu6WnhWan,53086420,321872530,-268786110,618
2022-01-05 17:30:31-05:00,1597,DmEVzPyCKnm89v481V2ic57vyikwwMja75uVZ2rjvjfp,38fPZzP4NwTtx7Qu6DLSqx9Sv8e5CQbSrr2BMvVmSy4J,True,252793908,63198477,393818,196909,196909,HfEnetJ7uBSmZWCjBNxdvv9HEC5nsW4wDV7wu6WnhWan,15752749,96597632,-80844883,623
2022-01-05 17:30:41-05:00,1598,BQBQicboM5o25LihnffqxcJmoPoA3mgBKNeG4H8UTHVh,E8rJFAs7dbDmQA1o5aTeNqdmADxWMd5cDzvwAGMFFCix,True,21959718,5489929,34336,17168,17168,HfEnetJ7uBSmZWCjBNxdvv9HEC5nsW4wDV7wu6WnhWan,1373448,12192813,-10819365,625
2022-01-05 17:30:45-05:00,1599,HVZkXeDR3mc8oB9qFFwCK4RXpPojdcHk9tRGep6xtKGK,Bh3py7awPejWqeTMxtAgF7mPotL2Asxf8YrYJykq9nBt,True,95775207,23943801,149541,74770,74771,HfEnetJ7uBSmZWCjBNxdvv9HEC5nsW4wDV7wu6WnhWan,5981658,22714612,-16732954,624
2022-01-05 17:31:11-05:00,1600,DvuRmJkfn6FQczUKgYeaSCqwy2NTMunuAKNrnmxMvnzS,7LpWTX9dgBtW75kfEoB5WuNsDwEdw5s8CYSHh3J4qagM,True,958046764,239511691,1487804,743902,743902,72FwbpFGoLEazJEdpqNtPNefsadUrimUqma9wSoy4qiS,59512188,293986673,-234474485,621
2022-01-05 17:31:32-05:00,1601,9KD2AifD5wFD4QkHYuawXbJgLWHrfj2QPF3fT8jhGVA5,Ga9gAqmkuHbqrr31sUFPqa1xa5WNxLWJWGPUaMxQqLdj,True,19741395,4935348,28191,14095,14096,4BnQKPLuE3DMTtxp8MjUBytgnhvxqq3ZTqZHTVZo4JJh,1127665,6976058,-5848393,571
2022-01-05 17:31:44-05:00,1602,JDeYjCLpfnzcfxDFgHf4aBcHsajwdR14GUaKAA9euzVf,EJbvKoyMZcoCx4vWa61uMbW2vr6mUhrgEuECdteVBuZZ,True,117796587,29449146,184073,92036,92037,72FwbpFGoLEazJEdpqNtPNefsadUrimUqma9wSoy4qiS,7362927,43007999,-35645072,625
2022-01-05 17:31:52-05:00,1603,8xvLGVeDmhVYQhN2ZpWkVG9jCrukRsNQ4926a4TMiZqa,9ciBySSjvADwp47WkETiFWZKVTFL8Hf1XvK7aSxhcgQS,True,376594857,94148714,552752,276376,276376,HfEnetJ7uBSmZWCjBNxdvv9HEC5nsW4wDV7wu6WnhWan,22110080,81935395,-59825315,587
2022-01-05 17:31:54-05:00,1604,5Rxuqgs4CaSKbfDXqBMFXkLTQ9dxrUjThXzoy3ouYVtK,BgvbKru66ebrGUcFFymGTmsaQv6GgcGMybiWaXqzBtwX,True,3139632,784908,4525,2262,2263,HfEnetJ7uBSmZWCjBNxdvv9HEC5nsW4wDV7wu6WnhWan,181026,1172201,-991175,576
2022-01-05 17:32:04-05:00,1605,3qnPsgqW11AcDEmyjmJquPcPLyE3EdJQuVLJ5kinDrd3,86rZadBB7emKio76aFTahpbrFtxd9tqZ4Mxgzaavq2xU,True,2292706,573176,3553,1776,1777,HfEnetJ7uBSmZWCjBNxdvv9HEC5nsW4wDV7wu6WnhWan,142121,549416,-407295,619
2022-01-05 17:32:06-05:00,1606,HGJoZvLakWfSDFwuvShNBc4kCf7nP7VqzyM3mELpbFEf,12Qn5jin7QvsBngXqYAv4UstyG3b6nRf1jsLp9Dp8G7k,True,235369984,58842496,367735,183867,183868,HfEnetJ7uBSmZWCjBNxdvv9HEC5nsW4wDV7wu6WnhWan,14709429,60562755,-45853326,624
2022-01-05 17:32:07-05:00,1607,7PzGZgzieFyyFs1dbajkNQgVxooFUNZrj1bUsQvrSwbp,A2gDREmSmJTBPPw3sbKVY3smC9wbHMDdv87gr4Tr2ES7,True,41269640,10317410,64148,32074,32074,HfEnetJ7uBSmZWCjBNxdvv9HEC5nsW4wDV7wu6WnhWan,2565957,9901293,-7335336,621
2022-01-05 17:32:19-05:00,1608,3VdSA9CED9f5swRwHX2U15U7J6Muaq8VPnCNy9CaGDHe,2YYstfnfdYic5NWmEbcUEHpccNUVd1EhuCkExvMsoMk8,True,101587460,25396865,143370,71685,71685,HfEnetJ7uBSmZWCjBNxdvv9HEC5nsW4wDV7wu6WnhWan,5734823,35310654,-29575831,564
2022-01-05 17:33:10-05:00,1609,GqAS41YJssg9aaEp3hs3sG98APCsXhiQBQszXaSjZ2bN,2wodJ3AhrXdE1T4oVL95KvoBND7PubG5Wd5GWiLCMZJU,True,2755883405,688970851,4306852,2153426,2153426,HfEnetJ7uBSmZWCjBNxdvv9HEC5nsW4wDV7wu6WnhWan,172274114,1562333152,-1390059038,625
2022-01-05 17:33:26-05:00,1610,BrHRMouGRz3LBNzd9anfdYMhWfg8yUPHL4PqJ8WdEDFS,4uzoLa3mC2VYHAPBoHLX4gTjPTC28rPf2fvEGtJWPYc,True,882092747,220523186,1358957,679478,679479,HfEnetJ7uBSmZWCjBNxdvv9HEC5nsW4wDV7wu6WnhWan,54358306,496666170,-442307864,616
2022-01-05 17:33:29-05:00,1611,B4Uc39nKzz9wBRQsCkMR4A7RwTJ8rSuwpR6EQn2AesRb,H49bGZgatRZVpj6QufZRVgYrQtH7LpdbiqKBs23151m,True,375161525,93790381,577170,288585,288585,72FwbpFGoLEazJEdpqNtPNefsadUrimUqma9wSoy4qiS,23086803,238574745,-215487942,615
2022-01-05 17:33:33-05:00,1612,BYvjENe16Ta77PqGV7JKEWrsqCTfkMGYwTSG5gXneDvd,EvxAXgvhPC6QkNurbK7vWyTApGo8J2R4EgMAknkHVU3d,True,44819277,11204819,69696,34848,34848,HfEnetJ7uBSmZWCjBNxdvv9HEC5nsW4wDV7wu6WnhWan,2787870,17962533,-15174663,622
2022-01-05 17:33:42-05:00,1613,BPsM1um9ZJf7eNoVMsQCRSwgARMuLCGGSDxf9tZeNeEy,BpzDdXfxVygiSYSmsHV6uPxQMeTFtrURMCCqhswQjd5X,True,17478507,4369626,27121,13560,13561,4BnQKPLuE3DMTtxp8MjUBytgnhvxqq3ZTqZHTVZo4JJh,1084864,3604337,-2519473,620
2022-01-05 17:33:53-05:00,1614,3WcJUt8jQ1ngL3ZCGo6dFrc3GmTMTYtzeDva7mri2Tqx,HeG1Pz2oMjqtkfsRMsbqP3VpatnVEQzcWmKDVoFp4Htr,True,235362683,58840670,367180,183590,183590,72FwbpFGoLEazJEdpqNtPNefsadUrimUqma9wSoy4qiS,14687238,60547865,-45860627,624
2022-01-05 17:33:54-05:00,1615,DR7XL3qweFyTKDatQYS2LacqGLv2368cnGuWpEpk4hSL,Fd3BYCiiQfThDJsxBUNwYTMP8eNCrnXMVzE1wpejJqXa,True,69168,17292,108,54,54,72FwbpFGoLEazJEdpqNtPNefsadUrimUqma9wSoy4qiS,4324,21880,-17556,625
2022-01-05 17:33:59-05:00,1616,6NJFN855M3Q3RLTDNo57gTgAmwPD6G2E3WvMb1m5eNCN,3YpqNnonsvXaRT4nCC3G5FZx1jjVtbDPc36LiR6WK5jR,True,1147145045,286786261,1785795,892897,892898,4BnQKPLuE3DMTtxp8MjUBytgnhvxqq3ZTqZHTVZo4JJh,71431809,409671591,-338239782,622
2022-01-05 17:34:47-05:00,1617,7vKmhLV45Q5etXhJL5ng8rxWhYSiUCDmAbGnwBPr7zcx,cP6xPeuHLnjr858QK1F9qYn7rJpEbPy7wEJHoju6oV7,True,505779496,126444874,786021,393010,393011,GmqQKnMfFxkv6ChqGaZ2wmSFDow7R1x7WeRfU58GVvfw,31440851,122732205,-91291354,621
2022-01-05 17:34:52-05:00,1618,2PzBAkdXkrwH9VuoMALumQz86qkW7sSBQtCrHw14JUp3,D5vwWAMHVooobG2sCWv9EwtJrAFZG6cwKH4dfmA98tbt,True,30394627,7598656,47374,23687,23687,HfEnetJ7uBSmZWCjBNxdvv9HEC5nsW4wDV7wu6WnhWan,1894975,7496712,-5601737,623
2022-01-05 17:34:58-05:00,1619,i7TcF4weYcqgrRdH3GpndbEYxCxfcSfr9JWYrAUg1CF,BkDfknUir7PnSEW8auoB87PytycEFwyX5kT2GY4SGJJL,True,61787052,15446763,96530,48265,48265,72FwbpFGoLEazJEdpqNtPNefsadUrimUqma9wSoy4qiS,3861233,35815059,-31953826,624
2022-01-05 17:35:13-05:00,1620,8swGZMrPrLAxZd7MxTbkCL13k3DmAJUw41jCp6Xo6awW,3fKnX7yTNXAT4uMmXVdTy47ALJT8h8YSD3WiBb4BGuzH,True,3481013294,870253323,5081928,2540964,2540964,4BnQKPLuE3DMTtxp8MjUBytgnhvxqq3ZTqZHTVZo4JJh,203277138,848992678,-645715540,583
2022-01-05 17:35:16-05:00,1621,HdfQweV1KuYSpWdycZbpGrUc8yMcY3ZczLn1agKXMJaf,G1Ae1PZHkANkwFnhUKS1tvdFEv8dAFeojBkezh6rUNMh,True,80575385,20143845,124174,62087,62087,72FwbpFGoLEazJEdpqNtPNefsadUrimUqma9wSoy4qiS,4966994,22927185,-17960191,616
2022-01-05 17:35:24-05:00,1622,EanSXRkJu91FKUhPCzYxWkmM3PQUWcovEnoZXcd6vQ9E,Fg4EzAzHStoLRDPmoBUczdWnWrhAb7jKEujqAujLFT8,True,2172745384,543186346,3380006,1690003,1690003,4BnQKPLuE3DMTtxp8MjUBytgnhvxqq3ZTqZHTVZo4JJh,135200244,555607057,-420406813,622
2022-01-05 17:35:24-05:00,1623,9WJBnVi84E926j7xEd566WzrZJkPJWRgmEnYj9vyjuad,4dLaFS5F7TGyLdwuJLMGkz3bSL53aHzd9ZfpNmhHxXeF,True,231032690,57758172,353903,176951,176952,72FwbpFGoLEazJEdpqNtPNefsadUrimUqma9wSoy4qiS,14156133,70698428,-56542295,612
2022-01-05 17:35:32-05:00,1624,DMgPzJnMQfvpk6LWscs9V9CwnYDj4CEUgKB9S65WsTaY,BZRSLH1Vw1BQwXTZtBcgUYqmFF7TuzYxAaZ8TXUKwLUQ,True,68649,17161,106,53,53,72FwbpFGoLEazJEdpqNtPNefsadUrimUqma9wSoy4qiS,4249,25243,-20994,618
2022-01-05 17:35:33-05:00,1625,399591e8XgY52yCMorCQ2WL6dQZTC485ZooHtmGuirhZ,JCiXAooFmKmEPQ2S7C8iSk6CLcTyrPEe1SsPSLyUGySe,True,16118228,4029557,25150,12575,12575,72FwbpFGoLEazJEdpqNtPNefsadUrimUqma9wSoy4qiS,1006022,5885673,-4879651,624
2022-01-05 17:35:33-05:00,1626,DrzTARa7RK8RXoxHZPKCBqYtMC8TAUHRw8SznXRKTa5M,FYANet92VhyXkKZqqBJR4sFxuCftWb68sgQU9VHCdTJk,True,385793,96448,601,300,301,72FwbpFGoLEazJEdpqNtPNefsadUrimUqma9wSoy4qiS,24078,88338,-64260,624
2022-01-05 17:35:53-05:00,1627,A7SMcwnq3DewryUj1jScnAboKGnuDVcW15F3ubNcG66Y,5qLCE37FdeWLCQnkfNJViFMGNcDeiELgE3VgPbBUuDGF,True,268524973,67131243,415907,207953,207954,4BnQKPLuE3DMTtxp8MjUBytgnhvxqq3ZTqZHTVZo4JJh,16636295,83823833,-67187538,619
2022-01-05 17:36:03-05:00,1628,5Z3ZFCA65WoWhm3okRuuziEMi7ajGAEHWUFchzBNba5S,FcomdrWidygkxMKzcsY5xELbmwC652uMci648LMTv7AB,True,145130,36282,223,111,112,72FwbpFGoLEazJEdpqNtPNefsadUrimUqma9wSoy4qiS,8928,34097,-25169,615
2022-01-05 17:36:06-05:00,1629,89CkXnSZnr52Zsoh48efv9MQacrkB6GMtrbEpNJSyA2H,HcvRBS4Z22CpYgDNgm4TVF4AVXFDuYzBUAFcdHAwdpg4,True,35006888,8751722,54748,27374,27374,72FwbpFGoLEazJEdpqNtPNefsadUrimUqma9wSoy4qiS,2189950,8384221,-6194271,625
2022-01-05 17:36:07-05:00,1630,E1wp3bmkcY3eiEYyGYwhTCsr7BZ7RfPa5DJTZFupcFwj,452hVdYkD5SDDrA6hv6DLPFvyS8PvR2P6DPNScGxWTsW,True,9410855,2352713,14579,7289,7290,HfEnetJ7uBSmZWCjBNxdvv9HEC5nsW4wDV7wu6WnhWan,583178,2421192,-1838014,619
2022-01-05 17:36:08-05:00,1631,AKxRtcdpi7gWhAuL8ENj7zhgeQezzEXe9TSANE6bQoRA,2YH4vrU9deP8Cu6E8Hzf8GqKG1yVjv5pdz4FE7r5YKir,True,79928637,19982159,124817,62408,62409,72FwbpFGoLEazJEdpqNtPNefsadUrimUqma9wSoy4qiS,4992684,19105540,-14112856,624
2022-01-05 17:37:21-05:00,1632,GaEpNGa8jnwSRvjzzEMYkZe1pKcr2eiZtePrqFxpABjB,5CFZHuyWbJv14zPdX5dSQDREgHrCb4vsFvB6hLiEe3Ji,True,1778391,444597,2773,1386,1387,HfEnetJ7uBSmZWCjBNxdvv9HEC5nsW4wDV7wu6WnhWan,110926,432536,-321610,623
2022-01-05 17:37:32-05:00,1633,HqtTbC1LFreGvgfpZe7nCqkNnh8GHPQKosfmc19zb1yi,E39UNiHNkwQEd5GXkCtTPqSorQSB1kLx8kjzK4jdFoi3,True,3629514519,907378629,5664012,2832006,2832006,HfEnetJ7uBSmZWCjBNxdvv9HEC5nsW4wDV7wu6WnhWan,226560484,1066453388,-839892904,624
2022-01-05 17:37:51-05:00,1634,D3mXrJzhHf8qRaoCKLschUxAFoijFCFuT6bmNZH4W7Cj,9E3Xtqw7TncXWnbhAbFJMtuNmP6WS3ooGuptzyzw7UpA,True,675201,168800,1050,525,525,HfEnetJ7uBSmZWCjBNxdvv9HEC5nsW4wDV7wu6WnhWan,42020,247733,-205713,622
2022-01-05 17:37:58-05:00,1635,Ar5QB4VBcUyzSCG23z2QNAbrWY55NbHCr1MNN6P2GAmh,BusFGTiDrJmxzwGUxWz9b3SFF3eseqtgh2DRHqyAwyVe,True,5397883,1349470,8435,4217,4218,HfEnetJ7uBSmZWCjBNxdvv9HEC5nsW4wDV7wu6WnhWan,337405,1402533,-1065128,625
2022-01-05 17:38:39-05:00,1636,2NdwSLxsGok8PczpCZj9CVX2BymNU5MvHt7hWfGetg2M,8AQbDXeA6mD9QoZBFJcYbnHvZwKNxzA9CCHLAgdSfTA3,True,124370,31092,193,96,97,72FwbpFGoLEazJEdpqNtPNefsadUrimUqma9wSoy4qiS,7745,41542,-33797,622
2022-01-05 17:38:58-05:00,1637,4MmpDGUTyMcYEqJ1RoZ46AN2BhrBUseHaHqF8AmiTPyD,7HW2YZpYM349HMfW7u4h9ESZ1AXkwN8JcVDTNFzp9aTz,True,1401253111,350313277,2189639,1094819,1094820,72FwbpFGoLEazJEdpqNtPNefsadUrimUqma9wSoy4qiS,87585570,466963499,-379377929,625
2022-01-05 17:39:00-05:00,1638,9YEzjb49Awvedv9yNc6LG54SkGBug2RYiJwiUV13mGsS,3H8w5WCD187NWWoZMNUCzUDdxTgqrRJLga8gDzUVXBgZ,True,12801233,3200308,20010,10005,10005,HfEnetJ7uBSmZWCjBNxdvv9HEC5nsW4wDV7wu6WnhWan,800416,5153052,-4352636,625
2022-01-05 17:39:31-05:00,1639,EQUZQWk4WLT6LFeWZs3P9AQufFcoZouFETfhyxvuS2JM,Byc2mLXArmkjQPWaxCJksHZD2XpZyCQ2FRtDJyztU81V,True,1109312401,277328100,1734048,867024,867024,HfEnetJ7uBSmZWCjBNxdvv9HEC5nsW4wDV7wu6WnhWan,69361933,408314028,-338952095,625
2022-01-05 17:39:53-05:00,1640,4mB2DVbQVqVk535v98Cj8SPNg1tTc3DFyY2Q7VBbY645,HXo255k3RgsTGsc4hiP6ZTXUspBTqJ37duQa5eK7tqp3,True,3168546128,792136531,4827962,2413981,2413981,72FwbpFGoLEazJEdpqNtPNefsadUrimUqma9wSoy4qiS,193118480,760291764,-567173284,609
2022-01-05 17:40:13-05:00,1641,AtKuDfcFXqWUMnRqQpjedUMTb5CQKLc2zoqEAcQpysKQ,9bPFLYp5TDZruLLDXDYYCiPYcD982iF8xt5rfTkqwNsL,True,129875,32468,202,101,101,72FwbpFGoLEazJEdpqNtPNefsadUrimUqma9wSoy4qiS,8118,29744,-21626,625
2022-01-05 21:29:33-05:00,1642,9jdfc9GFTecsdRuTjWFGX13niKKmeBxRgtv5j86uhSnU,HLWMShobjSkaLyXrNjgwVaUGVtbtdUSnr1XjqpXn1bLR,True,3419675,854918,5346,2673,2673,72FwbpFGoLEazJEdpqNtPNefsadUrimUqma9wSoy4qiS,213861,959898,-746037,625
2022-01-05 21:29:43-05:00,1643,GJ3PbEfPK8jjrPgMmZtvN5fMSSy2dtiiAtZ8wcfgxVuc,FCUDVFb2TjDvehHE8fVBofqSykpb9W6Afc9QeHtj7te7,True,895916223,223979055,1400845,700422,700423,3zqXX6kzhkbW3d4TwD2CNjMRwxTbREXySekvq37kfCNk,56033817,325712130,-269678313,625
2022-01-05 21:29:49-05:00,1644,JCBhqqPQxP1Xc41sSY6e1sQKRstHhe7D1v6rLz4hp3Qp,DWMUq2bMD1jqpxHtyXDFjcAwjA27yyMRe68hGcsK143m,True,81319,20329,127,63,64,DddJ7EWCmYEEZETCBNgAUSg81Ls6fZtiAaY5ekJ5sXx1,5086,19243,-14157,625
2022-01-05 21:59:34-05:00,1645,243SAnGxchCVB1LQAUF4SsozR86yDwEdg2QQpbWGsMYe,5u8sNkb2oEQjUXJAB3yGStmv3Uwz16gBgExBo5myVK4b,True,85886044,21471511,134255,67127,67128,DddJ7EWCmYEEZETCBNgAUSg81Ls6fZtiAaY5ekJ5sXx1,5370232,19511634,-14141402,625
2022-01-05 22:00:36-05:00,1646,EV21gv8jEvXtmGDoGRNm5LJEvTBccLMZyVDCLsp54jP3,DGxxoU52aQNoUQcxdvQtv2H5q2PhK6TGkLgNSaFgnZrb,True,52054262,13013565,81432,40716,40716,3zqXX6kzhkbW3d4TwD2CNjMRwxTbREXySekvq37kfCNk,3257309,13436575,-10179266,625
2022-01-05 22:02:08-05:00,1647,Mcbzp1LhZwpfmXTv1pqe9D1jCKHw443j9QKp6tUpzgM,8uforSMAKEih5jHfHp3gCqCvaugtCmhzVfVHA63Akz7F,True,23277773,5819443,36421,18210,18211,3zqXX6kzhkbW3d4TwD2CNjMRwxTbREXySekvq37kfCNk,1456842,7839238,-6382396,625
2022-01-05 22:02:39-05:00,1648,8VT2nxz5ZYDJFd9uL2XZwEXxChd9pjuMJNMAcutZubL1,EhAkiRbouzUAWtqQFsN8HEEfi46UVN8H8tyBP7CbgeLe,True,107015,26753,167,83,84,3zqXX6kzhkbW3d4TwD2CNjMRwxTbREXySekvq37kfCNk,6697,31109,-24412,625
2022-01-05 22:07:26-05:00,1649,7LRBswSEDBjJzQ4YurfTxLydh7tFS2jVn5V95Z6wL7ci,fD41VYGmk66MW46KKb23vAqQvUSDScgXnVdsHhJBZzu,True,1373955,343488,2143,1071,1072,4BnQKPLuE3DMTtxp8MjUBytgnhvxqq3ZTqZHTVZo4JJh,85740,420384,-334644,624
2022-01-05 22:08:02-05:00,1650,CFFpbRxYEP18rqEGxxyG3bzSV13Lv7nfSmZvtUK17kCP,824UwqH2JcFsqYBk9MZ8tTnpka9udTL6WGX35YFtAJQk,True,41327207,10331801,64621,32310,32311,DddJ7EWCmYEEZETCBNgAUSg81Ls6fZtiAaY5ekJ5sXx1,2584849,9823221,-7238372,625
2022-01-05 22:08:02-05:00,1651,5hUZ9uQFcYnjAQVVaGLJWdKyg7y1XMpoo8osQ9DeY7Xd,BdYiKWsjuzJLcHh3814mJ4xQ9JxoQKKcr7AHZ7Vxoavq,True,472698,118174,738,369,369,3zqXX6kzhkbW3d4TwD2CNjMRwxTbREXySekvq37kfCNk,29543,119260,-89717,624
2022-01-05 22:09:22-05:00,1652,Buioe5v3DyFwD9nquW5XdYeVYbSABCyg79eUHEvtvfaW,7T9gi7prCcZJkYJMSB5Ef6Bu4pAuBw4XLvumSFnqKDSi,True,7598180,1899545,11888,5944,5944,4BnQKPLuE3DMTtxp8MjUBytgnhvxqq3ZTqZHTVZo4JJh,475529,2741765,-2266236,625
2022-01-05 22:10:07-05:00,1653,CEbGTNX6WpaoKp4RBGSn9LzYM6yAYyeiMrgVYgJxA4zb,AiXUcGAFFm4tc7vKBscSNjZawV5YJqbv7D1KpxD3Zufg,True,212834867,53208716,333063,166531,166532,DddJ7EWCmYEEZETCBNgAUSg81Ls6fZtiAaY5ekJ5sXx1,13322551,76595068,-63272517,625
2022-01-05 22:10:13-05:00,1654,3zH1b58jqbNU37y9kDTZZrotSeT8XzS1tuyAHPKWrbah,4trxDWV16x6sVcz7bxHehYHkjjyKebh3S9fyJf8txzK5,True,81250,20312,127,63,64,4BnQKPLuE3DMTtxp8MjUBytgnhvxqq3ZTqZHTVZo4JJh,5083,18811,-13728,625
2022-01-05 22:10:14-05:00,1655,FjDp4bWCtqehFD7FunCrjrcdxMezTJj5aqh2VnBvHDQU,HRYeZqcqhP1RPiAGXziR1qCWwk4sF6c5ZYbvSDhX7foN,True,86095910,21523977,134679,67339,67340,DddJ7EWCmYEEZETCBNgAUSg81Ls6fZtiAaY5ekJ5sXx1,5387177,19281267,-13894090,625
2022-01-05 22:10:23-05:00,1656,EgU9hX6VK7YXeCgCHVaJAMekCcyZa2MVWdKra5pN7Gwv,7y8Ad9XY34bqREvheXHT2tr8Jy11D6X3pu7yLVtjU4QV,True,106267161,26566790,165537,82768,82769,3zqXX6kzhkbW3d4TwD2CNjMRwxTbREXySekvq37kfCNk,6621488,32950599,-26329111,623
2022-01-05 22:10:28-05:00,1657,3g1debT8Z2efQPuMNSDPUNZzDqarBG2acErsZ4HP7QGA,42wDHagxr5Nno3mUx6kyYGDjwR98aedRbh3ByB468agB,True,202892,50723,316,158,158,4BnQKPLuE3DMTtxp8MjUBytgnhvxqq3ZTqZHTVZo4JJh,12652,48778,-36126,623
2022-01-05 22:10:29-05:00,1658,EEcTbsFTUEifcdbPyjBLkS943daEx1RpR8F3uZxKRZbT,8V3JzDQ1VWYQLas8fxUsWJZZHe4gEmn74RehtUwLw3k5,True,57412278,14353069,89763,44881,44882,DddJ7EWCmYEEZETCBNgAUSg81Ls6fZtiAaY5ekJ5sXx1,3590559,17641358,-14050799,625
2022-01-05 22:10:46-05:00,1659,H6tDNj9cHac223ckAnNfnC4bAJuNLBnf2pFk2iQdMzMP,28UL9dqgayCqCAexScXjdpobYGVDN44SGBVNAfBByk8C,True,717562909,179390727,1122206,561103,561103,3zqXX6kzhkbW3d4TwD2CNjMRwxTbREXySekvq37kfCNk,44888248,264166114,-219277866,625
2022-01-05 22:10:51-05:00,1660,4FazDUgfQ3AKoFcnWHr8E9Ht8jLA3tkxf75yrGZVHdmF,HzRMH6mbgEKydRCnnMvSsKgTEVNQi6nuzoR1xutYFdzg,True,657305,164326,1027,513,514,3zqXX6kzhkbW3d4TwD2CNjMRwxTbREXySekvq37kfCNk,41089,332290,-291201,625
2022-01-05 22:11:17-05:00,1661,2ce2v2TCbjNH635NgbwTG3sqiRWYrRRaBpxPxBZJ929q,9cnoebT43FkWDFhidndGCVNiFD4NErv8DuL1Va4Jv9S8,True,64507704,16126926,100900,50450,50450,4BnQKPLuE3DMTtxp8MjUBytgnhvxqq3ZTqZHTVZo4JJh,4036036,35401213,-31365177,625
2022-01-05 22:11:49-05:00,1662,9gYrMXAGmGSV4VFjXzYP5WwH2aFpB1TxA6CqpYsosKLv,Dh8aH6RK48wu4fkT9xKw5XL7itxnPDuw3SDwPwvL5sva,True,283787,70946,443,221,222,4BnQKPLuE3DMTtxp8MjUBytgnhvxqq3ZTqZHTVZo4JJh,17747,68042,-50295,625
2022-01-05 22:21:11-05:00,1663,ECuu1L4QGdemZ7FjAjVAAxYN6piinweY7Fuk5csVovfT,Amd8WGcpdtB8yoA83R1BUT5uryuqoKbcBexYacbrbGVX,True,32704123,8176030,51150,25575,25575,4BnQKPLuE3DMTtxp8MjUBytgnhvxqq3ZTqZHTVZo4JJh,2046036,6699452,-4653416,625
2022-01-05 22:30:11-05:00,1664,BxXXWywnC3dSyLPJHt7owfBhgSiBWzkuD3T8hGYLqCH6,4vuwEBXXbXFMPmbJJJRop4FCWGyKR1sXhBc3EWF6MiB8,True,1018504539,254626134,1581317,790658,790659,DddJ7EWCmYEEZETCBNgAUSg81Ls6fZtiAaY5ekJ5sXx1,63252700,379019362,-315766662,621
2022-01-05 22:30:11-05:00,1665,7W6ih2ZGXaE6tvuQFUPCvc7NvEJHy7UffgoVX3ZPdLXt,6uQCkeMjEXHBQxE2HD33RM1zyTsSko1fYZA1mWUggJ5B,True,275075,68768,426,213,213,3zqXX6kzhkbW3d4TwD2CNjMRwxTbREXySekvq37kfCNk,17062,69744,-52682,620
2022-01-05 22:30:13-05:00,1666,HhwiZPKZBGa16oVi739s4qtMDMTwzWXc7iwNfX63t2UP,5AnbMbAFKy85yHt5y2M5S38nNkA1vT4ejY5NjGbRNUqn,True,14804825,3701206,23048,11524,11524,DddJ7EWCmYEEZETCBNgAUSg81Ls6fZtiAaY5ekJ5sXx1,921929,6137828,-5215899,622
2022-01-05 22:30:15-05:00,1667,AGhvB6x3gmvAJSnr9UVtvhKqVg3Qgh1k4roHzrNHhAaa,HhhjXT6WJnz1HQfHcwKdBppuAhc8ncUcq1mkJ4EHqgpe,True,67540,16885,105,52,53,DddJ7EWCmYEEZETCBNgAUSg81Ls6fZtiAaY5ekJ5sXx1,4215,17249,-13034,624
2022-01-05 22:32:21-05:00,1668,GH6Q9E1jZPTTp46aDd57UNZPNS2D6PBSwyLL3EHSjGn2,2XvwZXNsrPWx4EfPvhTP933bzCC3SJHDQ8xARfrXdVY9,True,211007840,52751960,329487,164743,164744,DddJ7EWCmYEEZETCBNgAUSg81Ls6fZtiAaY5ekJ5sXx1,13179488,131422420,-118242932,624
2022-01-05 22:33:07-05:00,1669,5jin5wXjQQ25nGM2ECrCXcg1a95vquh6kM7rMRru6Ke7,EKM657EQ8HWWgf4cssByoYHoXGjFfTspTKXAGmygAPQG,True,401793804,100448451,627640,313820,313820,4BnQKPLuE3DMTtxp8MjUBytgnhvxqq3ZTqZHTVZo4JJh,25105608,124779814,-99674206,624
2022-01-05 22:48:37-05:00,1670,6u6bPgAmK8ufACrQV99A1Y5nhGkue3KEUHmQQkcNkxwP,7636yXT5w4DcVpc7LJdN46aiggzSq6U2GXHXL5kyy9F3,True,1266844280,316711070,1981664,990832,990832,GAUsoe8ZTCiGPm2hYxRPGxcPe5ShNzHK9eE3G2zgRjxd,79266587,392125341,-312858754,625
2022-01-05 22:48:49-05:00,1671,3njiRuSRMXRzKmamyiR72Hc38PU8UDDmWdfPhgxmGxEW,5WoF3gkgygyNNbwxWgVfqGWkExcDixuzgJQQjXEZQ6J5,True,2723973823,680993455,4260826,2130413,2130413,GAUsoe8ZTCiGPm2hYxRPGxcPe5ShNzHK9eE3G2zgRjxd,170433049,1317215060,-1146782011,625
2022-01-05 22:49:00-05:00,1672,GGGyesjbt7h2XHHp9u8vpiWGugFwEbrtYaKrNQSDhQd7,8tydo1ZjGHmPBSqU33tywB3f9szdsHk1ckGFe4Ay5pgs,True,538945192,134736298,843447,421723,421724,GAUsoe8ZTCiGPm2hYxRPGxcPe5ShNzHK9eE3G2zgRjxd,33737885,291776423,-258038538,625
2022-01-05 22:49:00-05:00,1673,5PbrpM9kjzF4R2eW2UTcRVXnhqWdRQWHZJXKLN43N8WC,6ip4ocbyHusy8CsVvcrpiRCUp2nq9cY8bHpTcUU3Wztq,True,84550574,21137643,132214,66107,66107,3zqXX6kzhkbW3d4TwD2CNjMRwxTbREXySekvq37kfCNk,5288572,21977997,-16689425,625
2022-01-05 22:49:06-05:00,1674,6dr65yANjSMmfBeKAuSxG3i16S9vMgF1CQ3zDyzh55Pn,EhrE5QpnshD41S4zPEBy2A5q2Gs2mwUrbHGo6WnT9zDP,True,3570974,892743,5572,2786,2786,3zqXX6kzhkbW3d4TwD2CNjMRwxTbREXySekvq37kfCNk,222914,1151942,-929028,624
2022-01-05 22:49:24-05:00,1675,8MKNsuGVaoYpdQy6NNyxDvRzh2DAquBUtri4nDsixUxs,D7M1SDmpZAs8vdPCCCa96UbDF15YQDxHmoGWB57tHiir,True,44171455,11042863,69077,34538,34539,3zqXX6kzhkbW3d4TwD2CNjMRwxTbREXySekvq37kfCNk,2763087,14818965,-12055878,625
2022-01-05 22:49:27-05:00,1676,3Lv2XpiD4KBUHq7Zx6u3zNhpXoySodXHH8o8f5yaaPxG,H6TN4rhpBXkEH3mZnymYNcKfmnxRH2uzfwzeLH2q6ahP,True,1990543,497635,3062,1531,1531,DddJ7EWCmYEEZETCBNgAUSg81Ls6fZtiAaY5ekJ5sXx1,122500,520444,-397944,615
2022-01-05 22:49:27-05:00,1677,671STD1iqWBnLjDV3Up5qqccx6rFnGDq8ZVkgQQsVuFG,AyLK5BYK36wrwdAsUZQNcvFvf4JY2iToWP8j7rny6jgs,False,109976,109976,5392,269,5123,GAUsoe8ZTCiGPm2hYxRPGxcPe5ShNzHK9eE3G2zgRjxd,5392,27838,-22446,490
2022-01-05 22:49:27-05:00,1678,FpqCxvTkSiwDwD5qEt6hXJxzFDLFLAQ8VevK8zwRqYun,A3p6YQisCJKpNkF7vkjZRbEfbnUt7vTZdR2zPBUSdTkk,True,4373919606,1093479901,6733056,3366528,3366528,3zqXX6kzhkbW3d4TwD2CNjMRwxTbREXySekvq37kfCNk,269322276,895402670,-626080394,615
2022-01-05 22:49:29-05:00,1679,2FrqGFZjbiNykJyo9BZ5S9FguQJPJiTi681rJJsQ5dta,3QUncYP92NKrfpaTvuF9iQg11PXKgZAgEngwh6BbnCCj,True,8804315,2201078,13756,6878,6878,GAUsoe8ZTCiGPm2hYxRPGxcPe5ShNzHK9eE3G2zgRjxd,550256,2160359,-1610103,624
2022-01-05 22:49:29-05:00,1680,Fd2HrzBAr4JobRPARZwpQHHVoSCEoog32A6tKMWAC1sK,BYappsar5sQf8VLem4wrLuTtrDFH9y8pEx1aMxfuU4Pq,True,320990703,80247675,501315,250657,250658,4BnQKPLuE3DMTtxp8MjUBytgnhvxqq3ZTqZHTVZo4JJh,20052632,99726900,-79674268,624
2022-01-05 22:49:30-05:00,1681,DAku12iueL13vRoTpKLyqdGaLQ2rWF6REe8Dr8soFvNs,H2vVH3LxkhGe6x6Mdwy67BYwTKNQM6XayKx7mhrwyfJM,True,4753137,1188284,7362,3681,3681,GAUsoe8ZTCiGPm2hYxRPGxcPe5ShNzHK9eE3G2zgRjxd,294498,1541363,-1246865,619
2022-01-05 22:49:30-05:00,1682,8NdcaYUC1X5CP7FMDip78uqtqmCt8GcZdCzLRTYTihmb,9Ei1K9bXWXSXcBfeX5exPSXGCAu62WSKzvnnd4wHvyVh,True,1400459,350114,2188,1094,1094,4BnQKPLuE3DMTtxp8MjUBytgnhvxqq3ZTqZHTVZo4JJh,87537,374263,-286726,625
2022-01-05 22:49:30-05:00,1683,6eBSLXDMVoW2nG3n7s42RXDH8byY3C6n1RsUuegBLSrG,37dYrKnTXYer7Bu9xFfpArA4ZNo2B9bycFw9HywDtTRx,True,105704669,26426167,164307,82153,82154,GAUsoe8ZTCiGPm2hYxRPGxcPe5ShNzHK9eE3G2zgRjxd,6572307,31408485,-24836178,621
2022-01-05 22:50:11-05:00,1684,F2v1YwVAwXLiUgsJ5uwn4qAAkTXitn1E75fJcPnGuAcy,5rdJ4H5GxPg4Juu77mGc7uya5LwEqLzDSRyG8mQ2mDbK,True,205472519,51368129,319461,159730,159731,DddJ7EWCmYEEZETCBNgAUSg81Ls6fZtiAaY5ekJ5sXx1,12778447,63938356,-51159909,621
2022-01-05 22:50:13-05:00,1685,8RmB8o4zux2sD48dEsKpsX475KRxTwdk8QULUDU9xx8R,AKSiZnb4YKVB6B86aPPqvyXquhvN9xqt45bexBCZ7nx,True,675035488,168758872,1050996,525498,525498,4BnQKPLuE3DMTtxp8MjUBytgnhvxqq3ZTqZHTVZo4JJh,42039873,255590285,-213550412,622
2022-01-05 22:50:14-05:00,1686,6yw4GPvkqUbakcEWtqSCfjVLukty11xqjDpGxtEN9Km2,5ppEx7wkpqbG5nApCWMdRja3oRSheFmAAsNHUX7h2w2Y,True,17597545,4399386,27505,13752,13753,4BnQKPLuE3DMTtxp8MjUBytgnhvxqq3ZTqZHTVZo4JJh,1100234,11466691,-10366457,625
2022-01-05 22:50:14-05:00,1687,EmGW2aAG69ssWqCtbfDocRaM2u3TJsczn2HHP9jdmRvD,aypkDKsp9uqAB4F6mwvm5LofpsrFBuZT2MMWtE2eHdB,True,6880076,1720019,10736,5368,5368,4BnQKPLuE3DMTtxp8MjUBytgnhvxqq3ZTqZHTVZo4JJh,429454,1986030,-1556576,624
2022-01-05 22:50:14-05:00,1688,AHm7zF4rpaxaayBLn5QDHgJSp8KAr647s4cNvQ9wLgd7,FDM33WngED24pukBvSDpPAzinW6afVAeGReum5nyLRiC,True,8824235,2206058,13799,6899,6900,4BnQKPLuE3DMTtxp8MjUBytgnhvxqq3ZTqZHTVZo4JJh,551961,2880007,-2328046,625
2022-01-05 22:50:15-05:00,1689,ANQkPUoMjLHyRtypeKzxsKW1DFauQsh9SnB3rRgRXM1Y,7RHAExWpG8Q3PXwKhJs2yXmYK9WogGydvFYpx28p6pgr,True,773580103,193395025,1209649,604824,604825,GAUsoe8ZTCiGPm2hYxRPGxcPe5ShNzHK9eE3G2zgRjxd,48385978,298266029,-249880051,625
2022-01-05 22:56:11-05:00,1690,67Z7ZGhNu5xxEh9BYKWcXp9m1T4tFiE1o1M16hCzUWQA,CT7YKWixz7BhTbvg5F6M5HCyPGnHoFLNFuDV9GhoLTo3,True,34776123,8694030,54365,27182,27183,GmqQKnMfFxkv6ChqGaZ2wmSFDow7R1x7WeRfU58GVvfw,2174609,13446242,-11271633,625
2022-01-05 22:56:11-05:00,1691,E8ifvhmyJGBGVQomo3AnZw2UcaLHcpGsTtuoCid8voU3,FMQUWTbTAfSLfrc6GTrz4DM2ZSgoxF3KtqGn8AyjVtsf,True,75736192,18934048,117578,58789,58789,DddJ7EWCmYEEZETCBNgAUSg81Ls6fZtiAaY5ekJ5sXx1,4703126,15145279,-10442153,620
2022-01-05 22:56:11-05:00,1692,2VyFcgZDH1HTEvD1XaWhwqBCMmZ1k6TmZ3fEpPcBZR9E,G1wFJETTpdoc7CfypGCzkq1jssXPfUkiuLjK2cwVZ9dJ,True,857938,214483,1335,667,668,DddJ7EWCmYEEZETCBNgAUSg81Ls6fZtiAaY5ekJ5sXx1,53439,278941,-225502,622
2022-01-05 22:56:14-05:00,1693,CvZssqscu2dm35mwcE3zg9zedavbRjVJjWD59Py5ExUK,7pXaoR6aHKYofCmg1eHipygNYDteEaf8rbbS8BDYGQK6,True,7490600,1872650,11716,5858,5858,4BnQKPLuE3DMTtxp8MjUBytgnhvxqq3ZTqZHTVZo4JJh,468670,1529873,-1061203,625
2022-01-05 22:56:21-05:00,1694,pgzvXpnUYiY7hLrfjmwScqLd8oj9vYcXpFvpm4y4JvG,GdqdQgoyBAFuXdbvoZyDhB3jyqJzVo4nkGh7EPFxkBF2,True,22553925,5638481,35175,17587,17588,4BnQKPLuE3DMTtxp8MjUBytgnhvxqq3ZTqZHTVZo4JJh,1407032,14814189,-13407157,623
2022-01-05 22:58:23-05:00,1695,Ckqos6cdncPKj13DnCmDVZsZTqp6eS7277CRrT9WhcEr,AtUV8m7VQJvZq7GLCAHMf3jV7iamKEPnWVZHWuuVZQp1,True,13275283,3318820,20767,10383,10384,4BnQKPLuE3DMTtxp8MjUBytgnhvxqq3ZTqZHTVZo4JJh,830691,5492103,-4661412,625
2022-01-05 22:58:23-05:00,1696,CRaKcudjkQiSw5YPVjTLVdXvJskeGiHSYtq5ZcMPJhgQ,AgqTg3b3bAcaBmRidhNC4Uf9ZwNbeH52RQEqumWyuUs7,True,9257383,2314345,14418,7209,7209,GAUsoe8ZTCiGPm2hYxRPGxcPe5ShNzHK9eE3G2zgRjxd,576754,3832310,-3255556,623
2022-01-05 22:58:29-05:00,1697,9vcKW1GfrDZ3KLPh2pEVFF8ZyKqD1pJW1hiE8H98Av7S,C6Ki27mo4sCHu6u8UnR1p7WSgsTjFQxGGR9Lk9n5Rhjq,True,29702072,7425518,46480,23240,23240,DddJ7EWCmYEEZETCBNgAUSg81Ls6fZtiAaY5ekJ5sXx1,1859214,9092613,-7233399,625
2022-01-05 22:58:55-05:00,1698,HVZkXeDR3mc8oB9qFFwCK4RXpPojdcHk9tRGep6xtKGK,Bh3py7awPejWqeTMxtAgF7mPotL2Asxf8YrYJykq9nBt,True,70487970,17621992,110279,55139,55140,GAUsoe8ZTCiGPm2hYxRPGxcPe5ShNzHK9eE3G2zgRjxd,4411172,18304390,-13893218,625
2022-01-05 22:59:21-05:00,1699,BQBQicboM5o25LihnffqxcJmoPoA3mgBKNeG4H8UTHVh,E8rJFAs7dbDmQA1o5aTeNqdmADxWMd5cDzvwAGMFFCix,True,16159043,4039760,25264,12632,12632,GAUsoe8ZTCiGPm2hYxRPGxcPe5ShNzHK9eE3G2zgRjxd,1010595,9435870,-8425275,625
2022-01-05 22:59:43-05:00,1700,3qnPsgqW11AcDEmyjmJquPcPLyE3EdJQuVLJ5kinDrd3,86rZadBB7emKio76aFTahpbrFtxd9tqZ4Mxgzaavq2xU,True,1688448,422112,2640,1320,1320,GAUsoe8ZTCiGPm2hYxRPGxcPe5ShNzHK9eE3G2zgRjxd,105629,442183,-336554,625
2022-01-05 23:00:01-05:00,1701,7PzGZgzieFyyFs1dbajkNQgVxooFUNZrj1bUsQvrSwbp,A2gDREmSmJTBPPw3sbKVY3smC9wbHMDdv87gr4Tr2ES7,True,30381846,7595461,47449,23724,23725,4BnQKPLuE3DMTtxp8MjUBytgnhvxqq3ZTqZHTVZo4JJh,1897995,7969894,-6071899,624
2022-01-05 23:00:05-05:00,1702,BrHRMouGRz3LBNzd9anfdYMhWfg8yUPHL4PqJ8WdEDFS,4uzoLa3mC2VYHAPBoHLX4gTjPTC28rPf2fvEGtJWPYc,True,650066663,162516665,1016297,508148,508149,3zqXX6kzhkbW3d4TwD2CNjMRwxTbREXySekvq37kfCNk,40651899,383892881,-343240982,625
2022-01-05 23:00:05-05:00,1703,B4Uc39nKzz9wBRQsCkMR4A7RwTJ8rSuwpR6EQn2AesRb,H49bGZgatRZVpj6QufZRVgYrQtH7LpdbiqKBs23151m,True,276477561,69119390,431421,215710,215711,3zqXX6kzhkbW3d4TwD2CNjMRwxTbREXySekvq37kfCNk,17256857,183767760,-166510903,624
2022-01-05 23:00:08-05:00,1704,HGJoZvLakWfSDFwuvShNBc4kCf7nP7VqzyM3mELpbFEf,12Qn5jin7QvsBngXqYAv4UstyG3b6nRf1jsLp9Dp8G7k,True,173254405,43313601,271088,135544,135544,DddJ7EWCmYEEZETCBNgAUSg81Ls6fZtiAaY5ekJ5sXx1,10843523,48507008,-37663485,625
2022-01-05 23:00:23-05:00,1705,CagSUfZLwXuCdypC4KzU6FSNdmCj9dKDroPcNeaRtsyt,yxw5d1ztZuEUY2QjL7eLpr72QJAj5rJd6ERvg91cy1m,True,17262486,4315621,26666,13333,13333,DddJ7EWCmYEEZETCBNgAUSg81Ls6fZtiAaY5ekJ5sXx1,1066662,3794076,-2727414,617
2022-01-05 23:00:23-05:00,1706,2FEbsetZMkRqLjSC8GBbgecKgX5T1T1fci2sLQux29p8,H722Fcd6DkTFRZxqQWbPDufBfXEgmFfhiEpQZWhxwYv1,True,51561411,12890352,79816,39908,39908,3zqXX6kzhkbW3d4TwD2CNjMRwxTbREXySekvq37kfCNk,3192667,11621256,-8428589,619
2022-01-05 23:00:25-05:00,1707,8xQ3tsWVUe75EG1HmocULJ3kh52utveoFMEPotTGrKno,i3SKW3ywrwYucX9ySEx1C4zaUKGnzLerP3V38437NyV,True,657490847,164372711,1027140,513570,513570,GAUsoe8ZTCiGPm2hYxRPGxcPe5ShNzHK9eE3G2zgRjxd,41085622,188152261,-147066639,624
2022-01-05 23:00:25-05:00,1708,BPsM1um9ZJf7eNoVMsQCRSwgARMuLCGGSDxf9tZeNeEy,BpzDdXfxVygiSYSmsHV6uPxQMeTFtrURMCCqhswQjd5X,True,12868253,3217063,20009,10004,10005,GAUsoe8ZTCiGPm2hYxRPGxcPe5ShNzHK9eE3G2zgRjxd,800381,2930617,-2130236,621
2022-01-05 23:00:25-05:00,1709,ymyzGH4Qc7HH5PbKpVphCbsQgLLXyGkPcXamQJuNj5C,8oTLHaV2XzbKXNWRuUjCfHjUn61Pw93LYK14m9q2VDpZ,True,146788071,36697017,226425,113212,113213,3zqXX6kzhkbW3d4TwD2CNjMRwxTbREXySekvq37kfCNk,9057012,32248941,-23191929,617
2022-01-05 23:00:25-05:00,1710,FV9CBGGTbppLnBKh79f2LzD1diTiS5g6u89FcpZHZmnK,Fe7mtmCUziFqbbYTvrhAcAq1Ub7YLfTJRtQ1hG7GzJD1,True,58075179,14518794,90849,45424,45425,4BnQKPLuE3DMTtxp8MjUBytgnhvxqq3ZTqZHTVZo4JJh,3633981,13078802,-9444821,625
2022-01-05 23:00:26-05:00,1711,BYvjENe16Ta77PqGV7JKEWrsqCTfkMGYwTSG5gXneDvd,EvxAXgvhPC6QkNurbK7vWyTApGo8J2R4EgMAknkHVU3d,True,32997300,8249325,51452,25726,25726,GAUsoe8ZTCiGPm2hYxRPGxcPe5ShNzHK9eE3G2zgRjxd,2058105,14056278,-11998173,623
2022-01-05 23:00:26-05:00,1712,GqAS41YJssg9aaEp3hs3sG98APCsXhiQBQszXaSjZ2bN,2wodJ3AhrXdE1T4oVL95KvoBND7PubG5Wd5GWiLCMZJU,True,2026894098,506723524,3132819,1566409,1566410,GAUsoe8ZTCiGPm2hYxRPGxcPe5ShNzHK9eE3G2zgRjxd,125312761,1207945728,-1082632967,618
2022-01-05 23:01:02-05:00,1713,3WcJUt8jQ1ngL3ZCGo6dFrc3GmTMTYtzeDva7mri2Tqx,HeG1Pz2oMjqtkfsRMsbqP3VpatnVEQzcWmKDVoFp4Htr,True,173271548,43317887,271105,135552,135553,4BnQKPLuE3DMTtxp8MjUBytgnhvxqq3ZTqZHTVZo4JJh,10844239,48490582,-37646343,625
2022-01-05 23:01:06-05:00,1714,36ByQojnxEckWdQTjqHfxKqCx9yjqWQsPsZyqaN72UWR,AZoirtS1fjX61agRM64tqThVinnJTh3BWgiHyNHPTgZP,True,8941245,2235311,13938,6969,6969,GAUsoe8ZTCiGPm2hYxRPGxcPe5ShNzHK9eE3G2zgRjxd,557554,3220634,-2663080,623
2022-01-05 23:04:16-05:00,1715,6Bq55LtGCEeGqh4JrFLCmmGc2iJfTTBJixivqH78aGSE,DSNrCgWJeNe2P9tAQu5FvCueTzNKDKds7wzuwTQSMRG,True,73230757,18307689,113404,56702,56702,GAUsoe8ZTCiGPm2hYxRPGxcPe5ShNzHK9eE3G2zgRjxd,4536160,16125403,-11589243,619
2022-01-05 23:04:20-05:00,1716,DR7XL3qweFyTKDatQYS2LacqGLv2368cnGuWpEpk4hSL,Fd3BYCiiQfThDJsxBUNwYTMP8eNCrnXMVzE1wpejJqXa,True,50862,12715,78,39,39,GAUsoe8ZTCiGPm2hYxRPGxcPe5ShNzHK9eE3G2zgRjxd,3136,17318,-14182,616
2022-01-05 23:04:27-05:00,1717,7vKmhLV45Q5etXhJL5ng8rxWhYSiUCDmAbGnwBPr7zcx,cP6xPeuHLnjr858QK1F9qYn7rJpEbPy7wEJHoju6oV7,True,372456571,93114142,582293,291146,291147,GAUsoe8ZTCiGPm2hYxRPGxcPe5ShNzHK9eE3G2zgRjxd,23291721,98640147,-75348426,625
2022-01-05 23:04:27-05:00,1718,7D4rFmGMPKNAF75VRPxHAhSn2wTjiW8jmth1UD22Xqq9,GQ7BrT6vsXu8tHCMm75YdxFR2r9QTCrCUbdPEZBSAg9w,True,412486837,103121709,644793,322396,322397,3zqXX6kzhkbW3d4TwD2CNjMRwxTbREXySekvq37kfCNk,25791741,85304575,-59512834,625
2022-01-05 23:05:04-05:00,1719,2PzBAkdXkrwH9VuoMALumQz86qkW7sSBQtCrHw14JUp3,D5vwWAMHVooobG2sCWv9EwtJrAFZG6cwKH4dfmA98tbt,True,22370514,5592628,34824,17412,17412,GAUsoe8ZTCiGPm2hYxRPGxcPe5ShNzHK9eE3G2zgRjxd,1392995,6019762,-4626767,622
2022-01-05 23:05:05-05:00,1720,3VdSA9CED9f5swRwHX2U15U7J6Muaq8VPnCNy9CaGDHe,2YYstfnfdYic5NWmEbcUEHpccNUVd1EhuCkExvMsoMk8,True,75365555,18841388,117417,58708,58709,3zqXX6kzhkbW3d4TwD2CNjMRwxTbREXySekvq37kfCNk,4696697,27704046,-23007349,623
2022-01-05 23:05:05-05:00,1721,5Z3ZFCA65WoWhm3okRuuziEMi7ajGAEHWUFchzBNba5S,FcomdrWidygkxMKzcsY5xELbmwC652uMci648LMTv7AB,True,106952,26738,166,83,83,GAUsoe8ZTCiGPm2hYxRPGxcPe5ShNzHK9eE3G2zgRjxd,6670,27443,-20773,623
2022-01-05 23:05:05-05:00,1722,i7TcF4weYcqgrRdH3GpndbEYxCxfcSfr9JWYrAUg1CF,BkDfknUir7PnSEW8auoB87PytycEFwyX5kT2GY4SGJJL,True,45475437,11368859,71014,35507,35507,3zqXX6kzhkbW3d4TwD2CNjMRwxTbREXySekvq37kfCNk,2840596,27670854,-24830258,624
2022-01-05 23:05:09-05:00,1723,9KD2AifD5wFD4QkHYuawXbJgLWHrfj2QPF3fT8jhGVA5,Ga9gAqmkuHbqrr31sUFPqa1xa5WNxLWJWGPUaMxQqLdj,True,14629025,3657256,22723,11361,11362,4BnQKPLuE3DMTtxp8MjUBytgnhvxqq3ZTqZHTVZo4JJh,908920,5472254,-4563334,621
2022-01-05 23:05:10-05:00,1724,DrzTARa7RK8RXoxHZPKCBqYtMC8TAUHRw8SznXRKTa5M,FYANet92VhyXkKZqqBJR4sFxuCftWb68sgQU9VHCdTJk,True,284010,71002,444,222,222,4BnQKPLuE3DMTtxp8MjUBytgnhvxqq3ZTqZHTVZo4JJh,17772,71303,-53531,625
2022-01-05 23:06:01-05:00,1725,A7SMcwnq3DewryUj1jScnAboKGnuDVcW15F3ubNcG66Y,5qLCE37FdeWLCQnkfNJViFMGNcDeiELgE3VgPbBUuDGF,True,197805457,49451364,309356,154678,154678,4BnQKPLuE3DMTtxp8MjUBytgnhvxqq3ZTqZHTVZo4JJh,12374267,66353749,-53979482,625
2022-01-05 23:06:11-05:00,1726,CK3ocyWzXQkJJZQmM6bBK4Nv6Rh3UEufjY6DvNU6gJZy,C924o4GY3p2BHLeAbFbe9SEysXqCUyD8sFu2d4NzkAV7,True,56021882,14005470,87546,43773,43773,4BnQKPLuE3DMTtxp8MjUBytgnhvxqq3ZTqZHTVZo4JJh,3501868,12469985,-8968117,625
2022-01-05 23:06:11-05:00,1727,E1wp3bmkcY3eiEYyGYwhTCsr7BZ7RfPa5DJTZFupcFwj,452hVdYkD5SDDrA6hv6DLPFvyS8PvR2P6DPNScGxWTsW,True,6931902,1732975,10833,5416,5417,4BnQKPLuE3DMTtxp8MjUBytgnhvxqq3ZTqZHTVZo4JJh,433323,1938075,-1504752,625
2022-01-05 23:06:43-05:00,1728,Cb4zhnvig11U4GcC4kqKrnDicGgPhUpfDQB1U7hP3nPa,DiRAMrKqaevGXeXg38KnhaYBERj8tNKU7oWFJvhS32kw,True,1733266,433316,2705,1352,1353,3zqXX6kzhkbW3d4TwD2CNjMRwxTbREXySekvq37kfCNk,108207,374941,-266734,624
2022-01-05 23:06:52-05:00,1729,2NHv3c4ufYGo3xNr6KXymAZJdpfURrNiCKbXZ7s82Vwo,E4NYpYgHTvSG6LqH2bBV9Q1XJ6pAzCp9FLSKMzJmYRrQ,True,222349581,55587395,347870,173935,173935,DddJ7EWCmYEEZETCBNgAUSg81Ls6fZtiAaY5ekJ5sXx1,13914823,82032862,-68118039,625
2022-01-05 23:07:15-05:00,1730,AKxRtcdpi7gWhAuL8ENj7zhgeQezzEXe9TSANE6bQoRA,2YH4vrU9deP8Cu6E8Hzf8GqKG1yVjv5pdz4FE7r5YKir,True,58837070,14709267,92042,46021,46021,DddJ7EWCmYEEZETCBNgAUSg81Ls6fZtiAaY5ekJ5sXx1,3681709,15375806,-11694097,625
2022-01-05 23:07:29-05:00,1731,89CkXnSZnr52Zsoh48efv9MQacrkB6GMtrbEpNJSyA2H,HcvRBS4Z22CpYgDNgm4TVF4AVXFDuYzBUAFcdHAwdpg4,True,25765791,6441447,40305,20152,20153,3zqXX6kzhkbW3d4TwD2CNjMRwxTbREXySekvq37kfCNk,1612213,6747301,-5135088,625
2022-01-05 23:07:38-05:00,1732,GaEpNGa8jnwSRvjzzEMYkZe1pKcr2eiZtePrqFxpABjB,5CFZHuyWbJv14zPdX5dSQDREgHrCb4vsFvB6hLiEe3Ji,True,1309283,327320,2048,1024,1024,DddJ7EWCmYEEZETCBNgAUSg81Ls6fZtiAaY5ekJ5sXx1,81934,347653,-265719,625
2022-01-05 23:07:41-05:00,1733,2rCRdyfi65rpxRRmg7knaSb8t55FuPt3h8wF4Fzhy8MM,CLVY5nSG3jTdRo7tRSKgK9DJgW6aswfWKe4tLxzsENmb,True,5414122,1353530,8452,4226,4226,4BnQKPLuE3DMTtxp8MjUBytgnhvxqq3ZTqZHTVZo4JJh,338091,1203969,-865878,624
2022-01-05 23:07:41-05:00,1734,HqtTbC1LFreGvgfpZe7nCqkNnh8GHPQKosfmc19zb1yi,E39UNiHNkwQEd5GXkCtTPqSorQSB1kLx8kjzK4jdFoi3,True,2671567197,667891799,4171025,2085512,2085513,4BnQKPLuE3DMTtxp8MjUBytgnhvxqq3ZTqZHTVZo4JJh,166841024,847429322,-680588298,624
2022-01-05 23:07:49-05:00,1735,D3mXrJzhHf8qRaoCKLschUxAFoijFCFuT6bmNZH4W7Cj,9E3Xtqw7TncXWnbhAbFJMtuNmP6WS3ooGuptzyzw7UpA,True,497027,124256,773,386,387,4BnQKPLuE3DMTtxp8MjUBytgnhvxqq3ZTqZHTVZo4JJh,30948,194607,-163659,622
2022-01-05 23:07:51-05:00,1736,2NdwSLxsGok8PczpCZj9CVX2BymNU5MvHt7hWfGetg2M,8AQbDXeA6mD9QoZBFJcYbnHvZwKNxzA9CCHLAgdSfTA3,True,91560,22890,142,71,71,DddJ7EWCmYEEZETCBNgAUSg81Ls6fZtiAaY5ekJ5sXx1,5715,32782,-27067,624
2022-01-05 23:07:58-05:00,1737,Ar5QB4VBcUyzSCG23z2QNAbrWY55NbHCr1MNN6P2GAmh,BusFGTiDrJmxzwGUxWz9b3SFF3eseqtgh2DRHqyAwyVe,True,3973342,993335,6217,3108,3109,4BnQKPLuE3DMTtxp8MjUBytgnhvxqq3ZTqZHTVZo4JJh,248712,1122630,-873918,625
2022-01-05 23:08:06-05:00,1738,4MmpDGUTyMcYEqJ1RoZ46AN2BhrBUseHaHqF8AmiTPyD,7HW2YZpYM349HMfW7u4h9ESZ1AXkwN8JcVDTNFzp9aTz,True,1031410271,257852567,1612986,806493,806493,4BnQKPLuE3DMTtxp8MjUBytgnhvxqq3ZTqZHTVZo4JJh,64519449,368597834,-304078385,625
2022-01-05 23:08:06-05:00,1739,9YEzjb49Awvedv9yNc6LG54SkGBug2RYiJwiUV13mGsS,3H8w5WCD187NWWoZMNUCzUDdxTgqrRJLga8gDzUVXBgZ,True,9422349,2355587,14738,7369,7369,4BnQKPLuE3DMTtxp8MjUBytgnhvxqq3ZTqZHTVZo4JJh,589526,4032581,-3443055,625
2022-01-05 23:08:14-05:00,1740,EQUZQWk4WLT6LFeWZs3P9AQufFcoZouFETfhyxvuS2JM,Byc2mLXArmkjQPWaxCJksHZD2XpZyCQ2FRtDJyztU81V,True,816496652,204124163,1276845,638422,638423,4BnQKPLuE3DMTtxp8MjUBytgnhvxqq3ZTqZHTVZo4JJh,51073821,320785442,-269711621,625
2022-01-05 23:08:18-05:00,1741,AtKuDfcFXqWUMnRqQpjedUMTb5CQKLc2zoqEAcQpysKQ,9bPFLYp5TDZruLLDXDYYCiPYcD982iF8xt5rfTkqwNsL,True,95568,23892,148,74,74,4BnQKPLuE3DMTtxp8MjUBytgnhvxqq3ZTqZHTVZo4JJh,5953,24012,-18059,622
2022-01-05 23:08:19-05:00,1742,J2gTwrYpzezkRupgBtgudQn5D33x6WjeBhTHnrA1qgqa,FBzoHRwqGRjnMvPEpiZVjtGZYJmAbneE4dpToXPzy8bv,True,271271943480,67817985870,421989633,210994816,210994817,4BnQKPLuE3DMTtxp8MjUBytgnhvxqq3ZTqZHTVZo4JJh,16879585350,62015671870,-45136086520,622
2022-01-05 23:08:27-05:00,1743,7LRBswSEDBjJzQ4YurfTxLydh7tFS2jVn5V95Z6wL7ci,fD41VYGmk66MW46KKb23vAqQvUSDScgXnVdsHhJBZzu,True,1007387,251846,1507,753,754,DddJ7EWCmYEEZETCBNgAUSg81Ls6fZtiAaY5ekJ5sXx1,60315,334379,-274064,598
2022-01-05 23:08:27-05:00,1744,2ce2v2TCbjNH635NgbwTG3sqiRWYrRRaBpxPxBZJ929q,9cnoebT43FkWDFhidndGCVNiFD4NErv8DuL1Va4Jv9S8,True,47419429,11854857,74106,37053,37053,GAUsoe8ZTCiGPm2hYxRPGxcPe5ShNzHK9eE3G2zgRjxd,2964267,27449538,-24485271,625
2022-01-05 23:08:27-05:00,1745,4FazDUgfQ3AKoFcnWHr8E9Ht8jLA3tkxf75yrGZVHdmF,HzRMH6mbgEKydRCnnMvSsKgTEVNQi6nuzoR1xutYFdzg,True,483102,120775,752,376,376,GAUsoe8ZTCiGPm2hYxRPGxcPe5ShNzHK9eE3G2zgRjxd,30089,258367,-228278,622
2022-01-05 23:08:27-05:00,1746,5hUZ9uQFcYnjAQVVaGLJWdKyg7y1XMpoo8osQ9DeY7Xd,BdYiKWsjuzJLcHh3814mJ4xQ9JxoQKKcr7AHZ7Vxoavq,True,346814,86703,525,262,263,DddJ7EWCmYEEZETCBNgAUSg81Ls6fZtiAaY5ekJ5sXx1,21026,96024,-74998,606
2022-01-05 23:08:27-05:00,1747,CAkknoa9UFPMEZ1KWSfqtmnL7ArVNV3HRETLwecuuXP,4cHJYv3dxA6qjcuxUkGRuL7STWobGPKtoHFD4ACUbiWq,True,89522362,22380590,134984,67492,67492,DddJ7EWCmYEEZETCBNgAUSg81Ls6fZtiAaY5ekJ5sXx1,5399380,23366160,-17966780,603
2022-01-05 23:08:27-05:00,1748,8VT2nxz5ZYDJFd9uL2XZwEXxChd9pjuMJNMAcutZubL1,EhAkiRbouzUAWtqQFsN8HEEfi46UVN8H8tyBP7CbgeLe,True,78435,19608,117,58,59,3zqXX6kzhkbW3d4TwD2CNjMRwxTbREXySekvq37kfCNk,4688,24825,-20137,597
2022-01-05 23:08:27-05:00,1749,H6tDNj9cHac223ckAnNfnC4bAJuNLBnf2pFk2iQdMzMP,28UL9dqgayCqCAexScXjdpobYGVDN44SGBVNAfBByk8C,True,527270333,131817583,818958,409479,409479,3zqXX6kzhkbW3d4TwD2CNjMRwxTbREXySekvq37kfCNk,32758328,208122727,-175364399,621
2022-01-05 23:08:27-05:00,1750,EgU9hX6VK7YXeCgCHVaJAMekCcyZa2MVWdKra5pN7Gwv,7y8Ad9XY34bqREvheXHT2tr8Jy11D6X3pu7yLVtjU4QV,True,78064490,19516122,120109,60054,60055,DddJ7EWCmYEEZETCBNgAUSg81Ls6fZtiAaY5ekJ5sXx1,4804397,26187199,-21382802,615
2022-01-05 23:08:27-05:00,1751,EV21gv8jEvXtmGDoGRNm5LJEvTBccLMZyVDCLsp54jP3,DGxxoU52aQNoUQcxdvQtv2H5q2PhK6TGkLgNSaFgnZrb,True,38131365,9532841,56472,28236,28236,3zqXX6kzhkbW3d4TwD2CNjMRwxTbREXySekvq37kfCNk,2258890,10802692,-8543802,592
2022-01-05 23:08:27-05:00,1752,9jdfc9GFTecsdRuTjWFGX13niKKmeBxRgtv5j86uhSnU,HLWMShobjSkaLyXrNjgwVaUGVtbtdUSnr1XjqpXn1bLR,True,2503528,625882,3658,1829,1829,GAUsoe8ZTCiGPm2hYxRPGxcPe5ShNzHK9eE3G2zgRjxd,146353,767111,-620758,584
2022-01-05 23:08:27-05:00,1753,3g1debT8Z2efQPuMNSDPUNZzDqarBG2acErsZ4HP7QGA,42wDHagxr5Nno3mUx6kyYGDjwR98aedRbh3ByB468agB,True,149068,37267,230,115,115,DddJ7EWCmYEEZETCBNgAUSg81Ls6fZtiAaY5ekJ5sXx1,9206,39402,-30196,617
2022-01-05 23:08:28-05:00,1754,3zH1b58jqbNU37y9kDTZZrotSeT8XzS1tuyAHPKWrbah,4trxDWV16x6sVcz7bxHehYHkjjyKebh3S9fyJf8txzK5,True,59646,14911,91,45,46,3zqXX6kzhkbW3d4TwD2CNjMRwxTbREXySekvq37kfCNk,3653,15242,-11589,612
2022-01-05 23:08:28-05:00,1755,JCBhqqPQxP1Xc41sSY6e1sQKRstHhe7D1v6rLz4hp3Qp,DWMUq2bMD1jqpxHtyXDFjcAwjA27yyMRe68hGcsK143m,True,59549,14887,87,43,44,3zqXX6kzhkbW3d4TwD2CNjMRwxTbREXySekvq37kfCNk,3496,15555,-12059,587
2022-01-05 23:08:28-05:00,1756,EEcTbsFTUEifcdbPyjBLkS943daEx1RpR8F3uZxKRZbT,8V3JzDQ1VWYQLas8fxUsWJZZHe4gEmn74RehtUwLw3k5,True,42181787,10545446,65372,32686,32686,3zqXX6kzhkbW3d4TwD2CNjMRwxTbREXySekvq37kfCNk,2614905,14030452,-11415547,619
2022-01-05 23:08:28-05:00,1757,CFFpbRxYEP18rqEGxxyG3bzSV13Lv7nfSmZvtUK17kCP,824UwqH2JcFsqYBk9MZ8tTnpka9udTL6WGX35YFtAJQk,True,30320940,7580235,45991,22995,22996,3zqXX6kzhkbW3d4TwD2CNjMRwxTbREXySekvq37kfCNk,1839675,7942933,-6103258,606
2022-01-05 23:08:32-05:00,1758,FjDp4bWCtqehFD7FunCrjrcdxMezTJj5aqh2VnBvHDQU,HRYeZqcqhP1RPiAGXziR1qCWwk4sF6c5ZYbvSDhX7foN,True,63205067,15801266,96823,48411,48412,3zqXX6kzhkbW3d4TwD2CNjMRwxTbREXySekvq37kfCNk,3872942,15660429,-11787487,612
2022-01-05 23:08:32-05:00,1759,Buioe5v3DyFwD9nquW5XdYeVYbSABCyg79eUHEvtvfaW,7T9gi7prCcZJkYJMSB5Ef6Bu4pAuBw4XLvumSFnqKDSi,True,5575166,1393791,8476,4238,4238,3zqXX6kzhkbW3d4TwD2CNjMRwxTbREXySekvq37kfCNk,339053,2162200,-1823147,608
2022-01-05 23:08:32-05:00,1760,4mB2DVbQVqVk535v98Cj8SPNg1tTc3DFyY2Q7VBbY645,HXo255k3RgsTGsc4hiP6ZTXUspBTqJ37duQa5eK7tqp3,True,2330084524,582521130,3454301,1727150,1727151,3zqXX6kzhkbW3d4TwD2CNjMRwxTbREXySekvq37kfCNk,138172077,610590144,-472418067,592
2022-01-05 23:08:32-05:00,1761,CEbGTNX6WpaoKp4RBGSn9LzYM6yAYyeiMrgVYgJxA4zb,AiXUcGAFFm4tc7vKBscSNjZawV5YJqbv7D1KpxD3Zufg,True,156194718,39048679,238167,119083,119084,3zqXX6kzhkbW3d4TwD2CNjMRwxTbREXySekvq37kfCNk,9526694,60412878,-50886184,609
2022-01-05 23:08:32-05:00,1762,GJ3PbEfPK8jjrPgMmZtvN5fMSSy2dtiiAtZ8wcfgxVuc,FCUDVFb2TjDvehHE8fVBofqSykpb9W6Afc9QeHtj7te7,True,656091689,164022922,963569,481784,481785,3zqXX6kzhkbW3d4TwD2CNjMRwxTbREXySekvq37kfCNk,38542767,256653416,-218110649,587
2022-01-05 23:08:37-05:00,1763,Mcbzp1LhZwpfmXTv1pqe9D1jCKHw443j9QKp6tUpzgM,8uforSMAKEih5jHfHp3gCqCvaugtCmhzVfVHA63Akz7F,True,17055421,4263855,25352,12676,12676,4BnQKPLuE3DMTtxp8MjUBytgnhvxqq3ZTqZHTVZo4JJh,1014088,6203799,-5189711,594
2022-01-05 23:09:29-05:00,1764,5Rxuqgs4CaSKbfDXqBMFXkLTQ9dxrUjThXzoy3ouYVtK,BgvbKru66ebrGUcFFymGTmsaQv6GgcGMybiWaXqzBtwX,True,2324819,581204,3611,1805,1806,3zqXX6kzhkbW3d4TwD2CNjMRwxTbREXySekvq37kfCNk,144442,917729,-773287,621
2022-01-05 23:30:05-05:00,1765,8xvLGVeDmhVYQhN2ZpWkVG9jCrukRsNQ4926a4TMiZqa,9ciBySSjvADwp47WkETiFWZKVTFL8Hf1XvK7aSxhcgQS,True,278499000,69624750,433793,216896,216897,GmqQKnMfFxkv6ChqGaZ2wmSFDow7R1x7WeRfU58GVvfw,17351732,66173222,-48821490,623
2022-01-05 23:30:43-05:00,1766,G5NLYTLxDZfJFKsJdMeWS8Ez95ZFwR5AX4hKhnfVJvoE,AwrC3pKhTeEDr1HCTWoKWjadteZccvqcisbC7vxTjn7w,True,142004050,35501012,219369,109684,109685,3zqXX6kzhkbW3d4TwD2CNjMRwxTbREXySekvq37kfCNk,8774794,51705868,-42931074,617
2022-01-05 23:37:10-05:00,1767,JDeYjCLpfnzcfxDFgHf4aBcHsajwdR14GUaKAA9euzVf,EJbvKoyMZcoCx4vWa61uMbW2vr6mUhrgEuECdteVBuZZ,True,86648677,21662169,134983,67491,67492,GmqQKnMfFxkv6ChqGaZ2wmSFDow7R1x7WeRfU58GVvfw,5399341,33832499,-28433158,623
2022-01-05 23:39:55-05:00,1768,7CSCMFa9W52tBDVUbXbc3woAy3GByeA1wPJdp3MgznPa,3447ptuVFu6G8B6N63RmS8mRv4n9PfHneypHLvbeaGLn,True,1181094298,295273574,1847608,923804,923804,72FwbpFGoLEazJEdpqNtPNefsadUrimUqma9wSoy4qiS,73904325,337241895,-263337570,625
2022-01-05 23:40:36-05:00,1769,8trkirSQNdMmAcJdeswxs5cPjH8dD6U4eJtWiAdMsrDB,HaSzpQ45x2MipfN17U6jGBxX8tXboomVDhXNSrnEfLDr,True,36697024,9174256,57299,28649,28650,4BnQKPLuE3DMTtxp8MjUBytgnhvxqq3ZTqZHTVZo4JJh,2291969,9250037,-6958068,624
2022-01-05 23:41:07-05:00,1770,Bsr6kx1B6BSEd5UnJ7Z61M49iUb3bFrDVhiEtMVtPDF2,3CFd1pUJAJPA9fobwn4Jj2mRju1CWmoop4Mh4znypNWT,True,325356667,81339166,507261,253630,253631,4BnQKPLuE3DMTtxp8MjUBytgnhvxqq3ZTqZHTVZo4JJh,20290477,66696653,-46406176,623
2022-01-06 03:32:21-05:00,1771,6NJFN855M3Q3RLTDNo57gTgAmwPD6G2E3WvMb1m5eNCN,3YpqNnonsvXaRT4nCC3G5FZx1jjVtbDPc36LiR6WK5jR,True,843798412,210949603,1297012,648506,648506,GAUsoe8ZTCiGPm2hYxRPGxcPe5ShNzHK9eE3G2zgRjxd,51880518,322176358,-270295840,614
2022-01-06 03:32:21-05:00,1772,8swGZMrPrLAxZd7MxTbkCL13k3DmAJUw41jCp6Xo6awW,3fKnX7yTNXAT4uMmXVdTy47ALJT8h8YSD3WiBb4BGuzH,True,2576741001,644185250,4012367,2006183,2006184,4BnQKPLuE3DMTtxp8MjUBytgnhvxqq3ZTqZHTVZo4JJh,160494707,679270829,-518776122,622
2022-01-06 03:38:52-05:00,1773,9WJBnVi84E926j7xEd566WzrZJkPJWRgmEnYj9vyjuad,4dLaFS5F7TGyLdwuJLMGkz3bSL53aHzd9ZfpNmhHxXeF,True,170376243,42594060,266493,133246,133247,GAUsoe8ZTCiGPm2hYxRPGxcPe5ShNzHK9eE3G2zgRjxd,10659743,55966916,-45307173,625
2022-01-06 03:38:56-05:00,1774,HdfQweV1KuYSpWdycZbpGrUc8yMcY3ZczLn1agKXMJaf,G1Ae1PZHkANkwFnhUKS1tvdFEv8dAFeojBkezh6rUNMh,True,59398410,14849602,92938,46469,46469,4BnQKPLuE3DMTtxp8MjUBytgnhvxqq3ZTqZHTVZo4JJh,3717538,18220911,-14503373,625
2022-01-06 03:39:42-05:00,1775,8kJu5aqVSmW8FSZR9h6F75ftn9V2U9uMLBEKeqRaC855,FhVHByujkvwwtjTVpZ4mqSUqoMoBgeLUc5H7rbz3FgAt,True,979915274,244978818,1533363,766681,766682,4BnQKPLuE3DMTtxp8MjUBytgnhvxqq3ZTqZHTVZo4JJh,61334521,381419247,-320084726,625
2022-01-06 04:05:53-05:00,1776,399591e8XgY52yCMorCQ2WL6dQZTC485ZooHtmGuirhZ,JCiXAooFmKmEPQ2S7C8iSk6CLcTyrPEe1SsPSLyUGySe,True,11861401,2965350,18376,9188,9188,4BnQKPLuE3DMTtxp8MjUBytgnhvxqq3ZTqZHTVZo4JJh,735052,4622072,-3887020,619
2022-01-06 04:06:05-05:00,1777,D9VKhnfLLCrntDGFYSfoxFaY76VnHmYZ1ZbyFXdKdibz,2hRCRH2pMDyQGYcXHa8Y6BZo6FbcGZf5VJC1v8Bp6tGa,True,1018235061,254558765,1591882,795941,795941,4BnQKPLuE3DMTtxp8MjUBytgnhvxqq3ZTqZHTVZo4JJh,63675301,221994741,-158319440,625
2022-01-06 04:26:14-05:00,1778,3VdSA9CED9f5swRwHX2U15U7J6Muaq8VPnCNy9CaGDHe,2YYstfnfdYic5NWmEbcUEHpccNUVd1EhuCkExvMsoMk8,True,55433852,13858463,86357,43178,43179,GAUsoe8ZTCiGPm2hYxRPGxcPe5ShNzHK9eE3G2zgRjxd,3454308,21800379,-18346071,623
2022-01-06 04:26:14-05:00,1779,9KD2AifD5wFD4QkHYuawXbJgLWHrfj2QPF3fT8jhGVA5,Ga9gAqmkuHbqrr31sUFPqa1xa5WNxLWJWGPUaMxQqLdj,True,10760091,2690022,16694,8347,8347,GmqQKnMfFxkv6ChqGaZ2wmSFDow7R1x7WeRfU58GVvfw,667792,4301980,-3634188,620
2022-01-06 04:26:37-05:00,1780,DYCYiQFH9QHzCo3eAw1pFoDu7pzwFMo1E2WDZjVFRz5w,CPh4FWsGak1kd1WFEH9qBjNhnun3R2tHtZA57zW8ugn5,True,407720283,101930069,637762,318881,318881,GAUsoe8ZTCiGPm2hYxRPGxcPe5ShNzHK9eE3G2zgRjxd,25510495,147078611,-121568116,625
2022-01-06 04:27:03-05:00,1781,5Rxuqgs4CaSKbfDXqBMFXkLTQ9dxrUjThXzoy3ouYVtK,BgvbKru66ebrGUcFFymGTmsaQv6GgcGMybiWaXqzBtwX,True,1710588,427647,2668,1334,1334,GAUsoe8ZTCiGPm2hYxRPGxcPe5ShNzHK9eE3G2zgRjxd,106733,719726,-612993,623
2022-01-06 04:27:43-05:00,1782,36ByQojnxEckWdQTjqHfxKqCx9yjqWQsPsZyqaN72UWR,AZoirtS1fjX61agRM64tqThVinnJTh3BWgiHyNHPTgZP,True,6576906,1644225,10265,5132,5133,3zqXX6kzhkbW3d4TwD2CNjMRwxTbREXySekvq37kfCNk,410616,2536957,-2126341,624
2022-01-06 04:27:48-05:00,1783,8xvLGVeDmhVYQhN2ZpWkVG9jCrukRsNQ4926a4TMiZqa,9ciBySSjvADwp47WkETiFWZKVTFL8Hf1XvK7aSxhcgQS,True,204854947,51213736,319253,159626,159627,GAUsoe8ZTCiGPm2hYxRPGxcPe5ShNzHK9eE3G2zgRjxd,12770152,53408567,-40638415,623
2022-01-06 04:27:49-05:00,1784,3ogBPSRcKfmwzgumVDHBkXLi1eCsEFG2xzSJgD4LQDNy,7TXyqWgJqfe71MSWFA2n7ufZbUdzf7JJoWej8FNNtMXo,True,173200579,43300144,267283,133641,133642,72FwbpFGoLEazJEdpqNtPNefsadUrimUqma9wSoy4qiS,10691344,39680610,-28989266,617
2022-01-06 04:28:34-05:00,1785,G5NLYTLxDZfJFKsJdMeWS8Ez95ZFwR5AX4hKhnfVJvoE,AwrC3pKhTeEDr1HCTWoKWjadteZccvqcisbC7vxTjn7w,True,104551890,26137972,163467,81733,81734,GAUsoe8ZTCiGPm2hYxRPGxcPe5ShNzHK9eE3G2zgRjxd,6538682,40688999,-34150317,625
2022-01-06 04:30:03-05:00,1786,JDeYjCLpfnzcfxDFgHf4aBcHsajwdR14GUaKAA9euzVf,EJbvKoyMZcoCx4vWa61uMbW2vr6mUhrgEuECdteVBuZZ,True,63752230,15938057,99748,49874,49874,4BnQKPLuE3DMTtxp8MjUBytgnhvxqq3ZTqZHTVZo4JJh,3989938,26549413,-22559475,625
2022-01-06 04:35:22-05:00,1787,8xQ3tsWVUe75EG1HmocULJ3kh52utveoFMEPotTGrKno,i3SKW3ywrwYucX9ySEx1C4zaUKGnzLerP3V38437NyV,True,483514857,120878713,754935,377467,377468,GmqQKnMfFxkv6ChqGaZ2wmSFDow7R1x7WeRfU58GVvfw,30197401,150107074,-119909673,624
2022-01-06 04:35:25-05:00,1788,Bsr6kx1B6BSEd5UnJ7Z61M49iUb3bFrDVhiEtMVtPDF2,3CFd1pUJAJPA9fobwn4Jj2mRju1CWmoop4Mh4znypNWT,True,239320114,59830028,373371,186685,186686,3zqXX6kzhkbW3d4TwD2CNjMRwxTbREXySekvq37kfCNk,14934864,54440867,-39506003,624
2022-01-06 04:37:01-05:00,1789,6NJFN855M3Q3RLTDNo57gTgAmwPD6G2E3WvMb1m5eNCN,3YpqNnonsvXaRT4nCC3G5FZx1jjVtbDPc36LiR6WK5jR,True,621001989,155250497,966409,483204,483205,3zqXX6kzhkbW3d4TwD2CNjMRwxTbREXySekvq37kfCNk,38656390,253256083,-214599693,622
2022-01-06 04:38:11-05:00,1790,Dn916KSmX3HqxT53hrxrbCrV3tdRMCPdaoiRLqetMrth,ATCXRiXgnjRRUbSTPBvtBXMENCqsViexSZbZ6aDaXXWA,True,7514581,1878644,11718,5859,5859,3zqXX6kzhkbW3d4TwD2CNjMRwxTbREXySekvq37kfCNk,468751,2440791,-1972040,623
2022-01-06 04:39:09-05:00,1791,8swGZMrPrLAxZd7MxTbkCL13k3DmAJUw41jCp6Xo6awW,3fKnX7yTNXAT4uMmXVdTy47ALJT8h8YSD3WiBb4BGuzH,True,1894547017,473636754,2955707,1477853,1477854,4BnQKPLuE3DMTtxp8MjUBytgnhvxqq3ZTqZHTVZo4JJh,118228289,545582110,-427353821,624
2022-01-06 04:39:33-05:00,1792,8E3K7vCHJ2xjdFofPRGLbMxrkm8UYEi926QmXPAFwsqe,4qHUDA1c43Dg4qi1ZPKqmpGYiEMUZ6r4UuzB5ftHCEhW,True,11565970483,2891492620,18096173,9048086,9048087,GAUsoe8ZTCiGPm2hYxRPGxcPe5ShNzHK9eE3G2zgRjxd,723846924,4129364169,-3405517245,625
2022-01-06 04:54:08-05:00,1793,9WJBnVi84E926j7xEd566WzrZJkPJWRgmEnYj9vyjuad,4dLaFS5F7TGyLdwuJLMGkz3bSL53aHzd9ZfpNmhHxXeF,True,125232503,31308125,195682,97841,97841,GmqQKnMfFxkv6ChqGaZ2wmSFDow7R1x7WeRfU58GVvfw,7827299,44358573,-36531274,625
2022-01-06 04:54:27-05:00,1794,399591e8XgY52yCMorCQ2WL6dQZTC485ZooHtmGuirhZ,JCiXAooFmKmEPQ2S7C8iSk6CLcTyrPEe1SsPSLyUGySe,True,8724328,2181082,13623,6811,6812,3zqXX6kzhkbW3d4TwD2CNjMRwxTbREXySekvq37kfCNk,544953,3631948,-3086995,624
2022-01-06 04:54:31-05:00,1795,8kJu5aqVSmW8FSZR9h6F75ftn9V2U9uMLBEKeqRaC855,FhVHByujkvwwtjTVpZ4mqSUqoMoBgeLUc5H7rbz3FgAt,True,720220305,180055076,1124782,562391,562391,GAUsoe8ZTCiGPm2hYxRPGxcPe5ShNzHK9eE3G2zgRjxd,44991286,299813086,-254821800,624
2022-01-06 04:54:53-05:00,1796,D9VKhnfLLCrntDGFYSfoxFaY76VnHmYZ1ZbyFXdKdibz,2hRCRH2pMDyQGYcXHa8Y6BZo6FbcGZf5VJC1v8Bp6tGa,True,748257370,187064342,1166612,583306,583306,GAUsoe8ZTCiGPm2hYxRPGxcPe5ShNzHK9eE3G2zgRjxd,46664493,180862623,-134198130,623
2022-01-06 04:55:15-05:00,1797,9KD2AifD5wFD4QkHYuawXbJgLWHrfj2QPF3fT8jhGVA5,Ga9gAqmkuHbqrr31sUFPqa1xa5WNxLWJWGPUaMxQqLdj,True,7910071,1977517,12277,6138,6139,72FwbpFGoLEazJEdpqNtPNefsadUrimUqma9wSoy4qiS,491100,3376745,-2885645,620
2022-01-06 04:55:20-05:00,1798,3VdSA9CED9f5swRwHX2U15U7J6Muaq8VPnCNy9CaGDHe,2YYstfnfdYic5NWmEbcUEHpccNUVd1EhuCkExvMsoMk8,True,40749261,10187315,63545,31772,31773,3zqXX6kzhkbW3d4TwD2CNjMRwxTbREXySekvq37kfCNk,2541823,17127640,-14585817,623
2022-01-06 04:56:00-05:00,1799,7jvKp6onXyWgwsFrFWj4hYTXJsYYD6ot5mn6rPFuJriy,J7N6HiozevJVTiY9hDEUs2ud5BwT5QSE7wnMBS1w5ie2,True,255411920,63852979,394501,197250,197251,GAUsoe8ZTCiGPm2hYxRPGxcPe5ShNzHK9eE3G2zgRjxd,15780065,98304894,-82524829,617
2022-01-06 04:56:00-05:00,1800,2VyFcgZDH1HTEvD1XaWhwqBCMmZ1k6TmZ3fEpPcBZR9E,G1wFJETTpdoc7CfypGCzkq1jssXPfUkiuLjK2cwVZ9dJ,True,631214,157803,985,492,493,3zqXX6kzhkbW3d4TwD2CNjMRwxTbREXySekvq37kfCNk,39413,220782,-181369,624
2022-01-06 04:56:01-05:00,1801,8trkirSQNdMmAcJdeswxs5cPjH8dD6U4eJtWiAdMsrDB,HaSzpQ45x2MipfN17U6jGBxX8tXboomVDhXNSrnEfLDr,True,26988013,6747003,42109,21054,21055,3zqXX6kzhkbW3d4TwD2CNjMRwxTbREXySekvq37kfCNk,1684372,7437699,-5753327,624
2022-01-06 04:56:11-05:00,1802,9gYrMXAGmGSV4VFjXzYP5WwH2aFpB1TxA6CqpYsosKLv,Dh8aH6RK48wu4fkT9xKw5XL7itxnPDuw3SDwPwvL5sva,True,208738,52184,326,163,163,4BnQKPLuE3DMTtxp8MjUBytgnhvxqq3ZTqZHTVZo4JJh,13057,54882,-41825,625
2022-01-06 04:56:16-05:00,1803,2jDRvE3pQNjWy1NRFa4tzB3KmU5UkbUCHw8sQRFujo66,C4zNi2szDrEEh4coTF3WRUghfP4ZwAVVSYTLWfkejQRu,True,3908220025,977055005,6108642,3054321,3054321,GAUsoe8ZTCiGPm2hYxRPGxcPe5ShNzHK9eE3G2zgRjxd,244345682,884438257,-640092575,625
2022-01-06 04:56:20-05:00,1804,5Rxuqgs4CaSKbfDXqBMFXkLTQ9dxrUjThXzoy3ouYVtK,BgvbKru66ebrGUcFFymGTmsaQv6GgcGMybiWaXqzBtwX,True,1257271,314317,1959,979,980,3zqXX6kzhkbW3d4TwD2CNjMRwxTbREXySekvq37kfCNk,78395,563811,-485416,623
2022-01-06 04:57:02-05:00,1805,ECuu1L4QGdemZ7FjAjVAAxYN6piinweY7Fuk5csVovfT,Amd8WGcpdtB8yoA83R1BUT5uryuqoKbcBexYacbrbGVX,True,24054326,6013581,37611,18805,18806,4BnQKPLuE3DMTtxp8MjUBytgnhvxqq3ZTqZHTVZo4JJh,1504463,5468300,-3963837,625
2022-01-06 04:57:42-05:00,1806,BxXXWywnC3dSyLPJHt7owfBhgSiBWzkuD3T8hGYLqCH6,4vuwEBXXbXFMPmbJJJRop4FCWGyKR1sXhBc3EWF6MiB8,True,749536677,187384169,1170260,585130,585130,GAUsoe8ZTCiGPm2hYxRPGxcPe5ShNzHK9eE3G2zgRjxd,46810417,297985539,-251175122,624
2022-01-06 04:57:47-05:00,1807,7W6ih2ZGXaE6tvuQFUPCvc7NvEJHy7UffgoVX3ZPdLXt,6uQCkeMjEXHBQxE2HD33RM1zyTsSko1fYZA1mWUggJ5B,True,202431,50607,315,157,158,4BnQKPLuE3DMTtxp8MjUBytgnhvxqq3ZTqZHTVZo4JJh,12620,56008,-43388,623
2022-01-06 04:58:34-05:00,1808,AGhvB6x3gmvAJSnr9UVtvhKqVg3Qgh1k4roHzrNHhAaa,HhhjXT6WJnz1HQfHcwKdBppuAhc8ncUcq1mkJ4EHqgpe,True,49688,12422,77,38,39,3zqXX6kzhkbW3d4TwD2CNjMRwxTbREXySekvq37kfCNk,3109,13852,-10743,625
2022-01-06 04:58:38-05:00,1809,HhwiZPKZBGa16oVi739s4qtMDMTwzWXc7iwNfX63t2UP,5AnbMbAFKy85yHt5y2M5S38nNkA1vT4ejY5NjGbRNUqn,True,10891640,2722910,16983,8491,8492,3zqXX6kzhkbW3d4TwD2CNjMRwxTbREXySekvq37kfCNk,679355,4803261,-4123906,623
2022-01-06 04:59:25-05:00,1810,GjQQ2fQ7mrGjWZwjVYFUKp9NM1LmfkhEo675ovU5SPa8,ECgVUMRY5nB4MALs5drDyipF7YohCPuJpj2UegCs7HMn,True,178665028,44666257,278672,139336,139336,3zqXX6kzhkbW3d4TwD2CNjMRwxTbREXySekvq37kfCNk,11146914,46150568,-35003654,623
2022-01-06 05:00:01-05:00,1811,3njiRuSRMXRzKmamyiR72Hc38PU8UDDmWdfPhgxmGxEW,5WoF3gkgygyNNbwxWgVfqGWkExcDixuzgJQQjXEZQ6J5,True,2003523053,500880763,3133105,1566552,1566553,GAUsoe8ZTCiGPm2hYxRPGxcPe5ShNzHK9eE3G2zgRjxd,125324228,1024933247,-899609019,625
2022-01-06 05:00:02-05:00,1812,5jin5wXjQQ25nGM2ECrCXcg1a95vquh6kM7rMRru6Ke7,EKM657EQ8HWWgf4cssByoYHoXGjFfTspTKXAGmygAPQG,True,295395075,73848768,458066,229033,229033,GAUsoe8ZTCiGPm2hYxRPGxcPe5ShNzHK9eE3G2zgRjxd,18322656,99029835,-80707179,620
2022-01-06 05:00:04-05:00,1813,GH6Q9E1jZPTTp46aDd57UNZPNS2D6PBSwyLL3EHSjGn2,2XvwZXNsrPWx4EfPvhTP933bzCC3SJHDQ8xARfrXdVY9,True,155092501,38773125,239474,119737,119737,3zqXX6kzhkbW3d4TwD2CNjMRwxTbREXySekvq37kfCNk,9578973,101424981,-91846008,617
2022-01-06 05:00:05-05:00,1814,6u6bPgAmK8ufACrQV99A1Y5nhGkue3KEUHmQQkcNkxwP,7636yXT5w4DcVpc7LJdN46aiggzSq6U2GXHXL5kyy9F3,True,931507439,232876859,1447612,723806,723806,4BnQKPLuE3DMTtxp8MjUBytgnhvxqq3ZTqZHTVZo4JJh,57904515,311186725,-253282210,621
2022-01-06 05:00:08-05:00,1815,5PbrpM9kjzF4R2eW2UTcRVXnhqWdRQWHZJXKLN43N8WC,6ip4ocbyHusy8CsVvcrpiRCUp2nq9cY8bHpTcUU3Wztq,True,62192627,15548156,97141,48570,48571,4BnQKPLuE3DMTtxp8MjUBytgnhvxqq3ZTqZHTVZo4JJh,3885671,17623097,-13737426,624
2022-01-06 05:00:08-05:00,1816,HdfQweV1KuYSpWdycZbpGrUc8yMcY3ZczLn1agKXMJaf,G1Ae1PZHkANkwFnhUKS1tvdFEv8dAFeojBkezh6rUNMh,True,43668372,10917092,68328,34164,34164,3zqXX6kzhkbW3d4TwD2CNjMRwxTbREXySekvq37kfCNk,2733121,14491143,-11758022,625
2022-01-06 05:00:14-05:00,1817,6dr65yANjSMmfBeKAuSxG3i16S9vMgF1CQ3zDyzh55Pn,EhrE5QpnshD41S4zPEBy2A5q2Gs2mwUrbHGo6WnT9zDP,True,2627470,656867,4111,2055,2056,GAUsoe8ZTCiGPm2hYxRPGxcPe5ShNzHK9eE3G2zgRjxd,164453,911986,-747533,625
2022-01-06 05:00:16-05:00,1818,GGGyesjbt7h2XHHp9u8vpiWGugFwEbrtYaKrNQSDhQd7,8tydo1ZjGHmPBSqU33tywB3f9szdsHk1ckGFe4Ay5pgs,True,396429340,99107335,619843,309921,309922,3zqXX6kzhkbW3d4TwD2CNjMRwxTbREXySekvq37kfCNk,24793727,226104841,-201311114,625
2022-01-06 05:09:11-05:00,1819,3Lv2XpiD4KBUHq7Zx6u3zNhpXoySodXHH8o8f5yaaPxG,H6TN4rhpBXkEH3mZnymYNcKfmnxRH2uzfwzeLH2q6ahP,True,1466403,366600,2293,1146,1147,3zqXX6kzhkbW3d4TwD2CNjMRwxTbREXySekvq37kfCNk,91745,416709,-324964,625
2022-01-06 05:13:54-05:00,1820,6CeKxTJvFqhyNEyzySiBBKEwYVMe7j3A6nkMes4BW6o2,DzDR9XvwY1z7ygQ8YrCXrwDGHSf67JZF8BzUnuFE2fxQ,True,34360443,8590110,53745,26872,26873,4BnQKPLuE3DMTtxp8MjUBytgnhvxqq3ZTqZHTVZo4JJh,2149806,7779363,-5629557,625
2022-01-06 05:13:54-05:00,1821,FpqCxvTkSiwDwD5qEt6hXJxzFDLFLAQ8VevK8zwRqYun,A3p6YQisCJKpNkF7vkjZRbEfbnUt7vTZdR2zPBUSdTkk,True,3221976892,805494223,5037874,2518937,2518937,4BnQKPLuE3DMTtxp8MjUBytgnhvxqq3ZTqZHTVZo4JJh,201514993,729673463,-528158470,625
2022-01-06 05:14:14-05:00,1822,8MKNsuGVaoYpdQy6NNyxDvRzh2DAquBUtri4nDsixUxs,D7M1SDmpZAs8vdPCCCa96UbDF15YQDxHmoGWB57tHiir,True,32486730,8121682,50645,25322,25323,3zqXX6kzhkbW3d4TwD2CNjMRwxTbREXySekvq37kfCNk,2025811,11709598,-9683787,623
2022-01-06 05:14:20-05:00,1823,C2Dmfw4G8KKzFq38aRH2pLCRngnGZDvUUN3fHDMjFkoG,7kzJk3BTNvY3hGFNj7nDy9L5CAYus6eNiCAxWH8dSioX,True,2912200,728050,4547,2273,2274,3zqXX6kzhkbW3d4TwD2CNjMRwxTbREXySekvq37kfCNk,181887,1277393,-1095506,624
2022-01-06 05:14:21-05:00,1824,DAku12iueL13vRoTpKLyqdGaLQ2rWF6REe8Dr8soFvNs,H2vVH3LxkhGe6x6Mdwy67BYwTKNQM6XayKx7mhrwyfJM,True,3499285,874821,5468,2734,2734,3zqXX6kzhkbW3d4TwD2CNjMRwxTbREXySekvq37kfCNk,218731,1219449,-1000718,625
2022-01-06 05:14:32-05:00,1825,6eBSLXDMVoW2nG3n7s42RXDH8byY3C6n1RsUuegBLSrG,37dYrKnTXYer7Bu9xFfpArA4ZNo2B9bycFw9HywDtTRx,True,77802888,19450722,121732,60866,60866,3zqXX6kzhkbW3d4TwD2CNjMRwxTbREXySekvq37kfCNk,4869283,24972117,-20102834,625
2022-01-06 05:15:05-05:00,1826,Fd2HrzBAr4JobRPARZwpQHHVoSCEoog32A6tKMWAC1sK,BYappsar5sQf8VLem4wrLuTtrDFH9y8pEx1aMxfuU4Pq,True,236158113,59039528,369369,184684,184685,4BnQKPLuE3DMTtxp8MjUBytgnhvxqq3ZTqZHTVZo4JJh,14774776,79116189,-64341413,625
2022-01-06 05:15:05-05:00,1827,2FrqGFZjbiNykJyo9BZ5S9FguQJPJiTi681rJJsQ5dta,3QUncYP92NKrfpaTvuF9iQg11PXKgZAgEngwh6BbnCCj,True,6477419,1619354,10135,5067,5068,3zqXX6kzhkbW3d4TwD2CNjMRwxTbREXySekvq37kfCNk,405427,1738824,-1333397,625
2022-01-06 05:15:32-05:00,1828,F2v1YwVAwXLiUgsJ5uwn4qAAkTXitn1E75fJcPnGuAcy,5rdJ4H5GxPg4Juu77mGc7uya5LwEqLzDSRyG8mQ2mDbK,True,151178277,37794569,235253,117626,117627,GAUsoe8ZTCiGPm2hYxRPGxcPe5ShNzHK9eE3G2zgRjxd,9410155,50706527,-41296372,622
2022-01-06 05:15:32-05:00,1829,8NdcaYUC1X5CP7FMDip78uqtqmCt8GcZdCzLRTYTihmb,9Ei1K9bXWXSXcBfeX5exPSXGCAu62WSKzvnnd4wHvyVh,True,1029937,257484,1602,801,801,GAUsoe8ZTCiGPm2hYxRPGxcPe5ShNzHK9eE3G2zgRjxd,64105,299558,-235453,622
2022-01-06 05:15:32-05:00,1830,8RmB8o4zux2sD48dEsKpsX475KRxTwdk8QULUDU9xx8R,AKSiZnb4YKVB6B86aPPqvyXquhvN9xqt45bexBCZ7nx,True,496667835,124166958,774423,387211,387212,GAUsoe8ZTCiGPm2hYxRPGxcPe5ShNzHK9eE3G2zgRjxd,30976922,200752226,-169775304,623
2022-01-06 05:15:33-05:00,1831,EmGW2aAG69ssWqCtbfDocRaM2u3TJsczn2HHP9jdmRvD,aypkDKsp9uqAB4F6mwvm5LofpsrFBuZT2MMWtE2eHdB,True,5062082,1265520,7915,3957,3958,4BnQKPLuE3DMTtxp8MjUBytgnhvxqq3ZTqZHTVZo4JJh,316634,1582042,-1265408,625
2022-01-06 05:20:34-05:00,1832,6tFQaTqqffino9kwMZTL2xVNBG8k9VREFhXqVi2si3A3,3w3wGxBbS4bmXeqmvd595SAWFeXekVpnH4UdbeEs8Sx5,True,34360305,8590076,53733,26866,26867,GAUsoe8ZTCiGPm2hYxRPGxcPe5ShNzHK9eE3G2zgRjxd,2149357,7779052,-5629695,625
2022-01-06 05:20:35-05:00,1833,AHm7zF4rpaxaayBLn5QDHgJSp8KAr647s4cNvQ9wLgd7,FDM33WngED24pukBvSDpPAzinW6afVAeGReum5nyLRiC,True,6490588,1622647,10132,5066,5066,4BnQKPLuE3DMTtxp8MjUBytgnhvxqq3ZTqZHTVZo4JJh,405303,2278928,-1873625,624
2022-01-06 05:20:35-05:00,1834,ANQkPUoMjLHyRtypeKzxsKW1DFauQsh9SnB3rRgRXM1Y,7RHAExWpG8Q3PXwKhJs2yXmYK9WogGydvFYpx28p6pgr,True,569026041,142256510,888880,444440,444440,4BnQKPLuE3DMTtxp8MjUBytgnhvxqq3ZTqZHTVZo4JJh,35555238,234129216,-198573978,624
2022-01-06 05:20:39-05:00,1835,6yw4GPvkqUbakcEWtqSCfjVLukty11xqjDpGxtEN9Km2,5ppEx7wkpqbG5nApCWMdRja3oRSheFmAAsNHUX7h2w2Y,True,12943590,3235897,20191,10095,10096,GAUsoe8ZTCiGPm2hYxRPGxcPe5ShNzHK9eE3G2zgRjxd,807650,8837065,-8029415,623
2022-01-06 05:20:58-05:00,1836,E8ifvhmyJGBGVQomo3AnZw2UcaLHcpGsTtuoCid8voU3,FMQUWTbTAfSLfrc6GTrz4DM2ZSgoxF3KtqGn8AyjVtsf,True,55712287,13928071,86259,43129,43130,3zqXX6kzhkbW3d4TwD2CNjMRwxTbREXySekvq37kfCNk,3450384,12371897,-8921513,619
2022-01-06 05:20:59-05:00,1837,8sneA6wAg6geVDJ1g7YWg4R1PfjuRVzeHp1nUBJinhZa,14i1uWtmcTjrdbg3DSr9vzd5NBnxqsn1A4QdgFBZqeYM,True,951487,237871,1480,740,740,4BnQKPLuE3DMTtxp8MjUBytgnhvxqq3ZTqZHTVZo4JJh,59230,276924,-217694,622
2022-01-06 05:20:59-05:00,1838,9UyQC8vc6zJJaSdnjvTAzgmcsw4fC3xFBBiCC1w9Sbjx,3ppBfboe6FPmt7f6WrivspMUoAznZKWQMeh3rCgw7vjQ,True,70159591,17539897,108852,54426,54426,4BnQKPLuE3DMTtxp8MjUBytgnhvxqq3ZTqZHTVZo4JJh,4354110,14186439,-9832329,620
2022-01-06 05:21:08-05:00,1839,HAk9c831TRUhvpoK4d7PTqfJuJhSjnJUXWpnYsH85bDJ,DVSa3CJrVLTHAeFYjEF89ZjWRm86QwruUk2Y8RvGpjsr,True,190259,47564,297,148,149,4BnQKPLuE3DMTtxp8MjUBytgnhvxqq3ZTqZHTVZo4JJh,11887,62441,-50554,624
2022-01-06 05:21:08-05:00,1840,67Z7ZGhNu5xxEh9BYKWcXp9m1T4tFiE1o1M16hCzUWQA,CT7YKWixz7BhTbvg5F6M5HCyPGnHoFLNFuDV9GhoLTo3,True,25581544,6395386,39972,19986,19986,4BnQKPLuE3DMTtxp8MjUBytgnhvxqq3ZTqZHTVZo4JJh,1598891,10553176,-8954285,625
2022-01-06 05:21:08-05:00,1841,CvZssqscu2dm35mwcE3zg9zedavbRjVJjWD59Py5ExUK,7pXaoR6aHKYofCmg1eHipygNYDteEaf8rbbS8BDYGQK6,True,5510140,1377535,8616,4308,4308,GAUsoe8ZTCiGPm2hYxRPGxcPe5ShNzHK9eE3G2zgRjxd,344663,1248376,-903713,625
2022-01-06 05:21:28-05:00,1842,pgzvXpnUYiY7hLrfjmwScqLd8oj9vYcXpFvpm4y4JvG,GdqdQgoyBAFuXdbvoZyDhB3jyqJzVo4nkGh7EPFxkBF2,True,16594861,4148715,25944,12972,12972,4BnQKPLuE3DMTtxp8MjUBytgnhvxqq3ZTqZHTVZo4JJh,1037776,11413733,-10375957,625
2022-01-06 07:29:41-05:00,1843,7CSCMFa9W52tBDVUbXbc3woAy3GByeA1wPJdp3MgznPa,3447ptuVFu6G8B6N63RmS8mRv4n9PfHneypHLvbeaGLn,True,868787977,217196993,1357618,678809,678809,3zqXX6kzhkbW3d4TwD2CNjMRwxTbREXySekvq37kfCNk,54304755,268854544,-214549789,625
2022-01-06 07:29:54-05:00,1844,CRaKcudjkQiSw5YPVjTLVdXvJskeGiHSYtq5ZcMPJhgQ,AgqTg3b3bAcaBmRidhNC4Uf9ZwNbeH52RQEqumWyuUs7,True,6811908,1702977,10613,5306,5307,3pStmNaV47N2sqUtHJHLAtCKiN9JZ6jzNY9h94ng8G1D,424528,2997327,-2572799,623
2022-01-06 07:29:55-05:00,1845,FhAt6pZW3k8StP9VLeWUfidpXfRLoKWdV7Wgxdh9cRy9,Guk93pTo3KcG8konHjJ52oi9rgexmmKhPQAkxZS1BtCG,True,1428701124,357175280,2234683,1117341,1117342,DddJ7EWCmYEEZETCBNgAUSg81Ls6fZtiAaY5ekJ5sXx1,89387342,438004226,-348616884,625
2022-01-06 07:29:59-05:00,1846,M69XSefqeum2arinvHEqmA3L2XHWNFN17p4msRhRZXf,2vK15yYUANLSbAoiBfgJ9VLyqsmtEpd2iNytQjms8GaQ,True,2131498462,532874615,3333908,1666954,1666954,HfEnetJ7uBSmZWCjBNxdvv9HEC5nsW4wDV7wu6WnhWan,133356337,992857875,-859501538,625
2022-01-06 07:30:04-05:00,1847,BAzH5niE2GX9CHGn3jK6Wv8Dd59PT95dX4dgfZXWoLPT,YNRnuEoNBPFsr7W91gc85TXAdA4ZnXfF2x951zbeRKF,True,177261,44313,277,138,139,DddJ7EWCmYEEZETCBNgAUSg81Ls6fZtiAaY5ekJ5sXx1,11084,59267,-48183,625
2022-01-06 07:30:05-05:00,1848,Ckqos6cdncPKj13DnCmDVZsZTqp6eS7277CRrT9WhcEr,AtUV8m7VQJvZq7GLCAHMf3jV7iamKEPnWVZHWuuVZQp1,True,9765599,2441399,15237,7618,7619,DddJ7EWCmYEEZETCBNgAUSg81Ls6fZtiAaY5ekJ5sXx1,609483,4296408,-3686925,624
2022-01-06 07:30:07-05:00,1849,9vcKW1GfrDZ3KLPh2pEVFF8ZyKqD1pJW1hiE8H98Av7S,C6Ki27mo4sCHu6u8UnR1p7WSgsTjFQxGGR9Lk9n5Rhjq,True,21836243,5459060,33774,16887,16887,GAUsoe8ZTCiGPm2hYxRPGxcPe5ShNzHK9eE3G2zgRjxd,1350994,7216362,-5865368,618
2022-01-06 07:30:07-05:00,1850,BQBQicboM5o25LihnffqxcJmoPoA3mgBKNeG4H8UTHVh,E8rJFAs7dbDmQA1o5aTeNqdmADxWMd5cDzvwAGMFFCix,True,11884859,2971214,18481,9240,9241,3zqXX6kzhkbW3d4TwD2CNjMRwxTbREXySekvq37kfCNk,739244,7292628,-6553384,622
2022-01-06 07:30:07-05:00,1851,CBL2NbekJrXvBiAcoj4fzQ4PfLDwTntW7Zt4nruHFYEw,59EvfgYTdKkfjUJz5LddLUAqbEdLaihcMzjcrTZsyzyS,True,73540,18385,114,57,57,4BnQKPLuE3DMTtxp8MjUBytgnhvxqq3ZTqZHTVZo4JJh,4560,20254,-15694,620
2022-01-06 07:30:07-05:00,1852,HVZkXeDR3mc8oB9qFFwCK4RXpPojdcHk9tRGep6xtKGK,Bh3py7awPejWqeTMxtAgF7mPotL2Asxf8YrYJykq9nBt,True,51834790,12958697,80470,40235,40235,4BnQKPLuE3DMTtxp8MjUBytgnhvxqq3ZTqZHTVZo4JJh,3218837,14669976,-11451139,620
2022-01-06 07:30:11-05:00,1853,6oroGB3mvzK3tDfiB9X2NJuL3x476pxhgRnt7VxqhdLo,2SoK8tKkLn2ppKURpTVazKsCEis4uahkHMsac1m85J4r,True,14081245,3520311,21844,10922,10922,4BnQKPLuE3DMTtxp8MjUBytgnhvxqq3ZTqZHTVZo4JJh,873791,9290273,-8416482,620
2022-01-06 07:30:12-05:00,1854,3qnPsgqW11AcDEmyjmJquPcPLyE3EdJQuVLJ5kinDrd3,86rZadBB7emKio76aFTahpbrFtxd9tqZ4Mxgzaavq2xU,True,1241773,310443,1930,965,965,3zqXX6kzhkbW3d4TwD2CNjMRwxTbREXySekvq37kfCNk,77208,354187,-276979,621
2022-01-06 07:30:14-05:00,1855,7PzGZgzieFyyFs1dbajkNQgVxooFUNZrj1bUsQvrSwbp,A2gDREmSmJTBPPw3sbKVY3smC9wbHMDdv87gr4Tr2ES7,True,22352522,5588130,34868,17434,17434,4BnQKPLuE3DMTtxp8MjUBytgnhvxqq3ZTqZHTVZo4JJh,1394743,6382538,-4987795,623
2022-01-06 19:49:45-05:00,1856,B4Uc39nKzz9wBRQsCkMR4A7RwTJ8rSuwpR6EQn2AesRb,H49bGZgatRZVpj6QufZRVgYrQtH7LpdbiqKBs23151m,True,203425956,50856489,315843,157921,157922,GAUsoe8ZTCiGPm2hYxRPGxcPe5ShNzHK9eE3G2zgRjxd,12633726,141449879,-128816153,621
2022-01-06 19:49:45-05:00,1857,ymyzGH4Qc7HH5PbKpVphCbsQgLLXyGkPcXamQJuNj5C,8oTLHaV2XzbKXNWRuUjCfHjUn61Pw93LYK14m9q2VDpZ,True,108108957,27027239,167764,83882,83882,GAUsoe8ZTCiGPm2hYxRPGxcPe5ShNzHK9eE3G2zgRjxd,6710584,26086783,-19376199,620
2022-01-06 19:49:46-05:00,1858,2FEbsetZMkRqLjSC8GBbgecKgX5T1T1fci2sLQux29p8,H722Fcd6DkTFRZxqQWbPDufBfXEgmFfhiEpQZWhxwYv1,True,37974536,9493634,59197,29598,29599,GAUsoe8ZTCiGPm2hYxRPGxcPe5ShNzHK9eE3G2zgRjxd,2367887,9385872,-7017985,623
2022-01-06 19:49:46-05:00,1859,GqAS41YJssg9aaEp3hs3sG98APCsXhiQBQszXaSjZ2bN,2wodJ3AhrXdE1T4oVL95KvoBND7PubG5Wd5GWiLCMZJU,True,1492850507,373212626,2323886,1161943,1161943,GAUsoe8ZTCiGPm2hYxRPGxcPe5ShNzHK9eE3G2zgRjxd,92955460,932289376,-839333916,622
2022-01-06 19:49:50-05:00,1860,HGJoZvLakWfSDFwuvShNBc4kCf7nP7VqzyM3mELpbFEf,12Qn5jin7QvsBngXqYAv4UstyG3b6nRf1jsLp9Dp8G7k,True,127473125,31868281,198553,99276,99277,GAUsoe8ZTCiGPm2hYxRPGxcPe5ShNzHK9eE3G2zgRjxd,7942144,38657664,-30715520,623
2022-01-06 19:49:50-05:00,1861,CagSUfZLwXuCdypC4KzU6FSNdmCj9dKDroPcNeaRtsyt,yxw5d1ztZuEUY2QjL7eLpr72QJAj5rJd6ERvg91cy1m,True,12713310,3178327,19755,9877,9878,DddJ7EWCmYEEZETCBNgAUSg81Ls6fZtiAaY5ekJ5sXx1,790224,3069342,-2279118,621
2022-01-06 19:49:50-05:00,1862,BrHRMouGRz3LBNzd9anfdYMhWfg8yUPHL4PqJ8WdEDFS,4uzoLa3mC2VYHAPBoHLX4gTjPTC28rPf2fvEGtJWPYc,True,478286410,119571602,744046,372023,372023,GAUsoe8ZTCiGPm2hYxRPGxcPe5ShNzHK9eE3G2zgRjxd,29761873,296460205,-266698332,622
2022-01-06 19:50:27-05:00,1863,BYvjENe16Ta77PqGV7JKEWrsqCTfkMGYwTSG5gXneDvd,EvxAXgvhPC6QkNurbK7vWyTApGo8J2R4EgMAknkHVU3d,True,24289233,6072308,37922,18961,18961,4BnQKPLuE3DMTtxp8MjUBytgnhvxqq3ZTqZHTVZo4JJh,1516911,10974293,-9457382,624
2022-01-06 19:50:29-05:00,1864,BPsM1um9ZJf7eNoVMsQCRSwgARMuLCGGSDxf9tZeNeEy,BpzDdXfxVygiSYSmsHV6uPxQMeTFtrURMCCqhswQjd5X,True,9472249,2368062,14733,7366,7367,3zqXX6kzhkbW3d4TwD2CNjMRwxTbREXySekvq37kfCNk,589342,2365962,-1776620,622
2022-01-06 19:59:00-05:00,1865,FV9CBGGTbppLnBKh79f2LzD1diTiS5g6u89FcpZHZmnK,Fe7mtmCUziFqbbYTvrhAcAq1Ub7YLfTJRtQ1hG7GzJD1,True,42723286,10680821,66386,33193,33193,3zqXX6kzhkbW3d4TwD2CNjMRwxTbREXySekvq37kfCNk,2655472,10572212,-7916740,621
2022-01-06 19:59:04-05:00,1866,CwTus4FyoXYqyTKAYDp69NLhA1joYZ3tarzY6FFTr6fn,6ivuvYWU6i25MzJSY8rG9rPDKiq38E6QtrV1jvRubLGr,True,82212,20553,128,64,64,GAUsoe8ZTCiGPm2hYxRPGxcPe5ShNzHK9eE3G2zgRjxd,5120,24006,-18886,622
2022-01-06 19:59:04-05:00,1867,6Bq55LtGCEeGqh4JrFLCmmGc2iJfTTBJixivqH78aGSE,DSNrCgWJeNe2P9tAQu5FvCueTzNKDKds7wzuwTQSMRG,True,53939024,13484756,84245,42122,42123,GAUsoe8ZTCiGPm2hYxRPGxcPe5ShNzHK9eE3G2zgRjxd,3369826,13045841,-9676015,624
2022-01-06 19:59:05-05:00,1868,3WcJUt8jQ1ngL3ZCGo6dFrc3GmTMTYtzeDva7mri2Tqx,HeG1Pz2oMjqtkfsRMsbqP3VpatnVEQzcWmKDVoFp4Htr,True,127477470,31869367,198353,99176,99177,HfEnetJ7uBSmZWCjBNxdvv9HEC5nsW4wDV7wu6WnhWan,7934138,38645314,-30711176,622
2022-01-06 19:59:05-05:00,1869,DR7XL3qweFyTKDatQYS2LacqGLv2368cnGuWpEpk4hSL,Fd3BYCiiQfThDJsxBUNwYTMP8eNCrnXMVzE1wpejJqXa,True,37463,9365,58,29,29,3zqXX6kzhkbW3d4TwD2CNjMRwxTbREXySekvq37kfCNk,2327,13648,-11321,621
2022-01-06 19:59:06-05:00,1870,6rb3fRVWJ5cSzFcmuC1YwdrNxiNctvboDF7HwsfyGoCA,H6JaYfFZkRk6iSJrA4nVeuFpMVQtVwQZHVgK1TyaupTE,True,340768,85192,530,265,265,4BnQKPLuE3DMTtxp8MjUBytgnhvxqq3ZTqZHTVZo4JJh,21213,202710,-181497,622
2022-01-06 19:59:06-05:00,1871,Cs2YxkuqBK1kjoYZbUZdUcxapPbv8oC75trwGgWoCPfG,2PgHQM1GhHykE4bQ1ggueAw2Zs1BFUW5hxvMvr8DojKM,True,446268897,111567224,694340,347170,347170,4BnQKPLuE3DMTtxp8MjUBytgnhvxqq3ZTqZHTVZo4JJh,27773628,181444131,-153670503,622
2022-01-06 21:12:01-05:00,1872,E1wp3bmkcY3eiEYyGYwhTCsr7BZ7RfPa5DJTZFupcFwj,452hVdYkD5SDDrA6hv6DLPFvyS8PvR2P6DPNScGxWTsW,True,5103793,1275948,7978,3989,3989,3zqXX6kzhkbW3d4TwD2CNjMRwxTbREXySekvq37kfCNk,319139,1542838,-1223699,625
2022-01-06 21:12:01-05:00,1873,CK3ocyWzXQkJJZQmM6bBK4Nv6Rh3UEufjY6DvNU6gJZy,C924o4GY3p2BHLeAbFbe9SEysXqCUyD8sFu2d4NzkAV7,True,41247553,10311888,64476,32238,32238,4BnQKPLuE3DMTtxp8MjUBytgnhvxqq3ZTqZHTVZo4JJh,2579053,10074023,-7494970,625
2022-01-06 21:12:01-05:00,1874,2PzBAkdXkrwH9VuoMALumQz86qkW7sSBQtCrHw14JUp3,D5vwWAMHVooobG2sCWv9EwtJrAFZG6cwKH4dfmA98tbt,True,16463050,4115762,25420,12710,12710,3zqXX6kzhkbW3d4TwD2CNjMRwxTbREXySekvq37kfCNk,1016829,4801745,-3784916,617
2022-01-06 21:12:01-05:00,1875,7vKmhLV45Q5etXhJL5ng8rxWhYSiUCDmAbGnwBPr7zcx,cP6xPeuHLnjr858QK1F9qYn7rJpEbPy7wEJHoju6oV7,True,273953561,68488390,421986,210993,210993,3zqXX6kzhkbW3d4TwD2CNjMRwxTbREXySekvq37kfCNk,16879477,78780701,-61901224,616
2022-01-06 21:12:01-05:00,1876,DrzTARa7RK8RXoxHZPKCBqYtMC8TAUHRw8SznXRKTa5M,FYANet92VhyXkKZqqBJR4sFxuCftWb68sgQU9VHCdTJk,True,209017,52254,325,162,163,3zqXX6kzhkbW3d4TwD2CNjMRwxTbREXySekvq37kfCNk,13001,57141,-44140,622
2022-01-06 21:12:01-05:00,1877,5Z3ZFCA65WoWhm3okRuuziEMi7ajGAEHWUFchzBNba5S,FcomdrWidygkxMKzcsY5xELbmwC652uMci648LMTv7AB,True,78708,19677,121,60,61,4BnQKPLuE3DMTtxp8MjUBytgnhvxqq3ZTqZHTVZo4JJh,4872,21958,-17086,618
2022-01-06 21:12:01-05:00,1878,i7TcF4weYcqgrRdH3GpndbEYxCxfcSfr9JWYrAUg1CF,BkDfknUir7PnSEW8auoB87PytycEFwyX5kT2GY4SGJJL,True,33466434,8366608,51888,25944,25944,4BnQKPLuE3DMTtxp8MjUBytgnhvxqq3ZTqZHTVZo4JJh,2075555,21338413,-19262858,620
2022-01-06 21:12:01-05:00,1879,7D4rFmGMPKNAF75VRPxHAhSn2wTjiW8jmth1UD22Xqq9,GQ7BrT6vsXu8tHCMm75YdxFR2r9QTCrCUbdPEZBSAg9w,True,303397598,75849399,467273,233636,233637,3zqXX6kzhkbW3d4TwD2CNjMRwxTbREXySekvq37kfCNk,18690925,69294290,-50603365,616
2022-01-06 21:24:00-05:00,1880,BzSJ77zKaqtBk2cEL1XqFL97zTXXMRHmxtkgtXwCc3C,2g4KXTwy2MPSRQ2khNp1o1rn7CradEr9H4ySYKDoSWN9,True,63935396,15983849,100045,50022,50023,4BnQKPLuE3DMTtxp8MjUBytgnhvxqq3ZTqZHTVZo4JJh,4001819,49025026,-45023207,625
2022-01-06 21:24:00-05:00,1881,Cb4zhnvig11U4GcC4kqKrnDicGgPhUpfDQB1U7hP3nPa,DiRAMrKqaevGXeXg38KnhaYBERj8tNKU7oWFJvhS32kw,True,1275085,318771,1964,982,982,4BnQKPLuE3DMTtxp8MjUBytgnhvxqq3ZTqZHTVZo4JJh,78582,303498,-224916,616
2022-01-06 21:24:01-05:00,1882,D3mXrJzhHf8qRaoCKLschUxAFoijFCFuT6bmNZH4W7Cj,9E3Xtqw7TncXWnbhAbFJMtuNmP6WS3ooGuptzyzw7UpA,True,366000,91500,570,285,285,GmqQKnMfFxkv6ChqGaZ2wmSFDow7R1x7WeRfU58GVvfw,22814,152330,-129516,623
2022-01-06 21:24:01-05:00,1883,9jdfc9GFTecsdRuTjWFGX13niKKmeBxRgtv5j86uhSnU,HLWMShobjSkaLyXrNjgwVaUGVtbtdUSnr1XjqpXn1bLR,True,1853825,463456,2897,1448,1449,3zqXX6kzhkbW3d4TwD2CNjMRwxTbREXySekvq37kfCNk,115886,605276,-489390,625
2022-01-06 21:24:01-05:00,1884,GaEpNGa8jnwSRvjzzEMYkZe1pKcr2eiZtePrqFxpABjB,5CFZHuyWbJv14zPdX5dSQDREgHrCb4vsFvB6hLiEe3Ji,True,963569,240892,1498,749,749,GmqQKnMfFxkv6ChqGaZ2wmSFDow7R1x7WeRfU58GVvfw,59939,277623,-217684,622
2022-01-06 21:24:01-05:00,1885,2rCRdyfi65rpxRRmg7knaSb8t55FuPt3h8wF4Fzhy8MM,CLVY5nSG3jTdRo7tRSKgK9DJgW6aswfWKe4tLxzsENmb,True,3985449,996362,6201,3100,3101,4BnQKPLuE3DMTtxp8MjUBytgnhvxqq3ZTqZHTVZo4JJh,248072,972624,-724552,622
2022-01-06 21:24:01-05:00,1886,HqtTbC1LFreGvgfpZe7nCqkNnh8GHPQKosfmc19zb1yi,E39UNiHNkwQEd5GXkCtTPqSorQSB1kLx8kjzK4jdFoi3,True,1966749847,491687461,3064343,1532171,1532172,3zqXX6kzhkbW3d4TwD2CNjMRwxTbREXySekvq37kfCNk,122573737,669996199,-547422462,623
2022-01-06 21:24:08-05:00,1887,2NHv3c4ufYGo3xNr6KXymAZJdpfURrNiCKbXZ7s82Vwo,E4NYpYgHTvSG6LqH2bBV9Q1XJ6pAzCp9FLSKMzJmYRrQ,True,163578514,40894628,252989,126494,126495,3zqXX6kzhkbW3d4TwD2CNjMRwxTbREXySekvq37kfCNk,10119574,64392178,-54272604,618
2022-01-06 21:24:08-05:00,1888,2NdwSLxsGok8PczpCZj9CVX2BymNU5MvHt7hWfGetg2M,8AQbDXeA6mD9QoZBFJcYbnHvZwKNxzA9CCHLAgdSfTA3,True,67420,16855,105,52,53,DddJ7EWCmYEEZETCBNgAUSg81Ls6fZtiAaY5ekJ5sXx1,4215,25766,-21551,625
2022-01-06 21:24:08-05:00,1889,AKxRtcdpi7gWhAuL8ENj7zhgeQezzEXe9TSANE6bQoRA,2YH4vrU9deP8Cu6E8Hzf8GqKG1yVjv5pdz4FE7r5YKir,True,43292454,10823113,67113,33556,33557,4BnQKPLuE3DMTtxp8MjUBytgnhvxqq3ZTqZHTVZo4JJh,2684526,12290474,-9605948,620
2022-01-06 21:24:08-05:00,1890,89CkXnSZnr52Zsoh48efv9MQacrkB6GMtrbEpNJSyA2H,HcvRBS4Z22CpYgDNgm4TVF4AVXFDuYzBUAFcdHAwdpg4,True,18962337,4740584,29483,14741,14742,DddJ7EWCmYEEZETCBNgAUSg81Ls6fZtiAaY5ekJ5sXx1,1179334,5392663,-4213329,621
2022-01-06 21:27:36-05:00,1891,EV21gv8jEvXtmGDoGRNm5LJEvTBccLMZyVDCLsp54jP3,DGxxoU52aQNoUQcxdvQtv2H5q2PhK6TGkLgNSaFgnZrb,True,28169180,7042295,43188,21594,21594,4BnQKPLuE3DMTtxp8MjUBytgnhvxqq3ZTqZHTVZo4JJh,1727557,8564764,-6837207,613
2022-01-06 21:27:36-05:00,1892,GJ3PbEfPK8jjrPgMmZtvN5fMSSy2dtiiAtZ8wcfgxVuc,FCUDVFb2TjDvehHE8fVBofqSykpb9W6Afc9QeHtj7te7,True,484623405,121155851,733768,366884,366884,3zqXX6kzhkbW3d4TwD2CNjMRwxTbREXySekvq37kfCNk,29350741,200382667,-171031926,605
2022-01-06 21:27:36-05:00,1893,JCBhqqPQxP1Xc41sSY6e1sQKRstHhe7D1v6rLz4hp3Qp,DWMUq2bMD1jqpxHtyXDFjcAwjA27yyMRe68hGcsK143m,True,43992,10998,66,33,33,3zqXX6kzhkbW3d4TwD2CNjMRwxTbREXySekvq37kfCNk,2668,12383,-9715,606
2022-01-06 21:27:36-05:00,1894,AtKuDfcFXqWUMnRqQpjedUMTb5CQKLc2zoqEAcQpysKQ,9bPFLYp5TDZruLLDXDYYCiPYcD982iF8xt5rfTkqwNsL,True,70278,17569,107,53,54,4BnQKPLuE3DMTtxp8MjUBytgnhvxqq3ZTqZHTVZo4JJh,4294,19237,-14943,611
2022-01-06 21:27:36-05:00,1895,8VT2nxz5ZYDJFd9uL2XZwEXxChd9pjuMJNMAcutZubL1,EhAkiRbouzUAWtqQFsN8HEEfi46UVN8H8tyBP7CbgeLe,True,57942,14485,89,44,45,3zqXX6kzhkbW3d4TwD2CNjMRwxTbREXySekvq37kfCNk,3593,19582,-15989,620
2022-01-06 21:27:36-05:00,1896,6XHt7CrURSomkQrtVXV5JuKSZY4tQRpUyQKfCDaSTYaD,GCgcmPSDDBsn2smYbpiX3PJybDkQWtufPu4YRsbEEU8X,True,2130280888,532570222,3250647,1625323,1625324,3zqXX6kzhkbW3d4TwD2CNjMRwxTbREXySekvq37kfCNk,130025899,990745011,-860719112,610
2022-01-06 21:27:36-05:00,1897,Ar5QB4VBcUyzSCG23z2QNAbrWY55NbHCr1MNN6P2GAmh,BusFGTiDrJmxzwGUxWz9b3SFF3eseqtgh2DRHqyAwyVe,True,2918951,729737,4418,2209,2209,4BnQKPLuE3DMTtxp8MjUBytgnhvxqq3ZTqZHTVZo4JJh,176723,893218,-716495,605
2022-01-06 21:27:36-05:00,1898,7LRBswSEDBjJzQ4YurfTxLydh7tFS2jVn5V95Z6wL7ci,fD41VYGmk66MW46KKb23vAqQvUSDScgXnVdsHhJBZzu,True,744156,186039,1155,577,578,4BnQKPLuE3DMTtxp8MjUBytgnhvxqq3ZTqZHTVZo4JJh,46221,263155,-216934,621
2022-01-06 21:27:36-05:00,1899,9YEzjb49Awvedv9yNc6LG54SkGBug2RYiJwiUV13mGsS,3H8w5WCD187NWWoZMNUCzUDdxTgqrRJLga8gDzUVXBgZ,True,6924126,1731031,10524,5262,5262,4BnQKPLuE3DMTtxp8MjUBytgnhvxqq3ZTqZHTVZo4JJh,420964,3145893,-2724929,607
2022-01-06 21:27:36-05:00,1900,4MmpDGUTyMcYEqJ1RoZ46AN2BhrBUseHaHqF8AmiTPyD,7HW2YZpYM349HMfW7u4h9ESZ1AXkwN8JcVDTNFzp9aTz,True,757944171,189486042,1151702,575851,575851,4BnQKPLuE3DMTtxp8MjUBytgnhvxqq3ZTqZHTVZo4JJh,46068114,289749005,-243680891,607
2022-01-06 21:27:36-05:00,1901,EQUZQWk4WLT6LFeWZs3P9AQufFcoZouFETfhyxvuS2JM,Byc2mLXArmkjQPWaxCJksHZD2XpZyCQ2FRtDJyztU81V,True,600092520,150023130,913681,456840,456841,HfEnetJ7uBSmZWCjBNxdvv9HEC5nsW4wDV7wu6WnhWan,36547268,251116470,-214569202,609
2022-01-06 21:27:36-05:00,1902,Mcbzp1LhZwpfmXTv1pqe9D1jCKHw443j9QKp6tUpzgM,8uforSMAKEih5jHfHp3gCqCvaugtCmhzVfVHA63Akz7F,True,12599663,3149915,19411,9705,9706,3zqXX6kzhkbW3d4TwD2CNjMRwxTbREXySekvq37kfCNk,776473,4860662,-4084189,616
2022-01-06 21:27:43-05:00,1903,EeUACm9TkjHKES5U7Yj1oPhYmcp7R3tvesGBiP8txEzq,3qkmm4aS6EDirEDejmbm5PDw2jpYkC7zKqrMkmgeE5BA,True,1459041,364760,2229,1114,1115,4BnQKPLuE3DMTtxp8MjUBytgnhvxqq3ZTqZHTVZo4JJh,89192,340741,-251549,611
2022-01-06 21:52:46-05:00,1904,CAkknoa9UFPMEZ1KWSfqtmnL7ArVNV3HRETLwecuuXP,4cHJYv3dxA6qjcuxUkGRuL7STWobGPKtoHFD4ACUbiWq,True,66095062,16523765,102770,51385,51385,3zqXX6kzhkbW3d4TwD2CNjMRwxTbREXySekvq37kfCNk,4110825,18632681,-14521856,621
2022-01-06 21:52:52-05:00,1905,5hUZ9uQFcYnjAQVVaGLJWdKyg7y1XMpoo8osQ9DeY7Xd,BdYiKWsjuzJLcHh3814mJ4xQ9JxoQKKcr7AHZ7Vxoavq,True,255969,63992,398,199,199,3zqXX6kzhkbW3d4TwD2CNjMRwxTbREXySekvq37kfCNk,15946,76337,-60391,622
2022-01-06 21:52:52-05:00,1906,CFFpbRxYEP18rqEGxxyG3bzSV13Lv7nfSmZvtUK17kCP,824UwqH2JcFsqYBk9MZ8tTnpka9udTL6WGX35YFtAJQk,True,22377388,5594347,34854,17427,17427,3zqXX6kzhkbW3d4TwD2CNjMRwxTbREXySekvq37kfCNk,1394173,6334941,-4940768,623
2022-01-06 21:52:52-05:00,1907,Buioe5v3DyFwD9nquW5XdYeVYbSABCyg79eUHEvtvfaW,7T9gi7prCcZJkYJMSB5Ef6Bu4pAuBw4XLvumSFnqKDSi,True,4114574,1028643,6428,3214,3214,3zqXX6kzhkbW3d4TwD2CNjMRwxTbREXySekvq37kfCNk,257121,1691283,-1434162,624
2022-01-06 21:52:56-05:00,1908,8mbMH9EKd9kQDyFrYiDJCV9VaWxWCzpZBQZLyYN2yNVx,J9gT39dF1egMeQvweXYWeRAX3kpmBABijYZhfj6M2UqU,True,141835710,35458927,220952,110476,110476,3zqXX6kzhkbW3d4TwD2CNjMRwxTbREXySekvq37kfCNk,8838113,31982403,-23144290,623
2022-01-06 21:53:01-05:00,1909,CEbGTNX6WpaoKp4RBGSn9LzYM6yAYyeiMrgVYgJxA4zb,AiXUcGAFFm4tc7vKBscSNjZawV5YJqbv7D1KpxD3Zufg,True,115170149,28792537,178154,89077,89077,3zqXX6kzhkbW3d4TwD2CNjMRwxTbREXySekvq37kfCNk,7126180,47266911,-40140731,618
2022-01-06 21:53:04-05:00,1910,FjDp4bWCtqehFD7FunCrjrcdxMezTJj5aqh2VnBvHDQU,HRYeZqcqhP1RPiAGXziR1qCWwk4sF6c5ZYbvSDhX7foN,True,46602528,11650632,72484,36242,36242,3zqXX6kzhkbW3d4TwD2CNjMRwxTbREXySekvq37kfCNk,2899398,12541316,-9641918,622
2022-01-06 21:53:04-05:00,1911,3zH1b58jqbNU37y9kDTZZrotSeT8XzS1tuyAHPKWrbah,4trxDWV16x6sVcz7bxHehYHkjjyKebh3S9fyJf8txzK5,True,43971,10992,68,34,34,3zqXX6kzhkbW3d4TwD2CNjMRwxTbREXySekvq37kfCNk,2727,12184,-9457,620
2022-01-06 21:53:06-05:00,1912,EgU9hX6VK7YXeCgCHVaJAMekCcyZa2MVWdKra5pN7Gwv,7y8Ad9XY34bqREvheXHT2tr8Jy11D6X3pu7yLVtjU4QV,True,57547812,14386953,89763,44881,44882,3zqXX6kzhkbW3d4TwD2CNjMRwxTbREXySekvq37kfCNk,3590547,20628254,-17037707,623
2022-01-06 21:53:19-05:00,1913,3g1debT8Z2efQPuMNSDPUNZzDqarBG2acErsZ4HP7QGA,42wDHagxr5Nno3mUx6kyYGDjwR98aedRbh3ByB468agB,True,109860,27465,171,85,86,3zqXX6kzhkbW3d4TwD2CNjMRwxTbREXySekvq37kfCNk,6858,31447,-24589,624
2022-01-06 21:55:48-05:00,1914,4mB2DVbQVqVk535v98Cj8SPNg1tTc3DFyY2Q7VBbY645,HXo255k3RgsTGsc4hiP6ZTXUspBTqJ37duQa5eK7tqp3,True,1719080255,429770063,2682067,1341033,1341034,3zqXX6kzhkbW3d4TwD2CNjMRwxTbREXySekvq37kfCNk,107282698,485969781,-378687083,624
2022-01-06 21:55:48-05:00,1915,H6tDNj9cHac223ckAnNfnC4bAJuNLBnf2pFk2iQdMzMP,28UL9dqgayCqCAexScXjdpobYGVDN44SGBVNAfBByk8C,True,388238371,97059592,602389,301194,301195,3zqXX6kzhkbW3d4TwD2CNjMRwxTbREXySekvq37kfCNk,24095582,162835571,-138739989,620
2022-01-06 21:55:48-05:00,1916,EEcTbsFTUEifcdbPyjBLkS943daEx1RpR8F3uZxKRZbT,8V3JzDQ1VWYQLas8fxUsWJZZHe4gEmn74RehtUwLw3k5,True,31059065,7764766,48047,24023,24024,3zqXX6kzhkbW3d4TwD2CNjMRwxTbREXySekvq37kfCNk,1921905,11060856,-9138951,618
2022-01-06 21:55:48-05:00,1917,J2gTwrYpzezkRupgBtgudQn5D33x6WjeBhTHnrA1qgqa,FBzoHRwqGRjnMvPEpiZVjtGZYJmAbneE4dpToXPzy8bv,True,199744412571,49936103142,310551057,155275528,155275529,3zqXX6kzhkbW3d4TwD2CNjMRwxTbREXySekvq37kfCNk,12422042305,50518923025,-38096880720,621
2022-01-06 21:55:48-05:00,1918,2ce2v2TCbjNH635NgbwTG3sqiRWYrRRaBpxPxBZJ929q,9cnoebT43FkWDFhidndGCVNiFD4NErv8DuL1Va4Jv9S8,True,34798191,8699547,51679,25839,25840,3zqXX6kzhkbW3d4TwD2CNjMRwxTbREXySekvq37kfCNk,2067177,21197533,-19130356,594
2022-01-06 21:55:49-05:00,1919,93ho4cgnpAJiJsG6uu2udkLVNU7rkz4QjCYfsqvpbPA5,45ouQn9gGwXqnTGfaP5CvU8fCKadBRA5kPwtfvJzykRU,True,366959257,91739814,542233,271116,271117,3zqXX6kzhkbW3d4TwD2CNjMRwxTbREXySekvq37kfCNk,21689322,86529747,-64840425,591
2022-01-06 21:55:49-05:00,1920,4FazDUgfQ3AKoFcnWHr8E9Ht8jLA3tkxf75yrGZVHdmF,HzRMH6mbgEKydRCnnMvSsKgTEVNQi6nuzoR1xutYFdzg,True,354517,88629,523,261,262,3zqXX6kzhkbW3d4TwD2CNjMRwxTbREXySekvq37kfCNk,20951,199971,-179020,590
2022-01-06 21:55:56-05:00,1921,2bikYf33ZxxDmvkMNjWDGGqEpbYJPvWv5At3hzyeLEQK,5FtirUBjRAZ3k5arFFVwKz42ixWzhkEBLkaK9PraRZ78,True,846728,211682,1283,641,642,3zqXX6kzhkbW3d4TwD2CNjMRwxTbREXySekvq37kfCNk,51349,194621,-143272,606
2022-01-06 21:55:56-05:00,1922,ECuu1L4QGdemZ7FjAjVAAxYN6piinweY7Fuk5csVovfT,Amd8WGcpdtB8yoA83R1BUT5uryuqoKbcBexYacbrbGVX,True,17652618,4413154,26472,13236,13236,3zqXX6kzhkbW3d4TwD2CNjMRwxTbREXySekvq37kfCNk,1058881,4419891,-3361010,599
2022-01-06 21:55:56-05:00,1923,AGhvB6x3gmvAJSnr9UVtvhKqVg3Qgh1k4roHzrNHhAaa,HhhjXT6WJnz1HQfHcwKdBppuAhc8ncUcq1mkJ4EHqgpe,True,36490,9122,55,27,28,3zqXX6kzhkbW3d4TwD2CNjMRwxTbREXySekvq37kfCNk,2215,11049,-8834,607
2022-01-06 21:55:56-05:00,1924,GH6Q9E1jZPTTp46aDd57UNZPNS2D6PBSwyLL3EHSjGn2,2XvwZXNsrPWx4EfPvhTP933bzCC3SJHDQ8xARfrXdVY9,True,114088470,28522117,174508,87254,87254,3zqXX6kzhkbW3d4TwD2CNjMRwxTbREXySekvq37kfCNk,6980338,78095990,-71115652,611
2022-01-06 21:55:56-05:00,1925,HhwiZPKZBGa16oVi739s4qtMDMTwzWXc7iwNfX63t2UP,5AnbMbAFKy85yHt5y2M5S38nNkA1vT4ejY5NjGbRNUqn,True,7998801,1999700,12086,6043,6043,3zqXX6kzhkbW3d4TwD2CNjMRwxTbREXySekvq37kfCNk,483451,3746311,-3262860,604
2022-01-06 21:55:56-05:00,1926,CCHzYXr5zMXFu8MMZNkfUWGyUcF8xy7Vvhq7tNCtZg2L,AuEXkCJTTJ3HK8iP4qTWpQr4vp6HPRJZyZwfRjF8zjfp,True,846726,211681,1283,641,642,3zqXX6kzhkbW3d4TwD2CNjMRwxTbREXySekvq37kfCNk,51347,194621,-143274,606
2022-01-06 21:55:57-05:00,1927,ES1MDwRUa3hoToPKQiiZkzMYe9PDVnAQwMrEvZrzvnc1,C4wBG3xTDkmDQneB28xYnf1aBNEeq7UB8oR7NuEfLkFg,True,159076252,39769063,245536,122768,122768,3zqXX6kzhkbW3d4TwD2CNjMRwxTbREXySekvq37kfCNk,9821447,36145195,-26323748,617
2022-01-06 21:55:57-05:00,1928,921FBgLS3A1wA77uWitsnTvW737Q2jY7tzvgWtWLXNC7,E4eJ9H7cqP9zNpMH5xRBTAp9yaBCBihuJBNd6pqzteDG,True,846724,211681,1283,641,642,3zqXX6kzhkbW3d4TwD2CNjMRwxTbREXySekvq37kfCNk,51345,194621,-143276,606
2022-01-06 21:55:57-05:00,1929,5jin5wXjQQ25nGM2ECrCXcg1a95vquh6kM7rMRru6Ke7,EKM657EQ8HWWgf4cssByoYHoXGjFfTspTKXAGmygAPQG,True,217295651,54323912,334241,167120,167121,3zqXX6kzhkbW3d4TwD2CNjMRwxTbREXySekvq37kfCNk,13369654,78151389,-64781735,615
2022-01-06 21:55:57-05:00,1930,7MSzV5yy5FmrM4j1BcYSRiTGWfit1AJahheRUaXzz349,aPSTZLxBpVr3sucjbj95emRV2J1GrUWr7wbARYqJkQZ,True,25752790,6438197,38534,19267,19267,3zqXX6kzhkbW3d4TwD2CNjMRwxTbREXySekvq37kfCNk,1541385,5828595,-4287210,598
2022-01-06 21:55:57-05:00,1931,Hy3kzXneDN6FUkiZctU1vWe97BYvj6yZ7QvQzehfWmNr,EhXgQg8BTniANV525RpY76z7Hrh6DuqrMChjqEoXfVJe,True,7465411,1866352,11630,5815,5815,3zqXX6kzhkbW3d4TwD2CNjMRwxTbREXySekvq37kfCNk,465225,2833634,-2368409,623
2022-01-06 21:55:57-05:00,1932,BxXXWywnC3dSyLPJHt7owfBhgSiBWzkuD3T8hGYLqCH6,4vuwEBXXbXFMPmbJJJRop4FCWGyKR1sXhBc3EWF6MiB8,True,550284074,137571018,828827,414413,414414,3zqXX6kzhkbW3d4TwD2CNjMRwxTbREXySekvq37kfCNk,33153093,233407548,-200254455,602
2022-01-06 21:55:57-05:00,1933,4D7mDXe7SdmbAx7kaD1mBNuEa7DzMi6TAwXURxtLEazk,5pSnT91PHoLdN6uhPnUtoD7cboLmndn26y1XouPx8vwW,True,8569491,2142372,13264,6632,6632,3zqXX6kzhkbW3d4TwD2CNjMRwxTbREXySekvq37kfCNk,530585,1959094,-1428509,619
2022-01-06 21:55:57-05:00,1934,5RvNKzSeJ1fvqsKpcQu25evEZGmKjyEDgwsMZkykoT3P,BRqSGfE4XHXu4HrinwetWumfVTmr82iuF6Y5oSV6eMiK,True,847564,211891,1304,652,652,3zqXX6kzhkbW3d4TwD2CNjMRwxTbREXySekvq37kfCNk,52181,194617,-142436,615
2022-01-06 21:55:57-05:00,1935,6u6bPgAmK8ufACrQV99A1Y5nhGkue3KEUHmQQkcNkxwP,7636yXT5w4DcVpc7LJdN46aiggzSq6U2GXHXL5kyy9F3,True,685282721,171320680,1060491,530245,530246,3zqXX6kzhkbW3d4TwD2CNjMRwxTbREXySekvq37kfCNk,42419644,245736053,-203316409,619
2022-01-06 21:55:57-05:00,1936,DJiXXW7sjNsAAxWupDKBUsFhXSgPoerVYaAtJqqNgVbn,2MsqvNuJw1xQhJ3UnXt9i7oNHDuZpR9w7iE1WQcGqt5m,True,846703,211675,1283,641,642,3zqXX6kzhkbW3d4TwD2CNjMRwxTbREXySekvq37kfCNk,51324,194621,-143297,606
2022-01-06 21:55:58-05:00,1937,7W6ih2ZGXaE6tvuQFUPCvc7NvEJHy7UffgoVX3ZPdLXt,6uQCkeMjEXHBQxE2HD33RM1zyTsSko1fYZA1mWUggJ5B,True,148616,37154,223,111,112,3zqXX6kzhkbW3d4TwD2CNjMRwxTbREXySekvq37kfCNk,8930,44680,-35750,600
2022-01-06 21:55:58-05:00,1938,GGGyesjbt7h2XHHp9u8vpiWGugFwEbrtYaKrNQSDhQd7,8tydo1ZjGHmPBSqU33tywB3f9szdsHk1ckGFe4Ay5pgs,True,291640824,72910206,454982,227491,227491,3zqXX6kzhkbW3d4TwD2CNjMRwxTbREXySekvq37kfCNk,18199311,174865308,-156665997,624
2022-01-06 21:56:00-05:00,1939,5PbrpM9kjzF4R2eW2UTcRVXnhqWdRQWHZJXKLN43N8WC,6ip4ocbyHusy8CsVvcrpiRCUp2nq9cY8bHpTcUU3Wztq,True,45752651,11438162,71267,35633,35634,3zqXX6kzhkbW3d4TwD2CNjMRwxTbREXySekvq37kfCNk,2850683,14045603,-11194920,623
2022-01-06 21:56:05-05:00,1940,2QStaRnbSnDhA891Lb1bxjVeMYpJUpNdqaVkw3rqU45V,DakRWPnttPoRcjY5V7WLwiwBx39BapCo9Atog8dL17Ku,True,13083436,3270859,20275,10137,10138,3zqXX6kzhkbW3d4TwD2CNjMRwxTbREXySekvq37kfCNk,811017,2727581,-1916564,619
2022-01-06 21:56:05-05:00,1941,3njiRuSRMXRzKmamyiR72Hc38PU8UDDmWdfPhgxmGxEW,5WoF3gkgygyNNbwxWgVfqGWkExcDixuzgJQQjXEZQ6J5,True,1473961110,368490277,2296326,1148163,1148163,3zqXX6kzhkbW3d4TwD2CNjMRwxTbREXySekvq37kfCNk,91853042,795277304,-703424262,623
2022-01-06 21:56:07-05:00,1942,9gYrMXAGmGSV4VFjXzYP5WwH2aFpB1TxA6CqpYsosKLv,Dh8aH6RK48wu4fkT9xKw5XL7itxnPDuw3SDwPwvL5sva,True,153163,38290,229,114,115,3zqXX6kzhkbW3d4TwD2CNjMRwxTbREXySekvq37kfCNk,9168,43928,-34760,598
2022-01-06 21:56:07-05:00,1943,6dr65yANjSMmfBeKAuSxG3i16S9vMgF1CQ3zDyzh55Pn,EhrE5QpnshD41S4zPEBy2A5q2Gs2mwUrbHGo6WnT9zDP,True,1933141,483285,3023,1511,1512,3zqXX6kzhkbW3d4TwD2CNjMRwxTbREXySekvq37kfCNk,120936,719049,-598113,625
2022-01-06 22:01:28-05:00,1944,BZxJ6CtrVoiU86DMMieMeDFLNWtMpHGTvZfM7nyay6o4,6CRxRR8bisRLHFJBFWjyumYuy7j4C4PkjYH1K8gXhdWD,True,16553748,4138434,25876,12938,12938,4BnQKPLuE3DMTtxp8MjUBytgnhvxqq3ZTqZHTVZo4JJh,1035044,3606309,-2571265,625
2022-01-06 22:02:21-05:00,1945,Gbxc51WERLLeCtiHv7rDvE52aqF541RoQWG5n5aqErq6,4ngBoHbfXijLMqGKxFMNht9sbmxy2g5eqBmn8QsBmbx1,True,4373227,1093306,6843,3421,3422,3zqXX6kzhkbW3d4TwD2CNjMRwxTbREXySekvq37kfCNk,273746,1510180,-1236434,625
2022-01-06 22:02:36-05:00,1946,3Lv2XpiD4KBUHq7Zx6u3zNhpXoySodXHH8o8f5yaaPxG,H6TN4rhpBXkEH3mZnymYNcKfmnxRH2uzfwzeLH2q6ahP,True,1078991,269747,1685,842,843,3zqXX6kzhkbW3d4TwD2CNjMRwxTbREXySekvq37kfCNk,67412,331948,-264536,624
2022-01-06 22:06:57-05:00,1947,6CeKxTJvFqhyNEyzySiBBKEwYVMe7j3A6nkMes4BW6o2,DzDR9XvwY1z7ygQ8YrCXrwDGHSf67JZF8BzUnuFE2fxQ,True,25283489,6320872,39510,19755,19755,3zqXX6kzhkbW3d4TwD2CNjMRwxTbREXySekvq37kfCNk,1580427,6289448,-4709021,625
2022-01-06 22:06:57-05:00,1948,FpqCxvTkSiwDwD5qEt6hXJxzFDLFLAQ8VevK8zwRqYun,A3p6YQisCJKpNkF7vkjZRbEfbnUt7vTZdR2zPBUSdTkk,True,2370959389,592739847,3706344,1853172,1853172,4BnQKPLuE3DMTtxp8MjUBytgnhvxqq3ZTqZHTVZo4JJh,148253781,589971378,-441717597,625
2022-01-06 22:07:00-05:00,1949,8MKNsuGVaoYpdQy6NNyxDvRzh2DAquBUtri4nDsixUxs,D7M1SDmpZAs8vdPCCCa96UbDF15YQDxHmoGWB57tHiir,True,23908112,5977028,37275,18637,18638,3zqXX6kzhkbW3d4TwD2CNjMRwxTbREXySekvq37kfCNk,1491000,9210786,-7719786,623
2022-01-06 22:07:01-05:00,1950,8VnGmfop6qcUezAJ2M15jz2Nn6mPQgehDcJPvypq4XJn,6F6sqXNhgkW9ev8QNMm4ydywUUmemhwgydRQYNeqyUmi,True,61146596,15286649,95259,47629,47630,3zqXX6kzhkbW3d4TwD2CNjMRwxTbREXySekvq37kfCNk,3810397,42663801,-38853404,623
2022-01-06 22:07:09-05:00,1951,C2Dmfw4G8KKzFq38aRH2pLCRngnGZDvUUN3fHDMjFkoG,7kzJk3BTNvY3hGFNj7nDy9L5CAYus6eNiCAxWH8dSioX,True,2143119,535779,3346,1673,1673,3zqXX6kzhkbW3d4TwD2CNjMRwxTbREXySekvq37kfCNk,133868,996529,-862661,624
2022-01-06 22:07:11-05:00,1952,DAku12iueL13vRoTpKLyqdGaLQ2rWF6REe8Dr8soFvNs,H2vVH3LxkhGe6x6Mdwy67BYwTKNQM6XayKx7mhrwyfJM,True,2574509,643627,4009,2004,2005,3zqXX6kzhkbW3d4TwD2CNjMRwxTbREXySekvq37kfCNk,160375,960869,-800494,622
2022-01-06 22:07:13-05:00,1953,6eBSLXDMVoW2nG3n7s42RXDH8byY3C6n1RsUuegBLSrG,37dYrKnTXYer7Bu9xFfpArA4ZNo2B9bycFw9HywDtTRx,True,57252554,14313138,89567,44783,44784,4BnQKPLuE3DMTtxp8MjUBytgnhvxqq3ZTqZHTVZo4JJh,3582695,19759481,-16176786,625
2022-01-06 22:07:30-05:00,1954,F2v1YwVAwXLiUgsJ5uwn4qAAkTXitn1E75fJcPnGuAcy,5rdJ4H5GxPg4Juu77mGc7uya5LwEqLzDSRyG8mQ2mDbK,True,111296446,27824111,174018,87009,87009,3zqXX6kzhkbW3d4TwD2CNjMRwxTbREXySekvq37kfCNk,6960759,40020482,-33059723,625
2022-01-06 22:07:30-05:00,1955,Fd2HrzBAr4JobRPARZwpQHHVoSCEoog32A6tKMWAC1sK,BYappsar5sQf8VLem4wrLuTtrDFH9y8pEx1aMxfuU4Pq,True,173790229,43447557,271973,135986,135987,4BnQKPLuE3DMTtxp8MjUBytgnhvxqq3ZTqZHTVZo4JJh,10878925,62463785,-51584860,625
2022-01-06 22:07:30-05:00,1956,8NdcaYUC1X5CP7FMDip78uqtqmCt8GcZdCzLRTYTihmb,9Ei1K9bXWXSXcBfeX5exPSXGCAu62WSKzvnnd4wHvyVh,True,758230,189557,1185,592,593,4BnQKPLuE3DMTtxp8MjUBytgnhvxqq3ZTqZHTVZo4JJh,47416,238230,-190814,625
2022-01-06 22:07:37-05:00,1957,8RmB8o4zux2sD48dEsKpsX475KRxTwdk8QULUDU9xx8R,AKSiZnb4YKVB6B86aPPqvyXquhvN9xqt45bexBCZ7nx,True,365594718,91398679,571987,285993,285994,3zqXX6kzhkbW3d4TwD2CNjMRwxTbREXySekvq37kfCNk,22879489,157119196,-134239707,625
2022-01-06 22:07:37-05:00,1958,2FrqGFZjbiNykJyo9BZ5S9FguQJPJiTi681rJJsQ5dta,3QUncYP92NKrfpaTvuF9iQg11PXKgZAgEngwh6BbnCCj,True,4766077,1191519,7446,3723,3723,3zqXX6kzhkbW3d4TwD2CNjMRwxTbREXySekvq37kfCNk,297870,1389907,-1092037,624
2022-01-06 22:08:35-05:00,1959,6tFQaTqqffino9kwMZTL2xVNBG8k9VREFhXqVi2si3A3,3w3wGxBbS4bmXeqmvd595SAWFeXekVpnH4UdbeEs8Sx5,True,25282216,6320554,39469,19734,19735,4BnQKPLuE3DMTtxp8MjUBytgnhvxqq3ZTqZHTVZo4JJh,1578771,6289065,-4710294,624
2022-01-06 22:08:35-05:00,1960,AHm7zF4rpaxaayBLn5QDHgJSp8KAr647s4cNvQ9wLgd7,FDM33WngED24pukBvSDpPAzinW6afVAeGReum5nyLRiC,True,4776834,1194208,7465,3732,3733,4BnQKPLuE3DMTtxp8MjUBytgnhvxqq3ZTqZHTVZo4JJh,298615,1794942,-1496327,625
2022-01-06 22:08:35-05:00,1961,EmGW2aAG69ssWqCtbfDocRaM2u3TJsczn2HHP9jdmRvD,aypkDKsp9uqAB4F6mwvm5LofpsrFBuZT2MMWtE2eHdB,True,3724399,931099,5807,2903,2904,3zqXX6kzhkbW3d4TwD2CNjMRwxTbREXySekvq37kfCNk,232308,1253528,-1021220,623
2022-01-06 22:21:19-05:00,1962,6yw4GPvkqUbakcEWtqSCfjVLukty11xqjDpGxtEN9Km2,5ppEx7wkpqbG5nApCWMdRja3oRSheFmAAsNHUX7h2w2Y,True,9526141,2381535,14876,7438,7438,DddJ7EWCmYEEZETCBNgAUSg81Ls6fZtiAaY5ekJ5sXx1,595041,6798657,-6203616,624
2022-01-06 22:21:19-05:00,1963,ANQkPUoMjLHyRtypeKzxsKW1DFauQsh9SnB3rRgRXM1Y,7RHAExWpG8Q3PXwKhJs2yXmYK9WogGydvFYpx28p6pgr,True,418788060,104697015,655178,327589,327589,DddJ7EWCmYEEZETCBNgAUSg81Ls6fZtiAaY5ekJ5sXx1,26207159,183121845,-156914686,625
2022-01-06 22:21:27-05:00,1964,7iUx7JBwqUvPVPeCqMEXQdLccZJmaFYm1DUQiu3ouHa3,3EVZzhRmJnX9ZiBZZo9tenDtMogAyuA1yf2cKzvUWiuu,True,4950224,1237556,7725,3862,3863,DddJ7EWCmYEEZETCBNgAUSg81Ls6fZtiAaY5ekJ5sXx1,309036,1745417,-1436381,624
2022-01-06 22:21:31-05:00,1965,9zpPiboHF5HW7NfCx7hYdmJGwUomVMTiUFc4Um5KrDi3,8q3eBpuwV6dMNkib9N8XQAq2tBUcjSANRe5SXpd4dFhZ,True,47340218,11835054,74010,37005,37005,3zqXX6kzhkbW3d4TwD2CNjMRwxTbREXySekvq37kfCNk,2960434,10610216,-7649782,625
2022-01-06 22:21:43-05:00,1966,E8ifvhmyJGBGVQomo3AnZw2UcaLHcpGsTtuoCid8voU3,FMQUWTbTAfSLfrc6GTrz4DM2ZSgoxF3KtqGn8AyjVtsf,True,41034182,10258545,64181,32090,32091,DddJ7EWCmYEEZETCBNgAUSg81Ls6fZtiAaY5ekJ5sXx1,2567247,10008439,-7441192,625
2022-01-06 22:21:57-05:00,1967,9UyQC8vc6zJJaSdnjvTAzgmcsw4fC3xFBBiCC1w9Sbjx,3ppBfboe6FPmt7f6WrivspMUoAznZKWQMeh3rCgw7vjQ,True,51662638,12915659,80730,40365,40365,3zqXX6kzhkbW3d4TwD2CNjMRwxTbREXySekvq37kfCNk,3229211,11560550,-8331339,625
2022-01-06 22:22:19-05:00,1968,67Z7ZGhNu5xxEh9BYKWcXp9m1T4tFiE1o1M16hCzUWQA,CT7YKWixz7BhTbvg5F6M5HCyPGnHoFLNFuDV9GhoLTo3,True,18826228,4706557,29437,14718,14719,3zqXX6kzhkbW3d4TwD2CNjMRwxTbREXySekvq37kfCNk,1177480,8253130,-7075650,625
2022-01-06 22:22:19-05:00,1969,2F45BX9mRmtNCHPejKFknN5aNgGvR4vVLFjMaY1a7dR8,ALdSutsvEFRUEQGGBbi31QywTL1pdXSDWrNJzvNTaoXL,True,144442565,36110641,224368,112184,112184,3zqXX6kzhkbW3d4TwD2CNjMRwxTbREXySekvq37kfCNk,8974755,49694575,-40719820,621
2022-01-06 22:22:22-05:00,1970,D58t4uTjFumsUeYFaKnpV8BRTEQEqKXBreFTdwGrott7,67p6kHDfVqQijfcwugvZK59c3aRRH9x3eHxruqH8WEqF,True,4360080,1090019,6819,3409,3410,3zqXX6kzhkbW3d4TwD2CNjMRwxTbREXySekvq37kfCNk,272760,1502640,-1229880,625
2022-01-06 22:22:25-05:00,1971,CvZssqscu2dm35mwcE3zg9zedavbRjVJjWD59Py5ExUK,7pXaoR6aHKYofCmg1eHipygNYDteEaf8rbbS8BDYGQK6,True,4053631,1013407,6311,3155,3156,3zqXX6kzhkbW3d4TwD2CNjMRwxTbREXySekvq37kfCNk,252440,1009199,-756759,622
2022-01-06 22:22:26-05:00,1972,2VyFcgZDH1HTEvD1XaWhwqBCMmZ1k6TmZ3fEpPcBZR9E,G1wFJETTpdoc7CfypGCzkq1jssXPfUkiuLjK2cwVZ9dJ,True,464567,116141,724,362,362,3zqXX6kzhkbW3d4TwD2CNjMRwxTbREXySekvq37kfCNk,28977,173849,-144872,623
2022-01-06 22:22:27-05:00,1973,pgzvXpnUYiY7hLrfjmwScqLd8oj9vYcXpFvpm4y4JvG,GdqdQgoyBAFuXdbvoZyDhB3jyqJzVo4nkGh7EPFxkBF2,True,12211062,3052765,19069,9534,9535,3zqXX6kzhkbW3d4TwD2CNjMRwxTbREXySekvq37kfCNk,762792,8779847,-8017055,624
2022-01-06 22:22:38-05:00,1974,6nJyqvFKprwaVCE1gAa2P4RHKc6Pa6XFSJymx654zZ9K,4e7iJmdwzAPxp1Zi8Azo38YyPQdPKqqY4VLJyQ5rpdYP,True,14433352,3608338,22578,11289,11289,3zqXX6kzhkbW3d4TwD2CNjMRwxTbREXySekvq37kfCNk,903133,5479285,-4576152,625
2022-01-06 22:23:17-05:00,1975,CRaKcudjkQiSw5YPVjTLVdXvJskeGiHSYtq5ZcMPJhgQ,AgqTg3b3bAcaBmRidhNC4Uf9ZwNbeH52RQEqumWyuUs7,True,5013421,1253355,7838,3919,3919,3zqXX6kzhkbW3d4TwD2CNjMRwxTbREXySekvq37kfCNk,313520,2338630,-2025110,625
2022-01-06 22:23:42-05:00,1976,DYCYiQFH9QHzCo3eAw1pFoDu7pzwFMo1E2WDZjVFRz5w,CPh4FWsGak1kd1WFEH9qBjNhnun3R2tHtZA57zW8ugn5,True,300083187,75020796,468344,234172,234172,3zqXX6kzhkbW3d4TwD2CNjMRwxTbREXySekvq37kfCNk,18733773,115619018,-96885245,624
2022-01-06 22:23:53-05:00,1977,8BTja7VnFPe6M9BHTqg5LTpX6vd4ugTeWLzpq3oFP8WM,pscjH4sPnNL6zQBmvHjEEbix6BTstnsrSwGysNWyPkd,False,170190,170190,8505,425,8080,3zqXX6kzhkbW3d4TwD2CNjMRwxTbREXySekvq37kfCNk,8505,57012,-48507,499
2022-01-06 22:23:53-05:00,1978,9vcKW1GfrDZ3KLPh2pEVFF8ZyKqD1pJW1hiE8H98Av7S,C6Ki27mo4sCHu6u8UnR1p7WSgsTjFQxGGR9Lk9n5Rhjq,True,16082266,4020566,25165,12582,12583,3zqXX6kzhkbW3d4TwD2CNjMRwxTbREXySekvq37kfCNk,1006627,5700575,-4693948,625
2022-01-06 22:23:57-05:00,1979,36ByQojnxEckWdQTjqHfxKqCx9yjqWQsPsZyqaN72UWR,AZoirtS1fjX61agRM64tqThVinnJTh3BWgiHyNHPTgZP,True,4841223,1210305,7543,3771,3772,DddJ7EWCmYEEZETCBNgAUSg81Ls6fZtiAaY5ekJ5sXx1,301756,1987973,-1686217,623
2022-01-06 22:24:03-05:00,1980,M69XSefqeum2arinvHEqmA3L2XHWNFN17p4msRhRZXf,2vK15yYUANLSbAoiBfgJ9VLyqsmtEpd2iNytQjms8GaQ,True,1568220746,392055186,2452258,1226129,1226129,4BnQKPLuE3DMTtxp8MjUBytgnhvxqq3ZTqZHTVZo4JJh,98090334,773159501,-675069167,625
2022-01-06 22:24:04-05:00,1981,Ckqos6cdncPKj13DnCmDVZsZTqp6eS7277CRrT9WhcEr,AtUV8m7VQJvZq7GLCAHMf3jV7iamKEPnWVZHWuuVZQp1,True,7186053,1796513,11227,5613,5614,3zqXX6kzhkbW3d4TwD2CNjMRwxTbREXySekvq37kfCNk,449093,3352435,-2903342,624
2022-01-06 22:24:10-05:00,1982,HVZkXeDR3mc8oB9qFFwCK4RXpPojdcHk9tRGep6xtKGK,Bh3py7awPejWqeTMxtAgF7mPotL2Asxf8YrYJykq9nBt,True,38161182,9540295,59656,29828,29828,3zqXX6kzhkbW3d4TwD2CNjMRwxTbREXySekvq37kfCNk,2386244,11689531,-9303287,625
2022-01-06 22:24:10-05:00,1983,zLTuMVfVswjMkhyvjaXnvjcKXv5xNk3iSWSjRGpVqXf,J3D8NHUJCiSjvFYfJ5Es4YDhF1KcPZWRUmCQ5L92t8eB,True,704367079,176091769,1101152,550576,550576,3zqXX6kzhkbW3d4TwD2CNjMRwxTbREXySekvq37kfCNk,44046095,201121516,-157075421,625
2022-01-06 22:24:10-05:00,1984,6oroGB3mvzK3tDfiB9X2NJuL3x476pxhgRnt7VxqhdLo,2SoK8tKkLn2ppKURpTVazKsCEis4uahkHMsac1m85J4r,True,10366597,2591649,16187,8093,8094,3zqXX6kzhkbW3d4TwD2CNjMRwxTbREXySekvq37kfCNk,647501,7154202,-6506701,624
2022-01-06 22:24:10-05:00,1985,7bnCuBLXnPS3wDBunrzoV5qm1GwfnPfRBwV2f9Xzo3Aj,9Xd7GNcFrx7z66DRW8kK3d1jN4tzuiwv9jyDFbHUx9vW,False,173162,173162,8407,420,7987,3zqXX6kzhkbW3d4TwD2CNjMRwxTbREXySekvq37kfCNk,8407,58656,-50249,485
2022-01-06 22:24:12-05:00,1986,CBL2NbekJrXvBiAcoj4fzQ4PfLDwTntW7Zt4nruHFYEw,59EvfgYTdKkfjUJz5LddLUAqbEdLaihcMzjcrTZsyzyS,True,54136,13534,84,42,42,3zqXX6kzhkbW3d4TwD2CNjMRwxTbREXySekvq37kfCNk,3375,16165,-12790,623
2022-01-06 22:24:15-05:00,1987,8sneA6wAg6geVDJ1g7YWg4R1PfjuRVzeHp1nUBJinhZa,14i1uWtmcTjrdbg3DSr9vzd5NBnxqsn1A4QdgFBZqeYM,True,699973,174992,1091,545,546,4BnQKPLuE3DMTtxp8MjUBytgnhvxqq3ZTqZHTVZo4JJh,43673,220588,-176915,623
2022-01-06 22:24:24-05:00,1988,6uZobpBuFcQeYgZ4dApFi6iy4DB9GLHP1AAsQcCj6212,SGGFiPjjhscwroiWMqY4jTAHFw8eakpsEv35wNoHUPY,True,777882916,194470727,1208659,604329,604330,3zqXX6kzhkbW3d4TwD2CNjMRwxTbREXySekvq37kfCNk,48346367,200245020,-151898653,621
2022-01-06 22:24:35-05:00,1989,3qnPsgqW11AcDEmyjmJquPcPLyE3EdJQuVLJ5kinDrd3,86rZadBB7emKio76aFTahpbrFtxd9tqZ4Mxgzaavq2xU,True,914115,228528,1429,714,715,3zqXX6kzhkbW3d4TwD2CNjMRwxTbREXySekvq37kfCNk,57172,282122,-224950,625
2022-01-06 22:24:42-05:00,1990,7jvKp6onXyWgwsFrFWj4hYTXJsYYD6ot5mn6rPFuJriy,J7N6HiozevJVTiY9hDEUs2ud5BwT5QSE7wnMBS1w5ie2,True,188149096,47037273,292785,146392,146393,3zqXX6kzhkbW3d4TwD2CNjMRwxTbREXySekvq37kfCNk,11711427,77015251,-65303824,622
2022-01-06 22:24:50-05:00,1991,DMgPzJnMQfvpk6LWscs9V9CwnYDj4CEUgKB9S65WsTaY,BZRSLH1Vw1BQwXTZtBcgUYqmFF7TuzYxAaZ8TXUKwLUQ,True,50521,12629,78,39,39,3zqXX6kzhkbW3d4TwD2CNjMRwxTbREXySekvq37kfCNk,3152,19866,-16714,623
2022-01-06 22:24:58-05:00,1992,3C2MZQKh9x4zNTCMbhhvoafGaFMwUooqfy9MCgPyXs6E,AHjgWKpYPWe6ketjDHDKFBFsKQiRJ41jnkuo39MVYxZo,True,1224491865,306122966,1913777,956888,956889,72FwbpFGoLEazJEdpqNtPNefsadUrimUqma9wSoy4qiS,76551107,535270943,-458719836,625
2022-01-06 22:25:01-05:00,1993,864zY9zuCktUurPTtdGeLvUATnDqHZpT1GeWUApsXh2m,CzatBrNJUi7MeyfbNhszRaPMidgt8Xkcmy5ZwFMP9RCs,True,161994385,40498596,252987,126493,126494,3zqXX6kzhkbW3d4TwD2CNjMRwxTbREXySekvq37kfCNk,10119510,51519191,-41399681,624
2022-01-06 22:25:02-05:00,1994,ymyzGH4Qc7HH5PbKpVphCbsQgLLXyGkPcXamQJuNj5C,8oTLHaV2XzbKXNWRuUjCfHjUn61Pw93LYK14m9q2VDpZ,True,79555598,19888899,124483,62241,62242,3zqXX6kzhkbW3d4TwD2CNjMRwxTbREXySekvq37kfCNk,4979334,21037690,-16058356,625
2022-01-06 22:25:02-05:00,1995,7PzGZgzieFyyFs1dbajkNQgVxooFUNZrj1bUsQvrSwbp,A2gDREmSmJTBPPw3sbKVY3smC9wbHMDdv87gr4Tr2ES7,True,16448157,4112039,25689,12844,12845,3zqXX6kzhkbW3d4TwD2CNjMRwxTbREXySekvq37kfCNk,1027590,5084676,-4057086,624
2022-01-06 22:25:08-05:00,1996,3ogBPSRcKfmwzgumVDHBkXLi1eCsEFG2xzSJgD4LQDNy,7TXyqWgJqfe71MSWFA2n7ufZbUdzf7JJoWej8FNNtMXo,True,127613520,31903380,198581,99290,99291,3zqXX6kzhkbW3d4TwD2CNjMRwxTbREXySekvq37kfCNk,7943269,31973296,-24030027,622
2022-01-06 22:25:14-05:00,1997,B4Uc39nKzz9wBRQsCkMR4A7RwTJ8rSuwpR6EQn2AesRb,H49bGZgatRZVpj6QufZRVgYrQtH7LpdbiqKBs23151m,True,149692247,37423061,234258,117129,117129,3zqXX6kzhkbW3d4TwD2CNjMRwxTbREXySekvq37kfCNk,9370352,108860111,-99489759,625
2022-01-06 22:25:24-05:00,1998,3WcJUt8jQ1ngL3ZCGo6dFrc3GmTMTYtzeDva7mri2Tqx,HeG1Pz2oMjqtkfsRMsbqP3VpatnVEQzcWmKDVoFp4Htr,True,93747623,23436905,145779,72889,72890,3zqXX6kzhkbW3d4TwD2CNjMRwxTbREXySekvq37kfCNk,5831192,30725181,-24893989,622
2022-01-06 22:25:24-05:00,1999,GqAS41YJssg9aaEp3hs3sG98APCsXhiQBQszXaSjZ2bN,2wodJ3AhrXdE1T4oVL95KvoBND7PubG5Wd5GWiLCMZJU,True,1096586424,274146606,1676602,838301,838301,DddJ7EWCmYEEZETCBNgAUSg81Ls6fZtiAaY5ekJ5sXx1,67064099,719637802,-652573703,611
2022-01-06 22:25:24-05:00,2000,CagSUfZLwXuCdypC4KzU6FSNdmCj9dKDroPcNeaRtsyt,yxw5d1ztZuEUY2QjL7eLpr72QJAj5rJd6ERvg91cy1m,True,9338519,2334629,14240,7120,7120,3zqXX6kzhkbW3d4TwD2CNjMRwxTbREXySekvq37kfCNk,569611,2475415,-1905804,609
2022-01-06 22:25:24-05:00,2001,8xQ3tsWVUe75EG1HmocULJ3kh52utveoFMEPotTGrKno,i3SKW3ywrwYucX9ySEx1C4zaUKGnzLerP3V38437NyV,True,355840973,88960243,555411,277705,277706,3zqXX6kzhkbW3d4TwD2CNjMRwxTbREXySekvq37kfCNk,22216474,118947459,-96730985,624
2022-01-06 22:25:24-05:00,2002,FV9CBGGTbppLnBKh79f2LzD1diTiS5g6u89FcpZHZmnK,Fe7mtmCUziFqbbYTvrhAcAq1Ub7YLfTJRtQ1hG7GzJD1,True,31417229,7854307,48726,24363,24363,DddJ7EWCmYEEZETCBNgAUSg81Ls6fZtiAaY5ekJ5sXx1,1949067,8511872,-6562805,620
2022-01-06 22:25:24-05:00,2003,6Bq55LtGCEeGqh4JrFLCmmGc2iJfTTBJixivqH78aGSE,DSNrCgWJeNe2P9tAQu5FvCueTzNKDKds7wzuwTQSMRG,True,39664737,9916184,61934,30967,30967,3zqXX6kzhkbW3d4TwD2CNjMRwxTbREXySekvq37kfCNk,2477385,10523949,-8046564,624
2022-01-06 22:25:28-05:00,2004,2FEbsetZMkRqLjSC8GBbgecKgX5T1T1fci2sLQux29p8,H722Fcd6DkTFRZxqQWbPDufBfXEgmFfhiEpQZWhxwYv1,True,27892281,6973070,42673,21336,21337,3zqXX6kzhkbW3d4TwD2CNjMRwxTbREXySekvq37kfCNk,1706944,7559065,-5852121,611
2022-01-06 22:25:28-05:00,2005,Gs3WP18hbzNpbBgiU39e6tfkggfCKRyNqPqJQcthuHFD,4XAY25YUma6gUdG2GdbXeivum3t21g93ZagfWGTZYkWZ,True,42580457,10645113,65894,32947,32947,3zqXX6kzhkbW3d4TwD2CNjMRwxTbREXySekvq37kfCNk,2635795,16966845,-14331050,619
2022-01-06 22:25:29-05:00,2006,BPsM1um9ZJf7eNoVMsQCRSwgARMuLCGGSDxf9tZeNeEy,BpzDdXfxVygiSYSmsHV6uPxQMeTFtrURMCCqhswQjd5X,True,6961129,1740282,10706,5353,5353,3zqXX6kzhkbW3d4TwD2CNjMRwxTbREXySekvq37kfCNk,428276,1903800,-1475524,615
2022-01-06 22:25:29-05:00,2007,Cs2YxkuqBK1kjoYZbUZdUcxapPbv8oC75trwGgWoCPfG,2PgHQM1GhHykE4bQ1ggueAw2Zs1BFUW5hxvMvr8DojKM,True,328172094,82043023,509881,254940,254941,3zqXX6kzhkbW3d4TwD2CNjMRwxTbREXySekvq37kfCNk,20395278,142179413,-121784135,621
2022-01-06 22:25:29-05:00,2008,HGJoZvLakWfSDFwuvShNBc4kCf7nP7VqzyM3mELpbFEf,12Qn5jin7QvsBngXqYAv4UstyG3b6nRf1jsLp9Dp8G7k,True,93630891,23407722,143139,71569,71570,DddJ7EWCmYEEZETCBNgAUSg81Ls6fZtiAaY5ekJ5sXx1,5725578,30736298,-25010720,611
2022-01-06 22:25:30-05:00,2009,6rb3fRVWJ5cSzFcmuC1YwdrNxiNctvboDF7HwsfyGoCA,H6JaYfFZkRk6iSJrA4nVeuFpMVQtVwQZHVgK1TyaupTE,True,250586,62646,389,194,195,3zqXX6kzhkbW3d4TwD2CNjMRwxTbREXySekvq37kfCNk,15576,156689,-141113,621
2022-01-06 22:25:31-05:00,2010,BrHRMouGRz3LBNzd9anfdYMhWfg8yUPHL4PqJ8WdEDFS,4uzoLa3mC2VYHAPBoHLX4gTjPTC28rPf2fvEGtJWPYc,True,351310781,87827695,536211,268105,268106,DddJ7EWCmYEEZETCBNgAUSg81Ls6fZtiAaY5ekJ5sXx1,21448479,228878488,-207430009,610
2022-01-06 22:25:33-05:00,2011,DR7XL3qweFyTKDatQYS2LacqGLv2368cnGuWpEpk4hSL,Fd3BYCiiQfThDJsxBUNwYTMP8eNCrnXMVzE1wpejJqXa,True,27550,6887,42,21,21,3zqXX6kzhkbW3d4TwD2CNjMRwxTbREXySekvq37kfCNk,1709,10749,-9040,620
2022-01-06 22:25:33-05:00,2012,CwTus4FyoXYqyTKAYDp69NLhA1joYZ3tarzY6FFTr6fn,6ivuvYWU6i25MzJSY8rG9rPDKiq38E6QtrV1jvRubLGr,True,60451,15112,93,46,47,DddJ7EWCmYEEZETCBNgAUSg81Ls6fZtiAaY5ekJ5sXx1,3756,19129,-15373,621
2022-01-06 22:25:33-05:00,2013,BYvjENe16Ta77PqGV7JKEWrsqCTfkMGYwTSG5gXneDvd,EvxAXgvhPC6QkNurbK7vWyTApGo8J2R4EgMAknkHVU3d,True,17849248,4462312,27572,13786,13786,DddJ7EWCmYEEZETCBNgAUSg81Ls6fZtiAaY5ekJ5sXx1,1102913,8563632,-7460719,617
2022-01-06 22:25:41-05:00,2014,U3vvMQ4X4aKzVYfhMw1V1p58HRqaLnuXozqmmefYeD9,7JA94MArkNCFRhBq8f5a32DgMF6aPdFsoC5HvXDQ6NuR,True,1812806352,453201588,2768599,1384299,1384300,DddJ7EWCmYEEZETCBNgAUSg81Ls6fZtiAaY5ekJ5sXx1,110743996,709550205,-598806209,610
2022-01-06 22:25:52-05:00,2015,8xvLGVeDmhVYQhN2ZpWkVG9jCrukRsNQ4926a4TMiZqa,9ciBySSjvADwp47WkETiFWZKVTFL8Hf1XvK7aSxhcgQS,True,150819802,37704950,235004,117502,117502,DddJ7EWCmYEEZETCBNgAUSg81Ls6fZtiAaY5ekJ5sXx1,9400183,42702072,-33301889,623
2022-01-06 22:26:00-05:00,2016,F1JT1p2VuwK4L7zj7NNnZtYiZiNUCcTGKDkgdoX3BZdZ,3BKe4yzTwnnBnvTWP3britpPJ4oAWL7JZJzNLCxjUufS,True,30273,7568,47,23,24,3zqXX6kzhkbW3d4TwD2CNjMRwxTbREXySekvq37kfCNk,1889,4437,-2548,623
2022-01-06 22:26:24-05:00,2017,BWtXpiXn1bomr28mGfQFTx1Kd58CQipEnKmeweYowDEC,9jws1qkXvWAdEtBvURVEeGcGJzt4zG2gh8AJESvjKKrx,True,843913609,210978402,1314973,657486,657487,3zqXX6kzhkbW3d4TwD2CNjMRwxTbREXySekvq37kfCNk,52598934,333890094,-281291160,623
2022-01-06 22:26:24-05:00,2018,7D4rFmGMPKNAF75VRPxHAhSn2wTjiW8jmth1UD22Xqq9,GQ7BrT6vsXu8tHCMm75YdxFR2r9QTCrCUbdPEZBSAg9w,True,223329600,55832400,349379,174689,174690,3zqXX6kzhkbW3d4TwD2CNjMRwxTbREXySekvq37kfCNk,13975199,56146996,-42171797,625
2022-01-06 22:26:26-05:00,2019,7vKmhLV45Q5etXhJL5ng8rxWhYSiUCDmAbGnwBPr7zcx,cP6xPeuHLnjr858QK1F9qYn7rJpEbPy7wEJHoju6oV7,True,201640460,50410115,315145,157572,157573,DddJ7EWCmYEEZETCBNgAUSg81Ls6fZtiAaY5ekJ5sXx1,12605823,62857030,-50251207,625
2022-01-06 22:26:27-05:00,2020,5SwL5U5hhQXPW1HXFf4GuU4xkmXoAKx58pjY53NPHqWS,7zB7JvYFzEEwawJy7k7NXvBSG3UsbQte7JxgwvBNbS7U,True,1544463621,386115905,2403549,1201774,1201775,3zqXX6kzhkbW3d4TwD2CNjMRwxTbREXySekvq37kfCNk,96141963,606193352,-510051389,622
2022-01-06 22:26:35-05:00,2021,G5NLYTLxDZfJFKsJdMeWS8Ez95ZFwR5AX4hKhnfVJvoE,AwrC3pKhTeEDr1HCTWoKWjadteZccvqcisbC7vxTjn7w,True,76922124,19230531,119158,59579,59579,3zqXX6kzhkbW3d4TwD2CNjMRwxTbREXySekvq37kfCNk,4766353,31871366,-27105013,619
2022-01-06 22:26:42-05:00,2022,2PzBAkdXkrwH9VuoMALumQz86qkW7sSBQtCrHw14JUp3,D5vwWAMHVooobG2sCWv9EwtJrAFZG6cwKH4dfmA98tbt,True,12104369,3026092,18671,9335,9336,DddJ7EWCmYEEZETCBNgAUSg81Ls6fZtiAaY5ekJ5sXx1,746871,3828480,-3081609,617
2022-01-06 22:26:42-05:00,2023,5Z3ZFCA65WoWhm3okRuuziEMi7ajGAEHWUFchzBNba5S,FcomdrWidygkxMKzcsY5xELbmwC652uMci648LMTv7AB,True,57870,14467,89,44,45,DddJ7EWCmYEEZETCBNgAUSg81Ls6fZtiAaY5ekJ5sXx1,3583,17559,-13976,619
2022-01-06 22:26:42-05:00,2024,DrzTARa7RK8RXoxHZPKCBqYtMC8TAUHRw8SznXRKTa5M,FYANet92VhyXkKZqqBJR4sFxuCftWb68sgQU9VHCdTJk,True,153680,38420,239,119,120,DddJ7EWCmYEEZETCBNgAUSg81Ls6fZtiAaY5ekJ5sXx1,9573,45762,-36189,622
2022-01-06 22:26:46-05:00,2025,i7TcF4weYcqgrRdH3GpndbEYxCxfcSfr9JWYrAUg1CF,BkDfknUir7PnSEW8auoB87PytycEFwyX5kT2GY4SGJJL,True,24606137,6151534,38167,19083,19084,3zqXX6kzhkbW3d4TwD2CNjMRwxTbREXySekvq37kfCNk,1526685,16467530,-14940845,620
2022-01-06 22:27:01-05:00,2026,CK3ocyWzXQkJJZQmM6bBK4Nv6Rh3UEufjY6DvNU6gJZy,C924o4GY3p2BHLeAbFbe9SEysXqCUyD8sFu2d4NzkAV7,True,30295570,7573892,46760,23380,23380,DddJ7EWCmYEEZETCBNgAUSg81Ls6fZtiAaY5ekJ5sXx1,1870424,8131760,-6261336,617
2022-01-06 22:27:02-05:00,2027,E1wp3bmkcY3eiEYyGYwhTCsr7BZ7RfPa5DJTZFupcFwj,452hVdYkD5SDDrA6hv6DLPFvyS8PvR2P6DPNScGxWTsW,True,3748638,937159,5786,2893,2893,3zqXX6kzhkbW3d4TwD2CNjMRwxTbREXySekvq37kfCNk,231452,1228434,-996982,617
2022-01-06 22:27:02-05:00,2028,GJ3PbEfPK8jjrPgMmZtvN5fMSSy2dtiiAtZ8wcfgxVuc,FCUDVFb2TjDvehHE8fVBofqSykpb9W6Afc9QeHtj7te7,True,357233632,89308408,558379,279189,279190,3zqXX6kzhkbW3d4TwD2CNjMRwxTbREXySekvq37kfCNk,22335192,156845056,-134509864,625
2022-01-06 22:27:03-05:00,2029,89CkXnSZnr52Zsoh48efv9MQacrkB6GMtrbEpNJSyA2H,HcvRBS4Z22CpYgDNgm4TVF4AVXFDuYzBUAFcdHAwdpg4,True,13944255,3486063,21762,10881,10881,DddJ7EWCmYEEZETCBNgAUSg81Ls6fZtiAaY5ekJ5sXx1,870485,4307983,-3437498,624
2022-01-06 22:27:04-05:00,2030,2rCRdyfi65rpxRRmg7knaSb8t55FuPt3h8wF4Fzhy8MM,CLVY5nSG3jTdRo7tRSKgK9DJgW6aswfWKe4tLxzsENmb,True,2930756,732689,4578,2289,2289,3zqXX6kzhkbW3d4TwD2CNjMRwxTbREXySekvq37kfCNk,183148,784894,-601746,624
2022-01-06 22:27:04-05:00,2031,Cb4zhnvig11U4GcC4kqKrnDicGgPhUpfDQB1U7hP3nPa,DiRAMrKqaevGXeXg38KnhaYBERj8tNKU7oWFJvhS32kw,True,937652,234413,1445,722,723,DddJ7EWCmYEEZETCBNgAUSg81Ls6fZtiAaY5ekJ5sXx1,57831,245181,-187350,616
2022-01-06 22:27:04-05:00,2032,AKxRtcdpi7gWhAuL8ENj7zhgeQezzEXe9TSANE6bQoRA,2YH4vrU9deP8Cu6E8Hzf8GqKG1yVjv5pdz4FE7r5YKir,True,31836876,7959219,49517,24758,24759,DddJ7EWCmYEEZETCBNgAUSg81Ls6fZtiAaY5ekJ5sXx1,1980683,9817624,-7836941,622
2022-01-06 22:27:07-05:00,2033,GaEpNGa8jnwSRvjzzEMYkZe1pKcr2eiZtePrqFxpABjB,5CFZHuyWbJv14zPdX5dSQDREgHrCb4vsFvB6hLiEe3Ji,True,708574,177143,1106,553,553,3zqXX6kzhkbW3d4TwD2CNjMRwxTbREXySekvq37kfCNk,44244,221611,-177367,624
2022-01-06 22:27:12-05:00,2034,2NHv3c4ufYGo3xNr6KXymAZJdpfURrNiCKbXZ7s82Vwo,E4NYpYgHTvSG6LqH2bBV9Q1XJ6pAzCp9FLSKMzJmYRrQ,True,120293999,30073499,186514,93257,93257,3zqXX6kzhkbW3d4TwD2CNjMRwxTbREXySekvq37kfCNk,7460582,50555147,-43094565,620
2022-01-06 22:27:12-05:00,2035,Ar5QB4VBcUyzSCG23z2QNAbrWY55NbHCr1MNN6P2GAmh,BusFGTiDrJmxzwGUxWz9b3SFF3eseqtgh2DRHqyAwyVe,True,2151651,537912,3361,1680,1681,3zqXX6kzhkbW3d4TwD2CNjMRwxTbREXySekvq37kfCNk,134454,709389,-574935,624
2022-01-06 22:27:12-05:00,2036,6cnA7PeqQgpZdA7jBg4yMzTusm8JJHRWBMup84ywJfYo,FLqcukY7RehqY6ACrwVJnGH3eRgRDe93K1jLYCQN2F3U,True,631914312,157978578,987721,493860,493861,3zqXX6kzhkbW3d4TwD2CNjMRwxTbREXySekvq37kfCNk,39508863,253385178,-213876315,625
2022-01-06 22:27:16-05:00,2037,D3mXrJzhHf8qRaoCKLschUxAFoijFCFuT6bmNZH4W7Cj,9E3Xtqw7TncXWnbhAbFJMtuNmP6WS3ooGuptzyzw7UpA,True,269106,67276,420,210,210,DddJ7EWCmYEEZETCBNgAUSg81Ls6fZtiAaY5ekJ5sXx1,16814,119346,-102532,624
2022-01-06 22:27:19-05:00,2038,HutRztBianNUgm9sJDWKUQBmoVyy8y7CfnNk4hHjSkEW,EtVfvPyiy5bizbCZxR19TNUgETf3QcmziBvMtc6o5zjr,True,1146538144,286634536,1790208,895104,895104,3zqXX6kzhkbW3d4TwD2CNjMRwxTbREXySekvq37kfCNk,71608335,803274991,-731666656,624
2022-01-06 22:27:22-05:00,2039,DmEVzPyCKnm89v481V2ic57vyikwwMja75uVZ2rjvjfp,38fPZzP4NwTtx7Qu6DLSqx9Sv8e5CQbSrr2BMvVmSy4J,True,185780993,46445248,288668,144334,144334,DddJ7EWCmYEEZETCBNgAUSg81Ls6fZtiAaY5ekJ5sXx1,11546754,75997349,-64450595,621
2022-01-06 22:27:23-05:00,2040,JCBhqqPQxP1Xc41sSY6e1sQKRstHhe7D1v6rLz4hp3Qp,DWMUq2bMD1jqpxHtyXDFjcAwjA27yyMRe68hGcsK143m,True,32420,8105,50,25,25,3zqXX6kzhkbW3d4TwD2CNjMRwxTbREXySekvq37kfCNk,2024,9885,-7861,624
2022-01-06 22:27:26-05:00,2041,HqtTbC1LFreGvgfpZe7nCqkNnh8GHPQKosfmc19zb1yi,E39UNiHNkwQEd5GXkCtTPqSorQSB1kLx8kjzK4jdFoi3,True,1446049311,361512327,2257563,1128781,1128782,3zqXX6kzhkbW3d4TwD2CNjMRwxTbREXySekvq37kfCNk,90302536,529913494,-439610958,624
2022-01-06 22:27:28-05:00,2042,DvuRmJkfn6FQczUKgYeaSCqwy2NTMunuAKNrnmxMvnzS,7LpWTX9dgBtW75kfEoB5WuNsDwEdw5s8CYSHh3J4qagM,True,704434042,176108510,1098298,549149,549149,3zqXX6kzhkbW3d4TwD2CNjMRwxTbREXySekvq37kfCNk,43931930,233922627,-189990697,623
2022-01-06 22:27:45-05:00,2043,4MmpDGUTyMcYEqJ1RoZ46AN2BhrBUseHaHqF8AmiTPyD,7HW2YZpYM349HMfW7u4h9ESZ1AXkwN8JcVDTNFzp9aTz,True,558554960,139638740,873459,436729,436730,3zqXX6kzhkbW3d4TwD2CNjMRwxTbREXySekvq37kfCNk,34938388,227606997,-192668609,625
2022-01-06 22:27:47-05:00,2044,9YEzjb49Awvedv9yNc6LG54SkGBug2RYiJwiUV13mGsS,3H8w5WCD187NWWoZMNUCzUDdxTgqrRJLga8gDzUVXBgZ,True,5101829,1275457,7962,3981,3981,72FwbpFGoLEazJEdpqNtPNefsadUrimUqma9wSoy4qiS,318491,2453455,-2134964,624
2022-01-06 22:27:48-05:00,2045,BzSJ77zKaqtBk2cEL1XqFL97zTXXMRHmxtkgtXwCc3C,2g4KXTwy2MPSRQ2khNp1o1rn7CradEr9H4ySYKDoSWN9,True,46995744,11748936,73491,36745,36746,3zqXX6kzhkbW3d4TwD2CNjMRwxTbREXySekvq37kfCNk,2939672,37662925,-34723253,625
2022-01-06 22:27:48-05:00,2046,2NdwSLxsGok8PczpCZj9CVX2BymNU5MvHt7hWfGetg2M,8AQbDXeA6mD9QoZBFJcYbnHvZwKNxzA9CCHLAgdSfTA3,True,49559,12389,77,38,39,3zqXX6kzhkbW3d4TwD2CNjMRwxTbREXySekvq37kfCNk,3098,20268,-17170,625
2022-01-06 22:27:48-05:00,2047,9jdfc9GFTecsdRuTjWFGX13niKKmeBxRgtv5j86uhSnU,HLWMShobjSkaLyXrNjgwVaUGVtbtdUSnr1XjqpXn1bLR,True,1362390,340597,2120,1060,1060,3zqXX6kzhkbW3d4TwD2CNjMRwxTbREXySekvq37kfCNk,84828,479850,-395022,622
2022-01-06 22:27:55-05:00,2048,8BMDSWFtzq9fu1ubVGtSFw8fEaMg1uvJiECuJnN8e1pd,FwkETAXL296CirvQ2AJuSHHtdKsxkZkmXSwZVVHXVDhA,True,605473840,151368460,945389,472694,472695,DddJ7EWCmYEEZETCBNgAUSg81Ls6fZtiAaY5ekJ5sXx1,37815562,182341722,-144526160,624
