ts,record_id,user_authority,user,partial,base_asset_value,base_asset_value_closed,liquidation_fee,fee_to_liquidator,fee_to_insurance_fund,liquidator,total_collateral,collateral,unrealized_pnl,margin_ratio
2022-04-28 11:46:59-04:00,16385,AQr9mVmcXCNQhBVCfx63MwR6c4WqDSC9K2BZqr7N8LCx,CB7TWUaL381ounsLw6neAUaKRxJL9P1HC9uGX5e1Uxod,True,225603736,9584776,50473,25236,25237,2a35JJeTUW1pm6M3e8DHCjp8qr4vbc2cRPhuzZWyFzYd,11880322,63156239,-51275917,526
2022-04-28 12:12:16-04:00,16386,BTwSuuDHNhQAFAzBZRWev5j1ix2RTWvjZAxLpw8grAxu,31NCyUpSXxxJYLSrdK3c5bLomUtMejobMfYnq7j71GtM,True,58429516,14607379,90683,45341,45342,68sueyVfmy5ToEGtLFGDkwebX47xAmzyXE29z8JrmcWv,3627334,15012342,-11385008,620
2022-04-28 12:22:12-04:00,16387,4e73KnWFY3sY2b9WbURTUj5xY1RJS35xy2TvHu379pZ8,13iaT7iXeqaVPyhRCPXFzhpVYNEvDS8in1qDE2ZthykT,True,6743823454,1685955863,11983599,5991799,5991800,DQCvC9mR68hJ3tJsUiddh6JwcBJAmntqGJR2nUsEq7yj,479343988,1194945315,-715601327,710
2022-04-28 12:22:13-04:00,16388,958fskVpeZ1XAq99DX717S89owyq3ospoH6KVfS1Kt3j,7zFRz2kJv874nkBTnKd2xUXwfLuHXtJpzTorvAZzgix6,True,1087359058,271839764,1893088,946544,946544,GXyFXZMNk2NFyEzw6JetVqsujqcz2yCixH7n8EpDJYWD,75723557,384328524,-308604967,696
2022-04-28 12:39:41-04:00,16389,CzWT7zuiD3Usn1DB8C87kZ3yaLcAd1GXe62cZ5xDdEKa,2AsTxJr8dyhHmccUngu2f6beGE9iiXH4yXhmQ48SpCXm,True,34463501,3085717,13808,6904,6904,2a35JJeTUW1pm6M3e8DHCjp8qr4vbc2cRPhuzZWyFzYd,1542222,8822884,-7280662,447
2022-04-28 12:45:19-04:00,16390,5V5gFVMYSwGYfHFecRoHg8G22Rg4bXfVK2FSRTMhPQty,73raXd5MvixmDvJRnVjRL7yQaHZGFRiC9aBxL9ysiRvy,True,139425404,34856351,244389,122194,122195,6UQfSsLooL4pQKQfLtXCutQS2BnF7A7F7ewJopDLmUpc,9775582,26404321,-16628739,701
2022-04-28 12:46:26-04:00,16391,958fskVpeZ1XAq99DX717S89owyq3ospoH6KVfS1Kt3j,7zFRz2kJv874nkBTnKd2xUXwfLuHXtJpzTorvAZzgix6,True,830523123,207630780,1470666,735333,735333,68sueyVfmy5ToEGtLFGDkwebX47xAmzyXE29z8JrmcWv,58826640,305342844,-246516204,708
2022-04-28 12:46:34-04:00,16392,4e73KnWFY3sY2b9WbURTUj5xY1RJS35xy2TvHu379pZ8,13iaT7iXeqaVPyhRCPXFzhpVYNEvDS8in1qDE2ZthykT,True,5170381042,1292595260,8871173,4435586,4435587,68sueyVfmy5ToEGtLFGDkwebX47xAmzyXE29z8JrmcWv,354846938,1006877405,-652030467,686
2022-04-28 13:29:17-04:00,16393,FQnJRA6XCLRpcexUyy5kpxtE1mRcbKZCjQvAo388Xbqc,Hibg8j63eP7oE4HjgviWD77oMLHNcnrib9kYL7q4Uetz,True,6609527849,1652381962,11779266,5889633,5889633,A9TwRM1BMxqb8DCC7YNAMV6zPenEJm3HTZBy7wJKK58U,471170670,2181214003,-1710043333,712
2022-04-28 13:29:59-04:00,16394,8RQrftvvDMztkaUK7USZjeA4bkhJZLX9f1jygdWrsYgb,6bJLycnh4ZHEJtsUZkoygZVp24C8uYDXLedEyzH9iQWG,True,213393423,20060830,131476,65738,65738,68sueyVfmy5ToEGtLFGDkwebX47xAmzyXE29z8JrmcWv,13985610,50841089,-36855479,655
2022-04-28 15:05:57-04:00,16395,958fskVpeZ1XAq99DX717S89owyq3ospoH6KVfS1Kt3j,7zFRz2kJv874nkBTnKd2xUXwfLuHXtJpzTorvAZzgix6,True,635010016,158752504,1131779,565889,565890,3zqXX6kzhkbW3d4TwD2CNjMRwxTbREXySekvq37kfCNk,45271194,242309307,-197038113,712
2022-04-28 15:06:30-04:00,16396,4e73KnWFY3sY2b9WbURTUj5xY1RJS35xy2TvHu379pZ8,13iaT7iXeqaVPyhRCPXFzhpVYNEvDS8in1qDE2ZthykT,True,3946743787,986685946,6930535,3465267,3465268,gjBMZYVujDjD1ECG4i97M8Q3gV9ESnwwTSUGropkusj,277221406,836802058,-559580652,702
2022-04-28 15:06:40-04:00,16397,8RQrftvvDMztkaUK7USZjeA4bkhJZLX9f1jygdWrsYgb,6bJLycnh4ZHEJtsUZkoygZVp24C8uYDXLedEyzH9iQWG,True,194749098,20088113,128288,64144,64144,2a35JJeTUW1pm6M3e8DHCjp8qr4vbc2cRPhuzZWyFzYd,12437265,41195164,-28757899,638
2022-04-28 15:09:56-04:00,16398,FQnJRA6XCLRpcexUyy5kpxtE1mRcbKZCjQvAo388Xbqc,Hibg8j63eP7oE4HjgviWD77oMLHNcnrib9kYL7q4Uetz,True,5079158514,1269789628,8434469,4217234,4217235,A2p75MbAbeUdHkPLkAjgGeiwuu9WPrkMHzjCkDXF1Xr3,337378777,1744137525,-1406758748,664
2022-04-28 15:09:57-04:00,16399,9eKNXvt7rsFHQrGi3mRXkM72mgXzihiT8Fu5W7684aDz,Hqb9XR3XMvyqdohRa5myFSNm3oLxDNtjRhbdkfn5jGPS,True,130857060762,27960910418,177352820,88676410,88676410,gjBMZYVujDjD1ECG4i97M8Q3gV9ESnwwTSUGropkusj,8300112036,19889241566,-11589129530,634
2022-04-28 15:10:01-04:00,16400,CW93ahtJm7jTwZxVCWTAfjpu19qyUZtXo1DrZFFkaSKe,5xLuUAgk9fAvBhPyUaWHfH6c5ejzefLt7X17mEcxvvQW,True,746764231,152049518,646327,323163,323164,2a35JJeTUW1pm6M3e8DHCjp8qr4vbc2cRPhuzZWyFzYd,31743267,96031992,-64288725,425
2022-04-28 15:10:01-04:00,16401,FQnJRA6XCLRpcexUyy5kpxtE1mRcbKZCjQvAo388Xbqc,Hibg8j63eP7oE4HjgviWD77oMLHNcnrib9kYL7q4Uetz,True,3886644811,971661202,6291709,3145854,3145855,6UQfSsLooL4pQKQfLtXCutQS2BnF7A7F7ewJopDLmUpc,251668383,1385272441,-1133604058,647
2022-04-28 15:10:11-04:00,16402,958fskVpeZ1XAq99DX717S89owyq3ospoH6KVfS1Kt3j,7zFRz2kJv874nkBTnKd2xUXwfLuHXtJpzTorvAZzgix6,True,492628725,123157181,694205,347102,347103,2xTUy2RS74GJMMDnmFaegMzFLn19RVfYG4CibhBmjP1i,27768202,191936902,-164168700,563
2022-04-28 15:10:11-04:00,16403,5V5gFVMYSwGYfHFecRoHg8G22Rg4bXfVK2FSRTMhPQty,73raXd5MvixmDvJRnVjRL7yQaHZGFRiC9aBxL9ysiRvy,True,391190822,97797705,541094,270547,270547,2a35JJeTUW1pm6M3e8DHCjp8qr4vbc2cRPhuzZWyFzYd,21643760,55758534,-34114774,553
2022-04-28 15:10:12-04:00,16404,7ibRzTcuG8ah4mzzXYMuXqtTC8RHYWhmGgXL257rmLa4,SsLPddD1G5F7WUGXwXCne36k6momA7jwKGqgyTZcGDt,True,1402258032,350564508,1994300,997150,997150,68sueyVfmy5ToEGtLFGDkwebX47xAmzyXE29z8JrmcWv,79772009,289956120,-210184111,568
2022-04-28 15:10:13-04:00,16405,6Auz7aARPERW9zbV8428yFUWkA9DuitQYiWQzewueU3o,G1xfLGt5twz7MTfEq6NnMZBpr6GmXceKdGUQkc9jugRB,True,233670763,58417690,300991,150495,150496,6UQfSsLooL4pQKQfLtXCutQS2BnF7A7F7ewJopDLmUpc,12039669,30572685,-18533016,515
2022-04-28 15:10:36-04:00,16406,fAJK1wrBhSW297AtFWX2U4rUBf2gkzfQ6UrQL9yHEYW,5pyTFpanSyUCHxeMhJMKtpdrcMSAWc8bFadbyM7q4q4B,True,301801154,75450288,506744,253372,253372,2a35JJeTUW1pm6M3e8DHCjp8qr4vbc2cRPhuzZWyFzYd,20269791,31533137,-11263346,671
2022-04-28 15:13:01-04:00,16407,8RQrftvvDMztkaUK7USZjeA4bkhJZLX9f1jygdWrsYgb,6bJLycnh4ZHEJtsUZkoygZVp24C8uYDXLedEyzH9iQWG,True,175485786,15404780,100812,50406,50406,68sueyVfmy5ToEGtLFGDkwebX47xAmzyXE29z8JrmcWv,11484176,42072242,-30588066,654
2022-04-28 15:17:00-04:00,16408,CzWT7zuiD3Usn1DB8C87kZ3yaLcAd1GXe62cZ5xDdEKa,2AsTxJr8dyhHmccUngu2f6beGE9iiXH4yXhmQ48SpCXm,True,32184304,2434917,10366,5183,5183,68sueyVfmy5ToEGtLFGDkwebX47xAmzyXE29z8JrmcWv,1370181,7444474,-6074293,425
2022-04-28 15:17:02-04:00,16409,4e73KnWFY3sY2b9WbURTUj5xY1RJS35xy2TvHu379pZ8,13iaT7iXeqaVPyhRCPXFzhpVYNEvDS8in1qDE2ZthykT,True,3023444032,755861008,5173025,2586512,2586513,2a35JJeTUW1pm6M3e8DHCjp8qr4vbc2cRPhuzZWyFzYd,206921017,690899802,-483978785,684
2022-04-28 15:18:45-04:00,16410,6Auz7aARPERW9zbV8428yFUWkA9DuitQYiWQzewueU3o,G1xfLGt5twz7MTfEq6NnMZBpr6GmXceKdGUQkc9jugRB,True,174548988,43637247,311092,155546,155546,2a35JJeTUW1pm6M3e8DHCjp8qr4vbc2cRPhuzZWyFzYd,12443701,25642737,-13199036,712
2022-04-28 15:23:43-04:00,16411,958fskVpeZ1XAq99DX717S89owyq3ospoH6KVfS1Kt3j,7zFRz2kJv874nkBTnKd2xUXwfLuHXtJpzTorvAZzgix6,True,370147758,92536939,659994,329997,329997,GXyFXZMNk2NFyEzw6JetVqsujqcz2yCixH7n8EpDJYWD,26399762,150213314,-123813552,713
2022-04-28 15:23:43-04:00,16412,5V5gFVMYSwGYfHFecRoHg8G22Rg4bXfVK2FSRTMhPQty,73raXd5MvixmDvJRnVjRL7yQaHZGFRiC9aBxL9ysiRvy,True,293928964,73482241,514209,257104,257105,68sueyVfmy5ToEGtLFGDkwebX47xAmzyXE29z8JrmcWv,20568390,46699651,-26131261,699
2022-04-28 15:23:47-04:00,16413,CzWT7zuiD3Usn1DB8C87kZ3yaLcAd1GXe62cZ5xDdEKa,2AsTxJr8dyhHmccUngu2f6beGE9iiXH4yXhmQ48SpCXm,True,29831405,5602540,22702,11351,11351,68sueyVfmy5ToEGtLFGDkwebX47xAmzyXE29z8JrmcWv,1208853,6289814,-5080961,405
2022-04-28 15:23:53-04:00,16414,7ibRzTcuG8ah4mzzXYMuXqtTC8RHYWhmGgXL257rmLa4,SsLPddD1G5F7WUGXwXCne36k6momA7jwKGqgyTZcGDt,True,1054852617,263713154,1865606,932803,932803,2xTUy2RS74GJMMDnmFaegMzFLn19RVfYG4CibhBmjP1i,74624247,235533110,-160908863,707
2022-04-28 15:23:56-04:00,16415,8RQrftvvDMztkaUK7USZjeA4bkhJZLX9f1jygdWrsYgb,6bJLycnh4ZHEJtsUZkoygZVp24C8uYDXLedEyzH9iQWG,True,161017160,15050941,97656,48828,48828,68sueyVfmy5ToEGtLFGDkwebX47xAmzyXE29z8JrmcWv,10447462,34476861,-24029399,648
2022-04-28 15:24:06-04:00,16416,9eKNXvt7rsFHQrGi3mRXkM72mgXzihiT8Fu5W7684aDz,Hqb9XR3XMvyqdohRa5myFSNm3oLxDNtjRhbdkfn5jGPS,True,104685103842,26171275960,186737027,93368513,93368514,gjBMZYVujDjD1ECG4i97M8Q3gV9ESnwwTSUGropkusj,7469481090,18169600292,-10700119202,713
2022-04-28 15:24:07-04:00,16417,7ibRzTcuG8ah4mzzXYMuXqtTC8RHYWhmGgXL257rmLa4,SsLPddD1G5F7WUGXwXCne36k6momA7jwKGqgyTZcGDt,True,807079821,201769955,1420457,710228,710229,GXyFXZMNk2NFyEzw6JetVqsujqcz2yCixH7n8EpDJYWD,56818283,193503192,-136684909,703
2022-04-28 15:24:09-04:00,16418,958fskVpeZ1XAq99DX717S89owyq3ospoH6KVfS1Kt3j,7zFRz2kJv874nkBTnKd2xUXwfLuHXtJpzTorvAZzgix6,True,283700913,70925228,491241,245620,245621,2py1FiYeL2f7J3HU36qiJz6TD6HCmiTN36RyxYtapQCZ,19649674,118606019,-98956345,692
2022-04-28 15:24:11-04:00,16419,5V5gFVMYSwGYfHFecRoHg8G22Rg4bXfVK2FSRTMhPQty,73raXd5MvixmDvJRnVjRL7yQaHZGFRiC9aBxL9ysiRvy,True,225282195,56320548,380467,190233,190234,2a35JJeTUW1pm6M3e8DHCjp8qr4vbc2cRPhuzZWyFzYd,15218709,39657881,-24439172,675
2022-04-28 15:24:16-04:00,16420,FQnJRA6XCLRpcexUyy5kpxtE1mRcbKZCjQvAo388Xbqc,Hibg8j63eP7oE4HjgviWD77oMLHNcnrib9kYL7q4Uetz,True,2977937504,744484376,4560959,2280479,2280480,2py1FiYeL2f7J3HU36qiJz6TD6HCmiTN36RyxYtapQCZ,182438373,1096310117,-913871744,612
2022-04-28 15:24:20-04:00,16421,4e73KnWFY3sY2b9WbURTUj5xY1RJS35xy2TvHu379pZ8,13iaT7iXeqaVPyhRCPXFzhpVYNEvDS8in1qDE2ZthykT,True,2339931259,584982814,3234993,1617496,1617497,GXyFXZMNk2NFyEzw6JetVqsujqcz2yCixH7n8EpDJYWD,129399757,565247440,-435847683,553
2022-04-28 15:24:20-04:00,16422,CzWT7zuiD3Usn1DB8C87kZ3yaLcAd1GXe62cZ5xDdEKa,2AsTxJr8dyhHmccUngu2f6beGE9iiXH4yXhmQ48SpCXm,True,24386270,1894662,7992,3996,3996,2a35JJeTUW1pm6M3e8DHCjp8qr4vbc2cRPhuzZWyFzYd,1028746,5884223,-4855477,421
2022-04-28 15:24:29-04:00,16423,8RQrftvvDMztkaUK7USZjeA4bkhJZLX9f1jygdWrsYgb,6bJLycnh4ZHEJtsUZkoygZVp24C8uYDXLedEyzH9iQWG,True,146835609,12055769,77837,38918,38919,68sueyVfmy5ToEGtLFGDkwebX47xAmzyXE29z8JrmcWv,9480416,35148321,-25667905,645
2022-04-28 15:48:20-04:00,16424,GdmdwHEVufQPVY4wzW32ZKhGwJ6T7EEWYH8ZcSgNU5ee,Gxyre48jDULjD1eykxQvDMdjGLmymrBgG38zCjjJP3wf,True,1411136651,352784162,2473539,1236769,1236770,3zqXX6kzhkbW3d4TwD2CNjMRwxTbREXySekvq37kfCNk,98941566,144643005,-45701439,701
2022-04-28 16:02:24-04:00,16425,GdmdwHEVufQPVY4wzW32ZKhGwJ6T7EEWYH8ZcSgNU5ee,Gxyre48jDULjD1eykxQvDMdjGLmymrBgG38zCjjJP3wf,True,1033242962,258310740,1783962,891981,891981,3zqXX6kzhkbW3d4TwD2CNjMRwxTbREXySekvq37kfCNk,71358500,130860619,-59502119,690
2022-04-28 16:08:14-04:00,16426,DHfy6B2AYsqMCxPLBCXMDfQn3Gr2VwJaLFHUZKqpCjsb,EPZpYaY1gCAb8pMtri5veRowBmCrCpTHBMa3Rmgt6S29,True,516566178,129141544,900182,450091,450091,A9TwRM1BMxqb8DCC7YNAMV6zPenEJm3HTZBy7wJKK58U,36007310,37349943,-1342633,697
2022-04-28 16:11:13-04:00,16427,AQr9mVmcXCNQhBVCfx63MwR6c4WqDSC9K2BZqr7N8LCx,CB7TWUaL381ounsLw6neAUaKRxJL9P1HC9uGX5e1Uxod,True,220899751,20168326,104440,52220,52220,2a35JJeTUW1pm6M3e8DHCjp8qr4vbc2cRPhuzZWyFzYd,11439161,60895199,-49456038,517
2022-04-28 16:29:01-04:00,16428,CzWT7zuiD3Usn1DB8C87kZ3yaLcAd1GXe62cZ5xDdEKa,2AsTxJr8dyhHmccUngu2f6beGE9iiXH4yXhmQ48SpCXm,False,22324578,22324578,906269,45313,860956,68sueyVfmy5ToEGtLFGDkwebX47xAmzyXE29z8JrmcWv,906270,4949341,-4043071,405
2022-04-28 16:31:22-04:00,16429,4e73KnWFY3sY2b9WbURTUj5xY1RJS35xy2TvHu379pZ8,13iaT7iXeqaVPyhRCPXFzhpVYNEvDS8in1qDE2ZthykT,True,1758669028,439667257,3061104,1530552,1530552,6UQfSsLooL4pQKQfLtXCutQS2BnF7A7F7ewJopDLmUpc,122444181,453344866,-330900685,696
2022-04-28 16:33:25-04:00,16430,FQnJRA6XCLRpcexUyy5kpxtE1mRcbKZCjQvAo388Xbqc,Hibg8j63eP7oE4HjgviWD77oMLHNcnrib9kYL7q4Uetz,True,2253790369,563447592,3938504,1969252,1969252,3zqXX6kzhkbW3d4TwD2CNjMRwxTbREXySekvq37kfCNk,157540173,863687373,-706147200,699
2022-04-28 16:33:55-04:00,16431,GD6Hw8ZErxFJeA5PunxorcUNN5v9gM77mWPjHT3Mx2Bw,EmreHG5gVyyL7iVhoxq8GcmzPV7V6SBxVNZajutC5HAF,True,1252657462,313164365,2103590,1051795,1051795,68sueyVfmy5ToEGtLFGDkwebX47xAmzyXE29z8JrmcWv,84143627,125160848,-41017221,671
2022-04-28 16:45:32-04:00,16432,CW93ahtJm7jTwZxVCWTAfjpu19qyUZtXo1DrZFFkaSKe,5xLuUAgk9fAvBhPyUaWHfH6c5ejzefLt7X17mEcxvvQW,True,594727814,41096388,203192,101596,101596,C4UnXuShCvjSMgBAgVNMy1oakxCNk1et27A82fywU112,29405142,83838788,-54433646,494
2022-04-28 17:01:25-04:00,16433,9XuUGP13n5xuMtUYhAH1fe9jFKK7FjgTzcuJqDfV1gqC,AFNffLzWzrg7vgdwxyHeaSc6kUtqYPV8pRvdUx8wt7x3,True,28621027892,7155256973,50468445,25234222,25234223,3zqXX6kzhkbW3d4TwD2CNjMRwxTbREXySekvq37kfCNk,2018737836,2924254763,-905516927,705
2022-04-28 17:24:25-04:00,16434,5V5gFVMYSwGYfHFecRoHg8G22Rg4bXfVK2FSRTMhPQty,73raXd5MvixmDvJRnVjRL7yQaHZGFRiC9aBxL9ysiRvy,True,171691465,42922866,302418,151209,151209,68sueyVfmy5ToEGtLFGDkwebX47xAmzyXE29z8JrmcWv,12096734,33158919,-21062185,704
2022-04-28 17:35:07-04:00,16435,4e73KnWFY3sY2b9WbURTUj5xY1RJS35xy2TvHu379pZ8,13iaT7iXeqaVPyhRCPXFzhpVYNEvDS8in1qDE2ZthykT,True,1344996167,336249041,2332440,1166220,1166220,C4UnXuShCvjSMgBAgVNMy1oakxCNk1et27A82fywU112,93297607,367633198,-274335591,693
2022-04-28 17:35:07-04:00,16436,958fskVpeZ1XAq99DX717S89owyq3ospoH6KVfS1Kt3j,7zFRz2kJv874nkBTnKd2xUXwfLuHXtJpzTorvAZzgix6,True,217392176,54348044,363180,181590,181590,DQCvC9mR68hJ3tJsUiddh6JwcBJAmntqGJR2nUsEq7yj,14527220,93364431,-78837211,668
2022-04-28 17:37:59-04:00,16437,HooxSzasW3HMoFJ6sAvRQ75Char1J5aBdJtsqfDV6myp,BCmsWwpGeV4NNfeKZKKydty2uueLGHYTJDk1WErpXsVT,True,46376651,11594162,72440,36220,36220,2a35JJeTUW1pm6M3e8DHCjp8qr4vbc2cRPhuzZWyFzYd,2897601,17065854,-14168253,624
2022-04-28 17:38:35-04:00,16438,FQnJRA6XCLRpcexUyy5kpxtE1mRcbKZCjQvAo388Xbqc,Hibg8j63eP7oE4HjgviWD77oMLHNcnrib9kYL7q4Uetz,True,1735739906,433934976,2702215,1351107,1351108,3zqXX6kzhkbW3d4TwD2CNjMRwxTbREXySekvq37kfCNk,108088611,683325533,-575236922,622
2022-04-28 17:38:36-04:00,16439,7ibRzTcuG8ah4mzzXYMuXqtTC8RHYWhmGgXL257rmLa4,SsLPddD1G5F7WUGXwXCne36k6momA7jwKGqgyTZcGDt,True,498912413,124728103,786166,393083,393083,2a35JJeTUW1pm6M3e8DHCjp8qr4vbc2cRPhuzZWyFzYd,31446661,57141389,-25694728,630
2022-04-28 17:38:37-04:00,16440,FQnJRA6XCLRpcexUyy5kpxtE1mRcbKZCjQvAo388Xbqc,Hibg8j63eP7oE4HjgviWD77oMLHNcnrib9kYL7q4Uetz,False,1541624171,1541624171,0,0,0,3zqXX6kzhkbW3d4TwD2CNjMRwxTbREXySekvq37kfCNk,0,536944797,-671377642,0
2022-04-28 17:38:39-04:00,16441,FsMiJiJZibohKoV5QRisWCjzuFd86xSxFb4m73AQmu93,7p3TSKBaG9SV2YNDnhutQKacPKpTTmgsEfzmK51t6sYb,False,986160929,986160929,0,0,0,C4UnXuShCvjSMgBAgVNMy1oakxCNk1et27A82fywU112,0,139533883,-235538170,0
2022-04-28 17:38:40-04:00,16442,5V5gFVMYSwGYfHFecRoHg8G22Rg4bXfVK2FSRTMhPQty,73raXd5MvixmDvJRnVjRL7yQaHZGFRiC9aBxL9ysiRvy,False,155665182,155665182,0,0,0,DQCvC9mR68hJ3tJsUiddh6JwcBJAmntqGJR2nUsEq7yj,0,27592649,-42694916,0
2022-04-28 17:38:40-04:00,16443,7ibRzTcuG8ah4mzzXYMuXqtTC8RHYWhmGgXL257rmLa4,SsLPddD1G5F7WUGXwXCne36k6momA7jwKGqgyTZcGDt,False,443822572,443822572,0,0,0,gjBMZYVujDjD1ECG4i97M8Q3gV9ESnwwTSUGropkusj,0,49946860,-88924627,0
2022-04-28 17:38:44-04:00,16444,CW93ahtJm7jTwZxVCWTAfjpu19qyUZtXo1DrZFFkaSKe,5xLuUAgk9fAvBhPyUaWHfH6c5ejzefLt7X17mEcxvvQW,False,570048926,570048926,10726266,536313,10189953,3zqXX6kzhkbW3d4TwD2CNjMRwxTbREXySekvq37kfCNk,10726267,71383662,-60657395,188
2022-04-28 17:38:45-04:00,16445,4e73KnWFY3sY2b9WbURTUj5xY1RJS35xy2TvHu379pZ8,13iaT7iXeqaVPyhRCPXFzhpVYNEvDS8in1qDE2ZthykT,False,1105296781,1105296781,0,0,0,68sueyVfmy5ToEGtLFGDkwebX47xAmzyXE29z8JrmcWv,0,296810944,-302395432,0
2022-04-28 17:38:49-04:00,16446,8RQrftvvDMztkaUK7USZjeA4bkhJZLX9f1jygdWrsYgb,6bJLycnh4ZHEJtsUZkoygZVp24C8uYDXLedEyzH9iQWG,False,137978235,137978235,6201979,310098,5891881,68sueyVfmy5ToEGtLFGDkwebX47xAmzyXE29z8JrmcWv,6201981,28944926,-22742945,449
2022-04-28 17:38:52-04:00,16447,958fskVpeZ1XAq99DX717S89owyq3ospoH6KVfS1Kt3j,7zFRz2kJv874nkBTnKd2xUXwfLuHXtJpzTorvAZzgix6,False,176692876,176692876,515296,25764,489532,C4UnXuShCvjSMgBAgVNMy1oakxCNk1et27A82fywU112,515296,73293916,-72778620,29
2022-04-28 18:12:55-04:00,16448,5o4EAqBTiUKn41QhPL5kRjrGTgQVdP7xLtxC7xNxjkwn,E8gDreu3LxW1EHJ8hnqChK9QdffGh5GocJYKdrbYat8E,True,466073253,116518313,727938,363969,363969,68sueyVfmy5ToEGtLFGDkwebX47xAmzyXE29z8JrmcWv,29117553,142201991,-113084438,624
2022-04-28 19:15:42-04:00,16449,DHfy6B2AYsqMCxPLBCXMDfQn3Gr2VwJaLFHUZKqpCjsb,EPZpYaY1gCAb8pMtri5veRowBmCrCpTHBMa3Rmgt6S29,True,680855731,170213932,1157237,578618,578619,2a35JJeTUW1pm6M3e8DHCjp8qr4vbc2cRPhuzZWyFzYd,46289492,36156827,10132665,679
2022-04-28 19:19:17-04:00,16450,DHfy6B2AYsqMCxPLBCXMDfQn3Gr2VwJaLFHUZKqpCjsb,EPZpYaY1gCAb8pMtri5veRowBmCrCpTHBMa3Rmgt6S29,True,500452572,125113143,873575,436787,436788,C4UnXuShCvjSMgBAgVNMy1oakxCNk1et27A82fywU112,34943028,37562824,-2619796,698
2022-04-28 20:42:39-04:00,16451,B2nFCBzpcf1ptxYz1qJhsvMi66FxVC9MRbmyE651zyvc,Hrkw5SLuHTpmqamJBBTiDQHoF6Cmj5tSf4BFvgbNqUVx,True,1186663470,296665867,2112400,1056200,1056200,gjBMZYVujDjD1ECG4i97M8Q3gV9ESnwwTSUGropkusj,84496020,184475850,-99979830,712
2022-04-28 20:46:58-04:00,16452,DK24JASWC2tR9MyHiQwGVNXZj97AuhYo6BmfxGp289eR,BFjgan9PWn6ECgXUbLKbqzNnHcsGfJ1yYYxioPNCmwGj,True,687831200,171957799,1208037,604018,604019,6UQfSsLooL4pQKQfLtXCutQS2BnF7A7F7ewJopDLmUpc,48321528,75897819,-27576291,702
2022-04-28 21:52:34-04:00,16453,F4hN7ecndZ8Gr5KQNSFaSrMGawMasz7jfWTLTMpk7gaB,AJ23FpXSGjipcqywk88WGsKfqfiiUjPzZLsvLtBAhB12,True,3178542076,794635519,5626446,2813223,2813223,3zqXX6kzhkbW3d4TwD2CNjMRwxTbREXySekvq37kfCNk,225057859,136993365,88064494,708
2022-04-28 21:52:39-04:00,16454,4ix593T9wKzayR8FqXFc2xZjNiEXM1MafowMVgP9c3AU,Go4gJoYfXXZjxNH4PFd9knsSCjDkgw5QQy7KzgUrUb2n,True,1875729651,468932412,2995051,1497525,1497526,2a35JJeTUW1pm6M3e8DHCjp8qr4vbc2cRPhuzZWyFzYd,119802074,193745563,-73943489,638
2022-04-28 21:54:29-04:00,16455,B2nFCBzpcf1ptxYz1qJhsvMi66FxVC9MRbmyE651zyvc,Hrkw5SLuHTpmqamJBBTiDQHoF6Cmj5tSf4BFvgbNqUVx,True,868436101,217109025,1528650,764325,764325,GXyFXZMNk2NFyEzw6JetVqsujqcz2yCixH7n8EpDJYWD,61146013,157794747,-96648734,704
2022-04-28 21:56:11-04:00,16456,DK24JASWC2tR9MyHiQwGVNXZj97AuhYo6BmfxGp289eR,BFjgan9PWn6ECgXUbLKbqzNnHcsGfJ1yYYxioPNCmwGj,True,503685034,125921258,877850,438925,438925,68sueyVfmy5ToEGtLFGDkwebX47xAmzyXE29z8JrmcWv,35114032,68017712,-32903680,697
2022-04-28 21:57:03-04:00,16457,F4hN7ecndZ8Gr5KQNSFaSrMGawMasz7jfWTLTMpk7gaB,AJ23FpXSGjipcqywk88WGsKfqfiiUjPzZLsvLtBAhB12,True,2326297997,581574499,4045571,2022785,2022786,68sueyVfmy5ToEGtLFGDkwebX47xAmzyXE29z8JrmcWv,161822853,154044301,7778552,695
2022-04-28 21:57:03-04:00,16458,4ix593T9wKzayR8FqXFc2xZjNiEXM1MafowMVgP9c3AU,Go4gJoYfXXZjxNH4PFd9knsSCjDkgw5QQy7KzgUrUb2n,True,1386118256,346529564,2403201,1201600,1201601,2py1FiYeL2f7J3HU36qiJz6TD6HCmiTN36RyxYtapQCZ,96128040,172512063,-76384023,693
2022-04-28 22:04:26-04:00,16459,B2nFCBzpcf1ptxYz1qJhsvMi66FxVC9MRbmyE651zyvc,Hrkw5SLuHTpmqamJBBTiDQHoF6Cmj5tSf4BFvgbNqUVx,True,633785746,158446436,1052937,526468,526469,3zqXX6kzhkbW3d4TwD2CNjMRwxTbREXySekvq37kfCNk,42117499,132202266,-90084767,664
2022-04-28 22:04:30-04:00,16460,DK24JASWC2tR9MyHiQwGVNXZj97AuhYo6BmfxGp289eR,BFjgan9PWn6ECgXUbLKbqzNnHcsGfJ1yYYxioPNCmwGj,True,369630299,92407574,653172,326586,326586,gjBMZYVujDjD1ECG4i97M8Q3gV9ESnwwTSUGropkusj,26126888,58956522,-32829634,706
2022-04-28 22:09:53-04:00,16461,4ix593T9wKzayR8FqXFc2xZjNiEXM1MafowMVgP9c3AU,Go4gJoYfXXZjxNH4PFd9knsSCjDkgw5QQy7KzgUrUb2n,True,1017713893,254428473,1797920,898960,898960,A9TwRM1BMxqb8DCC7YNAMV6zPenEJm3HTZBy7wJKK58U,71916809,151217815,-79301006,706
2022-04-28 22:14:44-04:00,16462,B2nFCBzpcf1ptxYz1qJhsvMi66FxVC9MRbmyE651zyvc,Hrkw5SLuHTpmqamJBBTiDQHoF6Cmj5tSf4BFvgbNqUVx,True,467243270,116810817,824213,412106,412107,2a35JJeTUW1pm6M3e8DHCjp8qr4vbc2cRPhuzZWyFzYd,32968522,108659707,-75691185,705
2022-04-28 22:20:38-04:00,16463,4ix593T9wKzayR8FqXFc2xZjNiEXM1MafowMVgP9c3AU,Go4gJoYfXXZjxNH4PFd9knsSCjDkgw5QQy7KzgUrUb2n,True,746026347,186506586,1321495,660747,660748,2py1FiYeL2f7J3HU36qiJz6TD6HCmiTN36RyxYtapQCZ,52859816,129671571,-76811755,708
2022-04-28 22:35:03-04:00,16464,8qq2gfbca7JXvq4gViBBVT2QAbM4MvBMEQLXgn8UUTvt,3o5jpBVYdFFEYrGRdCUkLrUC85wsuTKgy8iYwnpZyC1B,True,264088477,35270962,157819,78909,78910,68sueyVfmy5ToEGtLFGDkwebX47xAmzyXE29z8JrmcWv,11816606,113352147,-101535541,447
2022-04-28 22:35:40-04:00,16465,GNohZMtk1VAuhLAgNGT8J3HYCKDCiyjvLeAWr64d7Duy,6soTLVj9DzFht8DzvjRfNPAWhZuiDBS5fDE1fpeuDSSz,True,3001674592,750418648,4677785,2338892,2338893,2xTUy2RS74GJMMDnmFaegMzFLn19RVfYG4CibhBmjP1i,187111401,846674407,-659563006,623
2022-04-28 22:54:55-04:00,16466,5wcyw2KsaCSSXaDocVzV8Yz9yHNG1E8TajEoeoBqiENL,2vuppCGeADLpY3sGJVLbmM5aRW3r5aHDgCBLS7QZoCg5,True,26993591,6748397,41062,20531,20531,C4UnXuShCvjSMgBAgVNMy1oakxCNk1et27A82fywU112,1642502,8585502,-6943000,608
2022-04-28 22:54:55-04:00,16467,6NJFN855M3Q3RLTDNo57gTgAmwPD6G2E3WvMb1m5eNCN,3YpqNnonsvXaRT4nCC3G5FZx1jjVtbDPc36LiR6WK5jR,True,82994241,20748560,124902,62451,62451,2a35JJeTUW1pm6M3e8DHCjp8qr4vbc2cRPhuzZWyFzYd,4996080,28750216,-23754136,601
2022-04-28 22:57:04-04:00,16468,BWta2HTjCwDidjsgv1vPoD3gCHSGf679N1xijEj5jzD3,JEFa5ojXJ95W2NsV5j8qBENTm5n1uGfPDFwLRvebHDVn,True,341079475,85269868,519127,259563,259564,3zqXX6kzhkbW3d4TwD2CNjMRwxTbREXySekvq37kfCNk,20765101,111240138,-90475037,608
2022-04-28 22:57:07-04:00,16469,HHp8dRc1YMWE93uyLdM98DkUhM8U8zm3JC59chrbbWrk,AdqFuGe28VeAwwjRPZCBGVy5ftf9zNNQkg413i66wyig,True,26097518,6524379,40372,20186,20186,2a35JJeTUW1pm6M3e8DHCjp8qr4vbc2cRPhuzZWyFzYd,1614884,9761291,-8146407,618
2022-04-28 22:57:16-04:00,16470,AQr9mVmcXCNQhBVCfx63MwR6c4WqDSC9K2BZqr7N8LCx,CB7TWUaL381ounsLw6neAUaKRxJL9P1HC9uGX5e1Uxod,True,167556203,9355363,47466,23733,23733,2a35JJeTUW1pm6M3e8DHCjp8qr4vbc2cRPhuzZWyFzYd,8501336,48691350,-40190014,507
2022-04-28 23:13:57-04:00,16471,7ueXVhSvXvttkeQ18w2cLh65naoEPvYF86RrdUK2Vc5Q,CKTehY1W6bw85cS4o7g2qXKjP4656Vwo37244BAEAiw1,True,57103274,14272586,86801,43400,43401,68sueyVfmy5ToEGtLFGDkwebX47xAmzyXE29z8JrmcWv,3472849,28931612,-25458763,608
2022-04-28 23:20:47-04:00,16472,5QxR9QPTADFys9VQNm473RgprTikCXC23vhsBc9ojyAQ,H9zdf8nJ4JCF7jrwGsxiuiFoa14gzDmYsZ5N5ig3UGna,True,280946429,70236607,488897,244448,244449,68sueyVfmy5ToEGtLFGDkwebX47xAmzyXE29z8JrmcWv,19555885,29237750,-9681865,696
2022-04-28 23:20:50-04:00,16473,B2nFCBzpcf1ptxYz1qJhsvMi66FxVC9MRbmyE651zyvc,Hrkw5SLuHTpmqamJBBTiDQHoF6Cmj5tSf4BFvgbNqUVx,True,342566051,85641512,609895,304947,304948,2a35JJeTUW1pm6M3e8DHCjp8qr4vbc2cRPhuzZWyFzYd,24395811,89048210,-64652399,712
2022-04-28 23:21:16-04:00,16474,Aegmcn7VWMa1hTYSqLiJAz2P9EmSHXZNJZgeCtPEnAhZ,5MPtSRLs5paUtdwhinwhZZV8jnR4LeyPbM94qLYMk75C,True,1022753339,255688334,1758186,879093,879093,A2p75MbAbeUdHkPLkAjgGeiwuu9WPrkMHzjCkDXF1Xr3,70327463,101304087,-30976624,687
2022-04-28 23:22:50-04:00,16475,5zSoXxVZYYQAtq3urfcUQmJkjFDBXkUJYSNFdq759Tof,3C459gJnmj4EYTG3tDFJEEf1aAT915sxRLs2THEdQqha,True,1047232379,261808094,1824894,912447,912447,GXyFXZMNk2NFyEzw6JetVqsujqcz2yCixH7n8EpDJYWD,72995794,275932098,-202936304,697
2022-04-28 23:22:52-04:00,16476,4ix593T9wKzayR8FqXFc2xZjNiEXM1MafowMVgP9c3AU,Go4gJoYfXXZjxNH4PFd9knsSCjDkgw5QQy7KzgUrUb2n,True,545869546,136467386,951949,475974,475975,2a35JJeTUW1pm6M3e8DHCjp8qr4vbc2cRPhuzZWyFzYd,38077969,109379787,-71301818,697
2022-04-28 23:33:49-04:00,16477,5QxR9QPTADFys9VQNm473RgprTikCXC23vhsBc9ojyAQ,H9zdf8nJ4JCF7jrwGsxiuiFoa14gzDmYsZ5N5ig3UGna,True,206084272,51521068,361035,180517,180518,C4UnXuShCvjSMgBAgVNMy1oakxCNk1et27A82fywU112,14441438,26334119,-11892681,700
2022-04-28 23:34:43-04:00,16478,B2nFCBzpcf1ptxYz1qJhsvMi66FxVC9MRbmyE651zyvc,Hrkw5SLuHTpmqamJBBTiDQHoF6Cmj5tSf4BFvgbNqUVx,True,250189746,62547436,426278,213139,213139,2a35JJeTUW1pm6M3e8DHCjp8qr4vbc2cRPhuzZWyFzYd,17051123,72285009,-55233886,681
2022-04-28 23:36:55-04:00,16479,5vp63gpRmA7mzAj8czoQsMsNHg1773XwYdwi4f5XC4nE,wqgmuTgVubuFucijWBVJU9tqMgGKHy61DVLEDC46q3H,True,396519622,99129905,619355,309677,309678,2py1FiYeL2f7J3HU36qiJz6TD6HCmiTN36RyxYtapQCZ,24774233,53328850,-28554617,624
2022-04-28 23:47:17-04:00,16480,D5VZNThkv6XD6bimPshD2J3PvbPXgCbivZuPfkVxgdjc,8C77LmMk4C3KvyEb1N3scdbAgwN7J45nAcv9tkL5namB,True,2613878872,653469718,4047905,2023952,2023953,2a35JJeTUW1pm6M3e8DHCjp8qr4vbc2cRPhuzZWyFzYd,161916206,728944568,-567028362,619
2022-04-28 23:53:40-04:00,16481,CLP8qmL8aN9ocJKYnbKSo4k46CU3LBsebspfREQcSGvo,F6tkkFJnvjYyPdSXDNzZMUfhd1o8dFiLyLPRZ5U1sXHE,True,27652173,6913043,43096,21548,21548,2a35JJeTUW1pm6M3e8DHCjp8qr4vbc2cRPhuzZWyFzYd,1723847,2774311,-1050464,623
2022-04-28 23:53:54-04:00,16482,7GpG8k6hM27vK1R5Sx1v5xUBuF6vybP41dcymjXDi5P7,7Aip6HDcbZ5mvoSucNupRS9enRdGx37F8L432K7V81do,True,27134054713,6783513678,41915441,20957720,20957721,GXyFXZMNk2NFyEzw6JetVqsujqcz2yCixH7n8EpDJYWD,1676617657,4790088717,-3113471060,617
2022-04-29 00:00:29-04:00,16483,DZnaFtxiEHUv3geRGsKufTnCUhkSMbN2M7W4Bwu2LgkM,A38xXBMxA13qQnVB1tcd5USxpfdaUGmkp31FeTmCyb52,True,4827129270,1206782317,8246699,4123349,4123350,3zqXX6kzhkbW3d4TwD2CNjMRwxTbREXySekvq37kfCNk,329867989,495007731,-165139742,683
2022-04-29 00:00:30-04:00,16484,DmwHBt9RS9QZesz2k6NsiC9CXCvgaGSTWycWj8nCdkC6,EEN2iGeHGY9AbsrBTgs9CFNTfdiGWymzt6VGto8ZGyfF,True,392478177,98119544,666555,333277,333278,68sueyVfmy5ToEGtLFGDkwebX47xAmzyXE29z8JrmcWv,26662223,49955108,-23292885,679
2022-04-29 00:00:32-04:00,16485,GdmdwHEVufQPVY4wzW32ZKhGwJ6T7EEWYH8ZcSgNU5ee,Gxyre48jDULjD1eykxQvDMdjGLmymrBgG38zCjjJP3wf,True,758184330,189546082,1335328,667664,667664,gjBMZYVujDjD1ECG4i97M8Q3gV9ESnwwTSUGropkusj,53413137,114852387,-61439250,704
2022-04-29 00:04:55-04:00,16486,AQr9mVmcXCNQhBVCfx63MwR6c4WqDSC9K2BZqr7N8LCx,CB7TWUaL381ounsLw6neAUaKRxJL9P1HC9uGX5e1Uxod,True,157658520,9104131,45662,22831,22831,68sueyVfmy5ToEGtLFGDkwebX47xAmzyXE29z8JrmcWv,7907587,44393318,-36485731,501
2022-04-29 00:06:44-04:00,16487,DaHTFbsmuU4J1Erji8ZfqB1L2wSuY7DCxAuHoopwMHog,7tmPzHaeVyGdvMXWEuJzYRoSQfw4dH4Njyf6Rh3F7U9Z,True,147660847,36915211,228376,114188,114188,2a35JJeTUW1pm6M3e8DHCjp8qr4vbc2cRPhuzZWyFzYd,9135055,25080419,-15945364,618
2022-04-29 00:07:53-04:00,16488,12GjTFcAZ5rnnR9DwXDUMmjFoyuFa3txDF4PPA4YoAQq,Ebm7YVYTYyMtEBM4STgbyyLuSFTwnnuFDQ1Wysvtj2vR,True,150434085,37608521,234739,117369,117370,68sueyVfmy5ToEGtLFGDkwebX47xAmzyXE29z8JrmcWv,9389590,28279389,-18889799,624
2022-04-29 00:48:16-04:00,16489,Aegmcn7VWMa1hTYSqLiJAz2P9EmSHXZNJZgeCtPEnAhZ,5MPtSRLs5paUtdwhinwhZZV8jnR4LeyPbM94qLYMk75C,True,751524289,187881072,1331061,665530,665531,3zqXX6kzhkbW3d4TwD2CNjMRwxTbREXySekvq37kfCNk,53242450,92091564,-38849114,708
2022-04-29 05:06:34-04:00,16490,AQr9mVmcXCNQhBVCfx63MwR6c4WqDSC9K2BZqr7N8LCx,CB7TWUaL381ounsLw6neAUaKRxJL9P1HC9uGX5e1Uxod,True,148024148,8233752,40762,20381,20381,68sueyVfmy5ToEGtLFGDkwebX47xAmzyXE29z8JrmcWv,7328167,43123081,-35794914,495
2022-04-29 05:06:43-04:00,16491,5UDGqNpkcMDjByBNi7WYMg8VJ81EzNJu48zsXbW9irSd,FmtUoQNiG25v8sn4pveM6wAWvja9u6FvZ2gdxWHSRjur,True,414917014,103729253,648100,324050,324050,A2p75MbAbeUdHkPLkAjgGeiwuu9WPrkMHzjCkDXF1Xr3,25924028,142137766,-116213738,624
2022-04-29 05:18:17-04:00,16492,JCxWCcMnPXMbwdMWxjhKYrWKiCpzSAmczM1F7jbrkTAi,8FrewhQHBn3GHwYeJMbt9F2Ydoy3EECZRxvPdbFHrn1k,True,1340742359,335185589,1008398,504199,504199,C4UnXuShCvjSMgBAgVNMy1oakxCNk1et27A82fywU112,40335928,92559011,-52223083,300
2022-04-29 05:18:18-04:00,16493,5XcrJqz4M3F7d5SruWRSWLH8zY6cDVwTXbqcA2Y5YLBS,6gJ1xLxAQ1HW4WRpBx7LhHiQuqqdMvLxSdeeNUS5NFsi,True,234619171,58654792,176564,88282,88282,C4UnXuShCvjSMgBAgVNMy1oakxCNk1et27A82fywU112,7062599,11688867,-4626268,301
2022-04-29 05:54:37-04:00,16494,DHfy6B2AYsqMCxPLBCXMDfQn3Gr2VwJaLFHUZKqpCjsb,EPZpYaY1gCAb8pMtri5veRowBmCrCpTHBMa3Rmgt6S29,True,19406451758,4851612939,14674334,7337167,7337167,DQCvC9mR68hJ3tJsUiddh6JwcBJAmntqGJR2nUsEq7yj,586973367,943517011,-356543644,302
2022-04-29 06:00:36-04:00,16495,FU7X4DWnGTbxwXULBq3v9SACzYhQyFGqsXjUDzyFqiem,925BaEnWxTfEv4oQb9Xf1wyyEEWEr8kXeSdXTtRfShfw,True,89706915,22426728,139858,69929,69929,68sueyVfmy5ToEGtLFGDkwebX47xAmzyXE29z8JrmcWv,5594324,26837455,-21243131,623
2022-04-29 06:01:51-04:00,16496,J6ndjmic8buVqwa4URRRgv2iTc4ekbYUHdcpa3DUCufN,7qvvczUw8ngwdQae49BiQwQmdV2SSWsAVV2tmZYL7gw6,True,453929974,113482493,667065,333532,333533,2a35JJeTUW1pm6M3e8DHCjp8qr4vbc2cRPhuzZWyFzYd,26682600,201416576,-174733976,587
2022-04-29 06:15:25-04:00,16497,AXBfrbCpYAWKN5jgDVVMiKXscQ96YtotKV3DT6XSzm9o,Dh3SiHAqrQzPQnTLRMxtBn2EFyHNgyfnYGpgcuNGTvyL,True,462978947,115744736,722637,361318,361319,6UQfSsLooL4pQKQfLtXCutQS2BnF7A7F7ewJopDLmUpc,28905486,169352836,-140447350,624
2022-04-29 06:30:22-04:00,16498,6NJFN855M3Q3RLTDNo57gTgAmwPD6G2E3WvMb1m5eNCN,3YpqNnonsvXaRT4nCC3G5FZx1jjVtbDPc36LiR6WK5jR,True,61199971,15299992,95486,47743,47743,68sueyVfmy5ToEGtLFGDkwebX47xAmzyXE29z8JrmcWv,3819474,22681083,-18861609,624
2022-04-11 22:40:00-04:00,15475,3DEyi4Dnfxc7d91JbTpQjdAP1Ypgx5kaTSm4wwh8Zbm2,Cb2aqg5MyjopPzx5zd4zU81RUwJDeNTGV1jfiCLmgNTL,True,19273434,4818358,29948,14974,14974,gjBMZYVujDjD1ECG4i97M8Q3gV9ESnwwTSUGropkusj,1197935,4420157,-3222222,621
2022-04-12 07:15:41-04:00,15476,8K1GzGeaAuFdjuVZi6DqBcYiA1zSRioMkRvjotr8p7fz,5mqocPwTdjwAPiJf7vx9bo7AzvfQBT2t5bV9u2Jzb2e1,True,1359228415,339807103,2110371,1055185,1055186,3zqXX6kzhkbW3d4TwD2CNjMRwxTbREXySekvq37kfCNk,84414858,130128434,-45713576,621
2022-04-12 07:32:18-04:00,15477,G3ZEAY19iDMjF7P57dgFUZiC4bpeFvMPKShenugL7E2Y,D6nUGgpWkQUZcUKZYawfedX67uqQ9Co1wEwtbHPMtc7X,True,175903168,43975792,273695,136847,136848,3zqXX6kzhkbW3d4TwD2CNjMRwxTbREXySekvq37kfCNk,10947816,16832141,-5884325,622
2022-04-12 08:03:19-04:00,15478,8K1GzGeaAuFdjuVZi6DqBcYiA1zSRioMkRvjotr8p7fz,5mqocPwTdjwAPiJf7vx9bo7AzvfQBT2t5bV9u2Jzb2e1,True,1037067783,259266945,1616452,808226,808226,2a35JJeTUW1pm6M3e8DHCjp8qr4vbc2cRPhuzZWyFzYd,64658107,116603094,-51944987,623
2022-04-12 08:43:26-04:00,15479,G3ZEAY19iDMjF7P57dgFUZiC4bpeFvMPKShenugL7E2Y,D6nUGgpWkQUZcUKZYawfedX67uqQ9Co1wEwtbHPMtc7X,True,134214794,33553698,209639,104819,104820,68sueyVfmy5ToEGtLFGDkwebX47xAmzyXE29z8JrmcWv,8385576,15086440,-6700864,624
2022-04-12 08:44:38-04:00,15480,8K1GzGeaAuFdjuVZi6DqBcYiA1zSRioMkRvjotr8p7fz,5mqocPwTdjwAPiJf7vx9bo7AzvfQBT2t5bV9u2Jzb2e1,True,791391528,197847882,1236274,618137,618137,3zqXX6kzhkbW3d4TwD2CNjMRwxTbREXySekvq37kfCNk,49450965,102007960,-52556995,624
2022-04-12 10:25:02-04:00,15481,niCk6QHFU1kyU56Mdq5RJzKrecdkNSn23ZA6wduFdWS,BQbUYSw1XsuE6LnVd4XjmxAyYgx4drE4FsetJBCdwVZW,True,145521053,36366228,225943,112971,112972,2a35JJeTUW1pm6M3e8DHCjp8qr4vbc2cRPhuzZWyFzYd,9041260,8908046,133214,621
2022-04-12 13:52:08-04:00,15482,FU7X4DWnGTbxwXULBq3v9SACzYhQyFGqsXjUDzyFqiem,925BaEnWxTfEv4oQb9Xf1wyyEEWEr8kXeSdXTtRfShfw,True,2466238610,616559652,4393276,2196638,2196638,3zqXX6kzhkbW3d4TwD2CNjMRwxTbREXySekvq37kfCNk,175731063,191936833,-16205770,712
2022-04-12 14:14:04-04:00,15483,FoGtu9wcVbBmATBKtBMWvbRd558yzSDT5dPBTBJgzqFT,9rnvQvgQtkT7RSdDpZHnkTVd2V9CMRBSB7v79GDip4hS,True,394999702,98749925,606636,303318,303318,68sueyVfmy5ToEGtLFGDkwebX47xAmzyXE29z8JrmcWv,24265474,42219177,-17953703,614
2022-04-12 14:14:27-04:00,15484,niCk6QHFU1kyU56Mdq5RJzKrecdkNSn23ZA6wduFdWS,BQbUYSw1XsuE6LnVd4XjmxAyYgx4drE4FsetJBCdwVZW,True,106365885,26577728,150650,75325,75325,gjBMZYVujDjD1ECG4i97M8Q3gV9ESnwwTSUGropkusj,6029144,8718236,-2689092,566
2022-04-12 14:44:58-04:00,15485,niCk6QHFU1kyU56Mdq5RJzKrecdkNSn23ZA6wduFdWS,BQbUYSw1XsuE6LnVd4XjmxAyYgx4drE4FsetJBCdwVZW,True,78632734,19644602,118027,59013,59014,DQCvC9mR68hJ3tJsUiddh6JwcBJAmntqGJR2nUsEq7yj,4724365,7897059,-3172694,600
2022-04-12 15:09:48-04:00,15486,AQr9mVmcXCNQhBVCfx63MwR6c4WqDSC9K2BZqr7N8LCx,CB7TWUaL381ounsLw6neAUaKRxJL9P1HC9uGX5e1Uxod,True,1116936369,115743072,723333,361666,361667,A9TwRM1BMxqb8DCC7YNAMV6zPenEJm3HTZBy7wJKK58U,69802642,243455954,-173653312,624
2022-04-12 16:00:06-04:00,15487,D8BtQirMEk3W9Pq29B6KkKWrwPfmsUNpwz5npx7aGMLY,J7LMZwaSoh5hbGcwee6oPsnN4ZFD7Zp3LQWkJGNUHRfJ,True,729948934,182487233,1134712,567356,567356,2a35JJeTUW1pm6M3e8DHCjp8qr4vbc2cRPhuzZWyFzYd,45388500,196709675,-151321175,621
2022-04-13 02:30:06-04:00,15488,DmwHBt9RS9QZesz2k6NsiC9CXCvgaGSTWycWj8nCdkC6,EEN2iGeHGY9AbsrBTgs9CFNTfdiGWymzt6VGto8ZGyfF,True,1235963327,308990831,2158010,1079005,1079005,3zqXX6kzhkbW3d4TwD2CNjMRwxTbREXySekvq37kfCNk,86320400,127794676,-41474276,698
2022-04-13 06:17:52-04:00,15489,niCk6QHFU1kyU56Mdq5RJzKrecdkNSn23ZA6wduFdWS,BQbUYSw1XsuE6LnVd4XjmxAyYgx4drE4FsetJBCdwVZW,True,73857284,18450671,114780,57390,57390,2a35JJeTUW1pm6M3e8DHCjp8qr4vbc2cRPhuzZWyFzYd,4594622,6967255,-2372633,622
2022-04-13 07:43:56-04:00,15490,6RuQVU9nu2Ecp177M9ggWczLACvQ8PfT31RTcmfwe9Hq,DZgsgqvMNLTXkBxySZC7Monak2JGsXRMJT4hBQzpf6Xm,True,6979508607,1744877151,10769103,5384551,5384552,68sueyVfmy5ToEGtLFGDkwebX47xAmzyXE29z8JrmcWv,430764156,589666308,-158902152,617
2022-04-13 08:56:44-04:00,15491,FU7X4DWnGTbxwXULBq3v9SACzYhQyFGqsXjUDzyFqiem,925BaEnWxTfEv4oQb9Xf1wyyEEWEr8kXeSdXTtRfShfw,True,2182638399,545659599,3858039,1929019,1929020,3zqXX6kzhkbW3d4TwD2CNjMRwxTbREXySekvq37kfCNk,154321594,183081058,-28759464,707
2022-04-13 09:55:46-04:00,15492,DmwHBt9RS9QZesz2k6NsiC9CXCvgaGSTWycWj8nCdkC6,EEN2iGeHGY9AbsrBTgs9CFNTfdiGWymzt6VGto8ZGyfF,True,945606796,236401699,1636648,818324,818324,3zqXX6kzhkbW3d4TwD2CNjMRwxTbREXySekvq37kfCNk,65465947,115344348,-49878401,692
2022-04-13 09:55:47-04:00,15493,7eeGop9Aw2FeAhtm9GaXzemxvSd4MK2EoHSRETn9GDPc,93ZvMtq5ur5uJtnCbuvnd9UJDc1WhFmQKxTjB49Hm1WL,True,10024556211,2506139052,17324421,8662210,8662211,3zqXX6kzhkbW3d4TwD2CNjMRwxTbREXySekvq37kfCNk,692976874,2018181094,-1325204220,691
2022-04-13 10:17:08-04:00,15494,HDJrLBSkMZ34BjJKrxYvSjhMP1z3dvZeuCAEqHFHqSn7,DXYU9k5x6T9wDCJyPn9KLLSpBgw4FFxe8zg9YsCmfLvp,True,1034405412,258601353,1611123,805561,805562,3zqXX6kzhkbW3d4TwD2CNjMRwxTbREXySekvq37kfCNk,64444953,99097020,-34652067,623
2022-04-13 10:25:53-04:00,15495,DmwHBt9RS9QZesz2k6NsiC9CXCvgaGSTWycWj8nCdkC6,EEN2iGeHGY9AbsrBTgs9CFNTfdiGWymzt6VGto8ZGyfF,True,721635100,180408775,1285559,642779,642780,68sueyVfmy5ToEGtLFGDkwebX47xAmzyXE29z8JrmcWv,51422385,101339793,-49917408,712
2022-04-13 11:24:19-04:00,15496,FncFHJooh1hy9Gc2y5sKdcYkZ5uHzsxHG4vHT9cVZGcK,BkFa4b5Jyv4ZJCCpwDYv355ezVFiZfAtn18AV7kstd2v,True,2471863290,617965822,3855535,1927767,1927768,2a35JJeTUW1pm6M3e8DHCjp8qr4vbc2cRPhuzZWyFzYd,154221423,252450172,-98228749,623
2022-04-13 15:06:47-04:00,15497,Af5aSkdtYSRqdSfK3mPBK3Grq33PDCLCASBdsMo5cmkm,9PvGthPurjNkCoTUVDBW9nNNmvAdrwK8tk4hknK7Wydg,True,1450218294,362554573,2252155,1126077,1126078,3zqXX6kzhkbW3d4TwD2CNjMRwxTbREXySekvq37kfCNk,90086236,148660844,-58574608,621
2022-04-13 21:25:07-04:00,15498,FoGtu9wcVbBmATBKtBMWvbRd558yzSDT5dPBTBJgzqFT,9rnvQvgQtkT7RSdDpZHnkTVd2V9CMRBSB7v79GDip4hS,True,168519268,42129817,263171,131585,131586,3zqXX6kzhkbW3d4TwD2CNjMRwxTbREXySekvq37kfCNk,10526841,18020435,-7493594,624
2022-04-13 21:42:06-04:00,15499,G3ZEAY19iDMjF7P57dgFUZiC4bpeFvMPKShenugL7E2Y,D6nUGgpWkQUZcUKZYawfedX67uqQ9Co1wEwtbHPMtc7X,True,102393367,25598341,159556,79778,79778,68sueyVfmy5ToEGtLFGDkwebX47xAmzyXE29z8JrmcWv,6382270,13140304,-6758034,623
2022-04-14 07:25:50-04:00,15500,CZ1snuuBhno2SqfAmMLzEEQhrsH2reAmZrGhFVsydvHD,F4Hj3jxxE8W8TbgpvjRLnrQ1Jdd28ZKTPNyu1h9BnLiH,True,6033997315,1508499328,9413504,4706752,4706752,3zqXX6kzhkbW3d4TwD2CNjMRwxTbREXySekvq37kfCNk,376540196,448499792,-71959596,624
2022-04-14 10:03:34-04:00,15501,FU7X4DWnGTbxwXULBq3v9SACzYhQyFGqsXjUDzyFqiem,925BaEnWxTfEv4oQb9Xf1wyyEEWEr8kXeSdXTtRfShfw,True,2570414424,642603606,4085754,2042877,2042877,DQCvC9mR68hJ3tJsUiddh6JwcBJAmntqGJR2nUsEq7yj,163430170,171328440,-7898270,635
2022-04-14 10:03:50-04:00,15502,CZ1snuuBhno2SqfAmMLzEEQhrsH2reAmZrGhFVsydvHD,F4Hj3jxxE8W8TbgpvjRLnrQ1Jdd28ZKTPNyu1h9BnLiH,True,4431425718,1107856429,6830628,3415314,3415314,DQCvC9mR68hJ3tJsUiddh6JwcBJAmntqGJR2nUsEq7yj,273225150,421517022,-148291872,616
2022-04-14 10:04:30-04:00,15503,68RZsaAJib9kw5xnnt9QhvsAa1DGJzww1MKqACsMvxGr,3z8H2C111LCABJymwxJAG9boicBXcJXq3ft6jqmV9rSw,True,484966815,121241703,864373,432186,432187,3zqXX6kzhkbW3d4TwD2CNjMRwxTbREXySekvq37kfCNk,34574934,49548264,-14973330,712
2022-04-14 11:36:34-04:00,15504,BTwSuuDHNhQAFAzBZRWev5j1ix2RTWvjZAxLpw8grAxu,31NCyUpSXxxJYLSrdK3c5bLomUtMejobMfYnq7j71GtM,True,502570085,125642521,784874,392437,392437,3zqXX6kzhkbW3d4TwD2CNjMRwxTbREXySekvq37kfCNk,31394993,51832950,-20437957,624
2022-04-14 11:37:43-04:00,15505,G1itFhAuojgBizYvak692TxrGS2Ck3KcYEfNQXYNitbW,8u8JiQpfkpbpM9EjunnM6MY22FAGycwmW6DgFVGA5c48,True,720702403,180175600,1125870,562935,562935,DQCvC9mR68hJ3tJsUiddh6JwcBJAmntqGJR2nUsEq7yj,45034837,74247872,-29213035,624
2022-04-14 11:42:41-04:00,15506,B3NyyoWNzyzvpWv1G6a9gZJMjD1sTQBdZojBaH18mNjY,BCj3EGFMhJ9wh4KvF9cqYsuNHug7kCbALFMLMtuh24bq,True,12692689154,3173172288,22611055,11305527,11305528,68sueyVfmy5ToEGtLFGDkwebX47xAmzyXE29z8JrmcWv,904442237,1985937568,-1081495331,712
2022-04-14 11:46:03-04:00,15507,CZ1snuuBhno2SqfAmMLzEEQhrsH2reAmZrGhFVsydvHD,F4Hj3jxxE8W8TbgpvjRLnrQ1Jdd28ZKTPNyu1h9BnLiH,True,3259017319,814754329,5046848,2523424,2523424,3zqXX6kzhkbW3d4TwD2CNjMRwxTbREXySekvq37kfCNk,201873955,377783946,-175909991,619
2022-04-14 12:24:56-04:00,15508,Dy48VdeAJJ7hxEPgf9qhPfpaQC4wLuKGw8GftGHcqngN,BF2S2u5faPuQicjtGmGEYWAPxnhM6MsHz5Ye7cRnV3Kp,True,142433697,35608424,218198,109099,109099,gjBMZYVujDjD1ECG4i97M8Q3gV9ESnwwTSUGropkusj,8727940,14712611,-5984671,612
2022-04-14 12:42:17-04:00,15509,Grp3cwXwum32ANiJAd6vYAGz6UPrQi1bVpjYQkf3xTFR,Q5qL5kPYtYqt3UGkxZTieTqVHMqKG8SbAsYw2d8VXh6,True,25027254728,2836239236,17620580,8810290,8810290,DQCvC9mR68hJ3tJsUiddh6JwcBJAmntqGJR2nUsEq7yj,1554857458,2676066342,-1121208884,621
2022-04-14 12:50:09-04:00,15510,AQr9mVmcXCNQhBVCfx63MwR6c4WqDSC9K2BZqr7N8LCx,CB7TWUaL381ounsLw6neAUaKRxJL9P1HC9uGX5e1Uxod,True,993963528,86987707,543657,271828,271829,A9TwRM1BMxqb8DCC7YNAMV6zPenEJm3HTZBy7wJKK58U,62120903,235383293,-173262390,624
2022-04-14 14:55:02-04:00,15511,G1itFhAuojgBizYvak692TxrGS2Ck3KcYEfNQXYNitbW,8u8JiQpfkpbpM9EjunnM6MY22FAGycwmW6DgFVGA5c48,True,529560650,132390162,823003,411501,411502,3zqXX6kzhkbW3d4TwD2CNjMRwxTbREXySekvq37kfCNk,32920140,65800152,-32880012,621
2022-04-14 14:56:05-04:00,15512,7e33yGYb8MyqYa4UHZEguG4GHHpzTG7cE8vr5vSB75F3,HkWRSSSAmHf1HWxxTzxdoNN1w1QMKCkwNL4Fwg9eaXdT,True,19392939124,4848234781,29860464,14930232,14930232,68sueyVfmy5ToEGtLFGDkwebX47xAmzyXE29z8JrmcWv,1194418578,2460392798,-1265974220,615
2022-04-14 15:01:41-04:00,15513,9U25LWBU67c9S6L9F4qmjpTkaHqjFgxyuTCqQ7Zqj62g,ESyDCGZWamnabH3NNvus52X6Z9YAmt3y8oB8zYLmhfX3,True,2478886980,619721745,3853542,1926771,1926771,68sueyVfmy5ToEGtLFGDkwebX47xAmzyXE29z8JrmcWv,154141716,397020408,-242878692,621
2022-04-14 16:12:37-04:00,15514,EDFNynTdSf9HfMkEuNJUeoeG6guc6zsg7zrmQuoA4Npn,A6DrZZWdZE1TbyXFthYNtyJUZMFhtCtwPqnREn5ECZcs,True,40481099,10120274,63194,31597,31597,HfEnetJ7uBSmZWCjBNxdvv9HEC5nsW4wDV7wu6WnhWan,2527767,12053806,-9526039,624
2022-04-14 16:12:41-04:00,15515,v8PjH3mAe252Zyh1iuPMigysGQZoZL1KncefGDw1ANx,2BDYraDRL6SekAjXy3rbGXCxmPt75gkEfhomEp9FzkUE,True,54274633566,13568658391,82735215,41367607,41367608,3zqXX6kzhkbW3d4TwD2CNjMRwxTbREXySekvq37kfCNk,3309408623,9265934325,-5956525702,609
2022-04-14 16:19:17-04:00,15516,BhhVhLVZkSd3aHDMd6ojTgtJtbgAdMCA9Xj8jL2GMXoL,G8HUQp2yGSw9T6it5ej91cqkd82naca8heji453g2jEH,True,623299218,87628788,547100,273550,273550,gjBMZYVujDjD1ECG4i97M8Q3gV9ESnwwTSUGropkusj,38914970,184219803,-145304833,624
2022-04-14 16:21:56-04:00,15517,AQr9mVmcXCNQhBVCfx63MwR6c4WqDSC9K2BZqr7N8LCx,CB7TWUaL381ounsLw6neAUaKRxJL9P1HC9uGX5e1Uxod,True,901378582,64841068,402550,201275,201275,2a35JJeTUW1pm6M3e8DHCjp8qr4vbc2cRPhuzZWyFzYd,55960007,229281429,-173321422,620
2022-04-14 22:22:13-04:00,15518,4iuxCnnt8hRhchVhUTCA2fyTKbzirUTh7X95zFMXLqRN,23LkMyCv4w4dMoyD5tURob2meDb3ZrMCkbuhJv1XwJPo,True,25781284387,6445321096,40113400,20056700,20056700,2a35JJeTUW1pm6M3e8DHCjp8qr4vbc2cRPhuzZWyFzYd,1604536011,2468902149,-864366138,622
2022-04-14 23:10:39-04:00,15519,4iuxCnnt8hRhchVhUTCA2fyTKbzirUTh7X95zFMXLqRN,23LkMyCv4w4dMoyD5tURob2meDb3ZrMCkbuhJv1XwJPo,True,19672020673,4918005168,30710007,15355003,15355004,3zqXX6kzhkbW3d4TwD2CNjMRwxTbREXySekvq37kfCNk,1228400287,2228277929,-999877642,624
2022-04-14 23:37:26-04:00,15520,4iuxCnnt8hRhchVhUTCA2fyTKbzirUTh7X95zFMXLqRN,23LkMyCv4w4dMoyD5tURob2meDb3ZrMCkbuhJv1XwJPo,True,15025064873,3756266218,23166022,11583011,11583011,2a35JJeTUW1pm6M3e8DHCjp8qr4vbc2cRPhuzZWyFzYd,926640912,1956405820,-1029764908,616
2022-04-15 00:06:54-04:00,15521,4iuxCnnt8hRhchVhUTCA2fyTKbzirUTh7X95zFMXLqRN,23LkMyCv4w4dMoyD5tURob2meDb3ZrMCkbuhJv1XwJPo,True,11458204135,2864551033,17859655,8929827,8929828,3zqXX6kzhkbW3d4TwD2CNjMRwxTbREXySekvq37kfCNk,714386225,1681109318,-966723093,623
2022-04-15 00:19:33-04:00,15522,EFzTG8kgbs1kExcFxcQrLSteeKD7jVqgQ2x3onCnhNuP,9wLCaZ7eVfs3u7Gp6HypL1Nz7hWgAcLcjbLtdyxf9gFU,True,20474085,5118521,36087,18043,18044,2a35JJeTUW1pm6M3e8DHCjp8qr4vbc2cRPhuzZWyFzYd,1443499,1990684,-547185,705
2022-04-15 09:49:35-04:00,15523,BTwSuuDHNhQAFAzBZRWev5j1ix2RTWvjZAxLpw8grAxu,31NCyUpSXxxJYLSrdK3c5bLomUtMejobMfYnq7j71GtM,True,369391234,92347808,576991,288495,288496,A9TwRM1BMxqb8DCC7YNAMV6zPenEJm3HTZBy7wJKK58U,23079655,45946726,-22867071,624
2022-04-15 09:50:10-04:00,15524,68RZsaAJib9kw5xnnt9QhvsAa1DGJzww1MKqACsMvxGr,3z8H2C111LCABJymwxJAG9boicBXcJXq3ft6jqmV9rSw,True,355354338,88838584,632089,316044,316045,68sueyVfmy5ToEGtLFGDkwebX47xAmzyXE29z8JrmcWv,25283589,44904016,-19620427,711
2022-04-15 09:54:21-04:00,15525,2YxXDtHrovuHPo6ejip9NnoRzcuuPU9djzYSiCQ1PRUX,Hd6hrwSYcHmbnTWKQ9H59NY1YtwBqkRCfNGiGVVw2NtK,True,9883766567,1257642415,8395684,4197842,4197842,DQCvC9mR68hJ3tJsUiddh6JwcBJAmntqGJR2nUsEq7yj,659813801,997267389,-337453588,667
2022-04-15 12:11:25-04:00,15526,DXGapgtgkag6midSCYNhHCNaCqvhUmuSvnVhXxNXBmyt,Csq6W5QkGZL6qE6Z1ERF3bfHtKjnM8hAxiY1YA3rTwSX,True,30972677,7743169,47603,23801,23802,DQCvC9mR68hJ3tJsUiddh6JwcBJAmntqGJR2nUsEq7yj,1904147,13789162,-11885015,614
2022-04-16 11:14:11-04:00,15527,B3NyyoWNzyzvpWv1G6a9gZJMjD1sTQBdZojBaH18mNjY,BCj3EGFMhJ9wh4KvF9cqYsuNHug7kCbALFMLMtuh24bq,True,9295619178,2323904794,16386170,8193085,8193085,68sueyVfmy5ToEGtLFGDkwebX47xAmzyXE29z8JrmcWv,655446803,1706992538,-1051545735,705
2022-04-16 11:14:38-04:00,15528,B3NyyoWNzyzvpWv1G6a9gZJMjD1sTQBdZojBaH18mNjY,BCj3EGFMhJ9wh4KvF9cqYsuNHug7kCbALFMLMtuh24bq,True,6787163107,1696790776,11362733,5681366,5681367,2py1FiYeL2f7J3HU36qiJz6TD6HCmiTN36RyxYtapQCZ,454509356,1436932025,-982422669,669
2022-04-16 11:38:30-04:00,15529,D85pWm1LS9MvtR4f3QhkFLvNUhZLQ2NZBFQTyAVnmigm,CRN85DYkJJi6irhtVAf4qcJU3ijVodWdXgWe7Fs6Ahka,True,62818875,15704718,111877,55938,55939,2a35JJeTUW1pm6M3e8DHCjp8qr4vbc2cRPhuzZWyFzYd,4475104,6424224,-1949120,712
2022-04-16 14:22:49-04:00,15530,7e33yGYb8MyqYa4UHZEguG4GHHpzTG7cE8vr5vSB75F3,HkWRSSSAmHf1HWxxTzxdoNN1w1QMKCkwNL4Fwg9eaXdT,True,14267039701,3566759925,22122960,11061480,11061480,68sueyVfmy5ToEGtLFGDkwebX47xAmzyXE29z8JrmcWv,884918408,2124713956,-1239795548,620
2022-04-17 11:58:01-04:00,15531,CXPwt2ExsLAkjUWVsgUmvcMwji5CVY5vbMvomdg54CnQ,5LeDHg3VwCE8V1J6pMf8wvEVuNUyjQdz3cppSi9swaYP,True,71719494,17929873,111344,55672,55672,6UQfSsLooL4pQKQfLtXCutQS2BnF7A7F7ewJopDLmUpc,4453768,6863426,-2409658,620
2022-04-17 19:23:55-04:00,15532,AQr9mVmcXCNQhBVCfx63MwR6c4WqDSC9K2BZqr7N8LCx,CB7TWUaL381ounsLw6neAUaKRxJL9P1HC9uGX5e1Uxod,True,832982826,60651228,379020,189510,189510,2py1FiYeL2f7J3HU36qiJz6TD6HCmiTN36RyxYtapQCZ,52054676,224375674,-172320998,624
2022-04-17 19:24:29-04:00,15533,v8PjH3mAe252Zyh1iuPMigysGQZoZL1KncefGDw1ANx,2BDYraDRL6SekAjXy3rbGXCxmPt75gkEfhomEp9FzkUE,True,39766703239,9941675809,57534100,28767050,28767050,2a35JJeTUW1pm6M3e8DHCjp8qr4vbc2cRPhuzZWyFzYd,2301364022,7730990806,-5429626784,578
2022-04-17 19:24:30-04:00,15534,DK24JASWC2tR9MyHiQwGVNXZj97AuhYo6BmfxGp289eR,BFjgan9PWn6ECgXUbLKbqzNnHcsGfJ1yYYxioPNCmwGj,True,442122560,110530640,617026,308513,308513,gjBMZYVujDjD1ECG4i97M8Q3gV9ESnwwTSUGropkusj,24681076,92186700,-67505624,558
2022-04-17 19:24:30-04:00,15535,EDFNynTdSf9HfMkEuNJUeoeG6guc6zsg7zrmQuoA4Npn,A6DrZZWdZE1TbyXFthYNtyJUZMFhtCtwPqnREn5ECZcs,True,29539108,7384777,41330,20665,20665,68sueyVfmy5ToEGtLFGDkwebX47xAmzyXE29z8JrmcWv,1653221,9619482,-7966261,559
2022-04-17 19:24:30-04:00,15536,GKbDACVE2yR8WwrMeGfSQuSXLqXR3B1N5YzZ93i5xyeB,B5EEB6xDf7fwwaE6CaJjwsgCNNdUc29tjW1gY2pHiKxq,True,944163118,236040779,1336984,668492,668492,gjBMZYVujDjD1ECG4i97M8Q3gV9ESnwwTSUGropkusj,53479395,98325851,-44846456,566
2022-04-17 19:24:32-04:00,15537,BjCNaM7YbE9SjFi7tzi4677zg1fKXGJwtecz2GWwWuhd,6rNsSrKZezQrLb2whToNjnizpnurDXrobHqfEK3QqU1M,True,734394195,66531968,413137,206568,206569,gjBMZYVujDjD1ECG4i97M8Q3gV9ESnwwTSUGropkusj,45603008,246183703,-200580695,620
2022-04-17 19:24:37-04:00,15538,DXGapgtgkag6midSCYNhHCNaCqvhUmuSvnVhXxNXBmyt,Csq6W5QkGZL6qE6Z1ERF3bfHtKjnM8hAxiY1YA3rTwSX,True,22790600,5697650,35590,17795,17795,2a35JJeTUW1pm6M3e8DHCjp8qr4vbc2cRPhuzZWyFzYd,1423621,10776300,-9352679,624
2022-04-17 19:26:43-04:00,15539,AQr9mVmcXCNQhBVCfx63MwR6c4WqDSC9K2BZqr7N8LCx,CB7TWUaL381ounsLw6neAUaKRxJL9P1HC9uGX5e1Uxod,True,768654191,51406849,321007,160503,160504,gjBMZYVujDjD1ECG4i97M8Q3gV9ESnwwTSUGropkusj,47998249,208225514,-160227265,624
2022-04-17 19:27:24-04:00,15540,7AizMrxWWr7qfneuXMy6ifL3BVDTAKkuud4PyZFy92kh,GyAWRRfQkVAXtyhVF14vU3kPMr4kG1VyA9FAHdDTr8ud,True,61904292,15476073,96691,48345,48346,2a35JJeTUW1pm6M3e8DHCjp8qr4vbc2cRPhuzZWyFzYd,3867647,17276878,-13409231,624
2022-04-17 19:27:50-04:00,15541,BhhVhLVZkSd3aHDMd6ojTgtJtbgAdMCA9Xj8jL2GMXoL,G8HUQp2yGSw9T6it5ej91cqkd82naca8heji453g2jEH,True,530172334,66357145,412258,206129,206129,gjBMZYVujDjD1ECG4i97M8Q3gV9ESnwwTSUGropkusj,32938175,163408928,-130470753,621
2022-04-17 19:28:17-04:00,15542,FU7X4DWnGTbxwXULBq3v9SACzYhQyFGqsXjUDzyFqiem,925BaEnWxTfEv4oQb9Xf1wyyEEWEr8kXeSdXTtRfShfw,True,1419101229,354775307,2202536,1101268,1101268,3zqXX6kzhkbW3d4TwD2CNjMRwxTbREXySekvq37kfCNk,88101472,146420866,-58319394,620
2022-04-17 19:28:24-04:00,15543,BjCNaM7YbE9SjFi7tzi4677zg1fKXGJwtecz2GWwWuhd,6rNsSrKZezQrLb2whToNjnizpnurDXrobHqfEK3QqU1M,True,664141621,58425860,364813,182406,182407,2py1FiYeL2f7J3HU36qiJz6TD6HCmiTN36RyxYtapQCZ,41469265,235782436,-194313171,624
2022-04-17 19:29:29-04:00,15544,AQr9mVmcXCNQhBVCfx63MwR6c4WqDSC9K2BZqr7N8LCx,CB7TWUaL381ounsLw6neAUaKRxJL9P1HC9uGX5e1Uxod,True,714138014,48848591,304853,152426,152427,3zqXX6kzhkbW3d4TwD2CNjMRwxTbREXySekvq37kfCNk,44567914,194472758,-149904844,624
2022-04-17 19:47:15-04:00,15545,68RZsaAJib9kw5xnnt9QhvsAa1DGJzww1MKqACsMvxGr,3z8H2C111LCABJymwxJAG9boicBXcJXq3ft6jqmV9rSw,True,260457830,65114457,464775,232387,232388,68sueyVfmy5ToEGtLFGDkwebX47xAmzyXE29z8JrmcWv,18591038,39375212,-20784174,713
2022-04-17 19:47:27-04:00,15546,DK24JASWC2tR9MyHiQwGVNXZj97AuhYo6BmfxGp289eR,BFjgan9PWn6ECgXUbLKbqzNnHcsGfJ1yYYxioPNCmwGj,True,327919189,81979797,509782,254891,254891,2a35JJeTUW1pm6M3e8DHCjp8qr4vbc2cRPhuzZWyFzYd,20391319,74694870,-54303551,621
2022-04-17 19:47:30-04:00,15547,EDFNynTdSf9HfMkEuNJUeoeG6guc6zsg7zrmQuoA4Npn,A6DrZZWdZE1TbyXFthYNtyJUZMFhtCtwPqnREn5ECZcs,True,21908045,5477011,34140,17070,17070,gjBMZYVujDjD1ECG4i97M8Q3gV9ESnwwTSUGropkusj,1365605,7586595,-6220990,623
2022-04-17 19:47:32-04:00,15548,5r3YEyxbXrMEwYCFyZXS5t1eRLDahPFxPBBYNyMfHfcZ,7fnHdwm7JWHREPPk7dMud4vEoYZqsiRYCMo6ZSQqMwQc,True,179936126,23581021,147210,73605,73605,A2p75MbAbeUdHkPLkAjgGeiwuu9WPrkMHzjCkDXF1Xr3,11232970,69927148,-58694178,624
2022-04-17 19:48:14-04:00,15549,AQr9mVmcXCNQhBVCfx63MwR6c4WqDSC9K2BZqr7N8LCx,CB7TWUaL381ounsLw6neAUaKRxJL9P1HC9uGX5e1Uxod,True,662404566,46076051,287821,143910,143911,gjBMZYVujDjD1ECG4i97M8Q3gV9ESnwwTSUGropkusj,41378204,190968389,-149590185,624
2022-04-17 20:08:35-04:00,15550,GKbDACVE2yR8WwrMeGfSQuSXLqXR3B1N5YzZ93i5xyeB,B5EEB6xDf7fwwaE6CaJjwsgCNNdUc29tjW1gY2pHiKxq,True,699479518,174869879,1087301,543650,543651,A2p75MbAbeUdHkPLkAjgGeiwuu9WPrkMHzjCkDXF1Xr3,43492075,85776377,-42284302,621
2022-04-18 00:06:25-04:00,15551,An9PgoB3s9T3TVC9vipP27wsPR9aZx8xPn7R6AbXojDa,2aoxARd4dXzvZ1uQpm8oETBLUF3JqzVU3Ek9LDH6ckWv,True,71599659520,5640322884,35911164,17955582,17955582,gjBMZYVujDjD1ECG4i97M8Q3gV9ESnwwTSUGropkusj,4558652433,8346132755,-3787480322,636
2022-04-18 00:14:38-04:00,15552,An9PgoB3s9T3TVC9vipP27wsPR9aZx8xPn7R6AbXojDa,2aoxARd4dXzvZ1uQpm8oETBLUF3JqzVU3Ek9LDH6ckWv,True,65617144090,4216409728,26863263,13431631,13431632,A2p75MbAbeUdHkPLkAjgGeiwuu9WPrkMHzjCkDXF1Xr3,4180548723,7708251927,-3527703204,637
2022-04-18 00:17:12-04:00,15553,An9PgoB3s9T3TVC9vipP27wsPR9aZx8xPn7R6AbXojDa,2aoxARd4dXzvZ1uQpm8oETBLUF3JqzVU3Ek9LDH6ckWv,True,61150168585,3693629229,23575858,11787929,11787929,DQCvC9mR68hJ3tJsUiddh6JwcBJAmntqGJR2nUsEq7yj,3903119683,7211474429,-3308354746,638
2022-04-18 00:19:30-04:00,15554,68zbVKnneMQqngbNkeLtPEP2ayNhawc1B2hPgqAEqgXK,HqiFpLr4NC7xJz9bEFusq8bCKaoxAQG1xsLxdUAzg8aa,True,1815259672,129252138,807081,403540,403541,6UQfSsLooL4pQKQfLtXCutQS2BnF7A7F7ewJopDLmUpc,113349174,507900519,-394551345,624
2022-04-18 00:19:33-04:00,15555,BTwSuuDHNhQAFAzBZRWev5j1ix2RTWvjZAxLpw8grAxu,31NCyUpSXxxJYLSrdK3c5bLomUtMejobMfYnq7j71GtM,True,271586076,67896519,424284,212142,212142,68sueyVfmy5ToEGtLFGDkwebX47xAmzyXE29z8JrmcWv,16971378,39580297,-22608919,624
2022-04-18 00:19:38-04:00,15556,An9PgoB3s9T3TVC9vipP27wsPR9aZx8xPn7R6AbXojDa,2aoxARd4dXzvZ1uQpm8oETBLUF3JqzVU3Ek9LDH6ckWv,True,57233292215,3654958268,23349367,11674683,11674684,A9TwRM1BMxqb8DCC7YNAMV6zPenEJm3HTZBy7wJKK58U,3656296684,7076920687,-3420624003,638
2022-04-18 00:19:44-04:00,15557,3BKX31xq3f13J2Zo8Wue4SYpCMWLXjgUt2nkwTTNfU2T,2pTxNAaV4pXRRUDE97ZFteBJn9tyktjh3FW1CWfwebci,True,19833299,4958324,30064,15032,15032,2a35JJeTUW1pm6M3e8DHCjp8qr4vbc2cRPhuzZWyFzYd,1202581,7577837,-6375256,606
2022-04-18 00:19:45-04:00,15558,HKrsoo3kUwwYou6vQAjrCccyWvTFm2Wy14hwBxofoV1p,6k2SbUiTFKi8EhZWSbNffGqofwBvr4y2HZsLkGgfq2iX,True,2094494312,523623578,3069289,1534644,1534645,3zqXX6kzhkbW3d4TwD2CNjMRwxTbREXySekvq37kfCNk,122771560,236117331,-113345771,586
2022-04-18 00:19:47-04:00,15559,BjCNaM7YbE9SjFi7tzi4677zg1fKXGJwtecz2GWwWuhd,6rNsSrKZezQrLb2whToNjnizpnurDXrobHqfEK3QqU1M,True,601654368,57714862,354983,177491,177492,2a35JJeTUW1pm6M3e8DHCjp8qr4vbc2cRPhuzZWyFzYd,37005568,215872517,-178866949,615
2022-04-18 00:19:53-04:00,15560,HDmtdNjr3UNmzXfmajyKASLz9wz4YzNrspTMABcr7tXV,bsQ5Ae5oD7dbNjnz49unSovEp4eDGiB2bfdihVZkAtE,True,74008078,18502019,112433,56216,56217,68sueyVfmy5ToEGtLFGDkwebX47xAmzyXE29z8JrmcWv,4497326,7629682,-3132356,607
2022-04-18 00:19:58-04:00,15561,AQr9mVmcXCNQhBVCfx63MwR6c4WqDSC9K2BZqr7N8LCx,CB7TWUaL381ounsLw6neAUaKRxJL9P1HC9uGX5e1Uxod,True,613496349,44539351,276886,138443,138443,2py1FiYeL2f7J3HU36qiJz6TD6HCmiTN36RyxYtapQCZ,38139030,178624288,-140485258,621
2022-04-18 00:19:58-04:00,15562,9eWpSyu71Z6dmx7yTh7WrbVScdrrZN14d5tfmqEGFgXt,2r89PFKSD9zmSp2Wyx4CQ75HAtmUgwhAS2oG5MuYuiV6,True,1502133779,375533444,2311026,1155513,1155513,3zqXX6kzhkbW3d4TwD2CNjMRwxTbREXySekvq37kfCNk,92441067,566672493,-474231426,615
2022-04-18 00:20:00-04:00,15563,68zbVKnneMQqngbNkeLtPEP2ayNhawc1B2hPgqAEqgXK,HqiFpLr4NC7xJz9bEFusq8bCKaoxAQG1xsLxdUAzg8aa,True,1678121262,121726478,759145,379572,379573,6UQfSsLooL4pQKQfLtXCutQS2BnF7A7F7ewJopDLmUpc,104655821,495745620,-391089799,623
2022-04-18 00:20:06-04:00,15564,4tsi43FGMTZiGUuX8Xp84hjnWpNbLSMjd81zGwK6egZU,H8xKg7KubTiB37cKc4aTeMEbiqzRysK2THrKjtZ6Z4ur,True,536403814,134100953,836379,418189,418190,3zqXX6kzhkbW3d4TwD2CNjMRwxTbREXySekvq37kfCNk,33455192,109786311,-76331119,623
2022-04-18 00:20:06-04:00,15565,7frvVhg1eWJpsvG7ndjppb8Bmd1tFq5H1g26UiKZxqTP,3Ugo9b53e6e8PLnvKjqRP8pvvoubSPV6qiKtxey7mrGt,True,682562248,170640562,1054906,527453,527453,3zqXX6kzhkbW3d4TwD2CNjMRwxTbREXySekvq37kfCNk,42196254,138897930,-96701676,618
2022-04-18 00:20:09-04:00,15566,An9PgoB3s9T3TVC9vipP27wsPR9aZx8xPn7R6AbXojDa,2aoxARd4dXzvZ1uQpm8oETBLUF3JqzVU3Ek9LDH6ckWv,True,53311700383,3143018801,19846276,9923138,9923138,2a35JJeTUW1pm6M3e8DHCjp8qr4vbc2cRPhuzZWyFzYd,3366313753,6960109261,-3593795508,631
2022-04-18 00:20:11-04:00,15567,6K1Xww22wVZuBwP6oYb3DPR5GvdxsQSiZ4WSmejQjyqf,8RoFHjv1TkGFqjKoSwzvyRNMoBP1ma1Hi2jy6FzD4i2g,True,59141665,12904090,70840,35420,35420,68sueyVfmy5ToEGtLFGDkwebX47xAmzyXE29z8JrmcWv,3246759,11915712,-8668953,548
2022-04-18 00:20:11-04:00,15568,BhhVhLVZkSd3aHDMd6ojTgtJtbgAdMCA9Xj8jL2GMXoL,G8HUQp2yGSw9T6it5ej91cqkd82naca8heji453g2jEH,True,458721299,65597704,392073,196036,196037,3zqXX6kzhkbW3d4TwD2CNjMRwxTbREXySekvq37kfCNk,27417520,148368082,-120950562,597
2022-04-18 00:20:11-04:00,15569,AQr9mVmcXCNQhBVCfx63MwR6c4WqDSC9K2BZqr7N8LCx,CB7TWUaL381ounsLw6neAUaKRxJL9P1HC9uGX5e1Uxod,True,566438674,38221497,238488,119244,119244,6UQfSsLooL4pQKQfLtXCutQS2BnF7A7F7ewJopDLmUpc,35343820,165569421,-130225601,623
2022-04-18 00:20:11-04:00,15570,5FewDaMC9U7n5EHcto98GaAmDVxDh5SYimuTP6AtfakM,7DAULUoqV7f9hsBzKEhjQPnWaHSqiMWcBqWcdcadaQv4,True,1350977047,175057010,1081007,540503,540504,6UQfSsLooL4pQKQfLtXCutQS2BnF7A7F7ewJopDLmUpc,83425208,141664008,-58238800,617
2022-04-18 00:20:12-04:00,15571,v8PjH3mAe252Zyh1iuPMigysGQZoZL1KncefGDw1ANx,2BDYraDRL6SekAjXy3rbGXCxmPt75gkEfhomEp9FzkUE,True,29323367743,7330841935,43552614,21776307,21776307,3zqXX6kzhkbW3d4TwD2CNjMRwxTbREXySekvq37kfCNk,1742104573,6328761208,-4586656635,594
2022-04-18 00:20:15-04:00,15572,BjCNaM7YbE9SjFi7tzi4677zg1fKXGJwtecz2GWwWuhd,6rNsSrKZezQrLb2whToNjnizpnurDXrobHqfEK3QqU1M,True,540955347,48990541,304893,152446,152447,2a35JJeTUW1pm6M3e8DHCjp8qr4vbc2cRPhuzZWyFzYd,33666426,193944629,-160278203,622
2022-04-18 00:20:15-04:00,15573,DxmkdZiygge1YAwbL8U6LudY3QJkSnZMHThQXkE4Z5qy,Gi8oNcSDphbtosjFudeEPtX88bUnYid1tL9FnXnLfASU,True,723980001,180995000,1036615,518307,518308,68sueyVfmy5ToEGtLFGDkwebX47xAmzyXE29z8JrmcWv,41464633,121475828,-80011195,572
2022-04-18 00:20:17-04:00,15574,8qq2gfbca7JXvq4gViBBVT2QAbM4MvBMEQLXgn8UUTvt,3o5jpBVYdFFEYrGRdCUkLrUC85wsuTKgy8iYwnpZyC1B,True,613565625,60555422,373217,186608,186609,3zqXX6kzhkbW3d4TwD2CNjMRwxTbREXySekvq37kfCNk,37815560,332825936,-295010376,616
2022-04-18 00:20:19-04:00,15575,GgJXh5hTo4xyVuuGEis971RRXcZECLpjvtMSCZtVu13Q,9BGMfGfMZNXdcygAuqYQudWHhSE5LqVoWsNsruCawnRK,False,11915580,11915580,701911,35095,666816,68sueyVfmy5ToEGtLFGDkwebX47xAmzyXE29z8JrmcWv,701911,2557247,-1855336,589
2022-04-18 00:20:19-04:00,15576,AQr9mVmcXCNQhBVCfx63MwR6c4WqDSC9K2BZqr7N8LCx,CB7TWUaL381ounsLw6neAUaKRxJL9P1HC9uGX5e1Uxod,True,525940661,35625526,222371,111185,111186,68sueyVfmy5ToEGtLFGDkwebX47xAmzyXE29z8JrmcWv,32828816,154923078,-122094262,624
2022-04-18 00:20:20-04:00,15577,5r3YEyxbXrMEwYCFyZXS5t1eRLDahPFxPBBYNyMfHfcZ,7fnHdwm7JWHREPPk7dMud4vEoYZqsiRYCMo6ZSQqMwQc,True,154720915,21109405,128580,64290,64290,68sueyVfmy5ToEGtLFGDkwebX47xAmzyXE29z8JrmcWv,9424318,60340644,-50916326,609
2022-04-18 00:20:22-04:00,15578,4PZZxNrWLhNCuT5VJ1DQe3XxQVVwMPrjfUpdeAY8qS7U,A7CvKre7y5VbUN1HneNHmuBv7jWtayV78oozAqaVbQrv,True,63983198,15995799,87708,43854,43854,68sueyVfmy5ToEGtLFGDkwebX47xAmzyXE29z8JrmcWv,3508349,27721234,-24212885,548
2022-04-18 00:20:25-04:00,15579,68zbVKnneMQqngbNkeLtPEP2ayNhawc1B2hPgqAEqgXK,HqiFpLr4NC7xJz9bEFusq8bCKaoxAQG1xsLxdUAzg8aa,True,1546929587,109085674,665907,332953,332954,A9TwRM1BMxqb8DCC7YNAMV6zPenEJm3HTZBy7wJKK58U,94431479,475087281,-380655802,610
2022-04-18 00:20:32-04:00,15580,9VojCEgzn99QRVPGKn6euGRQbM7Q86GZ6yHJQa7N3gv4,GW4GVNnUtEt68avsowddpmjoUTUyMvxV4c5kY3Gzz9fT,True,1276624762,126335231,784339,392169,392170,68sueyVfmy5ToEGtLFGDkwebX47xAmzyXE29z8JrmcWv,79257989,477643353,-398385364,620
2022-04-18 00:20:32-04:00,15581,7CSCMFa9W52tBDVUbXbc3woAy3GByeA1wPJdp3MgznPa,3447ptuVFu6G8B6N63RmS8mRv4n9PfHneypHLvbeaGLn,True,238929745,22006473,136539,68269,68270,3zqXX6kzhkbW3d4TwD2CNjMRwxTbREXySekvq37kfCNk,14824476,86880901,-72056425,620
2022-04-18 00:20:59-04:00,15582,FU7X4DWnGTbxwXULBq3v9SACzYhQyFGqsXjUDzyFqiem,925BaEnWxTfEv4oQb9Xf1wyyEEWEr8kXeSdXTtRfShfw,True,1042879593,260719898,1613191,806595,806596,68sueyVfmy5ToEGtLFGDkwebX47xAmzyXE29z8JrmcWv,64527672,129764249,-65236577,618
2022-04-18 00:21:04-04:00,15583,B3NyyoWNzyzvpWv1G6a9gZJMjD1sTQBdZojBaH18mNjY,BCj3EGFMhJ9wh4KvF9cqYsuNHug7kCbALFMLMtuh24bq,True,5005648532,1251412133,8821637,4410818,4410819,68sueyVfmy5ToEGtLFGDkwebX47xAmzyXE29z8JrmcWv,352865486,1179529735,-826664249,704
2022-04-18 00:21:10-04:00,15584,An9PgoB3s9T3TVC9vipP27wsPR9aZx8xPn7R6AbXojDa,2aoxARd4dXzvZ1uQpm8oETBLUF3JqzVU3Ek9LDH6ckWv,True,50019144361,2727311065,17431372,8715686,8715686,A9TwRM1BMxqb8DCC7YNAMV6zPenEJm3HTZBy7wJKK58U,3196930256,6565944915,-3369014659,639
2022-04-18 00:21:15-04:00,15585,ARB1q7bNcQ7grwFEZC6nk9Pfrrg7yZ2WK8zVqq5CEE8F,53e8mUYrWzQnCm9XQyp18CL9owyPqJcYyxZANYhRypPx,False,5457824,5457824,339992,16999,322993,68sueyVfmy5ToEGtLFGDkwebX47xAmzyXE29z8JrmcWv,339992,1279084,-939092,622
2022-04-18 00:21:32-04:00,15586,GPeALajYLrgVJgYb65PQUkFJxzeh4APUesZjy77sMy9j,Hnmv48N2jFXN2TYmyPxTsZf9JtnRoz2PfMEzL67UigXx,True,71509670,17877417,111698,55849,55849,A9TwRM1BMxqb8DCC7YNAMV6zPenEJm3HTZBy7wJKK58U,4467956,11018890,-6550934,624
2022-04-18 00:22:22-04:00,15587,7AizMrxWWr7qfneuXMy6ifL3BVDTAKkuud4PyZFy92kh,GyAWRRfQkVAXtyhVF14vU3kPMr4kG1VyA9FAHdDTr8ud,True,45502167,11375541,70969,35484,35485,2a35JJeTUW1pm6M3e8DHCjp8qr4vbc2cRPhuzZWyFzYd,2838799,13821854,-10983055,623
2022-04-18 00:23:10-04:00,15588,B6Wc3euMqUf6QjzCqDtNeAEUM7MvADFaiReEq9VYH2Qg,2pzhsqXYd5u7h4xTN8bMS3GbicVnJ6KY3MQn7spSXroA,True,240122165,31115178,194365,97182,97183,3zqXX6kzhkbW3d4TwD2CNjMRwxTbREXySekvq37kfCNk,14999568,46118967,-31119399,624
2022-04-18 00:23:22-04:00,15589,5r3YEyxbXrMEwYCFyZXS5t1eRLDahPFxPBBYNyMfHfcZ,7fnHdwm7JWHREPPk7dMud4vEoYZqsiRYCMo6ZSQqMwQc,True,132506858,17431553,107755,53877,53878,A2p75MbAbeUdHkPLkAjgGeiwuu9WPrkMHzjCkDXF1Xr3,8191086,54657365,-46466279,618
2022-04-18 00:23:23-04:00,15590,7CSCMFa9W52tBDVUbXbc3woAy3GByeA1wPJdp3MgznPa,3447ptuVFu6G8B6N63RmS8mRv4n9PfHneypHLvbeaGLn,True,215663635,20408893,127075,63537,63538,6UQfSsLooL4pQKQfLtXCutQS2BnF7A7F7ewJopDLmUpc,13428300,80180126,-66751826,622
2022-04-18 00:23:25-04:00,15591,C3DnHRyndQw1EinnmrayLzuhP9KhXYKVDUpf55BumxG1,6aU3EvNk5CyD5LdGhQksYKkNxvJ5vw23JvMEdwqeDSMo,True,584170472,146042618,902843,451421,451422,68sueyVfmy5ToEGtLFGDkwebX47xAmzyXE29z8JrmcWv,36113746,269455244,-233341498,618
2022-04-18 00:23:25-04:00,15592,85w2wxozVA7Zfm1FdA1yWb8D43jdC9mefYzNqFyRe5iU,BHieDhQaBUbsWGmqNerfbCAMMGGAjEPpiNiSWAQS57D5,True,93154397,23288599,143897,71948,71949,2a35JJeTUW1pm6M3e8DHCjp8qr4vbc2cRPhuzZWyFzYd,5755902,22643132,-16887230,617
2022-04-18 00:23:29-04:00,15593,6xFAmuXkSiTpJsPeGQ7vUH9zqPiY3eDVUnBoD5WVSSbT,4gLFfCY7K6DD5Ebvfc7v6jTzq5BozGvgdP8TaXPbnwE4,True,273202802,68300700,425346,212673,212673,3zqXX6kzhkbW3d4TwD2CNjMRwxTbREXySekvq37kfCNk,17013875,63420287,-46406412,622
2022-04-18 00:23:29-04:00,15594,3geiQ6Ph1iyCnfEfTmWpVnvdJnYoUb3HNeKXwshQMJuF,3uu2PC2DhTR3iXVEKbq5hC8FrzyTYbwF9Ztm3BD3hjEm,True,1208264706,302066176,1871962,935981,935981,3zqXX6kzhkbW3d4TwD2CNjMRwxTbREXySekvq37kfCNk,74878501,124171318,-49292817,619
2022-04-18 00:23:33-04:00,15595,9VojCEgzn99QRVPGKn6euGRQbM7Q86GZ6yHJQa7N3gv4,GW4GVNnUtEt68avsowddpmjoUTUyMvxV4c5kY3Gzz9fT,True,1142626942,99702341,617876,308938,308938,gjBMZYVujDjD1ECG4i97M8Q3gV9ESnwwTSUGropkusj,70811061,434447338,-363636277,619
2022-04-18 00:23:48-04:00,15596,An9PgoB3s9T3TVC9vipP27wsPR9aZx8xPn7R6AbXojDa,2aoxARd4dXzvZ1uQpm8oETBLUF3JqzVU3Ek9LDH6ckWv,True,47140404419,2694246712,17306528,8653264,8653264,3zqXX6kzhkbW3d4TwD2CNjMRwxTbREXySekvq37kfCNk,3028070007,6419276769,-3391206762,642
2022-04-18 00:23:48-04:00,15597,68zbVKnneMQqngbNkeLtPEP2ayNhawc1B2hPgqAEqgXK,HqiFpLr4NC7xJz9bEFusq8bCKaoxAQG1xsLxdUAzg8aa,True,1432390134,95010396,585771,292885,292886,6UQfSsLooL4pQKQfLtXCutQS2BnF7A7F7ewJopDLmUpc,88311793,440370428,-352058635,616
2022-04-18 00:23:48-04:00,15598,E4hzgCW69WjwBVWvTv4EvyTLT63dVBrS2gXeHCaezPrb,GTxQfXHAj9HTiwu7EwEKAQ1ZKoZDmcBgevJoZUDag1Gr,True,36115516,9028879,53399,26699,26700,6UQfSsLooL4pQKQfLtXCutQS2BnF7A7F7ewJopDLmUpc,2135982,7641594,-5505612,591
2022-04-18 00:23:48-04:00,15599,BTq6T9nDzYTPTRvxkhNLn82DF3RCWdRkatZUmSTGCu43,3Uuhmxo4tWMbrqowx2bQSJeWzMykUUcZanj29ptCmEa6,True,1578862308,217688008,1330176,665088,665088,3zqXX6kzhkbW3d4TwD2CNjMRwxTbREXySekvq37kfCNk,96475965,459789895,-363313930,611
2022-04-18 00:23:48-04:00,15600,BjCNaM7YbE9SjFi7tzi4677zg1fKXGJwtecz2GWwWuhd,6rNsSrKZezQrLb2whToNjnizpnurDXrobHqfEK3QqU1M,True,489153431,43107399,269227,134613,134614,6UQfSsLooL4pQKQfLtXCutQS2BnF7A7F7ewJopDLmUpc,30550158,185239931,-154689773,624
2022-04-18 00:23:48-04:00,15601,5yPGvUz6JWKjkViGwTCpygJii1rP2xv5yx146ULtBiYq,FMnHUCQWTf1UHu5qVFqUAsWh8aba9EQYTEoiXy55totD,True,38706361,9676590,58028,29014,29014,6UQfSsLooL4pQKQfLtXCutQS2BnF7A7F7ewJopDLmUpc,2321152,4219343,-1898191,599
2022-04-18 00:23:48-04:00,15602,HV3BVN9zLURqQBJyUFFeytFvjhhoYYJ3VXTCDYpML7Fd,ZCesJgyYoyWb3wfUP6BusxEBtVAYb2AAe94QbxVkFsb,True,114419238,28604809,168051,84025,84026,A9TwRM1BMxqb8DCC7YNAMV6zPenEJm3HTZBy7wJKK58U,6722076,23270990,-16548914,587
2022-04-18 00:23:52-04:00,15603,8RWQnZLKrEDvaekhSZNyuFbavew6NUbZbexudJQ4LvHe,7o5hHfycEjxgDgKwyHs22Qu1Tdqu9qXoKLeqaUWsch14,False,3534,3534,209,10,199,3zqXX6kzhkbW3d4TwD2CNjMRwxTbREXySekvq37kfCNk,209,0,209,591
2022-04-18 00:23:53-04:00,15604,67DwuUmzk6uGwmptjYErQssFeJ5fd1ztFwKWZUovr7pK,HKzc15e1QLBrSsbAENyMXSVHDoap1F5MHCHB9L1Dm8HA,True,17237591,4309397,25933,12966,12967,gjBMZYVujDjD1ECG4i97M8Q3gV9ESnwwTSUGropkusj,1037351,7486991,-6449640,601
2022-04-18 00:24:07-04:00,15605,DGHPykC1F6ZGrvMwSiEWuffUkKLnsG3VWY4TNEN71Kme,FYftYceHytwL9Ms5HxJ72ssw3gxr4cq3eV4ww15yfoJP,True,1948894236,487223559,3038127,1519063,1519064,3zqXX6kzhkbW3d4TwD2CNjMRwxTbREXySekvq37kfCNk,121525099,253901127,-132376028,623
2022-04-18 00:24:07-04:00,15606,7yW1M1xeVx4hy3QftnpqdBDRYwamfu3K5i6AEnxgyTWb,7wf7FWS2DYp5RveQAmGNXAEUWPcHziuMLd4hV5LPgxF8,True,20402984,5100746,29689,14844,14845,gjBMZYVujDjD1ECG4i97M8Q3gV9ESnwwTSUGropkusj,1187573,5811518,-4623945,582
2022-04-18 00:24:08-04:00,15607,GHHkWuoUrAsuf1n8Y2GFozQxxv3LSr2zU9DWwKmAGTG9,7Fr2hNXbiNUufq8USBK3HwWN4bQT6H9fcFzDt7fdKy2U,True,390589641479,97647410369,574681528,287340764,287340764,6UQfSsLooL4pQKQfLtXCutQS2BnF7A7F7ewJopDLmUpc,22987261121,88019149584,-65031888463,588
2022-04-18 00:24:08-04:00,15608,B6Wc3euMqUf6QjzCqDtNeAEUM7MvADFaiReEq9VYH2Qg,2pzhsqXYd5u7h4xTN8bMS3GbicVnJ6KY3MQn7spSXroA,True,206826088,28873766,176240,88120,88120,2py1FiYeL2f7J3HU36qiJz6TD6HCmiTN36RyxYtapQCZ,12624304,43056733,-30432429,610
2022-04-18 00:24:08-04:00,15609,BhhVhLVZkSd3aHDMd6ojTgtJtbgAdMCA9Xj8jL2GMXoL,G8HUQp2yGSw9T6it5ej91cqkd82naca8heji453g2jEH,True,388607809,49278428,285439,142719,142720,2a35JJeTUW1pm6M3e8DHCjp8qr4vbc2cRPhuzZWyFzYd,22509661,129385455,-106875794,579
2022-04-18 00:24:08-04:00,15610,5zSrKR5jwRqcCCFh2CcqH4DPE5ka56dmBqjndjuTLzLb,DjoKm6riRduDv4jUuQ2vPRZgJo7oyrhKqBBu9ypxvZhh,True,70347148,10345669,59679,29839,29840,2a35JJeTUW1pm6M3e8DHCjp8qr4vbc2cRPhuzZWyFzYd,4058029,28447961,-24389932,576
2022-04-18 00:24:08-04:00,15611,68zbVKnneMQqngbNkeLtPEP2ayNhawc1B2hPgqAEqgXK,HqiFpLr4NC7xJz9bEFusq8bCKaoxAQG1xsLxdUAzg8aa,True,1332629197,91993677,572793,286396,286397,A2p75MbAbeUdHkPLkAjgGeiwuu9WPrkMHzjCkDXF1Xr3,82975481,429340981,-346365500,622
2022-04-18 00:24:09-04:00,15612,85w2wxozVA7Zfm1FdA1yWb8D43jdC9mefYzNqFyRe5iU,BHieDhQaBUbsWGmqNerfbCAMMGGAjEPpiNiSWAQS57D5,True,68535747,17133936,107048,53524,53524,gjBMZYVujDjD1ECG4i97M8Q3gV9ESnwwTSUGropkusj,4281954,18277507,-13995553,624
2022-04-18 00:24:09-04:00,15613,DwoQXrbwHmfnkWvYaHbPjir3WLmq3oSpSrAjnPdDqgtL,Hv6r5uYpyyn8B4PTzrki6mj5hdF64yaa564Zi277tANU,True,22757080711,5689270177,34520164,17260082,17260082,3zqXX6kzhkbW3d4TwD2CNjMRwxTbREXySekvq37kfCNk,1380806594,9464817450,-8084010856,606
2022-04-18 00:24:09-04:00,15614,HT2SuCbePhjNZaar24uVwihYowCNvSjdvhJ8BRSVw9nX,98Ts4LCnapHVoCJ5PW3Armvh4jvDtpfs3SYRLRxiAgzZ,True,6914020277,1205660687,6985446,3492723,3492723,6UQfSsLooL4pQKQfLtXCutQS2BnF7A7F7ewJopDLmUpc,400589665,1711501716,-1310912051,579
2022-04-18 00:24:09-04:00,15615,FV9CBGGTbppLnBKh79f2LzD1diTiS5g6u89FcpZHZmnK,Fe7mtmCUziFqbbYTvrhAcAq1Ub7YLfTJRtQ1hG7GzJD1,True,22845025,2882324,17188,8594,8594,6UQfSsLooL4pQKQfLtXCutQS2BnF7A7F7ewJopDLmUpc,1362384,7559637,-6197253,596
2022-04-18 00:24:09-04:00,15616,5YC2wXkdk7D4Ubs9TEAbP1hi88Sy35bzYVWjLbgVxn5s,4Mx69ezqFK2wudZ62oVhx2pwjVbKv8JB1HR29ZUcdEJb,True,246222935,61555733,324326,162163,162163,3zqXX6kzhkbW3d4TwD2CNjMRwxTbREXySekvq37kfCNk,12973044,76527593,-63554549,526
2022-04-18 00:24:13-04:00,15617,C3DnHRyndQw1EinnmrayLzuhP9KhXYKVDUpf55BumxG1,6aU3EvNk5CyD5LdGhQksYKkNxvJ5vw23JvMEdwqeDSMo,True,429534334,107383583,665434,332717,332717,3zqXX6kzhkbW3d4TwD2CNjMRwxTbREXySekvq37kfCNk,26617383,210220691,-183603308,619
2022-04-18 00:24:13-04:00,15618,2dbTtvw8XJnGdCeGnk1rbCY2SYszRNcCoGSVkACo1LDs,7aE9VZ6FP38CMuxDrjHESyNX6YZRxnfiDp3K4gDpDxJj,True,464759678,116189919,638745,319372,319373,A9TwRM1BMxqb8DCC7YNAMV6zPenEJm3HTZBy7wJKK58U,25549832,50461018,-24911186,549
2022-04-18 00:24:13-04:00,15619,9U25LWBU67c9S6L9F4qmjpTkaHqjFgxyuTCqQ7Zqj62g,ESyDCGZWamnabH3NNvus52X6Z9YAmt3y8oB8zYLmhfX3,True,1809191040,452297760,2499577,1249788,1249789,A9TwRM1BMxqb8DCC7YNAMV6zPenEJm3HTZBy7wJKK58U,99983119,332167908,-232184789,552
2022-04-18 00:24:14-04:00,15620,G1itFhAuojgBizYvak692TxrGS2Ck3KcYEfNQXYNitbW,8u8JiQpfkpbpM9EjunnM6MY22FAGycwmW6DgFVGA5c48,True,385217122,96304280,501685,250842,250843,3zqXX6kzhkbW3d4TwD2CNjMRwxTbREXySekvq37kfCNk,20067421,56683070,-36615649,520
2022-04-18 00:24:14-04:00,15621,D8BtQirMEk3W9Pq29B6KkKWrwPfmsUNpwz5npx7aGMLY,J7LMZwaSoh5hbGcwee6oPsnN4ZFD7Zp3LQWkJGNUHRfJ,True,500450606,125112651,715105,357552,357553,3zqXX6kzhkbW3d4TwD2CNjMRwxTbREXySekvq37kfCNk,28604221,51831238,-23227017,571
2022-04-18 00:24:14-04:00,15622,J8khFNhJg25xVY7yjEtETTQVVzKHqdVCs1Rh2pJKvJqU,4eUP2YxTapjr6TLrd57XxZan7KJG5AtHK8yPRNVEbavx,True,55491474,13872868,77958,38979,38979,2a35JJeTUW1pm6M3e8DHCjp8qr4vbc2cRPhuzZWyFzYd,3118333,14728431,-11610098,561
2022-04-18 00:24:14-04:00,15623,7CSCMFa9W52tBDVUbXbc3woAy3GByeA1wPJdp3MgznPa,3447ptuVFu6G8B6N63RmS8mRv4n9PfHneypHLvbeaGLn,True,193590967,16725350,100542,50271,50271,A2p75MbAbeUdHkPLkAjgGeiwuu9WPrkMHzjCkDXF1Xr3,11637450,73631879,-61994429,601
2022-04-18 00:24:15-04:00,15624,41C3X3toJCZ65Nd6zc79teYuDeTphgZDZZJZgy7y1Z8j,3tzdngRbjatMiGdhXqWaCWNkd3bNFTis1CZYCkhNFpiC,True,621048267,155262066,942240,471120,471120,3zqXX6kzhkbW3d4TwD2CNjMRwxTbREXySekvq37kfCNk,37689608,266356854,-228667246,606
2022-04-18 00:24:19-04:00,15625,AX2VRZoWZDfZT4QdwuXUSyRCx4N6B9eHAR75FSmcrVFG,FBgLGmbouri9wCV92UXZaDjwK6fcpjhDDD5NLVWmuRRK,True,994583817,248645954,1441756,720878,720878,3zqXX6kzhkbW3d4TwD2CNjMRwxTbREXySekvq37kfCNk,57670267,404322476,-346652209,579
2022-04-18 00:24:19-04:00,15626,29JVska5UEG3axs63EmtHpPvkswNEqYpZ3PKMSfupiAG,DCftNBUsuogxyaJe9G9m3eWipH6o3qo4Rn4TuQXdVaBF,True,186812798,46703199,257796,128898,128898,3zqXX6kzhkbW3d4TwD2CNjMRwxTbREXySekvq37kfCNk,10311846,24749223,-14437377,551
2022-04-18 00:24:19-04:00,15627,2i5g7q4gD1GEfSz8BkhKn1idQ5U7cFPbMDWugjr7bBQW,Dpx6K9G5uZD63rTzBafZ56WKd1X9M25Mzfppd7Jib4xn,True,223942958,55985739,305963,152981,152982,3zqXX6kzhkbW3d4TwD2CNjMRwxTbREXySekvq37kfCNk,12238540,106349923,-94111383,546
2022-04-18 00:24:19-04:00,15628,4U5pUaMfeesvncA9JNmMhs7gSV1B8cmPnXJXSRBVS3So,QaYTU1jx464rJqmQtqtb4z5uuT5KEFNQNQiJgo81RzA,True,33085428,8271357,42154,21077,21077,68sueyVfmy5ToEGtLFGDkwebX47xAmzyXE29z8JrmcWv,1686174,7751308,-6065134,509
2022-04-18 00:24:19-04:00,15629,1EH82ta3wXUyUwW8VWQnVzSG3r1rHcSj2DvDeTKmp3F,B6aMfucYPbCzWBtauLtgTpwR45wKSK8yqscHJR3F5usu,True,120202408,30050602,169510,84755,84755,2a35JJeTUW1pm6M3e8DHCjp8qr4vbc2cRPhuzZWyFzYd,6780400,30650564,-23870164,564
2022-04-18 00:24:20-04:00,15630,6pAs5S7zGX77DHSYUuCxvxbf2FQQHQhbBmAYLd3iJvWS,HNTWEhsrnEe8FeVDpEcxuoD5PnuveB5BwSf3gdBmhzxv,True,372099548,93024887,573412,286706,286706,DQCvC9mR68hJ3tJsUiddh6JwcBJAmntqGJR2nUsEq7yj,22936495,37716538,-14780043,616
2022-04-18 00:24:23-04:00,15631,7e33yGYb8MyqYa4UHZEguG4GHHpzTG7cE8vr5vSB75F3,HkWRSSSAmHf1HWxxTzxdoNN1w1QMKCkwNL4Fwg9eaXdT,True,10500100107,2625025026,16380619,8190309,8190310,68sueyVfmy5ToEGtLFGDkwebX47xAmzyXE29z8JrmcWv,655224797,1792308756,-1137083959,624
2022-04-18 00:24:23-04:00,15632,BTq6T9nDzYTPTRvxkhNLn82DF3RCWdRkatZUmSTGCu43,3Uuhmxo4tWMbrqowx2bQSJeWzMykUUcZanj29ptCmEa6,True,1349932456,176550862,1097337,548668,548669,6UQfSsLooL4pQKQfLtXCutQS2BnF7A7F7ewJopDLmUpc,83903945,383753223,-299849278,621
2022-04-18 00:24:24-04:00,15633,DYVRtcWJQPkyJRs2xXd6zFSENzsDbkmG9tN8tXBzArD5,2MNLM3YEfb9VLQe6MPkenbZoi5gC2ECYVPqEnbSScjHT,True,85594103,21398525,112703,56351,56352,47z82br5WdW2DZajdnPDPSSRRKsyAggqXqK6oPUwTaLf,4508154,8896572,-4388418,526
2022-04-18 00:24:26-04:00,15634,8AVdWWDFJerLB9M3HXDk1UijgCmd7DqHP883SpbQhgmv,EULz3KU7Zzi4Ub7D4W5envbwRhuMxQ6J5Vc8ezvwsy1t,True,98138703,24534675,149955,74977,74978,2a35JJeTUW1pm6M3e8DHCjp8qr4vbc2cRPhuzZWyFzYd,5998205,22841278,-16843073,611
2022-04-18 00:24:27-04:00,15635,FhCW2CghBaoo1MkXUXUb4okam8g5beQofgs3WXerNYzn,HWSPdmF3hSnnfVe29Y5rDGSPqbMQv2ug1wYrdwJZNWFK,True,298535628,74633907,463762,231881,231881,3zqXX6kzhkbW3d4TwD2CNjMRwxTbREXySekvq37kfCNk,18550519,30735222,-12184703,621
2022-04-18 00:24:27-04:00,15636,9qGz5Mh1XNUXqY1vEg5S1ZEMzPFvBLRbp1qaXwxSFMby,D8KnbVXStSUz3QhZGzY5o853ASocjkyu9x682oHgVoZh,True,52041624123,12094607857,72685071,36342535,36342536,3zqXX6kzhkbW3d4TwD2CNjMRwxTbREXySekvq37kfCNk,3127550093,11243279655,-8115729562,600
2022-04-18 00:24:27-04:00,15637,An9PgoB3s9T3TVC9vipP27wsPR9aZx8xPn7R6AbXojDa,2aoxARd4dXzvZ1uQpm8oETBLUF3JqzVU3Ek9LDH6ckWv,True,44251211275,2303583393,14658286,7329143,7329143,3zqXX6kzhkbW3d4TwD2CNjMRwxTbREXySekvq37kfCNk,2815817047,6284162090,-3468345043,636
2022-04-18 00:24:29-04:00,15638,AKcGcqFMxvVWFHpc9oUJYGZsLN4DUHVkMSLGYrMcCYYN,4dWje79e7kH8GWJwwfB76BQUVUSgnYHTVxrtfNyG5A4K,True,47317729539,8445190164,49437994,24718997,24718997,68sueyVfmy5ToEGtLFGDkwebX47xAmzyXE29z8JrmcWv,2769971585,5910038205,-3140066620,585
2022-04-18 00:24:31-04:00,15639,DVMLxFACqaNBD7q1TGJUUApJX7etJsxQRRFBP2DfBazJ,4hnRjD7S2KxD7UrgfrApntVxUD7Srh5E9nwPY53v89kz,True,67580725,8480304,52118,26059,26059,gjBMZYVujDjD1ECG4i97M8Q3gV9ESnwwTSUGropkusj,4153395,24081314,-19927919,614
2022-04-18 00:24:33-04:00,15640,6TvTxJWSPeyaTVm8PmarVDzxhbTqnkyoabQTgihXyGMj,62ngTMHaRDFjpvzasDgfmgyJ5T6jS9PmYgy97HCkyQS4,False,13352377,13352377,797450,39872,757578,2a35JJeTUW1pm6M3e8DHCjp8qr4vbc2cRPhuzZWyFzYd,797450,2525434,-1727984,597
2022-04-18 00:24:33-04:00,15641,GLGQxmrYNDs5o8ntzpokP5RXDBSsrVGDebF2jHiCSP1B,gbTdqfL8xU1HK4b9qCm2CPKjSsWSkW8ErRCAtdWTbpq,True,412540590,103135147,628561,314280,314281,3zqXX6kzhkbW3d4TwD2CNjMRwxTbREXySekvq37kfCNk,25142474,42602947,-17460473,609
2022-04-18 00:24:34-04:00,15642,7CSCMFa9W52tBDVUbXbc3woAy3GByeA1wPJdp3MgznPa,3447ptuVFu6G8B6N63RmS8mRv4n9PfHneypHLvbeaGLn,True,176112641,16225485,99353,49676,49677,68sueyVfmy5ToEGtLFGDkwebX47xAmzyXE29z8JrmcWv,10783932,67911208,-57127276,612
2022-04-18 00:24:34-04:00,15643,BhhVhLVZkSd3aHDMd6ojTgtJtbgAdMCA9Xj8jL2GMXoL,G8HUQp2yGSw9T6it5ej91cqkd82naca8heji453g2jEH,True,338184499,47834389,298155,149077,149078,3zqXX6kzhkbW3d4TwD2CNjMRwxTbREXySekvq37kfCNk,21079340,115236974,-94157634,623
2022-04-18 00:24:34-04:00,15644,BjCNaM7YbE9SjFi7tzi4677zg1fKXGJwtecz2GWwWuhd,6rNsSrKZezQrLb2whToNjnizpnurDXrobHqfEK3QqU1M,True,442776348,42777673,260961,130480,130481,6UQfSsLooL4pQKQfLtXCutQS2BnF7A7F7ewJopDLmUpc,27011247,168612048,-141600801,610
2022-04-18 00:24:39-04:00,15645,5o4EAqBTiUKn41QhPL5kRjrGTgQVdP7xLtxC7xNxjkwn,E8gDreu3LxW1EHJ8hnqChK9QdffGh5GocJYKdrbYat8E,True,1586244972,396561243,2338494,1169247,1169247,3zqXX6kzhkbW3d4TwD2CNjMRwxTbREXySekvq37kfCNk,93539774,337625457,-244085683,589
2022-04-18 00:24:40-04:00,15646,EC8fafqtuQzqbm2TZs3GeuXB9qXomkykrTG1na2rfFpx,A72f7W58h3r8nut45RmqdTk1J31NGYT2sVWMn18dK885,False,15875287,15875287,951551,47577,903974,2a35JJeTUW1pm6M3e8DHCjp8qr4vbc2cRPhuzZWyFzYd,951551,4086909,-3135358,599
2022-04-18 00:24:40-04:00,15647,5yPGvUz6JWKjkViGwTCpygJii1rP2xv5yx146ULtBiYq,FMnHUCQWTf1UHu5qVFqUAsWh8aba9EQYTEoiXy55totD,True,28542498,7135624,44396,22198,22198,6UQfSsLooL4pQKQfLtXCutQS2BnF7A7F7ewJopDLmUpc,1775851,3686780,-1910929,622
2022-04-18 00:24:40-04:00,15648,7sgoB9mHcUoNFFdQSsBvyC4tXYzYR86ct11WQsS1FvAp,5k2QtQPgMUvj88Tmizf1pABHtC3VHJDc6BYNkB9gp19M,True,251781169,62945292,351994,175997,175997,3zqXX6kzhkbW3d4TwD2CNjMRwxTbREXySekvq37kfCNk,14079798,56003487,-41923689,559
2022-04-18 00:24:40-04:00,15649,6xFAmuXkSiTpJsPeGQ7vUH9zqPiY3eDVUnBoD5WVSSbT,4gLFfCY7K6DD5Ebvfc7v6jTzq5BozGvgdP8TaXPbnwE4,True,200555469,50138867,306047,153023,153024,gjBMZYVujDjD1ECG4i97M8Q3gV9ESnwwTSUGropkusj,12241896,51394009,-39152113,610
2022-04-18 00:24:40-04:00,15650,HV3BVN9zLURqQBJyUFFeytFvjhhoYYJ3VXTCDYpML7Fd,ZCesJgyYoyWb3wfUP6BusxEBtVAYb2AAe94QbxVkFsb,True,84373809,21093452,127835,63917,63918,gjBMZYVujDjD1ECG4i97M8Q3gV9ESnwwTSUGropkusj,5113405,18965826,-13852421,606
2022-04-18 00:24:43-04:00,15651,3geiQ6Ph1iyCnfEfTmWpVnvdJnYoUb3HNeKXwshQMJuF,3uu2PC2DhTR3iXVEKbq5hC8FrzyTYbwF9Ztm3BD3hjEm,True,886871171,221717792,1341979,670989,670990,3zqXX6kzhkbW3d4TwD2CNjMRwxTbREXySekvq37kfCNk,53679180,109987817,-56308637,605
2022-04-18 00:24:43-04:00,15652,68zbVKnneMQqngbNkeLtPEP2ayNhawc1B2hPgqAEqgXK,HqiFpLr4NC7xJz9bEFusq8bCKaoxAQG1xsLxdUAzg8aa,True,1235373342,89987295,561908,280954,280954,3zqXX6kzhkbW3d4TwD2CNjMRwxTbREXySekvq37kfCNk,77140510,393692468,-316551958,624
2022-04-18 00:24:44-04:00,15653,AQr9mVmcXCNQhBVCfx63MwR6c4WqDSC9K2BZqr7N8LCx,CB7TWUaL381ounsLw6neAUaKRxJL9P1HC9uGX5e1Uxod,True,487707739,34109936,209811,104905,104906,3zqXX6kzhkbW3d4TwD2CNjMRwxTbREXySekvq37kfCNk,29999049,151289592,-121290543,615
2022-04-18 00:24:44-04:00,15654,E4hzgCW69WjwBVWvTv4EvyTLT63dVBrS2gXeHCaezPrb,GTxQfXHAj9HTiwu7EwEKAQ1ZKoZDmcBgevJoZUDag1Gr,True,26626626,6656656,40564,20282,20282,2a35JJeTUW1pm6M3e8DHCjp8qr4vbc2cRPhuzZWyFzYd,1622572,6211804,-4589232,609
2022-04-18 00:24:44-04:00,15655,BTwSuuDHNhQAFAzBZRWev5j1ix2RTWvjZAxLpw8grAxu,31NCyUpSXxxJYLSrdK3c5bLomUtMejobMfYnq7j71GtM,True,198566032,49641508,285589,142794,142795,3zqXX6kzhkbW3d4TwD2CNjMRwxTbREXySekvq37kfCNk,11423569,33504489,-22080920,575
2022-04-18 00:24:45-04:00,15656,Br1j5Ftafei7ysu5SmqVZSoRe4uS4qCPeKSPHg55pyiE,G8fc7QvXjfkgBFvAVUgJFQS3VaF1biL9rktBExGa87Ks,True,339820591,84955147,529442,264721,264721,3zqXX6kzhkbW3d4TwD2CNjMRwxTbREXySekvq37kfCNk,21177692,59671243,-38493551,623
2022-04-18 00:24:48-04:00,15657,DXGapgtgkag6midSCYNhHCNaCqvhUmuSvnVhXxNXBmyt,Csq6W5QkGZL6qE6Z1ERF3bfHtKjnM8hAxiY1YA3rTwSX,False,16689732,16689732,984776,49238,935538,A9TwRM1BMxqb8DCC7YNAMV6zPenEJm3HTZBy7wJKK58U,984776,8402509,-7417733,590
2022-04-18 00:24:49-04:00,15658,3uUdWwgwtFdPa3FJTSrirqPKMtQb3zmT5Wpp4zPy9sJP,5G7dhz8jvWekGy9Wh3ZCXNXSPbB1QArfFYs7MYNgRDkW,True,27536471,6884117,41155,20577,20578,47z82br5WdW2DZajdnPDPSSRRKsyAggqXqK6oPUwTaLf,1646202,12902707,-11256505,597
2022-04-18 00:24:56-04:00,15659,67DwuUmzk6uGwmptjYErQssFeJ5fd1ztFwKWZUovr7pK,HKzc15e1QLBrSsbAENyMXSVHDoap1F5MHCHB9L1Dm8HA,False,12705348,12705348,788572,39428,749144,2py1FiYeL2f7J3HU36qiJz6TD6HCmiTN36RyxYtapQCZ,788572,5848652,-5060080,620
2022-04-18 00:24:58-04:00,15660,5FewDaMC9U7n5EHcto98GaAmDVxDh5SYimuTP6AtfakM,7DAULUoqV7f9hsBzKEhjQPnWaHSqiMWcBqWcdcadaQv4,True,1166418515,161529087,1008746,504373,504373,3zqXX6kzhkbW3d4TwD2CNjMRwxTbREXySekvq37kfCNk,72842679,132296154,-59453475,624
2022-04-18 00:25:00-04:00,15661,HooxSzasW3HMoFJ6sAvRQ75Char1J5aBdJtsqfDV6myp,BCmsWwpGeV4NNfeKZKKydty2uueLGHYTJDk1WErpXsVT,True,157563962,39390990,227503,113751,113752,47z82br5WdW2DZajdnPDPSSRRKsyAggqXqK6oPUwTaLf,9100121,42886972,-33786851,577
2022-04-18 00:25:18-04:00,15662,7rv6mScghVBDC6cdbkZ47NtqqrTZAqyewKEsRHUkP6x5,EFgBoSg7u5yHdR5kqARTb3BUGmwnuz6g72GsuJTBiEEv,False,21160,21160,1315,65,1250,72FwbpFGoLEazJEdpqNtPNefsadUrimUqma9wSoy4qiS,1315,0,1315,621
2022-04-18 00:25:28-04:00,15663,4U5pUaMfeesvncA9JNmMhs7gSV1B8cmPnXJXSRBVS3So,QaYTU1jx464rJqmQtqtb4z5uuT5KEFNQNQiJgo81RzA,True,24713757,6178439,38592,19296,19296,2a35JJeTUW1pm6M3e8DHCjp8qr4vbc2cRPhuzZWyFzYd,1543706,6192881,-4649175,624
2022-04-18 00:25:37-04:00,15664,9VojCEgzn99QRVPGKn6euGRQbM7Q86GZ6yHJQa7N3gv4,GW4GVNnUtEt68avsowddpmjoUTUyMvxV4c5kY3Gzz9fT,True,1037522592,93177108,581871,290935,290936,3zqXX6kzhkbW3d4TwD2CNjMRwxTbREXySekvq37kfCNk,64791176,408536505,-343745329,624
2022-04-18 00:26:40-04:00,15665,9eWpSyu71Z6dmx7yTh7WrbVScdrrZN14d5tfmqEGFgXt,2r89PFKSD9zmSp2Wyx4CQ75HAtmUgwhAS2oG5MuYuiV6,True,1105107891,276276972,1715939,857969,857970,DQCvC9mR68hJ3tJsUiddh6JwcBJAmntqGJR2nUsEq7yj,68637597,445854306,-377216709,621
2022-04-18 00:27:05-04:00,15666,3BKX31xq3f13J2Zo8Wue4SYpCMWLXjgUt2nkwTTNfU2T,2pTxNAaV4pXRRUDE97ZFteBJn9tyktjh3FW1CWfwebci,False,14609921,14609921,907463,45373,862090,68sueyVfmy5ToEGtLFGDkwebX47xAmzyXE29z8JrmcWv,907463,5953971,-5046508,621
2022-04-18 00:29:07-04:00,15667,68RZsaAJib9kw5xnnt9QhvsAa1DGJzww1MKqACsMvxGr,3z8H2C111LCABJymwxJAG9boicBXcJXq3ft6jqmV9rSw,True,190767442,47691860,338776,169388,169388,2a35JJeTUW1pm6M3e8DHCjp8qr4vbc2cRPhuzZWyFzYd,13551049,33721189,-20170140,710
2022-04-18 00:29:29-04:00,15668,5r3YEyxbXrMEwYCFyZXS5t1eRLDahPFxPBBYNyMfHfcZ,7fnHdwm7JWHREPPk7dMud4vEoYZqsiRYCMo6ZSQqMwQc,True,114079720,15587546,96844,48422,48422,68sueyVfmy5ToEGtLFGDkwebX47xAmzyXE29z8JrmcWv,7087746,47236272,-40148526,621
2022-04-18 00:41:40-04:00,15669,8qq2gfbca7JXvq4gViBBVT2QAbM4MvBMEQLXgn8UUTvt,3o5jpBVYdFFEYrGRdCUkLrUC85wsuTKgy8iYwnpZyC1B,True,548152504,46325857,288683,144341,144342,2py1FiYeL2f7J3HU36qiJz6TD6HCmiTN36RyxYtapQCZ,34158674,287537671,-253378997,623
2022-04-18 00:42:27-04:00,15670,An9PgoB3s9T3TVC9vipP27wsPR9aZx8xPn7R6AbXojDa,2aoxARd4dXzvZ1uQpm8oETBLUF3JqzVU3Ek9LDH6ckWv,True,41815079754,2385352751,15223162,7611581,7611581,A9TwRM1BMxqb8DCC7YNAMV6zPenEJm3HTZBy7wJKK58U,2668610633,6085361505,-3416750872,638
2022-04-18 00:42:43-04:00,15671,AQr9mVmcXCNQhBVCfx63MwR6c4WqDSC9K2BZqr7N8LCx,CB7TWUaL381ounsLw6neAUaKRxJL9P1HC9uGX5e1Uxod,True,452043144,32704215,204270,102135,102135,A9TwRM1BMxqb8DCC7YNAMV6zPenEJm3HTZBy7wJKK58U,28234579,141679723,-113445144,624
2022-04-18 00:42:57-04:00,15672,6Zyz5SGNMpEtCBu7H2USCkJCKpAJxLJrdf7h8N1W4fwp,3TTgDXx7VPZtB7aJDMShctxL5Y5To2Ugz927CoHNRztJ,True,113067736,28266934,174350,87175,87175,A9TwRM1BMxqb8DCC7YNAMV6zPenEJm3HTZBy7wJKK58U,6974032,49254288,-42280256,616
2022-04-18 00:42:59-04:00,15673,8fVwuVA2CL5sZoHh6Dg4MBpcX3cvoUm7mnitnpQSdPBD,4F4ccaNm1KQu29XvsKvdjFkmpsbWqNvXkV41851EYQyu,True,247847341,23832466,148931,74465,74466,6UQfSsLooL4pQKQfLtXCutQS2BnF7A7F7ewJopDLmUpc,15488231,61485492,-45997261,624
2022-04-18 00:43:10-04:00,15674,9VojCEgzn99QRVPGKn6euGRQbM7Q86GZ6yHJQa7N3gv4,GW4GVNnUtEt68avsowddpmjoUTUyMvxV4c5kY3Gzz9fT,True,938802379,91335285,570758,285379,285379,gjBMZYVujDjD1ECG4i97M8Q3gV9ESnwwTSUGropkusj,58666200,374568985,-315902785,624
2022-04-18 00:49:38-04:00,15675,J6ndjmic8buVqwa4URRRgv2iTc4ekbYUHdcpa3DUCufN,7qvvczUw8ngwdQae49BiQwQmdV2SSWsAVV2tmZYL7gw6,True,18085766092,4521441523,28249394,14124697,14124697,A9TwRM1BMxqb8DCC7YNAMV6zPenEJm3HTZBy7wJKK58U,1129975780,2834607441,-1704631661,624
2022-04-18 00:53:07-04:00,15676,An9PgoB3s9T3TVC9vipP27wsPR9aZx8xPn7R6AbXojDa,2aoxARd4dXzvZ1uQpm8oETBLUF3JqzVU3Ek9LDH6ckWv,True,39290927818,2303527918,14742396,7371198,7371198,A9TwRM1BMxqb8DCC7YNAMV6zPenEJm3HTZBy7wJKK58U,2514588286,5919342778,-3404754492,639
2022-04-18 00:56:18-04:00,15677,impmg97osZac6q2B4SjAewuVYdMu4kPAg9totcz9h9Y,7ytd7QqMrXK3bVLPsgWSQSTgyAZnmPsPoD42k4Frkbz,True,255573819,51962899,324636,162318,162318,3zqXX6kzhkbW3d4TwD2CNjMRwxTbREXySekvq37kfCNk,15966882,20827289,-4860407,624
2022-04-18 00:57:54-04:00,15678,5zSrKR5jwRqcCCFh2CcqH4DPE5ka56dmBqjndjuTLzLb,DjoKm6riRduDv4jUuQ2vPRZgJo7oyrhKqBBu9ypxvZhh,True,59712941,7685637,47748,23874,23874,A9TwRM1BMxqb8DCC7YNAMV6zPenEJm3HTZBy7wJKK58U,3709812,25301997,-21592185,621
2022-04-18 00:58:00-04:00,15679,BjCNaM7YbE9SjFi7tzi4677zg1fKXGJwtecz2GWwWuhd,6rNsSrKZezQrLb2whToNjnizpnurDXrobHqfEK3QqU1M,True,398087593,35843872,223652,111826,111826,gjBMZYVujDjD1ECG4i97M8Q3gV9ESnwwTSUGropkusj,24839204,152678103,-127838899,623
2022-04-18 00:58:07-04:00,15680,7CSCMFa9W52tBDVUbXbc3woAy3GByeA1wPJdp3MgznPa,3447ptuVFu6G8B6N63RmS8mRv4n9PfHneypHLvbeaGLn,True,159144583,15059809,94080,47040,47040,gjBMZYVujDjD1ECG4i97M8Q3gV9ESnwwTSUGropkusj,9942006,62609268,-52667262,624
2022-04-18 00:59:03-04:00,15681,FV9CBGGTbppLnBKh79f2LzD1diTiS5g6u89FcpZHZmnK,Fe7mtmCUziFqbbYTvrhAcAq1Ub7YLfTJRtQ1hG7GzJD1,True,19858623,2826322,17663,8831,8832,gjBMZYVujDjD1ECG4i97M8Q3gV9ESnwwTSUGropkusj,1241118,6821614,-5580496,624
2022-04-18 00:59:19-04:00,15682,5BjBPqumCb9KC82ZNNch3dcRzbpGdRLJneru7o9a1D9R,FuZtBWKktxFu4yoiLVMzxq8fMhQyN8SGzGPz49xs3m6P,True,295843041,38267552,239106,119553,119553,DQCvC9mR68hJ3tJsUiddh6JwcBJAmntqGJR2nUsEq7yj,18485131,89942604,-71457473,624
2022-04-18 00:59:26-04:00,15683,EahfXK27VcsfynP3DtAYDwRn4Xc5rbJVRqt5iTjPTpP2,D9HBnxuDQ9KyvnaHrP6RL4MQ1WxsyepxmAbJDdvT11tg,False,238965,238965,14905,745,14160,DQCvC9mR68hJ3tJsUiddh6JwcBJAmntqGJR2nUsEq7yj,14905,25942,-11037,623
2022-04-18 00:59:26-04:00,15684,5P5wYp4Fza14RYYmGd9vTXo7SahRpV68EUQrG4iYHRtB,5cM2uE7mkTqbrxstWpUefXd7FuGjbs6iWMUt8s8xWc5u,True,353769027,88442256,547702,273851,273851,DQCvC9mR68hJ3tJsUiddh6JwcBJAmntqGJR2nUsEq7yj,21908083,165324439,-143416356,619
2022-04-18 00:59:31-04:00,15685,G1itFhAuojgBizYvak692TxrGS2Ck3KcYEfNQXYNitbW,8u8JiQpfkpbpM9EjunnM6MY22FAGycwmW6DgFVGA5c48,True,287266241,71816560,447978,223989,223989,DQCvC9mR68hJ3tJsUiddh6JwcBJAmntqGJR2nUsEq7yj,17919135,47028733,-29109598,623
2022-04-18 00:59:31-04:00,15686,HT2SuCbePhjNZaar24uVwihYowCNvSjdvhJ8BRSVw9nX,98Ts4LCnapHVoCJ5PW3Armvh4jvDtpfs3SYRLRxiAgzZ,True,5666548352,899051644,5581528,2790764,2790764,68sueyVfmy5ToEGtLFGDkwebX47xAmzyXE29z8JrmcWv,351792981,1446796289,-1095003308,620
2022-04-18 00:59:34-04:00,15687,G7DDx3Wgv5MfLdMHokpzKXSeDc7rKyEif7S31yRck2Ws,4PU8yx1fP4yY3DDr3XEXvMcFWDUVdFjfEtGHQqYn7iSL,True,58358431,14589607,90739,45369,45370,2a35JJeTUW1pm6M3e8DHCjp8qr4vbc2cRPhuzZWyFzYd,3629567,13914653,-10285086,621
2022-04-18 00:59:49-04:00,15688,7yW1M1xeVx4hy3QftnpqdBDRYwamfu3K5i6AEnxgyTWb,7wf7FWS2DYp5RveQAmGNXAEUWPcHziuMLd4hV5LPgxF8,False,15081538,15081538,937184,46859,890325,6UQfSsLooL4pQKQfLtXCutQS2BnF7A7F7ewJopDLmUpc,937184,4625847,-3688663,621
2022-04-18 01:00:11-04:00,15689,5YC2wXkdk7D4Ubs9TEAbP1hi88Sy35bzYVWjLbgVxn5s,4Mx69ezqFK2wudZ62oVhx2pwjVbKv8JB1HR29ZUcdEJb,True,183407102,45851775,284684,142342,142342,3zqXX6kzhkbW3d4TwD2CNjMRwxTbREXySekvq37kfCNk,11387363,60313967,-48926604,620
2022-04-18 01:00:13-04:00,15690,DYVRtcWJQPkyJRs2xXd6zFSENzsDbkmG9tN8tXBzArD5,2MNLM3YEfb9VLQe6MPkenbZoi5gC2ECYVPqEnbSScjHT,True,63767194,15941798,99165,49582,49583,A2p75MbAbeUdHkPLkAjgGeiwuu9WPrkMHzjCkDXF1Xr3,3966631,7686389,-3719758,622
2022-04-18 01:05:25-04:00,15691,2ssYxbmFPYBdse9a6NJ26M8hsscYpjv5MyqyYkjftdrL,FKvvXz9eYXW2zgy37eaUW9u2K9LnnDsNx3DcgtATpizY,True,31825405,7956351,49261,24630,24631,gjBMZYVujDjD1ECG4i97M8Q3gV9ESnwwTSUGropkusj,1970444,8861276,-6890832,619
2022-04-18 01:05:36-04:00,15692,BTq6T9nDzYTPTRvxkhNLn82DF3RCWdRkatZUmSTGCu43,3Uuhmxo4tWMbrqowx2bQSJeWzMykUUcZanj29ptCmEa6,True,1163216319,159601166,996150,498075,498075,DQCvC9mR68hJ3tJsUiddh6JwcBJAmntqGJR2nUsEq7yj,72602160,366043436,-293441276,624
2022-04-18 01:05:36-04:00,15693,HKrsoo3kUwwYou6vQAjrCccyWvTFm2Wy14hwBxofoV1p,6k2SbUiTFKi8EhZWSbNffGqofwBvr4y2HZsLkGgfq2iX,True,1547740374,386935093,2414308,1207154,1207154,68sueyVfmy5ToEGtLFGDkwebX47xAmzyXE29z8JrmcWv,96572346,204766434,-108194088,623
2022-04-18 01:05:39-04:00,15694,B6Wc3euMqUf6QjzCqDtNeAEUM7MvADFaiReEq9VYH2Qg,2pzhsqXYd5u7h4xTN8bMS3GbicVnJ6KY3MQn7spSXroA,True,176520260,22625354,141189,70594,70595,3zqXX6kzhkbW3d4TwD2CNjMRwxTbREXySekvq37kfCNk,11015406,37926635,-26911229,624
2022-04-18 01:05:46-04:00,15695,An9PgoB3s9T3TVC9vipP27wsPR9aZx8xPn7R6AbXojDa,2aoxARd4dXzvZ1uQpm8oETBLUF3JqzVU3Ek9LDH6ckWv,True,36841829093,2043867659,13053517,6526758,6526759,3zqXX6kzhkbW3d4TwD2CNjMRwxTbREXySekvq37kfCNk,2352967740,5567346580,-3214378840,638
2022-04-18 01:05:48-04:00,15696,4YQV4JNDYDQKxPkJKCcn63UPitwRN57wYd7cBLEubwoR,DKyKdHGTcCBWwgq1hyPchGGBY4GuSQsCs8sUNMgLriAU,True,1125578550,281394637,1755468,877734,877734,3zqXX6kzhkbW3d4TwD2CNjMRwxTbREXySekvq37kfCNk,70218730,283823740,-213605010,623
2022-04-18 01:05:54-04:00,15697,68zbVKnneMQqngbNkeLtPEP2ayNhawc1B2hPgqAEqgXK,HqiFpLr4NC7xJz9bEFusq8bCKaoxAQG1xsLxdUAzg8aa,True,1140067585,79057687,494014,247007,247007,gjBMZYVujDjD1ECG4i97M8Q3gV9ESnwwTSUGropkusj,71240454,376875122,-305634668,624
2022-04-18 01:06:18-04:00,15698,HHp8dRc1YMWE93uyLdM98DkUhM8U8zm3JC59chrbbWrk,AdqFuGe28VeAwwjRPZCBGVy5ftf9zNNQkg413i66wyig,True,89309940,22327485,139275,69637,69638,gjBMZYVujDjD1ECG4i97M8Q3gV9ESnwwTSUGropkusj,5571021,24488473,-18917452,623
2022-04-18 01:08:16-04:00,15699,2i5g7q4gD1GEfSz8BkhKn1idQ5U7cFPbMDWugjr7bBQW,Dpx6K9G5uZD63rTzBafZ56WKd1X9M25Mzfppd7Jib4xn,True,166393626,41598406,259196,129598,129598,gjBMZYVujDjD1ECG4i97M8Q3gV9ESnwwTSUGropkusj,10367843,82515526,-72147683,623
2022-04-18 03:49:07-04:00,15700,9RtNbEZ4ZR8T1HFF4cujPVy2kejVBKFo3CPQi8psSa1q,7zwaGb71jKc9y2HKCKy5q2XV2YUphkyU1hkDaab1GBas,True,2176709656,544177414,3374424,1687212,1687212,3zqXX6kzhkbW3d4TwD2CNjMRwxTbREXySekvq37kfCNk,134976981,553892845,-418915864,620
2022-04-18 03:49:11-04:00,15701,6K1Xww22wVZuBwP6oYb3DPR5GvdxsQSiZ4WSmejQjyqf,8RoFHjv1TkGFqjKoSwzvyRNMoBP1ma1Hi2jy6FzD4i2g,True,45910281,9606410,59590,29795,29795,gjBMZYVujDjD1ECG4i97M8Q3gV9ESnwwTSUGropkusj,2847958,9975738,-7127780,620
2022-04-18 04:51:38-04:00,15702,bYUscp4qgQap7iDu5R8tyBz73dov4j3zDV2FgDUvSDx,E4d8ank6Ymezu4ubD2tU5B5fXuoh2E1RQkrdaLgMfuaT,True,181207753,45301938,280684,140342,140342,2py1FiYeL2f7J3HU36qiJz6TD6HCmiTN36RyxYtapQCZ,11227380,59944142,-48716762,619
2022-04-18 04:52:08-04:00,15703,FV9CBGGTbppLnBKh79f2LzD1diTiS5g6u89FcpZHZmnK,Fe7mtmCUziFqbbYTvrhAcAq1Ub7YLfTJRtQ1hG7GzJD1,True,16865932,2111944,13183,6591,6592,A9TwRM1BMxqb8DCC7YNAMV6zPenEJm3HTZBy7wJKK58U,1052859,5968645,-4915786,624
2022-04-18 04:53:11-04:00,15704,impmg97osZac6q2B4SjAewuVYdMu4kPAg9totcz9h9Y,7ytd7QqMrXK3bVLPsgWSQSTgyAZnmPsPoD42k4Frkbz,True,200526409,38294569,238408,119204,119204,A2p75MbAbeUdHkPLkAjgGeiwuu9WPrkMHzjCkDXF1Xr3,12484080,18532291,-6048211,622
2022-04-18 04:53:22-04:00,15705,J6ndjmic8buVqwa4URRRgv2iTc4ekbYUHdcpa3DUCufN,7qvvczUw8ngwdQae49BiQwQmdV2SSWsAVV2tmZYL7gw6,True,13292564379,3323141094,20592045,10296022,10296023,3zqXX6kzhkbW3d4TwD2CNjMRwxTbREXySekvq37kfCNk,823681802,2385491570,-1561809768,619
2022-04-18 04:53:22-04:00,15706,7ueXVhSvXvttkeQ18w2cLh65naoEPvYF86RrdUK2Vc5Q,CKTehY1W6bw85cS4o7g2qXKjP4656Vwo37244BAEAiw1,True,1665649711,416409225,2549179,1274589,1274590,3zqXX6kzhkbW3d4TwD2CNjMRwxTbREXySekvq37kfCNk,101967995,390386362,-288418367,612
2022-04-18 04:53:23-04:00,15707,3662SX3YSARYupcxpgtTvUAPUsU7aJKsGxvpkNC1AV1A,HkAb86jdGHbz6VxrtbA81jPvjhiNHhbe82NBPFxnwzE5,True,62965774,15741443,95895,47947,47948,2a35JJeTUW1pm6M3e8DHCjp8qr4vbc2cRPhuzZWyFzYd,3835829,10832612,-6996783,609
2022-04-18 04:57:12-04:00,15708,BTq6T9nDzYTPTRvxkhNLn82DF3RCWdRkatZUmSTGCu43,3Uuhmxo4tWMbrqowx2bQSJeWzMykUUcZanj29ptCmEa6,True,994373663,128677302,804181,402090,402091,3zqXX6kzhkbW3d4TwD2CNjMRwxTbREXySekvq37kfCNk,62144404,305128980,-242984576,624
2022-04-18 04:59:28-04:00,15709,5zSrKR5jwRqcCCFh2CcqH4DPE5ka56dmBqjndjuTLzLb,DjoKm6riRduDv4jUuQ2vPRZgJo7oyrhKqBBu9ypxvZhh,True,51596351,7179523,44859,22429,22430,A2p75MbAbeUdHkPLkAjgGeiwuu9WPrkMHzjCkDXF1Xr3,3223891,22858680,-19634789,624
2022-04-18 05:02:02-04:00,15710,9U25LWBU67c9S6L9F4qmjpTkaHqjFgxyuTCqQ7Zqj62g,ESyDCGZWamnabH3NNvus52X6Z9YAmt3y8oB8zYLmhfX3,True,1343426700,335856675,2098980,1049490,1049490,3zqXX6kzhkbW3d4TwD2CNjMRwxTbREXySekvq37kfCNk,83959231,271593023,-187633792,624
2022-04-18 05:02:03-04:00,15711,29JVska5UEG3axs63EmtHpPvkswNEqYpZ3PKMSfupiAG,DCftNBUsuogxyaJe9G9m3eWipH6o3qo4Rn4TuQXdVaBF,True,138731123,34682780,216740,108370,108370,2a35JJeTUW1pm6M3e8DHCjp8qr4vbc2cRPhuzZWyFzYd,8669613,20876414,-12206801,624
2022-04-18 05:02:12-04:00,15712,68zbVKnneMQqngbNkeLtPEP2ayNhawc1B2hPgqAEqgXK,HqiFpLr4NC7xJz9bEFusq8bCKaoxAQG1xsLxdUAzg8aa,True,1056480351,68877027,430479,215239,215240,68sueyVfmy5ToEGtLFGDkwebX47xAmzyXE29z8JrmcWv,66029771,347898354,-281868583,624
2022-04-18 05:02:59-04:00,15713,8gxJEB4eSp5R8Z4Vy8TChcbLWPG93cVhpGLYWPuo4UMz,5dykor5kUojjBccSkbKqsHJ61voZWnD2MDuSNvsF6ohA,True,197132530,49283132,306440,153220,153220,2py1FiYeL2f7J3HU36qiJz6TD6HCmiTN36RyxYtapQCZ,12257600,56703571,-44445971,621
2022-04-18 05:03:05-04:00,15714,Cf6VsvBxhycnYD2QfnHqca6QeJRs7gzSkYEbfmarRNkZ,2ahUgNCtaCLoujC6ChNY3t1ffConqjCBcK9Ri17S8Pvf,True,6969724518,721623984,4486429,2243214,2243215,2a35JJeTUW1pm6M3e8DHCjp8qr4vbc2cRPhuzZWyFzYd,433316767,1408812603,-975495836,621
2022-04-18 05:03:06-04:00,15715,1EH82ta3wXUyUwW8VWQnVzSG3r1rHcSj2DvDeTKmp3F,B6aMfucYPbCzWBtauLtgTpwR45wKSK8yqscHJR3F5usu,True,88973498,22243374,135718,67859,67859,6UQfSsLooL4pQKQfLtXCutQS2BnF7A7F7ewJopDLmUpc,5428747,24509813,-19081066,610
2022-04-18 05:03:06-04:00,15716,J8khFNhJg25xVY7yjEtETTQVVzKHqdVCs1Rh2pJKvJqU,4eUP2YxTapjr6TLrd57XxZan7KJG5AtHK8yPRNVEbavx,True,41070427,10267606,62260,31130,31130,68sueyVfmy5ToEGtLFGDkwebX47xAmzyXE29z8JrmcWv,2490426,11746208,-9255782,606
2022-04-18 05:03:07-04:00,15717,An9PgoB3s9T3TVC9vipP27wsPR9aZx8xPn7R6AbXojDa,2aoxARd4dXzvZ1uQpm8oETBLUF3JqzVU3Ek9LDH6ckWv,True,34679809559,1965774539,12573373,6286686,6286687,3zqXX6kzhkbW3d4TwD2CNjMRwxTbREXySekvq37kfCNk,2218170029,5450445318,-3232275289,639
2022-04-18 05:03:09-04:00,15718,FV9CBGGTbppLnBKh79f2LzD1diTiS5g6u89FcpZHZmnK,Fe7mtmCUziFqbbYTvrhAcAq1Ub7YLfTJRtQ1hG7GzJD1,False,14630211,14630211,914284,45714,868570,6UQfSsLooL4pQKQfLtXCutQS2BnF7A7F7ewJopDLmUpc,914285,5322741,-4408456,624
2022-04-18 05:03:10-04:00,15719,DVMLxFACqaNBD7q1TGJUUApJX7etJsxQRRFBP2DfBazJ,4hnRjD7S2KxD7UrgfrApntVxUD7Srh5E9nwPY53v89kz,True,58608552,8375747,51532,25766,25766,A2p75MbAbeUdHkPLkAjgGeiwuu9WPrkMHzjCkDXF1Xr3,3605976,20640825,-17034849,615
2022-04-18 05:03:18-04:00,15720,D8BtQirMEk3W9Pq29B6KkKWrwPfmsUNpwz5npx7aGMLY,J7LMZwaSoh5hbGcwee6oPsnN4ZFD7Zp3LQWkJGNUHRfJ,True,370319332,92579833,571363,285681,285682,68sueyVfmy5ToEGtLFGDkwebX47xAmzyXE29z8JrmcWv,22854525,45295442,-22440917,617
2022-04-18 05:03:57-04:00,15721,AX2VRZoWZDfZT4QdwuXUSyRCx4N6B9eHAR75FSmcrVFG,FBgLGmbouri9wCV92UXZaDjwK6fcpjhDDD5NLVWmuRRK,True,735695602,183923900,1148862,574431,574431,68sueyVfmy5ToEGtLFGDkwebX47xAmzyXE29z8JrmcWv,45954511,316196267,-270241756,624
2022-04-18 13:09:39-04:00,15722,31tyt6M4RuSjM1pZ9tXbPSdVDNr7q4CU66tHD5soPHkT,G9n4eXhx2Lh7b8FGauiAXBd3PgbH7PAVHYREkXjVXBns,True,4349660841,1087415210,6792292,3396146,3396146,2py1FiYeL2f7J3HU36qiJz6TD6HCmiTN36RyxYtapQCZ,271691698,416437496,-144745798,624
2022-04-18 13:11:53-04:00,15723,CLP8qmL8aN9ocJKYnbKSo4k46CU3LBsebspfREQcSGvo,F6tkkFJnvjYyPdSXDNzZMUfhd1o8dFiLyLPRZ5U1sXHE,True,877187158,219296789,1295598,647799,647799,A2p75MbAbeUdHkPLkAjgGeiwuu9WPrkMHzjCkDXF1Xr3,51823945,84377938,-32553993,590
2022-04-18 14:17:38-04:00,15724,6qMy28LbRwYuifvAQpy5zhBq3DQG2K7cYY7zXohQXR3q,6PELaxBDik7RSNX13Lm2TvLvuxxgK2ktC6BStT7MCDvw,True,493286918,123321729,770541,385270,385271,A2p75MbAbeUdHkPLkAjgGeiwuu9WPrkMHzjCkDXF1Xr3,30821659,47238345,-16416686,624
2022-04-18 14:48:29-04:00,15725,CLP8qmL8aN9ocJKYnbKSo4k46CU3LBsebspfREQcSGvo,F6tkkFJnvjYyPdSXDNzZMUfhd1o8dFiLyLPRZ5U1sXHE,True,666727891,166681972,1041544,520772,520772,A2p75MbAbeUdHkPLkAjgGeiwuu9WPrkMHzjCkDXF1Xr3,41661792,74919824,-33258032,624
2022-04-18 16:40:10-04:00,15726,CLP8qmL8aN9ocJKYnbKSo4k46CU3LBsebspfREQcSGvo,F6tkkFJnvjYyPdSXDNzZMUfhd1o8dFiLyLPRZ5U1sXHE,True,508968628,127242157,790234,395117,395117,A2p75MbAbeUdHkPLkAjgGeiwuu9WPrkMHzjCkDXF1Xr3,31609386,65478459,-33869073,621
2022-04-18 19:45:24-04:00,15727,G3ZEAY19iDMjF7P57dgFUZiC4bpeFvMPKShenugL7E2Y,D6nUGgpWkQUZcUKZYawfedX67uqQ9Co1wEwtbHPMtc7X,True,78115891,19528972,120126,60063,60063,DQCvC9mR68hJ3tJsUiddh6JwcBJAmntqGJR2nUsEq7yj,4805072,11194527,-6389455,615
2022-04-18 19:45:26-04:00,15728,CLP8qmL8aN9ocJKYnbKSo4k46CU3LBsebspfREQcSGvo,F6tkkFJnvjYyPdSXDNzZMUfhd1o8dFiLyLPRZ5U1sXHE,True,388441292,97110323,600819,300409,300410,3zqXX6kzhkbW3d4TwD2CNjMRwxTbREXySekvq37kfCNk,24032761,56150998,-32118237,618
2022-04-18 20:13:51-04:00,15729,6qMy28LbRwYuifvAQpy5zhBq3DQG2K7cYY7zXohQXR3q,6PELaxBDik7RSNX13Lm2TvLvuxxgK2ktC6BStT7MCDvw,True,376554265,94138566,586648,293324,293324,2a35JJeTUW1pm6M3e8DHCjp8qr4vbc2cRPhuzZWyFzYd,23465923,42369558,-18903635,623
2022-04-18 20:47:55-04:00,15730,GLGQxmrYNDs5o8ntzpokP5RXDBSsrVGDebF2jHiCSP1B,gbTdqfL8xU1HK4b9qCm2CPKjSsWSkW8ErRCAtdWTbpq,False,1434413,1434413,88192,4409,83783,68sueyVfmy5ToEGtLFGDkwebX47xAmzyXE29z8JrmcWv,88192,171711,-83519,614
2022-04-19 09:51:02-04:00,15731,CLP8qmL8aN9ocJKYnbKSo4k46CU3LBsebspfREQcSGvo,F6tkkFJnvjYyPdSXDNzZMUfhd1o8dFiLyLPRZ5U1sXHE,True,304524082,76131020,475373,237686,237687,DQCvC9mR68hJ3tJsUiddh6JwcBJAmntqGJR2nUsEq7yj,19014953,47284809,-28269856,624
2022-04-19 09:51:05-04:00,15732,2Tm69hQroe4dREXCLHubHfDTkDPohvcMEFuALmCpNZw6,4FH8oJspDa4TPVVXgzJzVM1eTHdnNvSf59C1A8m2PXoc,True,2437599521,211501683,1316859,658429,658430,A2p75MbAbeUdHkPLkAjgGeiwuu9WPrkMHzjCkDXF1Xr3,151770774,173355979,-21585205,622
2022-04-19 09:51:06-04:00,15733,G3ZEAY19iDMjF7P57dgFUZiC4bpeFvMPKShenugL7E2Y,D6nUGgpWkQUZcUKZYawfedX67uqQ9Co1wEwtbHPMtc7X,True,59539371,14884842,92181,46090,46091,gjBMZYVujDjD1ECG4i97M8Q3gV9ESnwwTSUGropkusj,3687253,9431833,-5744580,619
2022-04-19 09:55:43-04:00,15734,2Tm69hQroe4dREXCLHubHfDTkDPohvcMEFuALmCpNZw6,4FH8oJspDa4TPVVXgzJzVM1eTHdnNvSf59C1A8m2PXoc,True,2236784605,187488316,1171534,585767,585767,68sueyVfmy5ToEGtLFGDkwebX47xAmzyXE29z8JrmcWv,139767148,176777603,-37010455,624
2022-04-19 10:00:57-04:00,15735,DxmkdZiygge1YAwbL8U6LudY3QJkSnZMHThQXkE4Z5qy,Gi8oNcSDphbtosjFudeEPtX88bUnYid1tL9FnXnLfASU,True,289638880,72409720,444403,222201,222202,68sueyVfmy5ToEGtLFGDkwebX47xAmzyXE29z8JrmcWv,17776120,35911321,-18135201,613
2022-04-19 10:03:12-04:00,15736,2Tm69hQroe4dREXCLHubHfDTkDPohvcMEFuALmCpNZw6,4FH8oJspDa4TPVVXgzJzVM1eTHdnNvSf59C1A8m2PXoc,True,2059661171,161231678,1003415,501707,501708,A2p75MbAbeUdHkPLkAjgGeiwuu9WPrkMHzjCkDXF1Xr3,128181759,171662067,-43480308,622
2022-04-19 10:03:21-04:00,15737,HDJrLBSkMZ34BjJKrxYvSjhMP1z3dvZeuCAEqHFHqSn7,DXYU9k5x6T9wDCJyPn9KLLSpBgw4FFxe8zg9YsCmfLvp,True,789091256,197272814,1230227,615113,615114,2xTUy2RS74GJMMDnmFaegMzFLn19RVfYG4CibhBmjP1i,49209083,88497267,-39288184,623
2022-04-19 10:24:43-04:00,15738,EFzTG8kgbs1kExcFxcQrLSteeKD7jVqgQ2x3onCnhNuP,9wLCaZ7eVfs3u7Gp6HypL1Nz7hWgAcLcjbLtdyxf9gFU,True,19380238,4845059,34405,17202,17203,A9TwRM1BMxqb8DCC7YNAMV6zPenEJm3HTZBy7wJKK58U,1376226,3390252,-2014026,710
2022-04-19 10:39:21-04:00,15739,CLP8qmL8aN9ocJKYnbKSo4k46CU3LBsebspfREQcSGvo,F6tkkFJnvjYyPdSXDNzZMUfhd1o8dFiLyLPRZ5U1sXHE,True,232397844,58099461,362928,181464,181464,2a35JJeTUW1pm6M3e8DHCjp8qr4vbc2cRPhuzZWyFzYd,14517125,39724851,-25207726,624
2022-04-19 10:40:03-04:00,15740,G3ZEAY19iDMjF7P57dgFUZiC4bpeFvMPKShenugL7E2Y,D6nUGgpWkQUZcUKZYawfedX67uqQ9Co1wEwtbHPMtc7X,True,45449549,11362387,69915,34957,34958,A9TwRM1BMxqb8DCC7YNAMV6zPenEJm3HTZBy7wJKK58U,2796601,7900077,-5103476,615
2022-04-19 10:51:52-04:00,15741,2Tm69hQroe4dREXCLHubHfDTkDPohvcMEFuALmCpNZw6,4FH8oJspDa4TPVVXgzJzVM1eTHdnNvSf59C1A8m2PXoc,True,1906496700,142552145,890615,445307,445308,6UQfSsLooL4pQKQfLtXCutQS2BnF7A7F7ewJopDLmUpc,119111137,171604747,-52493610,624
2022-04-19 10:54:19-04:00,15742,EFzTG8kgbs1kExcFxcQrLSteeKD7jVqgQ2x3onCnhNuP,9wLCaZ7eVfs3u7Gp6HypL1Nz7hWgAcLcjbLtdyxf9gFU,True,14820558,3705139,26411,13205,13206,2xTUy2RS74GJMMDnmFaegMzFLn19RVfYG4CibhBmjP1i,1056442,2852371,-1795929,712
2022-04-19 10:57:41-04:00,15743,4T2MDxf43fxhNe8A2aF7G8hFFpPnkeWkMGPRiYVcBo9h,4cjUvZRpju4xAdS8b5CjxhVEk3o52KBGwjkH9hq23u8A,True,141363816,35340954,220803,110401,110402,2py1FiYeL2f7J3HU36qiJz6TD6HCmiTN36RyxYtapQCZ,8832133,15291436,-6459303,624
2022-04-19 11:11:36-04:00,15744,2Tm69hQroe4dREXCLHubHfDTkDPohvcMEFuALmCpNZw6,4FH8oJspDa4TPVVXgzJzVM1eTHdnNvSf59C1A8m2PXoc,True,1771782304,121039197,753733,376866,376867,2py1FiYeL2f7J3HU36qiJz6TD6HCmiTN36RyxYtapQCZ,110332190,165804808,-55472618,622
2022-04-19 11:14:04-04:00,15745,2Tm69hQroe4dREXCLHubHfDTkDPohvcMEFuALmCpNZw6,4FH8oJspDa4TPVVXgzJzVM1eTHdnNvSf59C1A8m2PXoc,True,1656783012,111597538,697414,348707,348707,A2p75MbAbeUdHkPLkAjgGeiwuu9WPrkMHzjCkDXF1Xr3,103538552,165643862,-62105310,624
2022-04-19 12:53:46-04:00,15746,EFzTG8kgbs1kExcFxcQrLSteeKD7jVqgQ2x3onCnhNuP,9wLCaZ7eVfs3u7Gp6HypL1Nz7hWgAcLcjbLtdyxf9gFU,False,11339246,11339246,806755,40337,766418,2a35JJeTUW1pm6M3e8DHCjp8qr4vbc2cRPhuzZWyFzYd,806755,2377546,-1570791,711
2022-04-19 12:55:18-04:00,15747,fAJK1wrBhSW297AtFWX2U4rUBf2gkzfQ6UrQL9yHEYW,5pyTFpanSyUCHxeMhJMKtpdrcMSAWc8bFadbyM7q4q4B,True,159973283,39993320,285475,142737,142738,2a35JJeTUW1pm6M3e8DHCjp8qr4vbc2cRPhuzZWyFzYd,11419017,16262920,-4843903,713
2022-04-19 17:51:50-04:00,15748,9jvmuV6rnbEeCjrJSXU67aMCTSFJ9MquiGLXjgTDmUQS,7PsemtRTQHnypsnUGZR67BiCbf1cw3h4V6i834qwrdna,True,1152252858,288063214,1778611,889305,889306,2a35JJeTUW1pm6M3e8DHCjp8qr4vbc2cRPhuzZWyFzYd,71144446,223479658,-152335212,617
2022-04-19 17:51:51-04:00,15749,CLP8qmL8aN9ocJKYnbKSo4k46CU3LBsebspfREQcSGvo,F6tkkFJnvjYyPdSXDNzZMUfhd1o8dFiLyLPRZ5U1sXHE,True,177389315,44347328,274418,137209,137209,2a35JJeTUW1pm6M3e8DHCjp8qr4vbc2cRPhuzZWyFzYd,10976725,32973765,-21997040,618
2022-04-19 17:51:56-04:00,15750,G3ZEAY19iDMjF7P57dgFUZiC4bpeFvMPKShenugL7E2Y,D6nUGgpWkQUZcUKZYawfedX67uqQ9Co1wEwtbHPMtc7X,True,34641248,8660312,53892,26946,26946,68sueyVfmy5ToEGtLFGDkwebX47xAmzyXE29z8JrmcWv,2155700,6537405,-4381705,622
2022-04-19 20:16:22-04:00,15751,DZHhvYM7HgnwRtgdbmio4pRA9r1jHdd1dWcxwycx6aGT,3u9E35HEg3go9H3PT5jVfriYXenpKF6ZQHeM3QexnPzU,True,3509755428,877438857,5381455,2690727,2690728,6UQfSsLooL4pQKQfLtXCutQS2BnF7A7F7ewJopDLmUpc,215258213,288972148,-73713935,613
2022-04-19 21:46:09-04:00,15752,Hya9U3Ao61oebVBPEnUiqinqvpzTguAZhbAWDmEQpm3a,FdYMMqoYPe5Jgj8R2ovKVUKxRPK1xppR59XRGPdvHRAx,True,278394512,57962626,397793,198896,198897,2a35JJeTUW1pm6M3e8DHCjp8qr4vbc2cRPhuzZWyFzYd,19106012,58941553,-39835541,686
2022-04-19 21:54:58-04:00,15753,Hya9U3Ao61oebVBPEnUiqinqvpzTguAZhbAWDmEQpm3a,FdYMMqoYPe5Jgj8R2ovKVUKxRPK1xppR59XRGPdvHRAx,True,223947472,44347506,300853,150426,150427,A9TwRM1BMxqb8DCC7YNAMV6zPenEJm3HTZBy7wJKK58U,15192633,50612668,-35420035,678
2022-04-19 22:00:31-04:00,15754,EAmvC16UQrM5xxmtpLHEABBkFtN88ZGB1qD9Si79HisJ,862ytUTXXPFDiUHUzi2AfrBXkTFaDdujP6pTu7xW4Fyh,True,618708182,148365759,990554,495277,495277,2xTUy2RS74GJMMDnmFaegMzFLn19RVfYG4CibhBmjP1i,41307643,139052772,-97745129,667
2022-04-19 22:01:04-04:00,15755,Hya9U3Ao61oebVBPEnUiqinqvpzTguAZhbAWDmEQpm3a,FdYMMqoYPe5Jgj8R2ovKVUKxRPK1xppR59XRGPdvHRAx,True,182256603,33908175,227686,113843,113843,A2p75MbAbeUdHkPLkAjgGeiwuu9WPrkMHzjCkDXF1Xr3,12238171,43489200,-31251029,671
2022-04-19 22:15:20-04:00,15756,EAmvC16UQrM5xxmtpLHEABBkFtN88ZGB1qD9Si79HisJ,862ytUTXXPFDiUHUzi2AfrBXkTFaDdujP6pTu7xW4Fyh,True,477351441,113030492,788682,394341,394341,3zqXX6kzhkbW3d4TwD2CNjMRwxTbREXySekvq37kfCNk,33307722,114691989,-81384267,697
2022-04-19 22:17:55-04:00,15757,Hya9U3Ao61oebVBPEnUiqinqvpzTguAZhbAWDmEQpm3a,FdYMMqoYPe5Jgj8R2ovKVUKxRPK1xppR59XRGPdvHRAx,True,150393466,25940036,171825,85912,85913,DQCvC9mR68hJ3tJsUiddh6JwcBJAmntqGJR2nUsEq7yj,9962004,37490277,-27528273,662
2022-04-19 22:25:37-04:00,15758,EAmvC16UQrM5xxmtpLHEABBkFtN88ZGB1qD9Si79HisJ,862ytUTXXPFDiUHUzi2AfrBXkTFaDdujP6pTu7xW4Fyh,True,370633309,86348912,610554,305277,305277,2a35JJeTUW1pm6M3e8DHCjp8qr4vbc2cRPhuzZWyFzYd,26206680,94608464,-68401784,707
2022-04-19 22:26:19-04:00,15759,Hya9U3Ao61oebVBPEnUiqinqvpzTguAZhbAWDmEQpm3a,FdYMMqoYPe5Jgj8R2ovKVUKxRPK1xppR59XRGPdvHRAx,True,126021700,19870050,129635,64817,64818,2xTUy2RS74GJMMDnmFaegMzFLn19RVfYG4CibhBmjP1i,8221909,32483125,-24261216,652
2022-04-19 22:29:36-04:00,15760,EAmvC16UQrM5xxmtpLHEABBkFtN88ZGB1qD9Si79HisJ,862ytUTXXPFDiUHUzi2AfrBXkTFaDdujP6pTu7xW4Fyh,True,289452616,66053739,466168,233084,233084,DQCvC9mR68hJ3tJsUiddh6JwcBJAmntqGJR2nUsEq7yj,20427907,77944363,-57516456,705
2022-04-19 22:44:19-04:00,15761,Hya9U3Ao61oebVBPEnUiqinqvpzTguAZhbAWDmEQpm3a,FdYMMqoYPe5Jgj8R2ovKVUKxRPK1xppR59XRGPdvHRAx,True,107346397,15214234,97758,48879,48879,DQCvC9mR68hJ3tJsUiddh6JwcBJAmntqGJR2nUsEq7yj,6897527,28311645,-21414118,642
2022-04-19 22:47:54-04:00,15762,EAmvC16UQrM5xxmtpLHEABBkFtN88ZGB1qD9Si79HisJ,862ytUTXXPFDiUHUzi2AfrBXkTFaDdujP6pTu7xW4Fyh,True,227366055,50532098,355479,177739,177740,6UQfSsLooL4pQKQfLtXCutQS2BnF7A7F7ewJopDLmUpc,15994561,64142366,-48147805,703
2022-04-19 23:33:41-04:00,15763,Hya9U3Ao61oebVBPEnUiqinqvpzTguAZhbAWDmEQpm3a,FdYMMqoYPe5Jgj8R2ovKVUKxRPK1xppR59XRGPdvHRAx,True,93062004,11621041,73300,36650,36650,gjBMZYVujDjD1ECG4i97M8Q3gV9ESnwwTSUGropkusj,5869985,24870677,-19000692,630
2022-04-19 23:52:56-04:00,15764,EAmvC16UQrM5xxmtpLHEABBkFtN88ZGB1qD9Si79HisJ,862ytUTXXPFDiUHUzi2AfrBXkTFaDdujP6pTu7xW4Fyh,True,179871855,38661284,271042,135521,135521,6UQfSsLooL4pQKQfLtXCutQS2BnF7A7F7ewJopDLmUpc,12610294,52800279,-40189985,701
2022-04-19 23:53:14-04:00,15765,Hya9U3Ao61oebVBPEnUiqinqvpzTguAZhbAWDmEQpm3a,FdYMMqoYPe5Jgj8R2ovKVUKxRPK1xppR59XRGPdvHRAx,True,82179254,8899256,54777,27388,27389,A2p75MbAbeUdHkPLkAjgGeiwuu9WPrkMHzjCkDXF1Xr3,5058394,22079456,-17021062,615
2022-04-19 23:53:30-04:00,15766,EAmvC16UQrM5xxmtpLHEABBkFtN88ZGB1qD9Si79HisJ,862ytUTXXPFDiUHUzi2AfrBXkTFaDdujP6pTu7xW4Fyh,True,144105451,29719683,194776,97388,97388,2a35JJeTUW1pm6M3e8DHCjp8qr4vbc2cRPhuzZWyFzYd,9444372,43519072,-34074700,655
2022-04-19 23:53:38-04:00,15767,EAmvC16UQrM5xxmtpLHEABBkFtN88ZGB1qD9Si79HisJ,862ytUTXXPFDiUHUzi2AfrBXkTFaDdujP6pTu7xW4Fyh,True,115657023,22606639,155946,77973,77973,2py1FiYeL2f7J3HU36qiJz6TD6HCmiTN36RyxYtapQCZ,7978341,35842292,-27863951,689
2022-04-19 23:53:38-04:00,15768,Hya9U3Ao61oebVBPEnUiqinqvpzTguAZhbAWDmEQpm3a,FdYMMqoYPe5Jgj8R2ovKVUKxRPK1xppR59XRGPdvHRAx,True,74039421,8949355,51300,25650,25650,A2p75MbAbeUdHkPLkAjgGeiwuu9WPrkMHzjCkDXF1Xr3,4244194,19802702,-15558508,573
2022-04-19 23:54:12-04:00,15769,Hya9U3Ao61oebVBPEnUiqinqvpzTguAZhbAWDmEQpm3a,FdYMMqoYPe5Jgj8R2ovKVUKxRPK1xppR59XRGPdvHRAx,True,65556309,6980107,39679,19839,19840,2py1FiYeL2f7J3HU36qiJz6TD6HCmiTN36RyxYtapQCZ,3726651,18302042,-14575391,568
2022-04-19 23:54:16-04:00,15770,EAmvC16UQrM5xxmtpLHEABBkFtN88ZGB1qD9Si79HisJ,862ytUTXXPFDiUHUzi2AfrBXkTFaDdujP6pTu7xW4Fyh,True,94380387,17286223,118910,59455,59455,2a35JJeTUW1pm6M3e8DHCjp8qr4vbc2cRPhuzZWyFzYd,6492392,29757588,-23265196,687
2022-04-20 04:18:19-04:00,15771,Hya9U3Ao61oebVBPEnUiqinqvpzTguAZhbAWDmEQpm3a,FdYMMqoYPe5Jgj8R2ovKVUKxRPK1xppR59XRGPdvHRAx,True,58753342,6766962,40354,20177,20177,2xTUy2RS74GJMMDnmFaegMzFLn19RVfYG4CibhBmjP1i,3503771,16284121,-12780350,596
2022-04-20 05:45:03-04:00,15772,Hya9U3Ao61oebVBPEnUiqinqvpzTguAZhbAWDmEQpm3a,FdYMMqoYPe5Jgj8R2ovKVUKxRPK1xppR59XRGPdvHRAx,True,52342643,5267814,31262,15631,15631,2xTUy2RS74GJMMDnmFaegMzFLn19RVfYG4CibhBmjP1i,3106341,15100985,-11994644,593
2022-04-20 06:06:05-04:00,15773,EAmvC16UQrM5xxmtpLHEABBkFtN88ZGB1qD9Si79HisJ,862ytUTXXPFDiUHUzi2AfrBXkTFaDdujP6pTu7xW4Fyh,True,78124489,13186261,90259,45129,45130,2py1FiYeL2f7J3HU36qiJz6TD6HCmiTN36RyxYtapQCZ,5347600,24865095,-19517495,684
2022-04-20 06:19:07-04:00,15774,Hya9U3Ao61oebVBPEnUiqinqvpzTguAZhbAWDmEQpm3a,FdYMMqoYPe5Jgj8R2ovKVUKxRPK1xppR59XRGPdvHRAx,True,47419306,5099607,29354,14677,14677,2a35JJeTUW1pm6M3e8DHCjp8qr4vbc2cRPhuzZWyFzYd,2729553,13556785,-10827232,575
2022-04-20 06:22:02-04:00,15775,EAmvC16UQrM5xxmtpLHEABBkFtN88ZGB1qD9Si79HisJ,862ytUTXXPFDiUHUzi2AfrBXkTFaDdujP6pTu7xW4Fyh,True,65755998,10098699,68182,34091,34091,68sueyVfmy5ToEGtLFGDkwebX47xAmzyXE29z8JrmcWv,4439571,20969601,-16530030,675
2022-04-20 06:27:27-04:00,15776,CVjkHr29t8pzeXU1U1CdMpT6qwf9Jw4XGxvxU7RURPYj,D66Zpxp7q4Tn4KiLa2pHTrADhgtP8tGqNXVPyCo9mcxc,True,243756260,60939065,380502,190251,190251,A9TwRM1BMxqb8DCC7YNAMV6zPenEJm3HTZBy7wJKK58U,15220083,33615232,-18395149,624
2022-04-20 06:29:54-04:00,15777,Hya9U3Ao61oebVBPEnUiqinqvpzTguAZhbAWDmEQpm3a,FdYMMqoYPe5Jgj8R2ovKVUKxRPK1xppR59XRGPdvHRAx,True,42597388,4045097,23004,11502,11502,gjBMZYVujDjD1ECG4i97M8Q3gV9ESnwwTSUGropkusj,2422510,12646567,-10224057,568
2022-04-20 06:29:58-04:00,15778,G3ZEAY19iDMjF7P57dgFUZiC4bpeFvMPKShenugL7E2Y,D6nUGgpWkQUZcUKZYawfedX67uqQ9Co1wEwtbHPMtc7X,True,26426212,6606553,40798,20399,20399,6UQfSsLooL4pQKQfLtXCutQS2BnF7A7F7ewJopDLmUpc,1631939,5363500,-3731561,617
2022-04-20 06:29:58-04:00,15779,CLP8qmL8aN9ocJKYnbKSo4k46CU3LBsebspfREQcSGvo,F6tkkFJnvjYyPdSXDNzZMUfhd1o8dFiLyLPRZ5U1sXHE,True,135322280,33830570,207401,103700,103701,2a35JJeTUW1pm6M3e8DHCjp8qr4vbc2cRPhuzZWyFzYd,8296078,27074328,-18778250,613
2022-04-20 06:29:58-04:00,15780,9jvmuV6rnbEeCjrJSXU67aMCTSFJ9MquiGLXjgTDmUQS,7PsemtRTQHnypsnUGZR67BiCbf1cw3h4V6i834qwrdna,True,879006453,219751613,1343275,671637,671638,gjBMZYVujDjD1ECG4i97M8Q3gV9ESnwwTSUGropkusj,53731010,182806660,-129075650,611
2022-04-20 06:48:14-04:00,15781,Hya9U3Ao61oebVBPEnUiqinqvpzTguAZhbAWDmEQpm3a,FdYMMqoYPe5Jgj8R2ovKVUKxRPK1xppR59XRGPdvHRAx,True,38776009,3879037,21765,10882,10883,A9TwRM1BMxqb8DCC7YNAMV6zPenEJm3HTZBy7wJKK58U,2175788,11395398,-9219610,561
2022-04-20 07:39:38-04:00,15782,2Tm69hQroe4dREXCLHubHfDTkDPohvcMEFuALmCpNZw6,4FH8oJspDa4TPVVXgzJzVM1eTHdnNvSf59C1A8m2PXoc,True,1561800999,110270223,603996,301998,301998,gjBMZYVujDjD1ECG4i97M8Q3gV9ESnwwTSUGropkusj,85546377,159681286,-74134909,547
2022-04-20 07:50:13-04:00,15783,DxmkdZiygge1YAwbL8U6LudY3QJkSnZMHThQXkE4Z5qy,Gi8oNcSDphbtosjFudeEPtX88bUnYid1tL9FnXnLfASU,True,221220225,55305056,332942,166471,166471,68sueyVfmy5ToEGtLFGDkwebX47xAmzyXE29z8JrmcWv,13317693,30912550,-17594857,602
2022-04-20 07:53:41-04:00,15784,DnG3qNVMm7BR6KnSVAgozQ9CtKi1qVgtBxPZNUx2SrZK,4GHmhDdBdJgrVmM3T2A8tsQVhzoRTfUBf1kvkbwh8TGR,False,3198674,3198674,199424,9971,189453,6UQfSsLooL4pQKQfLtXCutQS2BnF7A7F7ewJopDLmUpc,199426,0,199426,623
2022-04-20 08:00:58-04:00,15785,2Tm69hQroe4dREXCLHubHfDTkDPohvcMEFuALmCpNZw6,4FH8oJspDa4TPVVXgzJzVM1eTHdnNvSf59C1A8m2PXoc,True,1457568014,103568534,560611,280305,280306,gjBMZYVujDjD1ECG4i97M8Q3gV9ESnwwTSUGropkusj,78897463,152068566,-73171103,541
2022-04-20 11:20:03-04:00,15786,fAJK1wrBhSW297AtFWX2U4rUBf2gkzfQ6UrQL9yHEYW,5pyTFpanSyUCHxeMhJMKtpdrcMSAWc8bFadbyM7q4q4B,True,162530169,40632542,122168,61084,61084,2py1FiYeL2f7J3HU36qiJz6TD6HCmiTN36RyxYtapQCZ,4886731,9543183,-4656452,300
2022-04-20 11:20:28-04:00,15787,D22p65XepEPmSMKUHSbwjtAakcyVWs1KNFDsRzR8BzQM,Em19t6VrnfvQ86q5AU5MWWa6eCYwysKZyBcpJsmQYr4Z,True,5755312323,1438828080,8948938,4474469,4474469,2a35JJeTUW1pm6M3e8DHCjp8qr4vbc2cRPhuzZWyFzYd,357957559,595769381,-237811822,621
2022-04-20 11:20:29-04:00,15788,D85pWm1LS9MvtR4f3QhkFLvNUhZLQ2NZBFQTyAVnmigm,CRN85DYkJJi6irhtVAf4qcJU3ijVodWdXgWe7Fs6Ahka,True,36701176,9175294,56582,28291,28291,68sueyVfmy5ToEGtLFGDkwebX47xAmzyXE29z8JrmcWv,2263315,4574585,-2311270,616
2022-04-20 14:41:35-04:00,15789,D5VZNThkv6XD6bimPshD2J3PvbPXgCbivZuPfkVxgdjc,8C77LmMk4C3KvyEb1N3scdbAgwN7J45nAcv9tkL5namB,True,30412285691,7603071422,47239529,23619764,23619765,2xTUy2RS74GJMMDnmFaegMzFLn19RVfYG4CibhBmjP1i,1889581186,3140171114,-1250589928,621
2022-04-20 19:06:04-04:00,15790,EukjfStiY4851KKYdtN9Mc1Rvzgkpuj1zs7yvAnUYYMY,AwkyGsqXanwHRd4xwBn4Xt1daygwKgCkzso9s6FMF1Qg,True,168394320,42098580,295475,147737,147738,68sueyVfmy5ToEGtLFGDkwebX47xAmzyXE29z8JrmcWv,11819021,60204248,-48385227,701
2022-04-20 21:03:55-04:00,15791,93AGRvU9jLpCXC9sLZbbzUWE5CAxqyrmDC5uErSVbBfP,F6pPSqZa7UFyrwWQNtkriEjZoCaqogqpKsUg4xPVxAsU,True,442988751,110747187,770823,385411,385412,68sueyVfmy5ToEGtLFGDkwebX47xAmzyXE29z8JrmcWv,30832943,41632898,-10799955,696
2022-04-20 23:03:58-04:00,15792,SEndYVMCKAeZUKSqGrMUSqXFmxtA9M1t4eXsUhVsTBF,3fcQQcbkpqodakamn82pFnMxBEPL2Drsg4jJNZ6dx72M,True,1907580061,443848641,3105448,1552724,1552724,3zqXX6kzhkbW3d4TwD2CNjMRwxTbREXySekvq37kfCNk,133466508,132048299,1418209,699
2022-04-21 01:39:56-04:00,15793,SEndYVMCKAeZUKSqGrMUSqXFmxtA9M1t4eXsUhVsTBF,3fcQQcbkpqodakamn82pFnMxBEPL2Drsg4jJNZ6dx72M,True,1525298793,348217558,2247990,1123995,1123995,68sueyVfmy5ToEGtLFGDkwebX47xAmzyXE29z8JrmcWv,98468854,126599605,-28130751,645
2022-04-21 01:44:53-04:00,15794,F4hN7ecndZ8Gr5KQNSFaSrMGawMasz7jfWTLTMpk7gaB,AJ23FpXSGjipcqywk88WGsKfqfiiUjPzZLsvLtBAhB12,True,1335972216,269635204,1877823,938911,938912,gjBMZYVujDjD1ECG4i97M8Q3gV9ESnwwTSUGropkusj,93041272,107069121,-14027849,696
2022-04-21 01:51:37-04:00,15795,SEndYVMCKAeZUKSqGrMUSqXFmxtA9M1t4eXsUhVsTBF,3fcQQcbkpqodakamn82pFnMxBEPL2Drsg4jJNZ6dx72M,True,1159352027,256883661,1766264,883132,883132,6UQfSsLooL4pQKQfLtXCutQS2BnF7A7F7ewJopDLmUpc,79714016,114624209,-34910193,687
2022-04-21 01:52:10-04:00,15796,D22p65XepEPmSMKUHSbwjtAakcyVWs1KNFDsRzR8BzQM,Em19t6VrnfvQ86q5AU5MWWa6eCYwysKZyBcpJsmQYr4Z,True,4231525679,1057881419,6603544,3301772,3301772,2a35JJeTUW1pm6M3e8DHCjp8qr4vbc2cRPhuzZWyFzYd,264141760,528449282,-264307522,624
2022-04-21 01:52:11-04:00,15797,D85pWm1LS9MvtR4f3QhkFLvNUhZLQ2NZBFQTyAVnmigm,CRN85DYkJJi6irhtVAf4qcJU3ijVodWdXgWe7Fs6Ahka,True,26974612,6743653,41401,20700,20701,2a35JJeTUW1pm6M3e8DHCjp8qr4vbc2cRPhuzZWyFzYd,1656048,3940812,-2284764,613
2022-04-21 01:52:11-04:00,15798,EmLMKbiiBsVpffybGuPUVFRcb5C5KxsZ5H4JSvkgHouL,895uV1W4TG8QdvJKDhPHAzG22gGoGcwpEgQrM5SjMEeQ,True,4128781137,1032195284,6260692,3130346,3130346,3zqXX6kzhkbW3d4TwD2CNjMRwxTbREXySekvq37kfCNk,250427685,556729552,-306301867,606
2022-04-21 02:40:32-04:00,15799,F4hN7ecndZ8Gr5KQNSFaSrMGawMasz7jfWTLTMpk7gaB,AJ23FpXSGjipcqywk88WGsKfqfiiUjPzZLsvLtBAhB12,True,1047627149,197395704,1365908,682954,682954,2xTUy2RS74GJMMDnmFaegMzFLn19RVfYG4CibhBmjP1i,72492131,104456023,-31963892,691
2022-04-21 06:40:02-04:00,15800,3P62tbTXyD1AMCzcLNoWLfKEddcswp31xEMjkbyqpqMw,4qKzZB6d4tZJSMeCggaep614HUBZJnx6hSSDFtiAHUGG,True,101781668,25445417,76775,38387,38388,A9TwRM1BMxqb8DCC7YNAMV6zPenEJm3HTZBy7wJKK58U,3071032,4900582,-1829550,301
2022-04-21 07:04:47-04:00,15801,CLP8qmL8aN9ocJKYnbKSo4k46CU3LBsebspfREQcSGvo,F6tkkFJnvjYyPdSXDNzZMUfhd1o8dFiLyLPRZ5U1sXHE,True,111188546,27797136,173731,86865,86866,2a35JJeTUW1pm6M3e8DHCjp8qr4vbc2cRPhuzZWyFzYd,6949247,22096876,-15147629,624
2022-04-21 07:11:22-04:00,15802,CVjkHr29t8pzeXU1U1CdMpT6qwf9Jw4XGxvxU7RURPYj,D66Zpxp7q4Tn4KiLa2pHTrADhgtP8tGqNXVPyCo9mcxc,True,185934736,46483684,290069,145034,145035,A2p75MbAbeUdHkPLkAjgGeiwuu9WPrkMHzjCkDXF1Xr3,11602794,28517049,-16914255,624
2022-04-21 08:43:40-04:00,15803,9jvmuV6rnbEeCjrJSXU67aMCTSFJ9MquiGLXjgTDmUQS,7PsemtRTQHnypsnUGZR67BiCbf1cw3h4V6i834qwrdna,True,669365163,167341290,1044850,522425,522425,A2p75MbAbeUdHkPLkAjgGeiwuu9WPrkMHzjCkDXF1Xr3,41794018,148715294,-106921276,624
2022-04-21 08:43:53-04:00,15804,G3ZEAY19iDMjF7P57dgFUZiC4bpeFvMPKShenugL7E2Y,D6nUGgpWkQUZcUKZYawfedX67uqQ9Co1wEwtbHPMtc7X,True,20156892,5039223,30984,15492,15492,A2p75MbAbeUdHkPLkAjgGeiwuu9WPrkMHzjCkDXF1Xr3,1239375,4375282,-3135907,614
2022-04-21 08:46:41-04:00,15805,3P62tbTXyD1AMCzcLNoWLfKEddcswp31xEMjkbyqpqMw,4qKzZB6d4tZJSMeCggaep614HUBZJnx6hSSDFtiAHUGG,True,77004164,19251041,58162,29081,29081,A9TwRM1BMxqb8DCC7YNAMV6zPenEJm3HTZBy7wJKK58U,2326484,4366634,-2040150,302
2022-04-21 09:35:19-04:00,15806,2Tm69hQroe4dREXCLHubHfDTkDPohvcMEFuALmCpNZw6,4FH8oJspDa4TPVVXgzJzVM1eTHdnNvSf59C1A8m2PXoc,True,1359285188,85876518,460143,230071,230072,gjBMZYVujDjD1ECG4i97M8Q3gV9ESnwwTSUGropkusj,72833254,144893954,-72060700,535
2022-04-21 11:00:53-04:00,15807,CLP8qmL8aN9ocJKYnbKSo4k46CU3LBsebspfREQcSGvo,F6tkkFJnvjYyPdSXDNzZMUfhd1o8dFiLyLPRZ5U1sXHE,True,84876040,21219010,131522,65761,65761,gjBMZYVujDjD1ECG4i97M8Q3gV9ESnwwTSUGropkusj,5260915,18106335,-12845420,619
2022-04-21 16:11:49-04:00,15808,5yPGvUz6JWKjkViGwTCpygJii1rP2xv5yx146ULtBiYq,FMnHUCQWTf1UHu5qVFqUAsWh8aba9EQYTEoiXy55totD,True,31840208,7960052,49577,24788,24789,6UQfSsLooL4pQKQfLtXCutQS2BnF7A7F7ewJopDLmUpc,1983113,4247010,-2263897,622
2022-04-21 16:32:46-04:00,15809,3CxwyEadyRMxq6XyjjVAK4TB3we6dcLZf3GVCQLSDEPM,Bp12mixLHgc3L6CvzqzsyV4GLMrmxGiydZE4buJwsHmr,True,155051434,32465575,115263,57631,57632,2xTUy2RS74GJMMDnmFaegMzFLn19RVfYG4CibhBmjP1i,5504862,15336712,-9831850,355
2022-04-21 16:32:47-04:00,15810,EmLMKbiiBsVpffybGuPUVFRcb5C5KxsZ5H4JSvkgHouL,895uV1W4TG8QdvJKDhPHAzG22gGoGcwpEgQrM5SjMEeQ,True,3042551410,760637852,4746081,2373040,2373041,3zqXX6kzhkbW3d4TwD2CNjMRwxTbREXySekvq37kfCNk,189843272,474135618,-284292346,623
2022-04-21 16:32:47-04:00,15811,D22p65XepEPmSMKUHSbwjtAakcyVWs1KNFDsRzR8BzQM,Em19t6VrnfvQ86q5AU5MWWa6eCYwysKZyBcpJsmQYr4Z,True,3110254450,777563612,4846313,2423156,2423157,6UQfSsLooL4pQKQfLtXCutQS2BnF7A7F7ewJopDLmUpc,193852525,456024609,-262172084,623
2022-04-21 16:32:47-04:00,15812,D85pWm1LS9MvtR4f3QhkFLvNUhZLQ2NZBFQTyAVnmigm,CRN85DYkJJi6irhtVAf4qcJU3ijVodWdXgWe7Fs6Ahka,True,19855751,4963937,30938,15469,15469,68sueyVfmy5ToEGtLFGDkwebX47xAmzyXE29z8JrmcWv,1237551,3326356,-2088805,623
2022-04-21 16:33:15-04:00,15813,Br1j5Ftafei7ysu5SmqVZSoRe4uS4qCPeKSPHg55pyiE,G8fc7QvXjfkgBFvAVUgJFQS3VaF1biL9rktBExGa87Ks,True,283379854,70844963,441484,220742,220742,DQCvC9mR68hJ3tJsUiddh6JwcBJAmntqGJR2nUsEq7yj,17659385,34280424,-16621039,623
2022-04-21 16:34:16-04:00,15814,F4hN7ecndZ8Gr5KQNSFaSrMGawMasz7jfWTLTMpk7gaB,AJ23FpXSGjipcqywk88WGsKfqfiiUjPzZLsvLtBAhB12,True,835549137,146376626,989800,494900,494900,2py1FiYeL2f7J3HU36qiJz6TD6HCmiTN36RyxYtapQCZ,56499953,97691523,-41191570,676
2022-04-21 16:34:55-04:00,15815,4pVzpvQywzjV9y7vR4mR3J1vgurmHCPE4z2jDsJfvMdr,DcxzYh2P27r4ji6rV1BiSiDSYW1zQR7eFLYKA6U4s4RP,True,14671679435,3667919858,11102547,5551273,5551274,2a35JJeTUW1pm6M3e8DHCjp8qr4vbc2cRPhuzZWyFzYd,444101896,778291517,-334189621,302
2022-04-21 16:35:41-04:00,15816,SEndYVMCKAeZUKSqGrMUSqXFmxtA9M1t4eXsUhVsTBF,3fcQQcbkpqodakamn82pFnMxBEPL2Drsg4jJNZ6dx72M,True,876508944,187137087,1153071,576535,576536,gjBMZYVujDjD1ECG4i97M8Q3gV9ESnwwTSUGropkusj,54007336,101340526,-47333190,616
2022-04-21 16:40:04-04:00,15817,3CxwyEadyRMxq6XyjjVAK4TB3we6dcLZf3GVCQLSDEPM,Bp12mixLHgc3L6CvzqzsyV4GLMrmxGiydZE4buJwsHmr,True,121650899,24178171,88535,44267,44268,6UQfSsLooL4pQKQfLtXCutQS2BnF7A7F7ewJopDLmUpc,4454639,13131314,-8676675,366
2022-04-21 16:42:13-04:00,15818,5yPGvUz6JWKjkViGwTCpygJii1rP2xv5yx146ULtBiYq,FMnHUCQWTf1UHu5qVFqUAsWh8aba9EQYTEoiXy55totD,True,23406642,5851660,36500,18250,18250,6UQfSsLooL4pQKQfLtXCutQS2BnF7A7F7ewJopDLmUpc,1460022,3631491,-2171469,623
2022-04-21 16:57:02-04:00,15819,4pVzpvQywzjV9y7vR4mR3J1vgurmHCPE4z2jDsJfvMdr,DcxzYh2P27r4ji6rV1BiSiDSYW1zQR7eFLYKA6U4s4RP,True,10892568816,2723142204,8045214,4022607,4022607,2a35JJeTUW1pm6M3e8DHCjp8qr4vbc2cRPhuzZWyFzYd,321808588,686174580,-364365992,295
2022-04-21 16:57:22-04:00,15820,EmLMKbiiBsVpffybGuPUVFRcb5C5KxsZ5H4JSvkgHouL,895uV1W4TG8QdvJKDhPHAzG22gGoGcwpEgQrM5SjMEeQ,True,2236560609,559140152,3493606,1746803,1746803,DQCvC9mR68hJ3tJsUiddh6JwcBJAmntqGJR2nUsEq7yj,139744242,398612884,-258868642,624
2022-04-21 16:57:24-04:00,15821,D22p65XepEPmSMKUHSbwjtAakcyVWs1KNFDsRzR8BzQM,Em19t6VrnfvQ86q5AU5MWWa6eCYwysKZyBcpJsmQYr4Z,True,2286241801,571560450,3563929,1781964,1781965,2a35JJeTUW1pm6M3e8DHCjp8qr4vbc2cRPhuzZWyFzYd,142557175,385942542,-243385367,623
2022-04-21 16:57:25-04:00,15822,D85pWm1LS9MvtR4f3QhkFLvNUhZLQ2NZBFQTyAVnmigm,CRN85DYkJJi6irhtVAf4qcJU3ijVodWdXgWe7Fs6Ahka,False,14592622,14592622,907421,45371,862050,2a35JJeTUW1pm6M3e8DHCjp8qr4vbc2cRPhuzZWyFzYd,907421,2773230,-1865809,621
2022-04-21 17:49:14-04:00,15823,Br1j5Ftafei7ysu5SmqVZSoRe4uS4qCPeKSPHg55pyiE,G8fc7QvXjfkgBFvAVUgJFQS3VaF1biL9rktBExGa87Ks,True,208097619,52024404,319114,159557,159557,gjBMZYVujDjD1ECG4i97M8Q3gV9ESnwwTSUGropkusj,12764592,29670137,-16905545,613
2022-04-21 18:00:23-04:00,15824,3CxwyEadyRMxq6XyjjVAK4TB3we6dcLZf3GVCQLSDEPM,Bp12mixLHgc3L6CvzqzsyV4GLMrmxGiydZE4buJwsHmr,True,96823404,18026869,69097,34548,34549,2xTUy2RS74GJMMDnmFaegMzFLn19RVfYG4CibhBmjP1i,3711319,11298647,-7587328,383
2022-04-21 18:01:20-04:00,15825,5QxR9QPTADFys9VQNm473RgprTikCXC23vhsBc9ojyAQ,H9zdf8nJ4JCF7jrwGsxiuiFoa14gzDmYsZ5N5ig3UGna,True,691712248,172928062,1077736,538868,538868,A9TwRM1BMxqb8DCC7YNAMV6zPenEJm3HTZBy7wJKK58U,43109454,73582564,-30473110,623
2022-04-21 18:02:07-04:00,15826,F4hN7ecndZ8Gr5KQNSFaSrMGawMasz7jfWTLTMpk7gaB,AJ23FpXSGjipcqywk88WGsKfqfiiUjPzZLsvLtBAhB12,True,680016273,108792994,741553,370776,370777,68sueyVfmy5ToEGtLFGDkwebX47xAmzyXE29z8JrmcWv,46351187,90913546,-44562359,681
2022-04-21 18:29:39-04:00,15827,3CxwyEadyRMxq6XyjjVAK4TB3we6dcLZf3GVCQLSDEPM,Bp12mixLHgc3L6CvzqzsyV4GLMrmxGiydZE4buJwsHmr,True,78272973,13453162,53601,26800,26801,2a35JJeTUW1pm6M3e8DHCjp8qr4vbc2cRPhuzZWyFzYd,3118660,9818754,-6700094,398
2022-04-21 18:29:47-04:00,15828,5yPGvUz6JWKjkViGwTCpygJii1rP2xv5yx146ULtBiYq,FMnHUCQWTf1UHu5qVFqUAsWh8aba9EQYTEoiXy55totD,True,17182404,4295601,26211,13105,13106,2py1FiYeL2f7J3HU36qiJz6TD6HCmiTN36RyxYtapQCZ,1048471,3049669,-2001198,610
2022-04-21 18:30:30-04:00,15829,djW9rVm1v4nW64QiVqgFUCRza24VqthDcSfVEyRHPed,EsXvQmXVXECqZPtmSdiuwieHPP5jsmyn67p78vHaJcqq,True,2701338127,675334531,1974448,987224,987224,2a35JJeTUW1pm6M3e8DHCjp8qr4vbc2cRPhuzZWyFzYd,78977946,287930161,-208952215,292
2022-04-21 18:30:31-04:00,15830,3CxwyEadyRMxq6XyjjVAK4TB3we6dcLZf3GVCQLSDEPM,Bp12mixLHgc3L6CvzqzsyV4GLMrmxGiydZE4buJwsHmr,True,64489476,6078214,25775,12887,12888,gjBMZYVujDjD1ECG4i97M8Q3gV9ESnwwTSUGropkusj,2734724,8640048,-5905324,424
2022-04-21 18:30:35-04:00,15831,Gwe1S7Wthi8pcNCzk1ttAvXwTUpBtfsEoDW5fMWRrPcW,B17Z5G2kPPLkGzhoXmjkjJoNDqPfahXg2gat2u5AmfEc,True,101075666,25268916,179153,89576,89577,6UQfSsLooL4pQKQfLtXCutQS2BnF7A7F7ewJopDLmUpc,7166130,10329885,-3163755,708
2022-04-21 18:30:51-04:00,15832,7tFD53kPTqrzjCu1Wji78gUqhoRtCUhsP1pM3DQKT7uG,BJvgPLYBDJrQJdQVowrsMwUGMurq4zTihoFwWoEokfu3,True,7246955133,1146273540,7137762,3568881,3568881,3zqXX6kzhkbW3d4TwD2CNjMRwxTbREXySekvq37kfCNk,451262668,925282147,-474019479,622
2022-04-21 18:31:13-04:00,15833,F4hN7ecndZ8Gr5KQNSFaSrMGawMasz7jfWTLTMpk7gaB,AJ23FpXSGjipcqywk88WGsKfqfiiUjPzZLsvLtBAhB12,True,562373810,80359054,525275,262637,262638,gjBMZYVujDjD1ECG4i97M8Q3gV9ESnwwTSUGropkusj,36760165,84830142,-48069977,653
2022-04-21 18:31:38-04:00,15834,2dbTtvw8XJnGdCeGnk1rbCY2SYszRNcCoGSVkACo1LDs,7aE9VZ6FP38CMuxDrjHESyNX6YZRxnfiDp3K4gDpDxJj,True,1604869327,401217331,1212230,606115,606115,gjBMZYVujDjD1ECG4i97M8Q3gV9ESnwwTSUGropkusj,48489205,85318527,-36829322,302
2022-04-21 18:31:56-04:00,15835,SEndYVMCKAeZUKSqGrMUSqXFmxtA9M1t4eXsUhVsTBF,3fcQQcbkpqodakamn82pFnMxBEPL2Drsg4jJNZ6dx72M,True,678505121,138267489,959438,479719,479719,gjBMZYVujDjD1ECG4i97M8Q3gV9ESnwwTSUGropkusj,47081510,84470022,-37388512,693
2022-04-21 18:32:01-04:00,15836,D5VZNThkv6XD6bimPshD2J3PvbPXgCbivZuPfkVxgdjc,8C77LmMk4C3KvyEb1N3scdbAgwN7J45nAcv9tkL5namB,True,22361903340,5590475835,34670934,17335467,17335467,68sueyVfmy5ToEGtLFGDkwebX47xAmzyXE29z8JrmcWv,1386837387,2795480621,-1408643234,620
2022-04-21 23:10:27-04:00,15837,SEndYVMCKAeZUKSqGrMUSqXFmxtA9M1t4eXsUhVsTBF,3fcQQcbkpqodakamn82pFnMxBEPL2Drsg4jJNZ6dx72M,True,533967688,101674371,689342,344671,344671,gjBMZYVujDjD1ECG4i97M8Q3gV9ESnwwTSUGropkusj,36202523,69602436,-33399913,677
2022-04-22 01:09:19-04:00,15838,CLP8qmL8aN9ocJKYnbKSo4k46CU3LBsebspfREQcSGvo,F6tkkFJnvjYyPdSXDNzZMUfhd1o8dFiLyLPRZ5U1sXHE,True,119608589,29902147,186711,93355,93356,A9TwRM1BMxqb8DCC7YNAMV6zPenEJm3HTZBy7wJKK58U,7468440,10743848,-3275408,624
2022-04-22 05:59:12-04:00,15839,3CxwyEadyRMxq6XyjjVAK4TB3we6dcLZf3GVCQLSDEPM,Bp12mixLHgc3L6CvzqzsyV4GLMrmxGiydZE4buJwsHmr,True,66537350,12056937,46990,23495,23495,6UQfSsLooL4pQKQfLtXCutQS2BnF7A7F7ewJopDLmUpc,2593229,8006360,-5413131,389
2022-04-22 06:02:23-04:00,15840,2dbTtvw8XJnGdCeGnk1rbCY2SYszRNcCoGSVkACo1LDs,7aE9VZ6FP38CMuxDrjHESyNX6YZRxnfiDp3K4gDpDxJj,True,1557022346,389255586,1179138,589569,589569,3zqXX6kzhkbW3d4TwD2CNjMRwxTbREXySekvq37kfCNk,47165520,80862059,-33696539,302
2022-04-22 06:40:10-04:00,15841,CLP8qmL8aN9ocJKYnbKSo4k46CU3LBsebspfREQcSGvo,F6tkkFJnvjYyPdSXDNzZMUfhd1o8dFiLyLPRZ5U1sXHE,True,91305352,22826338,141583,70791,70792,2xTUy2RS74GJMMDnmFaegMzFLn19RVfYG4CibhBmjP1i,5663350,9718906,-4055556,620
2022-04-22 10:23:53-04:00,15842,F4hN7ecndZ8Gr5KQNSFaSrMGawMasz7jfWTLTMpk7gaB,AJ23FpXSGjipcqywk88WGsKfqfiiUjPzZLsvLtBAhB12,True,477597288,59025733,389958,194979,194979,DQCvC9mR68hJ3tJsUiddh6JwcBJAmntqGJR2nUsEq7yj,31552870,78790765,-47237895,660
2022-04-22 10:23:58-04:00,15843,3CxwyEadyRMxq6XyjjVAK4TB3we6dcLZf3GVCQLSDEPM,Bp12mixLHgc3L6CvzqzsyV4GLMrmxGiydZE4buJwsHmr,True,54130362,4546938,18347,9173,9174,DQCvC9mR68hJ3tJsUiddh6JwcBJAmntqGJR2nUsEq7yj,2184267,7015523,-4831256,403
2022-04-22 10:23:58-04:00,15844,2dbTtvw8XJnGdCeGnk1rbCY2SYszRNcCoGSVkACo1LDs,7aE9VZ6FP38CMuxDrjHESyNX6YZRxnfiDp3K4gDpDxJj,True,1378791876,344697969,1043587,521793,521794,6UQfSsLooL4pQKQfLtXCutQS2BnF7A7F7ewJopDLmUpc,41743491,78025826,-36282335,302
2022-04-22 10:24:04-04:00,15845,FU7X4DWnGTbxwXULBq3v9SACzYhQyFGqsXjUDzyFqiem,925BaEnWxTfEv4oQb9Xf1wyyEEWEr8kXeSdXTtRfShfw,True,767342706,191835676,1187165,593582,593583,A9TwRM1BMxqb8DCC7YNAMV6zPenEJm3HTZBy7wJKK58U,47486600,111259255,-63772655,618
2022-04-22 10:25:06-04:00,15846,Br1j5Ftafei7ysu5SmqVZSoRe4uS4qCPeKSPHg55pyiE,G8fc7QvXjfkgBFvAVUgJFQS3VaF1biL9rktBExGa87Ks,True,153395164,38348791,239434,119717,119717,A9TwRM1BMxqb8DCC7YNAMV6zPenEJm3HTZBy7wJKK58U,9577398,24935996,-15358598,624
2022-04-22 10:55:16-04:00,15847,4pVzpvQywzjV9y7vR4mR3J1vgurmHCPE4z2jDsJfvMdr,DcxzYh2P27r4ji6rV1BiSiDSYW1zQR7eFLYKA6U4s4RP,True,6456579109,1614144777,4185568,2092784,2092784,DQCvC9mR68hJ3tJsUiddh6JwcBJAmntqGJR2nUsEq7yj,167422748,311229871,-143807123,259
2022-04-22 11:04:19-04:00,15848,CAeUB4VbyVdcNRTfj7PQShbkx7HgYsBz5JK1NcHfUYQa,Duarumo4Amf86Dkd2pFyJP73NimC9i4dBttxZC6rEiJE,True,5775903505,1443975876,4212221,2106110,2106111,2py1FiYeL2f7J3HU36qiJz6TD6HCmiTN36RyxYtapQCZ,168488848,290554557,-122065709,291
2022-04-22 11:45:36-04:00,15849,4pVzpvQywzjV9y7vR4mR3J1vgurmHCPE4z2jDsJfvMdr,DcxzYh2P27r4ji6rV1BiSiDSYW1zQR7eFLYKA6U4s4RP,True,4824872188,1206218047,3637260,1818630,1818630,68sueyVfmy5ToEGtLFGDkwebX47xAmzyXE29z8JrmcWv,145490426,271406725,-125916299,301
2022-04-22 11:58:22-04:00,15850,FhCW2CghBaoo1MkXUXUb4okam8g5beQofgs3WXerNYzn,HWSPdmF3hSnnfVe29Y5rDGSPqbMQv2ug1wYrdwJZNWFK,True,1258713612,314678403,889002,444501,444501,DQCvC9mR68hJ3tJsUiddh6JwcBJAmntqGJR2nUsEq7yj,35560089,63087271,-27527182,282
2022-04-22 12:02:18-04:00,15851,3CxwyEadyRMxq6XyjjVAK4TB3we6dcLZf3GVCQLSDEPM,Bp12mixLHgc3L6CvzqzsyV4GLMrmxGiydZE4buJwsHmr,True,49307140,8931812,34148,17074,17074,2py1FiYeL2f7J3HU36qiJz6TD6HCmiTN36RyxYtapQCZ,1885178,6540932,-4655754,382
2022-04-22 12:05:36-04:00,15852,CAeUB4VbyVdcNRTfj7PQShbkx7HgYsBz5JK1NcHfUYQa,Duarumo4Amf86Dkd2pFyJP73NimC9i4dBttxZC6rEiJE,True,4296509192,1074127298,3217652,1608826,1608826,DQCvC9mR68hJ3tJsUiddh6JwcBJAmntqGJR2nUsEq7yj,128706092,256072723,-127366631,299
2022-04-22 12:29:12-04:00,15853,fAJK1wrBhSW297AtFWX2U4rUBf2gkzfQ6UrQL9yHEYW,5pyTFpanSyUCHxeMhJMKtpdrcMSAWc8bFadbyM7q4q4B,True,196539554,49134888,348616,174308,174308,DQCvC9mR68hJ3tJsUiddh6JwcBJAmntqGJR2nUsEq7yj,13944658,19157285,-5212627,709
2022-04-22 23:08:42-04:00,15854,D5VZNThkv6XD6bimPshD2J3PvbPXgCbivZuPfkVxgdjc,8C77LmMk4C3KvyEb1N3scdbAgwN7J45nAcv9tkL5namB,True,16468842654,4117210663,25729210,12864605,12864605,A2p75MbAbeUdHkPLkAjgGeiwuu9WPrkMHzjCkDXF1Xr3,1029168412,2401285403,-1372116991,624
2022-04-22 23:29:57-04:00,15855,2dbTtvw8XJnGdCeGnk1rbCY2SYszRNcCoGSVkACo1LDs,7aE9VZ6FP38CMuxDrjHESyNX6YZRxnfiDp3K4gDpDxJj,True,1116149885,279037471,834458,417229,417229,A9TwRM1BMxqb8DCC7YNAMV6zPenEJm3HTZBy7wJKK58U,33378334,67648117,-34269783,299
2022-04-22 23:30:29-04:00,15856,DBpCYPg3XaURq987o1MQwphyzjmD7VTWAjfQDgPw95aD,CNdhCvdP6ajoYKwRnsc2W3eahwUW4MZb2hGjFc1tjEWx,True,2639574658,659893664,1997106,998553,998553,A9TwRM1BMxqb8DCC7YNAMV6zPenEJm3HTZBy7wJKK58U,79884240,131675786,-51791546,302
2022-04-23 00:23:02-04:00,15857,5j5R1o3wXaL7cS9fxodLkrFjxPnujuX8boG7Zb9Fh9fs,4SZXsGqPoUy11ZKK5kNUpxCPK3ZcSxWMn12h4YREr9tS,True,284339001,60940438,206897,103448,103449,A9TwRM1BMxqb8DCC7YNAMV6zPenEJm3HTZBy7wJKK58U,9653532,35129522,-25475990,339
2022-04-23 00:23:04-04:00,15858,7tFD53kPTqrzjCu1Wji78gUqhoRtCUhsP1pM3DQKT7uG,BJvgPLYBDJrQJdQVowrsMwUGMurq4zTihoFwWoEokfu3,True,6030009524,847409702,5222488,2611244,2611244,6UQfSsLooL4pQKQfLtXCutQS2BnF7A7F7ewJopDLmUpc,371622555,873645731,-502023176,616
2022-04-23 00:24:03-04:00,15859,FhCW2CghBaoo1MkXUXUb4okam8g5beQofgs3WXerNYzn,HWSPdmF3hSnnfVe29Y5rDGSPqbMQv2ug1wYrdwJZNWFK,True,937724058,234431014,708972,354486,354486,2a35JJeTUW1pm6M3e8DHCjp8qr4vbc2cRPhuzZWyFzYd,28358883,55365909,-27007026,302
2022-04-23 00:24:22-04:00,15860,3CxwyEadyRMxq6XyjjVAK4TB3we6dcLZf3GVCQLSDEPM,Bp12mixLHgc3L6CvzqzsyV4GLMrmxGiydZE4buJwsHmr,True,40448642,3404068,13967,6983,6984,A2p75MbAbeUdHkPLkAjgGeiwuu9WPrkMHzjCkDXF1Xr3,1659758,5685832,-4026074,410
2022-04-23 00:24:26-04:00,15861,2dbTtvw8XJnGdCeGnk1rbCY2SYszRNcCoGSVkACo1LDs,7aE9VZ6FP38CMuxDrjHESyNX6YZRxnfiDp3K4gDpDxJj,True,829557037,207389259,624193,312096,312097,2a35JJeTUW1pm6M3e8DHCjp8qr4vbc2cRPhuzZWyFzYd,24967751,58235252,-33267501,300
2022-04-23 00:26:17-04:00,15862,DBpCYPg3XaURq987o1MQwphyzjmD7VTWAjfQDgPw95aD,CNdhCvdP6ajoYKwRnsc2W3eahwUW4MZb2hGjFc1tjEWx,True,1961259764,490314941,1485420,742710,742710,gjBMZYVujDjD1ECG4i97M8Q3gV9ESnwwTSUGropkusj,59416824,116735863,-57319039,302
2022-04-23 02:19:56-04:00,15863,7mhEMbGEpSYgYoZx6WvApjysTxsPqpCDSJCmKF45x3n6,12J2purUC4QYjaPKZwL3Y5P1JikTBD3oY9pLgY6yt6am,True,2797937414,699484353,4901451,2450725,2450726,2py1FiYeL2f7J3HU36qiJz6TD6HCmiTN36RyxYtapQCZ,196058075,269703640,-73645565,700
2022-04-23 04:16:27-04:00,15864,7mhEMbGEpSYgYoZx6WvApjysTxsPqpCDSJCmKF45x3n6,12J2purUC4QYjaPKZwL3Y5P1JikTBD3oY9pLgY6yt6am,True,2138099225,534524806,3789923,1894961,1894962,2xTUy2RS74GJMMDnmFaegMzFLn19RVfYG4CibhBmjP1i,151596946,246940369,-95343423,709
2022-04-23 04:18:26-04:00,15865,7mhEMbGEpSYgYoZx6WvApjysTxsPqpCDSJCmKF45x3n6,12J2purUC4QYjaPKZwL3Y5P1JikTBD3oY9pLgY6yt6am,True,1635779475,408944868,2890049,1445024,1445025,A2p75MbAbeUdHkPLkAjgGeiwuu9WPrkMHzjCkDXF1Xr3,115601967,219577421,-103975454,706
2022-04-23 04:46:40-04:00,15866,7mhEMbGEpSYgYoZx6WvApjysTxsPqpCDSJCmKF45x3n6,12J2purUC4QYjaPKZwL3Y5P1JikTBD3oY9pLgY6yt6am,True,1250451237,312612809,2227382,1113691,1113691,2xTUy2RS74GJMMDnmFaegMzFLn19RVfYG4CibhBmjP1i,89095288,190842783,-101747495,712
2022-04-23 08:05:27-04:00,15867,5B3nic6AUDSiweK5kgbwd6W9DqqX9tJ1zUSQHNWPe24b,2cpauDZ4j1ACSoFfR55NNEVh9quRiVcSFF7Zq3L26U8a,True,6563159615,915332943,6071987,3035993,3035994,A9TwRM1BMxqb8DCC7YNAMV6zPenEJm3HTZBy7wJKK58U,435376304,550327874,-114951570,663
2022-04-23 08:06:54-04:00,15868,3Dc89y1Z6ViLFDoY3vwcJewSjMQam2mSTqPtpxsPZVz5,4NfXm5CTgNUTQd6NPj2hKwjMYDr7a8d5yVC9rV2uTcjA,True,1927598659,481899664,3412109,1706054,1706055,3zqXX6kzhkbW3d4TwD2CNjMRwxTbREXySekvq37kfCNk,136484366,196827855,-60343489,708
2022-04-23 11:52:44-04:00,15869,5bF9tSdmHqni2jdMMbLfiE5jxHtX8WoJXNXxMuykuojW,FrRNyeq1GrnBbAdBeEMPKX6yv54KJLhTpoPBB3irxDei,True,9282209522,2320552380,14973844,7486922,7486922,2py1FiYeL2f7J3HU36qiJz6TD6HCmiTN36RyxYtapQCZ,598953791,926241910,-327288119,645
2022-04-23 11:52:48-04:00,15870,7ibRzTcuG8ah4mzzXYMuXqtTC8RHYWhmGgXL257rmLa4,SsLPddD1G5F7WUGXwXCne36k6momA7jwKGqgyTZcGDt,True,797427592,199356898,1329552,664776,664776,6UQfSsLooL4pQKQfLtXCutQS2BnF7A7F7ewJopDLmUpc,53182093,84385953,-31203860,666
2022-04-23 11:53:19-04:00,15871,BkmEBrAGEEXe4od6WiLJEg1VjM7VzQZ1a3sMthGZMyNq,68XmVwKTH6pD5Rd73ow4hqYweddt5fkA2BjYXHkpQUBQ,False,6437496,6437496,454201,22710,431491,A9TwRM1BMxqb8DCC7YNAMV6zPenEJm3HTZBy7wJKK58U,454201,635656,-181455,705
2022-04-23 11:53:26-04:00,15872,EukjfStiY4851KKYdtN9Mc1Rvzgkpuj1zs7yvAnUYYMY,AwkyGsqXanwHRd4xwBn4Xt1daygwKgCkzso9s6FMF1Qg,False,130312414,130312414,7491614,374580,7117034,2py1FiYeL2f7J3HU36qiJz6TD6HCmiTN36RyxYtapQCZ,7491614,47798790,-40307176,574
2022-04-23 11:53:27-04:00,15873,7ibRzTcuG8ah4mzzXYMuXqtTC8RHYWhmGgXL257rmLa4,SsLPddD1G5F7WUGXwXCne36k6momA7jwKGqgyTZcGDt,False,614077469,614077469,35845766,1792288,34053478,A9TwRM1BMxqb8DCC7YNAMV6zPenEJm3HTZBy7wJKK58U,35845766,75302689,-39456923,583
2022-04-23 12:41:21-04:00,15874,EAmvC16UQrM5xxmtpLHEABBkFtN88ZGB1qD9Si79HisJ,862ytUTXXPFDiUHUzi2AfrBXkTFaDdujP6pTu7xW4Fyh,True,139878086,25302631,87291,43645,43646,2py1FiYeL2f7J3HU36qiJz6TD6HCmiTN36RyxYtapQCZ,4825672,13911704,-9086032,344
2022-04-23 12:56:31-04:00,15875,EAmvC16UQrM5xxmtpLHEABBkFtN88ZGB1qD9Si79HisJ,862ytUTXXPFDiUHUzi2AfrBXkTFaDdujP6pTu7xW4Fyh,True,115322049,18996592,65754,32877,32877,6UQfSsLooL4pQKQfLtXCutQS2BnF7A7F7ewJopDLmUpc,3991787,13521714,-9529927,346
2022-04-23 12:56:32-04:00,15876,F2AU2PjaSmHxWWhkz8XxMggkCMWbMVgawt89tSnYS6RL,ET9febRJiW197DYMaJbgk3kWsAeFv5f4peQ4vFCVppK6,False,6132969126,6132969126,341253063,17062653,324190410,3zqXX6kzhkbW3d4TwD2CNjMRwxTbREXySekvq37kfCNk,341253063,585883498,-244630435,556
2022-04-23 15:04:36-04:00,15877,3Xbsek5MsEGoWr3G9yhuohREr26B2vSQcjqXdspTFHta,2rPxkUiMo9wGDq8EvAiwY3ngRpKmL223cBWWNTYoBmFp,True,888893893,222223473,1500526,750263,750263,2py1FiYeL2f7J3HU36qiJz6TD6HCmiTN36RyxYtapQCZ,60021055,91056735,-31035680,675
2022-04-23 16:17:39-04:00,15878,DmwHBt9RS9QZesz2k6NsiC9CXCvgaGSTWycWj8nCdkC6,EEN2iGeHGY9AbsrBTgs9CFNTfdiGWymzt6VGto8ZGyfF,True,1428837610,357209402,2534797,1267398,1267399,2py1FiYeL2f7J3HU36qiJz6TD6HCmiTN36RyxYtapQCZ,101391886,151062616,-49670730,709
2022-04-23 16:17:43-04:00,15879,3Xbsek5MsEGoWr3G9yhuohREr26B2vSQcjqXdspTFHta,2rPxkUiMo9wGDq8EvAiwY3ngRpKmL223cBWWNTYoBmFp,True,653610236,163402559,1136675,568337,568338,2a35JJeTUW1pm6M3e8DHCjp8qr4vbc2cRPhuzZWyFzYd,45467017,81867278,-36400261,695
2022-04-23 16:28:15-04:00,15880,5bF9tSdmHqni2jdMMbLfiE5jxHtX8WoJXNXxMuykuojW,FrRNyeq1GrnBbAdBeEMPKX6yv54KJLhTpoPBB3irxDei,True,3665453121,916363280,6503956,3251978,3251978,A9TwRM1BMxqb8DCC7YNAMV6zPenEJm3HTZBy7wJKK58U,260158254,374306065,-114147811,709
2022-04-23 18:52:42-04:00,15881,DmwHBt9RS9QZesz2k6NsiC9CXCvgaGSTWycWj8nCdkC6,EEN2iGeHGY9AbsrBTgs9CFNTfdiGWymzt6VGto8ZGyfF,True,1047040316,261760079,1856432,928216,928216,2a35JJeTUW1pm6M3e8DHCjp8qr4vbc2cRPhuzZWyFzYd,74257315,136263200,-62005885,709
2022-04-23 18:52:43-04:00,15882,3Xbsek5MsEGoWr3G9yhuohREr26B2vSQcjqXdspTFHta,2rPxkUiMo9wGDq8EvAiwY3ngRpKmL223cBWWNTYoBmFp,True,480070995,120017748,854705,427352,427353,2py1FiYeL2f7J3HU36qiJz6TD6HCmiTN36RyxYtapQCZ,34188209,71660358,-37472149,712
2022-04-23 19:21:19-04:00,15883,5bF9tSdmHqni2jdMMbLfiE5jxHtX8WoJXNXxMuykuojW,FrRNyeq1GrnBbAdBeEMPKX6yv54KJLhTpoPBB3irxDei,True,2686432866,671608216,4775013,2387506,2387507,2py1FiYeL2f7J3HU36qiJz6TD6HCmiTN36RyxYtapQCZ,191000533,340357644,-149357111,710
2022-04-23 19:33:10-04:00,15884,CLP8qmL8aN9ocJKYnbKSo4k46CU3LBsebspfREQcSGvo,F6tkkFJnvjYyPdSXDNzZMUfhd1o8dFiLyLPRZ5U1sXHE,True,78460227,19615056,121787,60893,60894,68sueyVfmy5ToEGtLFGDkwebX47xAmzyXE29z8JrmcWv,4871508,7128610,-2257102,620
2022-04-23 19:35:39-04:00,15885,5QxR9QPTADFys9VQNm473RgprTikCXC23vhsBc9ojyAQ,H9zdf8nJ4JCF7jrwGsxiuiFoa14gzDmYsZ5N5ig3UGna,True,507543968,126885992,786646,393323,393323,68sueyVfmy5ToEGtLFGDkwebX47xAmzyXE29z8JrmcWv,31465870,65564210,-34098340,619
2022-04-23 19:35:41-04:00,15886,2CcC3D56NXriBsSPjiAEXV2ajKs1t3Q6RDGT8qnonarY,TihwXEmfvuxSuYZHThxmKmVSiYtPa2bN386HxfpKVLs,True,5444028093,1361007023,9533164,4766582,4766582,68sueyVfmy5ToEGtLFGDkwebX47xAmzyXE29z8JrmcWv,381326590,778195404,-396868814,700
2022-04-23 19:35:45-04:00,15887,DmwHBt9RS9QZesz2k6NsiC9CXCvgaGSTWycWj8nCdkC6,EEN2iGeHGY9AbsrBTgs9CFNTfdiGWymzt6VGto8ZGyfF,True,767195958,191798989,1358161,679080,679081,2py1FiYeL2f7J3HU36qiJz6TD6HCmiTN36RyxYtapQCZ,54326441,119006869,-64680428,708
2022-04-23 19:35:51-04:00,15888,3Xbsek5MsEGoWr3G9yhuohREr26B2vSQcjqXdspTFHta,2rPxkUiMo9wGDq8EvAiwY3ngRpKmL223cBWWNTYoBmFp,True,351657621,87914405,623559,311779,311780,A9TwRM1BMxqb8DCC7YNAMV6zPenEJm3HTZBy7wJKK58U,24942391,61461765,-36519374,709
2022-04-23 19:35:57-04:00,15889,2dbTtvw8XJnGdCeGnk1rbCY2SYszRNcCoGSVkACo1LDs,7aE9VZ6FP38CMuxDrjHESyNX6YZRxnfiDp3K4gDpDxJj,True,1397119330,349279832,1057185,528592,528593,2py1FiYeL2f7J3HU36qiJz6TD6HCmiTN36RyxYtapQCZ,42287409,56340597,-14053188,302
2022-04-23 19:59:29-04:00,15890,FU7X4DWnGTbxwXULBq3v9SACzYhQyFGqsXjUDzyFqiem,925BaEnWxTfEv4oQb9Xf1wyyEEWEr8kXeSdXTtRfShfw,True,565477941,141369485,882070,441035,441035,DQCvC9mR68hJ3tJsUiddh6JwcBJAmntqGJR2nUsEq7yj,35282817,93157129,-57874312,623
2022-04-23 21:47:51-04:00,15891,2CcC3D56NXriBsSPjiAEXV2ajKs1t3Q6RDGT8qnonarY,TihwXEmfvuxSuYZHThxmKmVSiYtPa2bN386HxfpKVLs,True,4601005899,1150251474,8046155,4023077,4023078,2py1FiYeL2f7J3HU36qiJz6TD6HCmiTN36RyxYtapQCZ,321846232,671404748,-349558516,699
2022-04-23 21:47:51-04:00,15892,F4hN7ecndZ8Gr5KQNSFaSrMGawMasz7jfWTLTMpk7gaB,AJ23FpXSGjipcqywk88WGsKfqfiiUjPzZLsvLtBAhB12,True,461528571,115382142,793768,396884,396884,2py1FiYeL2f7J3HU36qiJz6TD6HCmiTN36RyxYtapQCZ,31750725,44242307,-12491582,687
2022-04-23 21:48:14-04:00,15893,5bF9tSdmHqni2jdMMbLfiE5jxHtX8WoJXNXxMuykuojW,FrRNyeq1GrnBbAdBeEMPKX6yv54KJLhTpoPBB3irxDei,True,1966143435,491535858,3438452,1719226,1719226,68sueyVfmy5ToEGtLFGDkwebX47xAmzyXE29z8JrmcWv,137538109,298843263,-161305154,699
2022-04-24 00:20:13-04:00,15894,7mhEMbGEpSYgYoZx6WvApjysTxsPqpCDSJCmKF45x3n6,12J2purUC4QYjaPKZwL3Y5P1JikTBD3oY9pLgY6yt6am,True,4358130453,1089532613,7753609,3876804,3876805,gjBMZYVujDjD1ECG4i97M8Q3gV9ESnwwTSUGropkusj,310144370,420941861,-110797491,711
2022-04-24 00:28:30-04:00,15895,DveCRMXe4oGq4nfsNmfabw37euBwqxqNUH5svSCkYjwD,BWJvLCXqju7J2PqPcy4xd5z42VJCFzTMXAhd17Ng25sQ,True,9584661364,2396165341,17036309,8518154,8518155,2xTUy2RS74GJMMDnmFaegMzFLn19RVfYG4CibhBmjP1i,681452385,1052979484,-371527099,710
2022-04-24 00:28:35-04:00,15896,DmwHBt9RS9QZesz2k6NsiC9CXCvgaGSTWycWj8nCdkC6,EEN2iGeHGY9AbsrBTgs9CFNTfdiGWymzt6VGto8ZGyfF,True,562569036,140642259,1003412,501706,501706,gjBMZYVujDjD1ECG4i97M8Q3gV9ESnwwTSUGropkusj,40136518,101525786,-61389268,713
2022-04-24 07:29:22-04:00,15897,HxEjbaeXyjRYmxhkvPER7iuevx9R3AH9rdAtAu9r4zxL,HUXTVWjDHoKRNDEt4qXC9c7BpDtjB2tSNW7bXhHXsMk9,True,206398859,51599426,321233,160616,160617,DQCvC9mR68hJ3tJsUiddh6JwcBJAmntqGJR2nUsEq7yj,12849408,21078271,-8228863,622
2022-04-24 09:05:58-04:00,15898,5yPGvUz6JWKjkViGwTCpygJii1rP2xv5yx146ULtBiYq,FMnHUCQWTf1UHu5qVFqUAsWh8aba9EQYTEoiXy55totD,False,12677145,12677145,773882,38694,735188,A9TwRM1BMxqb8DCC7YNAMV6zPenEJm3HTZBy7wJKK58U,773882,2484449,-1710567,610
2022-04-24 09:37:53-04:00,15899,Br1j5Ftafei7ysu5SmqVZSoRe4uS4qCPeKSPHg55pyiE,G8fc7QvXjfkgBFvAVUgJFQS3VaF1biL9rktBExGa87Ks,True,112965618,28241404,176083,88041,88042,gjBMZYVujDjD1ECG4i97M8Q3gV9ESnwwTSUGropkusj,7043351,20643829,-13600478,623
2022-04-24 09:38:42-04:00,15900,7BEY9qatFJomsayFmky3h3dAbKhY5XkRGwMobJuxXYhQ,J8MK3tAQKreBUG2reXY6gqr1uhbHhcAZEcxsLQmG5Ntt,True,2150246600,537561650,3835661,1917830,1917831,A9TwRM1BMxqb8DCC7YNAMV6zPenEJm3HTZBy7wJKK58U,153426463,518190149,-364763686,713
2022-04-24 11:01:55-04:00,15901,7mhEMbGEpSYgYoZx6WvApjysTxsPqpCDSJCmKF45x3n6,12J2purUC4QYjaPKZwL3Y5P1JikTBD3oY9pLgY6yt6am,True,3342281641,835570410,5725823,2862911,2862912,A9TwRM1BMxqb8DCC7YNAMV6zPenEJm3HTZBy7wJKK58U,229032956,386933349,-157900393,685
2022-04-24 12:33:48-04:00,15902,3CxwyEadyRMxq6XyjjVAK4TB3we6dcLZf3GVCQLSDEPM,Bp12mixLHgc3L6CvzqzsyV4GLMrmxGiydZE4buJwsHmr,True,43466464,8333796,31462,15731,15731,6UQfSsLooL4pQKQfLtXCutQS2BnF7A7F7ewJopDLmUpc,1640964,5298591,-3657627,377
2022-04-24 12:37:23-04:00,15903,4pVzpvQywzjV9y7vR4mR3J1vgurmHCPE4z2jDsJfvMdr,DcxzYh2P27r4ji6rV1BiSiDSYW1zQR7eFLYKA6U4s4RP,True,2198990773,549747693,1660569,830284,830285,3zqXX6kzhkbW3d4TwD2CNjMRwxTbREXySekvq37kfCNk,66422778,109722022,-43299244,302
2022-04-24 12:52:01-04:00,15904,djW9rVm1v4nW64QiVqgFUCRza24VqthDcSfVEyRHPed,EsXvQmXVXECqZPtmSdiuwieHPP5jsmyn67p78vHaJcqq,True,1414538597,353634649,1049752,524876,524876,A2p75MbAbeUdHkPLkAjgGeiwuu9WPrkMHzjCkDXF1Xr3,41990096,69990264,-28000168,296
2022-04-24 12:52:11-04:00,15905,BTwSuuDHNhQAFAzBZRWev5j1ix2RTWvjZAxLpw8grAxu,31NCyUpSXxxJYLSrdK3c5bLomUtMejobMfYnq7j71GtM,True,146979400,36744850,228238,114119,114119,2a35JJeTUW1pm6M3e8DHCjp8qr4vbc2cRPhuzZWyFzYd,9129524,27635730,-18506206,621
2022-04-24 12:52:28-04:00,15906,D5VZNThkv6XD6bimPshD2J3PvbPXgCbivZuPfkVxgdjc,8C77LmMk4C3KvyEb1N3scdbAgwN7J45nAcv9tkL5namB,True,12131465131,3032866282,18948070,9474035,9474035,gjBMZYVujDjD1ECG4i97M8Q3gV9ESnwwTSUGropkusj,757922801,2014460710,-1256537909,624
2022-04-24 12:53:14-04:00,15907,HooxSzasW3HMoFJ6sAvRQ75Char1J5aBdJtsqfDV6myp,BCmsWwpGeV4NNfeKZKKydty2uueLGHYTJDk1WErpXsVT,True,116633848,29158462,182079,91039,91040,A2p75MbAbeUdHkPLkAjgGeiwuu9WPrkMHzjCkDXF1Xr3,7283198,34162731,-26879533,624
2022-04-24 12:54:03-04:00,15908,5o4EAqBTiUKn41QhPL5kRjrGTgQVdP7xLtxC7xNxjkwn,E8gDreu3LxW1EHJ8hnqChK9QdffGh5GocJYKdrbYat8E,True,1172074984,293018746,1827165,913582,913583,A2p75MbAbeUdHkPLkAjgGeiwuu9WPrkMHzjCkDXF1Xr3,73086636,273785582,-200698946,623
2022-04-24 12:54:45-04:00,15909,7AizMrxWWr7qfneuXMy6ifL3BVDTAKkuud4PyZFy92kh,GyAWRRfQkVAXtyhVF14vU3kPMr4kG1VyA9FAHdDTr8ud,True,33525155,8381288,52327,26163,26164,A9TwRM1BMxqb8DCC7YNAMV6zPenEJm3HTZBy7wJKK58U,2093095,10931902,-8838807,624
2022-04-24 12:54:46-04:00,15910,5r3YEyxbXrMEwYCFyZXS5t1eRLDahPFxPBBYNyMfHfcZ,7fnHdwm7JWHREPPk7dMud4vEoYZqsiRYCMo6ZSQqMwQc,True,97755876,12856045,79756,39878,39878,A9TwRM1BMxqb8DCC7YNAMV6zPenEJm3HTZBy7wJKK58U,6064592,42538798,-36474206,620
2022-04-24 13:25:11-04:00,15911,5g5EaEMiM2WQcfDpL3R3caYziX9xvGCFs9eVmmQdcgzS,J71CftCqiK1873fkVx9NGc7v7nvRZMYVBkGN3GhSPyeX,True,90401779,22600444,161349,80674,80675,2xTUy2RS74GJMMDnmFaegMzFLn19RVfYG4CibhBmjP1i,6453993,25659864,-19205871,713
2022-04-24 15:06:36-04:00,15912,CLP8qmL8aN9ocJKYnbKSo4k46CU3LBsebspfREQcSGvo,F6tkkFJnvjYyPdSXDNzZMUfhd1o8dFiLyLPRZ5U1sXHE,True,59773540,14943385,92881,46440,46441,2xTUy2RS74GJMMDnmFaegMzFLn19RVfYG4CibhBmjP1i,3715267,5217474,-1502207,621
2022-04-24 15:42:54-04:00,15913,BFWNfNhm4RUFJs3721We8Dyocw1okinoUA3JtHshAHkU,7czPpWxLYgLgAGmvxiKA6zRGQ97FdLVB83FvNqEuKnFj,True,190729092,47682273,338411,169205,169206,6UQfSsLooL4pQKQfLtXCutQS2BnF7A7F7ewJopDLmUpc,13536447,18423787,-4887340,709
2022-04-24 20:09:28-04:00,15914,3CxwyEadyRMxq6XyjjVAK4TB3we6dcLZf3GVCQLSDEPM,Bp12mixLHgc3L6CvzqzsyV4GLMrmxGiydZE4buJwsHmr,True,34907783,6220152,24579,12289,12290,2a35JJeTUW1pm6M3e8DHCjp8qr4vbc2cRPhuzZWyFzYd,1379404,4626493,-3247089,395
2022-04-24 20:09:51-04:00,15915,2rLWe1XADCU93guPU6WgSW6x56gYNfif9bm11V93mJnv,BEGhQRm3fgSHeBtk2DYrXEBPKPRvS3sHyTNopmoBJxMs,True,31840989,7960247,49434,24717,24717,2a35JJeTUW1pm6M3e8DHCjp8qr4vbc2cRPhuzZWyFzYd,1977387,29897407,-27920020,621
2022-04-24 20:09:58-04:00,15916,7zDNgPFeomS1hdQhuY8iGF3nnGMNnx1YrinZJetrefje,AKyG5R6Bac6Fu83ruL9FGpjKCfDKxbP6QfEGbCgqegiV,True,366683471,91430574,276858,138429,138429,3zqXX6kzhkbW3d4TwD2CNjMRwxTbREXySekvq37kfCNk,11103445,25534971,-14431526,302
2022-04-24 20:10:05-04:00,15917,FhCW2CghBaoo1MkXUXUb4okam8g5beQofgs3WXerNYzn,HWSPdmF3hSnnfVe29Y5rDGSPqbMQv2ug1wYrdwJZNWFK,True,780851846,195212961,586021,293010,293011,3zqXX6kzhkbW3d4TwD2CNjMRwxTbREXySekvq37kfCNk,23440847,47963359,-24522512,300
2022-04-24 20:10:06-04:00,15918,BZxJ6CtrVoiU86DMMieMeDFLNWtMpHGTvZfM7nyay6o4,6CRxRR8bisRLHFJBFWjyumYuy7j4C4PkjYH1K8gXhdWD,False,10768240,10768240,666784,33339,633445,72FwbpFGoLEazJEdpqNtPNefsadUrimUqma9wSoy4qiS,666784,3313425,-2646641,619
2022-04-24 20:10:15-04:00,15919,6Zyz5SGNMpEtCBu7H2USCkJCKpAJxLJrdf7h8N1W4fwp,3TTgDXx7VPZtB7aJDMShctxL5Y5To2Ugz927CoHNRztJ,True,83377020,20844255,129139,64569,64570,2a35JJeTUW1pm6M3e8DHCjp8qr4vbc2cRPhuzZWyFzYd,5165578,38299856,-33134278,619
2022-04-24 20:10:42-04:00,15920,5j5R1o3wXaL7cS9fxodLkrFjxPnujuX8boG7Zb9Fh9fs,4SZXsGqPoUy11ZKK5kNUpxCPK3ZcSxWMn12h4YREr9tS,True,222025343,45648124,164243,82121,82122,2a35JJeTUW1pm6M3e8DHCjp8qr4vbc2cRPhuzZWyFzYd,7988577,29163693,-21175116,359
2022-04-24 20:12:04-04:00,15921,6RuQVU9nu2Ecp177M9ggWczLACvQ8PfT31RTcmfwe9Hq,DZgsgqvMNLTXkBxySZC7Monak2JGsXRMJT4hBQzpf6Xm,True,1078038020,269509505,1923883,961941,961942,68sueyVfmy5ToEGtLFGDkwebX47xAmzyXE29z8JrmcWv,76955354,109256406,-32301052,713
2022-04-24 20:14:17-04:00,15922,3uUdWwgwtFdPa3FJTSrirqPKMtQb3zmT5Wpp4zPy9sJP,5G7dhz8jvWekGy9Wh3ZCXNXSPbB1QArfFYs7MYNgRDkW,True,20328917,5082229,31754,15877,15877,68sueyVfmy5ToEGtLFGDkwebX47xAmzyXE29z8JrmcWv,1270185,10036011,-8765826,624
2022-04-24 20:15:36-04:00,15923,5r3YEyxbXrMEwYCFyZXS5t1eRLDahPFxPBBYNyMfHfcZ,7fnHdwm7JWHREPPk7dMud4vEoYZqsiRYCMo6ZSQqMwQc,True,84180775,11555287,71986,35993,35993,A9TwRM1BMxqb8DCC7YNAMV6zPenEJm3HTZBy7wJKK58U,5244279,36734865,-31490586,622
2022-04-24 20:16:29-04:00,15924,2CcC3D56NXriBsSPjiAEXV2ajKs1t3Q6RDGT8qnonarY,TihwXEmfvuxSuYZHThxmKmVSiYtPa2bN386HxfpKVLs,True,5644802100,883032702,6282630,3141315,3141315,3zqXX6kzhkbW3d4TwD2CNjMRwxTbREXySekvq37kfCNk,401618286,574254392,-172636106,711
2022-04-24 20:16:55-04:00,15925,5BJnMHFSiQjHRGFJDW1jnqCfkHHYWnQzmmccy9eA4jNj,9517JGYsPmvgPUM9pFRD2vipHmdgE578F7jA7Qq6jorm,False,277962,277962,17366,868,16498,A2p75MbAbeUdHkPLkAjgGeiwuu9WPrkMHzjCkDXF1Xr3,17366,218828,-201462,624
2022-04-24 20:17:04-04:00,15926,HxEjbaeXyjRYmxhkvPER7iuevx9R3AH9rdAtAu9r4zxL,HUXTVWjDHoKRNDEt4qXC9c7BpDtjB2tSNW7bXhHXsMk9,True,151666535,37916348,232745,116372,116373,gjBMZYVujDjD1ECG4i97M8Q3gV9ESnwwTSUGropkusj,9309905,18615726,-9305821,613
2022-04-24 20:20:27-04:00,15927,3CxwyEadyRMxq6XyjjVAK4TB3we6dcLZf3GVCQLSDEPM,Bp12mixLHgc3L6CvzqzsyV4GLMrmxGiydZE4buJwsHmr,True,28515895,2479619,10287,5143,5144,2xTUy2RS74GJMMDnmFaegMzFLn19RVfYG4CibhBmjP1i,1183089,4095148,-2912059,414
2022-04-24 20:20:37-04:00,15928,7AizMrxWWr7qfneuXMy6ifL3BVDTAKkuud4PyZFy92kh,GyAWRRfQkVAXtyhVF14vU3kPMr4kG1VyA9FAHdDTr8ud,True,24650624,6162656,38498,19249,19249,gjBMZYVujDjD1ECG4i97M8Q3gV9ESnwwTSUGropkusj,1539932,8662306,-7122374,624
2022-04-24 20:22:45-04:00,15929,HHp8dRc1YMWE93uyLdM98DkUhM8U8zm3JC59chrbbWrk,AdqFuGe28VeAwwjRPZCBGVy5ftf9zNNQkg413i66wyig,True,65686185,16421546,102539,51269,51270,gjBMZYVujDjD1ECG4i97M8Q3gV9ESnwwTSUGropkusj,4101586,19586032,-15484446,624
2022-04-24 20:22:47-04:00,15930,FtF3PVw8YNJseWPMcA2GEuQZ6nni1mq5kYPa2LrSzfkW,4yr1TM2dXrBvLNMpSaoryuGU2P8D3WG1ZCkvVzWFiQRH,True,793597650,191623755,1186396,593198,593198,2xTUy2RS74GJMMDnmFaegMzFLn19RVfYG4CibhBmjP1i,49133914,373310593,-324176679,619
2022-04-24 20:22:47-04:00,15931,CiomzdJ9g2bCskudk28cEU4aTgF6jYaerkiazbB7E3DA,9rxtTBmKoxPzhR4xoRH65Kmi7f3pEp1RanoeQq9V9RU5,False,12196953,12196953,760371,38018,722353,2xTUy2RS74GJMMDnmFaegMzFLn19RVfYG4CibhBmjP1i,760371,6232834,-5472463,623
2022-04-24 20:22:48-04:00,15932,FU7X4DWnGTbxwXULBq3v9SACzYhQyFGqsXjUDzyFqiem,925BaEnWxTfEv4oQb9Xf1wyyEEWEr8kXeSdXTtRfShfw,True,416320524,104080131,648530,324265,324265,DQCvC9mR68hJ3tJsUiddh6JwcBJAmntqGJR2nUsEq7yj,25941207,77143645,-51202438,623
2022-04-24 20:23:07-04:00,15933,3CxwyEadyRMxq6XyjjVAK4TB3we6dcLZf3GVCQLSDEPM,Bp12mixLHgc3L6CvzqzsyV4GLMrmxGiydZE4buJwsHmr,True,25885562,4618495,18235,9117,9118,A9TwRM1BMxqb8DCC7YNAMV6zPenEJm3HTZBy7wJKK58U,1022088,3752691,-2730603,394
2022-04-24 20:23:08-04:00,15934,5j5R1o3wXaL7cS9fxodLkrFjxPnujuX8boG7Zb9Fh9fs,4SZXsGqPoUy11ZKK5kNUpxCPK3ZcSxWMn12h4YREr9tS,True,174972567,33970804,124637,62318,62319,A2p75MbAbeUdHkPLkAjgGeiwuu9WPrkMHzjCkDXF1Xr3,6419682,24686458,-18266776,366
2022-04-24 20:23:34-04:00,15935,bYUscp4qgQap7iDu5R8tyBz73dov4j3zDV2FgDUvSDx,E4d8ank6Ymezu4ubD2tU5B5fXuoh2E1RQkrdaLgMfuaT,True,133597267,33399316,202658,101329,101329,DQCvC9mR68hJ3tJsUiddh6JwcBJAmntqGJR2nUsEq7yj,8106350,46953828,-38847478,606
2022-04-24 20:23:37-04:00,15936,BmWnnK7YPWCsoRPz61nZ4yBAUEHzwJbHEV2jZeG4vFe2,CfvRqcRNpTvTdFQXo1wGstFPA666HTLg83aN7yShyAb7,True,4250502604,1062625651,2774914,1387457,1387457,A2p75MbAbeUdHkPLkAjgGeiwuu9WPrkMHzjCkDXF1Xr3,110996593,598963122,-487966529,261
2022-04-24 20:23:38-04:00,15937,7zDNgPFeomS1hdQhuY8iGF3nnGMNnx1YrinZJetrefje,AKyG5R6Bac6Fu83ruL9FGpjKCfDKxbP6QfEGbCgqegiV,True,272551883,67899910,202429,101214,101215,gjBMZYVujDjD1ECG4i97M8Q3gV9ESnwwTSUGropkusj,8125573,21664295,-13538722,298
2022-04-24 20:23:39-04:00,15938,FhCW2CghBaoo1MkXUXUb4okam8g5beQofgs3WXerNYzn,HWSPdmF3hSnnfVe29Y5rDGSPqbMQv2ug1wYrdwJZNWFK,True,580187399,145046849,435083,217541,217542,2a35JJeTUW1pm6M3e8DHCjp8qr4vbc2cRPhuzZWyFzYd,17403340,41266425,-23863085,299
2022-04-24 20:23:51-04:00,15939,5j5R1o3wXaL7cS9fxodLkrFjxPnujuX8boG7Zb9Fh9fs,4SZXsGqPoUy11ZKK5kNUpxCPK3ZcSxWMn12h4YREr9tS,True,140144948,25282816,98107,49053,49054,2xTUy2RS74GJMMDnmFaegMzFLn19RVfYG4CibhBmjP1i,5438230,21061665,-15623435,388
2022-04-24 20:23:51-04:00,15940,3CxwyEadyRMxq6XyjjVAK4TB3we6dcLZf3GVCQLSDEPM,Bp12mixLHgc3L6CvzqzsyV4GLMrmxGiydZE4buJwsHmr,False,21140020,21140020,876805,43840,832965,2xTUy2RS74GJMMDnmFaegMzFLn19RVfYG4CibhBmjP1i,876806,3307760,-2430954,414
2022-04-24 20:23:56-04:00,15941,3662SX3YSARYupcxpgtTvUAPUsU7aJKsGxvpkNC1AV1A,HkAb86jdGHbz6VxrtbA81jPvjhiNHhbe82NBPFxnwzE5,True,46358617,11589654,67208,33604,33604,2a35JJeTUW1pm6M3e8DHCjp8qr4vbc2cRPhuzZWyFzYd,2688343,8801789,-6113446,579
2022-04-24 20:24:00-04:00,15942,7ueXVhSvXvttkeQ18w2cLh65naoEPvYF86RrdUK2Vc5Q,CKTehY1W6bw85cS4o7g2qXKjP4656Vwo37244BAEAiw1,True,1226248153,306558822,1787689,893844,893845,A9TwRM1BMxqb8DCC7YNAMV6zPenEJm3HTZBy7wJKK58U,71508337,310920436,-239412099,583
2022-04-24 20:24:02-04:00,15943,J6ndjmic8buVqwa4URRRgv2iTc4ekbYUHdcpa3DUCufN,7qvvczUw8ngwdQae49BiQwQmdV2SSWsAVV2tmZYL7gw6,True,9783953817,2445988454,14457948,7228974,7228974,A9TwRM1BMxqb8DCC7YNAMV6zPenEJm3HTZBy7wJKK58U,578317929,1941599412,-1363281483,591
2022-04-24 20:24:02-04:00,15944,8gxJEB4eSp5R8Z4Vy8TChcbLWPG93cVhpGLYWPuo4UMz,5dykor5kUojjBccSkbKqsHJ61voZWnD2MDuSNvsF6ohA,True,145551791,36387947,227416,113708,113708,2a35JJeTUW1pm6M3e8DHCjp8qr4vbc2cRPhuzZWyFzYd,9096651,44730297,-35633646,624
2022-04-24 20:24:12-04:00,15945,Br1j5Ftafei7ysu5SmqVZSoRe4uS4qCPeKSPHg55pyiE,G8fc7QvXjfkgBFvAVUgJFQS3VaF1biL9rktBExGa87Ks,True,82648875,20662218,118874,59437,59437,A2p75MbAbeUdHkPLkAjgGeiwuu9WPrkMHzjCkDXF1Xr3,4754975,17031104,-12276129,575
2022-04-24 20:24:14-04:00,15946,DufAyX9ifvrS5bqJip1mqtKSGnfFTt5CqxktLMNsuqb8,EiXfkhfnq6HzpYkTWSjNGCETn77gzxgveAr9DJ8TKprZ,True,155648837,38912209,242559,121279,121280,A9TwRM1BMxqb8DCC7YNAMV6zPenEJm3HTZBy7wJKK58U,9702387,54164665,-44462278,623
2022-04-24 20:24:19-04:00,15947,5r3YEyxbXrMEwYCFyZXS5t1eRLDahPFxPBBYNyMfHfcZ,7fnHdwm7JWHREPPk7dMud4vEoYZqsiRYCMo6ZSQqMwQc,True,71943037,9385827,58575,29287,29288,A9TwRM1BMxqb8DCC7YNAMV6zPenEJm3HTZBy7wJKK58U,4489842,33219495,-28729653,624
2022-04-24 20:24:30-04:00,15948,HxEjbaeXyjRYmxhkvPER7iuevx9R3AH9rdAtAu9r4zxL,HUXTVWjDHoKRNDEt4qXC9c7BpDtjB2tSNW7bXhHXsMk9,True,111578578,27894360,172637,86318,86319,2xTUy2RS74GJMMDnmFaegMzFLn19RVfYG4CibhBmjP1i,6905563,16057235,-9151672,618
2022-04-24 20:24:36-04:00,15949,BmWnnK7YPWCsoRPz61nZ4yBAUEHzwJbHEV2jZeG4vFe2,CfvRqcRNpTvTdFQXo1wGstFPA666HTLg83aN7yShyAb7,True,3173300765,793325191,2341137,1170568,1170569,2xTUy2RS74GJMMDnmFaegMzFLn19RVfYG4CibhBmjP1i,93645491,474351758,-380706267,295
2022-04-24 20:24:57-04:00,15950,7CSCMFa9W52tBDVUbXbc3woAy3GByeA1wPJdp3MgznPa,3447ptuVFu6G8B6N63RmS8mRv4n9PfHneypHLvbeaGLn,True,141569238,11808288,59650,29825,29825,2a35JJeTUW1pm6M3e8DHCjp8qr4vbc2cRPhuzZWyFzYd,7151506,57271497,-50119991,505
2022-04-24 20:25:13-04:00,15951,5wcyw2KsaCSSXaDocVzV8Yz9yHNG1E8TajEoeoBqiENL,2vuppCGeADLpY3sGJVLbmM5aRW3r5aHDgCBLS7QZoCg5,True,429767552,107441888,671183,335591,335592,A2p75MbAbeUdHkPLkAjgGeiwuu9WPrkMHzjCkDXF1Xr3,26847343,49028603,-22181260,624
2022-04-24 20:25:19-04:00,15952,2CcC3D56NXriBsSPjiAEXV2ajKs1t3Q6RDGT8qnonarY,TihwXEmfvuxSuYZHThxmKmVSiYtPa2bN386HxfpKVLs,True,4701027306,653412710,4650636,2325318,2325318,2a35JJeTUW1pm6M3e8DHCjp8qr4vbc2cRPhuzZWyFzYd,334593564,523358051,-188764487,711
2022-04-24 20:25:20-04:00,15953,9VojCEgzn99QRVPGKn6euGRQbM7Q86GZ6yHJQa7N3gv4,GW4GVNnUtEt68avsowddpmjoUTUyMvxV4c5kY3Gzz9fT,True,843059484,76747509,474560,237280,237280,3zqXX6kzhkbW3d4TwD2CNjMRwxTbREXySekvq37kfCNk,52129720,338779567,-286649847,618
2022-04-24 20:25:21-04:00,15954,2rLWe1XADCU93guPU6WgSW6x56gYNfif9bm11V93mJnv,BEGhQRm3fgSHeBtk2DYrXEBPKPRvS3sHyTNopmoBJxMs,True,23350935,5837733,34953,17476,17477,2py1FiYeL2f7J3HU36qiJz6TD6HCmiTN36RyxYtapQCZ,1398146,22868002,-21469856,598
2022-04-24 20:25:21-04:00,15955,6Zyz5SGNMpEtCBu7H2USCkJCKpAJxLJrdf7h8N1W4fwp,3TTgDXx7VPZtB7aJDMShctxL5Y5To2Ugz927CoHNRztJ,True,61269697,15317424,94334,47167,47167,HfEnetJ7uBSmZWCjBNxdvv9HEC5nsW4wDV7wu6WnhWan,3773371,29887317,-26113946,615
2022-04-24 20:25:46-04:00,15956,7X1UBUXhC59kzJKyroP6fe5GVtGCrVMZGKwbSnedkvwJ,5A24drY1wqNsjV6cABFfFx2D5BQ16m6vozbxvyUcXG4C,True,138470165,34617541,214394,107197,107197,A9TwRM1BMxqb8DCC7YNAMV6zPenEJm3HTZBy7wJKK58U,8575791,31354748,-22778957,619
2022-04-24 20:28:14-04:00,15957,7BEY9qatFJomsayFmky3h3dAbKhY5XkRGwMobJuxXYhQ,J8MK3tAQKreBUG2reXY6gqr1uhbHhcAZEcxsLQmG5Ntt,True,1573669072,393417268,2734225,1367112,1367113,2py1FiYeL2f7J3HU36qiJz6TD6HCmiTN36RyxYtapQCZ,109369001,422359364,-312990363,694
2022-04-24 20:29:47-04:00,15958,5g5EaEMiM2WQcfDpL3R3caYziX9xvGCFs9eVmmQdcgzS,J71CftCqiK1873fkVx9NGc7v7nvRZMYVBkGN3GhSPyeX,True,66257621,16564405,117739,58869,58870,A2p75MbAbeUdHkPLkAjgGeiwuu9WPrkMHzjCkDXF1Xr3,4709596,20658452,-15948856,710
2022-04-24 20:29:51-04:00,15959,D5VZNThkv6XD6bimPshD2J3PvbPXgCbivZuPfkVxgdjc,8C77LmMk4C3KvyEb1N3scdbAgwN7J45nAcv9tkL5namB,True,8920203570,2230050892,13888728,6944364,6944364,2xTUy2RS74GJMMDnmFaegMzFLn19RVfYG4CibhBmjP1i,555549120,1680411897,-1124862777,622
2022-04-24 20:33:56-04:00,15960,bYUscp4qgQap7iDu5R8tyBz73dov4j3zDV2FgDUvSDx,E4d8ank6Ymezu4ubD2tU5B5fXuoh2E1RQkrdaLgMfuaT,True,98372709,24593177,151961,75980,75981,6UQfSsLooL4pQKQfLtXCutQS2BnF7A7F7ewJopDLmUpc,6078450,37040002,-30961552,617
2022-04-24 20:34:21-04:00,15961,3662SX3YSARYupcxpgtTvUAPUsU7aJKsGxvpkNC1AV1A,HkAb86jdGHbz6VxrtbA81jPvjhiNHhbe82NBPFxnwzE5,True,34290958,8572739,53578,26789,26789,2xTUy2RS74GJMMDnmFaegMzFLn19RVfYG4CibhBmjP1i,2143130,7206294,-5063164,624
2022-04-24 20:34:28-04:00,15962,7ueXVhSvXvttkeQ18w2cLh65naoEPvYF86RrdUK2Vc5Q,CKTehY1W6bw85cS4o7g2qXKjP4656Vwo37244BAEAiw1,True,906441590,226607188,1411804,705902,705902,2xTUy2RS74GJMMDnmFaegMzFLn19RVfYG4CibhBmjP1i,56472967,249334039,-192861072,623
2022-04-24 20:34:35-04:00,15963,impmg97osZac6q2B4SjAewuVYdMu4kPAg9totcz9h9Y,7ytd7QqMrXK3bVLPsgWSQSTgyAZnmPsPoD42k4Frkbz,True,158853463,27705254,146124,73062,73062,2a35JJeTUW1pm6M3e8DHCjp8qr4vbc2cRPhuzZWyFzYd,8378397,15704208,-7325811,527
2022-04-24 20:42:12-04:00,15964,A5NXadGWnFZRoHEn1dKTRjcXgWmfMLMyJdpF4rQPZyRR,ALs3Zfotc4c4A6TFDMbd5GM5whK1dTYSnGrHiMBWmApH,True,480926264,120231092,751273,375636,375637,6UQfSsLooL4pQKQfLtXCutQS2BnF7A7F7ewJopDLmUpc,30051076,200131043,-170079967,624
2022-04-24 20:48:37-04:00,15965,Br1j5Ftafei7ysu5SmqVZSoRe4uS4qCPeKSPHg55pyiE,G8fc7QvXjfkgBFvAVUgJFQS3VaF1biL9rktBExGa87Ks,True,61169818,15292454,95481,47740,47741,A9TwRM1BMxqb8DCC7YNAMV6zPenEJm3HTZBy7wJKK58U,3819262,13843438,-10024176,624
2022-04-24 20:48:38-04:00,15966,68RZsaAJib9kw5xnnt9QhvsAa1DGJzww1MKqACsMvxGr,3z8H2C111LCABJymwxJAG9boicBXcJXq3ft6jqmV9rSw,True,139932037,34983009,249535,124767,124768,A9TwRM1BMxqb8DCC7YNAMV6zPenEJm3HTZBy7wJKK58U,9981404,28255933,-18274529,713
2022-04-24 20:48:48-04:00,15967,J6ndjmic8buVqwa4URRRgv2iTc4ekbYUHdcpa3DUCufN,7qvvczUw8ngwdQae49BiQwQmdV2SSWsAVV2tmZYL7gw6,True,7225329526,1806332381,11280603,5640301,5640302,2a35JJeTUW1pm6M3e8DHCjp8qr4vbc2cRPhuzZWyFzYd,451224144,1589649723,-1138425579,624
2022-04-24 20:49:46-04:00,15968,5r3YEyxbXrMEwYCFyZXS5t1eRLDahPFxPBBYNyMfHfcZ,7fnHdwm7JWHREPPk7dMud4vEoYZqsiRYCMo6ZSQqMwQc,True,61997721,8504550,53110,26555,26555,A2p75MbAbeUdHkPLkAjgGeiwuu9WPrkMHzjCkDXF1Xr3,3871778,28627677,-24755899,624
2022-04-24 20:49:48-04:00,15969,8gxJEB4eSp5R8Z4Vy8TChcbLWPG93cVhpGLYWPuo4UMz,5dykor5kUojjBccSkbKqsHJ61voZWnD2MDuSNvsF6ohA,True,106925310,26731327,165767,82883,82884,68sueyVfmy5ToEGtLFGDkwebX47xAmzyXE29z8JrmcWv,6630701,35595275,-28964574,620
2022-04-24 20:54:56-04:00,15970,BTwSuuDHNhQAFAzBZRWev5j1ix2RTWvjZAxLpw8grAxu,31NCyUpSXxxJYLSrdK3c5bLomUtMejobMfYnq7j71GtM,True,108091598,27022899,168601,84300,84301,6UQfSsLooL4pQKQfLtXCutQS2BnF7A7F7ewJopDLmUpc,6744063,22766889,-16022826,623
2022-04-24 20:55:13-04:00,15971,HxEjbaeXyjRYmxhkvPER7iuevx9R3AH9rdAtAu9r4zxL,HUXTVWjDHoKRNDEt4qXC9c7BpDtjB2tSNW7bXhHXsMk9,True,82060707,20514894,127733,63866,63867,A9TwRM1BMxqb8DCC7YNAMV6zPenEJm3HTZBy7wJKK58U,5109421,13597060,-8487639,622
2022-04-24 20:55:20-04:00,15972,HooxSzasW3HMoFJ6sAvRQ75Char1J5aBdJtsqfDV6myp,BCmsWwpGeV4NNfeKZKKydty2uueLGHYTJDk1WErpXsVT,True,85704513,21426128,132972,66486,66486,A9TwRM1BMxqb8DCC7YNAMV6zPenEJm3HTZBy7wJKK58U,5318913,27249587,-21930674,620
2022-04-24 20:55:23-04:00,15973,5j5R1o3wXaL7cS9fxodLkrFjxPnujuX8boG7Zb9Fh9fs,4SZXsGqPoUy11ZKK5kNUpxCPK3ZcSxWMn12h4YREr9tS,True,114215384,9666809,39723,19861,19862,A2p75MbAbeUdHkPLkAjgGeiwuu9WPrkMHzjCkDXF1Xr3,4693375,18143086,-13449711,410
2022-04-24 20:55:30-04:00,15974,9VojCEgzn99QRVPGKn6euGRQbM7Q86GZ6yHJQa7N3gv4,GW4GVNnUtEt68avsowddpmjoUTUyMvxV4c5kY3Gzz9fT,True,762190772,66937876,417457,208728,208729,DQCvC9mR68hJ3tJsUiddh6JwcBJAmntqGJR2nUsEq7yj,47533957,321304024,-273770067,623
2022-04-24 20:55:30-04:00,15975,6NJFN855M3Q3RLTDNo57gTgAmwPD6G2E3WvMb1m5eNCN,3YpqNnonsvXaRT4nCC3G5FZx1jjVtbDPc36LiR6WK5jR,True,970409919,242602479,1506660,753330,753330,2xTUy2RS74GJMMDnmFaegMzFLn19RVfYG4CibhBmjP1i,60266407,155985950,-95719543,621
2022-04-24 20:56:16-04:00,15976,FU7X4DWnGTbxwXULBq3v9SACzYhQyFGqsXjUDzyFqiem,925BaEnWxTfEv4oQb9Xf1wyyEEWEr8kXeSdXTtRfShfw,True,306072472,76518118,478118,239059,239059,A2p75MbAbeUdHkPLkAjgGeiwuu9WPrkMHzjCkDXF1Xr3,19124756,63699395,-44574639,624
2022-04-24 20:59:24-04:00,15977,5o4EAqBTiUKn41QhPL5kRjrGTgQVdP7xLtxC7xNxjkwn,E8gDreu3LxW1EHJ8hnqChK9QdffGh5GocJYKdrbYat8E,True,861614661,215403665,1342597,671298,671299,gjBMZYVujDjD1ECG4i97M8Q3gV9ESnwwTSUGropkusj,53703895,221684164,-167980269,623
2022-04-24 21:05:17-04:00,15978,7zDNgPFeomS1hdQhuY8iGF3nnGMNnx1YrinZJetrefje,AKyG5R6Bac6Fu83ruL9FGpjKCfDKxbP6QfEGbCgqegiV,True,202903861,50489643,153631,76815,76816,A9TwRM1BMxqb8DCC7YNAMV6zPenEJm3HTZBy7wJKK58U,6174060,18090592,-11916532,304
2022-04-24 21:05:20-04:00,15979,FhCW2CghBaoo1MkXUXUb4okam8g5beQofgs3WXerNYzn,HWSPdmF3hSnnfVe29Y5rDGSPqbMQv2ug1wYrdwJZNWFK,True,431067549,107766887,322332,161166,161166,A9TwRM1BMxqb8DCC7YNAMV6zPenEJm3HTZBy7wJKK58U,12893307,34874660,-21981353,299
2022-04-24 21:16:24-04:00,15980,7mhEMbGEpSYgYoZx6WvApjysTxsPqpCDSJCmKF45x3n6,12J2purUC4QYjaPKZwL3Y5P1JikTBD3oY9pLgY6yt6am,True,2548533976,637133494,4544097,2272048,2272049,A9TwRM1BMxqb8DCC7YNAMV6zPenEJm3HTZBy7wJKK58U,181763881,342647725,-160883844,713
2022-04-24 21:39:06-04:00,15981,6RuQVU9nu2Ecp177M9ggWczLACvQ8PfT31RTcmfwe9Hq,DZgsgqvMNLTXkBxySZC7Monak2JGsXRMJT4hBQzpf6Xm,True,789394240,197348560,1398551,699275,699276,DQCvC9mR68hJ3tJsUiddh6JwcBJAmntqGJR2nUsEq7yj,55942066,99397045,-43454979,708
2022-04-24 23:03:24-04:00,15982,3uUdWwgwtFdPa3FJTSrirqPKMtQb3zmT5Wpp4zPy9sJP,5G7dhz8jvWekGy9Wh3ZCXNXSPbB1QArfFYs7MYNgRDkW,False,14934632,14934632,924609,46230,878379,2xTUy2RS74GJMMDnmFaegMzFLn19RVfYG4CibhBmjP1i,924609,7811041,-6886432,619
2022-04-25 00:35:17-04:00,15983,AXBfrbCpYAWKN5jgDVVMiKXscQ96YtotKV3DT6XSzm9o,Dh3SiHAqrQzPQnTLRMxtBn2EFyHNgyfnYGpgcuNGTvyL,True,1580565483,395141370,2464669,1232334,1232335,gjBMZYVujDjD1ECG4i97M8Q3gV9ESnwwTSUGropkusj,98586785,424870569,-326283784,623
2022-04-25 01:43:46-04:00,15984,5wcyw2KsaCSSXaDocVzV8Yz9yHNG1E8TajEoeoBqiENL,2vuppCGeADLpY3sGJVLbmM5aRW3r5aHDgCBLS7QZoCg5,True,316041027,79010256,493461,246730,246731,DQCvC9mR68hJ3tJsUiddh6JwcBJAmntqGJR2nUsEq7yj,19738464,42664987,-22926523,624
2022-04-25 01:44:14-04:00,15985,7AizMrxWWr7qfneuXMy6ifL3BVDTAKkuud4PyZFy92kh,GyAWRRfQkVAXtyhVF14vU3kPMr4kG1VyA9FAHdDTr8ud,True,18129280,4532320,28300,14150,14150,gjBMZYVujDjD1ECG4i97M8Q3gV9ESnwwTSUGropkusj,1132003,6832486,-5700483,624
2022-04-25 01:46:36-04:00,15986,7X1UBUXhC59kzJKyroP6fe5GVtGCrVMZGKwbSnedkvwJ,5A24drY1wqNsjV6cABFfFx2D5BQ16m6vozbxvyUcXG4C,True,101909567,25477391,159222,79611,79611,2a35JJeTUW1pm6M3e8DHCjp8qr4vbc2cRPhuzZWyFzYd,6368913,25396872,-19027959,624
2022-04-25 01:47:37-04:00,15987,FtF3PVw8YNJseWPMcA2GEuQZ6nni1mq5kYPa2LrSzfkW,4yr1TM2dXrBvLNMpSaoryuGU2P8D3WG1ZCkvVzWFiQRH,True,590773559,140956778,868737,434368,434369,2a35JJeTUW1pm6M3e8DHCjp8qr4vbc2cRPhuzZWyFzYd,36410268,292673547,-256263279,616
2022-04-25 01:50:58-04:00,15988,bYUscp4qgQap7iDu5R8tyBz73dov4j3zDV2FgDUvSDx,E4d8ank6Ymezu4ubD2tU5B5fXuoh2E1RQkrdaLgMfuaT,True,72391765,18097941,112587,56293,56294,DQCvC9mR68hJ3tJsUiddh6JwcBJAmntqGJR2nUsEq7yj,4503480,29112802,-24609322,622
2022-04-25 01:51:16-04:00,15989,8qq2gfbca7JXvq4gViBBVT2QAbM4MvBMEQLXgn8UUTvt,3o5jpBVYdFFEYrGRdCUkLrUC85wsuTKgy8iYwnpZyC1B,True,494381889,42545296,213797,106898,106899,3zqXX6kzhkbW3d4TwD2CNjMRwxTbREXySekvq37kfCNk,24843522,253710368,-228866846,502
2022-04-25 02:03:30-04:00,15990,3662SX3YSARYupcxpgtTvUAPUsU7aJKsGxvpkNC1AV1A,HkAb86jdGHbz6VxrtbA81jPvjhiNHhbe82NBPFxnwzE5,True,25219510,6304877,39370,19685,19685,2xTUy2RS74GJMMDnmFaegMzFLn19RVfYG4CibhBmjP1i,1574837,5870961,-4296124,624
2022-04-25 02:03:37-04:00,15991,7ueXVhSvXvttkeQ18w2cLh65naoEPvYF86RrdUK2Vc5Q,CKTehY1W6bw85cS4o7g2qXKjP4656Vwo37244BAEAiw1,True,666067228,166513597,1021740,510870,510870,3zqXX6kzhkbW3d4TwD2CNjMRwxTbREXySekvq37kfCNk,40870437,199313522,-158443085,613
2022-04-25 02:03:39-04:00,15992,Br1j5Ftafei7ysu5SmqVZSoRe4uS4qCPeKSPHg55pyiE,G8fc7QvXjfkgBFvAVUgJFQS3VaF1biL9rktBExGa87Ks,True,44993214,11248303,70275,35137,35138,2a35JJeTUW1pm6M3e8DHCjp8qr4vbc2cRPhuzZWyFzYd,2811016,11213433,-8402417,624
2022-04-25 02:03:39-04:00,15993,impmg97osZac6q2B4SjAewuVYdMu4kPAg9totcz9h9Y,7ytd7QqMrXK3bVLPsgWSQSTgyAZnmPsPoD42k4Frkbz,True,129516730,20351383,102814,51407,51407,DQCvC9mR68hJ3tJsUiddh6JwcBJAmntqGJR2nUsEq7yj,6543190,12908829,-6365639,505
2022-04-25 02:03:47-04:00,15994,J6ndjmic8buVqwa4URRRgv2iTc4ekbYUHdcpa3DUCufN,7qvvczUw8ngwdQae49BiQwQmdV2SSWsAVV2tmZYL7gw6,True,5313167003,1328291750,8268164,4134082,4134082,2a35JJeTUW1pm6M3e8DHCjp8qr4vbc2cRPhuzZWyFzYd,330726566,1292235120,-961508554,622
2022-04-25 02:05:55-04:00,15995,D5VZNThkv6XD6bimPshD2J3PvbPXgCbivZuPfkVxgdjc,8C77LmMk4C3KvyEb1N3scdbAgwN7J45nAcv9tkL5namB,True,6563101492,1640775373,10199207,5099603,5099604,2xTUy2RS74GJMMDnmFaegMzFLn19RVfYG4CibhBmjP1i,407968315,1380931710,-972963395,621
2022-04-25 02:05:55-04:00,15996,8gxJEB4eSp5R8Z4Vy8TChcbLWPG93cVhpGLYWPuo4UMz,5dykor5kUojjBccSkbKqsHJ61voZWnD2MDuSNvsF6ohA,True,78689292,19672323,122748,61374,61374,2py1FiYeL2f7J3HU36qiJz6TD6HCmiTN36RyxYtapQCZ,4909932,28138502,-23228570,623
2022-04-25 02:05:57-04:00,15997,7CSCMFa9W52tBDVUbXbc3woAy3GByeA1wPJdp3MgznPa,3447ptuVFu6G8B6N63RmS8mRv4n9PfHneypHLvbeaGLn,True,129149639,10828128,53949,26974,26975,2a35JJeTUW1pm6M3e8DHCjp8qr4vbc2cRPhuzZWyFzYd,6434660,52903175,-46468515,498
2022-04-25 02:06:22-04:00,15998,EUHZeJkyUdeEzZP2hThoMTpfUJoZwoPqUus3hrnDkHUQ,7pbzABMyUg2d5LyUdo9rYM8MdrgcMt2MQ7EejmfG6kbN,True,153392347,38348086,239432,119716,119716,2py1FiYeL2f7J3HU36qiJz6TD6HCmiTN36RyxYtapQCZ,9577302,56414754,-46837452,624
2022-04-25 02:06:57-04:00,15999,HxEjbaeXyjRYmxhkvPER7iuevx9R3AH9rdAtAu9r4zxL,HUXTVWjDHoKRNDEt4qXC9c7BpDtjB2tSNW7bXhHXsMk9,True,60361546,15090101,93966,46983,46983,DQCvC9mR68hJ3tJsUiddh6JwcBJAmntqGJR2nUsEq7yj,3758725,11308937,-7550212,622
2022-04-25 02:07:03-04:00,16000,9VojCEgzn99QRVPGKn6euGRQbM7Q86GZ6yHJQa7N3gv4,GW4GVNnUtEt68avsowddpmjoUTUyMvxV4c5kY3Gzz9fT,True,691836413,66408059,414672,207336,207336,DQCvC9mR68hJ3tJsUiddh6JwcBJAmntqGJR2nUsEq7yj,43200427,292401323,-249200896,624
2022-04-25 02:07:15-04:00,16001,6NJFN855M3Q3RLTDNo57gTgAmwPD6G2E3WvMb1m5eNCN,3YpqNnonsvXaRT4nCC3G5FZx1jjVtbDPc36LiR6WK5jR,True,714045173,178511293,1113484,556742,556742,2a35JJeTUW1pm6M3e8DHCjp8qr4vbc2cRPhuzZWyFzYd,44539376,130123256,-85583880,623
2022-04-25 02:07:45-04:00,16002,DufAyX9ifvrS5bqJip1mqtKSGnfFTt5CqxktLMNsuqb8,EiXfkhfnq6HzpYkTWSjNGCETn77gzxgveAr9DJ8TKprZ,True,114514877,28628719,178783,89391,89392,2a35JJeTUW1pm6M3e8DHCjp8qr4vbc2cRPhuzZWyFzYd,7151348,42720354,-35569006,624
2022-04-25 02:09:11-04:00,16003,HHp8dRc1YMWE93uyLdM98DkUhM8U8zm3JC59chrbbWrk,AdqFuGe28VeAwwjRPZCBGVy5ftf9zNNQkg413i66wyig,True,48292466,12073116,75428,37714,37714,2a35JJeTUW1pm6M3e8DHCjp8qr4vbc2cRPhuzZWyFzYd,3017126,15602683,-12585557,624
2022-04-25 02:11:56-04:00,16004,FU7X4DWnGTbxwXULBq3v9SACzYhQyFGqsXjUDzyFqiem,925BaEnWxTfEv4oQb9Xf1wyyEEWEr8kXeSdXTtRfShfw,True,225187340,56296835,351258,175629,175629,2a35JJeTUW1pm6M3e8DHCjp8qr4vbc2cRPhuzZWyFzYd,14050348,51851064,-37800716,623
2022-04-25 02:12:35-04:00,16005,7CSCMFa9W52tBDVUbXbc3woAy3GByeA1wPJdp3MgznPa,3447ptuVFu6G8B6N63RmS8mRv4n9PfHneypHLvbeaGLn,True,117669254,8726888,42484,21242,21242,A9TwRM1BMxqb8DCC7YNAMV6zPenEJm3HTZBy7wJKK58U,5728454,48585355,-42856901,486
2022-04-25 02:12:36-04:00,16006,5r3YEyxbXrMEwYCFyZXS5t1eRLDahPFxPBBYNyMfHfcZ,7fnHdwm7JWHREPPk7dMud4vEoYZqsiRYCMo6ZSQqMwQc,True,53024909,6897266,43065,21532,21533,DQCvC9mR68hJ3tJsUiddh6JwcBJAmntqGJR2nUsEq7yj,3310811,25790492,-22479681,624
2022-04-25 02:12:52-04:00,16007,2rLWe1XADCU93guPU6WgSW6x56gYNfif9bm11V93mJnv,BEGhQRm3fgSHeBtk2DYrXEBPKPRvS3sHyTNopmoBJxMs,True,17239087,4309771,26899,13449,13450,A2p75MbAbeUdHkPLkAjgGeiwuu9WPrkMHzjCkDXF1Xr3,1075972,17452499,-16376527,624
2022-04-25 02:13:22-04:00,16008,AXBfrbCpYAWKN5jgDVVMiKXscQ96YtotKV3DT6XSzm9o,Dh3SiHAqrQzPQnTLRMxtBn2EFyHNgyfnYGpgcuNGTvyL,True,1162186667,290546666,1813032,906516,906516,A9TwRM1BMxqb8DCC7YNAMV6zPenEJm3HTZBy7wJKK58U,72521314,340548103,-268026789,624
2022-04-25 02:16:08-04:00,16009,3RpbaFEL5ZYrQBPpaAeCUXs43Ssdr5Tm4ScMGtp6XbYF,CpKGwcVZrd3vKTNhdF8xNsd77FT3QxQWb7xFQxiyPB5p,True,26174852594,6543713148,40819809,20409904,20409905,2py1FiYeL2f7J3HU36qiJz6TD6HCmiTN36RyxYtapQCZ,1632792399,5919710357,-4286917958,623
2022-04-25 02:16:48-04:00,16010,C4k1drtNpR2axjxWk6DMreczYo3kdRc95u49HUAzpS42,2xRS27CLv9ynXa6F7w7SESPtK1ryBcf5BFeAB59N5cWF,True,26965224,6741306,42046,21023,21023,A9TwRM1BMxqb8DCC7YNAMV6zPenEJm3HTZBy7wJKK58U,1681843,8652126,-6970283,623
2022-04-25 02:44:18-04:00,16011,8fVwuVA2CL5sZoHh6Dg4MBpcX3cvoUm7mnitnpQSdPBD,4F4ccaNm1KQu29XvsKvdjFkmpsbWqNvXkV41851EYQyu,True,220106022,18938765,97147,48573,48574,6UQfSsLooL4pQKQfLtXCutQS2BnF7A7F7ewJopDLmUpc,11290475,52929542,-41639067,512
2022-04-25 02:50:54-04:00,16012,9VojCEgzn99QRVPGKn6euGRQbM7Q86GZ6yHJQa7N3gv4,GW4GVNnUtEt68avsowddpmjoUTUyMvxV4c5kY3Gzz9fT,True,621319078,56410486,351149,175574,175575,2a35JJeTUW1pm6M3e8DHCjp8qr4vbc2cRPhuzZWyFzYd,38676479,264646066,-225969587,622
2022-04-25 02:51:02-04:00,16013,6Zyz5SGNMpEtCBu7H2USCkJCKpAJxLJrdf7h8N1W4fwp,3TTgDXx7VPZtB7aJDMShctxL5Y5To2Ugz927CoHNRztJ,True,45124276,11281069,70416,35208,35208,6UQfSsLooL4pQKQfLtXCutQS2BnF7A7F7ewJopDLmUpc,2816651,23230202,-20413551,624
2022-04-25 02:51:45-04:00,16014,5j5R1o3wXaL7cS9fxodLkrFjxPnujuX8boG7Zb9Fh9fs,4SZXsGqPoUy11ZKK5kNUpxCPK3ZcSxWMn12h4YREr9tS,True,103979117,18854828,73787,36893,36894,2a35JJeTUW1pm6M3e8DHCjp8qr4vbc2cRPhuzZWyFzYd,4069208,16916484,-12847276,391
2022-04-25 02:51:57-04:00,16015,5wcyw2KsaCSSXaDocVzV8Yz9yHNG1E8TajEoeoBqiENL,2vuppCGeADLpY3sGJVLbmM5aRW3r5aHDgCBLS7QZoCg5,True,232224415,58056103,360106,180053,180053,GXyFXZMNk2NFyEzw6JetVqsujqcz2yCixH7n8EpDJYWD,14404273,36408831,-22004558,620
2022-04-25 02:52:26-04:00,16016,68RZsaAJib9kw5xnnt9QhvsAa1DGJzww1MKqACsMvxGr,3z8H2C111LCABJymwxJAG9boicBXcJXq3ft6jqmV9rSw,True,102526214,25631553,182605,91302,91303,GXyFXZMNk2NFyEzw6JetVqsujqcz2yCixH7n8EpDJYWD,7304234,23434825,-16130591,712
2022-04-25 02:53:03-04:00,16017,7CSCMFa9W52tBDVUbXbc3woAy3GByeA1wPJdp3MgznPa,3447ptuVFu6G8B6N63RmS8mRv4n9PfHneypHLvbeaGLn,True,108410888,8015920,38112,19056,19056,2py1FiYeL2f7J3HU36qiJz6TD6HCmiTN36RyxYtapQCZ,5154492,45216441,-40061949,475
2022-04-25 02:53:24-04:00,16018,7X1UBUXhC59kzJKyroP6fe5GVtGCrVMZGKwbSnedkvwJ,5A24drY1wqNsjV6cABFfFx2D5BQ16m6vozbxvyUcXG4C,True,74909779,18727444,116904,58452,58452,2a35JJeTUW1pm6M3e8DHCjp8qr4vbc2cRPhuzZWyFzYd,4676194,20469942,-15793748,624
2022-04-25 02:53:55-04:00,16019,7BEY9qatFJomsayFmky3h3dAbKhY5XkRGwMobJuxXYhQ,J8MK3tAQKreBUG2reXY6gqr1uhbHhcAZEcxsLQmG5Ntt,True,1156806217,289201554,2063025,1031512,1031513,2py1FiYeL2f7J3HU36qiJz6TD6HCmiTN36RyxYtapQCZ,82521022,340932683,-258411661,713
2022-04-25 02:54:04-04:00,16020,5r3YEyxbXrMEwYCFyZXS5t1eRLDahPFxPBBYNyMfHfcZ,7fnHdwm7JWHREPPk7dMud4vEoYZqsiRYCMo6ZSQqMwQc,True,45701838,6298114,39164,19582,19582,GXyFXZMNk2NFyEzw6JetVqsujqcz2yCixH7n8EpDJYWD,2841941,22205374,-19363433,621
2022-04-25 02:54:10-04:00,16021,EFHg5FatMRRSZnKJPJF9e1iw2cjPJRmwTTZYtkHno9DP,84LnLKhZDJgWFnbBYnYjqWkjymemXfidecPFwnUAvuFj,True,1126858767,281714691,848689,424344,424345,A2p75MbAbeUdHkPLkAjgGeiwuu9WPrkMHzjCkDXF1Xr3,33947582,119037980,-85090398,301
2022-04-25 02:54:47-04:00,16022,djW9rVm1v4nW64QiVqgFUCRza24VqthDcSfVEyRHPed,EsXvQmXVXECqZPtmSdiuwieHPP5jsmyn67p78vHaJcqq,True,1051795518,262948879,794312,397156,397156,gjBMZYVujDjD1ECG4i97M8Q3gV9ESnwwTSUGropkusj,31772489,61905097,-30132608,302
2022-04-25 02:54:47-04:00,16023,FtF3PVw8YNJseWPMcA2GEuQZ6nni1mq5kYPa2LrSzfkW,4yr1TM2dXrBvLNMpSaoryuGU2P8D3WG1ZCkvVzWFiQRH,True,441169699,103657398,630314,315157,315157,2xTUy2RS74GJMMDnmFaegMzFLn19RVfYG4CibhBmjP1i,26826424,229634022,-202807598,608
2022-04-25 02:54:48-04:00,16024,7AizMrxWWr7qfneuXMy6ifL3BVDTAKkuud4PyZFy92kh,GyAWRRfQkVAXtyhVF14vU3kPMr4kG1VyA9FAHdDTr8ud,False,13320471,13320471,825046,41252,783794,2py1FiYeL2f7J3HU36qiJz6TD6HCmiTN36RyxYtapQCZ,825046,5376905,-4551859,619
2022-04-25 02:55:02-04:00,16025,9VojCEgzn99QRVPGKn6euGRQbM7Q86GZ6yHJQa7N3gv4,GW4GVNnUtEt68avsowddpmjoUTUyMvxV4c5kY3Gzz9fT,True,561674885,49228329,307562,153781,153781,gjBMZYVujDjD1ECG4i97M8Q3gV9ESnwwTSUGropkusj,35091623,250392847,-215301224,624
2022-04-25 02:55:25-04:00,16026,impmg97osZac6q2B4SjAewuVYdMu4kPAg9totcz9h9Y,7ytd7QqMrXK3bVLPsgWSQSTgyAZnmPsPoD42k4Frkbz,True,107934899,15080719,72793,36396,36397,GXyFXZMNk2NFyEzw6JetVqsujqcz2yCixH7n8EpDJYWD,5209928,10434536,-5224608,482
2022-04-25 02:55:30-04:00,16027,BTq6T9nDzYTPTRvxkhNLn82DF3RCWdRkatZUmSTGCu43,3Uuhmxo4tWMbrqowx2bQSJeWzMykUUcZanj29ptCmEa6,True,843648645,90275494,396970,198485,198485,3zqXX6kzhkbW3d4TwD2CNjMRwxTbREXySekvq37kfCNk,37097932,285956591,-248858659,439
2022-04-25 02:55:32-04:00,16028,BTwSuuDHNhQAFAzBZRWev5j1ix2RTWvjZAxLpw8grAxu,31NCyUpSXxxJYLSrdK3c5bLomUtMejobMfYnq7j71GtM,True,79470868,19867717,124035,62017,62018,DQCvC9mR68hJ3tJsUiddh6JwcBJAmntqGJR2nUsEq7yj,4961424,18576497,-13615073,624
2022-04-25 02:55:39-04:00,16029,HooxSzasW3HMoFJ6sAvRQ75Char1J5aBdJtsqfDV6myp,BCmsWwpGeV4NNfeKZKKydty2uueLGHYTJDk1WErpXsVT,True,63030772,15757693,98136,49068,49068,2a35JJeTUW1pm6M3e8DHCjp8qr4vbc2cRPhuzZWyFzYd,3925457,21621160,-17695703,622
2022-04-25 02:55:40-04:00,16030,BmWnnK7YPWCsoRPz61nZ4yBAUEHzwJbHEV2jZeG4vFe2,CfvRqcRNpTvTdFQXo1wGstFPA666HTLg83aN7yShyAb7,True,2355531096,588882774,1664273,832136,832137,2a35JJeTUW1pm6M3e8DHCjp8qr4vbc2cRPhuzZWyFzYd,66570938,376632214,-310061276,282
2022-04-25 02:55:45-04:00,16031,7CSCMFa9W52tBDVUbXbc3woAy3GByeA1wPJdp3MgznPa,3447ptuVFu6G8B6N63RmS8mRv4n9PfHneypHLvbeaGLn,True,99872217,6483496,29820,14910,14910,C4UnXuShCvjSMgBAgVNMy1oakxCNk1et27A82fywU112,4593629,41875229,-37281600,459
2022-04-25 02:55:46-04:00,16032,5j5R1o3wXaL7cS9fxodLkrFjxPnujuX8boG7Zb9Fh9fs,4SZXsGqPoUy11ZKK5kNUpxCPK3ZcSxWMn12h4YREr9tS,True,84551677,7109118,28778,14389,14389,HfEnetJ7uBSmZWCjBNxdvv9HEC5nsW4wDV7wu6WnhWan,3422809,14620020,-11197211,404
2022-04-25 02:56:00-04:00,16033,5o4EAqBTiUKn41QhPL5kRjrGTgQVdP7xLtxC7xNxjkwn,E8gDreu3LxW1EHJ8hnqChK9QdffGh5GocJYKdrbYat8E,True,633439318,158359829,986503,493251,493252,3zqXX6kzhkbW3d4TwD2CNjMRwxTbREXySekvq37kfCNk,39460149,178225095,-138764946,622
2022-04-25 02:56:00-04:00,16034,8fVwuVA2CL5sZoHh6Dg4MBpcX3cvoUm7mnitnpQSdPBD,4F4ccaNm1KQu29XvsKvdjFkmpsbWqNvXkV41851EYQyu,True,200028078,16892561,84907,42453,42454,gjBMZYVujDjD1ECG4i97M8Q3gV9ESnwwTSUGropkusj,10054149,52321634,-42267485,502
2022-04-25 02:56:06-04:00,16035,bYUscp4qgQap7iDu5R8tyBz73dov4j3zDV2FgDUvSDx,E4d8ank6Ymezu4ubD2tU5B5fXuoh2E1RQkrdaLgMfuaT,True,53194117,13298529,82081,41040,41041,2xTUy2RS74GJMMDnmFaegMzFLn19RVfYG4CibhBmjP1i,3283272,22840189,-19556917,617
2022-04-25 02:56:07-04:00,16036,D8hA6qzDLFSTbkwvEdBsFZz5ykzuLP96FPhYh4uSh2PW,Bdj1hZnx27FrEw6wMKDheBFWFFDaKUdiq8Sv6WhL5gc5,True,82649249,20662312,126640,63320,63320,2xTUy2RS74GJMMDnmFaegMzFLn19RVfYG4CibhBmjP1i,5065639,22406479,-17340840,612
2022-04-25 02:56:23-04:00,16037,5g5EaEMiM2WQcfDpL3R3caYziX9xvGCFs9eVmmQdcgzS,J71CftCqiK1873fkVx9NGc7v7nvRZMYVBkGN3GhSPyeX,True,48598710,12149677,86729,43364,43365,A9TwRM1BMxqb8DCC7YNAMV6zPenEJm3HTZBy7wJKK58U,3469168,16525727,-13056559,713
2022-04-25 02:56:29-04:00,16038,7zDNgPFeomS1hdQhuY8iGF3nnGMNnx1YrinZJetrefje,AKyG5R6Bac6Fu83ruL9FGpjKCfDKxbP6QfEGbCgqegiV,True,150996582,37517768,114270,57135,57135,A9TwRM1BMxqb8DCC7YNAMV6zPenEJm3HTZBy7wJKK58U,4599017,14969096,-10370079,304
2022-04-25 02:56:52-04:00,16039,D5VZNThkv6XD6bimPshD2J3PvbPXgCbivZuPfkVxgdjc,8C77LmMk4C3KvyEb1N3scdbAgwN7J45nAcv9tkL5namB,True,4825802590,1206450647,7531139,3765569,3765570,gjBMZYVujDjD1ECG4i97M8Q3gV9ESnwwTSUGropkusj,301245579,1128754299,-827508720,624
2022-04-25 02:57:00-04:00,16040,A5NXadGWnFZRoHEn1dKTRjcXgWmfMLMyJdpF4rQPZyRR,ALs3Zfotc4c4A6TFDMbd5GM5whK1dTYSnGrHiMBWmApH,True,353759871,88439507,552379,276189,276190,gjBMZYVujDjD1ECG4i97M8Q3gV9ESnwwTSUGropkusj,22095287,156598592,-134503305,624
2022-04-25 02:57:26-04:00,16041,FhCW2CghBaoo1MkXUXUb4okam8g5beQofgs3WXerNYzn,HWSPdmF3hSnnfVe29Y5rDGSPqbMQv2ug1wYrdwJZNWFK,True,320380068,80095017,241094,120547,120547,6UQfSsLooL4pQKQfLtXCutQS2BnF7A7F7ewJopDLmUpc,9643772,29056561,-19412789,301
2022-04-25 02:58:03-04:00,16042,3qaXKaNNT8mpC4KnA868wYkDCojg8ukUVxN19dtfYbPM,5o21p7NCXgv5cYPtBqQVvR3Ses6mHceYgCNmd5VL3tkG,True,371688563,34260100,160729,80364,80365,GXyFXZMNk2NFyEzw6JetVqsujqcz2yCixH7n8EpDJYWD,17437581,71181973,-53744392,469
2022-04-25 02:58:27-04:00,16043,8qq2gfbca7JXvq4gViBBVT2QAbM4MvBMEQLXgn8UUTvt,3o5jpBVYdFFEYrGRdCUkLrUC85wsuTKgy8iYwnpZyC1B,True,446520443,34454506,169610,84805,84805,2a35JJeTUW1pm6M3e8DHCjp8qr4vbc2cRPhuzZWyFzYd,21981035,216908707,-194927672,492
2022-04-25 02:58:52-04:00,16044,AgokoeqypXXfMsjAyBXPRrJFGeP7B7D6SXvnGUTwMdap,53zBz3fTZisWQH1v6NHyhCdpLXx5NaPNp7uW9KPXLDan,False,1383335,1383335,86442,4322,82120,2a35JJeTUW1pm6M3e8DHCjp8qr4vbc2cRPhuzZWyFzYd,86442,955155,-868713,624
2022-04-25 02:58:55-04:00,16045,3662SX3YSARYupcxpgtTvUAPUsU7aJKsGxvpkNC1AV1A,HkAb86jdGHbz6VxrtbA81jPvjhiNHhbe82NBPFxnwzE5,True,18510673,4627668,28287,14143,14144,6UQfSsLooL4pQKQfLtXCutQS2BnF7A7F7ewJopDLmUpc,1131507,4757584,-3626077,611
2022-04-25 02:58:56-04:00,16046,7ueXVhSvXvttkeQ18w2cLh65naoEPvYF86RrdUK2Vc5Q,CKTehY1W6bw85cS4o7g2qXKjP4656Vwo37244BAEAiw1,True,489708954,122424052,750085,375042,375043,gjBMZYVujDjD1ECG4i97M8Q3gV9ESnwwTSUGropkusj,30004206,158697543,-128693337,612
2022-04-25 03:01:53-04:00,16047,9VojCEgzn99QRVPGKn6euGRQbM7Q86GZ6yHJQa7N3gv4,GW4GVNnUtEt68avsowddpmjoUTUyMvxV4c5kY3Gzz9fT,True,509403763,48905118,303905,151952,151953,68sueyVfmy5ToEGtLFGDkwebX47xAmzyXE29z8JrmcWv,31655341,228915236,-197259895,621
2022-04-25 03:02:35-04:00,16048,CYcgATWjZUXrqxJyVTEMkDBv1eyUjb1TZi2raTd1ujvU,7jefj3noz9JDDnJ74YZL946EPJtywSnPsi7ZpgU4Wj1G,False,3446636,3446636,205853,10292,195561,2py1FiYeL2f7J3HU36qiJz6TD6HCmiTN36RyxYtapQCZ,205853,2014992,-1809139,597
2022-04-25 03:02:36-04:00,16049,EUHZeJkyUdeEzZP2hThoMTpfUJoZwoPqUus3hrnDkHUQ,7pbzABMyUg2d5LyUdo9rYM8MdrgcMt2MQ7EejmfG6kbN,True,112738361,28184590,175322,87661,87661,DQCvC9mR68hJ3tJsUiddh6JwcBJAmntqGJR2nUsEq7yj,7012919,44447452,-37434533,622
2022-04-25 03:02:51-04:00,16050,7CSCMFa9W52tBDVUbXbc3woAy3GByeA1wPJdp3MgznPa,3447ptuVFu6G8B6N63RmS8mRv4n9PfHneypHLvbeaGLn,True,93029770,12460222,56227,28113,28114,GXyFXZMNk2NFyEzw6JetVqsujqcz2yCixH7n8EpDJYWD,4198061,39282111,-35084050,451
2022-04-25 03:02:51-04:00,16051,4ne6vC7qdxQYHJCsaeFAKZrKdFt2SwXGHQ3jrMHqt4DL,Cf1dLHY2WXH9rXbRKq5TT8THbdo9SdNUZq4rYhRCF9z,False,19071,19071,1169,58,1111,68sueyVfmy5ToEGtLFGDkwebX47xAmzyXE29z8JrmcWv,1169,17019,-15850,612
2022-04-25 03:02:54-04:00,16052,5r3YEyxbXrMEwYCFyZXS5t1eRLDahPFxPBBYNyMfHfcZ,7fnHdwm7JWHREPPk7dMud4vEoYZqsiRYCMo6ZSQqMwQc,True,39033112,5086484,31605,15802,15803,A2p75MbAbeUdHkPLkAjgGeiwuu9WPrkMHzjCkDXF1Xr3,2425386,20020758,-17595372,621
2022-04-25 03:02:59-04:00,16053,EAtQUZAkQxwJF779DwPcWHZ455FzYX8mzm1uV5LBnhPB,8h8t6GW1Y7xMBfWpfyFfUVBP4apMbJVNg7igZUYZLsyr,False,116366,116366,7186,359,6827,68sueyVfmy5ToEGtLFGDkwebX47xAmzyXE29z8JrmcWv,7186,81055,-73869,617
2022-04-25 03:03:06-04:00,16054,8fVwuVA2CL5sZoHh6Dg4MBpcX3cvoUm7mnitnpQSdPBD,4F4ccaNm1KQu29XvsKvdjFkmpsbWqNvXkV41851EYQyu,True,182104793,13987983,68560,34280,34280,DQCvC9mR68hJ3tJsUiddh6JwcBJAmntqGJR2nUsEq7yj,8925644,45041729,-36116085,490
2022-04-25 03:03:06-04:00,16055,DBpCYPg3XaURq987o1MQwphyzjmD7VTWAjfQDgPw95aD,CNdhCvdP6ajoYKwRnsc2W3eahwUW4MZb2hGjFc1tjEWx,True,1825651074,456412768,1299595,649797,649798,3zqXX6kzhkbW3d4TwD2CNjMRwxTbREXySekvq37kfCNk,51983804,96257277,-44273473,284
2022-04-25 03:03:10-04:00,16056,DufAyX9ifvrS5bqJip1mqtKSGnfFTt5CqxktLMNsuqb8,EiXfkhfnq6HzpYkTWSjNGCETn77gzxgveAr9DJ8TKprZ,True,84187417,21046854,131489,65744,65745,GXyFXZMNk2NFyEzw6JetVqsujqcz2yCixH7n8EpDJYWD,5259562,33635362,-28375800,624
2022-04-25 03:03:11-04:00,16057,Br1j5Ftafei7ysu5SmqVZSoRe4uS4qCPeKSPHg55pyiE,G8fc7QvXjfkgBFvAVUgJFQS3VaF1biL9rktBExGa87Ks,True,33067823,8266955,51457,25728,25729,6UQfSsLooL4pQKQfLtXCutQS2BnF7A7F7ewJopDLmUpc,2058287,9037263,-6978976,622
2022-04-25 03:03:11-04:00,16058,EXP61AETWHw3kHSjrJH1jQBt6cXR9Zebz34Cueb3KAzg,2JT9GrgdUKjuQQtXvZqevbjFquUQBMYDoADmBjDKWXj3,False,472359,472359,29264,1463,27801,2a35JJeTUW1pm6M3e8DHCjp8qr4vbc2cRPhuzZWyFzYd,29264,412896,-383632,619
2022-04-25 03:03:12-04:00,16059,BTq6T9nDzYTPTRvxkhNLn82DF3RCWdRkatZUmSTGCu43,3Uuhmxo4tWMbrqowx2bQSJeWzMykUUcZanj29ptCmEa6,True,747874301,67171268,279708,139854,139854,3zqXX6kzhkbW3d4TwD2CNjMRwxTbREXySekvq37kfCNk,31142305,267132262,-235989957,416
2022-04-25 03:03:13-04:00,16060,EFHg5FatMRRSZnKJPJF9e1iw2cjPJRmwTTZYtkHno9DP,84LnLKhZDJgWFnbBYnYjqWkjymemXfidecPFwnUAvuFj,True,837219423,209304855,628648,314324,314324,3zqXX6kzhkbW3d4TwD2CNjMRwxTbREXySekvq37kfCNk,25145940,96898966,-71753026,300
2022-04-25 03:03:13-04:00,16061,C4k1drtNpR2axjxWk6DMreczYo3kdRc95u49HUAzpS42,2xRS27CLv9ynXa6F7w7SESPtK1ryBcf5BFeAB59N5cWF,True,19796460,4949115,30220,15110,15110,gjBMZYVujDjD1ECG4i97M8Q3gV9ESnwwTSUGropkusj,1208806,6864000,-5655194,610
2022-04-25 03:03:20-04:00,16062,2dbTtvw8XJnGdCeGnk1rbCY2SYszRNcCoGSVkACo1LDs,7aE9VZ6FP38CMuxDrjHESyNX6YZRxnfiDp3K4gDpDxJj,True,1091781322,272945330,821078,410539,410539,2a35JJeTUW1pm6M3e8DHCjp8qr4vbc2cRPhuzZWyFzYd,32843157,56716878,-23873721,300
2022-04-25 03:03:23-04:00,16063,AL8JFS4gjaQx89f9j8wtaNJgV76K8bw1ugvNtgvhgAnb,HJYvG2kGKe8kXgtZSWTWwTmSjxA3XUeCvyT7acoKtS1C,True,123602888297,23894539099,71083287,35541643,35541644,gjBMZYVujDjD1ECG4i97M8Q3gV9ESnwwTSUGropkusj,3677032492,17443285062,-13766252570,297
2022-04-25 03:03:27-04:00,16064,6k9unyyhVTrGhAhBrFjgumRfBtKFRBrVaeWtYB56LgEg,3n9VYUH53fxmwFwdYKT9xAZYDzjodhMsJ5iGAoJTqCt4,False,103252,103252,6340,317,6023,A2p75MbAbeUdHkPLkAjgGeiwuu9WPrkMHzjCkDXF1Xr3,6340,72183,-65843,614
2022-04-25 03:03:27-04:00,16065,5j5R1o3wXaL7cS9fxodLkrFjxPnujuX8boG7Zb9Fh9fs,4SZXsGqPoUy11ZKK5kNUpxCPK3ZcSxWMn12h4YREr9tS,True,77064056,13962078,54577,27288,27289,DQCvC9mR68hJ3tJsUiddh6JwcBJAmntqGJR2nUsEq7yj,3012452,13568251,-10555799,390
2022-04-25 03:03:27-04:00,16066,djW9rVm1v4nW64QiVqgFUCRza24VqthDcSfVEyRHPed,EsXvQmXVXECqZPtmSdiuwieHPP5jsmyn67p78vHaJcqq,True,779473658,194868414,539817,269908,269909,gjBMZYVujDjD1ECG4i97M8Q3gV9ESnwwTSUGropkusj,21592710,53578619,-31985909,277
2022-04-25 03:03:29-04:00,16067,impmg97osZac6q2B4SjAewuVYdMu4kPAg9totcz9h9Y,7ytd7QqMrXK3bVLPsgWSQSTgyAZnmPsPoD42k4Frkbz,True,91930413,11176032,51114,25557,25557,A2p75MbAbeUdHkPLkAjgGeiwuu9WPrkMHzjCkDXF1Xr3,4204487,8391334,-4186847,457
2022-04-25 03:03:29-04:00,16068,F3Hq5hKQ7mh2PiaMDtqTd1xPrGCUszajivFu1pBqvsbk,6pjiEFs1jM2SvY5MCHpESPKg8EmUSPUSvEr19Z1WFy3X,True,288126400,72031600,195190,97595,97595,A9TwRM1BMxqb8DCC7YNAMV6zPenEJm3HTZBy7wJKK58U,7807635,19576738,-11769103,270
2022-04-25 03:03:30-04:00,16069,GQviUdocJ1s4FsVDDexanvo5yQWRZgwwkGJBCg7TMtJC,HAX4VAKgQpKtm1149iRgtzvUaUkiXWcA1bJ9ERu6tXkd,False,101975,101975,6222,311,5911,2a35JJeTUW1pm6M3e8DHCjp8qr4vbc2cRPhuzZWyFzYd,6222,71228,-65006,610
2022-04-25 03:03:34-04:00,16070,9VojCEgzn99QRVPGKn6euGRQbM7Q86GZ6yHJQa7N3gv4,GW4GVNnUtEt68avsowddpmjoUTUyMvxV4c5kY3Gzz9fT,True,457607611,41649322,259033,129516,129517,2a35JJeTUW1pm6M3e8DHCjp8qr4vbc2cRPhuzZWyFzYd,28460402,206323006,-177862604,621
2022-04-25 03:03:34-04:00,16071,J6ndjmic8buVqwa4URRRgv2iTc4ekbYUHdcpa3DUCufN,7qvvczUw8ngwdQae49BiQwQmdV2SSWsAVV2tmZYL7gw6,True,3895468154,973867038,5810398,2905199,2905199,3zqXX6kzhkbW3d4TwD2CNjMRwxTbREXySekvq37kfCNk,232415956,1043990564,-811574608,596
2022-04-25 03:03:36-04:00,16072,GHn96Ev7UmKJWqch3H3wzXpRT7qLg5FBuSBJAATVED1f,BXBSUddfz9MThXqk4517M7YVRDGdTm4pC6G4ipT69TMV,False,82291,82291,5051,252,4799,2a35JJeTUW1pm6M3e8DHCjp8qr4vbc2cRPhuzZWyFzYd,5051,57360,-52309,613
2022-04-25 03:03:38-04:00,16073,2niazdR63iWLyZ3ABWZVAnJiEjVyDyLGo4jZ6wh3j2Zz,4RvU5UtyE5CqMStPciiCTdhYCdaUUfdKSYS5nkATs1qn,False,103235,103235,6324,316,6008,2a35JJeTUW1pm6M3e8DHCjp8qr4vbc2cRPhuzZWyFzYd,6324,72183,-65859,612
2022-04-25 03:03:43-04:00,16074,3qaXKaNNT8mpC4KnA868wYkDCojg8ukUVxN19dtfYbPM,5o21p7NCXgv5cYPtBqQVvR3Ses6mHceYgCNmd5VL3tkG,True,335264206,25461859,114605,57302,57303,3zqXX6kzhkbW3d4TwD2CNjMRwxTbREXySekvq37kfCNk,15090438,63745772,-48655334,450
2022-04-25 03:03:48-04:00,16075,7CSCMFa9W52tBDVUbXbc3woAy3GByeA1wPJdp3MgznPa,3447ptuVFu6G8B6N63RmS8mRv4n9PfHneypHLvbeaGLn,True,80235520,5912440,28059,14029,14030,gjBMZYVujDjD1ECG4i97M8Q3gV9ESnwwTSUGropkusj,3807806,34926977,-31119171,474
2022-04-25 03:03:49-04:00,16076,GHHkWuoUrAsuf1n8Y2GFozQxxv3LSr2zU9DWwKmAGTG9,7Fr2hNXbiNUufq8USBK3HwWN4bQT6H9fcFzDt7fdKy2U,True,382857501197,95714375299,282706265,141353132,141353133,3zqXX6kzhkbW3d4TwD2CNjMRwxTbREXySekvq37kfCNk,11308250625,72113987991,-60805737366,295
2022-04-25 03:03:49-04:00,16077,BTq6T9nDzYTPTRvxkhNLn82DF3RCWdRkatZUmSTGCu43,3Uuhmxo4tWMbrqowx2bQSJeWzMykUUcZanj29ptCmEa6,True,674916504,118602246,440658,220329,220329,gjBMZYVujDjD1ECG4i97M8Q3gV9ESnwwTSUGropkusj,25076068,252539381,-227463313,371
2022-04-25 03:03:49-04:00,16078,5j5R1o3wXaL7cS9fxodLkrFjxPnujuX8boG7Zb9Fh9fs,4SZXsGqPoUy11ZKK5kNUpxCPK3ZcSxWMn12h4YREr9tS,True,62679040,5294518,21412,10706,10706,gjBMZYVujDjD1ECG4i97M8Q3gV9ESnwwTSUGropkusj,2534937,11667602,-9132665,404
2022-04-25 03:03:50-04:00,16079,6Zyz5SGNMpEtCBu7H2USCkJCKpAJxLJrdf7h8N1W4fwp,3TTgDXx7VPZtB7aJDMShctxL5Y5To2Ugz927CoHNRztJ,True,33171890,8292972,51731,25865,25866,68sueyVfmy5ToEGtLFGDkwebX47xAmzyXE29z8JrmcWv,2069263,18050796,-15981533,623
2022-04-25 03:03:50-04:00,16080,8gxJEB4eSp5R8Z4Vy8TChcbLWPG93cVhpGLYWPuo4UMz,5dykor5kUojjBccSkbKqsHJ61voZWnD2MDuSNvsF6ohA,True,57847099,14461774,90196,45098,45098,2py1FiYeL2f7J3HU36qiJz6TD6HCmiTN36RyxYtapQCZ,3607879,22199427,-18591548,623
2022-04-25 03:03:50-04:00,16081,HXMjB1tdGJUtjXi5sQon6m4XJjfC6X7pdc6jTXApyjsH,CFcAoXdBVcPW7YYqP5ujq7q94DCsP4dLK2XDSwxQutKy,False,342144,342144,20850,1042,19808,2a35JJeTUW1pm6M3e8DHCjp8qr4vbc2cRPhuzZWyFzYd,20850,165780,-144930,609
2022-04-25 03:03:51-04:00,16082,2dbTtvw8XJnGdCeGnk1rbCY2SYszRNcCoGSVkACo1LDs,7aE9VZ6FP38CMuxDrjHESyNX6YZRxnfiDp3K4gDpDxJj,True,811284141,202821035,611755,305877,305878,gjBMZYVujDjD1ECG4i97M8Q3gV9ESnwwTSUGropkusj,24470228,49936849,-25466621,301
2022-04-25 03:03:51-04:00,16083,2rLWe1XADCU93guPU6WgSW6x56gYNfif9bm11V93mJnv,BEGhQRm3fgSHeBtk2DYrXEBPKPRvS3sHyTNopmoBJxMs,False,12642305,12642305,759907,37995,721912,gjBMZYVujDjD1ECG4i97M8Q3gV9ESnwwTSUGropkusj,759907,13329325,-12569418,601
2022-04-25 03:03:52-04:00,16084,EFHg5FatMRRSZnKJPJF9e1iw2cjPJRmwTTZYtkHno9DP,84LnLKhZDJgWFnbBYnYjqWkjymemXfidecPFwnUAvuFj,True,621644839,155411209,456189,228094,228095,A9TwRM1BMxqb8DCC7YNAMV6zPenEJm3HTZBy7wJKK58U,18247563,78337982,-60090419,293
2022-04-25 03:03:53-04:00,16085,BmWnnK7YPWCsoRPz61nZ4yBAUEHzwJbHEV2jZeG4vFe2,CfvRqcRNpTvTdFQXo1wGstFPA666HTLg83aN7yShyAb7,True,1741812404,435453101,1000281,500140,500141,3zqXX6kzhkbW3d4TwD2CNjMRwxTbREXySekvq37kfCNk,40011271,297441889,-257430618,229
2022-04-25 03:03:55-04:00,16086,98pwBGgiSDuwuas6WYW2hc9qUxfULwvNE34aixaxbxXY,BLrjKxekjThtJ9rKtQxs1Y4rZ225EE2Q16VkP9TkThyV,False,80483,80483,5010,250,4760,68sueyVfmy5ToEGtLFGDkwebX47xAmzyXE29z8JrmcWv,5010,56759,-51749,622
2022-04-25 03:03:56-04:00,16087,HTaKM45d7RzEyCp6CT3escbGBsa7nU1kKwssmmjZbiW2,AikDqAGp97D1cZu77wrXBeU4z6dzd6iZQ3WMQi81aSbe,True,3632252133,908063033,5672572,2836286,2836286,68sueyVfmy5ToEGtLFGDkwebX47xAmzyXE29z8JrmcWv,226902902,1594843164,-1367940262,624
2022-04-25 03:04:15-04:00,16088,FU7X4DWnGTbxwXULBq3v9SACzYhQyFGqsXjUDzyFqiem,925BaEnWxTfEv4oQb9Xf1wyyEEWEr8kXeSdXTtRfShfw,True,165534999,41383749,257911,128955,128956,gjBMZYVujDjD1ECG4i97M8Q3gV9ESnwwTSUGropkusj,10316479,42024040,-31707561,623
2022-04-25 03:04:20-04:00,16089,G3vArDs7nb18se4xMZ68oMHmTAsYP63x8dfY57jAogwp,EY7J8Hw8jWbryw11CYdPVUSdAoDGGNEfacqghVnJn3JK,False,296885,296885,17969,898,17071,2a35JJeTUW1pm6M3e8DHCjp8qr4vbc2cRPhuzZWyFzYd,17969,210083,-192114,605
2022-04-25 03:04:21-04:00,16090,33CE2t84MhG7SMsphhZaxvwFVRbK5wcUMUdEw8UBhoq8,DjNko7SbbK9nQT4K5oBWKiSiXiYS9Rv1k5vT3PNiMyaf,False,72574,72574,4476,223,4253,A2p75MbAbeUdHkPLkAjgGeiwuu9WPrkMHzjCkDXF1Xr3,4476,65451,-60975,616
2022-04-25 03:04:21-04:00,16091,28JujYG1mbpYSjF7LNqXpup17TXb45VJHhhnFMVXtft2,DAqyVExAtmsovPGrkpkFDxm6T7pKWLztfh9iPjTNDqrd,False,126976,126976,7655,382,7273,2a35JJeTUW1pm6M3e8DHCjp8qr4vbc2cRPhuzZWyFzYd,7655,89903,-82248,602
2022-04-25 03:04:21-04:00,16092,2utXC9PmMHh7D9x9wRdyibUHvSUquo96HHKy8F5cBeKY,GabBfvJyVgAUVuCe5sk4UHyC95AWaB4CSJiwWZUKerTd,False,2644162,2644162,160026,8001,152025,2py1FiYeL2f7J3HU36qiJz6TD6HCmiTN36RyxYtapQCZ,160026,1074001,-913975,605
2022-04-25 03:04:32-04:00,16093,7FB6X8YgiDn7YK9bZZmcFyzhuvVLVWPCfBbenwMXhx5,2EaDCpL9MpAKuiC2bvUCGRfvqYvgVXGFHXt35QdNakfG,False,72788,72788,4447,222,4225,2a35JJeTUW1pm6M3e8DHCjp8qr4vbc2cRPhuzZWyFzYd,4447,37325,-32878,610
2022-04-25 03:04:38-04:00,16094,9d7ixk9XCdumGXVP5fEQKJPDx15SS2uz5gvJA7HxaQsx,12pcw5FXob2x6LG3UmXZ2HE8zrVre91YZWfRqwm6XA5Q,False,1925,1925,118,5,113,2a35JJeTUW1pm6M3e8DHCjp8qr4vbc2cRPhuzZWyFzYd,118,911,-793,612
2022-04-25 03:04:52-04:00,16095,HHp8dRc1YMWE93uyLdM98DkUhM8U8zm3JC59chrbbWrk,AdqFuGe28VeAwwjRPZCBGVy5ftf9zNNQkg413i66wyig,True,35497534,8874383,55447,27723,27724,GXyFXZMNk2NFyEzw6JetVqsujqcz2yCixH7n8EpDJYWD,2217890,12378901,-10161011,624
2022-04-25 03:52:00-04:00,16096,AQr9mVmcXCNQhBVCfx63MwR6c4WqDSC9K2BZqr7N8LCx,CB7TWUaL381ounsLw6neAUaKRxJL9P1HC9uGX5e1Uxod,True,506826073,29730944,170712,85356,85356,A2p75MbAbeUdHkPLkAjgGeiwuu9WPrkMHzjCkDXF1Xr3,29101551,131311297,-102209746,574
2022-04-25 03:55:53-04:00,16097,68RZsaAJib9kw5xnnt9QhvsAa1DGJzww1MKqACsMvxGr,3z8H2C111LCABJymwxJAG9boicBXcJXq3ft6jqmV9rSw,True,75123180,18780795,133700,66850,66850,2py1FiYeL2f7J3HU36qiJz6TD6HCmiTN36RyxYtapQCZ,5348015,19218485,-13870470,711
2022-04-25 04:03:36-04:00,16098,HxEjbaeXyjRYmxhkvPER7iuevx9R3AH9rdAtAu9r4zxL,HUXTVWjDHoKRNDEt4qXC9c7BpDtjB2tSNW7bXhHXsMk9,True,44353160,11088009,68299,34149,34150,2xTUy2RS74GJMMDnmFaegMzFLn19RVfYG4CibhBmjP1i,2732072,9313080,-6581008,615
2022-04-25 04:04:06-04:00,16099,5r3YEyxbXrMEwYCFyZXS5t1eRLDahPFxPBBYNyMfHfcZ,7fnHdwm7JWHREPPk7dMud4vEoYZqsiRYCMo6ZSQqMwQc,True,33657422,4615447,28784,14392,14392,gjBMZYVujDjD1ECG4i97M8Q3gV9ESnwwTSUGropkusj,2099107,17240670,-15141563,623
2022-04-25 04:23:28-04:00,16100,AQr9mVmcXCNQhBVCfx63MwR6c4WqDSC9K2BZqr7N8LCx,CB7TWUaL381ounsLw6neAUaKRxJL9P1HC9uGX5e1Uxod,True,480543146,27403965,156636,78318,78318,2py1FiYeL2f7J3HU36qiJz6TD6HCmiTN36RyxYtapQCZ,27467025,128212460,-100745435,571
2022-04-25 04:25:53-04:00,16101,AXBfrbCpYAWKN5jgDVVMiKXscQ96YtotKV3DT6XSzm9o,Dh3SiHAqrQzPQnTLRMxtBn2EFyHNgyfnYGpgcuNGTvyL,True,854035161,213508790,1320222,660111,660111,DQCvC9mR68hJ3tJsUiddh6JwcBJAmntqGJR2nUsEq7yj,52808888,271476434,-218667546,618
2022-04-25 04:26:37-04:00,16102,3RpbaFEL5ZYrQBPpaAeCUXs43Ssdr5Tm4ScMGtp6XbYF,CpKGwcVZrd3vKTNhdF8xNsd77FT3QxQWb7xFQxiyPB5p,True,19240907474,4810226868,29876721,14938360,14938361,2py1FiYeL2f7J3HU36qiJz6TD6HCmiTN36RyxYtapQCZ,1195068857,4820962463,-3625893606,621
2022-04-25 04:54:53-04:00,16103,6NJFN855M3Q3RLTDNo57gTgAmwPD6G2E3WvMb1m5eNCN,3YpqNnonsvXaRT4nCC3G5FZx1jjVtbDPc36LiR6WK5jR,True,524699350,131174837,810509,405254,405255,A9TwRM1BMxqb8DCC7YNAMV6zPenEJm3HTZBy7wJKK58U,32420371,107460617,-75040246,617
2022-04-25 04:54:54-04:00,16104,5wcyw2KsaCSSXaDocVzV8Yz9yHNG1E8TajEoeoBqiENL,2vuppCGeADLpY3sGJVLbmM5aRW3r5aHDgCBLS7QZoCg5,True,170823951,42705987,266103,133051,133052,gjBMZYVujDjD1ECG4i97M8Q3gV9ESnwwTSUGropkusj,10644128,30493750,-19849622,623
2022-04-25 04:55:17-04:00,16105,7X1UBUXhC59kzJKyroP6fe5GVtGCrVMZGKwbSnedkvwJ,5A24drY1wqNsjV6cABFfFx2D5BQ16m6vozbxvyUcXG4C,True,55075900,13768975,85871,42935,42936,2a35JJeTUW1pm6M3e8DHCjp8qr4vbc2cRPhuzZWyFzYd,3434876,16386835,-12951959,623
2022-04-25 04:55:25-04:00,16106,D8hA6qzDLFSTbkwvEdBsFZz5ykzuLP96FPhYh4uSh2PW,Bdj1hZnx27FrEw6wMKDheBFWFFDaKUdiq8Sv6WhL5gc5,True,60800710,15200177,93321,46660,46661,gjBMZYVujDjD1ECG4i97M8Q3gV9ESnwwTSUGropkusj,3732854,17924970,-14192116,613
2022-04-25 04:55:25-04:00,16107,bYUscp4qgQap7iDu5R8tyBz73dov4j3zDV2FgDUvSDx,E4d8ank6Ymezu4ubD2tU5B5fXuoh2E1RQkrdaLgMfuaT,True,39131646,9782911,60610,30305,30305,2a35JJeTUW1pm6M3e8DHCjp8qr4vbc2cRPhuzZWyFzYd,2424430,17856182,-15431752,619
2022-04-25 04:58:27-04:00,16108,8fVwuVA2CL5sZoHh6Dg4MBpcX3cvoUm7mnitnpQSdPBD,4F4ccaNm1KQu29XvsKvdjFkmpsbWqNvXkV41851EYQyu,True,167234978,12506509,59562,29781,29781,DQCvC9mR68hJ3tJsUiddh6JwcBJAmntqGJR2nUsEq7yj,7964663,44363357,-36398694,476
2022-04-25 04:59:49-04:00,16109,A5NXadGWnFZRoHEn1dKTRjcXgWmfMLMyJdpF4rQPZyRR,ALs3Zfotc4c4A6TFDMbd5GM5whK1dTYSnGrHiMBWmApH,True,259763264,64940359,397147,198573,198574,6UQfSsLooL4pQKQfLtXCutQS2BnF7A7F7ewJopDLmUpc,15886015,122325148,-106439133,611
2022-04-25 05:05:20-04:00,16110,AQr9mVmcXCNQhBVCfx63MwR6c4WqDSC9K2BZqr7N8LCx,CB7TWUaL381ounsLw6neAUaKRxJL9P1HC9uGX5e1Uxod,True,451563615,21582544,122417,61208,61209,gjBMZYVujDjD1ECG4i97M8Q3gV9ESnwwTSUGropkusj,25613070,118966645,-93353575,567
2022-04-25 05:18:19-04:00,16111,3qaXKaNNT8mpC4KnA868wYkDCojg8ukUVxN19dtfYbPM,5o21p7NCXgv5cYPtBqQVvR3Ses6mHceYgCNmd5VL3tkG,True,308370487,44604340,195422,97711,97711,A9TwRM1BMxqb8DCC7YNAMV6zPenEJm3HTZBy7wJKK58U,13510513,57924191,-44413678,438
2022-04-25 05:18:46-04:00,16112,7CSCMFa9W52tBDVUbXbc3woAy3GByeA1wPJdp3MgznPa,3447ptuVFu6G8B6N63RmS8mRv4n9PfHneypHLvbeaGLn,True,73981700,4790887,22201,11100,11101,6UQfSsLooL4pQKQfLtXCutQS2BnF7A7F7ewJopDLmUpc,3428403,32312118,-28883715,463
2022-04-25 07:20:36-04:00,16113,5QxR9QPTADFys9VQNm473RgprTikCXC23vhsBc9ojyAQ,H9zdf8nJ4JCF7jrwGsxiuiFoa14gzDmYsZ5N5ig3UGna,True,373163797,93290949,582932,291466,291466,A9TwRM1BMxqb8DCC7YNAMV6zPenEJm3HTZBy7wJKK58U,23317307,56387071,-33069764,624
2022-04-25 11:00:24-04:00,16114,G3ZEAY19iDMjF7P57dgFUZiC4bpeFvMPKShenugL7E2Y,D6nUGgpWkQUZcUKZYawfedX67uqQ9Co1wEwtbHPMtc7X,False,14117353,14117353,882278,44113,838165,gjBMZYVujDjD1ECG4i97M8Q3gV9ESnwwTSUGropkusj,882278,2233894,-1351616,624
2022-04-25 11:13:30-04:00,16115,9jvmuV6rnbEeCjrJSXU67aMCTSFJ9MquiGLXjgTDmUQS,7PsemtRTQHnypsnUGZR67BiCbf1cw3h4V6i834qwrdna,True,882138002,220534500,1369300,684650,684650,GXyFXZMNk2NFyEzw6JetVqsujqcz2yCixH7n8EpDJYWD,54772009,84271215,-29499206,620
2022-04-25 11:21:37-04:00,16116,CLP8qmL8aN9ocJKYnbKSo4k46CU3LBsebspfREQcSGvo,F6tkkFJnvjYyPdSXDNzZMUfhd1o8dFiLyLPRZ5U1sXHE,True,45657280,11414320,69618,34809,34809,2a35JJeTUW1pm6M3e8DHCjp8qr4vbc2cRPhuzZWyFzYd,2784741,4738544,-1953803,609
2022-04-25 12:16:16-04:00,16117,9jvmuV6rnbEeCjrJSXU67aMCTSFJ9MquiGLXjgTDmUQS,7PsemtRTQHnypsnUGZR67BiCbf1cw3h4V6i834qwrdna,True,672934760,168233690,1051101,525550,525551,2py1FiYeL2f7J3HU36qiJz6TD6HCmiTN36RyxYtapQCZ,42044079,75504663,-33460584,624
2022-04-25 12:25:02-04:00,16118,BFWNfNhm4RUFJs3721We8Dyocw1okinoUA3JtHshAHkU,7czPpWxLYgLgAGmvxiKA6zRGQ97FdLVB83FvNqEuKnFj,True,145911255,36477813,258629,129314,129315,gjBMZYVujDjD1ECG4i97M8Q3gV9ESnwwTSUGropkusj,10345197,16877871,-6532674,709
2022-04-25 12:26:07-04:00,16119,7mhEMbGEpSYgYoZx6WvApjysTxsPqpCDSJCmKF45x3n6,12J2purUC4QYjaPKZwL3Y5P1JikTBD3oY9pLgY6yt6am,True,1845344701,461336175,2862096,1431048,1431048,A2p75MbAbeUdHkPLkAjgGeiwuu9WPrkMHzjCkDXF1Xr3,114483863,176238073,-61754210,620
2022-04-25 12:44:46-04:00,16120,31tyt6M4RuSjM1pZ9tXbPSdVDNr7q4CU66tHD5soPHkT,G9n4eXhx2Lh7b8FGauiAXBd3PgbH7PAVHYREkXjVXBns,True,2004132440,501033110,1514834,757417,757417,A9TwRM1BMxqb8DCC7YNAMV6zPenEJm3HTZBy7wJKK58U,60593367,41338616,19254751,302
2022-04-25 12:50:53-04:00,16121,CLP8qmL8aN9ocJKYnbKSo4k46CU3LBsebspfREQcSGvo,F6tkkFJnvjYyPdSXDNzZMUfhd1o8dFiLyLPRZ5U1sXHE,True,34790211,8697552,54161,27080,27081,gjBMZYVujDjD1ECG4i97M8Q3gV9ESnwwTSUGropkusj,2166466,4179082,-2012616,622
2022-04-25 14:48:38-04:00,16122,31tyt6M4RuSjM1pZ9tXbPSdVDNr7q4CU66tHD5soPHkT,G9n4eXhx2Lh7b8FGauiAXBd3PgbH7PAVHYREkXjVXBns,True,1516394680,379098670,1144910,572455,572455,A9TwRM1BMxqb8DCC7YNAMV6zPenEJm3HTZBy7wJKK58U,45796405,44681756,1114649,302
2022-04-25 14:49:20-04:00,16123,FAVbkbRUab8jZ7j3d5LzcPYkdAnmcZ7kk57LQCadDfLE,2c9vvEJzGhodh1JhZmhuhxk1a5tXym1nVcPjoLBkNFek,True,160852494,40213123,116331,58165,58166,A2p75MbAbeUdHkPLkAjgGeiwuu9WPrkMHzjCkDXF1Xr3,4653278,7826156,-3172878,289
2022-04-25 14:50:02-04:00,16124,1EH82ta3wXUyUwW8VWQnVzSG3r1rHcSj2DvDeTKmp3F,B6aMfucYPbCzWBtauLtgTpwR45wKSK8yqscHJR3F5usu,True,1260166886,249878758,967466,483733,483733,A9TwRM1BMxqb8DCC7YNAMV6zPenEJm3HTZBy7wJKK58U,48790479,99042926,-50252447,387
2022-04-25 14:55:16-04:00,16125,9jvmuV6rnbEeCjrJSXU67aMCTSFJ9MquiGLXjgTDmUQS,7PsemtRTQHnypsnUGZR67BiCbf1cw3h4V6i834qwrdna,True,513558853,128389713,801794,400897,400897,GXyFXZMNk2NFyEzw6JetVqsujqcz2yCixH7n8EpDJYWD,32071785,66027798,-33956013,624
2022-04-25 15:15:15-04:00,16126,8J4BZXZzkK4SmWxc2YoaJRg9ivuuXbdVe5XpEhVds1ZM,3pirVwiye9NftvMpX5F7WpfcGZy5uV3c11xCdkkZbL9D,True,3111309828,777827457,5535240,2767620,2767620,GXyFXZMNk2NFyEzw6JetVqsujqcz2yCixH7n8EpDJYWD,221409628,482665646,-261256018,711
2022-04-25 15:37:19-04:00,16127,31tyt6M4RuSjM1pZ9tXbPSdVDNr7q4CU66tHD5soPHkT,G9n4eXhx2Lh7b8FGauiAXBd3PgbH7PAVHYREkXjVXBns,True,1147199676,286799919,868664,434332,434332,6UQfSsLooL4pQKQfLtXCutQS2BnF7A7F7ewJopDLmUpc,34746596,43831825,-9085229,302
2022-04-25 16:09:47-04:00,16128,7mhEMbGEpSYgYoZx6WvApjysTxsPqpCDSJCmKF45x3n6,12J2purUC4QYjaPKZwL3Y5P1JikTBD3oY9pLgY6yt6am,True,1408199317,352049829,2177624,1088812,1088812,GXyFXZMNk2NFyEzw6JetVqsujqcz2yCixH7n8EpDJYWD,87104987,157632739,-70527752,618
2022-04-25 16:10:55-04:00,16129,CLP8qmL8aN9ocJKYnbKSo4k46CU3LBsebspfREQcSGvo,F6tkkFJnvjYyPdSXDNzZMUfhd1o8dFiLyLPRZ5U1sXHE,True,26545036,6636259,41344,20672,20672,DQCvC9mR68hJ3tJsUiddh6JwcBJAmntqGJR2nUsEq7yj,1653790,3615636,-1961846,623
2022-04-25 18:48:01-04:00,16130,2vYbqZ56fGQwZm6ugcxUSmbd1hNw91kNL6D1LoAfckP2,4zrzxPxAZR4qXzTymS3kLR31VaVU974Mso5Fetov9ipz,True,5349324005,1337331001,3921520,1960760,1960760,2xTUy2RS74GJMMDnmFaegMzFLn19RVfYG4CibhBmjP1i,156860810,322361868,-165501058,293
2022-04-25 18:54:30-04:00,16131,BFWNfNhm4RUFJs3721We8Dyocw1okinoUA3JtHshAHkU,7czPpWxLYgLgAGmvxiKA6zRGQ97FdLVB83FvNqEuKnFj,True,111589994,27897498,198072,99036,99036,A2p75MbAbeUdHkPLkAjgGeiwuu9WPrkMHzjCkDXF1Xr3,7922897,14980507,-7057610,710
2022-04-25 19:31:56-04:00,16132,BFWNfNhm4RUFJs3721We8Dyocw1okinoUA3JtHshAHkU,7czPpWxLYgLgAGmvxiKA6zRGQ97FdLVB83FvNqEuKnFj,True,85390521,21347630,150845,75422,75423,gjBMZYVujDjD1ECG4i97M8Q3gV9ESnwwTSUGropkusj,6033800,13025914,-6992114,706
2022-04-25 19:32:46-04:00,16133,8RQrftvvDMztkaUK7USZjeA4bkhJZLX9f1jygdWrsYgb,6bJLycnh4ZHEJtsUZkoygZVp24C8uYDXLedEyzH9iQWG,True,304238984,39965064,268017,134008,134009,6UQfSsLooL4pQKQfLtXCutQS2BnF7A7F7ewJopDLmUpc,20403214,90289985,-69886771,670
2022-04-25 19:35:59-04:00,16134,FQnJRA6XCLRpcexUyy5kpxtE1mRcbKZCjQvAo388Xbqc,Hibg8j63eP7oE4HjgviWD77oMLHNcnrib9kYL7q4Uetz,True,13630354683,2511528666,16512416,8256208,8256208,68sueyVfmy5ToEGtLFGDkwebX47xAmzyXE29z8JrmcWv,896147865,1827772458,-931624593,657
2022-04-25 19:36:00-04:00,16135,BFWNfNhm4RUFJs3721We8Dyocw1okinoUA3JtHshAHkU,7czPpWxLYgLgAGmvxiKA6zRGQ97FdLVB83FvNqEuKnFj,True,65510264,16377566,110389,55194,55195,A2p75MbAbeUdHkPLkAjgGeiwuu9WPrkMHzjCkDXF1Xr3,4415582,11127541,-6711959,674
2022-04-25 19:37:08-04:00,16136,8RQrftvvDMztkaUK7USZjeA4bkhJZLX9f1jygdWrsYgb,6bJLycnh4ZHEJtsUZkoygZVp24C8uYDXLedEyzH9iQWG,True,266767525,30552190,202044,101022,101022,gjBMZYVujDjD1ECG4i97M8Q3gV9ESnwwTSUGropkusj,17641592,75058177,-57416585,661
2022-04-25 19:40:56-04:00,16137,31tyt6M4RuSjM1pZ9tXbPSdVDNr7q4CU66tHD5soPHkT,G9n4eXhx2Lh7b8FGauiAXBd3PgbH7PAVHYREkXjVXBns,True,868089971,217022492,654598,327299,327299,DQCvC9mR68hJ3tJsUiddh6JwcBJAmntqGJR2nUsEq7yj,26183945,40697995,-14514050,301
2022-04-25 20:42:35-04:00,16138,FQnJRA6XCLRpcexUyy5kpxtE1mRcbKZCjQvAo388Xbqc,Hibg8j63eP7oE4HjgviWD77oMLHNcnrib9kYL7q4Uetz,True,11272908498,1898875571,12202867,6101433,6101434,3zqXX6kzhkbW3d4TwD2CNjMRwxTbREXySekvq37kfCNk,724438241,1486442267,-762004026,642
2022-04-26 02:38:02-04:00,16139,F4hN7ecndZ8Gr5KQNSFaSrMGawMasz7jfWTLTMpk7gaB,AJ23FpXSGjipcqywk88WGsKfqfiiUjPzZLsvLtBAhB12,True,1364328651,341082162,2388615,1194307,1194308,2a35JJeTUW1pm6M3e8DHCjp8qr4vbc2cRPhuzZWyFzYd,95544618,109036438,-13491820,700
2022-04-26 04:13:56-04:00,16140,8J4BZXZzkK4SmWxc2YoaJRg9ivuuXbdVe5XpEhVds1ZM,3pirVwiye9NftvMpX5F7WpfcGZy5uV3c11xCdkkZbL9D,True,2380961664,595240416,4179390,2089695,2089695,2a35JJeTUW1pm6M3e8DHCjp8qr4vbc2cRPhuzZWyFzYd,167175632,411192122,-244016490,702
2022-04-26 07:08:02-04:00,16141,8qq2gfbca7JXvq4gViBBVT2QAbM4MvBMEQLXgn8UUTvt,3o5jpBVYdFFEYrGRdCUkLrUC85wsuTKgy8iYwnpZyC1B,True,426448033,32466866,155832,77916,77916,A9TwRM1BMxqb8DCC7YNAMV6zPenEJm3HTZBy7wJKK58U,20468435,191779059,-171310624,479
2022-04-26 08:13:20-04:00,16142,6fxUEgnR8SRihBVA4ZAxzXQTLPCeHsQatzUpB9XheY44,7Ds71dQsLTzuSy9LRG5P4wjmrofgQwJMJ5kXXvxpXiG2,True,1078244470,269561117,1889638,944819,944819,68sueyVfmy5ToEGtLFGDkwebX47xAmzyXE29z8JrmcWv,75585551,110435893,-34850342,701
2022-04-26 08:21:34-04:00,16143,F4hN7ecndZ8Gr5KQNSFaSrMGawMasz7jfWTLTMpk7gaB,AJ23FpXSGjipcqywk88WGsKfqfiiUjPzZLsvLtBAhB12,True,1001339463,250334865,1786381,893190,893191,gjBMZYVujDjD1ECG4i97M8Q3gV9ESnwwTSUGropkusj,71455261,103624796,-32169535,713
2022-04-26 09:33:06-04:00,16144,8qq2gfbca7JXvq4gViBBVT2QAbM4MvBMEQLXgn8UUTvt,3o5jpBVYdFFEYrGRdCUkLrUC85wsuTKgy8iYwnpZyC1B,True,389565640,25963542,121431,60715,60716,DQCvC9mR68hJ3tJsUiddh6JwcBJAmntqGJR2nUsEq7yj,18220036,164772556,-146552520,467
2022-04-26 09:54:48-04:00,16145,EFHg5FatMRRSZnKJPJF9e1iw2cjPJRmwTTZYtkHno9DP,84LnLKhZDJgWFnbBYnYjqWkjymemXfidecPFwnUAvuFj,True,940072165,235018041,712097,356048,356049,A2p75MbAbeUdHkPLkAjgGeiwuu9WPrkMHzjCkDXF1Xr3,28483891,62247685,-33763794,302
2022-04-26 10:01:37-04:00,16146,GrEmbsi2huF9z79BZN5qjxDd4K2yxsH2YeSEtHHmq2r4,A5zHtJTsATD22VWNBGUGDd83NjnvZCSG5SR7UpUKNNWZ,True,4887592127,1221898031,3670928,1835464,1835464,2a35JJeTUW1pm6M3e8DHCjp8qr4vbc2cRPhuzZWyFzYd,146837147,283998992,-137161845,300
2022-04-26 10:02:11-04:00,16147,EFHg5FatMRRSZnKJPJF9e1iw2cjPJRmwTTZYtkHno9DP,84LnLKhZDJgWFnbBYnYjqWkjymemXfidecPFwnUAvuFj,True,698218317,174554579,523064,261532,261532,6UQfSsLooL4pQKQfLtXCutQS2BnF7A7F7ewJopDLmUpc,20922588,53088246,-32165658,299
2022-04-26 10:02:17-04:00,16148,FhCW2CghBaoo1MkXUXUb4okam8g5beQofgs3WXerNYzn,HWSPdmF3hSnnfVe29Y5rDGSPqbMQv2ug1wYrdwJZNWFK,True,497956486,124489121,376438,188219,188219,gjBMZYVujDjD1ECG4i97M8Q3gV9ESnwwTSUGropkusj,15057529,25283800,-10226271,302
2022-04-26 10:18:06-04:00,16149,EQmTXrm9er5Ttk27cCDxm1z3Kpvi7nYi2LLL9YkcMWSr,4y8KEzuWxNiq9yoNZb8yKJ4RySPubB7JxHbRxvxR255G,False,12242490,12242490,370935,18546,352389,68sueyVfmy5ToEGtLFGDkwebX47xAmzyXE29z8JrmcWv,370936,2425666,-2054730,302
2022-04-26 10:42:41-04:00,16150,FhCW2CghBaoo1MkXUXUb4okam8g5beQofgs3WXerNYzn,HWSPdmF3hSnnfVe29Y5rDGSPqbMQv2ug1wYrdwJZNWFK,True,369972907,92493226,279665,139832,139833,2xTUy2RS74GJMMDnmFaegMzFLn19RVfYG4CibhBmjP1i,11186633,22358687,-11172054,302
2022-04-26 11:06:05-04:00,16151,F3Hq5hKQ7mh2PiaMDtqTd1xPrGCUszajivFu1pBqvsbk,6pjiEFs1jM2SvY5MCHpESPKg8EmUSPUSvEr19Z1WFy3X,True,156942163,39235540,118112,59056,59056,gjBMZYVujDjD1ECG4i97M8Q3gV9ESnwwTSUGropkusj,4724498,8495424,-3770926,301
2022-04-26 11:06:27-04:00,16152,4pVzpvQywzjV9y7vR4mR3J1vgurmHCPE4z2jDsJfvMdr,DcxzYh2P27r4ji6rV1BiSiDSYW1zQR7eFLYKA6U4s4RP,True,7431227040,1857806760,5617052,2808526,2808526,A9TwRM1BMxqb8DCC7YNAMV6zPenEJm3HTZBy7wJKK58U,224682118,460776416,-236094298,302
2022-04-26 11:20:24-04:00,16153,7GpG8k6hM27vK1R5Sx1v5xUBuF6vybP41dcymjXDi5P7,7Aip6HDcbZ5mvoSucNupRS9enRdGx37F8L432K7V81do,True,68404081450,17101020362,106719035,53359517,53359518,A9TwRM1BMxqb8DCC7YNAMV6zPenEJm3HTZBy7wJKK58U,4268761435,7464155127,-3195393692,624
2022-04-26 11:44:44-04:00,16154,DaHTFbsmuU4J1Erji8ZfqB1L2wSuY7DCxAuHoopwMHog,7tmPzHaeVyGdvMXWEuJzYRoSQfw4dH4Njyf6Rh3F7U9Z,True,372314718,93078679,581127,290563,290564,DQCvC9mR68hJ3tJsUiddh6JwcBJAmntqGJR2nUsEq7yj,23245112,38734794,-15489682,624
2022-04-26 11:54:12-04:00,16155,GrEmbsi2huF9z79BZN5qjxDd4K2yxsH2YeSEtHHmq2r4,A5zHtJTsATD22VWNBGUGDd83NjnvZCSG5SR7UpUKNNWZ,True,3625847664,906461916,2579926,1289963,1289963,A9TwRM1BMxqb8DCC7YNAMV6zPenEJm3HTZBy7wJKK58U,103197046,246103532,-142906486,284
2022-04-26 11:54:16-04:00,16156,EFHg5FatMRRSZnKJPJF9e1iw2cjPJRmwTTZYtkHno9DP,84LnLKhZDJgWFnbBYnYjqWkjymemXfidecPFwnUAvuFj,True,518800342,129700085,387964,193982,193982,DQCvC9mR68hJ3tJsUiddh6JwcBJAmntqGJR2nUsEq7yj,15518567,44510128,-28991561,299
2022-04-26 11:55:58-04:00,16157,FhCW2CghBaoo1MkXUXUb4okam8g5beQofgs3WXerNYzn,HWSPdmF3hSnnfVe29Y5rDGSPqbMQv2ug1wYrdwJZNWFK,True,274849922,68712480,206872,103436,103436,gjBMZYVujDjD1ECG4i97M8Q3gV9ESnwwTSUGropkusj,8274912,19288131,-11013219,301
2022-04-26 11:57:22-04:00,16158,F3Hq5hKQ7mh2PiaMDtqTd1xPrGCUszajivFu1pBqvsbk,6pjiEFs1jM2SvY5MCHpESPKg8EmUSPUSvEr19Z1WFy3X,True,116607459,29151864,87680,43840,43840,2xTUy2RS74GJMMDnmFaegMzFLn19RVfYG4CibhBmjP1i,3507222,7434878,-3927656,300
2022-04-26 11:58:16-04:00,16159,GHHkWuoUrAsuf1n8Y2GFozQxxv3LSr2zU9DWwKmAGTG9,7Fr2hNXbiNUufq8USBK3HwWN4bQT6H9fcFzDt7fdKy2U,True,387217067769,96804266942,293223006,146611503,146611503,6UQfSsLooL4pQKQfLtXCutQS2BnF7A7F7ewJopDLmUpc,11728920252,57742304328,-46013384076,302
2022-04-26 11:59:23-04:00,16160,9VojCEgzn99QRVPGKn6euGRQbM7Q86GZ6yHJQa7N3gv4,GW4GVNnUtEt68avsowddpmjoUTUyMvxV4c5kY3Gzz9fT,True,413801047,36443279,227344,113672,113672,68sueyVfmy5ToEGtLFGDkwebX47xAmzyXE29z8JrmcWv,25814197,194748291,-168934094,623
2022-04-26 12:03:48-04:00,16161,FhCW2CghBaoo1MkXUXUb4okam8g5beQofgs3WXerNYzn,HWSPdmF3hSnnfVe29Y5rDGSPqbMQv2ug1wYrdwJZNWFK,True,204137777,51034444,151650,75825,75825,gjBMZYVujDjD1ECG4i97M8Q3gV9ESnwwTSUGropkusj,6066009,16328063,-10262054,297
2022-04-26 12:03:48-04:00,16162,SEndYVMCKAeZUKSqGrMUSqXFmxtA9M1t4eXsUhVsTBF,3fcQQcbkpqodakamn82pFnMxBEPL2Drsg4jJNZ6dx72M,True,1357801575,198075375,1296080,648040,648040,2xTUy2RS74GJMMDnmFaegMzFLn19RVfYG4CibhBmjP1i,88845984,56133031,32712953,654
2022-04-26 12:03:51-04:00,16163,FtF3PVw8YNJseWPMcA2GEuQZ6nni1mq5kYPa2LrSzfkW,4yr1TM2dXrBvLNMpSaoryuGU2P8D3WG1ZCkvVzWFiQRH,True,331420383,76230640,456515,228257,228258,2a35JJeTUW1pm6M3e8DHCjp8qr4vbc2cRPhuzZWyFzYd,19847483,180106162,-160258679,598
2022-04-26 12:03:58-04:00,16164,3662SX3YSARYupcxpgtTvUAPUsU7aJKsGxvpkNC1AV1A,HkAb86jdGHbz6VxrtbA81jPvjhiNHhbe82NBPFxnwzE5,False,13648579,13648579,851927,42596,809331,2a35JJeTUW1pm6M3e8DHCjp8qr4vbc2cRPhuzZWyFzYd,851927,3805924,-2953997,624
2022-04-26 12:04:23-04:00,16165,7ueXVhSvXvttkeQ18w2cLh65naoEPvYF86RrdUK2Vc5Q,CKTehY1W6bw85cS4o7g2qXKjP4656Vwo37244BAEAiw1,True,361032559,90254961,563867,281933,281934,DQCvC9mR68hJ3tJsUiddh6JwcBJAmntqGJR2nUsEq7yj,22555495,125336738,-102781243,624
2022-04-26 12:31:53-04:00,16166,7GpG8k6hM27vK1R5Sx1v5xUBuF6vybP41dcymjXDi5P7,7Aip6HDcbZ5mvoSucNupRS9enRdGx37F8L432K7V81do,True,50264012641,12566003160,78079749,39039874,39039875,A2p75MbAbeUdHkPLkAjgGeiwuu9WPrkMHzjCkDXF1Xr3,3123189977,6590925362,-3467735385,621
2022-04-26 12:35:09-04:00,16167,AQr9mVmcXCNQhBVCfx63MwR6c4WqDSC9K2BZqr7N8LCx,CB7TWUaL381ounsLw6neAUaKRxJL9P1HC9uGX5e1Uxod,True,444237178,22702984,127758,63879,63879,GXyFXZMNk2NFyEzw6JetVqsujqcz2yCixH7n8EpDJYWD,24998942,117429654,-92430712,562
2022-04-26 12:37:29-04:00,16168,DaHTFbsmuU4J1Erji8ZfqB1L2wSuY7DCxAuHoopwMHog,7tmPzHaeVyGdvMXWEuJzYRoSQfw4dH4Njyf6Rh3F7U9Z,True,273540668,68385167,424242,212121,212121,gjBMZYVujDjD1ECG4i97M8Q3gV9ESnwwTSUGropkusj,16969687,34283272,-17313585,620
2022-04-26 12:38:30-04:00,16169,12GjTFcAZ5rnnR9DwXDUMmjFoyuFa3txDF4PPA4YoAQq,Ebm7YVYTYyMtEBM4STgbyyLuSFTwnnuFDQ1Wysvtj2vR,True,278707617,69676904,435473,217736,217737,GXyFXZMNk2NFyEzw6JetVqsujqcz2yCixH7n8EpDJYWD,17418921,39730241,-22311320,624
2022-04-26 13:13:05-04:00,16170,AQr9mVmcXCNQhBVCfx63MwR6c4WqDSC9K2BZqr7N8LCx,CB7TWUaL381ounsLw6neAUaKRxJL9P1HC9uGX5e1Uxod,True,420757687,22343194,125300,62650,62650,A2p75MbAbeUdHkPLkAjgGeiwuu9WPrkMHzjCkDXF1Xr3,23596011,107753503,-84157492,560
2022-04-26 13:14:29-04:00,16171,Br1j5Ftafei7ysu5SmqVZSoRe4uS4qCPeKSPHg55pyiE,G8fc7QvXjfkgBFvAVUgJFQS3VaF1biL9rktBExGa87Ks,True,24326048,6081512,37620,18810,18810,gjBMZYVujDjD1ECG4i97M8Q3gV9ESnwwTSUGropkusj,1504820,7213914,-5709094,618
2022-04-26 13:14:37-04:00,16172,J6ndjmic8buVqwa4URRRgv2iTc4ekbYUHdcpa3DUCufN,7qvvczUw8ngwdQae49BiQwQmdV2SSWsAVV2tmZYL7gw6,True,2877922400,719480600,4492685,2246342,2246343,68sueyVfmy5ToEGtLFGDkwebX47xAmzyXE29z8JrmcWv,179707424,832643547,-652936123,624
2022-04-26 13:14:37-04:00,16173,B1zAiuxNrv8RTc7dDBoAihXEsu59R7KNywkRkw27J53x,5SVx4t6TzhXz7v9aMHKwbyYZxjBhskW8tkDVm1qquhuC,True,8081712330,2020428082,12588041,6294020,6294021,GXyFXZMNk2NFyEzw6JetVqsujqcz2yCixH7n8EpDJYWD,503521676,2422410446,-1918888770,623
2022-04-26 13:15:33-04:00,16174,8gxJEB4eSp5R8Z4Vy8TChcbLWPG93cVhpGLYWPuo4UMz,5dykor5kUojjBccSkbKqsHJ61voZWnD2MDuSNvsF6ohA,True,42551739,10637934,65907,32953,32954,68sueyVfmy5ToEGtLFGDkwebX47xAmzyXE29z8JrmcWv,2636291,17413678,-14777387,619
2022-04-26 13:15:46-04:00,16175,F3Hq5hKQ7mh2PiaMDtqTd1xPrGCUszajivFu1pBqvsbk,6pjiEFs1jM2SvY5MCHpESPKg8EmUSPUSvEr19Z1WFy3X,True,86661713,21665428,65405,32702,32703,gjBMZYVujDjD1ECG4i97M8Q3gV9ESnwwTSUGropkusj,2616213,6356004,-3739791,301
2022-04-26 13:16:17-04:00,16176,HxEjbaeXyjRYmxhkvPER7iuevx9R3AH9rdAtAu9r4zxL,HUXTVWjDHoKRNDEt4qXC9c7BpDtjB2tSNW7bXhHXsMk9,True,32672969,8167962,51003,25501,25502,A2p75MbAbeUdHkPLkAjgGeiwuu9WPrkMHzjCkDXF1Xr3,2040230,7568202,-5527972,624
2022-04-26 13:16:27-04:00,16177,6NJFN855M3Q3RLTDNo57gTgAmwPD6G2E3WvMb1m5eNCN,3YpqNnonsvXaRT4nCC3G5FZx1jjVtbDPc36LiR6WK5jR,True,386278273,96569568,599802,299901,299901,gjBMZYVujDjD1ECG4i97M8Q3gV9ESnwwTSUGropkusj,23992111,87528451,-63536340,621
2022-04-26 13:16:33-04:00,16178,AoXamAP5a8TQVU1iASScAtAE6Dh2U6VwXTS2q7ksNfVp,FqffL8e7uWNqnu6ueuYQyKpoFhNxPjoKsR2gBkEgJcAM,False,14381639,14381639,889082,44454,844628,2a35JJeTUW1pm6M3e8DHCjp8qr4vbc2cRPhuzZWyFzYd,889082,5286550,-4397468,618
2022-04-26 13:16:53-04:00,16179,5wcyw2KsaCSSXaDocVzV8Yz9yHNG1E8TajEoeoBqiENL,2vuppCGeADLpY3sGJVLbmM5aRW3r5aHDgCBLS7QZoCg5,True,125570447,31392611,192738,96369,96369,68sueyVfmy5ToEGtLFGDkwebX47xAmzyXE29z8JrmcWv,7709539,25145299,-17435760,613
2022-04-26 13:17:24-04:00,16180,9VojCEgzn99QRVPGKn6euGRQbM7Q86GZ6yHJQa7N3gv4,GW4GVNnUtEt68avsowddpmjoUTUyMvxV4c5kY3Gzz9fT,True,375143539,36001478,224127,112063,112064,2xTUy2RS74GJMMDnmFaegMzFLn19RVfYG4CibhBmjP1i,23354643,178211364,-154856721,622
2022-04-26 13:17:30-04:00,16181,BWta2HTjCwDidjsgv1vPoD3gCHSGf679N1xijEj5jzD3,JEFa5ojXJ95W2NsV5j8qBENTm5n1uGfPDFwLRvebHDVn,True,1588172798,397043199,2467591,1233795,1233796,2xTUy2RS74GJMMDnmFaegMzFLn19RVfYG4CibhBmjP1i,98703659,328729207,-230025548,621
2022-04-26 13:17:30-04:00,16182,7X1UBUXhC59kzJKyroP6fe5GVtGCrVMZGKwbSnedkvwJ,5A24drY1wqNsjV6cABFfFx2D5BQ16m6vozbxvyUcXG4C,True,40509787,10127446,62820,31410,31410,gjBMZYVujDjD1ECG4i97M8Q3gV9ESnwwTSUGropkusj,2512803,13024029,-10511226,620
2022-04-26 13:18:24-04:00,16183,D8hA6qzDLFSTbkwvEdBsFZz5ykzuLP96FPhYh4uSh2PW,Bdj1hZnx27FrEw6wMKDheBFWFFDaKUdiq8Sv6WhL5gc5,True,44801604,11200401,69933,34966,34967,gjBMZYVujDjD1ECG4i97M8Q3gV9ESnwwTSUGropkusj,2797328,14240489,-11443161,624
2022-04-26 13:19:35-04:00,16184,EUHZeJkyUdeEzZP2hThoMTpfUJoZwoPqUus3hrnDkHUQ,7pbzABMyUg2d5LyUdo9rYM8MdrgcMt2MQ7EejmfG6kbN,True,82956873,20739218,129580,64790,64790,GXyFXZMNk2NFyEzw6JetVqsujqcz2yCixH7n8EpDJYWD,5183211,34856312,-29673101,624
2022-04-26 13:21:49-04:00,16185,DufAyX9ifvrS5bqJip1mqtKSGnfFTt5CqxktLMNsuqb8,EiXfkhfnq6HzpYkTWSjNGCETn77gzxgveAr9DJ8TKprZ,True,61856450,15464112,95023,47511,47512,A9TwRM1BMxqb8DCC7YNAMV6zPenEJm3HTZBy7wJKK58U,3800923,26367056,-22566133,614
2022-04-26 13:21:50-04:00,16186,5r3YEyxbXrMEwYCFyZXS5t1eRLDahPFxPBBYNyMfHfcZ,7fnHdwm7JWHREPPk7dMud4vEoYZqsiRYCMo6ZSQqMwQc,True,28766504,3733805,23130,11565,11565,2a35JJeTUW1pm6M3e8DHCjp8qr4vbc2cRPhuzZWyFzYd,1782058,15486941,-13704883,619
2022-04-26 13:21:54-04:00,16187,bYUscp4qgQap7iDu5R8tyBz73dov4j3zDV2FgDUvSDx,E4d8ank6Ymezu4ubD2tU5B5fXuoh2E1RQkrdaLgMfuaT,True,28780329,7195082,44189,22094,22095,2py1FiYeL2f7J3HU36qiJz6TD6HCmiTN36RyxYtapQCZ,1767561,13909849,-12142288,614
2022-04-26 13:22:02-04:00,16188,8J4BZXZzkK4SmWxc2YoaJRg9ivuuXbdVe5XpEhVds1ZM,3pirVwiye9NftvMpX5F7WpfcGZy5uV3c11xCdkkZbL9D,True,6710603462,1677647773,5078632,2539316,2539316,3zqXX6kzhkbW3d4TwD2CNjMRwxTbREXySekvq37kfCNk,203145713,334607002,-131461289,302
2022-04-26 13:24:01-04:00,16189,impmg97osZac6q2B4SjAewuVYdMu4kPAg9totcz9h9Y,7ytd7QqMrXK3bVLPsgWSQSTgyAZnmPsPoD42k4Frkbz,True,80130903,8111009,35146,17573,17573,DQCvC9mR68hJ3tJsUiddh6JwcBJAmntqGJR2nUsEq7yj,3472251,6676866,-3204615,433
2022-04-26 13:24:01-04:00,16190,7ueXVhSvXvttkeQ18w2cLh65naoEPvYF86RrdUK2Vc5Q,CKTehY1W6bw85cS4o7g2qXKjP4656Vwo37244BAEAiw1,True,265383034,66342615,414619,207309,207310,DQCvC9mR68hJ3tJsUiddh6JwcBJAmntqGJR2nUsEq7yj,16585566,99070527,-82484961,624
2022-04-26 13:55:52-04:00,16191,SEndYVMCKAeZUKSqGrMUSqXFmxtA9M1t4eXsUhVsTBF,3fcQQcbkpqodakamn82pFnMxBEPL2Drsg4jJNZ6dx72M,True,1150628035,145997402,963260,481630,481630,2py1FiYeL2f7J3HU36qiJz6TD6HCmiTN36RyxYtapQCZ,75916116,44011159,31904957,659
2022-04-26 14:06:47-04:00,16192,Br1j5Ftafei7ysu5SmqVZSoRe4uS4qCPeKSPHg55pyiE,G8fc7QvXjfkgBFvAVUgJFQS3VaF1biL9rktBExGa87Ks,True,17890743,4472685,27810,13905,13905,gjBMZYVujDjD1ECG4i97M8Q3gV9ESnwwTSUGropkusj,1112426,5748063,-4635637,621
2022-04-26 14:07:39-04:00,16193,B1zAiuxNrv8RTc7dDBoAihXEsu59R7KNywkRkw27J53x,5SVx4t6TzhXz7v9aMHKwbyYZxjBhskW8tkDVm1qquhuC,True,5939553173,1484888293,9221889,4610944,4610945,3zqXX6kzhkbW3d4TwD2CNjMRwxTbREXySekvq37kfCNk,368875575,1932334502,-1563458927,621
2022-04-26 14:07:39-04:00,16194,J6ndjmic8buVqwa4URRRgv2iTc4ekbYUHdcpa3DUCufN,7qvvczUw8ngwdQae49BiQwQmdV2SSWsAVV2tmZYL7gw6,True,2112563972,528140993,3230515,1615257,1615258,A2p75MbAbeUdHkPLkAjgGeiwuu9WPrkMHzjCkDXF1Xr3,129220627,665122460,-535901833,611
2022-04-26 14:34:02-04:00,16195,8gxJEB4eSp5R8Z4Vy8TChcbLWPG93cVhpGLYWPuo4UMz,5dykor5kUojjBccSkbKqsHJ61voZWnD2MDuSNvsF6ohA,True,31301150,7825287,48900,24450,24450,2a35JJeTUW1pm6M3e8DHCjp8qr4vbc2cRPhuzZWyFzYd,1956003,13651777,-11695774,624
2022-04-26 14:42:51-04:00,16196,HxEjbaeXyjRYmxhkvPER7iuevx9R3AH9rdAtAu9r4zxL,HUXTVWjDHoKRNDEt4qXC9c7BpDtjB2tSNW7bXhHXsMk9,True,24017785,6004167,37515,18757,18758,gjBMZYVujDjD1ECG4i97M8Q3gV9ESnwwTSUGropkusj,1500688,6133884,-4633196,624
2022-04-26 15:18:01-04:00,16197,6NJFN855M3Q3RLTDNo57gTgAmwPD6G2E3WvMb1m5eNCN,3YpqNnonsvXaRT4nCC3G5FZx1jjVtbDPc36LiR6WK5jR,True,283965027,70991256,440019,220009,220010,gjBMZYVujDjD1ECG4i97M8Q3gV9ESnwwTSUGropkusj,17600776,71002235,-53401459,619
2022-04-26 15:18:04-04:00,16198,AQr9mVmcXCNQhBVCfx63MwR6c4WqDSC9K2BZqr7N8LCx,CB7TWUaL381ounsLw6neAUaKRxJL9P1HC9uGX5e1Uxod,True,395800768,19101983,104797,52398,52399,gjBMZYVujDjD1ECG4i97M8Q3gV9ESnwwTSUGropkusj,21714564,105474165,-83759601,548
2022-04-26 15:18:08-04:00,16199,5wcyw2KsaCSSXaDocVzV8Yz9yHNG1E8TajEoeoBqiENL,2vuppCGeADLpY3sGJVLbmM5aRW3r5aHDgCBLS7QZoCg5,True,92447851,23111962,144280,72140,72140,2xTUy2RS74GJMMDnmFaegMzFLn19RVfYG4CibhBmjP1i,5771234,20578611,-14807377,624
2022-04-26 15:27:03-04:00,16200,7X1UBUXhC59kzJKyroP6fe5GVtGCrVMZGKwbSnedkvwJ,5A24drY1wqNsjV6cABFfFx2D5BQ16m6vozbxvyUcXG4C,True,29795299,7448824,46447,23223,23224,2py1FiYeL2f7J3HU36qiJz6TD6HCmiTN36RyxYtapQCZ,1857910,10328438,-8470528,623
2022-04-26 15:27:08-04:00,16201,BWta2HTjCwDidjsgv1vPoD3gCHSGf679N1xijEj5jzD3,JEFa5ojXJ95W2NsV5j8qBENTm5n1uGfPDFwLRvebHDVn,True,1168004553,292001138,1822842,911421,911421,2xTUy2RS74GJMMDnmFaegMzFLn19RVfYG4CibhBmjP1i,72913710,268649866,-195736156,624
2022-04-26 15:28:58-04:00,16202,D8hA6qzDLFSTbkwvEdBsFZz5ykzuLP96FPhYh4uSh2PW,Bdj1hZnx27FrEw6wMKDheBFWFFDaKUdiq8Sv6WhL5gc5,True,32935451,8233862,51401,25700,25701,gjBMZYVujDjD1ECG4i97M8Q3gV9ESnwwTSUGropkusj,2056069,11304273,-9248204,624
2022-04-26 15:29:03-04:00,16203,3qaXKaNNT8mpC4KnA868wYkDCojg8ukUVxN19dtfYbPM,5o21p7NCXgv5cYPtBqQVvR3Ses6mHceYgCNmd5VL3tkG,True,262577351,18217012,83542,41771,41771,gjBMZYVujDjD1ECG4i97M8Q3gV9ESnwwTSUGropkusj,12041654,52248850,-40207196,458
2022-04-26 15:29:19-04:00,16204,FhCW2CghBaoo1MkXUXUb4okam8g5beQofgs3WXerNYzn,HWSPdmF3hSnnfVe29Y5rDGSPqbMQv2ug1wYrdwJZNWFK,True,151778179,37944544,114636,57318,57318,2a35JJeTUW1pm6M3e8DHCjp8qr4vbc2cRPhuzZWyFzYd,4585445,13608525,-9023080,302
2022-04-26 15:32:32-04:00,16205,BTq6T9nDzYTPTRvxkhNLn82DF3RCWdRkatZUmSTGCu43,3Uuhmxo4tWMbrqowx2bQSJeWzMykUUcZanj29ptCmEa6,True,554912469,47819383,196556,98278,98278,A2p75MbAbeUdHkPLkAjgGeiwuu9WPrkMHzjCkDXF1Xr3,22809155,205800068,-182990913,411
2022-04-26 15:32:50-04:00,16206,7GpG8k6hM27vK1R5Sx1v5xUBuF6vybP41dcymjXDi5P7,7Aip6HDcbZ5mvoSucNupRS9enRdGx37F8L432K7V81do,True,36930752443,9232688110,56972165,28486082,28486083,2xTUy2RS74GJMMDnmFaegMzFLn19RVfYG4CibhBmjP1i,2278886604,5664859683,-3385973079,617
2022-04-26 15:33:08-04:00,16207,bYUscp4qgQap7iDu5R8tyBz73dov4j3zDV2FgDUvSDx,E4d8ank6Ymezu4ubD2tU5B5fXuoh2E1RQkrdaLgMfuaT,True,21186482,5296620,33025,16512,16513,gjBMZYVujDjD1ECG4i97M8Q3gV9ESnwwTSUGropkusj,1321020,10826539,-9505519,623
2022-04-26 15:33:12-04:00,16208,9VojCEgzn99QRVPGKn6euGRQbM7Q86GZ6yHJQa7N3gv4,GW4GVNnUtEt68avsowddpmjoUTUyMvxV4c5kY3Gzz9fT,True,337095451,30564634,190908,95454,95454,2a35JJeTUW1pm6M3e8DHCjp8qr4vbc2cRPhuzZWyFzYd,21055184,160564470,-139509286,624
2022-04-26 15:33:19-04:00,16209,EVMrznfJS54BZiywDD2WhUtxzicDtbEpm2a5yLrtCgRF,CpzsMYVYvKg8ihrX1cKRw7TDEYwD3kAyiX92hsf2KiTz,True,9315532201,1464601526,9037547,4518773,4518774,A9TwRM1BMxqb8DCC7YNAMV6zPenEJm3HTZBy7wJKK58U,574829141,3809780470,-3234951329,617
2022-04-26 15:33:42-04:00,16210,AQr9mVmcXCNQhBVCfx63MwR6c4WqDSC9K2BZqr7N8LCx,CB7TWUaL381ounsLw6neAUaKRxJL9P1HC9uGX5e1Uxod,True,374172457,20220284,110917,55458,55459,68sueyVfmy5ToEGtLFGDkwebX47xAmzyXE29z8JrmcWv,20525163,103751491,-83226328,548
2022-04-26 15:34:03-04:00,16211,HTaKM45d7RzEyCp6CT3escbGBsa7nU1kKwssmmjZbiW2,AikDqAGp97D1cZu77wrXBeU4z6dzd6iZQ3WMQi81aSbe,True,2671311235,667827808,4156052,2078026,2078026,A9TwRM1BMxqb8DCC7YNAMV6zPenEJm3HTZBy7wJKK58U,166242087,1245400836,-1079158749,622
2022-04-26 15:34:05-04:00,16212,6Zyz5SGNMpEtCBu7H2USCkJCKpAJxLJrdf7h8N1W4fwp,3TTgDXx7VPZtB7aJDMShctxL5Y5To2Ugz927CoHNRztJ,True,24386560,6096640,37647,18823,18824,gjBMZYVujDjD1ECG4i97M8Q3gV9ESnwwTSUGropkusj,1505911,13984449,-12478538,617
2022-04-26 15:34:12-04:00,16213,63RJUGNb2mPuiVvqCacwZ9BDvnqoPuBFbogvHNZukUSW,FyLe7q7PNK9VjdVv2xJyT4q9Wwj5BikVu3xhBirYPhVS,True,787222845,196805711,1224573,612286,612287,2a35JJeTUW1pm6M3e8DHCjp8qr4vbc2cRPhuzZWyFzYd,48982921,292998951,-244016030,622
2022-04-26 15:34:16-04:00,16214,SEndYVMCKAeZUKSqGrMUSqXFmxtA9M1t4eXsUhVsTBF,3fcQQcbkpqodakamn82pFnMxBEPL2Drsg4jJNZ6dx72M,True,992625155,112442142,743987,371993,371994,3zqXX6kzhkbW3d4TwD2CNjMRwxTbREXySekvq37kfCNk,65678328,32335544,33342784,661
2022-04-26 15:34:24-04:00,16215,DaHTFbsmuU4J1Erji8ZfqB1L2wSuY7DCxAuHoopwMHog,7tmPzHaeVyGdvMXWEuJzYRoSQfw4dH4Njyf6Rh3F7U9Z,True,201151893,50287973,313687,156843,156844,2a35JJeTUW1pm6M3e8DHCjp8qr4vbc2cRPhuzZWyFzYd,12547495,29536822,-16989327,623
2022-04-26 15:34:38-04:00,16216,impmg97osZac6q2B4SjAewuVYdMu4kPAg9totcz9h9Y,7ytd7QqMrXK3bVLPsgWSQSTgyAZnmPsPoD42k4Frkbz,True,71519353,5963689,24438,12219,12219,gjBMZYVujDjD1ECG4i97M8Q3gV9ESnwwTSUGropkusj,2930742,5160568,-2229826,409
2022-04-26 15:34:42-04:00,16217,7ueXVhSvXvttkeQ18w2cLh65naoEPvYF86RrdUK2Vc5Q,CKTehY1W6bw85cS4o7g2qXKjP4656Vwo37244BAEAiw1,True,195056722,48761041,303832,151916,151916,6UQfSsLooL4pQKQfLtXCutQS2BnF7A7F7ewJopDLmUpc,12154103,78003851,-65849748,623
2022-04-26 15:34:45-04:00,16218,D5VZNThkv6XD6bimPshD2J3PvbPXgCbivZuPfkVxgdjc,8C77LmMk4C3KvyEb1N3scdbAgwN7J45nAcv9tkL5namB,True,3549122794,887280698,5476588,2738294,2738294,6UQfSsLooL4pQKQfLtXCutQS2BnF7A7F7ewJopDLmUpc,219063525,910627730,-691564205,617
2022-04-26 15:34:47-04:00,16219,BTq6T9nDzYTPTRvxkhNLn82DF3RCWdRkatZUmSTGCu43,3Uuhmxo4tWMbrqowx2bQSJeWzMykUUcZanj29ptCmEa6,True,504143099,90346362,352369,176184,176185,3zqXX6kzhkbW3d4TwD2CNjMRwxTbREXySekvq37kfCNk,19662612,192308323,-172645711,390
2022-04-26 15:34:49-04:00,16220,9VojCEgzn99QRVPGKn6euGRQbM7Q86GZ6yHJQa7N3gv4,GW4GVNnUtEt68avsowddpmjoUTUyMvxV4c5kY3Gzz9fT,True,304657216,26731954,166632,83316,83316,A9TwRM1BMxqb8DCC7YNAMV6zPenEJm3HTZBy7wJKK58U,18990675,151386522,-132395847,623
2022-04-26 15:34:49-04:00,16221,F3Hq5hKQ7mh2PiaMDtqTd1xPrGCUszajivFu1pBqvsbk,6pjiEFs1jM2SvY5MCHpESPKg8EmUSPUSvEr19Z1WFy3X,True,64403973,16100993,48779,24389,24390,DQCvC9mR68hJ3tJsUiddh6JwcBJAmntqGJR2nUsEq7yj,1951188,5348437,-3397249,302
2022-04-26 15:34:57-04:00,16222,5r3YEyxbXrMEwYCFyZXS5t1eRLDahPFxPBBYNyMfHfcZ,7fnHdwm7JWHREPPk7dMud4vEoYZqsiRYCMo6ZSQqMwQc,True,24800321,3418597,21022,10511,10511,6UQfSsLooL4pQKQfLtXCutQS2BnF7A7F7ewJopDLmUpc,1525087,13324025,-11798938,614
2022-04-26 15:35:00-04:00,16223,J6ndjmic8buVqwa4URRRgv2iTc4ekbYUHdcpa3DUCufN,7qvvczUw8ngwdQae49BiQwQmdV2SSWsAVV2tmZYL7gw6,True,1555263814,388815953,2416316,1208158,1208158,gjBMZYVujDjD1ECG4i97M8Q3gV9ESnwwTSUGropkusj,96652675,527917395,-431264720,621
2022-04-26 15:35:10-04:00,16224,C4k1drtNpR2axjxWk6DMreczYo3kdRc95u49HUAzpS42,2xRS27CLv9ynXa6F7w7SESPtK1ryBcf5BFeAB59N5cWF,False,14570067,14570067,883277,44163,839114,gjBMZYVujDjD1ECG4i97M8Q3gV9ESnwwTSUGropkusj,883277,5401964,-4518687,606
2022-04-26 15:35:10-04:00,16225,Br1j5Ftafei7ysu5SmqVZSoRe4uS4qCPeKSPHg55pyiE,G8fc7QvXjfkgBFvAVUgJFQS3VaF1biL9rktBExGa87Ks,False,13134481,13134481,799534,39976,759558,gjBMZYVujDjD1ECG4i97M8Q3gV9ESnwwTSUGropkusj,799534,4559852,-3760318,608
2022-04-26 15:35:23-04:00,16226,FtF3PVw8YNJseWPMcA2GEuQZ6nni1mq5kYPa2LrSzfkW,4yr1TM2dXrBvLNMpSaoryuGU2P8D3WG1ZCkvVzWFiQRH,True,251066761,56194339,341057,170528,170529,2py1FiYeL2f7J3HU36qiJz6TD6HCmiTN36RyxYtapQCZ,15237916,141624546,-126386630,606
2022-04-26 15:35:23-04:00,16227,12GjTFcAZ5rnnR9DwXDUMmjFoyuFa3txDF4PPA4YoAQq,Ebm7YVYTYyMtEBM4STgbyyLuSFTwnnuFDQ1Wysvtj2vR,True,204842503,51210625,320025,160012,160013,DQCvC9mR68hJ3tJsUiddh6JwcBJAmntqGJR2nUsEq7yj,12801009,33723268,-20922259,624
2022-04-26 15:36:33-04:00,16228,EFHg5FatMRRSZnKJPJF9e1iw2cjPJRmwTTZYtkHno9DP,84LnLKhZDJgWFnbBYnYjqWkjymemXfidecPFwnUAvuFj,True,385498856,96374714,287251,143625,143626,2xTUy2RS74GJMMDnmFaegMzFLn19RVfYG4CibhBmjP1i,11490064,36837332,-25347268,298
2022-04-26 16:18:13-04:00,16229,AQr9mVmcXCNQhBVCfx63MwR6c4WqDSC9K2BZqr7N8LCx,CB7TWUaL381ounsLw6neAUaKRxJL9P1HC9uGX5e1Uxod,True,354458538,16695668,90981,45490,45491,68sueyVfmy5ToEGtLFGDkwebX47xAmzyXE29z8JrmcWv,19315999,96496957,-77180958,544
2022-04-26 16:21:29-04:00,16230,CPUz1JGqSsAJZPpZxs7TyUhMUJhuhbpDsqgPswzkrrrE,81VYgn6keKvAMob96W7pXJo4TZdYsTjksmDM1cWcyWPn,True,558023845,139505961,863896,431948,431948,2a35JJeTUW1pm6M3e8DHCjp8qr4vbc2cRPhuzZWyFzYd,34555869,122784170,-88228301,619
2022-04-26 19:09:21-04:00,16231,8gxJEB4eSp5R8Z4Vy8TChcbLWPG93cVhpGLYWPuo4UMz,5dykor5kUojjBccSkbKqsHJ61voZWnD2MDuSNvsF6ohA,True,22981180,5745295,34924,17462,17462,6UQfSsLooL4pQKQfLtXCutQS2BnF7A7F7ewJopDLmUpc,1396963,10663521,-9266558,607
2022-04-26 19:09:24-04:00,16232,3qaXKaNNT8mpC4KnA868wYkDCojg8ukUVxN19dtfYbPM,5o21p7NCXgv5cYPtBqQVvR3Ses6mHceYgCNmd5VL3tkG,True,243321225,33624875,150211,75105,75106,2a35JJeTUW1pm6M3e8DHCjp8qr4vbc2cRPhuzZWyFzYd,10869858,46981469,-36111611,446
2022-04-26 19:09:47-04:00,16233,HxEjbaeXyjRYmxhkvPER7iuevx9R3AH9rdAtAu9r4zxL,HUXTVWjDHoKRNDEt4qXC9c7BpDtjB2tSNW7bXhHXsMk9,True,17666267,4416292,27597,13798,13799,DQCvC9mR68hJ3tJsUiddh6JwcBJAmntqGJR2nUsEq7yj,1103974,4926175,-3822201,624
2022-04-26 19:10:33-04:00,16234,6NJFN855M3Q3RLTDNo57gTgAmwPD6G2E3WvMb1m5eNCN,3YpqNnonsvXaRT4nCC3G5FZx1jjVtbDPc36LiR6WK5jR,True,208825732,52206433,322401,161200,161201,2xTUy2RS74GJMMDnmFaegMzFLn19RVfYG4CibhBmjP1i,12896065,57098276,-44202211,617
2022-04-26 19:10:35-04:00,16235,5wcyw2KsaCSSXaDocVzV8Yz9yHNG1E8TajEoeoBqiENL,2vuppCGeADLpY3sGJVLbmM5aRW3r5aHDgCBLS7QZoCg5,True,67995718,16998929,106220,53110,53110,2xTUy2RS74GJMMDnmFaegMzFLn19RVfYG4CibhBmjP1i,4248800,16694823,-12446023,624
2022-04-26 19:10:57-04:00,16236,7X1UBUXhC59kzJKyroP6fe5GVtGCrVMZGKwbSnedkvwJ,5A24drY1wqNsjV6cABFfFx2D5BQ16m6vozbxvyUcXG4C,True,21911737,5477934,34111,17055,17056,gjBMZYVujDjD1ECG4i97M8Q3gV9ESnwwTSUGropkusj,1364460,8152131,-6787671,622
2022-04-26 19:11:00-04:00,16237,BWta2HTjCwDidjsgv1vPoD3gCHSGf679N1xijEj5jzD3,JEFa5ojXJ95W2NsV5j8qBENTm5n1uGfPDFwLRvebHDVn,True,858195293,214548823,1320043,660021,660022,2xTUy2RS74GJMMDnmFaegMzFLn19RVfYG4CibhBmjP1i,52801756,217463218,-164661462,615
2022-04-26 19:11:37-04:00,16238,impmg97osZac6q2B4SjAewuVYdMu4kPAg9totcz9h9Y,7ytd7QqMrXK3bVLPsgWSQSTgyAZnmPsPoD42k4Frkbz,True,65187489,11889881,46018,23009,23009,68sueyVfmy5ToEGtLFGDkwebX47xAmzyXE29z8JrmcWv,2523000,3894918,-1371918,387
2022-04-26 19:11:37-04:00,16239,D8hA6qzDLFSTbkwvEdBsFZz5ykzuLP96FPhYh4uSh2PW,Bdj1hZnx27FrEw6wMKDheBFWFFDaKUdiq8Sv6WhL5gc5,True,24222302,6055575,37794,18897,18897,68sueyVfmy5ToEGtLFGDkwebX47xAmzyXE29z8JrmcWv,1511793,8927278,-7415485,624
2022-04-26 19:11:45-04:00,16240,bYUscp4qgQap7iDu5R8tyBz73dov4j3zDV2FgDUvSDx,E4d8ank6Ymezu4ubD2tU5B5fXuoh2E1RQkrdaLgMfuaT,False,15566315,15566315,955703,47785,907918,2a35JJeTUW1pm6M3e8DHCjp8qr4vbc2cRPhuzZWyFzYd,955703,8408411,-7452708,613
2022-04-26 19:11:56-04:00,16241,BTq6T9nDzYTPTRvxkhNLn82DF3RCWdRkatZUmSTGCu43,3Uuhmxo4tWMbrqowx2bQSJeWzMykUUcZanj29ptCmEa6,True,411572417,35116928,144854,72427,72427,68sueyVfmy5ToEGtLFGDkwebX47xAmzyXE29z8JrmcWv,16977097,158835107,-141858010,412
2022-04-26 19:12:41-04:00,16242,3qaXKaNNT8mpC4KnA868wYkDCojg8ukUVxN19dtfYbPM,5o21p7NCXgv5cYPtBqQVvR3Ses6mHceYgCNmd5VL3tkG,True,208757321,13693836,64157,32078,32079,gjBMZYVujDjD1ECG4i97M8Q3gV9ESnwwTSUGropkusj,9780618,42955923,-33175305,468
2022-04-26 19:12:50-04:00,16243,7ueXVhSvXvttkeQ18w2cLh65naoEPvYF86RrdUK2Vc5Q,CKTehY1W6bw85cS4o7g2qXKjP4656Vwo37244BAEAiw1,True,143388875,35844087,221545,110772,110773,2a35JJeTUW1pm6M3e8DHCjp8qr4vbc2cRPhuzZWyFzYd,8862639,61157749,-52295110,618
2022-04-26 19:13:18-04:00,16244,AQr9mVmcXCNQhBVCfx63MwR6c4WqDSC9K2BZqr7N8LCx,CB7TWUaL381ounsLw6neAUaKRxJL9P1HC9uGX5e1Uxod,True,337240567,16672180,90338,45169,45169,3zqXX6kzhkbW3d4TwD2CNjMRwxTbREXySekvq37kfCNk,18273499,88874668,-70601169,541
2022-04-26 19:13:19-04:00,16245,8fVwuVA2CL5sZoHh6Dg4MBpcX3cvoUm7mnitnpQSdPBD,4F4ccaNm1KQu29XvsKvdjFkmpsbWqNvXkV41851EYQyu,True,154091265,10190652,47641,23820,23821,A2p75MbAbeUdHkPLkAjgGeiwuu9WPrkMHzjCkDXF1Xr3,7203851,38690218,-31486367,467
2022-04-26 19:13:36-04:00,16246,J6ndjmic8buVqwa4URRRgv2iTc4ekbYUHdcpa3DUCufN,7qvvczUw8ngwdQae49BiQwQmdV2SSWsAVV2tmZYL7gw6,True,1142956310,285739077,1752440,876220,876220,A9TwRM1BMxqb8DCC7YNAMV6zPenEJm3HTZBy7wJKK58U,70097602,417137566,-347039964,613
2022-04-26 19:17:28-04:00,16247,impmg97osZac6q2B4SjAewuVYdMu4kPAg9totcz9h9Y,7ytd7QqMrXK3bVLPsgWSQSTgyAZnmPsPoD42k4Frkbz,True,52981640,4363821,17799,8899,8900,2a35JJeTUW1pm6M3e8DHCjp8qr4vbc2cRPhuzZWyFzYd,2161014,4491299,-2330285,407
2022-04-26 19:17:56-04:00,16248,BTq6T9nDzYTPTRvxkhNLn82DF3RCWdRkatZUmSTGCu43,3Uuhmxo4tWMbrqowx2bQSJeWzMykUUcZanj29ptCmEa6,True,374143443,67449416,261764,130882,130882,GXyFXZMNk2NFyEzw6JetVqsujqcz2yCixH7n8EpDJYWD,14520197,147970585,-133450388,388
2022-04-26 19:17:56-04:00,16249,8gxJEB4eSp5R8Z4Vy8TChcbLWPG93cVhpGLYWPuo4UMz,5dykor5kUojjBccSkbKqsHJ61voZWnD2MDuSNvsF6ohA,True,16931975,4232993,26453,13226,13227,gjBMZYVujDjD1ECG4i97M8Q3gV9ESnwwTSUGropkusj,1058129,8311982,-7253853,624
2022-04-26 19:18:01-04:00,16250,SEndYVMCKAeZUKSqGrMUSqXFmxtA9M1t4eXsUhVsTBF,3fcQQcbkpqodakamn82pFnMxBEPL2Drsg4jJNZ6dx72M,True,874028568,104241578,685149,342574,342575,gjBMZYVujDjD1ECG4i97M8Q3gV9ESnwwTSUGropkusj,57447357,42938486,14508871,657
2022-04-26 19:18:11-04:00,16251,GNohZMtk1VAuhLAgNGT8J3HYCKDCiyjvLeAWr64d7Duy,6soTLVj9DzFht8DzvjRfNPAWhZuiDBS5fDE1fpeuDSSz,True,4081036389,1020259097,6375116,3187558,3187558,6UQfSsLooL4pQKQfLtXCutQS2BnF7A7F7ewJopDLmUpc,255004673,1055142499,-800137826,624
2022-04-26 19:18:11-04:00,16252,7zDNgPFeomS1hdQhuY8iGF3nnGMNnx1YrinZJetrefje,AKyG5R6Bac6Fu83ruL9FGpjKCfDKxbP6QfEGbCgqegiV,True,112424788,27881176,84631,42315,42316,2a35JJeTUW1pm6M3e8DHCjp8qr4vbc2cRPhuzZWyFzYd,3412626,12263599,-8850973,303
2022-04-26 19:18:11-04:00,16253,3qaXKaNNT8mpC4KnA868wYkDCojg8ukUVxN19dtfYbPM,5o21p7NCXgv5cYPtBqQVvR3Ses6mHceYgCNmd5VL3tkG,True,194229163,13240755,60550,30275,30275,gjBMZYVujDjD1ECG4i97M8Q3gV9ESnwwTSUGropkusj,8882139,41742281,-32860142,457
2022-04-26 19:18:12-04:00,16254,FhCW2CghBaoo1MkXUXUb4okam8g5beQofgs3WXerNYzn,HWSPdmF3hSnnfVe29Y5rDGSPqbMQv2ug1wYrdwJZNWFK,True,112673537,28168384,82457,41228,41229,gjBMZYVujDjD1ECG4i97M8Q3gV9ESnwwTSUGropkusj,3298290,11226474,-7928184,292
2022-04-26 19:18:21-04:00,16255,FU7X4DWnGTbxwXULBq3v9SACzYhQyFGqsXjUDzyFqiem,925BaEnWxTfEv4oQb9Xf1wyyEEWEr8kXeSdXTtRfShfw,True,121740528,30435132,187636,93818,93818,DQCvC9mR68hJ3tJsUiddh6JwcBJAmntqGJR2nUsEq7yj,7505456,33697694,-26192238,616
2022-04-26 19:18:27-04:00,16256,7frvVhg1eWJpsvG7ndjppb8Bmd1tFq5H1g26UiKZxqTP,3Ugo9b53e6e8PLnvKjqRP8pvvoubSPV6qiKtxey7mrGt,True,484970626,121242656,361684,180842,180842,2a35JJeTUW1pm6M3e8DHCjp8qr4vbc2cRPhuzZWyFzYd,14467384,113961280,-99493896,298
2022-04-26 19:18:27-04:00,16257,4PZZxNrWLhNCuT5VJ1DQe3XxQVVwMPrjfUpdeAY8qS7U,A7CvKre7y5VbUN1HneNHmuBv7jWtayV78oozAqaVbQrv,True,45901274,11475318,34018,17009,17009,GXyFXZMNk2NFyEzw6JetVqsujqcz2yCixH7n8EpDJYWD,1360749,21606716,-20245967,296
2022-04-26 19:18:29-04:00,16258,HxEjbaeXyjRYmxhkvPER7iuevx9R3AH9rdAtAu9r4zxL,HUXTVWjDHoKRNDEt4qXC9c7BpDtjB2tSNW7bXhHXsMk9,False,12979958,12979947,806374,40318,766056,2a35JJeTUW1pm6M3e8DHCjp8qr4vbc2cRPhuzZWyFzYd,806376,3943001,-3136625,621
2022-04-26 19:18:30-04:00,16259,4tsi43FGMTZiGUuX8Xp84hjnWpNbLSMjd81zGwK6egZU,H8xKg7KubTiB37cKc4aTeMEbiqzRysK2THrKjtZ6Z4ur,True,380967038,95241759,287518,143759,143759,DQCvC9mR68hJ3tJsUiddh6JwcBJAmntqGJR2nUsEq7yj,11500734,90095141,-78594407,301
2022-04-26 19:18:35-04:00,16260,8fVwuVA2CL5sZoHh6Dg4MBpcX3cvoUm7mnitnpQSdPBD,4F4ccaNm1KQu29XvsKvdjFkmpsbWqNvXkV41851EYQyu,True,143271421,9488528,43226,21613,21613,3zqXX6kzhkbW3d4TwD2CNjMRwxTbREXySekvq37kfCNk,6527018,37892789,-31365771,455
2022-04-26 19:18:38-04:00,16261,6NJFN855M3Q3RLTDNo57gTgAmwPD6G2E3WvMb1m5eNCN,3YpqNnonsvXaRT4nCC3G5FZx1jjVtbDPc36LiR6WK5jR,True,153485789,38371447,236003,118001,118002,2a35JJeTUW1pm6M3e8DHCjp8qr4vbc2cRPhuzZWyFzYd,9440154,45727037,-36286883,615
2022-04-26 19:18:38-04:00,16262,5wcyw2KsaCSSXaDocVzV8Yz9yHNG1E8TajEoeoBqiENL,2vuppCGeADLpY3sGJVLbmM5aRW3r5aHDgCBLS7QZoCg5,True,49976102,12494025,78047,39023,39024,2a35JJeTUW1pm6M3e8DHCjp8qr4vbc2cRPhuzZWyFzYd,3121893,13477275,-10355382,624
2022-04-26 19:18:42-04:00,16263,EUHZeJkyUdeEzZP2hThoMTpfUJoZwoPqUus3hrnDkHUQ,7pbzABMyUg2d5LyUdo9rYM8MdrgcMt2MQ7EejmfG6kbN,True,60952276,15238069,94111,47055,47056,68sueyVfmy5ToEGtLFGDkwebX47xAmzyXE29z8JrmcWv,3764442,27284816,-23520374,617
2022-04-26 19:18:48-04:00,16264,impmg97osZac6q2B4SjAewuVYdMu4kPAg9totcz9h9Y,7ytd7QqMrXK3bVLPsgWSQSTgyAZnmPsPoD42k4Frkbz,True,48358434,8837043,34424,17212,17212,2xTUy2RS74GJMMDnmFaegMzFLn19RVfYG4CibhBmjP1i,1883830,3444982,-1561152,389
2022-04-26 19:18:48-04:00,16265,DmwHBt9RS9QZesz2k6NsiC9CXCvgaGSTWycWj8nCdkC6,EEN2iGeHGY9AbsrBTgs9CFNTfdiGWymzt6VGto8ZGyfF,True,1013825792,253456448,767441,383720,383721,6UQfSsLooL4pQKQfLtXCutQS2BnF7A7F7ewJopDLmUpc,30697657,61663456,-30965799,302
2022-04-26 19:18:55-04:00,16266,AXBfrbCpYAWKN5jgDVVMiKXscQ96YtotKV3DT6XSzm9o,Dh3SiHAqrQzPQnTLRMxtBn2EFyHNgyfnYGpgcuNGTvyL,True,628871937,157217984,980342,490171,490171,gjBMZYVujDjD1ECG4i97M8Q3gV9ESnwwTSUGropkusj,39213711,214892534,-175678823,623
2022-04-26 19:18:55-04:00,16267,GHHkWuoUrAsuf1n8Y2GFozQxxv3LSr2zU9DWwKmAGTG9,7Fr2hNXbiNUufq8USBK3HwWN4bQT6H9fcFzDt7fdKy2U,True,287624429416,71906107354,214628081,107314040,107314041,2a35JJeTUW1pm6M3e8DHCjp8qr4vbc2cRPhuzZWyFzYd,8585123254,47184610195,-38599486941,298
2022-04-26 19:18:56-04:00,16268,BTq6T9nDzYTPTRvxkhNLn82DF3RCWdRkatZUmSTGCu43,3Uuhmxo4tWMbrqowx2bQSJeWzMykUUcZanj29ptCmEa6,True,304057531,25965701,99248,49624,49624,gjBMZYVujDjD1ECG4i97M8Q3gV9ESnwwTSUGropkusj,11621937,122638843,-111016906,382
2022-04-26 19:18:59-04:00,16269,7CSCMFa9W52tBDVUbXbc3woAy3GByeA1wPJdp3MgznPa,3447ptuVFu6G8B6N63RmS8mRv4n9PfHneypHLvbeaGLn,True,68814674,9265202,40300,20150,20150,2a35JJeTUW1pm6M3e8DHCjp8qr4vbc2cRPhuzZWyFzYd,2993240,30263980,-27270740,434
2022-04-26 19:19:01-04:00,16270,8J4BZXZzkK4SmWxc2YoaJRg9ivuuXbdVe5XpEhVds1ZM,3pirVwiye9NftvMpX5F7WpfcGZy5uV3c11xCdkkZbL9D,True,4986325734,1246578464,3741902,1870951,1870951,3zqXX6kzhkbW3d4TwD2CNjMRwxTbREXySekvq37kfCNk,149676449,295449692,-145773243,300
2022-04-26 19:19:05-04:00,16271,EFHg5FatMRRSZnKJPJF9e1iw2cjPJRmwTTZYtkHno9DP,84LnLKhZDJgWFnbBYnYjqWkjymemXfidecPFwnUAvuFj,True,285648634,71412158,192384,96192,96192,A9TwRM1BMxqb8DCC7YNAMV6zPenEJm3HTZBy7wJKK58U,7695399,30182588,-22487189,269
2022-04-26 19:19:07-04:00,16272,5BjBPqumCb9KC82ZNNch3dcRzbpGdRLJneru7o9a1D9R,FuZtBWKktxFu4yoiLVMzxq8fMhQyN8SGzGPz49xs3m6P,True,251654046,34535070,160334,80167,80167,2a35JJeTUW1pm6M3e8DHCjp8qr4vbc2cRPhuzZWyFzYd,11683479,80831952,-69148473,464
2022-04-26 19:19:12-04:00,16273,9VojCEgzn99QRVPGKn6euGRQbM7Q86GZ6yHJQa7N3gv4,GW4GVNnUtEt68avsowddpmjoUTUyMvxV4c5kY3Gzz9fT,True,276459968,26395928,164842,82421,82421,3zqXX6kzhkbW3d4TwD2CNjMRwxTbREXySekvq37kfCNk,17264931,138306561,-121041630,624
2022-04-26 19:19:14-04:00,16274,3qaXKaNNT8mpC4KnA868wYkDCojg8ukUVxN19dtfYbPM,5o21p7NCXgv5cYPtBqQVvR3Ses6mHceYgCNmd5VL3tkG,True,180213228,24936788,111341,55670,55671,2a35JJeTUW1pm6M3e8DHCjp8qr4vbc2cRPhuzZWyFzYd,8046409,37408605,-29362196,446
2022-04-26 19:19:16-04:00,16275,AQr9mVmcXCNQhBVCfx63MwR6c4WqDSC9K2BZqr7N8LCx,CB7TWUaL381ounsLw6neAUaKRxJL9P1HC9uGX5e1Uxod,True,318079482,14225029,76217,38108,38109,2a35JJeTUW1pm6M3e8DHCjp8qr4vbc2cRPhuzZWyFzYd,17042608,87100634,-70058026,535
2022-04-26 19:19:23-04:00,16276,68RZsaAJib9kw5xnnt9QhvsAa1DGJzww1MKqACsMvxGr,3z8H2C111LCABJymwxJAG9boicBXcJXq3ft6jqmV9rSw,True,55107874,13776968,97635,48817,48818,gjBMZYVujDjD1ECG4i97M8Q3gV9ESnwwTSUGropkusj,3905405,15543350,-11637945,708
2022-04-26 19:19:30-04:00,16277,FxtKooBW3e48DMxccJ4kcQVuZC9HyaZQeSXY64uNYNfx,GHBxYQdaR5CLbdJHTUPofKc4P32R7HV4pyuJjPXJSsGW,True,107320963,26830240,163497,81748,81749,2a35JJeTUW1pm6M3e8DHCjp8qr4vbc2cRPhuzZWyFzYd,6539880,49220407,-42680527,609
2022-04-26 19:19:30-04:00,16278,FRbeFwhUYCiHW5oP26mad8KND7CCYDbfnoNxX7GuXVp8,GrzXKxPX2WDka8i2D8sunMUsrsThKasQi8NYLwuCGygV,True,9164337264,1563602279,6312718,3156359,3156359,3zqXX6kzhkbW3d4TwD2CNjMRwxTbREXySekvq37kfCNk,369991065,2379759710,-2009768645,403
2022-04-26 19:19:31-04:00,16279,68gVM4kjmSYxT1uJW13rYSway8uVLUdcLa7sJuqHQaAf,DshroBQ3da7BcAiQpiFREsLKWbUDrBRmmZRw3Zu2Qfs9,True,14212927668,3553231917,10459083,5229541,5229542,3zqXX6kzhkbW3d4TwD2CNjMRwxTbREXySekvq37kfCNk,418363346,1550732904,-1132369558,294
2022-04-26 19:19:36-04:00,16280,7zDNgPFeomS1hdQhuY8iGF3nnGMNnx1YrinZJetrefje,AKyG5R6Bac6Fu83ruL9FGpjKCfDKxbP6QfEGbCgqegiV,True,83753110,20713886,62757,31378,31379,3zqXX6kzhkbW3d4TwD2CNjMRwxTbREXySekvq37kfCNk,2537493,9991632,-7454139,302
2022-04-26 19:19:36-04:00,16281,FhCW2CghBaoo1MkXUXUb4okam8g5beQofgs3WXerNYzn,HWSPdmF3hSnnfVe29Y5rDGSPqbMQv2ug1wYrdwJZNWFK,True,83786917,20946729,62439,31219,31220,6UQfSsLooL4pQKQfLtXCutQS2BnF7A7F7ewJopDLmUpc,2497597,9162406,-6664809,298
2022-04-26 19:19:41-04:00,16282,DufAyX9ifvrS5bqJip1mqtKSGnfFTt5CqxktLMNsuqb8,EiXfkhfnq6HzpYkTWSjNGCETn77gzxgveAr9DJ8TKprZ,True,45390985,11347746,67168,33584,33584,A2p75MbAbeUdHkPLkAjgGeiwuu9WPrkMHzjCkDXF1Xr3,2686723,20612771,-17926048,591
2022-04-26 19:19:42-04:00,16283,8fVwuVA2CL5sZoHh6Dg4MBpcX3cvoUm7mnitnpQSdPBD,4F4ccaNm1KQu29XvsKvdjFkmpsbWqNvXkV41851EYQyu,True,133202588,18619565,82521,41260,41261,GXyFXZMNk2NFyEzw6JetVqsujqcz2yCixH7n8EpDJYWD,5903487,33796046,-27892559,443
2022-04-26 19:19:43-04:00,16284,7X1UBUXhC59kzJKyroP6fe5GVtGCrVMZGKwbSnedkvwJ,5A24drY1wqNsjV6cABFfFx2D5BQ16m6vozbxvyUcXG4C,False,16098605,16098605,995151,49757,945394,A2p75MbAbeUdHkPLkAjgGeiwuu9WPrkMHzjCkDXF1Xr3,995151,6421123,-5425972,618
2022-04-26 19:19:46-04:00,16285,BWta2HTjCwDidjsgv1vPoD3gCHSGf679N1xijEj5jzD3,JEFa5ojXJ95W2NsV5j8qBENTm5n1uGfPDFwLRvebHDVn,True,631244891,157811222,977003,488501,488502,3zqXX6kzhkbW3d4TwD2CNjMRwxTbREXySekvq37kfCNk,39080134,175006331,-135926197,619
2022-04-26 19:19:50-04:00,16286,5r3YEyxbXrMEwYCFyZXS5t1eRLDahPFxPBBYNyMfHfcZ,7fnHdwm7JWHREPPk7dMud4vEoYZqsiRYCMo6ZSQqMwQc,True,21203349,2739905,17053,8526,8527,GXyFXZMNk2NFyEzw6JetVqsujqcz2yCixH7n8EpDJYWD,1319760,11969966,-10650206,622
2022-04-26 19:19:54-04:00,16287,AQr9mVmcXCNQhBVCfx63MwR6c4WqDSC9K2BZqr7N8LCx,CB7TWUaL381ounsLw6neAUaKRxJL9P1HC9uGX5e1Uxod,True,302743009,14856426,78446,39223,39223,A9TwRM1BMxqb8DCC7YNAMV6zPenEJm3HTZBy7wJKK58U,15985777,85912288,-69926511,528
2022-04-26 19:20:01-04:00,16288,7CSCMFa9W52tBDVUbXbc3woAy3GByeA1wPJdp3MgznPa,3447ptuVFu6G8B6N63RmS8mRv4n9PfHneypHLvbeaGLn,True,59405807,4275670,20219,10109,10110,A2p75MbAbeUdHkPLkAjgGeiwuu9WPrkMHzjCkDXF1Xr3,2809275,26919523,-24110248,472
2022-04-26 19:20:03-04:00,16289,A5NXadGWnFZRoHEn1dKTRjcXgWmfMLMyJdpF4rQPZyRR,ALs3Zfotc4c4A6TFDMbd5GM5whK1dTYSnGrHiMBWmApH,True,191506455,47876175,297850,148925,148925,gjBMZYVujDjD1ECG4i97M8Q3gV9ESnwwTSUGropkusj,11914145,95062556,-83148411,622
2022-04-26 19:20:10-04:00,16290,63RJUGNb2mPuiVvqCacwZ9BDvnqoPuBFbogvHNZukUSW,FyLe7q7PNK9VjdVv2xJyT4q9Wwj5BikVu3xhBirYPhVS,True,578064128,144516032,878219,439109,439110,2a35JJeTUW1pm6M3e8DHCjp8qr4vbc2cRPhuzZWyFzYd,35128778,230508277,-195379499,607
2022-04-26 19:20:11-04:00,16291,3qaXKaNNT8mpC4KnA868wYkDCojg8ukUVxN19dtfYbPM,5o21p7NCXgv5cYPtBqQVvR3Ses6mHceYgCNmd5VL3tkG,True,154267795,10209114,45837,22918,22919,gjBMZYVujDjD1ECG4i97M8Q3gV9ESnwwTSUGropkusj,6926423,34108611,-27182188,448
2022-04-26 19:20:12-04:00,16292,impmg97osZac6q2B4SjAewuVYdMu4kPAg9totcz9h9Y,7ytd7QqMrXK3bVLPsgWSQSTgyAZnmPsPoD42k4Frkbz,True,39197742,3200135,12456,6228,6228,gjBMZYVujDjD1ECG4i97M8Q3gV9ESnwwTSUGropkusj,1525757,3811982,-2286225,389
2022-04-26 19:20:13-04:00,16293,BTq6T9nDzYTPTRvxkhNLn82DF3RCWdRkatZUmSTGCu43,3Uuhmxo4tWMbrqowx2bQSJeWzMykUUcZanj29ptCmEa6,True,277363981,50181807,195304,97652,97652,2py1FiYeL2f7J3HU36qiJz6TD6HCmiTN36RyxYtapQCZ,10794840,114127479,-103332639,389
2022-04-26 19:20:17-04:00,16294,SEndYVMCKAeZUKSqGrMUSqXFmxtA9M1t4eXsUhVsTBF,3fcQQcbkpqodakamn82pFnMxBEPL2Drsg4jJNZ6dx72M,True,760124092,84782272,536249,268124,268125,DQCvC9mR68hJ3tJsUiddh6JwcBJAmntqGJR2nUsEq7yj,48077994,28970311,19107683,632
2022-04-26 19:20:18-04:00,16295,7ueXVhSvXvttkeQ18w2cLh65naoEPvYF86RrdUK2Vc5Q,CKTehY1W6bw85cS4o7g2qXKjP4656Vwo37244BAEAiw1,True,104717331,26176217,145325,72662,72663,DQCvC9mR68hJ3tJsUiddh6JwcBJAmntqGJR2nUsEq7yj,5813759,47862746,-42048987,555
2022-04-26 19:20:25-04:00,16296,2TX5VVdU5eEyJvmhZw3kryUeoC7TnKwoTerd8g2y3TPu,5y3GUw6HECEDFf6FshpeqFV2QhCr3EDs4ouYYhWSq4C,True,107020400,26755100,158410,79205,79205,A2p75MbAbeUdHkPLkAjgGeiwuu9WPrkMHzjCkDXF1Xr3,6336415,49317739,-42981324,592
2022-04-26 19:20:25-04:00,16297,J6ndjmic8buVqwa4URRRgv2iTc4ekbYUHdcpa3DUCufN,7qvvczUw8ngwdQae49BiQwQmdV2SSWsAVV2tmZYL7gw6,True,838050691,209512672,1229465,614732,614733,GXyFXZMNk2NFyEzw6JetVqsujqcz2yCixH7n8EpDJYWD,49178620,328680752,-279502132,586
2022-04-26 19:20:25-04:00,16298,D8hA6qzDLFSTbkwvEdBsFZz5ykzuLP96FPhYh4uSh2PW,Bdj1hZnx27FrEw6wMKDheBFWFFDaKUdiq8Sv6WhL5gc5,False,17595774,17595774,903046,45152,857894,2a35JJeTUW1pm6M3e8DHCjp8qr4vbc2cRPhuzZWyFzYd,903046,7035638,-6132592,513
2022-04-26 19:20:27-04:00,16299,9VojCEgzn99QRVPGKn6euGRQbM7Q86GZ6yHJQa7N3gv4,GW4GVNnUtEt68avsowddpmjoUTUyMvxV4c5kY3Gzz9fT,True,248394182,22438914,139390,69695,69695,2xTUy2RS74GJMMDnmFaegMzFLn19RVfYG4CibhBmjP1i,15430231,124490759,-109060528,621
2022-04-26 19:20:38-04:00,16300,6Zyz5SGNMpEtCBu7H2USCkJCKpAJxLJrdf7h8N1W4fwp,3TTgDXx7VPZtB7aJDMShctxL5Y5To2Ugz927CoHNRztJ,True,17940431,4485107,27833,13916,13917,68sueyVfmy5ToEGtLFGDkwebX47xAmzyXE29z8JrmcWv,1113356,10821765,-9708409,620
2022-04-26 19:20:49-04:00,16301,3RpbaFEL5ZYrQBPpaAeCUXs43Ssdr5Tm4ScMGtp6XbYF,CpKGwcVZrd3vKTNhdF8xNsd77FT3QxQWb7xFQxiyPB5p,True,14160644548,3540161137,22027302,11013651,11013651,3zqXX6kzhkbW3d4TwD2CNjMRwxTbREXySekvq37kfCNk,881092109,3881967461,-3000875352,622
2022-04-27 00:38:43-04:00,16302,43Wk9mS6z1XFiYptRNTkGsJhuFZEuEMWsW8xJzJ2EGf9,9HzrjVGu1hSdcoLnayPA15wTkiJjWqB4ZipwTE9DGP99,True,167545948,41886487,126825,63412,63413,2a35JJeTUW1pm6M3e8DHCjp8qr4vbc2cRPhuzZWyFzYd,5073029,8271194,-3198165,302
2022-04-27 02:46:22-04:00,16303,43Wk9mS6z1XFiYptRNTkGsJhuFZEuEMWsW8xJzJ2EGf9,9HzrjVGu1hSdcoLnayPA15wTkiJjWqB4ZipwTE9DGP99,True,126768244,31692061,95971,47985,47986,gjBMZYVujDjD1ECG4i97M8Q3gV9ESnwwTSUGropkusj,3838870,7346489,-3507619,302
2022-04-27 02:48:54-04:00,16304,8g2UEjCqCdEj6pDAJVdP8xLC1AzPWEF7Ti797fBt4Ecq,FZ1CQFp3WEeJAopMT14YwV7wyaS4Fypk5hfHGRudYKVn,False,10259902,10259902,719339,35966,683373,68sueyVfmy5ToEGtLFGDkwebX47xAmzyXE29z8JrmcWv,719339,988452,-269113,701
2022-04-27 03:01:47-04:00,16305,31tyt6M4RuSjM1pZ9tXbPSdVDNr7q4CU66tHD5soPHkT,G9n4eXhx2Lh7b8FGauiAXBd3PgbH7PAVHYREkXjVXBns,True,797632175,199408043,602916,301458,301458,A2p75MbAbeUdHkPLkAjgGeiwuu9WPrkMHzjCkDXF1Xr3,24116657,38566794,-14450137,302
2022-04-27 03:42:26-04:00,16306,43Wk9mS6z1XFiYptRNTkGsJhuFZEuEMWsW8xJzJ2EGf9,9HzrjVGu1hSdcoLnayPA15wTkiJjWqB4ZipwTE9DGP99,True,95924593,23981148,72373,36186,36187,2a35JJeTUW1pm6M3e8DHCjp8qr4vbc2cRPhuzZWyFzYd,2894938,6374182,-3479244,301
2022-04-27 04:00:22-04:00,16307,31tyt6M4RuSjM1pZ9tXbPSdVDNr7q4CU66tHD5soPHkT,G9n4eXhx2Lh7b8FGauiAXBd3PgbH7PAVHYREkXjVXBns,True,603459898,150864974,456960,228480,228480,gjBMZYVujDjD1ECG4i97M8Q3gV9ESnwwTSUGropkusj,18278429,34356587,-16078158,302
2022-04-27 04:17:48-04:00,16308,43Wk9mS6z1XFiYptRNTkGsJhuFZEuEMWsW8xJzJ2EGf9,9HzrjVGu1hSdcoLnayPA15wTkiJjWqB4ZipwTE9DGP99,True,72570968,18142742,54877,27438,27439,2a35JJeTUW1pm6M3e8DHCjp8qr4vbc2cRPhuzZWyFzYd,2195096,5432119,-3237023,302
2022-04-27 09:49:28-04:00,16309,31tyt6M4RuSjM1pZ9tXbPSdVDNr7q4CU66tHD5soPHkT,G9n4eXhx2Lh7b8FGauiAXBd3PgbH7PAVHYREkXjVXBns,True,456743782,114185945,341828,170914,170914,68sueyVfmy5ToEGtLFGDkwebX47xAmzyXE29z8JrmcWv,13673128,29883310,-16210182,299
2022-04-27 10:12:06-04:00,16310,DHfy6B2AYsqMCxPLBCXMDfQn3Gr2VwJaLFHUZKqpCjsb,EPZpYaY1gCAb8pMtri5veRowBmCrCpTHBMa3Rmgt6S29,True,960725341,240181335,727614,363807,363807,2a35JJeTUW1pm6M3e8DHCjp8qr4vbc2cRPhuzZWyFzYd,29104592,48027980,-18923388,302
2022-04-27 10:17:48-04:00,16311,DXZMRSKFgnNdiXHps2xzayuztJNH9EUUz2wkCCneXtW5,9Z2sUfTCZCkmw5n3HSsoLG992AcpJo2qxp7XpJnnBxZM,True,2763709677,690927177,2079855,1039927,1039928,2a35JJeTUW1pm6M3e8DHCjp8qr4vbc2cRPhuzZWyFzYd,83194266,144750815,-61556549,301
2022-04-27 10:20:08-04:00,16312,DHfy6B2AYsqMCxPLBCXMDfQn3Gr2VwJaLFHUZKqpCjsb,EPZpYaY1gCAb8pMtri5veRowBmCrCpTHBMa3Rmgt6S29,True,713752167,178438041,539628,269814,269814,2py1FiYeL2f7J3HU36qiJz6TD6HCmiTN36RyxYtapQCZ,21585139,42576741,-20991602,302
2022-04-27 12:05:39-04:00,16313,CzWT7zuiD3Usn1DB8C87kZ3yaLcAd1GXe62cZ5xDdEKa,2AsTxJr8dyhHmccUngu2f6beGE9iiXH4yXhmQ48SpCXm,True,100392122,15238021,83910,41955,41955,68sueyVfmy5ToEGtLFGDkwebX47xAmzyXE29z8JrmcWv,5528255,30927614,-25399359,550
2022-04-27 12:33:14-04:00,16314,CBEv8v9XZrgFT8UdEdd813XnRVv9R7GB5PLMyG8UWGC8,4uNcMEcQpJdThpisgNrttkQJTUFTsjEr25qgjkm4titC,True,101896553,8518551,37489,18744,18745,C4UnXuShCvjSMgBAgVNMy1oakxCNk1et27A82fywU112,4484467,14814543,-10330076,440
2022-04-27 12:36:00-04:00,16315,CBEv8v9XZrgFT8UdEdd813XnRVv9R7GB5PLMyG8UWGC8,4uNcMEcQpJdThpisgNrttkQJTUFTsjEr25qgjkm4titC,True,93786873,16939197,70565,35282,35283,68sueyVfmy5ToEGtLFGDkwebX47xAmzyXE29z8JrmcWv,3906991,13758573,-9851582,416
2022-04-27 12:43:31-04:00,16316,9NZhB8VtULVD4bMRA7694UR4YRnrNxixswurNoExWviW,6L3WycDHRoRsipk7YrExynUqgx31P7dNGw9eNU7Jdnnw,True,120433524,30108381,214594,107297,107297,2a35JJeTUW1pm6M3e8DHCjp8qr4vbc2cRPhuzZWyFzYd,8583797,21444870,-12861073,712
2022-04-27 12:43:36-04:00,16317,CBEv8v9XZrgFT8UdEdd813XnRVv9R7GB5PLMyG8UWGC8,4uNcMEcQpJdThpisgNrttkQJTUFTsjEr25qgjkm4titC,True,77207370,6608930,28974,14487,14487,2a35JJeTUW1pm6M3e8DHCjp8qr4vbc2cRPhuzZWyFzYd,3384844,12107678,-8722834,438
2022-04-27 12:43:37-04:00,16318,H3wBiU5HFm5ff8sPgREkEhBUz4HiE8cxfgSxzWVfgSd6,DyVZzezvAvEjwqbriA2jQBXLpMqMPHvXhjkbFX7G4B5,True,9256972038,1609299556,9430367,4715183,4715184,2a35JJeTUW1pm6M3e8DHCjp8qr4vbc2cRPhuzZWyFzYd,542451217,1483472628,-941021411,585
2022-04-27 12:58:49-04:00,16319,CBEv8v9XZrgFT8UdEdd813XnRVv9R7GB5PLMyG8UWGC8,4uNcMEcQpJdThpisgNrttkQJTUFTsjEr25qgjkm4titC,True,70518396,12632296,52861,26430,26431,2a35JJeTUW1pm6M3e8DHCjp8qr4vbc2cRPhuzZWyFzYd,2950984,11094801,-8143817,418
2022-04-27 13:11:11-04:00,16320,9NZhB8VtULVD4bMRA7694UR4YRnrNxixswurNoExWviW,6L3WycDHRoRsipk7YrExynUqgx31P7dNGw9eNU7Jdnnw,True,92243201,23060800,161590,80795,80795,68sueyVfmy5ToEGtLFGDkwebX47xAmzyXE29z8JrmcWv,6463625,18028220,-11564595,700
2022-04-27 13:11:22-04:00,16321,H3wBiU5HFm5ff8sPgREkEhBUz4HiE8cxfgSxzWVfgSd6,DyVZzezvAvEjwqbriA2jQBXLpMqMPHvXhjkbFX7G4B5,True,7733094018,1229889998,6930561,3465280,3465281,68sueyVfmy5ToEGtLFGDkwebX47xAmzyXE29z8JrmcWv,435768154,1285555828,-849787674,563
2022-04-27 13:13:03-04:00,16322,CBEv8v9XZrgFT8UdEdd813XnRVv9R7GB5PLMyG8UWGC8,4uNcMEcQpJdThpisgNrttkQJTUFTsjEr25qgjkm4titC,True,58138528,5068224,22541,11270,11271,2a35JJeTUW1pm6M3e8DHCjp8qr4vbc2cRPhuzZWyFzYd,2585774,9787168,-7201394,444
2022-04-27 13:16:17-04:00,16323,CW93ahtJm7jTwZxVCWTAfjpu19qyUZtXo1DrZFFkaSKe,5xLuUAgk9fAvBhPyUaWHfH6c5ejzefLt7X17mEcxvvQW,True,1241854756,104230974,505295,252647,252648,3zqXX6kzhkbW3d4TwD2CNjMRwxTbREXySekvq37kfCNk,60203264,129076994,-68873730,484
2022-04-27 13:16:30-04:00,16324,CzWT7zuiD3Usn1DB8C87kZ3yaLcAd1GXe62cZ5xDdEKa,2AsTxJr8dyhHmccUngu2f6beGE9iiXH4yXhmQ48SpCXm,True,85757457,11630571,60054,30027,30027,68sueyVfmy5ToEGtLFGDkwebX47xAmzyXE29z8JrmcWv,4428113,25271650,-20843537,516
2022-04-27 13:46:30-04:00,16325,GKbDACVE2yR8WwrMeGfSQuSXLqXR3B1N5YzZ93i5xyeB,B5EEB6xDf7fwwaE6CaJjwsgCNNdUc29tjW1gY2pHiKxq,True,10196500543,2549125135,18086986,9043493,9043493,68sueyVfmy5ToEGtLFGDkwebX47xAmzyXE29z8JrmcWv,723479455,1649229432,-925749977,709
2022-04-27 13:46:50-04:00,16326,9NZhB8VtULVD4bMRA7694UR4YRnrNxixswurNoExWviW,6L3WycDHRoRsipk7YrExynUqgx31P7dNGw9eNU7Jdnnw,True,70463901,17615975,125513,62756,62757,2a35JJeTUW1pm6M3e8DHCjp8qr4vbc2cRPhuzZWyFzYd,5020535,14975898,-9955363,712
2022-04-27 13:47:54-04:00,16327,H3wBiU5HFm5ff8sPgREkEhBUz4HiE8cxfgSxzWVfgSd6,DyVZzezvAvEjwqbriA2jQBXLpMqMPHvXhjkbFX7G4B5,True,6572708638,940654684,5044020,2522010,2522010,3zqXX6kzhkbW3d4TwD2CNjMRwxTbREXySekvq37kfCNk,352444725,1112966095,-760521370,536
2022-04-27 13:47:56-04:00,16328,CBEv8v9XZrgFT8UdEdd813XnRVv9R7GB5PLMyG8UWGC8,4uNcMEcQpJdThpisgNrttkQJTUFTsjEr25qgjkm4titC,True,53319539,9458251,39889,19944,19945,68sueyVfmy5ToEGtLFGDkwebX47xAmzyXE29z8JrmcWv,2248748,8915159,-6666411,421
2022-04-27 15:02:00-04:00,16329,CBEv8v9XZrgFT8UdEdd813XnRVv9R7GB5PLMyG8UWGC8,4uNcMEcQpJdThpisgNrttkQJTUFTsjEr25qgjkm4titC,True,43775772,3893121,17353,8676,8677,2a35JJeTUW1pm6M3e8DHCjp8qr4vbc2cRPhuzZWyFzYd,1951344,7916172,-5964828,445
2022-04-27 15:02:49-04:00,16330,9eWpSyu71Z6dmx7yTh7WrbVScdrrZN14d5tfmqEGFgXt,2r89PFKSD9zmSp2Wyx4CQ75HAtmUgwhAS2oG5MuYuiV6,True,3189071115,601605072,4152512,2076256,2076256,3zqXX6kzhkbW3d4TwD2CNjMRwxTbREXySekvq37kfCNk,220122124,878816939,-658694815,690
2022-04-27 15:05:26-04:00,16331,CW93ahtJm7jTwZxVCWTAfjpu19qyUZtXo1DrZFFkaSKe,5xLuUAgk9fAvBhPyUaWHfH6c5ejzefLt7X17mEcxvvQW,True,1135561585,78002948,363463,181731,181732,3zqXX6kzhkbW3d4TwD2CNjMRwxTbREXySekvq37kfCNk,52912773,115538599,-62625826,465
2022-04-27 23:11:28-04:00,16332,GKbDACVE2yR8WwrMeGfSQuSXLqXR3B1N5YzZ93i5xyeB,B5EEB6xDf7fwwaE6CaJjwsgCNNdUc29tjW1gY2pHiKxq,True,7798728756,1949682189,13857285,6928642,6928643,2a35JJeTUW1pm6M3e8DHCjp8qr4vbc2cRPhuzZWyFzYd,554291431,1405205209,-850913778,710
2022-04-27 23:11:39-04:00,16333,9NZhB8VtULVD4bMRA7694UR4YRnrNxixswurNoExWviW,6L3WycDHRoRsipk7YrExynUqgx31P7dNGw9eNU7Jdnnw,True,53948702,13487175,94903,47451,47452,68sueyVfmy5ToEGtLFGDkwebX47xAmzyXE29z8JrmcWv,3796151,12363686,-8567535,703
2022-04-27 23:12:57-04:00,16334,9eWpSyu71Z6dmx7yTh7WrbVScdrrZN14d5tfmqEGFgXt,2r89PFKSD9zmSp2Wyx4CQ75HAtmUgwhAS2oG5MuYuiV6,True,2614097051,459074670,3154020,1577010,1577010,3zqXX6kzhkbW3d4TwD2CNjMRwxTbREXySekvq37kfCNk,179598583,792511206,-612912623,687
2022-04-27 23:13:01-04:00,16335,H3wBiU5HFm5ff8sPgREkEhBUz4HiE8cxfgSxzWVfgSd6,DyVZzezvAvEjwqbriA2jQBXLpMqMPHvXhjkbFX7G4B5,True,5742495640,726169198,3696550,1848275,1848275,2xTUy2RS74GJMMDnmFaegMzFLn19RVfYG4CibhBmjP1i,292320676,964838200,-672517524,509
2022-04-27 23:13:50-04:00,16336,GKbDACVE2yR8WwrMeGfSQuSXLqXR3B1N5YzZ93i5xyeB,B5EEB6xDf7fwwaE6CaJjwsgCNNdUc29tjW1gY2pHiKxq,True,5967538143,1491884535,10548564,5274282,5274282,DQCvC9mR68hJ3tJsUiddh6JwcBJAmntqGJR2nUsEq7yj,421942570,1181596600,-759654030,707
2022-04-27 23:13:52-04:00,16337,9NZhB8VtULVD4bMRA7694UR4YRnrNxixswurNoExWviW,6L3WycDHRoRsipk7YrExynUqgx31P7dNGw9eNU7Jdnnw,True,41265315,10316328,72436,36218,36218,2a35JJeTUW1pm6M3e8DHCjp8qr4vbc2cRPhuzZWyFzYd,2897460,10127033,-7229573,702
2022-04-27 23:15:24-04:00,16338,9eWpSyu71Z6dmx7yTh7WrbVScdrrZN14d5tfmqEGFgXt,2r89PFKSD9zmSp2Wyx4CQ75HAtmUgwhAS2oG5MuYuiV6,True,2183176560,351344547,2386477,1193238,1193239,GXyFXZMNk2NFyEzw6JetVqsujqcz2yCixH7n8EpDJYWD,148290384,719778556,-571488172,679
2022-04-27 23:15:44-04:00,16339,H3wBiU5HFm5ff8sPgREkEhBUz4HiE8cxfgSxzWVfgSd6,DyVZzezvAvEjwqbriA2jQBXLpMqMPHvXhjkbFX7G4B5,True,5063013229,556298595,2658286,1329143,1329143,DQCvC9mR68hJ3tJsUiddh6JwcBJAmntqGJR2nUsEq7yj,241937339,832937279,-590999940,477
2022-04-27 23:16:01-04:00,16340,9NZhB8VtULVD4bMRA7694UR4YRnrNxixswurNoExWviW,6L3WycDHRoRsipk7YrExynUqgx31P7dNGw9eNU7Jdnnw,True,31525586,7881396,56210,28105,28105,2a35JJeTUW1pm6M3e8DHCjp8qr4vbc2cRPhuzZWyFzYd,2248425,8247280,-5998855,713
2022-04-28 04:33:08-04:00,16341,DXZMRSKFgnNdiXHps2xzayuztJNH9EUUz2wkCCneXtW5,9Z2sUfTCZCkmw5n3HSsoLG992AcpJo2qxp7XpJnnBxZM,True,1551861115,387965027,1170569,585284,585285,2a35JJeTUW1pm6M3e8DHCjp8qr4vbc2cRPhuzZWyFzYd,46822819,74591397,-27768578,301
2022-04-28 05:35:58-04:00,16342,CzWT7zuiD3Usn1DB8C87kZ3yaLcAd1GXe62cZ5xDdEKa,2AsTxJr8dyhHmccUngu2f6beGE9iiXH4yXhmQ48SpCXm,True,76399110,9074768,45137,22568,22569,HfEnetJ7uBSmZWCjBNxdvv9HEC5nsW4wDV7wu6WnhWan,3800083,20807300,-17007217,497
2022-04-28 05:42:39-04:00,16343,8qq2gfbca7JXvq4gViBBVT2QAbM4MvBMEQLXgn8UUTvt,3o5jpBVYdFFEYrGRdCUkLrUC85wsuTKgy8iYwnpZyC1B,True,358721072,23548090,106483,53241,53242,2a35JJeTUW1pm6M3e8DHCjp8qr4vbc2cRPhuzZWyFzYd,16221189,146030880,-129809691,452
2022-04-28 06:31:06-04:00,16344,6nk9tB1wMWPaHsp1KXCDDxjwgJ42hfr5Uzp1iTP5RMEX,BQRvPoALymicqgmgRjRPzuNcmypfPUaF88mXWW7suKRg,True,1880407919,470101979,2931568,1465784,1465784,A9TwRM1BMxqb8DCC7YNAMV6zPenEJm3HTZBy7wJKK58U,117262758,179862498,-62599740,623
2022-04-28 08:39:24-04:00,16345,5V5gFVMYSwGYfHFecRoHg8G22Rg4bXfVK2FSRTMhPQty,73raXd5MvixmDvJRnVjRL7yQaHZGFRiC9aBxL9ysiRvy,True,408360386,102090096,725213,362606,362607,2a35JJeTUW1pm6M3e8DHCjp8qr4vbc2cRPhuzZWyFzYd,29008555,49229030,-20220475,710
2022-04-28 08:39:31-04:00,16346,CzWT7zuiD3Usn1DB8C87kZ3yaLcAd1GXe62cZ5xDdEKa,2AsTxJr8dyhHmccUngu2f6beGE9iiXH4yXhmQ48SpCXm,True,67198183,6866653,32054,16027,16027,2a35JJeTUW1pm6M3e8DHCjp8qr4vbc2cRPhuzZWyFzYd,3136913,17118907,-13981994,466
2022-04-28 08:49:46-04:00,16347,CW93ahtJm7jTwZxVCWTAfjpu19qyUZtXo1DrZFFkaSKe,5xLuUAgk9fAvBhPyUaWHfH6c5ejzefLt7X17mEcxvvQW,True,1093204110,175080746,788064,394032,394032,DQCvC9mR68hJ3tJsUiddh6JwcBJAmntqGJR2nUsEq7yj,49206730,105277512,-56070782,450
2022-04-28 08:55:50-04:00,16348,JCxWCcMnPXMbwdMWxjhKYrWKiCpzSAmczM1F7jbrkTAi,8FrewhQHBn3GHwYeJMbt9F2Ydoy3EECZRxvPdbFHrn1k,True,2427557737,606889434,1816505,908252,908253,68sueyVfmy5ToEGtLFGDkwebX47xAmzyXE29z8JrmcWv,72660236,121378088,-48717852,299
2022-04-28 09:13:54-04:00,16349,CzWT7zuiD3Usn1DB8C87kZ3yaLcAd1GXe62cZ5xDdEKa,2AsTxJr8dyhHmccUngu2f6beGE9iiXH4yXhmQ48SpCXm,True,59990664,5163504,22858,11429,11429,68sueyVfmy5ToEGtLFGDkwebX47xAmzyXE29z8JrmcWv,2655836,14299217,-11643381,442
2022-04-28 09:20:17-04:00,16350,7m8sFjVHdVqcLyQKAiXPiinpaifyzkJ18XW8fkC25Nz5,9n6m25mbdj4gvQK9bS9nbNJ94M7r6AtPoVVaCc1VsEms,True,1950477203,487619300,1477303,738651,738652,3zqXX6kzhkbW3d4TwD2CNjMRwxTbREXySekvq37kfCNk,59092146,97465735,-38373589,302
2022-04-28 09:32:03-04:00,16351,5V5gFVMYSwGYfHFecRoHg8G22Rg4bXfVK2FSRTMhPQty,73raXd5MvixmDvJRnVjRL7yQaHZGFRiC9aBxL9ysiRvy,True,312348398,78087099,554514,277257,277257,68sueyVfmy5ToEGtLFGDkwebX47xAmzyXE29z8JrmcWv,22180592,43435385,-21254793,710
2022-04-28 09:33:32-04:00,16352,CW93ahtJm7jTwZxVCWTAfjpu19qyUZtXo1DrZFFkaSKe,5xLuUAgk9fAvBhPyUaWHfH6c5ejzefLt7X17mEcxvvQW,True,915288101,62726597,296596,148298,148298,2a35JJeTUW1pm6M3e8DHCjp8qr4vbc2cRPhuzZWyFzYd,43278581,107302663,-64024082,472
2022-04-28 09:41:11-04:00,16353,CBEv8v9XZrgFT8UdEdd813XnRVv9R7GB5PLMyG8UWGC8,4uNcMEcQpJdThpisgNrttkQJTUFTsjEr25qgjkm4titC,True,40474731,3022032,12725,6362,6363,2a35JJeTUW1pm6M3e8DHCjp8qr4vbc2cRPhuzZWyFzYd,1704412,7165625,-5461213,421
2022-04-28 09:42:11-04:00,16354,CW93ahtJm7jTwZxVCWTAfjpu19qyUZtXo1DrZFFkaSKe,5xLuUAgk9fAvBhPyUaWHfH6c5ejzefLt7X17mEcxvvQW,True,855209254,130233078,603789,301894,301895,2a35JJeTUW1pm6M3e8DHCjp8qr4vbc2cRPhuzZWyFzYd,39649433,95577260,-55927827,463
2022-04-28 09:42:32-04:00,16355,9eWpSyu71Z6dmx7yTh7WrbVScdrrZN14d5tfmqEGFgXt,2r89PFKSD9zmSp2Wyx4CQ75HAtmUgwhAS2oG5MuYuiV6,True,1833953167,266489354,1796595,898297,898298,2a35JJeTUW1pm6M3e8DHCjp8qr4vbc2cRPhuzZWyFzYd,123639952,657564539,-533924587,674
2022-04-28 09:42:35-04:00,16356,CBEv8v9XZrgFT8UdEdd813XnRVv9R7GB5PLMyG8UWGC8,4uNcMEcQpJdThpisgNrttkQJTUFTsjEr25qgjkm4titC,True,37651617,7100105,28670,14335,14335,2a35JJeTUW1pm6M3e8DHCjp8qr4vbc2cRPhuzZWyFzYd,1520411,6503907,-4983496,403
2022-04-28 09:45:01-04:00,16357,AQr9mVmcXCNQhBVCfx63MwR6c4WqDSC9K2BZqr7N8LCx,CB7TWUaL381ounsLw6neAUaKRxJL9P1HC9uGX5e1Uxod,True,302727179,12486887,65739,32869,32870,68sueyVfmy5ToEGtLFGDkwebX47xAmzyXE29z8JrmcWv,15937575,80039867,-64102292,526
2022-04-28 09:48:54-04:00,16358,JCxWCcMnPXMbwdMWxjhKYrWKiCpzSAmczM1F7jbrkTAi,8FrewhQHBn3GHwYeJMbt9F2Ydoy3EECZRxvPdbFHrn1k,True,1804500344,451125086,1366846,683423,683423,DQCvC9mR68hJ3tJsUiddh6JwcBJAmntqGJR2nUsEq7yj,54673852,107426323,-52752471,302
2022-04-28 09:50:10-04:00,16359,CzWT7zuiD3Usn1DB8C87kZ3yaLcAd1GXe62cZ5xDdEKa,2AsTxJr8dyhHmccUngu2f6beGE9iiXH4yXhmQ48SpCXm,True,54563135,9756536,40675,20337,20338,68sueyVfmy5ToEGtLFGDkwebX47xAmzyXE29z8JrmcWv,2274769,12170900,-9896131,416
2022-04-28 09:52:22-04:00,16360,FhCW2CghBaoo1MkXUXUb4okam8g5beQofgs3WXerNYzn,HWSPdmF3hSnnfVe29Y5rDGSPqbMQv2ug1wYrdwJZNWFK,True,128348251,32087062,97217,48608,48609,68sueyVfmy5ToEGtLFGDkwebX47xAmzyXE29z8JrmcWv,3888694,7378511,-3489817,302
2022-04-28 09:52:28-04:00,16361,AQr9mVmcXCNQhBVCfx63MwR6c4WqDSC9K2BZqr7N8LCx,CB7TWUaL381ounsLw6neAUaKRxJL9P1HC9uGX5e1Uxod,True,288558653,26323773,136432,68216,68216,68sueyVfmy5ToEGtLFGDkwebX47xAmzyXE29z8JrmcWv,14955581,77321827,-62366246,518
2022-04-28 09:59:41-04:00,16362,8gxJEB4eSp5R8Z4Vy8TChcbLWPG93cVhpGLYWPuo4UMz,5dykor5kUojjBccSkbKqsHJ61voZWnD2MDuSNvsF6ohA,False,12441324,12441324,771460,38573,732887,2a35JJeTUW1pm6M3e8DHCjp8qr4vbc2cRPhuzZWyFzYd,771460,6469522,-5698062,620
2022-04-28 10:01:02-04:00,16363,6NJFN855M3Q3RLTDNo57gTgAmwPD6G2E3WvMb1m5eNCN,3YpqNnonsvXaRT4nCC3G5FZx1jjVtbDPc36LiR6WK5jR,True,112780373,28195093,168892,84446,84446,68sueyVfmy5ToEGtLFGDkwebX47xAmzyXE29z8JrmcWv,6755694,36305780,-29550086,599
2022-04-28 10:01:07-04:00,16364,5wcyw2KsaCSSXaDocVzV8Yz9yHNG1E8TajEoeoBqiENL,2vuppCGeADLpY3sGJVLbmM5aRW3r5aHDgCBLS7QZoCg5,True,36721909,9180477,56160,28080,28080,2a35JJeTUW1pm6M3e8DHCjp8qr4vbc2cRPhuzZWyFzYd,2246400,10773204,-8526804,611
2022-04-28 10:01:27-04:00,16365,BWta2HTjCwDidjsgv1vPoD3gCHSGf679N1xijEj5jzD3,JEFa5ojXJ95W2NsV5j8qBENTm5n1uGfPDFwLRvebHDVn,True,464852783,116213195,726253,363126,363127,A9TwRM1BMxqb8DCC7YNAMV6zPenEJm3HTZBy7wJKK58U,29050159,139591582,-110541423,624
2022-04-28 10:01:45-04:00,16366,5YC2wXkdk7D4Ubs9TEAbP1hi88Sy35bzYVWjLbgVxn5s,4Mx69ezqFK2wudZ62oVhx2pwjVbKv8JB1HR29ZUcdEJb,True,301270221,75317555,228172,114086,114086,2a35JJeTUW1pm6M3e8DHCjp8qr4vbc2cRPhuzZWyFzYd,9126885,47381404,-38254519,302
2022-04-28 10:01:54-04:00,16367,7m8sFjVHdVqcLyQKAiXPiinpaifyzkJ18XW8fkC25Nz5,9n6m25mbdj4gvQK9bS9nbNJ94M7r6AtPoVVaCc1VsEms,True,1448809142,362202285,1088747,544373,544374,6UQfSsLooL4pQKQfLtXCutQS2BnF7A7F7ewJopDLmUpc,43549907,86408700,-42858793,300
2022-04-28 10:01:54-04:00,16368,GFYKsBjBAU6R52Zw7Ss9GvLyfV3L8Wt2DtxQQy65acYj,C5LfN6SocfQ1BmxpeMxkbBHwUPskFy7kDoAKeFaa3ceq,True,4416147452,1104036863,3330968,1665484,1665484,2py1FiYeL2f7J3HU36qiJz6TD6HCmiTN36RyxYtapQCZ,133238745,241658661,-108419916,301
2022-04-28 10:02:32-04:00,16369,EdCSJVDrgnE7PN9GK7t1t7hB79mBrJzyy1mMZL9u5nvM,GTy9uEWcCx4odtr1GLPpntNbdR7wJRYr3wE9P5rAaMw6,True,2225990441,437021963,1687206,843603,843603,3zqXX6kzhkbW3d4TwD2CNjMRwxTbREXySekvq37kfCNk,85938632,137850627,-51911995,386
2022-04-28 10:02:59-04:00,16370,DHfy6B2AYsqMCxPLBCXMDfQn3Gr2VwJaLFHUZKqpCjsb,EPZpYaY1gCAb8pMtri5veRowBmCrCpTHBMa3Rmgt6S29,True,538485386,134621346,399131,199565,199566,2py1FiYeL2f7J3HU36qiJz6TD6HCmiTN36RyxYtapQCZ,15965262,26940092,-10974830,296
2022-04-28 10:03:02-04:00,16371,7ueXVhSvXvttkeQ18w2cLh65naoEPvYF86RrdUK2Vc5Q,CKTehY1W6bw85cS4o7g2qXKjP4656Vwo37244BAEAiw1,True,77786956,19443532,120834,60417,60417,C4UnXuShCvjSMgBAgVNMy1oakxCNk1et27A82fywU112,4834164,37125687,-32291523,621
2022-04-28 10:03:12-04:00,16372,AQr9mVmcXCNQhBVCfx63MwR6c4WqDSC9K2BZqr7N8LCx,CB7TWUaL381ounsLw6neAUaKRxJL9P1HC9uGX5e1Uxod,True,260924295,12666054,68081,34040,34041,2a35JJeTUW1pm6M3e8DHCjp8qr4vbc2cRPhuzZWyFzYd,14024909,74229623,-60204714,537
2022-04-28 10:17:24-04:00,16373,CPUz1JGqSsAJZPpZxs7TyUhMUJhuhbpDsqgPswzkrrrE,81VYgn6keKvAMob96W7pXJo4TZdYsTjksmDM1cWcyWPn,True,410867754,102716938,639328,319664,319664,68sueyVfmy5ToEGtLFGDkwebX47xAmzyXE29z8JrmcWv,25573152,99400948,-73827796,622
2022-04-28 10:29:44-04:00,16374,64Diz8zzEv1jDWnBQPTHPpXwaWf7vjM19RyJmkPy1viQ,G8wkGHRHMtT3mvXBkH3zgsKNs8wbpdiPUS17y4cozhkZ,True,630687047,83583976,521340,260670,260670,DQCvC9mR68hJ3tJsUiddh6JwcBJAmntqGJR2nUsEq7yj,39338043,158890400,-119552357,623
2022-04-28 10:31:05-04:00,16375,J6ndjmic8buVqwa4URRRgv2iTc4ekbYUHdcpa3DUCufN,7qvvczUw8ngwdQae49BiQwQmdV2SSWsAVV2tmZYL7gw6,True,619949819,154987454,968142,484071,484071,gjBMZYVujDjD1ECG4i97M8Q3gV9ESnwwTSUGropkusj,38725717,256971452,-218245735,624
2022-04-28 10:31:18-04:00,16376,AQr9mVmcXCNQhBVCfx63MwR6c4WqDSC9K2BZqr7N8LCx,CB7TWUaL381ounsLw6neAUaKRxJL9P1HC9uGX5e1Uxod,True,248163901,12548663,67284,33642,33642,2a35JJeTUW1pm6M3e8DHCjp8qr4vbc2cRPhuzZWyFzYd,13306216,68691682,-55385466,536
2022-04-28 10:42:29-04:00,16377,CLP8qmL8aN9ocJKYnbKSo4k46CU3LBsebspfREQcSGvo,F6tkkFJnvjYyPdSXDNzZMUfhd1o8dFiLyLPRZ5U1sXHE,True,37627172,9406793,58713,29356,29357,2a35JJeTUW1pm6M3e8DHCjp8qr4vbc2cRPhuzZWyFzYd,2348533,2991530,-642997,624
2022-04-28 10:59:11-04:00,16378,8qq2gfbca7JXvq4gViBBVT2QAbM4MvBMEQLXgn8UUTvt,3o5jpBVYdFFEYrGRdCUkLrUC85wsuTKgy8iYwnpZyC1B,True,329001612,46609896,202844,101422,101422,2a35JJeTUW1pm6M3e8DHCjp8qr4vbc2cRPhuzZWyFzYd,14318061,124973137,-110655076,435
2022-04-28 11:02:18-04:00,16379,5V5gFVMYSwGYfHFecRoHg8G22Rg4bXfVK2FSRTMhPQty,73raXd5MvixmDvJRnVjRL7yQaHZGFRiC9aBxL9ysiRvy,True,241947305,60486826,348174,174087,174087,DQCvC9mR68hJ3tJsUiddh6JwcBJAmntqGJR2nUsEq7yj,13926978,37560514,-23633536,575
2022-04-28 11:02:19-04:00,16380,CzWT7zuiD3Usn1DB8C87kZ3yaLcAd1GXe62cZ5xDdEKa,2AsTxJr8dyhHmccUngu2f6beGE9iiXH4yXhmQ48SpCXm,True,45557729,11389432,43143,21571,21572,2a35JJeTUW1pm6M3e8DHCjp8qr4vbc2cRPhuzZWyFzYd,1725773,11244346,-9518573,378
2022-04-28 11:06:57-04:00,16381,8qq2gfbca7JXvq4gViBBVT2QAbM4MvBMEQLXgn8UUTvt,3o5jpBVYdFFEYrGRdCUkLrUC85wsuTKgy8iYwnpZyC1B,True,285030253,18605592,84462,42231,42231,2a35JJeTUW1pm6M3e8DHCjp8qr4vbc2cRPhuzZWyFzYd,12939326,128209997,-115270671,453
2022-04-28 11:13:37-04:00,16382,8RQrftvvDMztkaUK7USZjeA4bkhJZLX9f1jygdWrsYgb,6bJLycnh4ZHEJtsUZkoygZVp24C8uYDXLedEyzH9iQWG,True,237629978,25756798,169743,84871,84872,68sueyVfmy5ToEGtLFGDkwebX47xAmzyXE29z8JrmcWv,15660379,62689857,-47029478,659
2022-04-28 11:30:42-04:00,16383,5V5gFVMYSwGYfHFecRoHg8G22Rg4bXfVK2FSRTMhPQty,73raXd5MvixmDvJRnVjRL7yQaHZGFRiC9aBxL9ysiRvy,True,182133903,45533475,322634,161317,161317,68sueyVfmy5ToEGtLFGDkwebX47xAmzyXE29z8JrmcWv,12905380,31307634,-18402254,708
2022-04-28 11:45:26-04:00,16384,AQr9mVmcXCNQhBVCfx63MwR6c4WqDSC9K2BZqr7N8LCx,CB7TWUaL381ounsLw6neAUaKRxJL9P1HC9uGX5e1Uxod,True,237837621,11200136,59458,29729,29729,2a35JJeTUW1pm6M3e8DHCjp8qr4vbc2cRPhuzZWyFzYd,12626253,67402451,-54776198,530
