ts,record_id,user_authority,user,partial,base_asset_value,base_asset_value_closed,liquidation_fee,fee_to_liquidator,fee_to_insurance_fund,liquidator,total_collateral,collateral,unrealized_pnl,margin_ratio
2022-04-01 15:51:27-04:00,14337,5seV37JfFeqX91yaDfiupi2Ms7yYuuZFHwZ42ovhTbdU,KqBKpYuGWPhC8iYvedTYb4k5Lu3y89UMxt46t8gvn6h,True,49791365,12447841,77656,38828,38828,YQC4EUcgeBi9431viwvzvBbZJW3szeHX4dFmowRDyDw,3106256,16932883,-13826627,623
2022-04-01 15:51:37-04:00,14338,54rcQUxBXFfoNq8n9RxsxH1Lp4VHR2CfE71vCCVy6rPQ,4exavmUP5CfqEmqVusSNuW9Ha2rhPBAy2gg6rP2d5tvu,True,91095641,22773910,141447,70723,70724,YQC4EUcgeBi9431viwvzvBbZJW3szeHX4dFmowRDyDw,5657890,40896980,-35239090,621
2022-04-01 15:54:53-04:00,14339,HhU3H9e4SDu2n1FobL8gxS1pg3ayQBFQ84psbLqdcUw2,H1Z7WqJXn3T16xSFUQGpthMmvSbQNBkbhk1qbufChW3x,True,1320347080,330086770,2046015,1023007,1023008,3zqXX6kzhkbW3d4TwD2CNjMRwxTbREXySekvq37kfCNk,81840607,317573179,-235732572,619
2022-04-01 17:59:20-04:00,14340,4Bi1PEYPfA5VEoBqzGbt5fSd6PwuVsrF5SfLWXtpNxFA,3aApRXGYkRs9AZXchR5i7HnWXiRvBQgg3fz1bb4gMx2U,True,18269460,2578866,16090,8045,8045,3zqXX6kzhkbW3d4TwD2CNjMRwxTbREXySekvq37kfCNk,1139923,5688959,-4549036,623
2022-04-01 17:59:21-04:00,14341,6BQVtmNsxihi4PcA7MurtguTwa6SmbmKyP14RHyjVZkf,7ZFv5ms4HzVKiw7KgE8RUoKxW9rB6JUD7ujZxMx4DwnM,False,12325083,12325083,769420,38471,730949,YQC4EUcgeBi9431viwvzvBbZJW3szeHX4dFmowRDyDw,769420,4319507,-3550087,624
2022-04-01 17:59:31-04:00,14342,AT4qoJDVGXpEm3BGACUhC1zpVNLq4iX2bJ4cpABehpoD,AqaDPXbaY6ksVQwWGKorgBdRQMz3VpqxmHdWXmq17ScF,True,252866169,63216542,395096,197548,197548,3zqXX6kzhkbW3d4TwD2CNjMRwxTbREXySekvq37kfCNk,15803857,110454162,-94650305,624
2022-04-01 17:59:31-04:00,14343,AFYRpYG4Nm818mSXVrBX9SScLSHfe9VJynGZUgvBsgMc,5zbZnbBHauM6tKDJFhDdgTKVkhAgZ4V5WSyTDLUX2Mqs,True,50983643,12745910,79357,39678,39679,YQC4EUcgeBi9431viwvzvBbZJW3szeHX4dFmowRDyDw,3174283,18562491,-15388208,622
2022-04-01 18:00:21-04:00,14344,H7wVZszBQdmFuwMUYAw4SSYbjxeFY1QvNBuT8QiqTxZS,CUm235keNKnVd2BaCNp5a6HePtWGMo8dq8S1KXf2KRR4,True,31811998,7952999,49428,24714,24714,3zqXX6kzhkbW3d4TwD2CNjMRwxTbREXySekvq37kfCNk,1977124,3580636,-1603512,621
2022-04-01 18:01:25-04:00,14345,6qqBmN3Mmy56gXvtBwLUyQwJoh2cYKmMtP61Po9xgxRj,FySpFnWFTZAaYLZ2c8Lb9m89CJxj3ZFMcZTdcwRrEEGH,True,166054561,41513640,259160,129580,129580,3zqXX6kzhkbW3d4TwD2CNjMRwxTbREXySekvq37kfCNk,10366405,43930906,-33564501,624
2022-04-01 20:52:25-04:00,14346,2f5wSFQfcN5ogh4Ln9d7EeyzAVdmZ64NsB56mtoNFMst,9JhD3JQmGDxefbeZaw1Ynw1uwL3hdVaicyZH6RjL9Mi6,True,3005153570,423356754,2642122,1321061,1321061,3zqXX6kzhkbW3d4TwD2CNjMRwxTbREXySekvq37kfCNk,187548350,699221928,-511673578,624
2022-04-01 20:53:16-04:00,14347,GTzLxRn226vTjN4HTSDSCjDLjwNiP4jsarG4umsA4CPc,6BWii3HLmdacnSS1pe8RkbbN6kbe4jpYYbnHqM1hh2G5,True,350650723,87662680,536930,268465,268465,3zqXX6kzhkbW3d4TwD2CNjMRwxTbREXySekvq37kfCNk,21477237,43606676,-22129439,612
2022-04-01 20:55:55-04:00,14348,8fSFsWaVRYHg5fdFQFQ89aBTjqsodGyc4sinV5UbWxtc,8evZpC24viqM8NaVFRjR91jLjXHLkW6GYAdywY8h2wys,True,30119093,2601521,16257,8128,8129,YQC4EUcgeBi9431viwvzvBbZJW3szeHX4dFmowRDyDw,1882212,10037429,-8155217,624
2022-04-01 21:02:17-04:00,14349,5QxR9QPTADFys9VQNm473RgprTikCXC23vhsBc9ojyAQ,H9zdf8nJ4JCF7jrwGsxiuiFoa14gzDmYsZ5N5ig3UGna,True,418999352,104749838,652993,326496,326497,YQC4EUcgeBi9431viwvzvBbZJW3szeHX4dFmowRDyDw,26119753,58255778,-32136025,623
2022-04-01 21:47:52-04:00,14350,7mhEMbGEpSYgYoZx6WvApjysTxsPqpCDSJCmKF45x3n6,12J2purUC4QYjaPKZwL3Y5P1JikTBD3oY9pLgY6yt6am,True,2794194091,698548522,4362560,2181280,2181280,YQC4EUcgeBi9431viwvzvBbZJW3szeHX4dFmowRDyDw,174502410,193308380,-18805970,624
2022-04-02 04:53:41-04:00,14351,CVjkHr29t8pzeXU1U1CdMpT6qwf9Jw4XGxvxU7RURPYj,D66Zpxp7q4Tn4KiLa2pHTrADhgtP8tGqNXVPyCo9mcxc,True,646188738,82358921,512708,256354,256354,3zqXX6kzhkbW3d4TwD2CNjMRwxTbREXySekvq37kfCNk,40227131,122208315,-81981184,622
2022-04-02 05:30:16-04:00,14352,DhvrjbL4sST1jJ3EEoSP6H8qPWx7oQ8yNZ1eb15eqdNE,9Y4pizxMJve5X8uKfdf3MjStDTy9gpCdL8MrU2PGMt7d,False,433844,433844,26750,1337,25413,3RdfgDvLvsdZG5Cf6hKiKMQMqfidyxHzjYvUx1FZpeHQ,26752,30741,-3989,616
2022-04-02 05:46:04-04:00,14353,Gr3vv3TmUeQWxjRfE1mLwhLt7TtdY33x5rrKAzjBTVJs,FZWoYYVfeJN8Y93Yw82jyE8DnC39dWMDjNi2NxffTdey,False,13006216,13006216,810058,40502,769556,YQC4EUcgeBi9431viwvzvBbZJW3szeHX4dFmowRDyDw,810058,3132829,-2322771,622
2022-04-02 05:51:18-04:00,14354,CVjkHr29t8pzeXU1U1CdMpT6qwf9Jw4XGxvxU7RURPYj,D66Zpxp7q4Tn4KiLa2pHTrADhgtP8tGqNXVPyCo9mcxc,True,568073952,79406113,495486,247743,247743,3zqXX6kzhkbW3d4TwD2CNjMRwxTbREXySekvq37kfCNk,35447248,105629757,-70182509,623
2022-04-02 05:52:44-04:00,14355,7X1UBUXhC59kzJKyroP6fe5GVtGCrVMZGKwbSnedkvwJ,5A24drY1wqNsjV6cABFfFx2D5BQ16m6vozbxvyUcXG4C,True,604007272,151001818,943744,471872,471872,3zqXX6kzhkbW3d4TwD2CNjMRwxTbREXySekvq37kfCNk,37749765,104805963,-67056198,624
2022-04-02 06:11:43-04:00,14356,88awjJ2gbtVpwNCSwDLUbmtQM5xqGbJBwgEngdgUT8uV,7SE7JbDbRgsUzXUAnTrtCyzSCnEkLyYRuTQYRFqQ4rH9,False,13281718,13281718,829933,41496,788437,YQC4EUcgeBi9431viwvzvBbZJW3szeHX4dFmowRDyDw,829933,3247725,-2417792,624
2022-04-02 06:12:57-04:00,14357,74MzhjMjDLChEL9RWjUtb6Ztm7Qmq15MUkrbgAiJ8mgK,EY6caxTDF9WQWa7c9ZJCqL92EDcVMcLaSnHhWXvNW6nA,True,78244895,19561223,121117,60558,60559,YQC4EUcgeBi9431viwvzvBbZJW3szeHX4dFmowRDyDw,4844693,19133454,-14288761,619
2022-04-02 06:48:00-04:00,14358,8fSFsWaVRYHg5fdFQFQ89aBTjqsodGyc4sinV5UbWxtc,8evZpC24viqM8NaVFRjR91jLjXHLkW6GYAdywY8h2wys,True,27658908,2429700,15121,7560,7561,YQC4EUcgeBi9431viwvzvBbZJW3szeHX4dFmowRDyDw,1721379,9308578,-7587199,622
2022-04-02 07:23:06-04:00,14359,J1GAxgxftvYFrwMwjQN2dEG9tBzKmP9tuCrSwAhLvPf7,E4xChajb4ScoVfjaQsDuD9NQ3x3jryNQ5ksJ8UTWUfyb,True,37700171494,6895894124,42943006,21471503,21471503,YQC4EUcgeBi9431viwvzvBbZJW3szeHX4dFmowRDyDw,2347714031,16786248634,-14438534603,622
2022-04-02 07:24:05-04:00,14360,84CS9aD3YJABQUpuaKrzQrGDZmHDAT7sGGEVJCr9iWs,Du7MR89dZzrBMidrVXVqbZ71dJ3PthHrcA9G6HyNcSw9,True,113783172,28445793,176703,88351,88352,YQC4EUcgeBi9431viwvzvBbZJW3szeHX4dFmowRDyDw,7068156,21812137,-14743981,621
2022-04-02 07:24:08-04:00,14361,FMdKLXhQEnNJtvM17ZX8jhaeMaSD9UgDuN3Kw7kMrd7K,5pURHYWB5LUGwJmWVBGH8p6oyR9NJvXnZk7uDVoiassv,True,443115750,110778937,691642,345821,345821,3zqXX6kzhkbW3d4TwD2CNjMRwxTbREXySekvq37kfCNk,27665687,78243323,-50577636,624
2022-04-02 07:24:24-04:00,14362,3j9JdUmeNeQMEoj6m9ZWsUZyywfGwYgPNH5hUv5KjeiP,H2XBrDYsHqo4uCydNLXyxadQk7cXd48xEVr2PgR1tG2c,True,202800614948,23927935621,149539837,74769918,74769919,3zqXX6kzhkbW3d4TwD2CNjMRwxTbREXySekvq37kfCNk,12674211235,56176059927,-43501848692,624
2022-04-02 07:29:42-04:00,14363,8fSFsWaVRYHg5fdFQFQ89aBTjqsodGyc4sinV5UbWxtc,8evZpC24viqM8NaVFRjR91jLjXHLkW6GYAdywY8h2wys,True,25353026,2071887,12928,6464,6464,YQC4EUcgeBi9431viwvzvBbZJW3szeHX4dFmowRDyDw,1582068,8454493,-6872425,624
2022-04-02 07:29:43-04:00,14364,CcisiNab5DzQiQsAThVuzenP7AmLz7WzZAe2AhRzSZ2P,5JRsDGsVJ7KEhPTLeLddtq8jW9hBuLNLZCpAkH98eidG,True,698838562,174709640,1089429,544714,544715,3zqXX6kzhkbW3d4TwD2CNjMRwxTbREXySekvq37kfCNk,43577192,241554440,-197977248,623
2022-04-02 08:30:40-04:00,14365,8fSFsWaVRYHg5fdFQFQ89aBTjqsodGyc4sinV5UbWxtc,8evZpC24viqM8NaVFRjR91jLjXHLkW6GYAdywY8h2wys,True,23390562,1973199,12312,6156,6156,YQC4EUcgeBi9431viwvzvBbZJW3szeHX4dFmowRDyDw,1459528,8019845,-6560317,623
2022-04-02 08:33:10-04:00,14366,DYwsGtpvMAHnALhGDH2PWVzojxDdkaonahuy98bxQwTE,GvdXQ8qRsJb4twvAXp723qT3UNhA9sSndAFTQT1fHVGa,True,1033584816,258396204,1612302,806151,806151,YQC4EUcgeBi9431viwvzvBbZJW3szeHX4dFmowRDyDw,64492084,98995560,-34503476,623
2022-04-02 08:39:46-04:00,14367,GLXb8fHTTJ5njY9j1TzdSs98ZLfmy1QWwKLVHeiwiHhZ,BKoqP2E4J2CoHMhiDHk9W1LbW1DUNF5wuvFPswwnC1kT,True,3519333137,486070350,3030880,1515440,1515440,3zqXX6kzhkbW3d4TwD2CNjMRwxTbREXySekvq37kfCNk,219447234,996777342,-777330108,623
2022-04-02 08:39:46-04:00,14368,6yjPfkAHVeT6pnwwa2iAGnAvmHZc1nirWw1ByjesoTHD,9MwcpCovRfMMbCf1z3PsoqhNY4RmgYXU385bKWFwqMuC,True,103850667,25962666,161884,80942,80942,YQC4EUcgeBi9431viwvzvBbZJW3szeHX4dFmowRDyDw,6475360,34925481,-28450121,623
2022-04-02 08:40:16-04:00,14369,J1GAxgxftvYFrwMwjQN2dEG9tBzKmP9tuCrSwAhLvPf7,E4xChajb4ScoVfjaQsDuD9NQ3x3jryNQ5ksJ8UTWUfyb,True,31161951337,5213514862,32569445,16284722,16284723,3zqXX6kzhkbW3d4TwD2CNjMRwxTbREXySekvq37kfCNk,1946724051,13927097008,-11980372957,624
2022-04-02 08:40:16-04:00,14370,Hya9U3Ao61oebVBPEnUiqinqvpzTguAZhbAWDmEQpm3a,FdYMMqoYPe5Jgj8R2ovKVUKxRPK1xppR59XRGPdvHRAx,True,24629675,6157418,38178,19089,19089,YQC4EUcgeBi9431viwvzvBbZJW3szeHX4dFmowRDyDw,1527158,11135617,-9608459,620
2022-04-02 08:40:16-04:00,14371,3bprArD4auGxKGrBunvBCC65h8AuF42EqRHagn7azHZE,9Zerp7yNQC88vhmu8gsLGbP2kNN8KF2gzCPqVe1MmHTu,True,1036243117,259060779,1613831,806915,806916,3zqXX6kzhkbW3d4TwD2CNjMRwxTbREXySekvq37kfCNk,64553260,175702020,-111148760,622
2022-04-02 08:40:18-04:00,14372,8ayr4AZAcNN17UCJUXe5VJtaj6ziTmGpER4fpHGpdbiT,uRK1KLx2bX5xGSAkviLApXew2aT9ar4ATb24yu7ELRR,True,206902876,51725719,321640,160820,160820,YQC4EUcgeBi9431viwvzvBbZJW3szeHX4dFmowRDyDw,12865622,19798955,-6933333,621
2022-04-02 09:01:08-04:00,14373,DmrkajG3SrTXnYSYxGRfkzfvhkevD6RdtFk4SdLC2G6Q,5r7vkWH985E2mGSDBtznduhuu5PbZJ7d4zxjzhzEEZG1,True,4817433119,613325017,3832502,1916251,1916251,3zqXX6kzhkbW3d4TwD2CNjMRwxTbREXySekvq37kfCNk,301028388,860946748,-559918360,624
2022-04-02 09:01:09-04:00,14374,5seV37JfFeqX91yaDfiupi2Ms7yYuuZFHwZ42ovhTbdU,KqBKpYuGWPhC8iYvedTYb4k5Lu3y89UMxt46t8gvn6h,True,38002839,9500709,59224,29612,29612,YQC4EUcgeBi9431viwvzvBbZJW3szeHX4dFmowRDyDw,2368973,13398270,-11029297,623
2022-04-02 09:01:13-04:00,14375,54rcQUxBXFfoNq8n9RxsxH1Lp4VHR2CfE71vCCVy6rPQ,4exavmUP5CfqEmqVusSNuW9Ha2rhPBAy2gg6rP2d5tvu,True,69499137,17374784,108461,54230,54231,YQC4EUcgeBi9431viwvzvBbZJW3szeHX4dFmowRDyDw,4338466,31945222,-27606756,624
2022-04-02 09:01:47-04:00,14376,HhU3H9e4SDu2n1FobL8gxS1pg3ayQBFQ84psbLqdcUw2,H1Z7WqJXn3T16xSFUQGpthMmvSbQNBkbhk1qbufChW3x,True,1008142625,252035656,1547600,773800,773800,YQC4EUcgeBi9431viwvzvBbZJW3szeHX4dFmowRDyDw,61904002,256595051,-194691049,614
2022-04-02 09:01:47-04:00,14377,niCk6QHFU1kyU56Mdq5RJzKrecdkNSn23ZA6wduFdWS,BQbUYSw1XsuE6LnVd4XjmxAyYgx4drE4FsetJBCdwVZW,True,19612391,2690448,16652,8326,8326,YQC4EUcgeBi9431viwvzvBbZJW3szeHX4dFmowRDyDw,1213905,2817190,-1603285,618
2022-04-02 09:01:47-04:00,14378,2f5wSFQfcN5ogh4Ln9d7EeyzAVdmZ64NsB56mtoNFMst,9JhD3JQmGDxefbeZaw1Ynw1uwL3hdVaicyZH6RjL9Mi6,True,2605740043,335706391,2071957,1035978,1035979,YQC4EUcgeBi9431viwvzvBbZJW3szeHX4dFmowRDyDw,160824588,632861030,-472036442,617
2022-04-02 09:06:35-04:00,14379,AT4qoJDVGXpEm3BGACUhC1zpVNLq4iX2bJ4cpABehpoD,AqaDPXbaY6ksVQwWGKorgBdRQMz3VpqxmHdWXmq17ScF,True,193217764,48304441,295968,147984,147984,3zqXX6kzhkbW3d4TwD2CNjMRwxTbREXySekvq37kfCNk,11838731,86394856,-74556125,612
2022-04-02 09:06:35-04:00,14380,AFYRpYG4Nm818mSXVrBX9SScLSHfe9VJynGZUgvBsgMc,5zbZnbBHauM6tKDJFhDdgTKVkhAgZ4V5WSyTDLUX2Mqs,True,38948924,9737231,59583,29791,29792,YQC4EUcgeBi9431viwvzvBbZJW3szeHX4dFmowRDyDw,2383354,14635713,-12252359,611
2022-04-02 09:06:41-04:00,14381,H7wVZszBQdmFuwMUYAw4SSYbjxeFY1QvNBuT8QiqTxZS,CUm235keNKnVd2BaCNp5a6HePtWGMo8dq8S1KXf2KRR4,True,24277042,6069260,37737,18868,18869,3RdfgDvLvsdZG5Cf6hKiKMQMqfidyxHzjYvUx1FZpeHQ,1509505,3130188,-1620683,621
2022-04-02 09:12:44-04:00,14382,6qqBmN3Mmy56gXvtBwLUyQwJoh2cYKmMtP61Po9xgxRj,FySpFnWFTZAaYLZ2c8Lb9m89CJxj3ZFMcZTdcwRrEEGH,True,126730169,31682542,197930,98965,98965,3RdfgDvLvsdZG5Cf6hKiKMQMqfidyxHzjYvUx1FZpeHQ,7917223,35279989,-27362766,624
2022-04-02 09:13:00-04:00,14383,84CS9aD3YJABQUpuaKrzQrGDZmHDAT7sGGEVJCr9iWs,Du7MR89dZzrBMidrVXVqbZ71dJ3PthHrcA9G6HyNcSw9,True,86837541,21709385,134784,67392,67392,YQC4EUcgeBi9431viwvzvBbZJW3szeHX4dFmowRDyDw,5391385,17949605,-12558220,620
2022-04-02 09:13:00-04:00,14384,8fSFsWaVRYHg5fdFQFQ89aBTjqsodGyc4sinV5UbWxtc,8evZpC24viqM8NaVFRjR91jLjXHLkW6GYAdywY8h2wys,True,21520405,1853217,11572,5786,5786,3zqXX6kzhkbW3d4TwD2CNjMRwxTbREXySekvq37kfCNk,1343849,7453135,-6109286,624
2022-04-02 09:13:32-04:00,14385,FMdKLXhQEnNJtvM17ZX8jhaeMaSD9UgDuN3Kw7kMrd7K,5pURHYWB5LUGwJmWVBGH8p6oyR9NJvXnZk7uDVoiassv,True,338189577,84547394,528041,264020,264021,YQC4EUcgeBi9431viwvzvBbZJW3szeHX4dFmowRDyDw,21121650,64908767,-43787117,624
2022-04-02 09:22:08-04:00,14386,7yW1M1xeVx4hy3QftnpqdBDRYwamfu3K5i6AEnxgyTWb,7wf7FWS2DYp5RveQAmGNXAEUWPcHziuMLd4hV5LPgxF8,True,83259626,20814906,129692,64846,64846,YQC4EUcgeBi9431viwvzvBbZJW3szeHX4dFmowRDyDw,5187693,8447399,-3259706,623
2022-04-02 09:25:12-04:00,14387,GLXb8fHTTJ5njY9j1TzdSs98ZLfmy1QWwKLVHeiwiHhZ,BKoqP2E4J2CoHMhiDHk9W1LbW1DUNF5wuvFPswwnC1kT,True,3059035114,394470961,2458408,1229204,1229204,YQC4EUcgeBi9431viwvzvBbZJW3szeHX4dFmowRDyDw,190644153,838055933,-647411780,623
2022-04-02 09:26:05-04:00,14388,2f5wSFQfcN5ogh4Ln9d7EeyzAVdmZ64NsB56mtoNFMst,9JhD3JQmGDxefbeZaw1Ynw1uwL3hdVaicyZH6RjL9Mi6,True,2286035061,316973364,1979336,989668,989668,3zqXX6kzhkbW3d4TwD2CNjMRwxTbREXySekvq37kfCNk,142751222,558720468,-415969246,624
2022-04-02 09:29:54-04:00,14389,6yjPfkAHVeT6pnwwa2iAGnAvmHZc1nirWw1ByjesoTHD,9MwcpCovRfMMbCf1z3PsoqhNY4RmgYXU385bKWFwqMuC,True,79253525,19813381,123700,61850,61850,YQC4EUcgeBi9431viwvzvBbZJW3szeHX4dFmowRDyDw,4948003,27651168,-22703165,624
2022-04-02 09:30:40-04:00,14390,Hya9U3Ao61oebVBPEnUiqinqvpzTguAZhbAWDmEQpm3a,FdYMMqoYPe5Jgj8R2ovKVUKxRPK1xppR59XRGPdvHRAx,True,18790982,4697745,29256,14628,14628,YQC4EUcgeBi9431viwvzvBbZJW3szeHX4dFmowRDyDw,1170267,8695339,-7525072,622
2022-04-02 09:30:55-04:00,14391,3bprArD4auGxKGrBunvBCC65h8AuF42EqRHagn7azHZE,9Zerp7yNQC88vhmu8gsLGbP2kNN8KF2gzCPqVe1MmHTu,True,790791651,197697912,1233265,616632,616633,3zqXX6kzhkbW3d4TwD2CNjMRwxTbREXySekvq37kfCNk,49330633,146307705,-96977072,623
2022-04-02 09:31:36-04:00,14392,J1GAxgxftvYFrwMwjQN2dEG9tBzKmP9tuCrSwAhLvPf7,E4xChajb4ScoVfjaQsDuD9NQ3x3jryNQ5ksJ8UTWUfyb,True,26223572576,3982922195,24886176,12443088,12443088,3zqXX6kzhkbW3d4TwD2CNjMRwxTbREXySekvq37kfCNk,1638506669,11739274696,-10100768027,624
2022-04-02 09:32:10-04:00,14393,5seV37JfFeqX91yaDfiupi2Ms7yYuuZFHwZ42ovhTbdU,KqBKpYuGWPhC8iYvedTYb4k5Lu3y89UMxt46t8gvn6h,True,29022086,7255521,44744,22372,22372,YQC4EUcgeBi9431viwvzvBbZJW3szeHX4dFmowRDyDw,1789793,10581728,-8791935,616
2022-04-02 09:32:13-04:00,14394,54rcQUxBXFfoNq8n9RxsxH1Lp4VHR2CfE71vCCVy6rPQ,4exavmUP5CfqEmqVusSNuW9Ha2rhPBAy2gg6rP2d5tvu,True,53059621,13264905,82368,41184,41184,YQC4EUcgeBi9431viwvzvBbZJW3szeHX4dFmowRDyDw,3294737,24935091,-21640354,620
2022-04-02 09:32:22-04:00,14395,8fSFsWaVRYHg5fdFQFQ89aBTjqsodGyc4sinV5UbWxtc,8evZpC24viqM8NaVFRjR91jLjXHLkW6GYAdywY8h2wys,True,19766409,1560777,9736,4868,4868,YQC4EUcgeBi9431viwvzvBbZJW3szeHX4dFmowRDyDw,1233056,6781677,-5548621,623
2022-04-02 09:32:24-04:00,14396,HhU3H9e4SDu2n1FobL8gxS1pg3ayQBFQ84psbLqdcUw2,H1Z7WqJXn3T16xSFUQGpthMmvSbQNBkbhk1qbufChW3x,True,768504406,192126101,1198974,599487,599487,3zqXX6kzhkbW3d4TwD2CNjMRwxTbREXySekvq37kfCNk,47958965,206379970,-158421005,624
2022-04-02 09:33:00-04:00,14397,DmrkajG3SrTXnYSYxGRfkzfvhkevD6RdtFk4SdLC2G6Q,5r7vkWH985E2mGSDBtznduhuu5PbZJ7d4zxjzhzEEZG1,True,4245649668,592158629,3690990,1845495,1845495,YQC4EUcgeBi9431viwvzvBbZJW3szeHX4dFmowRDyDw,264636072,622052434,-357416362,623
2022-04-02 09:34:15-04:00,14398,niCk6QHFU1kyU56Mdq5RJzKrecdkNSn23ZA6wduFdWS,BQbUYSw1XsuE6LnVd4XjmxAyYgx4drE4FsetJBCdwVZW,True,17139384,2256373,14018,7009,7009,YQC4EUcgeBi9431viwvzvBbZJW3szeHX4dFmowRDyDw,1064898,3130643,-2065745,621
2022-04-02 09:34:15-04:00,14399,AFYRpYG4Nm818mSXVrBX9SScLSHfe9VJynGZUgvBsgMc,5zbZnbBHauM6tKDJFhDdgTKVkhAgZ4V5WSyTDLUX2Mqs,True,29709638,7427409,45645,22822,22823,YQC4EUcgeBi9431viwvzvBbZJW3szeHX4dFmowRDyDw,1825826,11513047,-9687221,614
2022-04-02 09:34:17-04:00,14400,AT4qoJDVGXpEm3BGACUhC1zpVNLq4iX2bJ4cpABehpoD,AqaDPXbaY6ksVQwWGKorgBdRQMz3VpqxmHdWXmq17ScF,True,147383709,36845927,226809,113404,113405,YQC4EUcgeBi9431viwvzvBbZJW3szeHX4dFmowRDyDw,9072377,67460004,-58387627,615
2022-04-02 09:34:57-04:00,14401,H7wVZszBQdmFuwMUYAw4SSYbjxeFY1QvNBuT8QiqTxZS,CUm235keNKnVd2BaCNp5a6HePtWGMo8dq8S1KXf2KRR4,True,18532732,4633183,28670,14335,14335,3RdfgDvLvsdZG5Cf6hKiKMQMqfidyxHzjYvUx1FZpeHQ,1146818,2687283,-1540465,618
2022-04-02 09:35:32-04:00,14402,CVjkHr29t8pzeXU1U1CdMpT6qwf9Jw4XGxvxU7RURPYj,D66Zpxp7q4Tn4KiLa2pHTrADhgtP8tGqNXVPyCo9mcxc,True,492787381,63754540,397913,198956,198957,YQC4EUcgeBi9431viwvzvBbZJW3szeHX4dFmowRDyDw,30756544,100390231,-69633687,624
2022-04-02 09:35:37-04:00,14403,6qqBmN3Mmy56gXvtBwLUyQwJoh2cYKmMtP61Po9xgxRj,FySpFnWFTZAaYLZ2c8Lb9m89CJxj3ZFMcZTdcwRrEEGH,True,96726206,24181551,151017,75508,75509,YQC4EUcgeBi9431viwvzvBbZJW3szeHX4dFmowRDyDw,6040714,28241448,-22200734,624
2022-04-02 09:35:46-04:00,14404,84CS9aD3YJABQUpuaKrzQrGDZmHDAT7sGGEVJCr9iWs,Du7MR89dZzrBMidrVXVqbZ71dJ3PthHrcA9G6HyNcSw9,True,66247406,16561851,103433,51716,51717,YQC4EUcgeBi9431viwvzvBbZJW3szeHX4dFmowRDyDw,4137351,14675307,-10537956,624
2022-04-02 09:35:53-04:00,14405,GLXb8fHTTJ5njY9j1TzdSs98ZLfmy1QWwKLVHeiwiHhZ,BKoqP2E4J2CoHMhiDHk9W1LbW1DUNF5wuvFPswwnC1kT,True,2685081845,375418597,2344274,1172137,1172137,3RdfgDvLvsdZG5Cf6hKiKMQMqfidyxHzjYvUx1FZpeHQ,167668053,796296499,-628628446,624
2022-04-02 09:36:11-04:00,14406,FMdKLXhQEnNJtvM17ZX8jhaeMaSD9UgDuN3Kw7kMrd7K,5pURHYWB5LUGwJmWVBGH8p6oyR9NJvXnZk7uDVoiassv,True,258107455,64526863,403208,201604,201604,YQC4EUcgeBi9431viwvzvBbZJW3szeHX4dFmowRDyDw,16128337,53434586,-37306249,624
2022-04-02 12:08:44-04:00,14407,74MzhjMjDLChEL9RWjUtb6Ztm7Qmq15MUkrbgAiJ8mgK,EY6caxTDF9WQWa7c9ZJCqL92EDcVMcLaSnHhWXvNW6nA,True,59687600,14921900,92397,46198,46199,YQC4EUcgeBi9431viwvzvBbZJW3szeHX4dFmowRDyDw,3695891,15416419,-11720528,619
2022-04-02 14:09:04-04:00,14408,3uUdWwgwtFdPa3FJTSrirqPKMtQb3zmT5Wpp4zPy9sJP,5G7dhz8jvWekGy9Wh3ZCXNXSPbB1QArfFYs7MYNgRDkW,True,2787977292,696994323,4354669,2177334,2177335,3zqXX6kzhkbW3d4TwD2CNjMRwxTbREXySekvq37kfCNk,174186782,288804973,-114618191,624
2022-04-02 18:17:50-04:00,14409,74MzhjMjDLChEL9RWjUtb6Ztm7Qmq15MUkrbgAiJ8mgK,EY6caxTDF9WQWa7c9ZJCqL92EDcVMcLaSnHhWXvNW6nA,True,45517085,11379271,70997,35498,35499,3zqXX6kzhkbW3d4TwD2CNjMRwxTbREXySekvq37kfCNk,2839890,12381687,-9541797,623
2022-04-02 19:09:09-04:00,14410,63RJUGNb2mPuiVvqCacwZ9BDvnqoPuBFbogvHNZukUSW,FyLe7q7PNK9VjdVv2xJyT4q9Wwj5BikVu3xhBirYPhVS,True,5613665854,1403416463,9931422,4965711,4965711,YQC4EUcgeBi9431viwvzvBbZJW3szeHX4dFmowRDyDw,397256893,753693988,-356437095,707
2022-04-02 19:29:54-04:00,14411,6Rk6wVu6pCDFwEWDbiY8wS93nDghyHP9kzdUEa6eFRRq,B5v7eFjSX6dDt1kt84Uvtqmrn7STbQPMbFMvjH6WGXJg,True,396385358,86776381,541206,270603,270603,3zqXX6kzhkbW3d4TwD2CNjMRwxTbREXySekvq37kfCNk,24721770,41231461,-16509691,623
2022-04-02 19:41:41-04:00,14412,APkYocxQ6tyDDnBtJ2Q5Uss6dfdyRD9QNj6CRKK6Wd89,51JqAwqsEgCTUBK3BqJVQKSabipGYGVgkjhFvSzo6v74,True,94059785,23514946,167658,83829,83829,3zqXX6kzhkbW3d4TwD2CNjMRwxTbREXySekvq37kfCNk,6706322,9596643,-2890321,712
2022-04-02 19:48:06-04:00,14413,7fKMVJH9YcTX8mFB4g3K27MvMvTjgno36tRMqAboGM9T,He9yWYM9bcc7Ni8B4XYuboJPbrTyazs5C92HoZm2ejxy,True,769146027,192286506,1195759,597879,597880,3zqXX6kzhkbW3d4TwD2CNjMRwxTbREXySekvq37kfCNk,47830376,79623522,-31793146,621
2022-04-02 19:49:13-04:00,14414,4ue8S7izJAMVKLrioQiTQb4AbLexsbYyvDF5fcV6ycQR,57m6mmGfpvP7vNNzw9fNeNkaEk2W7jYRF22ux61PTdty,True,137090914,34272728,213679,106839,106840,YQC4EUcgeBi9431viwvzvBbZJW3szeHX4dFmowRDyDw,8547173,14135959,-5588786,623
2022-04-02 19:49:45-04:00,14415,3uUdWwgwtFdPa3FJTSrirqPKMtQb3zmT5Wpp4zPy9sJP,5G7dhz8jvWekGy9Wh3ZCXNXSPbB1QArfFYs7MYNgRDkW,True,2049147777,512286944,3201295,1600647,1600648,3zqXX6kzhkbW3d4TwD2CNjMRwxTbREXySekvq37kfCNk,128051802,255912802,-127861000,624
2022-04-02 19:56:04-04:00,14416,6Auz7aARPERW9zbV8428yFUWkA9DuitQYiWQzewueU3o,G1xfLGt5twz7MTfEq6NnMZBpr6GmXceKdGUQkc9jugRB,True,238863693,59715923,373140,186570,186570,3zqXX6kzhkbW3d4TwD2CNjMRwxTbREXySekvq37kfCNk,14925634,24777332,-9851698,624
2022-04-02 21:14:11-04:00,14417,AUEU926CvNMZ4cVLmnkif7auWEHjoLTGdJ7RTYnSTWtk,HCgu9BWTQYkQx1xb4de9T3BtCLsHhynSzzbcoJmreBxD,True,441569990,110392497,689225,344612,344613,3zqXX6kzhkbW3d4TwD2CNjMRwxTbREXySekvq37kfCNk,27569035,45538841,-17969806,624
2022-04-02 21:21:42-04:00,14418,CZ1snuuBhno2SqfAmMLzEEQhrsH2reAmZrGhFVsydvHD,F4Hj3jxxE8W8TbgpvjRLnrQ1Jdd28ZKTPNyu1h9BnLiH,True,4324176008,1081044002,6746427,3373213,3373214,3zqXX6kzhkbW3d4TwD2CNjMRwxTbREXySekvq37kfCNk,269857113,445492841,-175635728,624
2022-04-02 21:21:55-04:00,14419,FU7X4DWnGTbxwXULBq3v9SACzYhQyFGqsXjUDzyFqiem,925BaEnWxTfEv4oQb9Xf1wyyEEWEr8kXeSdXTtRfShfw,True,124816195975,11370858225,71012771,35506385,35506386,3zqXX6kzhkbW3d4TwD2CNjMRwxTbREXySekvq37kfCNk,7794964821,7714458459,80506362,624
2022-04-02 21:22:25-04:00,14420,8nFpzAFXELGPsrgFwRjTfUidNme1CvgKQTsHWATtMqkz,ABt8ikXHraZ1bqkDUvMtJ3AUzADDWcCL8kMMDpAoth8V,True,400852280,100213070,626118,313059,313059,3zqXX6kzhkbW3d4TwD2CNjMRwxTbREXySekvq37kfCNk,25044750,41302970,-16258220,624
2022-04-03 01:34:37-04:00,14421,29JVska5UEG3axs63EmtHpPvkswNEqYpZ3PKMSfupiAG,DCftNBUsuogxyaJe9G9m3eWipH6o3qo4Rn4TuQXdVaBF,True,199420658,49855164,309229,154614,154615,3zqXX6kzhkbW3d4TwD2CNjMRwxTbREXySekvq37kfCNk,12369191,21593407,-9224216,620
2022-04-03 02:34:11-04:00,14422,6Rk6wVu6pCDFwEWDbiY8wS93nDghyHP9kzdUEa6eFRRq,B5v7eFjSX6dDt1kt84Uvtqmrn7STbQPMbFMvjH6WGXJg,True,337169558,71850693,446295,223147,223148,3zqXX6kzhkbW3d4TwD2CNjMRwxTbREXySekvq37kfCNk,20943077,36254847,-15311770,621
2022-04-03 02:34:14-04:00,14423,6eG79A3rpgHtLxUV85npfsYYhQNa3AhbBx8pYs7FQ4ic,8Prjuk5w1quKtSwZXqPwNuRF5FLewKhEBAcG3qQM2gKf,True,55267196,13816799,85872,42936,42936,YQC4EUcgeBi9431viwvzvBbZJW3szeHX4dFmowRDyDw,3434887,17804184,-14369297,621
2022-04-03 02:35:04-04:00,14424,74MzhjMjDLChEL9RWjUtb6Ztm7Qmq15MUkrbgAiJ8mgK,EY6caxTDF9WQWa7c9ZJCqL92EDcVMcLaSnHhWXvNW6nA,True,34741427,8685356,53750,26875,26875,YQC4EUcgeBi9431viwvzvBbZJW3szeHX4dFmowRDyDw,2150022,9909992,-7759970,618
2022-04-03 05:46:00-04:00,14425,8ayr4AZAcNN17UCJUXe5VJtaj6ziTmGpER4fpHGpdbiT,uRK1KLx2bX5xGSAkviLApXew2aT9ar4ATb24yu7ELRR,True,109856718,27464179,170432,85216,85216,3zqXX6kzhkbW3d4TwD2CNjMRwxTbREXySekvq37kfCNk,6817318,10513695,-3696377,620
2022-04-03 13:23:04-04:00,14426,Gw37fsD8M3AaZ22tSx9WeszxsAkWQ6Ap2XV3zXYhe3EJ,FbKeJsWR5ggVBy1R5sxNiWz5GAsxeyZD8nmyk5yCBqSz,True,306658739,76664684,538467,269233,269234,YQC4EUcgeBi9431viwvzvBbZJW3szeHX4dFmowRDyDw,21538697,61133798,-39595101,702
2022-04-03 13:23:58-04:00,14427,F2AU2PjaSmHxWWhkz8XxMggkCMWbMVgawt89tSnYS6RL,ET9febRJiW197DYMaJbgk3kWsAeFv5f4peQ4vFCVppK6,True,135508952,33877238,240947,120473,120474,YQC4EUcgeBi9431viwvzvBbZJW3szeHX4dFmowRDyDw,9637894,30548835,-20910941,711
2022-04-03 13:24:10-04:00,14428,63RJUGNb2mPuiVvqCacwZ9BDvnqoPuBFbogvHNZukUSW,FyLe7q7PNK9VjdVv2xJyT4q9Wwj5BikVu3xhBirYPhVS,True,4116566043,1029141510,7278979,3639489,3639490,3zqXX6kzhkbW3d4TwD2CNjMRwxTbREXySekvq37kfCNk,291159174,655297175,-364138001,707
2022-04-03 13:24:13-04:00,14429,AyFWvQUX79sq8L7KhcYrPRbxd6whUvEMETZL8atuuRr2,9LTjofdhGLn2Ltv6XfuHtX8MKEPzScGL669pC8Lrgtnh,True,115830201,22156978,152168,76084,76084,YQC4EUcgeBi9431viwvzvBbZJW3szeHX4dFmowRDyDw,7954959,19610572,-11655613,686
2022-04-03 13:24:13-04:00,14430,GCweck6iuscBsVbXW9ZYfMytdgwSYWwNifTWLaUbaSmA,6HwGWKGduMGvLnHmTJo6ZioZ3EMUZYHo2pG4tBFXgB4Y,True,199489635,49872408,354716,177358,177358,3zqXX6kzhkbW3d4TwD2CNjMRwxTbREXySekvq37kfCNk,14188662,44938324,-30749662,711
2022-04-03 13:28:33-04:00,14431,EHLV9s6E1s5SUbzZVzsGWH2vVRGHyxynM4GDJtfKEuYe,4hAx9osegpeocSSmJbMVBYMKCwo5WY3QVJuK7cuzz4b4,True,199442838,49860709,354083,177041,177042,3zqXX6kzhkbW3d4TwD2CNjMRwxTbREXySekvq37kfCNk,14163347,44960469,-30797122,710
2022-04-03 13:28:37-04:00,14432,5qY8ZrqpHPqkAuXp6HpE2zC8qTfzsP8MXWSoxkZQV5jx,GPs3ap45TuHwHwmDb5bnKYHLBa5wj3AyuEsXcfHjEcAL,True,90173829,22543457,159743,79871,79872,YQC4EUcgeBi9431viwvzvBbZJW3szeHX4dFmowRDyDw,6389740,15565347,-9175607,708
2022-04-03 13:28:37-04:00,14433,APkYocxQ6tyDDnBtJ2Q5Uss6dfdyRD9QNj6CRKK6Wd89,51JqAwqsEgCTUBK3BqJVQKSabipGYGVgkjhFvSzo6v74,True,68923551,17230887,121893,60946,60947,YQC4EUcgeBi9431viwvzvBbZJW3szeHX4dFmowRDyDw,4875726,8665608,-3789882,707
2022-04-03 13:28:39-04:00,14434,3hEe6AXGjjVzWnsadNZHfeB6CGg8nKSLyhtyqgBtVivt,6Qdu667ChFcRT7J5QHQzUsWpLmxmNvywAaevseSXqxPZ,True,16024799,4006199,28402,14201,14201,YQC4EUcgeBi9431viwvzvBbZJW3szeHX4dFmowRDyDw,1136119,3563611,-2427492,708
2022-04-03 13:29:52-04:00,14435,Gw37fsD8M3AaZ22tSx9WeszxsAkWQ6Ap2XV3zXYhe3EJ,FbKeJsWR5ggVBy1R5sxNiWz5GAsxeyZD8nmyk5yCBqSz,True,224326297,56081574,383311,191655,191656,3zqXX6kzhkbW3d4TwD2CNjMRwxTbREXySekvq37kfCNk,15332472,50706513,-35374041,683
2022-04-03 13:30:25-04:00,14436,5nALef7nAfNkSQSuTBLwewDby4pUx74Gzqib33Znmmt6,8xNTWK2xNK2xZPpgXfcE4QxPT2i6YvNYakiLgdQ2FqEt,True,1581181258,395295314,2462971,1231485,1231486,3zqXX6kzhkbW3d4TwD2CNjMRwxTbREXySekvq37kfCNk,98518859,143403442,-44884583,623
2022-04-03 18:24:44-04:00,14437,GTzLxRn226vTjN4HTSDSCjDLjwNiP4jsarG4umsA4CPc,6BWii3HLmdacnSS1pe8RkbbN6kbe4jpYYbnHqM1hh2G5,True,290542475,72635618,439523,219761,219762,3zqXX6kzhkbW3d4TwD2CNjMRwxTbREXySekvq37kfCNk,17580949,37538509,-19957560,605
2022-04-04 05:54:24-04:00,14438,F2AU2PjaSmHxWWhkz8XxMggkCMWbMVgawt89tSnYS6RL,ET9febRJiW197DYMaJbgk3kWsAeFv5f4peQ4vFCVppK6,True,99331816,24832954,176488,88244,88244,YQC4EUcgeBi9431viwvzvBbZJW3szeHX4dFmowRDyDw,7059527,25044628,-17985101,710
2022-04-04 06:04:09-04:00,14439,4rLtMQSN7dkQMAB1RiQwtQepNcvrpsGgshMmzpDNa5ta,ESnuS85iexRfPoCGQSHKxMB28FoDNc4sPwnWSC9RvKKs,True,28011457,7002864,49305,24652,24653,YQC4EUcgeBi9431viwvzvBbZJW3szeHX4dFmowRDyDw,1972213,3953698,-1981485,704
2022-04-04 06:04:09-04:00,14440,63RJUGNb2mPuiVvqCacwZ9BDvnqoPuBFbogvHNZukUSW,FyLe7q7PNK9VjdVv2xJyT4q9Wwj5BikVu3xhBirYPhVS,True,3019315999,754828999,5366197,2683098,2683099,3zqXX6kzhkbW3d4TwD2CNjMRwxTbREXySekvq37kfCNk,214647887,557601224,-342953337,710
2022-04-04 06:04:12-04:00,14441,GCweck6iuscBsVbXW9ZYfMytdgwSYWwNifTWLaUbaSmA,6HwGWKGduMGvLnHmTJo6ZioZ3EMUZYHo2pG4tBFXgB4Y,True,146212440,36553110,259369,129684,129685,YQC4EUcgeBi9431viwvzvBbZJW3szeHX4dFmowRDyDw,10374778,36846148,-26471370,709
2022-04-04 06:38:29-04:00,14442,EHLV9s6E1s5SUbzZVzsGWH2vVRGHyxynM4GDJtfKEuYe,4hAx9osegpeocSSmJbMVBYMKCwo5WY3QVJuK7cuzz4b4,True,146147620,36536905,258007,129003,129004,3zqXX6kzhkbW3d4TwD2CNjMRwxTbREXySekvq37kfCNk,10320307,36856996,-26536689,706
2022-04-04 06:39:13-04:00,14443,APkYocxQ6tyDDnBtJ2Q5Uss6dfdyRD9QNj6CRKK6Wd89,51JqAwqsEgCTUBK3BqJVQKSabipGYGVgkjhFvSzo6v74,True,50545415,12636353,89693,44846,44847,YQC4EUcgeBi9431viwvzvBbZJW3szeHX4dFmowRDyDw,3587743,7577878,-3990135,709
2022-04-04 06:39:16-04:00,14444,3hEe6AXGjjVzWnsadNZHfeB6CGg8nKSLyhtyqgBtVivt,6Qdu667ChFcRT7J5QHQzUsWpLmxmNvywAaevseSXqxPZ,False,11731445,11731445,816182,40809,775373,YQC4EUcgeBi9431viwvzvBbZJW3szeHX4dFmowRDyDw,816182,2923985,-2107803,695
2022-04-04 06:39:18-04:00,14445,5qY8ZrqpHPqkAuXp6HpE2zC8qTfzsP8MXWSoxkZQV5jx,GPs3ap45TuHwHwmDb5bnKYHLBa5wj3AyuEsXcfHjEcAL,True,66012328,16503082,114682,57341,57341,3zqXX6kzhkbW3d4TwD2CNjMRwxTbREXySekvq37kfCNk,4587303,13087900,-8500597,694
2022-04-04 06:39:30-04:00,14446,Gw37fsD8M3AaZ22tSx9WeszxsAkWQ6Ap2XV3zXYhe3EJ,FbKeJsWR5ggVBy1R5sxNiWz5GAsxeyZD8nmyk5yCBqSz,True,164705036,41176259,283690,141845,141845,3zqXX6kzhkbW3d4TwD2CNjMRwxTbREXySekvq37kfCNk,11347623,41423373,-30075750,688
2022-04-04 06:41:12-04:00,14447,13QjvYYcM5izdJ49PzRWqrw8ZCT3zH818AuTUJhw5Mbz,7Uxmf8a4rpKW1Z163MQygUqmqj2mMqjxih3ppwv3G8ee,True,410191400,102547850,630027,315013,315014,3zqXX6kzhkbW3d4TwD2CNjMRwxTbREXySekvq37kfCNk,25201093,42289436,-17088343,614
2022-04-04 08:45:43-04:00,14448,jLcMvWkdEDweLB1otEdmsnL48kQPF5esSKx5WDzrdei,3VtwkSQaVnPv8MFuyDDj6dGQGnuY5GDUY2wYkBFRkfdF,True,174706906379,43676726594,270831702,135415851,135415851,3zqXX6kzhkbW3d4TwD2CNjMRwxTbREXySekvq37kfCNk,10833268099,19109585136,-8276317037,620
2022-04-04 08:46:21-04:00,14449,6RuQVU9nu2Ecp177M9ggWczLACvQ8PfT31RTcmfwe9Hq,DZgsgqvMNLTXkBxySZC7Monak2JGsXRMJT4hBQzpf6Xm,True,15060105876,2379579293,14871473,7435736,7435737,3zqXX6kzhkbW3d4TwD2CNjMRwxTbREXySekvq37kfCNk,941199845,729173285,212026560,624
2022-04-04 08:48:24-04:00,14450,EYyXFfLaPc2JeUwi2G5WewrK6KNjZnvwg6CCKJYPUvi1,AEz7KTmSsrHmMdeDiFWNioj9zbEucHieMqrqnZY3zTcL,True,677040802,169260200,1200325,600162,600163,3zqXX6kzhkbW3d4TwD2CNjMRwxTbREXySekvq37kfCNk,48013012,73376365,-25363353,709
2022-04-04 08:51:33-04:00,14451,BFWNfNhm4RUFJs3721We8Dyocw1okinoUA3JtHshAHkU,7czPpWxLYgLgAGmvxiKA6zRGQ97FdLVB83FvNqEuKnFj,True,13659758679,3414939669,21325096,10662548,10662548,3zqXX6kzhkbW3d4TwD2CNjMRwxTbREXySekvq37kfCNk,853003874,1537712629,-684708755,624
2022-04-04 09:16:56-04:00,14452,5nALef7nAfNkSQSuTBLwewDby4pUx74Gzqib33Znmmt6,8xNTWK2xNK2xZPpgXfcE4QxPT2i6YvNYakiLgdQ2FqEt,True,1161055546,290263886,1796582,898291,898291,3zqXX6kzhkbW3d4TwD2CNjMRwxTbREXySekvq37kfCNk,71863296,130372348,-58509052,618
2022-04-04 09:17:12-04:00,14453,AiP6Qy3zAqKCVpsoQbNxLJKpEGrWYA2BBWRf3ECcLmSZ,3awK8LVFcHCeSZm25AhuhLzpHYjaaVgDhQba1FGrYCKr,True,1200249663,300062415,1874284,937142,937142,3zqXX6kzhkbW3d4TwD2CNjMRwxTbREXySekvq37kfCNk,74971385,123717936,-48746551,624
2022-04-04 09:32:12-04:00,14454,3uUdWwgwtFdPa3FJTSrirqPKMtQb3zmT5Wpp4zPy9sJP,5G7dhz8jvWekGy9Wh3ZCXNXSPbB1QArfFYs7MYNgRDkW,True,1502676163,375669040,2276718,1138359,1138359,YQC4EUcgeBi9431viwvzvBbZJW3szeHX4dFmowRDyDw,91068724,221183762,-130115038,606
2022-04-04 09:32:15-04:00,14455,6RuQVU9nu2Ecp177M9ggWczLACvQ8PfT31RTcmfwe9Hq,DZgsgqvMNLTXkBxySZC7Monak2JGsXRMJT4hBQzpf6Xm,True,12536519470,1762288037,10998851,5499425,5499426,3zqXX6kzhkbW3d4TwD2CNjMRwxTbREXySekvq37kfCNk,782433512,634582850,147850662,624
2022-04-04 09:32:15-04:00,14456,6Auz7aARPERW9zbV8428yFUWkA9DuitQYiWQzewueU3o,G1xfLGt5twz7MTfEq6NnMZBpr6GmXceKdGUQkc9jugRB,True,176288013,44072003,271564,135782,135782,3zqXX6kzhkbW3d4TwD2CNjMRwxTbREXySekvq37kfCNk,10862599,21988122,-11125523,616
2022-04-04 09:32:15-04:00,14457,5xpiEvfY9hpdUW1c85fQSTBPgVbcrjD5hkmUCYvSF2DR,AhJe4Y7uima7HC8eYfZs7xJZrWth12UczAa2fHyUjfbp,True,4321048561,1080262140,6704400,3352200,3352200,3zqXX6kzhkbW3d4TwD2CNjMRwxTbREXySekvq37kfCNk,268176022,446727791,-178551769,620
2022-04-04 11:03:11-04:00,14458,13QjvYYcM5izdJ49PzRWqrw8ZCT3zH818AuTUJhw5Mbz,7Uxmf8a4rpKW1Z163MQygUqmqj2mMqjxih3ppwv3G8ee,True,301932025,75483006,471363,235681,235682,3zqXX6kzhkbW3d4TwD2CNjMRwxTbREXySekvq37kfCNk,18854540,37383476,-18528936,624
2022-04-04 11:03:30-04:00,14459,8nFpzAFXELGPsrgFwRjTfUidNme1CvgKQTsHWATtMqkz,ABt8ikXHraZ1bqkDUvMtJ3AUzADDWcCL8kMMDpAoth8V,True,333573555,83393388,520611,260305,260306,3zqXX6kzhkbW3d4TwD2CNjMRwxTbREXySekvq37kfCNk,20824448,34475987,-13651539,624
2022-04-04 11:04:58-04:00,14460,D85pWm1LS9MvtR4f3QhkFLvNUhZLQ2NZBFQTyAVnmigm,CRN85DYkJJi6irhtVAf4qcJU3ijVodWdXgWe7Fs6Ahka,True,1158826307,289706576,1780343,890171,890172,3zqXX6kzhkbW3d4TwD2CNjMRwxTbREXySekvq37kfCNk,71213751,132548378,-61334627,614
2022-04-04 11:05:10-04:00,14461,29JVska5UEG3axs63EmtHpPvkswNEqYpZ3PKMSfupiAG,DCftNBUsuogxyaJe9G9m3eWipH6o3qo4Rn4TuQXdVaBF,True,123172043,30793010,191275,95637,95638,YQC4EUcgeBi9431viwvzvBbZJW3szeHX4dFmowRDyDw,7651013,13443894,-5792881,621
2022-04-04 11:06:57-04:00,14462,8K1GzGeaAuFdjuVZi6DqBcYiA1zSRioMkRvjotr8p7fz,5mqocPwTdjwAPiJf7vx9bo7AzvfQBT2t5bV9u2Jzb2e1,True,6584663338,1646165834,9747235,4873617,4873618,YQC4EUcgeBi9431viwvzvBbZJW3szeHX4dFmowRDyDw,389889428,295775250,94114178,592
2022-04-04 11:06:58-04:00,14463,AiP6Qy3zAqKCVpsoQbNxLJKpEGrWYA2BBWRf3ECcLmSZ,3awK8LVFcHCeSZm25AhuhLzpHYjaaVgDhQba1FGrYCKr,True,879483897,219870974,1309607,654803,654804,3zqXX6kzhkbW3d4TwD2CNjMRwxTbREXySekvq37kfCNk,52384290,109657468,-57273178,595
2022-04-04 11:09:22-04:00,14464,F2AU2PjaSmHxWWhkz8XxMggkCMWbMVgawt89tSnYS6RL,ET9febRJiW197DYMaJbgk3kWsAeFv5f4peQ4vFCVppK6,True,72745363,18186340,128215,64107,64108,YQC4EUcgeBi9431viwvzvBbZJW3szeHX4dFmowRDyDw,5128601,20372037,-15243436,705
2022-04-04 11:10:36-04:00,14465,4rLtMQSN7dkQMAB1RiQwtQepNcvrpsGgshMmzpDNa5ta,ESnuS85iexRfPoCGQSHKxMB28FoDNc4sPwnWSC9RvKKs,True,20518607,5129651,35812,17906,17906,YQC4EUcgeBi9431viwvzvBbZJW3szeHX4dFmowRDyDw,1432499,3408680,-1976181,698
2022-04-04 11:10:38-04:00,14466,63RJUGNb2mPuiVvqCacwZ9BDvnqoPuBFbogvHNZukUSW,FyLe7q7PNK9VjdVv2xJyT4q9Wwj5BikVu3xhBirYPhVS,True,2211130094,552782523,3896976,1948488,1948488,3zqXX6kzhkbW3d4TwD2CNjMRwxTbREXySekvq37kfCNk,155879050,467420460,-311541410,704
2022-04-04 11:10:46-04:00,14467,APkYocxQ6tyDDnBtJ2Q5Uss6dfdyRD9QNj6CRKK6Wd89,51JqAwqsEgCTUBK3BqJVQKSabipGYGVgkjhFvSzo6v74,True,37023992,9255998,65305,32652,32653,YQC4EUcgeBi9431viwvzvBbZJW3szeHX4dFmowRDyDw,2612214,6490149,-3877935,705
2022-04-04 11:10:49-04:00,14468,5qY8ZrqpHPqkAuXp6HpE2zC8qTfzsP8MXWSoxkZQV5jx,GPs3ap45TuHwHwmDb5bnKYHLBa5wj3AyuEsXcfHjEcAL,True,48439790,12109947,85054,42527,42527,YQC4EUcgeBi9431viwvzvBbZJW3szeHX4dFmowRDyDw,3402163,10847538,-7445375,702
2022-04-04 11:10:53-04:00,14469,GCweck6iuscBsVbXW9ZYfMytdgwSYWwNifTWLaUbaSmA,6HwGWKGduMGvLnHmTJo6ZioZ3EMUZYHo2pG4tBFXgB4Y,True,106854494,26713623,182709,91354,91355,YQC4EUcgeBi9431viwvzvBbZJW3szeHX4dFmowRDyDw,7308361,29969136,-22660775,683
2022-04-04 11:10:53-04:00,14470,H69q3Q8E74xm7swmMQpsJLVp2Q9JuBwBbxraAMX5Drzm,5RiCCwr1YLn1136t6pprm9FAvcrJNG8VA394CYHpYbtA,True,12933057417,3233264354,20143396,10071698,10071698,3zqXX6kzhkbW3d4TwD2CNjMRwxTbREXySekvq37kfCNk,805735875,1506759882,-701024007,623
2022-04-04 11:10:58-04:00,14471,EHLV9s6E1s5SUbzZVzsGWH2vVRGHyxynM4GDJtfKEuYe,4hAx9osegpeocSSmJbMVBYMKCwo5WY3QVJuK7cuzz4b4,True,106878395,26719598,183194,91597,91597,YQC4EUcgeBi9431viwvzvBbZJW3szeHX4dFmowRDyDw,7327765,29965015,-22637250,685
2022-04-04 11:11:21-04:00,14472,67DwuUmzk6uGwmptjYErQssFeJ5fd1ztFwKWZUovr7pK,HKzc15e1QLBrSsbAENyMXSVHDoap1F5MHCHB9L1Dm8HA,True,1277200150,319300037,1986253,993126,993127,3zqXX6kzhkbW3d4TwD2CNjMRwxTbREXySekvq37kfCNk,79450151,131594636,-52144485,622
2022-04-04 11:11:43-04:00,14473,DXGapgtgkag6midSCYNhHCNaCqvhUmuSvnVhXxNXBmyt,Csq6W5QkGZL6qE6Z1ERF3bfHtKjnM8hAxiY1YA3rTwSX,True,3472116787,868029196,5411426,2705713,2705713,YQC4EUcgeBi9431viwvzvBbZJW3szeHX4dFmowRDyDw,216457075,408514541,-192057466,623
2022-04-04 11:11:49-04:00,14474,3uUdWwgwtFdPa3FJTSrirqPKMtQb3zmT5Wpp4zPy9sJP,5G7dhz8jvWekGy9Wh3ZCXNXSPbB1QArfFYs7MYNgRDkW,True,1107184674,276796168,1724110,862055,862055,3zqXX6kzhkbW3d4TwD2CNjMRwxTbREXySekvq37kfCNk,68964416,186392399,-117427983,622
2022-04-04 11:12:56-04:00,14475,13QjvYYcM5izdJ49PzRWqrw8ZCT3zH818AuTUJhw5Mbz,7Uxmf8a4rpKW1Z163MQygUqmqj2mMqjxih3ppwv3G8ee,False,218909399,218909399,10843557,542177,10301380,3zqXX6kzhkbW3d4TwD2CNjMRwxTbREXySekvq37kfCNk,10843557,32280522,-21436965,495
2022-04-04 11:12:59-04:00,14476,2xgQaQTs7bkK34jSBZ2dFZf1DJKjMVW9LA3D9Pwtfims,6rniSBeGcJAcrqWhhnKCcRV58yYnjuqXj9b4Zu8DUwQ9,True,190495895,47061660,286732,143366,143366,3zqXX6kzhkbW3d4TwD2CNjMRwxTbREXySekvq37kfCNk,11606336,19863474,-8257138,609
2022-04-04 11:13:00-04:00,14477,CZ1snuuBhno2SqfAmMLzEEQhrsH2reAmZrGhFVsydvHD,F4Hj3jxxE8W8TbgpvjRLnrQ1Jdd28ZKTPNyu1h9BnLiH,True,3141437945,785359486,4029473,2014736,2014737,YQC4EUcgeBi9431viwvzvBbZJW3szeHX4dFmowRDyDw,161178948,394729064,-233550116,513
2022-04-04 11:13:00-04:00,14478,6eEifGxGRBnXV5EW2BwmCj8pa67znMjet98Nsq11LCsd,Dd4UCEX7tm6Q82SdSSFX9wBcJNw5TwKu8EyGjvxi9FVc,True,1917949621,479487405,2873081,1436540,1436541,YQC4EUcgeBi9431viwvzvBbZJW3szeHX4dFmowRDyDw,114923259,135892579,-20969320,599
2022-04-04 11:13:01-04:00,14479,8nFpzAFXELGPsrgFwRjTfUidNme1CvgKQTsHWATtMqkz,ABt8ikXHraZ1bqkDUvMtJ3AUzADDWcCL8kMMDpAoth8V,True,242905582,60726395,325731,162865,162866,3zqXX6kzhkbW3d4TwD2CNjMRwxTbREXySekvq37kfCNk,13029252,30543262,-17514010,536
2022-04-04 11:13:02-04:00,14480,29JVska5UEG3axs63EmtHpPvkswNEqYpZ3PKMSfupiAG,DCftNBUsuogxyaJe9G9m3eWipH6o3qo4Rn4TuQXdVaBF,True,90016217,22504054,127423,63711,63712,3zqXX6kzhkbW3d4TwD2CNjMRwxTbREXySekvq37kfCNk,5096922,11804505,-6707583,566
2022-04-04 11:13:02-04:00,14481,8K1GzGeaAuFdjuVZi6DqBcYiA1zSRioMkRvjotr8p7fz,5mqocPwTdjwAPiJf7vx9bo7AzvfQBT2t5bV9u2Jzb2e1,True,4859785788,1214946447,7535761,3767880,3767881,YQC4EUcgeBi9431viwvzvBbZJW3szeHX4dFmowRDyDw,301430477,309842486,-8412009,620
2022-04-04 13:40:52-04:00,14482,6Auz7aARPERW9zbV8428yFUWkA9DuitQYiWQzewueU3o,G1xfLGt5twz7MTfEq6NnMZBpr6GmXceKdGUQkc9jugRB,True,129726899,32431724,202530,101265,101265,YQC4EUcgeBi9431viwvzvBbZJW3szeHX4dFmowRDyDw,8101217,18934730,-10833513,624
2022-04-04 13:41:11-04:00,14483,Gw37fsD8M3AaZ22tSx9WeszxsAkWQ6Ap2XV3zXYhe3EJ,FbKeJsWR5ggVBy1R5sxNiWz5GAsxeyZD8nmyk5yCBqSz,True,121045641,30261410,215164,107582,107582,YQC4EUcgeBi9431viwvzvBbZJW3szeHX4dFmowRDyDw,8606574,33649602,-25043028,711
2022-04-04 13:41:14-04:00,14484,5xpiEvfY9hpdUW1c85fQSTBPgVbcrjD5hkmUCYvSF2DR,AhJe4Y7uima7HC8eYfZs7xJZrWth12UczAa2fHyUjfbp,True,3177487272,794371818,4953878,2476939,2476939,3zqXX6kzhkbW3d4TwD2CNjMRwxTbREXySekvq37kfCNk,198155130,395520721,-197365591,623
2022-04-04 13:42:44-04:00,14485,eiLMepBYM3VcWarQJC9fTnxotyMuUTbyMGJECedPEfu,k2ZfwPNBBCK7PvZ6MEvELTHHtQZSXCRGCymvkZwhDDt,True,149067259,31793448,197883,98941,98942,YQC4EUcgeBi9431viwvzvBbZJW3szeHX4dFmowRDyDw,9278007,19582497,-10304490,622
2022-04-04 13:42:44-04:00,14486,7yW1M1xeVx4hy3QftnpqdBDRYwamfu3K5i6AEnxgyTWb,7wf7FWS2DYp5RveQAmGNXAEUWPcHziuMLd4hV5LPgxF8,True,76399550,19099887,118501,59250,59251,YQC4EUcgeBi9431viwvzvBbZJW3szeHX4dFmowRDyDw,4740047,8340282,-3600235,620
2022-04-04 13:42:55-04:00,14487,FU7X4DWnGTbxwXULBq3v9SACzYhQyFGqsXjUDzyFqiem,925BaEnWxTfEv4oQb9Xf1wyyEEWEr8kXeSdXTtRfShfw,True,112750952897,11091574079,69019013,34509506,34509507,3zqXX6kzhkbW3d4TwD2CNjMRwxTbREXySekvq37kfCNk,7016100224,7869046502,-852946278,622
2022-04-04 13:43:40-04:00,14488,67DwuUmzk6uGwmptjYErQssFeJ5fd1ztFwKWZUovr7pK,HKzc15e1QLBrSsbAENyMXSVHDoap1F5MHCHB9L1Dm8HA,True,938907872,234726968,1461428,730714,730714,3zqXX6kzhkbW3d4TwD2CNjMRwxTbREXySekvq37kfCNk,58457151,116569126,-58111975,622
2022-04-04 13:43:42-04:00,14489,5zSoXxVZYYQAtq3urfcUQmJkjFDBXkUJYSNFdq759Tof,3C459gJnmj4EYTG3tDFJEEf1aAT915sxRLs2THEdQqha,True,15706714357,1173394743,7290106,3645053,3645053,3zqXX6kzhkbW3d4TwD2CNjMRwxTbREXySekvq37kfCNk,975832024,1364709820,-388877796,621
2022-04-04 13:44:11-04:00,14490,CZ1snuuBhno2SqfAmMLzEEQhrsH2reAmZrGhFVsydvHD,F4Hj3jxxE8W8TbgpvjRLnrQ1Jdd28ZKTPNyu1h9BnLiH,True,2345526020,586381505,3664019,1832009,1832010,3zqXX6kzhkbW3d4TwD2CNjMRwxTbREXySekvq37kfCNk,146560782,332347373,-185786591,624
2022-04-04 13:45:58-04:00,14491,F2AU2PjaSmHxWWhkz8XxMggkCMWbMVgawt89tSnYS6RL,ET9febRJiW197DYMaJbgk3kWsAeFv5f4peQ4vFCVppK6,True,53297202,13324300,93779,46889,46890,YQC4EUcgeBi9431viwvzvBbZJW3szeHX4dFmowRDyDw,3751183,16446199,-12695016,703
2022-04-04 13:49:47-04:00,14492,4rLtMQSN7dkQMAB1RiQwtQepNcvrpsGgshMmzpDNa5ta,ESnuS85iexRfPoCGQSHKxMB28FoDNc4sPwnWSC9RvKKs,True,15063338,3765834,26866,13433,13433,YQC4EUcgeBi9431viwvzvBbZJW3szeHX4dFmowRDyDw,1074640,2882439,-1807799,713
2022-04-04 13:52:05-04:00,14493,SEndYVMCKAeZUKSqGrMUSqXFmxtA9M1t4eXsUhVsTBF,3fcQQcbkpqodakamn82pFnMxBEPL2Drsg4jJNZ6dx72M,True,1919060956,250643889,1652819,826409,826410,3zqXX6kzhkbW3d4TwD2CNjMRwxTbREXySekvq37kfCNk,126548576,302402875,-175854299,659
2022-04-04 14:07:50-04:00,14494,GCweck6iuscBsVbXW9ZYfMytdgwSYWwNifTWLaUbaSmA,6HwGWKGduMGvLnHmTJo6ZioZ3EMUZYHo2pG4tBFXgB4Y,True,78574592,19643648,139450,69725,69725,3zqXX6kzhkbW3d4TwD2CNjMRwxTbREXySekvq37kfCNk,5578030,24141230,-18563200,709
2022-04-04 14:07:57-04:00,14495,FU7X4DWnGTbxwXULBq3v9SACzYhQyFGqsXjUDzyFqiem,925BaEnWxTfEv4oQb9Xf1wyyEEWEr8kXeSdXTtRfShfw,True,101025185785,8465135722,52893080,26446540,26446540,3zqXX6kzhkbW3d4TwD2CNjMRwxTbREXySekvq37kfCNk,6312401179,7674736842,-1362335663,624
2022-04-04 14:08:09-04:00,14496,EHLV9s6E1s5SUbzZVzsGWH2vVRGHyxynM4GDJtfKEuYe,4hAx9osegpeocSSmJbMVBYMKCwo5WY3QVJuK7cuzz4b4,True,78502956,19625739,137685,68842,68843,3zqXX6kzhkbW3d4TwD2CNjMRwxTbREXySekvq37kfCNk,5507410,24142529,-18635119,701
2022-04-04 14:08:09-04:00,14497,63RJUGNb2mPuiVvqCacwZ9BDvnqoPuBFbogvHNZukUSW,FyLe7q7PNK9VjdVv2xJyT4q9Wwj5BikVu3xhBirYPhVS,True,1619927213,404981803,2848687,1424343,1424344,3zqXX6kzhkbW3d4TwD2CNjMRwxTbREXySekvq37kfCNk,113947515,386563177,-272615662,703
2022-04-04 14:08:15-04:00,14498,5qY8ZrqpHPqkAuXp6HpE2zC8qTfzsP8MXWSoxkZQV5jx,GPs3ap45TuHwHwmDb5bnKYHLBa5wj3AyuEsXcfHjEcAL,True,35524364,8881091,63002,31501,31501,3zqXX6kzhkbW3d4TwD2CNjMRwxTbREXySekvq37kfCNk,2520087,8909860,-6389773,709
2022-04-04 14:08:19-04:00,14499,APkYocxQ6tyDDnBtJ2Q5Uss6dfdyRD9QNj6CRKK6Wd89,51JqAwqsEgCTUBK3BqJVQKSabipGYGVgkjhFvSzo6v74,True,27152754,6788188,48453,24226,24227,3zqXX6kzhkbW3d4TwD2CNjMRwxTbREXySekvq37kfCNk,1938133,5461971,-3523838,713
2022-04-04 18:48:22-04:00,14500,5T5GLsPG2F8zjjMuMcyD8cRY6fgGzEyNwM4AuFAD6Pmc,GKVFcaysgYpNqDzFdrYhPKmeLU22qEZ8xAxiVJPPvy8w,True,2163946754,540986688,3360329,1680164,1680165,YQC4EUcgeBi9431viwvzvBbZJW3szeHX4dFmowRDyDw,134413191,204462609,-70049418,621
2022-04-04 18:49:54-04:00,14501,GTzLxRn226vTjN4HTSDSCjDLjwNiP4jsarG4umsA4CPc,6BWii3HLmdacnSS1pe8RkbbN6kbe4jpYYbnHqM1hh2G5,True,283259921,70814980,442099,221049,221050,3zqXX6kzhkbW3d4TwD2CNjMRwxTbREXySekvq37kfCNk,17683973,32069123,-14385150,624
2022-04-04 20:49:55-04:00,14502,6Rk6wVu6pCDFwEWDbiY8wS93nDghyHP9kzdUEa6eFRRq,B5v7eFjSX6dDt1kt84Uvtqmrn7STbQPMbFMvjH6WGXJg,True,301708607,62948872,392889,196444,196445,3zqXX6kzhkbW3d4TwD2CNjMRwxTbREXySekvq37kfCNk,18830916,31610200,-12779284,624
2022-04-04 20:50:50-04:00,14503,7f9TE7GqXHaQPRfC2qjASdDXyoDgeimPtvAxUi36uupJ,7E6mmcAeNged5bsLsDUfu8ZPSL757BAP3h4ya7mK3Zpo,True,57949361,14487340,90522,45261,45261,YQC4EUcgeBi9431viwvzvBbZJW3szeHX4dFmowRDyDw,3620913,18635096,-15014183,624
2022-04-05 07:56:28-04:00,14504,5T5GLsPG2F8zjjMuMcyD8cRY6fgGzEyNwM4AuFAD6Pmc,GKVFcaysgYpNqDzFdrYhPKmeLU22qEZ8xAxiVJPPvy8w,True,1651340202,412835050,2567703,1283851,1283852,YQC4EUcgeBi9431viwvzvBbZJW3szeHX4dFmowRDyDw,102708153,183655326,-80947173,621
2022-04-05 08:30:18-04:00,14505,2Tm69hQroe4dREXCLHubHfDTkDPohvcMEFuALmCpNZw6,4FH8oJspDa4TPVVXgzJzVM1eTHdnNvSf59C1A8m2PXoc,True,745086222,102781204,641450,320725,320725,3zqXX6kzhkbW3d4TwD2CNjMRwxTbREXySekvq37kfCNk,46500338,128302635,-81802297,624
2022-04-05 10:09:15-04:00,14506,niCk6QHFU1kyU56Mdq5RJzKrecdkNSn23ZA6wduFdWS,BQbUYSw1XsuE6LnVd4XjmxAyYgx4drE4FsetJBCdwVZW,True,4008088817,1001897751,6189053,3094526,3094527,3zqXX6kzhkbW3d4TwD2CNjMRwxTbREXySekvq37kfCNk,247592902,419673983,-172081081,617
2022-04-05 12:04:52-04:00,14507,BTwSuuDHNhQAFAzBZRWev5j1ix2RTWvjZAxLpw8grAxu,31NCyUpSXxxJYLSrdK3c5bLomUtMejobMfYnq7j71GtM,True,1692887646,423221911,2636500,1318250,1318250,3zqXX6kzhkbW3d4TwD2CNjMRwxTbREXySekvq37kfCNk,105460031,173424869,-67964838,622
2022-04-05 13:54:03-04:00,14508,niCk6QHFU1kyU56Mdq5RJzKrecdkNSn23ZA6wduFdWS,BQbUYSw1XsuE6LnVd4XjmxAyYgx4drE4FsetJBCdwVZW,True,2944647968,736036690,4482760,2241380,2241380,YQC4EUcgeBi9431viwvzvBbZJW3szeHX4dFmowRDyDw,179340985,370624350,-191283365,609
2022-04-05 14:37:07-04:00,14509,BTwSuuDHNhQAFAzBZRWev5j1ix2RTWvjZAxLpw8grAxu,31NCyUpSXxxJYLSrdK3c5bLomUtMejobMfYnq7j71GtM,True,1240707265,310176816,1842480,921240,921240,YQC4EUcgeBi9431viwvzvBbZJW3szeHX4dFmowRDyDw,73699212,153745176,-80045964,594
2022-04-05 16:40:22-04:00,14510,niCk6QHFU1kyU56Mdq5RJzKrecdkNSn23ZA6wduFdWS,BQbUYSw1XsuE6LnVd4XjmxAyYgx4drE4FsetJBCdwVZW,True,2169336649,542211100,3382119,1691059,1691060,3zqXX6kzhkbW3d4TwD2CNjMRwxTbREXySekvq37kfCNk,135315498,318425946,-183110448,623
2022-04-05 19:52:27-04:00,14511,BTwSuuDHNhQAFAzBZRWev5j1ix2RTWvjZAxLpw8grAxu,31NCyUpSXxxJYLSrdK3c5bLomUtMejobMfYnq7j71GtM,True,913090381,228272595,1358926,679463,679463,3zqXX6kzhkbW3d4TwD2CNjMRwxTbREXySekvq37kfCNk,54357049,131894914,-77537865,595
2022-04-05 19:52:29-04:00,14512,niCk6QHFU1kyU56Mdq5RJzKrecdkNSn23ZA6wduFdWS,BQbUYSw1XsuE6LnVd4XjmxAyYgx4drE4FsetJBCdwVZW,True,1736935701,434113255,2705903,1352951,1352952,3zqXX6kzhkbW3d4TwD2CNjMRwxTbREXySekvq37kfCNk,108266259,269354136,-161087877,623
2022-04-05 19:53:28-04:00,14513,GeYsENPRf2qGZu9rJsi6UPQqHS6sR7LRLWsKbFgtMCSb,7A79wktqPkSpP7o4c1kP9CBpUibHTqycW81ZANgREc5S,True,486866768,121716692,759989,379994,379995,3zqXX6kzhkbW3d4TwD2CNjMRwxTbREXySekvq37kfCNk,30399573,49462538,-19062965,624
2022-04-05 20:08:56-04:00,14514,3uUdWwgwtFdPa3FJTSrirqPKMtQb3zmT5Wpp4zPy9sJP,5G7dhz8jvWekGy9Wh3ZCXNXSPbB1QArfFYs7MYNgRDkW,True,813414180,203353545,1261705,630852,630853,YQC4EUcgeBi9431viwvzvBbZJW3szeHX4dFmowRDyDw,50468213,155524263,-105056050,620
2022-04-05 20:09:39-04:00,14515,5xpiEvfY9hpdUW1c85fQSTBPgVbcrjD5hkmUCYvSF2DR,AhJe4Y7uima7HC8eYfZs7xJZrWth12UczAa2fHyUjfbp,True,2334294570,583573642,3624102,1812051,1812051,3zqXX6kzhkbW3d4TwD2CNjMRwxTbREXySekvq37kfCNk,144964105,341894193,-196930088,621
2022-04-05 20:09:39-04:00,14516,6Auz7aARPERW9zbV8428yFUWkA9DuitQYiWQzewueU3o,G1xfLGt5twz7MTfEq6NnMZBpr6GmXceKdGUQkc9jugRB,True,95209289,23802322,145915,72957,72958,YQC4EUcgeBi9431viwvzvBbZJW3szeHX4dFmowRDyDw,5836608,16047774,-10211166,613
2022-04-05 20:09:46-04:00,14517,5zSoXxVZYYQAtq3urfcUQmJkjFDBXkUJYSNFdq759Tof,3C459gJnmj4EYTG3tDFJEEf1aAT915sxRLs2THEdQqha,True,9422746132,496338542,3079534,1539767,1539767,YQC4EUcgeBi9431viwvzvBbZJW3szeHX4dFmowRDyDw,584634657,1027483734,-442849077,620
2022-04-05 20:10:28-04:00,14518,8nFpzAFXELGPsrgFwRjTfUidNme1CvgKQTsHWATtMqkz,ABt8ikXHraZ1bqkDUvMtJ3AUzADDWcCL8kMMDpAoth8V,True,181568725,45392181,282822,141411,141411,3zqXX6kzhkbW3d4TwD2CNjMRwxTbREXySekvq37kfCNk,11312893,25798359,-14485466,623
2022-04-05 20:13:23-04:00,14519,29JVska5UEG3axs63EmtHpPvkswNEqYpZ3PKMSfupiAG,DCftNBUsuogxyaJe9G9m3eWipH6o3qo4Rn4TuQXdVaBF,True,66722041,16680510,104111,52055,52056,3zqXX6kzhkbW3d4TwD2CNjMRwxTbREXySekvq37kfCNk,4164468,9985337,-5820869,624
2022-04-05 20:13:38-04:00,14520,5zSoXxVZYYQAtq3urfcUQmJkjFDBXkUJYSNFdq759Tof,3C459gJnmj4EYTG3tDFJEEf1aAT915sxRLs2THEdQqha,True,8898585227,471852361,2936198,1468099,1468099,YQC4EUcgeBi9431viwvzvBbZJW3szeHX4dFmowRDyDw,553732760,1021778784,-468046024,622
2022-04-05 20:13:45-04:00,14521,EN2YBXcj7E1eAaYJYXJjc6Rfsu6Awjgv9kN3bT3uiprp,HYDG5mqfCy2xwrYKixNzoWyDiqb9KbpnA8H3TQG2EDDG,True,835185971,208796389,1303095,651547,651548,3zqXX6kzhkbW3d4TwD2CNjMRwxTbREXySekvq37kfCNk,52123865,120783463,-68659598,624
2022-04-05 20:13:54-04:00,14522,DVMLxFACqaNBD7q1TGJUUApJX7etJsxQRRFBP2DfBazJ,4hnRjD7S2KxD7UrgfrApntVxUD7Srh5E9nwPY53v89kz,True,830189069,88807829,585371,292685,292686,YQC4EUcgeBi9431viwvzvBbZJW3szeHX4dFmowRDyDw,54721464,124596944,-69875480,659
2022-04-05 20:14:19-04:00,14523,6eEifGxGRBnXV5EW2BwmCj8pa67znMjet98Nsq11LCsd,Dd4UCEX7tm6Q82SdSSFX9wBcJNw5TwKu8EyGjvxi9FVc,True,1414354073,353588518,2190596,1095298,1095298,3zqXX6kzhkbW3d4TwD2CNjMRwxTbREXySekvq37kfCNk,87623869,127484101,-39860232,619
2022-04-05 20:14:19-04:00,14524,5zSoXxVZYYQAtq3urfcUQmJkjFDBXkUJYSNFdq759Tof,3C459gJnmj4EYTG3tDFJEEf1aAT915sxRLs2THEdQqha,True,8392206209,464036628,2854650,1427325,1427325,3zqXX6kzhkbW3d4TwD2CNjMRwxTbREXySekvq37kfCNk,516269905,996151791,-479881886,615
2022-04-05 20:14:39-04:00,14525,2xgQaQTs7bkK34jSBZ2dFZf1DJKjMVW9LA3D9Pwtfims,6rniSBeGcJAcrqWhhnKCcRV58yYnjuqXj9b4Zu8DUwQ9,True,140846494,34666372,214133,107066,107067,3zqXX6kzhkbW3d4TwD2CNjMRwxTbREXySekvq37kfCNk,8700083,17453615,-8753532,617
2022-04-05 20:14:54-04:00,14526,eiLMepBYM3VcWarQJC9fTnxotyMuUTbyMGJECedPEfu,k2ZfwPNBBCK7PvZ6MEvELTHHtQZSXCRGCymvkZwhDDt,True,115384735,23349435,145271,72635,72636,YQC4EUcgeBi9431viwvzvBbZJW3szeHX4dFmowRDyDw,7178825,16967521,-9788696,622
2022-04-05 20:15:03-04:00,14527,7yW1M1xeVx4hy3QftnpqdBDRYwamfu3K5i6AEnxgyTWb,7wf7FWS2DYp5RveQAmGNXAEUWPcHziuMLd4hV5LPgxF8,True,56055027,14013756,84127,42063,42064,3zqXX6kzhkbW3d4TwD2CNjMRwxTbREXySekvq37kfCNk,3365117,7309971,-3944854,600
2022-04-05 20:15:08-04:00,14528,GeYsENPRf2qGZu9rJsi6UPQqHS6sR7LRLWsKbFgtMCSb,7A79wktqPkSpP7o4c1kP9CBpUibHTqycW81ZANgREc5S,True,357514968,89378742,549649,274824,274825,YQC4EUcgeBi9431viwvzvBbZJW3szeHX4dFmowRDyDw,21985988,43919984,-21933996,614
2022-04-05 20:15:12-04:00,14529,5zSoXxVZYYQAtq3urfcUQmJkjFDBXkUJYSNFdq759Tof,3C459gJnmj4EYTG3tDFJEEf1aAT915sxRLs2THEdQqha,True,7907708351,460044956,2867847,1433923,1433924,3zqXX6kzhkbW3d4TwD2CNjMRwxTbREXySekvq37kfCNk,492954025,960525436,-467571411,623
2022-04-05 20:15:15-04:00,14530,SEndYVMCKAeZUKSqGrMUSqXFmxtA9M1t4eXsUhVsTBF,3fcQQcbkpqodakamn82pFnMxBEPL2Drsg4jJNZ6dx72M,True,1646294572,191897311,1276453,638226,638227,3zqXX6kzhkbW3d4TwD2CNjMRwxTbREXySekvq37kfCNk,109507452,305519518,-196012066,665
2022-04-05 20:15:22-04:00,14531,67DwuUmzk6uGwmptjYErQssFeJ5fd1ztFwKWZUovr7pK,HKzc15e1QLBrSsbAENyMXSVHDoap1F5MHCHB9L1Dm8HA,True,690334271,172583567,1075088,537544,537544,YQC4EUcgeBi9431viwvzvBbZJW3szeHX4dFmowRDyDw,43003544,100440491,-57436947,622
2022-04-05 20:15:35-04:00,14532,CZ1snuuBhno2SqfAmMLzEEQhrsH2reAmZrGhFVsydvHD,F4Hj3jxxE8W8TbgpvjRLnrQ1Jdd28ZKTPNyu1h9BnLiH,True,1722740963,430685240,2653236,1326618,1326618,YQC4EUcgeBi9431viwvzvBbZJW3szeHX4dFmowRDyDw,106129465,281913127,-175783662,616
2022-04-05 20:15:49-04:00,14533,8nFpzAFXELGPsrgFwRjTfUidNme1CvgKQTsHWATtMqkz,ABt8ikXHraZ1bqkDUvMtJ3AUzADDWcCL8kMMDpAoth8V,True,133472990,33368247,208162,104081,104081,YQC4EUcgeBi9431viwvzvBbZJW3szeHX4dFmowRDyDw,8326517,21894412,-13567895,623
2022-04-05 20:19:03-04:00,14534,FU7X4DWnGTbxwXULBq3v9SACzYhQyFGqsXjUDzyFqiem,925BaEnWxTfEv4oQb9Xf1wyyEEWEr8kXeSdXTtRfShfw,True,92008413961,8238940768,51157848,25578924,25578924,YQC4EUcgeBi9431viwvzvBbZJW3szeHX4dFmowRDyDw,5713055464,7733586832,-2020531368,620
2022-04-05 20:19:24-04:00,14535,DVMLxFACqaNBD7q1TGJUUApJX7etJsxQRRFBP2DfBazJ,4hnRjD7S2KxD7UrgfrApntVxUD7Srh5E9nwPY53v89kz,True,735438438,66022966,432648,216324,216324,YQC4EUcgeBi9431viwvzvBbZJW3szeHX4dFmowRDyDw,48193291,112818593,-64625302,655
2022-04-05 20:19:58-04:00,14536,D85pWm1LS9MvtR4f3QhkFLvNUhZLQ2NZBFQTyAVnmigm,CRN85DYkJJi6irhtVAf4qcJU3ijVodWdXgWe7Fs6Ahka,True,1202201193,211785304,1323565,661782,661783,3zqXX6kzhkbW3d4TwD2CNjMRwxTbREXySekvq37kfCNk,75132345,166149341,-91016996,624
2022-04-05 20:20:07-04:00,14537,GRqv7y5n92vQ7bXcBqUng4vaau6w1tQeou953s8kJNwD,Bk75oioYmUzfdpbxDHTFb2nWhJgNqAt8ud1ehem3VVhh,True,6080613567,1520153391,9490723,4745361,4745362,3zqXX6kzhkbW3d4TwD2CNjMRwxTbREXySekvq37kfCNk,379628938,617710493,-238081555,624
2022-04-05 20:20:29-04:00,14538,3uUdWwgwtFdPa3FJTSrirqPKMtQb3zmT5Wpp4zPy9sJP,5G7dhz8jvWekGy9Wh3ZCXNXSPbB1QArfFYs7MYNgRDkW,True,598115728,149528932,931540,465770,465770,YQC4EUcgeBi9431viwvzvBbZJW3szeHX4dFmowRDyDw,37261601,128004523,-90742922,622
2022-04-05 20:20:38-04:00,14539,5zSoXxVZYYQAtq3urfcUQmJkjFDBXkUJYSNFdq759Tof,3C459gJnmj4EYTG3tDFJEEf1aAT915sxRLs2THEdQqha,True,7420288818,449608080,2803649,1401824,1401825,3zqXX6kzhkbW3d4TwD2CNjMRwxTbREXySekvq37kfCNk,462711601,919091146,-456379545,623
2022-04-05 20:21:06-04:00,14540,EBRWnRzoNv5RytEjgrs5TXdiCMApLKHMntJJJzehJJns,5nJiYTa3GEbmaRwY1PvBJ1teXikQKgbUop5ANgaDhhcP,True,105661070,26415267,163284,81642,81642,47z82br5WdW2DZajdnPDPSSRRKsyAggqXqK6oPUwTaLf,6531370,10868839,-4337469,618
2022-04-05 20:21:09-04:00,14541,29JVska5UEG3axs63EmtHpPvkswNEqYpZ3PKMSfupiAG,DCftNBUsuogxyaJe9G9m3eWipH6o3qo4Rn4TuQXdVaBF,True,49017566,12254391,75909,37954,37955,YQC4EUcgeBi9431viwvzvBbZJW3szeHX4dFmowRDyDw,3036392,8426042,-5389650,619
2022-04-05 20:21:11-04:00,14542,FU7X4DWnGTbxwXULBq3v9SACzYhQyFGqsXjUDzyFqiem,925BaEnWxTfEv4oQb9Xf1wyyEEWEr8kXeSdXTtRfShfw,True,83278965726,6275665780,38970123,19485061,19485062,3zqXX6kzhkbW3d4TwD2CNjMRwxTbREXySekvq37kfCNk,5171390149,7488727793,-2317337644,620
2022-04-05 20:21:21-04:00,14543,6Auz7aARPERW9zbV8428yFUWkA9DuitQYiWQzewueU3o,G1xfLGt5twz7MTfEq6NnMZBpr6GmXceKdGUQkc9jugRB,True,70047288,17511822,108275,54137,54138,YQC4EUcgeBi9431viwvzvBbZJW3szeHX4dFmowRDyDw,4331014,13349149,-9018135,618
2022-04-05 20:21:23-04:00,14544,HooxSzasW3HMoFJ6sAvRQ75Char1J5aBdJtsqfDV6myp,BCmsWwpGeV4NNfeKZKKydty2uueLGHYTJDk1WErpXsVT,True,3540241722,885060430,5512948,2756474,2756474,3zqXX6kzhkbW3d4TwD2CNjMRwxTbREXySekvq37kfCNk,220517952,483867271,-263349319,622
2022-04-05 20:21:25-04:00,14545,DVMLxFACqaNBD7q1TGJUUApJX7etJsxQRRFBP2DfBazJ,4hnRjD7S2KxD7UrgfrApntVxUD7Srh5E9nwPY53v89kz,True,663987036,71165220,453710,226855,226855,3zqXX6kzhkbW3d4TwD2CNjMRwxTbREXySekvq37kfCNk,42332207,103402235,-61070028,637
2022-04-05 20:21:31-04:00,14546,8K1GzGeaAuFdjuVZi6DqBcYiA1zSRioMkRvjotr8p7fz,5mqocPwTdjwAPiJf7vx9bo7AzvfQBT2t5bV9u2Jzb2e1,True,2974516188,743629047,4696842,2348421,2348421,3zqXX6kzhkbW3d4TwD2CNjMRwxTbREXySekvq37kfCNk,187873698,306552422,-118678724,631
2022-04-05 20:21:43-04:00,14547,5xpiEvfY9hpdUW1c85fQSTBPgVbcrjD5hkmUCYvSF2DR,AhJe4Y7uima7HC8eYfZs7xJZrWth12UczAa2fHyUjfbp,True,1716665122,429166280,2682104,1341052,1341052,YQC4EUcgeBi9431viwvzvBbZJW3szeHX4dFmowRDyDw,107284197,289084898,-181800701,624
2022-04-05 20:21:51-04:00,14548,5zSoXxVZYYQAtq3urfcUQmJkjFDBXkUJYSNFdq759Tof,3C459gJnmj4EYTG3tDFJEEf1aAT915sxRLs2THEdQqha,True,6941726577,365753011,2270654,1135327,1135327,YQC4EUcgeBi9431viwvzvBbZJW3szeHX4dFmowRDyDw,430953791,888746341,-457792550,620
2022-04-05 20:21:54-04:00,14549,DXGapgtgkag6midSCYNhHCNaCqvhUmuSvnVhXxNXBmyt,Csq6W5QkGZL6qE6Z1ERF3bfHtKjnM8hAxiY1YA3rTwSX,True,2063674389,515918597,3222328,1611164,1611164,YQC4EUcgeBi9431viwvzvBbZJW3szeHX4dFmowRDyDw,128893139,214340767,-85447628,624
2022-04-05 20:23:33-04:00,14550,6eEifGxGRBnXV5EW2BwmCj8pa67znMjet98Nsq11LCsd,Dd4UCEX7tm6Q82SdSSFX9wBcJNw5TwKu8EyGjvxi9FVc,True,1039757992,259939498,1610642,805321,805321,3zqXX6kzhkbW3d4TwD2CNjMRwxTbREXySekvq37kfCNk,64425710,115342447,-50916737,619
2022-04-05 20:23:33-04:00,14551,D85pWm1LS9MvtR4f3QhkFLvNUhZLQ2NZBFQTyAVnmigm,CRN85DYkJJi6irhtVAf4qcJU3ijVodWdXgWe7Fs6Ahka,True,977528037,156394352,974671,487335,487336,3zqXX6kzhkbW3d4TwD2CNjMRwxTbREXySekvq37kfCNk,60920928,147839960,-86919032,623
2022-04-05 20:23:34-04:00,14552,J5q3HYmNhEHPz4DzVGHnSwBAwTqTn8jPwkjCaoQRs9t1,FbgqAegQKWQ8jVVVcJV6okGHgP1fhL2uoJpzfX3mYoH6,True,405833686,101458421,630303,315151,315152,3zqXX6kzhkbW3d4TwD2CNjMRwxTbREXySekvq37kfCNk,25212153,52391335,-27179182,621
2022-04-05 20:23:34-04:00,14553,eiLMepBYM3VcWarQJC9fTnxotyMuUTbyMGJECedPEfu,k2ZfwPNBBCK7PvZ6MEvELTHHtQZSXCRGCymvkZwhDDt,True,90655377,17238194,107503,53751,53752,YQC4EUcgeBi9431viwvzvBbZJW3szeHX4dFmowRDyDw,5653631,14522895,-8869264,623
2022-04-05 20:26:15-04:00,14554,BFWNfNhm4RUFJs3721We8Dyocw1okinoUA3JtHshAHkU,7czPpWxLYgLgAGmvxiKA6zRGQ97FdLVB83FvNqEuKnFj,True,9588085643,2397021410,14937381,7468690,7468691,3zqXX6kzhkbW3d4TwD2CNjMRwxTbREXySekvq37kfCNk,597495276,1365714257,-768218981,623
2022-04-05 21:12:37-04:00,14555,7JbCUyTgV4oLjFST9UUvtJkKpK6F99Pwb1Xe6JT8v7s4,9uYeL9R23XRstddnVE6kohfwCkR41E1GXtyduzc9TwEX,True,32822248102,8205560235,51229860,25614930,25614930,3zqXX6kzhkbW3d4TwD2CNjMRwxTbREXySekvq37kfCNk,2049194911,3367243482,-1318048571,624
2022-04-05 21:43:14-04:00,14556,AUEU926CvNMZ4cVLmnkif7auWEHjoLTGdJ7RTYnSTWtk,HCgu9BWTQYkQx1xb4de9T3BtCLsHhynSzzbcoJmreBxD,True,192478681,48119670,337558,168779,168779,YQC4EUcgeBi9431viwvzvBbZJW3szeHX4dFmowRDyDw,13502336,19669565,-6167229,701
2022-04-05 21:54:05-04:00,14557,8K1GzGeaAuFdjuVZi6DqBcYiA1zSRioMkRvjotr8p7fz,5mqocPwTdjwAPiJf7vx9bo7AzvfQBT2t5bV9u2Jzb2e1,True,1607169402,401792350,2748848,1374424,1374424,YQC4EUcgeBi9431viwvzvBbZJW3szeHX4dFmowRDyDw,109953944,180344974,-70391030,684
2022-04-06 04:12:31-04:00,14558,niCk6QHFU1kyU56Mdq5RJzKrecdkNSn23ZA6wduFdWS,BQbUYSw1XsuE6LnVd4XjmxAyYgx4drE4FsetJBCdwVZW,True,2073641967,518291637,3198353,1599176,1599177,3zqXX6kzhkbW3d4TwD2CNjMRwxTbREXySekvq37kfCNk,127963483,225488655,-97525172,617
2022-04-06 06:05:04-04:00,14559,AUEU926CvNMZ4cVLmnkif7auWEHjoLTGdJ7RTYnSTWtk,HCgu9BWTQYkQx1xb4de9T3BtCLsHhynSzzbcoJmreBxD,True,141084207,35271051,247241,123620,123621,3zqXX6kzhkbW3d4TwD2CNjMRwxTbREXySekvq37kfCNk,9889656,17793272,-7903616,700
2022-04-06 06:12:52-04:00,14560,8K1GzGeaAuFdjuVZi6DqBcYiA1zSRioMkRvjotr8p7fz,5mqocPwTdjwAPiJf7vx9bo7AzvfQBT2t5bV9u2Jzb2e1,True,1182545198,295636299,2109263,1054631,1054632,3zqXX6kzhkbW3d4TwD2CNjMRwxTbREXySekvq37kfCNk,84370559,160235620,-75865061,713
2022-04-06 06:18:28-04:00,14561,5UDGqNpkcMDjByBNi7WYMg8VJ81EzNJu48zsXbW9irSd,FmtUoQNiG25v8sn4pveM6wAWvja9u6FvZ2gdxWHSRjur,True,3751036835,937759208,6393325,3196662,3196663,YQC4EUcgeBi9431viwvzvBbZJW3szeHX4dFmowRDyDw,255733015,643810910,-388077895,681
2022-04-06 06:19:27-04:00,14562,2xgQaQTs7bkK34jSBZ2dFZf1DJKjMVW9LA3D9Pwtfims,6rniSBeGcJAcrqWhhnKCcRV58yYnjuqXj9b4Zu8DUwQ9,True,104125936,25486184,157036,78518,78518,3zqXX6kzhkbW3d4TwD2CNjMRwxTbREXySekvq37kfCNk,6415850,15025075,-8609225,616
2022-04-06 06:59:32-04:00,14563,niCk6QHFU1kyU56Mdq5RJzKrecdkNSn23ZA6wduFdWS,BQbUYSw1XsuE6LnVd4XjmxAyYgx4drE4FsetJBCdwVZW,True,1525871048,381351209,2381279,1190639,1190640,YQC4EUcgeBi9431viwvzvBbZJW3szeHX4dFmowRDyDw,95280313,198088067,-102807754,624
2022-04-06 07:01:40-04:00,14564,7yW1M1xeVx4hy3QftnpqdBDRYwamfu3K5i6AEnxgyTWb,7wf7FWS2DYp5RveQAmGNXAEUWPcHziuMLd4hV5LPgxF8,True,41350148,10337537,64567,32283,32284,A9TwRM1BMxqb8DCC7YNAMV6zPenEJm3HTZBy7wJKK58U,2582685,6232472,-3649787,624
2022-04-06 07:02:55-04:00,14565,5zSoXxVZYYQAtq3urfcUQmJkjFDBXkUJYSNFdq759Tof,3C459gJnmj4EYTG3tDFJEEf1aAT915sxRLs2THEdQqha,True,6557327614,346516151,2165037,1082518,1082519,3zqXX6kzhkbW3d4TwD2CNjMRwxTbREXySekvq37kfCNk,409702681,877660980,-467958299,624
2022-04-06 07:03:00-04:00,14566,GeYsENPRf2qGZu9rJsi6UPQqHS6sR7LRLWsKbFgtMCSb,7A79wktqPkSpP7o4c1kP9CBpUibHTqycW81ZANgREc5S,True,263112749,65778187,409175,204587,204588,3zqXX6kzhkbW3d4TwD2CNjMRwxTbREXySekvq37kfCNk,16367016,37841917,-21474901,622
2022-04-06 07:03:24-04:00,14567,67DwuUmzk6uGwmptjYErQssFeJ5fd1ztFwKWZUovr7pK,HKzc15e1QLBrSsbAENyMXSVHDoap1F5MHCHB9L1Dm8HA,True,507589777,126897444,791972,395986,395986,3zqXX6kzhkbW3d4TwD2CNjMRwxTbREXySekvq37kfCNk,31678896,84921061,-53242165,624
2022-04-06 07:03:59-04:00,14568,5zSoXxVZYYQAtq3urfcUQmJkjFDBXkUJYSNFdq759Tof,3C459gJnmj4EYTG3tDFJEEf1aAT915sxRLs2THEdQqha,True,6189906194,342591555,2139886,1069943,1069943,YQC4EUcgeBi9431viwvzvBbZJW3szeHX4dFmowRDyDw,386632375,849342838,-462710463,624
2022-04-06 07:04:30-04:00,14569,AyFWvQUX79sq8L7KhcYrPRbxd6whUvEMETZL8atuuRr2,9LTjofdhGLn2Ltv6XfuHtX8MKEPzScGL669pC8Lrgtnh,True,60824390,15206097,94552,47276,47276,YQC4EUcgeBi9431viwvzvBbZJW3szeHX4dFmowRDyDw,3782108,8516317,-4734209,621
2022-04-06 07:07:20-04:00,14570,8nFpzAFXELGPsrgFwRjTfUidNme1CvgKQTsHWATtMqkz,ABt8ikXHraZ1bqkDUvMtJ3AUzADDWcCL8kMMDpAoth8V,True,98055678,24513919,151303,75651,75652,A9TwRM1BMxqb8DCC7YNAMV6zPenEJm3HTZBy7wJKK58U,6052126,18277247,-12225121,617
2022-04-06 07:08:08-04:00,14571,A5NXadGWnFZRoHEn1dKTRjcXgWmfMLMyJdpF4rQPZyRR,ALs3Zfotc4c4A6TFDMbd5GM5whK1dTYSnGrHiMBWmApH,True,5586302918,1396575110,8579058,4289529,4289529,3zqXX6kzhkbW3d4TwD2CNjMRwxTbREXySekvq37kfCNk,343162481,1255573240,-912410759,614
2022-04-06 07:08:58-04:00,14572,BAkPsWHtpVcEGqUgKTKjwZ6d5aaUcaUhdgYxBnpSTDW2,BDwDmVaZnXh22sf8nsDtjVfgxMAswbM3PW3si3k4nbRK,True,677292338,169323084,1057502,528751,528751,YQC4EUcgeBi9431viwvzvBbZJW3szeHX4dFmowRDyDw,42300119,118968417,-76668298,624
2022-04-06 07:09:02-04:00,14573,FV9CBGGTbppLnBKh79f2LzD1diTiS5g6u89FcpZHZmnK,Fe7mtmCUziFqbbYTvrhAcAq1Ub7YLfTJRtQ1hG7GzJD1,True,68274852,17068713,106677,53338,53339,YQC4EUcgeBi9431viwvzvBbZJW3szeHX4dFmowRDyDw,4267084,7032214,-2765130,624
2022-04-06 07:10:04-04:00,14574,niCk6QHFU1kyU56Mdq5RJzKrecdkNSn23ZA6wduFdWS,BQbUYSw1XsuE6LnVd4XjmxAyYgx4drE4FsetJBCdwVZW,True,1115532549,278767864,1595398,797699,797699,3zqXX6kzhkbW3d4TwD2CNjMRwxTbREXySekvq37kfCNk,63842353,170049303,-106206950,572
2022-04-06 07:10:05-04:00,14575,GNohZMtk1VAuhLAgNGT8J3HYCKDCiyjvLeAWr64d7Duy,6soTLVj9DzFht8DzvjRfNPAWhZuiDBS5fDE1fpeuDSSz,True,2541850449,519502475,3136041,1568020,1568021,3zqXX6kzhkbW3d4TwD2CNjMRwxTbREXySekvq37kfCNk,153441967,355557627,-202115660,603
2022-04-06 07:10:08-04:00,14576,BTwSuuDHNhQAFAzBZRWev5j1ix2RTWvjZAxLpw8grAxu,31NCyUpSXxxJYLSrdK3c5bLomUtMejobMfYnq7j71GtM,True,673666807,168416701,1041098,520549,520549,YQC4EUcgeBi9431viwvzvBbZJW3szeHX4dFmowRDyDw,41643924,110983591,-69339667,618
2022-04-06 07:11:27-04:00,14577,5zSoXxVZYYQAtq3urfcUQmJkjFDBXkUJYSNFdq759Tof,3C459gJnmj4EYTG3tDFJEEf1aAT915sxRLs2THEdQqha,True,5826900621,337162257,2106668,1053334,1053334,3zqXX6kzhkbW3d4TwD2CNjMRwxTbREXySekvq37kfCNk,364078471,818875821,-454797350,624
2022-04-06 07:12:27-04:00,14578,JABfWoDV2wW68XEDANXArYWM7zabdbp5NBVrvzZd3mML,5hYUtd1Uv2pAcrbtSNNVTrRuk8acjmh92mzSm4iz5HJA,True,231759611,39022538,243230,121615,121615,3zqXX6kzhkbW3d4TwD2CNjMRwxTbREXySekvq37kfCNk,14445793,28823709,-14377916,623
2022-04-06 07:13:51-04:00,14579,EBRWnRzoNv5RytEjgrs5TXdiCMApLKHMntJJJzehJJns,5nJiYTa3GEbmaRwY1PvBJ1teXikQKgbUop5ANgaDhhcP,True,77744160,19436040,121319,60659,60660,A9TwRM1BMxqb8DCC7YNAMV6zPenEJm3HTZBy7wJKK58U,4852790,9607615,-4754825,624
2022-04-06 07:13:53-04:00,14580,3uUdWwgwtFdPa3FJTSrirqPKMtQb3zmT5Wpp4zPy9sJP,5G7dhz8jvWekGy9Wh3ZCXNXSPbB1QArfFYs7MYNgRDkW,True,439684693,109921173,684537,342268,342269,YQC4EUcgeBi9431viwvzvBbZJW3szeHX4dFmowRDyDw,27381481,104344105,-76962624,622
2022-04-06 07:14:04-04:00,14581,FU7X4DWnGTbxwXULBq3v9SACzYhQyFGqsXjUDzyFqiem,925BaEnWxTfEv4oQb9Xf1wyyEEWEr8kXeSdXTtRfShfw,True,76644819157,6139623949,38249676,19124838,19124838,3zqXX6kzhkbW3d4TwD2CNjMRwxTbREXySekvq37kfCNk,4774949746,7452024210,-2677074464,622
2022-04-06 07:14:05-04:00,14582,29JVska5UEG3axs63EmtHpPvkswNEqYpZ3PKMSfupiAG,DCftNBUsuogxyaJe9G9m3eWipH6o3qo4Rn4TuQXdVaBF,True,36020177,9005044,55278,27639,27639,YQC4EUcgeBi9431viwvzvBbZJW3szeHX4dFmowRDyDw,2211150,6996405,-4785255,613
2022-04-06 07:14:07-04:00,14583,4GbUrgiR6A91h3J9HHpuYCkZzjwrb62n3BURLeWj6Nic,12nUFUGYF1rXbwPeCbdGKdP3RE4g984fmZZggEYSFTZn,True,283122053,70780513,438290,219145,219145,3zqXX6kzhkbW3d4TwD2CNjMRwxTbREXySekvq37kfCNk,17531610,53549064,-36017454,619
2022-04-06 07:14:57-04:00,14584,DVMLxFACqaNBD7q1TGJUUApJX7etJsxQRRFBP2DfBazJ,4hnRjD7S2KxD7UrgfrApntVxUD7Srh5E9nwPY53v89kz,True,589470502,49034552,320119,160059,160060,3zqXX6kzhkbW3d4TwD2CNjMRwxTbREXySekvq37kfCNk,38483353,99070757,-60587404,652
2022-04-06 07:15:02-04:00,14585,8qq2gfbca7JXvq4gViBBVT2QAbM4MvBMEQLXgn8UUTvt,3o5jpBVYdFFEYrGRdCUkLrUC85wsuTKgy8iYwnpZyC1B,True,2065907376,176604843,1102989,551494,551495,YQC4EUcgeBi9431viwvzvBbZJW3szeHX4dFmowRDyDw,129026728,774268808,-645242080,624
2022-04-06 07:15:13-04:00,14586,6Auz7aARPERW9zbV8428yFUWkA9DuitQYiWQzewueU3o,G1xfLGt5twz7MTfEq6NnMZBpr6GmXceKdGUQkc9jugRB,True,51524744,12881186,80164,40082,40082,YQC4EUcgeBi9431viwvzvBbZJW3szeHX4dFmowRDyDw,3206564,10980933,-7774369,622
2022-04-06 07:15:18-04:00,14587,8K1GzGeaAuFdjuVZi6DqBcYiA1zSRioMkRvjotr8p7fz,5mqocPwTdjwAPiJf7vx9bo7AzvfQBT2t5bV9u2Jzb2e1,True,866505023,216626255,1546393,773196,773197,3zqXX6kzhkbW3d4TwD2CNjMRwxTbREXySekvq37kfCNk,61855757,139292153,-77436396,713
2022-04-06 07:26:44-04:00,14588,Gw37fsD8M3AaZ22tSx9WeszxsAkWQ6Ap2XV3zXYhe3EJ,FbKeJsWR5ggVBy1R5sxNiWz5GAsxeyZD8nmyk5yCBqSz,True,88674674,22168668,156239,78119,78120,YQC4EUcgeBi9431viwvzvBbZJW3szeHX4dFmowRDyDw,6249597,27143140,-20893543,704
2022-04-06 07:28:02-04:00,14589,D85pWm1LS9MvtR4f3QhkFLvNUhZLQ2NZBFQTyAVnmigm,CRN85DYkJJi6irhtVAf4qcJU3ijVodWdXgWe7Fs6Ahka,True,811888797,116357167,725596,362798,362798,3zqXX6kzhkbW3d4TwD2CNjMRwxTbREXySekvq37kfCNk,50628907,131601564,-80972657,623
2022-04-06 07:28:16-04:00,14590,DXGapgtgkag6midSCYNhHCNaCqvhUmuSvnVhXxNXBmyt,Csq6W5QkGZL6qE6Z1ERF3bfHtKjnM8hAxiY1YA3rTwSX,True,1516517133,379129283,2356784,1178392,1178392,YQC4EUcgeBi9431viwvzvBbZJW3szeHX4dFmowRDyDw,94271388,189631647,-95360259,621
2022-04-06 07:28:22-04:00,14591,5zSoXxVZYYQAtq3urfcUQmJkjFDBXkUJYSNFdq759Tof,3C459gJnmj4EYTG3tDFJEEf1aAT915sxRLs2THEdQqha,True,5467752315,334912503,2082491,1041245,1041246,3zqXX6kzhkbW3d4TwD2CNjMRwxTbREXySekvq37kfCNk,339985754,779959731,-439973977,621
2022-04-06 07:28:27-04:00,14592,J5q3HYmNhEHPz4DzVGHnSwBAwTqTn8jPwkjCaoQRs9t1,FbgqAegQKWQ8jVVVcJV6okGHgP1fhL2uoJpzfX3mYoH6,True,298467440,74616860,465531,232765,232766,A9TwRM1BMxqb8DCC7YNAMV6zPenEJm3HTZBy7wJKK58U,18621251,44914671,-26293420,623
2022-04-06 07:28:28-04:00,14593,FoGtu9wcVbBmATBKtBMWvbRd558yzSDT5dPBTBJgzqFT,9rnvQvgQtkT7RSdDpZHnkTVd2V9CMRBSB7v79GDip4hS,True,812930208,203232552,1243027,621513,621514,YQC4EUcgeBi9431viwvzvBbZJW3szeHX4dFmowRDyDw,49721098,83862803,-34141705,611
2022-04-06 07:28:54-04:00,14594,eiLMepBYM3VcWarQJC9fTnxotyMuUTbyMGJECedPEfu,k2ZfwPNBBCK7PvZ6MEvELTHHtQZSXCRGCymvkZwhDDt,True,72400754,12675222,79156,39578,39578,YQC4EUcgeBi9431viwvzvBbZJW3szeHX4dFmowRDyDw,4521471,12408736,-7887265,624
2022-04-06 07:29:18-04:00,14595,AX2VRZoWZDfZT4QdwuXUSyRCx4N6B9eHAR75FSmcrVFG,FBgLGmbouri9wCV92UXZaDjwK6fcpjhDDD5NLVWmuRRK,True,3908539676,977134919,6077721,3038860,3038861,3zqXX6kzhkbW3d4TwD2CNjMRwxTbREXySekvq37kfCNk,243108861,573131998,-330023137,621
2022-04-06 07:29:20-04:00,14596,2xgQaQTs7bkK34jSBZ2dFZf1DJKjMVW9LA3D9Pwtfims,6rniSBeGcJAcrqWhhnKCcRV58yYnjuqXj9b4Zu8DUwQ9,True,77114213,18738546,114983,57491,57492,YQC4EUcgeBi9431viwvzvBbZJW3szeHX4dFmowRDyDw,4731919,12704155,-7972236,613
2022-04-06 07:29:36-04:00,14597,FU7X4DWnGTbxwXULBq3v9SACzYhQyFGqsXjUDzyFqiem,925BaEnWxTfEv4oQb9Xf1wyyEEWEr8kXeSdXTtRfShfw,True,70151924216,5057922611,31604328,15802164,15802164,YQC4EUcgeBi9431viwvzvBbZJW3szeHX4dFmowRDyDw,4383429078,7217507327,-2834078249,624
2022-04-06 09:01:34-04:00,14598,F2AU2PjaSmHxWWhkz8XxMggkCMWbMVgawt89tSnYS6RL,ET9febRJiW197DYMaJbgk3kWsAeFv5f4peQ4vFCVppK6,True,39108593,9777148,69426,34713,34713,YQC4EUcgeBi9431viwvzvBbZJW3szeHX4dFmowRDyDw,2777075,13162990,-10385915,710
2022-04-06 09:01:35-04:00,14599,SEndYVMCKAeZUKSqGrMUSqXFmxtA9M1t4eXsUhVsTBF,3fcQQcbkpqodakamn82pFnMxBEPL2Drsg4jJNZ6dx72M,True,1434549150,181714482,1198650,599325,599325,YQC4EUcgeBi9431viwvzvBbZJW3szeHX4dFmowRDyDw,94627720,258654162,-164026442,659
2022-04-06 09:03:28-04:00,14600,4rLtMQSN7dkQMAB1RiQwtQepNcvrpsGgshMmzpDNa5ta,ESnuS85iexRfPoCGQSHKxMB28FoDNc4sPwnWSC9RvKKs,False,11038706,11038706,784442,39222,745220,YQC4EUcgeBi9431viwvzvBbZJW3szeHX4dFmowRDyDw,784442,2399115,-1614673,710
2022-04-06 09:17:40-04:00,14601,EHLV9s6E1s5SUbzZVzsGWH2vVRGHyxynM4GDJtfKEuYe,4hAx9osegpeocSSmJbMVBYMKCwo5WY3QVJuK7cuzz4b4,True,57646707,14411676,102887,51443,51444,YQC4EUcgeBi9431viwvzvBbZJW3szeHX4dFmowRDyDw,4115499,19323095,-15207596,713
2022-04-06 09:17:40-04:00,14602,GCweck6iuscBsVbXW9ZYfMytdgwSYWwNifTWLaUbaSmA,6HwGWKGduMGvLnHmTJo6ZioZ3EMUZYHo2pG4tBFXgB4Y,True,57574862,14393715,101470,50735,50735,3zqXX6kzhkbW3d4TwD2CNjMRwxTbREXySekvq37kfCNk,4058811,19338040,-15279229,704
2022-04-06 09:36:40-04:00,14603,niCk6QHFU1kyU56Mdq5RJzKrecdkNSn23ZA6wduFdWS,BQbUYSw1XsuE6LnVd4XjmxAyYgx4drE4FsetJBCdwVZW,True,1257015537,314138284,1951376,975688,975688,YQC4EUcgeBi9431viwvzvBbZJW3szeHX4dFmowRDyDw,78083805,141452500,-63368695,621
2022-04-06 09:38:41-04:00,14604,5qY8ZrqpHPqkAuXp6HpE2zC8qTfzsP8MXWSoxkZQV5jx,GPs3ap45TuHwHwmDb5bnKYHLBa5wj3AyuEsXcfHjEcAL,True,26047648,6511912,46268,23134,23134,YQC4EUcgeBi9431viwvzvBbZJW3szeHX4dFmowRDyDw,1850724,7238825,-5388101,710
2022-04-06 09:41:55-04:00,14605,5UDGqNpkcMDjByBNi7WYMg8VJ81EzNJu48zsXbW9irSd,FmtUoQNiG25v8sn4pveM6wAWvja9u6FvZ2gdxWHSRjur,True,2757918994,689479748,4849188,2424594,2424594,YQC4EUcgeBi9431viwvzvBbZJW3szeHX4dFmowRDyDw,193967537,541786214,-347818677,703
2022-04-06 09:42:44-04:00,14606,FFDTcCW6UXKpkMnCefTRLpF8ZkJtS4sbGTjkcNU31Pxh,9v5oBZNrx4EATT8iHT5wNRJSo2rRPpazAYvPeaNe2Tpc,True,1050396593,149336913,1065197,532598,532599,YQC4EUcgeBi9431viwvzvBbZJW3szeHX4dFmowRDyDw,74923204,172335370,-97412166,713
2022-04-06 09:42:52-04:00,14607,DVMLxFACqaNBD7q1TGJUUApJX7etJsxQRRFBP2DfBazJ,4hnRjD7S2KxD7UrgfrApntVxUD7Srh5E9nwPY53v89kz,True,537113038,53495512,346799,173399,173400,YQC4EUcgeBi9431viwvzvBbZJW3szeHX4dFmowRDyDw,34819863,91506323,-56686460,648
2022-04-06 09:42:56-04:00,14608,JABfWoDV2wW68XEDANXArYWM7zabdbp5NBVrvzZd3mML,5hYUtd1Uv2pAcrbtSNNVTrRuk8acjmh92mzSm4iz5HJA,True,190290574,28797683,177553,88776,88777,3zqXX6kzhkbW3d4TwD2CNjMRwxTbREXySekvq37kfCNk,11732474,26591356,-14858882,616
2022-04-06 09:42:56-04:00,14609,D8BtQirMEk3W9Pq29B6KkKWrwPfmsUNpwz5npx7aGMLY,J7LMZwaSoh5hbGcwee6oPsnN4ZFD7Zp3LQWkJGNUHRfJ,True,4085625583,663024662,4340547,2170273,2170274,3zqXX6kzhkbW3d4TwD2CNjMRwxTbREXySekvq37kfCNk,267468981,554190713,-286721732,654
2022-04-06 09:43:12-04:00,14610,BEATjyYuro1xc1kbgBoxBnVEk3usoUk9qwmdRndXdYW5,9RGBffhSMgab1KCM6dMvwiBENbnp5pERfCEjw4q5ckFS,True,215787809,53946952,371997,185998,185999,3zqXX6kzhkbW3d4TwD2CNjMRwxTbREXySekvq37kfCNk,14879882,49597800,-34717918,689
2022-04-06 09:43:17-04:00,14611,Gw37fsD8M3AaZ22tSx9WeszxsAkWQ6Ap2XV3zXYhe3EJ,FbKeJsWR5ggVBy1R5sxNiWz5GAsxeyZD8nmyk5yCBqSz,True,64819508,16204877,110102,55051,55051,YQC4EUcgeBi9431viwvzvBbZJW3szeHX4dFmowRDyDw,4404112,21761721,-17357609,679
2022-04-06 09:44:29-04:00,14612,8qq2gfbca7JXvq4gViBBVT2QAbM4MvBMEQLXgn8UUTvt,3o5jpBVYdFFEYrGRdCUkLrUC85wsuTKgy8iYwnpZyC1B,True,1873315456,169374509,1058129,529064,529065,3zqXX6kzhkbW3d4TwD2CNjMRwxTbREXySekvq37kfCNk,117031247,699658344,-582627097,624
2022-04-06 09:48:20-04:00,14613,SEndYVMCKAeZUKSqGrMUSqXFmxtA9M1t4eXsUhVsTBF,3fcQQcbkpqodakamn82pFnMxBEPL2Drsg4jJNZ6dx72M,True,1236746578,138065578,917450,458725,458725,3zqXX6kzhkbW3d4TwD2CNjMRwxTbREXySekvq37kfCNk,82182270,255082945,-172900675,664
2022-04-06 09:48:23-04:00,14614,Br1j5Ftafei7ysu5SmqVZSoRe4uS4qCPeKSPHg55pyiE,G8fc7QvXjfkgBFvAVUgJFQS3VaF1biL9rktBExGa87Ks,True,2732489984,548962204,3429101,1714550,1714551,3zqXX6kzhkbW3d4TwD2CNjMRwxTbREXySekvq37kfCNk,170685459,163614759,7070700,624
2022-04-06 09:48:51-04:00,14615,DVMLxFACqaNBD7q1TGJUUApJX7etJsxQRRFBP2DfBazJ,4hnRjD7S2KxD7UrgfrApntVxUD7Srh5E9nwPY53v89kz,True,480234422,44493749,288048,144024,144024,3zqXX6kzhkbW3d4TwD2CNjMRwxTbREXySekvq37kfCNk,31089960,88404565,-57314605,647
2022-04-06 09:48:53-04:00,14616,5zSoXxVZYYQAtq3urfcUQmJkjFDBXkUJYSNFdq759Tof,3C459gJnmj4EYTG3tDFJEEf1aAT915sxRLs2THEdQqha,True,5114152907,266277129,1660774,830387,830387,3zqXX6kzhkbW3d4TwD2CNjMRwxTbREXySekvq37kfCNk,318970409,754637497,-435667088,623
2022-04-06 09:49:03-04:00,14617,5FewDaMC9U7n5EHcto98GaAmDVxDh5SYimuTP6AtfakM,7DAULUoqV7f9hsBzKEhjQPnWaHSqiMWcBqWcdcadaQv4,True,2562693181,322445556,2014923,1007461,1007462,YQC4EUcgeBi9431viwvzvBbZJW3szeHX4dFmowRDyDw,160139677,261514644,-101374967,624
2022-04-06 09:49:22-04:00,14618,7yW1M1xeVx4hy3QftnpqdBDRYwamfu3K5i6AEnxgyTWb,7wf7FWS2DYp5RveQAmGNXAEUWPcHziuMLd4hV5LPgxF8,True,30259458,7564864,44092,22046,22046,3zqXX6kzhkbW3d4TwD2CNjMRwxTbREXySekvq37kfCNk,1763706,5254213,-3490507,582
2022-04-06 09:49:27-04:00,14619,6eEifGxGRBnXV5EW2BwmCj8pa67znMjet98Nsq11LCsd,Dd4UCEX7tm6Q82SdSSFX9wBcJNw5TwKu8EyGjvxi9FVc,True,1202910659,300727664,1781286,890643,890643,3zqXX6kzhkbW3d4TwD2CNjMRwxTbREXySekvq37kfCNk,71251464,153343180,-82091716,592
2022-04-06 09:49:29-04:00,14620,FU7X4DWnGTbxwXULBq3v9SACzYhQyFGqsXjUDzyFqiem,925BaEnWxTfEv4oQb9Xf1wyyEEWEr8kXeSdXTtRfShfw,True,64689918227,4700421807,28658804,14329402,14329402,3zqXX6kzhkbW3d4TwD2CNjMRwxTbREXySekvq37kfCNk,3944190116,6784381985,-2840191869,609
2022-04-06 09:49:30-04:00,14621,D85pWm1LS9MvtR4f3QhkFLvNUhZLQ2NZBFQTyAVnmigm,CRN85DYkJJi6irhtVAf4qcJU3ijVodWdXgWe7Fs6Ahka,True,687852136,86266556,529168,264584,264584,3zqXX6kzhkbW3d4TwD2CNjMRwxTbREXySekvq37kfCNk,42193640,118509704,-76316064,613
2022-04-06 09:49:30-04:00,14622,8K1GzGeaAuFdjuVZi6DqBcYiA1zSRioMkRvjotr8p7fz,5mqocPwTdjwAPiJf7vx9bo7AzvfQBT2t5bV9u2Jzb2e1,True,632973658,158243414,1085058,542529,542529,3zqXX6kzhkbW3d4TwD2CNjMRwxTbREXySekvq37kfCNk,43402337,118459112,-75056775,685
2022-04-06 09:49:31-04:00,14623,GeYsENPRf2qGZu9rJsi6UPQqHS6sR7LRLWsKbFgtMCSb,7A79wktqPkSpP7o4c1kP9CBpUibHTqycW81ZANgREc5S,True,193153768,48288442,294225,147112,147113,A9TwRM1BMxqb8DCC7YNAMV6zPenEJm3HTZBy7wJKK58U,11769009,32056495,-20287486,609
2022-04-06 09:49:35-04:00,14624,FFDTcCW6UXKpkMnCefTRLpF8ZkJtS4sbGTjkcNU31Pxh,9v5oBZNrx4EATT8iHT5wNRJSo2rRPpazAYvPeaNe2Tpc,True,890494078,111874303,795153,397576,397577,3zqXX6kzhkbW3d4TwD2CNjMRwxTbREXySekvq37kfCNk,63292405,163217210,-99924805,710
2022-04-06 09:49:47-04:00,14625,7CSCMFa9W52tBDVUbXbc3woAy3GByeA1wPJdp3MgznPa,3447ptuVFu6G8B6N63RmS8mRv4n9PfHneypHLvbeaGLn,True,4013436232,784244292,4890043,2445021,2445022,3zqXX6kzhkbW3d4TwD2CNjMRwxTbREXySekvq37kfCNk,250252126,599329785,-349077659,623
2022-04-06 09:49:48-04:00,14626,JABfWoDV2wW68XEDANXArYWM7zabdbp5NBVrvzZd3mML,5hYUtd1Uv2pAcrbtSNNVTrRuk8acjmh92mzSm4iz5HJA,True,159922240,21451717,133927,66963,66964,YQC4EUcgeBi9431viwvzvBbZJW3szeHX4dFmowRDyDw,9984270,24470252,-14485982,624
2022-04-06 09:49:48-04:00,14627,5UDGqNpkcMDjByBNi7WYMg8VJ81EzNJu48zsXbW9irSd,FmtUoQNiG25v8sn4pveM6wAWvja9u6FvZ2gdxWHSRjur,True,2019419112,504854778,3502455,1751227,1751228,3zqXX6kzhkbW3d4TwD2CNjMRwxTbREXySekvq37kfCNk,140098215,450763594,-310665379,693
2022-04-06 09:49:51-04:00,14628,J8khFNhJg25xVY7yjEtETTQVVzKHqdVCs1Rh2pJKvJqU,4eUP2YxTapjr6TLrd57XxZan7KJG5AtHK8yPRNVEbavx,True,1921749718,179450496,1120708,560354,560354,YQC4EUcgeBi9431viwvzvBbZJW3szeHX4dFmowRDyDw,120017556,84478585,35538971,624
2022-04-06 09:49:52-04:00,14629,5yPGvUz6JWKjkViGwTCpygJii1rP2xv5yx146ULtBiYq,FMnHUCQWTf1UHu5qVFqUAsWh8aba9EQYTEoiXy55totD,True,1813164220,156744254,975116,487558,487558,YQC4EUcgeBi9431viwvzvBbZJW3szeHX4dFmowRDyDw,112798186,285329082,-172530896,622
2022-04-06 09:49:53-04:00,14630,9x6AswVgr6MiayhvYFjqj4Fw8LYS795JcL5VrfSsoxi5,BLrbag9VCFCmTinyvVuitmkzXmZLqgaFR9gbRNyftiRX,True,7927620787,1359216390,8482071,4241035,4241036,3zqXX6kzhkbW3d4TwD2CNjMRwxTbREXySekvq37kfCNk,494716301,1361230292,-866513991,624
2022-04-06 09:49:54-04:00,14631,EN2YBXcj7E1eAaYJYXJjc6Rfsu6Awjgv9kN3bT3uiprp,HYDG5mqfCy2xwrYKixNzoWyDiqb9KbpnA8H3TQG2EDDG,True,613101562,153275292,937750,468875,468875,3zqXX6kzhkbW3d4TwD2CNjMRwxTbREXySekvq37kfCNk,37510053,102306025,-64795972,611
2022-04-06 09:50:02-04:00,14632,67DwuUmzk6uGwmptjYErQssFeJ5fd1ztFwKWZUovr7pK,HKzc15e1QLBrSsbAENyMXSVHDoap1F5MHCHB9L1Dm8HA,True,373139363,93284840,582960,291480,291480,3zqXX6kzhkbW3d4TwD2CNjMRwxTbREXySekvq37kfCNk,23318414,70804972,-47486558,624
2022-04-06 09:50:10-04:00,14633,B3NyyoWNzyzvpWv1G6a9gZJMjD1sTQBdZojBaH18mNjY,BCj3EGFMhJ9wh4KvF9cqYsuNHug7kCbALFMLMtuh24bq,True,4750166588,1187541647,7268255,3634127,3634128,3zqXX6kzhkbW3d4TwD2CNjMRwxTbREXySekvq37kfCNk,290730207,679484086,-388753879,612
2022-04-06 09:50:37-04:00,14634,7mhEMbGEpSYgYoZx6WvApjysTxsPqpCDSJCmKF45x3n6,12J2purUC4QYjaPKZwL3Y5P1JikTBD3oY9pLgY6yt6am,True,8899601711,2224900427,13877826,6938913,6938913,3zqXX6kzhkbW3d4TwD2CNjMRwxTbREXySekvq37kfCNk,555113065,916163037,-361049972,623
2022-04-06 09:50:39-04:00,14635,5zSoXxVZYYQAtq3urfcUQmJkjFDBXkUJYSNFdq759Tof,3C459gJnmj4EYTG3tDFJEEf1aAT915sxRLs2THEdQqha,True,4831442868,259932058,1618719,809359,809360,3zqXX6kzhkbW3d4TwD2CNjMRwxTbREXySekvq37kfCNk,300876725,738573186,-437696461,622
2022-04-06 09:50:42-04:00,14636,AyFWvQUX79sq8L7KhcYrPRbxd6whUvEMETZL8atuuRr2,9LTjofdhGLn2Ltv6XfuHtX8MKEPzScGL669pC8Lrgtnh,True,44709309,11177327,69417,34708,34709,YQC4EUcgeBi9431viwvzvBbZJW3szeHX4dFmowRDyDw,2776709,7236378,-4459669,621
2022-04-06 09:51:00-04:00,14637,D8BtQirMEk3W9Pq29B6KkKWrwPfmsUNpwz5npx7aGMLY,J7LMZwaSoh5hbGcwee6oPsnN4ZFD7Zp3LQWkJGNUHRfJ,True,3383369856,492397547,3258482,1629241,1629241,3zqXX6kzhkbW3d4TwD2CNjMRwxTbREXySekvq37kfCNk,223897369,516810132,-292912763,661
2022-04-06 09:51:29-04:00,14638,1EH82ta3wXUyUwW8VWQnVzSG3r1rHcSj2DvDeTKmp3F,B6aMfucYPbCzWBtauLtgTpwR45wKSK8yqscHJR3F5usu,True,2291075434,213721397,1335583,667791,667792,YQC4EUcgeBi9431viwvzvBbZJW3szeHX4dFmowRDyDw,143173516,73905761,69267755,624
2022-04-06 09:51:42-04:00,14639,HooxSzasW3HMoFJ6sAvRQ75Char1J5aBdJtsqfDV6myp,BCmsWwpGeV4NNfeKZKKydty2uueLGHYTJDk1WErpXsVT,True,2135428742,533857185,3302903,1651451,1651452,3zqXX6kzhkbW3d4TwD2CNjMRwxTbREXySekvq37kfCNk,132116150,340779474,-208663324,618
2022-04-06 09:52:12-04:00,14640,FU7X4DWnGTbxwXULBq3v9SACzYhQyFGqsXjUDzyFqiem,925BaEnWxTfEv4oQb9Xf1wyyEEWEr8kXeSdXTtRfShfw,True,59807511501,4516347729,28193772,14096886,14096886,3zqXX6kzhkbW3d4TwD2CNjMRwxTbREXySekvq37kfCNk,3733546393,6747290797,-3013744404,624
2022-04-06 09:53:45-04:00,14641,A5NXadGWnFZRoHEn1dKTRjcXgWmfMLMyJdpF4rQPZyRR,ALs3Zfotc4c4A6TFDMbd5GM5whK1dTYSnGrHiMBWmApH,True,4111804961,1027950635,6406315,3203157,3203158,3zqXX6kzhkbW3d4TwD2CNjMRwxTbREXySekvq37kfCNk,256252782,1019330187,-763077405,623
2022-04-06 09:55:41-04:00,14642,F2AU2PjaSmHxWWhkz8XxMggkCMWbMVgawt89tSnYS6RL,ET9febRJiW197DYMaJbgk3kWsAeFv5f4peQ4vFCVppK6,True,28641445,7160361,50441,25220,25221,YQC4EUcgeBi9431viwvzvBbZJW3szeHX4dFmowRDyDw,2017649,10497277,-8479628,704
2022-04-06 09:59:21-04:00,14643,3uUdWwgwtFdPa3FJTSrirqPKMtQb3zmT5Wpp4zPy9sJP,5G7dhz8jvWekGy9Wh3ZCXNXSPbB1QArfFYs7MYNgRDkW,True,323225607,80806401,503578,251789,251789,3zqXX6kzhkbW3d4TwD2CNjMRwxTbREXySekvq37kfCNk,20143134,84404870,-64261736,623
2022-04-06 10:00:57-04:00,14644,5yPGvUz6JWKjkViGwTCpygJii1rP2xv5yx146ULtBiYq,FMnHUCQWTf1UHu5qVFqUAsWh8aba9EQYTEoiXy55totD,True,1647363853,155202378,967676,483838,483838,3zqXX6kzhkbW3d4TwD2CNjMRwxTbREXySekvq37kfCNk,102712004,268748093,-166036089,623
2022-04-06 10:02:27-04:00,14645,8nFpzAFXELGPsrgFwRjTfUidNme1CvgKQTsHWATtMqkz,ABt8ikXHraZ1bqkDUvMtJ3AUzADDWcCL8kMMDpAoth8V,True,72113962,18028490,111718,55859,55859,3zqXX6kzhkbW3d4TwD2CNjMRwxTbREXySekvq37kfCNk,4468742,15065455,-10596713,619
2022-04-06 10:03:13-04:00,14646,DVMLxFACqaNBD7q1TGJUUApJX7etJsxQRRFBP2DfBazJ,4hnRjD7S2KxD7UrgfrApntVxUD7Srh5E9nwPY53v89kz,True,433162535,35568823,231719,115859,115860,3zqXX6kzhkbW3d4TwD2CNjMRwxTbREXySekvq37kfCNk,28219164,82606056,-54386892,651
2022-04-06 10:03:39-04:00,14647,BAkPsWHtpVcEGqUgKTKjwZ6d5aaUcaUhdgYxBnpSTDW2,BDwDmVaZnXh22sf8nsDtjVfgxMAswbM3PW3si3k4nbRK,True,497486138,124371534,768247,384123,384124,3zqXX6kzhkbW3d4TwD2CNjMRwxTbREXySekvq37kfCNk,30729893,98717762,-67987869,617
2022-04-06 10:03:39-04:00,14648,FV9CBGGTbppLnBKh79f2LzD1diTiS5g6u89FcpZHZmnK,Fe7mtmCUziFqbbYTvrhAcAq1Ub7YLfTJRtQ1hG7GzJD1,True,50150319,12537579,77540,38770,38770,3zqXX6kzhkbW3d4TwD2CNjMRwxTbREXySekvq37kfCNk,3101603,6231305,-3129702,618
2022-04-06 10:03:56-04:00,14649,D85pWm1LS9MvtR4f3QhkFLvNUhZLQ2NZBFQTyAVnmigm,CRN85DYkJJi6irhtVAf4qcJU3ijVodWdXgWe7Fs6Ahka,True,597201349,85195665,531651,265825,265826,3zqXX6kzhkbW3d4TwD2CNjMRwxTbREXySekvq37kfCNk,37267548,107712190,-70444642,624
2022-04-06 10:03:57-04:00,14650,5FewDaMC9U7n5EHcto98GaAmDVxDh5SYimuTP6AtfakM,7DAULUoqV7f9hsBzKEhjQPnWaHSqiMWcBqWcdcadaQv4,True,2218346730,315641982,1935831,967915,967916,A9TwRM1BMxqb8DCC7YNAMV6zPenEJm3HTZBy7wJKK58U,136051131,247772121,-111720990,613
2022-04-06 10:04:08-04:00,14651,eiLMepBYM3VcWarQJC9fTnxotyMuUTbyMGJECedPEfu,k2ZfwPNBBCK7PvZ6MEvELTHHtQZSXCRGCymvkZwhDDt,True,58966821,9388828,58611,29305,29306,3zqXX6kzhkbW3d4TwD2CNjMRwxTbREXySekvq37kfCNk,3681122,10574837,-6893715,624
2022-04-06 10:04:09-04:00,14652,J8khFNhJg25xVY7yjEtETTQVVzKHqdVCs1Rh2pJKvJqU,4eUP2YxTapjr6TLrd57XxZan7KJG5AtHK8yPRNVEbavx,True,1731545066,150005981,935969,467984,467985,YQC4EUcgeBi9431viwvzvBbZJW3szeHX4dFmowRDyDw,108040632,122990015,-14949383,623
2022-04-06 10:04:09-04:00,14653,DDdxcAmfFWLs79vYC1WUuwBVM1XUfxmAgbYgccL5bgZg,3tKaUfHU3Z7v1LDm581yDd1bpfnxLgGHCWTNur3KLptz,True,2792280672,698070168,4362552,2181276,2181276,3zqXX6kzhkbW3d4TwD2CNjMRwxTbREXySekvq37kfCNk,174502087,497458972,-322956885,624
2022-04-06 10:04:17-04:00,14654,29JVska5UEG3axs63EmtHpPvkswNEqYpZ3PKMSfupiAG,DCftNBUsuogxyaJe9G9m3eWipH6o3qo4Rn4TuQXdVaBF,True,26513284,6628321,41311,20655,20656,YQC4EUcgeBi9431viwvzvBbZJW3szeHX4dFmowRDyDw,1652442,5743243,-4090801,623
2022-04-06 10:04:20-04:00,14655,EBRWnRzoNv5RytEjgrs5TXdiCMApLKHMntJJJzehJJns,5nJiYTa3GEbmaRwY1PvBJ1teXikQKgbUop5ANgaDhhcP,True,57129047,14282261,88724,44362,44362,YQC4EUcgeBi9431viwvzvBbZJW3szeHX4dFmowRDyDw,3548990,8294227,-4745237,621
2022-04-06 10:04:23-04:00,14656,5zSoXxVZYYQAtq3urfcUQmJkjFDBXkUJYSNFdq759Tof,3C459gJnmj4EYTG3tDFJEEf1aAT915sxRLs2THEdQqha,True,4555978711,250362474,1558101,779050,779051,YQC4EUcgeBi9431viwvzvBbZJW3szeHX4dFmowRDyDw,283536033,717159441,-433623408,622
2022-04-06 10:04:26-04:00,14657,2i5g7q4gD1GEfSz8BkhKn1idQ5U7cFPbMDWugjr7bBQW,Dpx6K9G5uZD63rTzBafZ56WKd1X9M25Mzfppd7Jib4xn,True,4882447912,1220611978,7579829,3789914,3789915,3zqXX6kzhkbW3d4TwD2CNjMRwxTbREXySekvq37kfCNk,303193161,1067719473,-764526312,620
2022-04-06 10:04:28-04:00,14658,4GbUrgiR6A91h3J9HHpuYCkZzjwrb62n3BURLeWj6Nic,12nUFUGYF1rXbwPeCbdGKdP3RE4g984fmZZggEYSFTZn,True,208220184,52055046,323988,161994,161994,3zqXX6kzhkbW3d4TwD2CNjMRwxTbREXySekvq37kfCNk,12959533,44094606,-31135073,622
2022-04-06 10:04:44-04:00,14659,6Auz7aARPERW9zbV8428yFUWkA9DuitQYiWQzewueU3o,G1xfLGt5twz7MTfEq6NnMZBpr6GmXceKdGUQkc9jugRB,True,37878989,9469747,58943,29471,29472,3zqXX6kzhkbW3d4TwD2CNjMRwxTbREXySekvq37kfCNk,2357729,8953100,-6595371,622
2022-04-06 10:04:58-04:00,14660,FU7X4DWnGTbxwXULBq3v9SACzYhQyFGqsXjUDzyFqiem,925BaEnWxTfEv4oQb9Xf1wyyEEWEr8kXeSdXTtRfShfw,True,55013041231,3746137347,23334296,11667148,11667148,3zqXX6kzhkbW3d4TwD2CNjMRwxTbREXySekvq37kfCNk,3426704573,6476535333,-3049830760,622
2022-04-06 10:05:14-04:00,14661,FoGtu9wcVbBmATBKtBMWvbRd558yzSDT5dPBTBJgzqFT,9rnvQvgQtkT7RSdDpZHnkTVd2V9CMRBSB7v79GDip4hS,True,596074284,149018571,870470,435235,435235,3zqXX6kzhkbW3d4TwD2CNjMRwxTbREXySekvq37kfCNk,34818818,74053250,-39234432,584
2022-04-06 10:05:15-04:00,14662,AX2VRZoWZDfZT4QdwuXUSyRCx4N6B9eHAR75FSmcrVFG,FBgLGmbouri9wCV92UXZaDjwK6fcpjhDDD5NLVWmuRRK,True,2871064225,717766056,4412944,2206472,2206472,3zqXX6kzhkbW3d4TwD2CNjMRwxTbREXySekvq37kfCNk,176517766,484490776,-307973010,614
2022-04-06 10:05:18-04:00,14663,6eEifGxGRBnXV5EW2BwmCj8pa67znMjet98Nsq11LCsd,Dd4UCEX7tm6Q82SdSSFX9wBcJNw5TwKu8EyGjvxi9FVc,True,887945990,221986497,1380431,690215,690216,YQC4EUcgeBi9431viwvzvBbZJW3szeHX4dFmowRDyDw,55217266,131033827,-75816561,621
2022-04-06 10:05:18-04:00,14664,7yW1M1xeVx4hy3QftnpqdBDRYwamfu3K5i6AEnxgyTWb,7wf7FWS2DYp5RveQAmGNXAEUWPcHziuMLd4hV5LPgxF8,True,22335583,5583895,34005,17002,17003,3zqXX6kzhkbW3d4TwD2CNjMRwxTbREXySekvq37kfCNk,1360203,4337102,-2976899,608
2022-04-06 10:05:18-04:00,14665,DVMLxFACqaNBD7q1TGJUUApJX7etJsxQRRFBP2DfBazJ,4hnRjD7S2KxD7UrgfrApntVxUD7Srh5E9nwPY53v89kz,True,395070159,39574720,255075,127537,127538,3zqXX6kzhkbW3d4TwD2CNjMRwxTbREXySekvq37kfCNk,25463892,75747421,-50283529,644
2022-04-06 10:05:21-04:00,14666,C3DnHRyndQw1EinnmrayLzuhP9KhXYKVDUpf55BumxG1,6aU3EvNk5CyD5LdGhQksYKkNxvJ5vw23JvMEdwqeDSMo,True,9278995066,2319748766,13964220,6982110,6982110,YQC4EUcgeBi9431viwvzvBbZJW3szeHX4dFmowRDyDw,558568834,2164013078,-1605444244,601
2022-04-06 10:05:23-04:00,14667,5zSoXxVZYYQAtq3urfcUQmJkjFDBXkUJYSNFdq759Tof,3C459gJnmj4EYTG3tDFJEEf1aAT915sxRLs2THEdQqha,True,4291837713,247292752,1545346,772673,772673,3zqXX6kzhkbW3d4TwD2CNjMRwxTbREXySekvq37kfCNk,268199408,687768560,-419569152,624
2022-04-06 10:05:23-04:00,14668,2xgQaQTs7bkK34jSBZ2dFZf1DJKjMVW9LA3D9Pwtfims,6rniSBeGcJAcrqWhhnKCcRV58yYnjuqXj9b4Zu8DUwQ9,True,57148883,13755552,81517,40758,40759,3zqXX6kzhkbW3d4TwD2CNjMRwxTbREXySekvq37kfCNk,3386737,10587735,-7200998,592
2022-04-06 10:05:27-04:00,14669,1EH82ta3wXUyUwW8VWQnVzSG3r1rHcSj2DvDeTKmp3F,B6aMfucYPbCzWBtauLtgTpwR45wKSK8yqscHJR3F5usu,True,2058358963,205507109,1225369,612684,612685,3zqXX6kzhkbW3d4TwD2CNjMRwxTbREXySekvq37kfCNk,122733046,59377795,63355251,596
2022-04-06 10:05:30-04:00,14670,3BKX31xq3f13J2Zo8Wue4SYpCMWLXjgUt2nkwTTNfU2T,2pTxNAaV4pXRRUDE97ZFteBJn9tyktjh3FW1CWfwebci,True,299634013,74908503,468047,234023,234024,3zqXX6kzhkbW3d4TwD2CNjMRwxTbREXySekvq37kfCNk,18721909,46318360,-27596451,624
2022-04-06 10:05:38-04:00,14671,J5q3HYmNhEHPz4DzVGHnSwBAwTqTn8jPwkjCaoQRs9t1,FbgqAegQKWQ8jVVVcJV6okGHgP1fhL2uoJpzfX3mYoH6,True,219205024,54801256,337424,168712,168712,72FwbpFGoLEazJEdpqNtPNefsadUrimUqma9wSoy4qiS,13496991,37863285,-24366294,615
2022-04-06 10:05:59-04:00,14672,DXGapgtgkag6midSCYNhHCNaCqvhUmuSvnVhXxNXBmyt,Csq6W5QkGZL6qE6Z1ERF3bfHtKjnM8hAxiY1YA3rTwSX,True,1114687619,278671904,1727335,863667,863668,YQC4EUcgeBi9431viwvzvBbZJW3szeHX4dFmowRDyDw,69093430,163333834,-94240404,619
2022-04-06 10:06:29-04:00,14673,5yPGvUz6JWKjkViGwTCpygJii1rP2xv5yx146ULtBiYq,FMnHUCQWTf1UHu5qVFqUAsWh8aba9EQYTEoiXy55totD,True,1482783274,138130232,860446,430223,430223,3zqXX6kzhkbW3d4TwD2CNjMRwxTbREXySekvq37kfCNk,92366127,251551904,-159185777,622
2022-04-06 10:06:39-04:00,14674,GRqv7y5n92vQ7bXcBqUng4vaau6w1tQeou953s8kJNwD,Bk75oioYmUzfdpbxDHTFb2nWhJgNqAt8ud1ehem3VVhh,True,4468782700,1117195675,6963139,3481569,3481570,3zqXX6kzhkbW3d4TwD2CNjMRwxTbREXySekvq37kfCNk,278525568,549187142,-270661574,623
2022-04-06 10:06:54-04:00,14675,SEndYVMCKAeZUKSqGrMUSqXFmxtA9M1t4eXsUhVsTBF,3fcQQcbkpqodakamn82pFnMxBEPL2Drsg4jJNZ6dx72M,True,1085696116,133372100,876033,438016,438017,3zqXX6kzhkbW3d4TwD2CNjMRwxTbREXySekvq37kfCNk,71312203,214131211,-142819008,656
2022-04-06 10:07:09-04:00,14676,GCweck6iuscBsVbXW9ZYfMytdgwSYWwNifTWLaUbaSmA,6HwGWKGduMGvLnHmTJo6ZioZ3EMUZYHo2pG4tBFXgB4Y,True,42197583,10549395,74344,37172,37172,YQC4EUcgeBi9431viwvzvBbZJW3szeHX4dFmowRDyDw,2973777,15417178,-12443401,704
2022-04-06 10:09:09-04:00,14677,JABfWoDV2wW68XEDANXArYWM7zabdbp5NBVrvzZd3mML,5hYUtd1Uv2pAcrbtSNNVTrRuk8acjmh92mzSm4iz5HJA,True,137180780,18364556,114457,57228,57229,3zqXX6kzhkbW3d4TwD2CNjMRwxTbREXySekvq37kfCNk,8549833,22721248,-14171415,623
2022-04-06 10:15:15-04:00,14678,J8khFNhJg25xVY7yjEtETTQVVzKHqdVCs1Rh2pJKvJqU,4eUP2YxTapjr6TLrd57XxZan7KJG5AtHK8yPRNVEbavx,True,1572692252,148179665,925788,462894,462894,3zqXX6kzhkbW3d4TwD2CNjMRwxTbREXySekvq37kfCNk,98257830,103566712,-5308882,624
2022-04-06 11:11:59-04:00,14679,GeYsENPRf2qGZu9rJsi6UPQqHS6sR7LRLWsKbFgtMCSb,7A79wktqPkSpP7o4c1kP9CBpUibHTqycW81ZANgREc5S,True,142281554,35570388,222096,111048,111048,3zqXX6kzhkbW3d4TwD2CNjMRwxTbREXySekvq37kfCNk,8883874,26683548,-17799674,624
2022-04-06 11:18:43-04:00,14680,D85pWm1LS9MvtR4f3QhkFLvNUhZLQ2NZBFQTyAVnmigm,CRN85DYkJJi6irhtVAf4qcJU3ijVodWdXgWe7Fs6Ahka,True,506970331,63666875,397818,198909,198909,3zqXX6kzhkbW3d4TwD2CNjMRwxTbREXySekvq37kfCNk,31677790,97837392,-66159602,624
2022-04-06 11:18:58-04:00,14681,FU7X4DWnGTbxwXULBq3v9SACzYhQyFGqsXjUDzyFqiem,925BaEnWxTfEv4oQb9Xf1wyyEEWEr8kXeSdXTtRfShfw,True,51047232714,3490915959,21756952,10878476,10878476,3zqXX6kzhkbW3d4TwD2CNjMRwxTbREXySekvq37kfCNk,3181492245,6103858575,-2922366330,623
2022-04-06 11:19:07-04:00,14682,eiLMepBYM3VcWarQJC9fTnxotyMuUTbyMGJECedPEfu,k2ZfwPNBBCK7PvZ6MEvELTHHtQZSXCRGCymvkZwhDDt,True,48950085,6922304,42332,21166,21166,A9TwRM1BMxqb8DCC7YNAMV6zPenEJm3HTZBy7wJKK58U,2993507,9083337,-6089830,611
2022-04-06 11:19:07-04:00,14683,8nFpzAFXELGPsrgFwRjTfUidNme1CvgKQTsHWATtMqkz,ABt8ikXHraZ1bqkDUvMtJ3AUzADDWcCL8kMMDpAoth8V,True,53004958,13251239,81869,40934,40935,A9TwRM1BMxqb8DCC7YNAMV6zPenEJm3HTZBy7wJKK58U,3274794,12302885,-9028091,617
2022-04-06 11:19:08-04:00,14684,7mhEMbGEpSYgYoZx6WvApjysTxsPqpCDSJCmKF45x3n6,12J2purUC4QYjaPKZwL3Y5P1JikTBD3oY9pLgY6yt6am,True,6532335059,1633083764,9963489,4981744,4981745,3zqXX6kzhkbW3d4TwD2CNjMRwxTbREXySekvq37kfCNk,398539566,812267815,-413728249,610
2022-04-06 11:19:10-04:00,14685,67DwuUmzk6uGwmptjYErQssFeJ5fd1ztFwKWZUovr7pK,HKzc15e1QLBrSsbAENyMXSVHDoap1F5MHCHB9L1Dm8HA,True,273673939,68418484,413526,206763,206763,3zqXX6kzhkbW3d4TwD2CNjMRwxTbREXySekvq37kfCNk,16541070,58337667,-41796597,604
2022-04-06 11:19:10-04:00,14686,5YC2wXkdk7D4Ubs9TEAbP1hi88Sy35bzYVWjLbgVxn5s,4Mx69ezqFK2wudZ62oVhx2pwjVbKv8JB1HR29ZUcdEJb,True,3963724359,990931089,6174650,3087325,3087325,YQC4EUcgeBi9431viwvzvBbZJW3szeHX4dFmowRDyDw,246986002,408413613,-161427611,623
2022-04-06 11:19:11-04:00,14687,AyFWvQUX79sq8L7KhcYrPRbxd6whUvEMETZL8atuuRr2,9LTjofdhGLn2Ltv6XfuHtX8MKEPzScGL669pC8Lrgtnh,True,32810900,8202725,49613,24806,24807,47z82br5WdW2DZajdnPDPSSRRKsyAggqXqK6oPUwTaLf,1984556,6050406,-4065850,604
2022-04-06 11:19:15-04:00,14688,5zSoXxVZYYQAtq3urfcUQmJkjFDBXkUJYSNFdq759Tof,3C459gJnmj4EYTG3tDFJEEf1aAT915sxRLs2THEdQqha,True,4028278643,246424612,1530524,765262,765262,3zqXX6kzhkbW3d4TwD2CNjMRwxTbREXySekvq37kfCNk,250193362,664866846,-414673484,621
2022-04-06 11:19:34-04:00,14689,AwT3pH9dHjECDnuUiazbD6tZxZHdNwgJ4vBMmxLHMiLo,AjybksvjMT1QT6KvryXCG47pQGT8v9jxM34VkveGPQrs,True,34902234,8725558,54398,27199,27199,YQC4EUcgeBi9431viwvzvBbZJW3szeHX4dFmowRDyDw,2175940,4447425,-2271485,623
2022-04-06 11:21:29-04:00,14690,FV9CBGGTbppLnBKh79f2LzD1diTiS5g6u89FcpZHZmnK,Fe7mtmCUziFqbbYTvrhAcAq1Ub7YLfTJRtQ1hG7GzJD1,True,36883957,9220989,57352,28676,28676,A9TwRM1BMxqb8DCC7YNAMV6zPenEJm3HTZBy7wJKK58U,2294085,5370164,-3076079,621
2022-04-06 11:21:29-04:00,14691,BAkPsWHtpVcEGqUgKTKjwZ6d5aaUcaUhdgYxBnpSTDW2,BDwDmVaZnXh22sf8nsDtjVfgxMAswbM3PW3si3k4nbRK,True,365884606,91471151,567994,283997,283997,A9TwRM1BMxqb8DCC7YNAMV6zPenEJm3HTZBy7wJKK58U,22719788,80942653,-58222865,620
2022-04-06 11:21:32-04:00,14692,niCk6QHFU1kyU56Mdq5RJzKrecdkNSn23ZA6wduFdWS,BQbUYSw1XsuE6LnVd4XjmxAyYgx4drE4FsetJBCdwVZW,True,924564785,231030438,1439867,719933,719934,3zqXX6kzhkbW3d4TwD2CNjMRwxTbREXySekvq37kfCNk,57622346,123513564,-65891218,623
2022-04-06 11:30:58-04:00,14693,EN2YBXcj7E1eAaYJYXJjc6Rfsu6Awjgv9kN3bT3uiprp,HYDG5mqfCy2xwrYKixNzoWyDiqb9KbpnA8H3TQG2EDDG,True,451330468,112832521,701548,350774,350774,3zqXX6kzhkbW3d4TwD2CNjMRwxTbREXySekvq37kfCNk,28061975,85162129,-57100154,621
2022-04-06 11:32:55-04:00,14694,5yPGvUz6JWKjkViGwTCpygJii1rP2xv5yx146ULtBiYq,FMnHUCQWTf1UHu5qVFqUAsWh8aba9EQYTEoiXy55totD,True,1335960678,116329604,720527,360263,360264,3zqXX6kzhkbW3d4TwD2CNjMRwxTbREXySekvq37kfCNk,82747395,236079717,-153332322,619
2022-04-06 11:32:58-04:00,14695,Br1j5Ftafei7ysu5SmqVZSoRe4uS4qCPeKSPHg55pyiE,G8fc7QvXjfkgBFvAVUgJFQS3VaF1biL9rktBExGa87Ks,True,2150009381,405565755,2519537,1259768,1259769,3zqXX6kzhkbW3d4TwD2CNjMRwxTbREXySekvq37kfCNk,133567266,177679785,-44112519,621
2022-04-06 11:32:59-04:00,14696,5zSoXxVZYYQAtq3urfcUQmJkjFDBXkUJYSNFdq759Tof,3C459gJnmj4EYTG3tDFJEEf1aAT915sxRLs2THEdQqha,True,3768246721,195025100,1216526,608263,608263,47z82br5WdW2DZajdnPDPSSRRKsyAggqXqK6oPUwTaLf,235055528,629274861,-394219333,623
2022-04-06 11:33:00-04:00,14697,CZhzJ91hP1pFbNNz7YnUKXznvs6ZFVSRNLbe1SaTw29o,X3B4LpHFfeJPmCnEmRQ8V6MNMi7KpTE4MLD7LHYXUwy,True,384162237,47437012,294223,147111,147112,A9TwRM1BMxqb8DCC7YNAMV6zPenEJm3HTZBy7wJKK58U,23827355,54572410,-30745055,620
2022-04-06 11:33:00-04:00,14698,EHLV9s6E1s5SUbzZVzsGWH2vVRGHyxynM4GDJtfKEuYe,4hAx9osegpeocSSmJbMVBYMKCwo5WY3QVJuK7cuzz4b4,True,42223695,10555923,75040,37520,37520,YQC4EUcgeBi9431viwvzvBbZJW3szeHX4dFmowRDyDw,3001613,15419062,-12417449,710
2022-04-06 11:33:39-04:00,14699,5qY8ZrqpHPqkAuXp6HpE2zC8qTfzsP8MXWSoxkZQV5jx,GPs3ap45TuHwHwmDb5bnKYHLBa5wj3AyuEsXcfHjEcAL,True,19093741,4773435,34065,17032,17033,YQC4EUcgeBi9431viwvzvBbZJW3szeHX4dFmowRDyDw,1362613,5845765,-4483152,713
2022-04-06 12:31:17-04:00,14700,CVjkHr29t8pzeXU1U1CdMpT6qwf9Jw4XGxvxU7RURPYj,D66Zpxp7q4Tn4KiLa2pHTrADhgtP8tGqNXVPyCo9mcxc,True,308817240,51802716,323204,161602,161602,YQC4EUcgeBi9431viwvzvBbZJW3szeHX4dFmowRDyDw,19267528,47331085,-28063557,623
2022-04-06 12:32:27-04:00,14701,6K1Xww22wVZuBwP6oYb3DPR5GvdxsQSiZ4WSmejQjyqf,8RoFHjv1TkGFqjKoSwzvyRNMoBP1ma1Hi2jy6FzD4i2g,True,248592598,60033047,374510,187255,187255,YQC4EUcgeBi9431viwvzvBbZJW3szeHX4dFmowRDyDw,15508215,24635818,-9127603,623
2022-04-06 12:36:08-04:00,14702,DVMLxFACqaNBD7q1TGJUUApJX7etJsxQRRFBP2DfBazJ,4hnRjD7S2KxD7UrgfrApntVxUD7Srh5E9nwPY53v89kz,True,353328843,32462295,211351,105675,105676,YQC4EUcgeBi9431viwvzvBbZJW3szeHX4dFmowRDyDw,23004131,72840495,-49836364,651
2022-04-06 12:38:07-04:00,14703,Gw37fsD8M3AaZ22tSx9WeszxsAkWQ6Ap2XV3zXYhe3EJ,FbKeJsWR5ggVBy1R5sxNiWz5GAsxeyZD8nmyk5yCBqSz,True,47707971,11926992,84446,42223,42223,YQC4EUcgeBi9431viwvzvBbZJW3szeHX4dFmowRDyDw,3377870,17303267,-13925397,708
2022-04-06 12:38:26-04:00,14704,7CSCMFa9W52tBDVUbXbc3woAy3GByeA1wPJdp3MgznPa,3447ptuVFu6G8B6N63RmS8mRv4n9PfHneypHLvbeaGLn,True,3183090834,580090753,3619277,1809638,1809639,YQC4EUcgeBi9431viwvzvBbZJW3szeHX4dFmowRDyDw,198598042,531385206,-332787164,623
2022-04-06 12:38:34-04:00,14705,FU7X4DWnGTbxwXULBq3v9SACzYhQyFGqsXjUDzyFqiem,925BaEnWxTfEv4oQb9Xf1wyyEEWEr8kXeSdXTtRfShfw,True,47328148729,3362607528,20812872,10406436,10406436,YQC4EUcgeBi9431viwvzvBbZJW3szeHX4dFmowRDyDw,2929377591,6037463781,-3108086190,618
2022-04-06 12:38:34-04:00,14706,FFDTcCW6UXKpkMnCefTRLpF8ZkJtS4sbGTjkcNU31Pxh,9v5oBZNrx4EATT8iHT5wNRJSo2rRPpazAYvPeaNe2Tpc,True,770356580,110190434,774711,387355,387356,3zqXX6kzhkbW3d4TwD2CNjMRwxTbREXySekvq37kfCNk,54161178,144718743,-90557565,703
2022-04-06 12:38:38-04:00,14707,BEATjyYuro1xc1kbgBoxBnVEk3usoUk9qwmdRndXdYW5,9RGBffhSMgab1KCM6dMvwiBENbnp5pERfCEjw4q5ckFS,True,158021183,39505295,266416,133208,133208,YQC4EUcgeBi9431viwvzvBbZJW3szeHX4dFmowRDyDw,10656648,40520132,-29863484,674
2022-04-06 12:38:43-04:00,14708,H1oYXGZTagwv48FdDe6RNkjNaesedqLKyXxTmPc5k4Fp,Am3rx6XrkrZ4MdeZDyZUv1YW2fBujcz4dLjVCnRQHKZa,True,42111786,10527946,65777,32888,32889,47z82br5WdW2DZajdnPDPSSRRKsyAggqXqK6oPUwTaLf,2631098,3850518,-1219420,624
2022-04-06 12:38:46-04:00,14709,J7YiZCKE32Em1wYdwPNQAivCRcwrWx4UcXvc7zTzmauT,4XNuM7skYZpRfJpzLSDTK3dTvq8vrhb8Eqa53Z5CqLRv,True,11012759469,2753189867,19481746,9740873,9740873,3zqXX6kzhkbW3d4TwD2CNjMRwxTbREXySekvq37kfCNk,779269861,4080592217,-3301322356,707
2022-04-06 12:39:06-04:00,14710,D85pWm1LS9MvtR4f3QhkFLvNUhZLQ2NZBFQTyAVnmigm,CRN85DYkJJi6irhtVAf4qcJU3ijVodWdXgWe7Fs6Ahka,True,439201390,62699007,387538,193769,193769,YQC4EUcgeBi9431viwvzvBbZJW3szeHX4dFmowRDyDw,27146738,88682350,-61535612,618
2022-04-06 12:39:08-04:00,14711,3BKX31xq3f13J2Zo8Wue4SYpCMWLXjgUt2nkwTTNfU2T,2pTxNAaV4pXRRUDE97ZFteBJn9tyktjh3FW1CWfwebci,True,219714813,54928703,330938,165469,165469,3zqXX6kzhkbW3d4TwD2CNjMRwxTbREXySekvq37kfCNk,13237553,38947505,-25709952,602
2022-04-06 12:39:10-04:00,14712,5yPGvUz6JWKjkViGwTCpygJii1rP2xv5yx146ULtBiYq,FMnHUCQWTf1UHu5qVFqUAsWh8aba9EQYTEoiXy55totD,True,1211928030,114278080,700121,350060,350061,3zqXX6kzhkbW3d4TwD2CNjMRwxTbREXySekvq37kfCNk,74248430,222389059,-148140629,612
2022-04-06 12:40:09-04:00,14713,29JVska5UEG3axs63EmtHpPvkswNEqYpZ3PKMSfupiAG,DCftNBUsuogxyaJe9G9m3eWipH6o3qo4Rn4TuQXdVaBF,True,19438279,4859569,29068,14534,14534,YQC4EUcgeBi9431viwvzvBbZJW3szeHX4dFmowRDyDw,1162732,4677523,-3514791,598
2022-04-06 12:40:09-04:00,14714,9WH1YzDrdvZs8aDuFLwQHHXa2e66ZcwdfDi7qXEjQxFy,3Tpc8DqJwg1tTDgk6qH1UhvtwvhXxsp5GRFYMWxa8NKX,True,6461116693,1615279173,9845469,4922734,4922735,YQC4EUcgeBi9431viwvzvBbZJW3szeHX4dFmowRDyDw,393818798,923514865,-529696067,609
2022-04-06 12:40:09-04:00,14715,DVMLxFACqaNBD7q1TGJUUApJX7etJsxQRRFBP2DfBazJ,4hnRjD7S2KxD7UrgfrApntVxUD7Srh5E9nwPY53v89kz,True,318579769,26138479,168245,84122,84123,YQC4EUcgeBi9431viwvzvBbZJW3szeHX4dFmowRDyDw,20506001,67591629,-47085628,643
2022-04-06 12:40:09-04:00,14716,2i5g7q4gD1GEfSz8BkhKn1idQ5U7cFPbMDWugjr7bBQW,Dpx6K9G5uZD63rTzBafZ56WKd1X9M25Mzfppd7Jib4xn,True,3582202498,895550624,5391589,2695794,2695795,YQC4EUcgeBi9431viwvzvBbZJW3szeHX4dFmowRDyDw,215663594,868884570,-653220976,602
2022-04-06 12:40:15-04:00,14717,EBRWnRzoNv5RytEjgrs5TXdiCMApLKHMntJJJzehJJns,5nJiYTa3GEbmaRwY1PvBJ1teXikQKgbUop5ANgaDhhcP,True,41876431,10469107,62155,31077,31078,A9TwRM1BMxqb8DCC7YNAMV6zPenEJm3HTZBy7wJKK58U,2486214,7015522,-4529308,593
2022-04-06 12:40:21-04:00,14718,SEndYVMCKAeZUKSqGrMUSqXFmxtA9M1t4eXsUhVsTBF,3fcQQcbkpqodakamn82pFnMxBEPL2Drsg4jJNZ6dx72M,True,942082438,101012766,669721,334860,334861,3zqXX6kzhkbW3d4TwD2CNjMRwxTbREXySekvq37kfCNk,62460743,208469764,-146009021,663
2022-04-06 12:40:21-04:00,14719,4GbUrgiR6A91h3J9HHpuYCkZzjwrb62n3BURLeWj6Nic,12nUFUGYF1rXbwPeCbdGKdP3RE4g984fmZZggEYSFTZn,True,152748239,38187059,230128,115064,115064,3zqXX6kzhkbW3d4TwD2CNjMRwxTbREXySekvq37kfCNk,9205159,35973712,-26768553,602
2022-04-06 12:42:17-04:00,14720,FoGtu9wcVbBmATBKtBMWvbRd558yzSDT5dPBTBJgzqFT,9rnvQvgQtkT7RSdDpZHnkTVd2V9CMRBSB7v79GDip4hS,True,440664666,110166166,687959,343979,343980,3zqXX6kzhkbW3d4TwD2CNjMRwxTbREXySekvq37kfCNk,27518371,63337902,-35819531,624
2022-04-06 13:04:27-04:00,14721,CZhzJ91hP1pFbNNz7YnUKXznvs6ZFVSRNLbe1SaTw29o,X3B4LpHFfeJPmCnEmRQ8V6MNMi7KpTE4MLD7LHYXUwy,True,334007208,35418759,220267,110133,110134,A9TwRM1BMxqb8DCC7YNAMV6zPenEJm3HTZBy7wJKK58U,20771791,51581821,-30810030,621
2022-04-06 13:04:39-04:00,14722,EC8fafqtuQzqbm2TZs3GeuXB9qXomkykrTG1na2rfFpx,A72f7W58h3r8nut45RmqdTk1J31NGYT2sVWMn18dK885,True,100498419,25124604,156505,78252,78253,YQC4EUcgeBi9431viwvzvBbZJW3szeHX4dFmowRDyDw,6260226,12575538,-6315312,622
2022-04-06 13:04:40-04:00,14723,B3NyyoWNzyzvpWv1G6a9gZJMjD1sTQBdZojBaH18mNjY,BCj3EGFMhJ9wh4KvF9cqYsuNHug7kCbALFMLMtuh24bq,True,3497043071,874260767,5438028,2719014,2719014,A9TwRM1BMxqb8DCC7YNAMV6zPenEJm3HTZBy7wJKK58U,217521133,575392358,-357871225,622
2022-04-06 13:04:44-04:00,14724,7BEY9qatFJomsayFmky3h3dAbKhY5XkRGwMobJuxXYhQ,J8MK3tAQKreBUG2reXY6gqr1uhbHhcAZEcxsLQmG5Ntt,True,7438449106,1859612276,13168313,6584156,6584157,YQC4EUcgeBi9431viwvzvBbZJW3szeHX4dFmowRDyDw,526732545,1017205342,-490472797,708
2022-04-06 13:04:48-04:00,14725,FU7X4DWnGTbxwXULBq3v9SACzYhQyFGqsXjUDzyFqiem,925BaEnWxTfEv4oQb9Xf1wyyEEWEr8kXeSdXTtRfShfw,True,43762887483,3087999964,19083255,9541627,9541628,A9TwRM1BMxqb8DCC7YNAMV6zPenEJm3HTZBy7wJKK58U,2704463705,5805442494,-3100978789,617
2022-04-06 13:05:18-04:00,14726,eiLMepBYM3VcWarQJC9fTnxotyMuUTbyMGJECedPEfu,k2ZfwPNBBCK7PvZ6MEvELTHHtQZSXCRGCymvkZwhDDt,True,41666805,5267491,32709,16354,16355,A9TwRM1BMxqb8DCC7YNAMV6zPenEJm3HTZBy7wJKK58U,2587370,7845009,-5257639,620
2022-04-06 13:05:28-04:00,14727,7AizMrxWWr7qfneuXMy6ifL3BVDTAKkuud4PyZFy92kh,GyAWRRfQkVAXtyhVF14vU3kPMr4kG1VyA9FAHdDTr8ud,True,722301711,180575427,1118964,559482,559482,3zqXX6kzhkbW3d4TwD2CNjMRwxTbREXySekvq37kfCNk,44758582,74702497,-29943915,619
2022-04-06 13:05:42-04:00,14728,2xgQaQTs7bkK34jSBZ2dFZf1DJKjMVW9LA3D9Pwtfims,6rniSBeGcJAcrqWhhnKCcRV58yYnjuqXj9b4Zu8DUwQ9,True,42763550,10165890,63463,31731,31732,72FwbpFGoLEazJEdpqNtPNefsadUrimUqma9wSoy4qiS,2669651,8703538,-6033887,624
2022-04-06 13:06:23-04:00,14729,JABfWoDV2wW68XEDANXArYWM7zabdbp5NBVrvzZd3mML,5hYUtd1Uv2pAcrbtSNNVTrRuk8acjmh92mzSm4iz5HJA,True,117746730,15838454,98587,49293,49294,YQC4EUcgeBi9431viwvzvBbZJW3szeHX4dFmowRDyDw,7329261,20388923,-13059662,622
2022-04-06 13:06:26-04:00,14730,5yPGvUz6JWKjkViGwTCpygJii1rP2xv5yx146ULtBiYq,FMnHUCQWTf1UHu5qVFqUAsWh8aba9EQYTEoiXy55totD,True,1092344282,101487104,633240,316620,316620,3zqXX6kzhkbW3d4TwD2CNjMRwxTbREXySekvq37kfCNk,68158153,207306002,-139147849,623
2022-04-06 13:06:28-04:00,14731,8qq2gfbca7JXvq4gViBBVT2QAbM4MvBMEQLXgn8UUTvt,3o5jpBVYdFFEYrGRdCUkLrUC85wsuTKgy8iYwnpZyC1B,True,1658307655,163290927,1008723,504361,504362,3zqXX6kzhkbW3d4TwD2CNjMRwxTbREXySekvq37kfCNk,102441284,617725583,-515284299,617
2022-04-06 13:06:35-04:00,14732,5F7WHSYiVtCY8Z9KX9h6AT8qr4hbsSYasG15fq82ZWhr,E5wj8cqKM1ofNv14TspTa8yRwern8y2w6pXekL4cAWX7,True,70539999,17634999,105798,52899,52899,YQC4EUcgeBi9431viwvzvBbZJW3szeHX4dFmowRDyDw,4231940,8677061,-4445121,599
2022-04-06 13:06:36-04:00,14733,F2AU2PjaSmHxWWhkz8XxMggkCMWbMVgawt89tSnYS6RL,ET9febRJiW197DYMaJbgk3kWsAeFv5f4peQ4vFCVppK6,True,21014367,5253591,37406,18703,18703,3zqXX6kzhkbW3d4TwD2CNjMRwxTbREXySekvq37kfCNk,1496263,8322808,-6826545,712
2022-04-06 13:10:34-04:00,14734,D85pWm1LS9MvtR4f3QhkFLvNUhZLQ2NZBFQTyAVnmigm,CRN85DYkJJi6irhtVAf4qcJU3ijVodWdXgWe7Fs6Ahka,True,373083419,46765495,292214,146107,146107,3zqXX6kzhkbW3d4TwD2CNjMRwxTbREXySekvq37kfCNk,23312179,80078320,-56766141,624
2022-04-06 13:11:23-04:00,14735,EHLV9s6E1s5SUbzZVzsGWH2vVRGHyxynM4GDJtfKEuYe,4hAx9osegpeocSSmJbMVBYMKCwo5WY3QVJuK7cuzz4b4,True,30952244,7738061,55077,27538,27539,YQC4EUcgeBi9431viwvzvBbZJW3szeHX4dFmowRDyDw,2203109,12231956,-10028847,711
2022-04-06 13:11:23-04:00,14736,GCweck6iuscBsVbXW9ZYfMytdgwSYWwNifTWLaUbaSmA,6HwGWKGduMGvLnHmTJo6ZioZ3EMUZYHo2pG4tBFXgB4Y,True,30913879,7728469,53936,26968,26968,YQC4EUcgeBi9431viwvzvBbZJW3szeHX4dFmowRDyDw,2157451,12224542,-10067091,697
2022-04-06 13:12:01-04:00,14737,5FewDaMC9U7n5EHcto98GaAmDVxDh5SYimuTP6AtfakM,7DAULUoqV7f9hsBzKEhjQPnWaHSqiMWcBqWcdcadaQv4,True,1887163656,238507198,1490541,745270,745271,3zqXX6kzhkbW3d4TwD2CNjMRwxTbREXySekvq37kfCNk,117937576,228892810,-110955234,624
2022-04-06 13:12:31-04:00,14738,DVMLxFACqaNBD7q1TGJUUApJX7etJsxQRRFBP2DfBazJ,4hnRjD7S2KxD7UrgfrApntVxUD7Srh5E9nwPY53v89kz,True,290928801,29218133,188933,94466,94467,3zqXX6kzhkbW3d4TwD2CNjMRwxTbREXySekvq37kfCNk,18812416,61901147,-43088731,646
2022-04-06 13:12:38-04:00,14739,7CSCMFa9W52tBDVUbXbc3woAy3GByeA1wPJdp3MgznPa,3447ptuVFu6G8B6N63RmS8mRv4n9PfHneypHLvbeaGLn,True,2567291876,428232343,2653268,1326634,1326634,YQC4EUcgeBi9431viwvzvBbZJW3szeHX4dFmowRDyDw,159065867,472602162,-313536295,619
2022-04-06 13:12:57-04:00,14740,5yPGvUz6JWKjkViGwTCpygJii1rP2xv5yx146ULtBiYq,FMnHUCQWTf1UHu5qVFqUAsWh8aba9EQYTEoiXy55totD,True,984876341,85636499,535134,267567,267567,3zqXX6kzhkbW3d4TwD2CNjMRwxTbREXySekvq37kfCNk,61544076,193649571,-132105495,624
2022-04-06 13:13:12-04:00,14741,2NQ897mWoc9mBoxsVdEaYNpwPyy83KUrTkizRBZQPbEq,2QpX34D9y2WVGcCkbRgjkADpR313NqRbTr5pAVXvSjqz,True,496545780,124136445,774107,387053,387054,3zqXX6kzhkbW3d4TwD2CNjMRwxTbREXySekvq37kfCNk,30964285,98401496,-67437211,623
2022-04-06 14:02:52-04:00,14742,DXGapgtgkag6midSCYNhHCNaCqvhUmuSvnVhXxNXBmyt,Csq6W5QkGZL6qE6Z1ERF3bfHtKjnM8hAxiY1YA3rTwSX,True,4011051799,1002762949,6263584,3131792,3131792,3zqXX6kzhkbW3d4TwD2CNjMRwxTbREXySekvq37kfCNk,250543374,386820027,-136276653,624
2022-04-06 14:15:35-04:00,14743,niCk6QHFU1kyU56Mdq5RJzKrecdkNSn23ZA6wduFdWS,BQbUYSw1XsuE6LnVd4XjmxAyYgx4drE4FsetJBCdwVZW,True,991728695,247821075,1518285,759142,759143,3zqXX6kzhkbW3d4TwD2CNjMRwxTbREXySekvq37kfCNk,60758672,105343924,-44585252,612
2022-04-06 14:24:15-04:00,14744,2ssYxbmFPYBdse9a6NJ26M8hsscYpjv5MyqyYkjftdrL,FKvvXz9eYXW2zgy37eaUW9u2K9LnnDsNx3DcgtATpizY,True,201025914,50256478,311943,155971,155972,3zqXX6kzhkbW3d4TwD2CNjMRwxTbREXySekvq37kfCNk,12477745,28982907,-16505162,620
2022-04-06 14:24:32-04:00,14745,FncFHJooh1hy9Gc2y5sKdcYkZ5uHzsxHG4vHT9cVZGcK,BkFa4b5Jyv4ZJCCpwDYv355ezVFiZfAtn18AV7kstd2v,True,3478112122,869528030,5382946,2691473,2691473,3zqXX6kzhkbW3d4TwD2CNjMRwxTbREXySekvq37kfCNk,215317861,360488687,-145170826,619
2022-04-06 14:24:40-04:00,14746,EVzAZ7gH1v4VtRXiTdNnkp2PGS3W4M5PkSXGMDyLwUmC,2FkTeSCVRjNE5i9qRnKLZjBGsXL2sWEurxLERYo1cQsd,True,239906821,59976705,369173,184586,184587,3zqXX6kzhkbW3d4TwD2CNjMRwxTbREXySekvq37kfCNk,14766946,24684270,-9917324,615
2022-04-06 14:24:47-04:00,14747,FFDTcCW6UXKpkMnCefTRLpF8ZkJtS4sbGTjkcNU31Pxh,9v5oBZNrx4EATT8iHT5wNRJSo2rRPpazAYvPeaNe2Tpc,True,652693934,81732668,571758,285879,285879,YQC4EUcgeBi9431viwvzvBbZJW3szeHX4dFmowRDyDw,45659033,135821600,-90162567,699
2022-04-06 14:25:01-04:00,14748,8K1GzGeaAuFdjuVZi6DqBcYiA1zSRioMkRvjotr8p7fz,5mqocPwTdjwAPiJf7vx9bo7AzvfQBT2t5bV9u2Jzb2e1,True,463690153,115922538,781309,390654,390655,3zqXX6kzhkbW3d4TwD2CNjMRwxTbREXySekvq37kfCNk,31252378,98626343,-67373965,673
2022-04-06 14:25:04-04:00,14749,FU7X4DWnGTbxwXULBq3v9SACzYhQyFGqsXjUDzyFqiem,925BaEnWxTfEv4oQb9Xf1wyyEEWEr8kXeSdXTtRfShfw,True,40525777510,2747810107,17162830,8581415,8581415,3zqXX6kzhkbW3d4TwD2CNjMRwxTbREXySekvq37kfCNk,2531241327,5563539040,-3032297713,624
2022-04-06 18:14:24-04:00,14750,niCk6QHFU1kyU56Mdq5RJzKrecdkNSn23ZA6wduFdWS,BQbUYSw1XsuE6LnVd4XjmxAyYgx4drE4FsetJBCdwVZW,True,817011928,204237304,1249111,624555,624556,3zqXX6kzhkbW3d4TwD2CNjMRwxTbREXySekvq37kfCNk,49968285,92487214,-42518929,611
2022-04-06 18:59:27-04:00,14751,AwT3pH9dHjECDnuUiazbD6tZxZHdNwgJ4vBMmxLHMiLo,AjybksvjMT1QT6KvryXCG47pQGT8v9jxM34VkveGPQrs,True,25656876,6414219,39703,19851,19852,A9TwRM1BMxqb8DCC7YNAMV6zPenEJm3HTZBy7wJKK58U,1588147,3811582,-2223435,618
2022-04-06 18:59:38-04:00,14752,niCk6QHFU1kyU56Mdq5RJzKrecdkNSn23ZA6wduFdWS,BQbUYSw1XsuE6LnVd4XjmxAyYgx4drE4FsetJBCdwVZW,True,601647895,150396599,939774,469887,469887,YQC4EUcgeBi9431viwvzvBbZJW3szeHX4dFmowRDyDw,37594875,80638954,-43044079,624
2022-04-06 18:59:57-04:00,14753,6RuQVU9nu2Ecp177M9ggWczLACvQ8PfT31RTcmfwe9Hq,DZgsgqvMNLTXkBxySZC7Monak2JGsXRMJT4hBQzpf6Xm,True,7808246712,1952061678,12083670,6041835,6041835,YQC4EUcgeBi9431viwvzvBbZJW3szeHX4dFmowRDyDw,483346825,770024035,-286677210,619
2022-04-06 19:00:00-04:00,14754,JABfWoDV2wW68XEDANXArYWM7zabdbp5NBVrvzZd3mML,5hYUtd1Uv2pAcrbtSNNVTrRuk8acjmh92mzSm4iz5HJA,True,101008709,13459204,83948,41974,41974,3zqXX6kzhkbW3d4TwD2CNjMRwxTbREXySekvq37kfCNk,6300164,18805769,-12505605,623
2022-04-06 19:00:13-04:00,14755,C3DnHRyndQw1EinnmrayLzuhP9KhXYKVDUpf55BumxG1,6aU3EvNk5CyD5LdGhQksYKkNxvJ5vw23JvMEdwqeDSMo,True,6844490417,1711122604,10681424,5340712,5340712,3zqXX6kzhkbW3d4TwD2CNjMRwxTbREXySekvq37kfCNk,427256978,1746805447,-1319548469,624
2022-04-06 19:06:23-04:00,14756,7tFD53kPTqrzjCu1Wji78gUqhoRtCUhsP1pM3DQKT7uG,BJvgPLYBDJrQJdQVowrsMwUGMurq4zTihoFwWoEokfu3,True,7572002387,1276943138,7903198,3951599,3951599,3zqXX6kzhkbW3d4TwD2CNjMRwxTbREXySekvq37kfCNk,468642979,1247022610,-778379631,618
2022-04-06 19:06:40-04:00,14757,7yW1M1xeVx4hy3QftnpqdBDRYwamfu3K5i6AEnxgyTWb,7wf7FWS2DYp5RveQAmGNXAEUWPcHziuMLd4hV5LPgxF8,True,16450832,4112708,25477,12738,12739,A9TwRM1BMxqb8DCC7YNAMV6zPenEJm3HTZBy7wJKK58U,1019109,3552644,-2533535,619
2022-04-06 19:08:49-04:00,14758,EN2YBXcj7E1eAaYJYXJjc6Rfsu6Awjgv9kN3bT3uiprp,HYDG5mqfCy2xwrYKixNzoWyDiqb9KbpnA8H3TQG2EDDG,True,331866625,82966561,516683,258341,258342,YQC4EUcgeBi9431viwvzvBbZJW3szeHX4dFmowRDyDw,20667396,70127939,-49460543,622
2022-04-06 19:38:34-04:00,14759,CZhzJ91hP1pFbNNz7YnUKXznvs6ZFVSRNLbe1SaTw29o,X3B4LpHFfeJPmCnEmRQ8V6MNMi7KpTE4MLD7LHYXUwy,True,296653204,26327012,164407,82203,82204,YQC4EUcgeBi9431viwvzvBbZJW3szeHX4dFmowRDyDw,18525544,49121851,-30596307,624
2022-04-06 19:42:02-04:00,14760,6eEifGxGRBnXV5EW2BwmCj8pa67znMjet98Nsq11LCsd,Dd4UCEX7tm6Q82SdSSFX9wBcJNw5TwKu8EyGjvxi9FVc,True,652891887,163222971,1013035,506517,506518,YQC4EUcgeBi9431viwvzvBbZJW3szeHX4dFmowRDyDw,40521409,110457446,-69936037,620
2022-04-06 19:42:16-04:00,14761,GeYsENPRf2qGZu9rJsi6UPQqHS6sR7LRLWsKbFgtMCSb,7A79wktqPkSpP7o4c1kP9CBpUibHTqycW81ZANgREc5S,True,104534100,26133525,161208,80604,80604,3zqXX6kzhkbW3d4TwD2CNjMRwxTbREXySekvq37kfCNk,6448359,21975341,-15526982,616
2022-04-06 19:42:51-04:00,14762,67DwuUmzk6uGwmptjYErQssFeJ5fd1ztFwKWZUovr7pK,HKzc15e1QLBrSsbAENyMXSVHDoap1F5MHCHB9L1Dm8HA,True,201300732,50325183,302563,151281,151282,3zqXX6kzhkbW3d4TwD2CNjMRwxTbREXySekvq37kfCNk,12102540,47405320,-35302780,601
2022-04-06 19:42:52-04:00,14763,AyFWvQUX79sq8L7KhcYrPRbxd6whUvEMETZL8atuuRr2,9LTjofdhGLn2Ltv6XfuHtX8MKEPzScGL669pC8Lrgtnh,True,24135150,6033787,36337,18168,18169,YQC4EUcgeBi9431viwvzvBbZJW3szeHX4dFmowRDyDw,1453492,4975914,-3522422,602
2022-04-06 19:42:54-04:00,14764,8nFpzAFXELGPsrgFwRjTfUidNme1CvgKQTsHWATtMqkz,ABt8ikXHraZ1bqkDUvMtJ3AUzADDWcCL8kMMDpAoth8V,True,38919690,9729922,58632,29316,29316,3zqXX6kzhkbW3d4TwD2CNjMRwxTbREXySekvq37kfCNk,2345286,9950407,-7605121,602
2022-04-06 19:42:54-04:00,14765,5YC2wXkdk7D4Ubs9TEAbP1hi88Sy35bzYVWjLbgVxn5s,4Mx69ezqFK2wudZ62oVhx2pwjVbKv8JB1HR29ZUcdEJb,True,2911014674,727753668,4450366,2225183,2225183,3zqXX6kzhkbW3d4TwD2CNjMRwxTbREXySekvq37kfCNk,178014664,360979203,-182964539,611
2022-04-06 19:42:56-04:00,14766,FV9CBGGTbppLnBKh79f2LzD1diTiS5g6u89FcpZHZmnK,Fe7mtmCUziFqbbYTvrhAcAq1Ub7YLfTJRtQ1hG7GzJD1,True,27110835,6777708,41877,20938,20939,3zqXX6kzhkbW3d4TwD2CNjMRwxTbREXySekvq37kfCNk,1675119,4534322,-2859203,617
2022-04-06 19:45:50-04:00,14767,29JVska5UEG3axs63EmtHpPvkswNEqYpZ3PKMSfupiAG,DCftNBUsuogxyaJe9G9m3eWipH6o3qo4Rn4TuQXdVaBF,False,14322491,14322491,873233,43661,829572,3zqXX6kzhkbW3d4TwD2CNjMRwxTbREXySekvq37kfCNk,873233,3765549,-2892316,609
2022-04-06 19:45:50-04:00,14768,EBRWnRzoNv5RytEjgrs5TXdiCMApLKHMntJJJzehJJns,5nJiYTa3GEbmaRwY1PvBJ1teXikQKgbUop5ANgaDhhcP,True,30849257,7712314,46422,23211,23211,3zqXX6kzhkbW3d4TwD2CNjMRwxTbREXySekvq37kfCNk,1856916,5811978,-3955062,601
2022-04-06 19:45:53-04:00,14769,4GbUrgiR6A91h3J9HHpuYCkZzjwrb62n3BURLeWj6Nic,12nUFUGYF1rXbwPeCbdGKdP3RE4g984fmZZggEYSFTZn,True,112517279,28129319,172450,86225,86225,3zqXX6kzhkbW3d4TwD2CNjMRwxTbREXySekvq37kfCNk,6898022,29018532,-22120510,613
2022-04-06 19:45:59-04:00,14770,9WH1YzDrdvZs8aDuFLwQHHXa2e66ZcwdfDi7qXEjQxFy,3Tpc8DqJwg1tTDgk6qH1UhvtwvhXxsp5GRFYMWxa8NKX,True,4758524000,1189631000,7381482,3690741,3690741,47z82br5WdW2DZajdnPDPSSRRKsyAggqXqK6oPUwTaLf,295259297,780164224,-484904927,620
2022-04-06 19:46:00-04:00,14771,2i5g7q4gD1GEfSz8BkhKn1idQ5U7cFPbMDWugjr7bBQW,Dpx6K9G5uZD63rTzBafZ56WKd1X9M25Mzfppd7Jib4xn,True,2638180487,659545121,4025603,2012801,2012802,A9TwRM1BMxqb8DCC7YNAMV6zPenEJm3HTZBy7wJKK58U,161024151,699518546,-538494395,610
2022-04-06 19:46:03-04:00,14772,eiLMepBYM3VcWarQJC9fTnxotyMuUTbyMGJECedPEfu,k2ZfwPNBBCK7PvZ6MEvELTHHtQZSXCRGCymvkZwhDDt,True,36093002,5063400,31427,15713,15714,A9TwRM1BMxqb8DCC7YNAMV6zPenEJm3HTZBy7wJKK58U,2240230,7427180,-5186950,620
2022-04-06 19:46:25-04:00,14773,5FewDaMC9U7n5EHcto98GaAmDVxDh5SYimuTP6AtfakM,7DAULUoqV7f9hsBzKEhjQPnWaHSqiMWcBqWcdcadaQv4,True,1634187560,231709403,1441183,720591,720592,3zqXX6kzhkbW3d4TwD2CNjMRwxTbREXySekvq37kfCNk,101643049,215056230,-113413181,621
2022-04-06 19:46:27-04:00,14774,EDzP8bi8wGytnFoz4RynYddWyVWd5RFhHKcGZdwyAHJH,ELHWRXKjwkmoEj3nkJ9hw2bcL6dRd4znFeoLjitNbrXt,True,56471694,14117923,87997,43998,43999,3zqXX6kzhkbW3d4TwD2CNjMRwxTbREXySekvq37kfCNk,3519892,12977981,-9458089,623
2022-04-06 19:46:33-04:00,14775,3uUdWwgwtFdPa3FJTSrirqPKMtQb3zmT5Wpp4zPy9sJP,5G7dhz8jvWekGy9Wh3ZCXNXSPbB1QArfFYs7MYNgRDkW,True,237694188,59423547,370579,185289,185290,3zqXX6kzhkbW3d4TwD2CNjMRwxTbREXySekvq37kfCNk,14823181,67745534,-52922353,623
2022-04-06 19:46:49-04:00,14776,DVMLxFACqaNBD7q1TGJUUApJX7etJsxQRRFBP2DfBazJ,4hnRjD7S2KxD7UrgfrApntVxUD7Srh5E9nwPY53v89kz,True,260087004,23690394,153695,76847,76848,3zqXX6kzhkbW3d4TwD2CNjMRwxTbREXySekvq37kfCNk,16873597,59162414,-42288817,648
2022-04-06 19:46:55-04:00,14777,BTq6T9nDzYTPTRvxkhNLn82DF3RCWdRkatZUmSTGCu43,3Uuhmxo4tWMbrqowx2bQSJeWzMykUUcZanj29ptCmEa6,True,6944328243,1420222385,8853260,4426630,4426630,3zqXX6kzhkbW3d4TwD2CNjMRwxTbREXySekvq37kfCNk,432889598,1432337437,-999447839,623
2022-04-06 19:49:24-04:00,14778,FoGtu9wcVbBmATBKtBMWvbRd558yzSDT5dPBTBJgzqFT,9rnvQvgQtkT7RSdDpZHnkTVd2V9CMRBSB7v79GDip4hS,True,323851073,80962768,502185,251092,251093,3zqXX6kzhkbW3d4TwD2CNjMRwxTbREXySekvq37kfCNk,20087422,53600983,-33513561,620
2022-04-06 19:50:56-04:00,14779,2xgQaQTs7bkK34jSBZ2dFZf1DJKjMVW9LA3D9Pwtfims,6rniSBeGcJAcrqWhhnKCcRV58yYnjuqXj9b4Zu8DUwQ9,True,31998251,7475795,46701,23350,23351,YQC4EUcgeBi9431viwvzvBbZJW3szeHX4dFmowRDyDw,1998955,7133796,-5134841,624
2022-04-06 19:51:42-04:00,14780,8qq2gfbca7JXvq4gViBBVT2QAbM4MvBMEQLXgn8UUTvt,3o5jpBVYdFFEYrGRdCUkLrUC85wsuTKgy8iYwnpZyC1B,True,1480175574,125617406,783825,391912,391913,3zqXX6kzhkbW3d4TwD2CNjMRwxTbREXySekvq37kfCNk,92359835,611478448,-519118613,623
2022-04-06 19:52:09-04:00,14781,DDdxcAmfFWLs79vYC1WUuwBVM1XUfxmAgbYgccL5bgZg,3tKaUfHU3Z7v1LDm581yDd1bpfnxLgGHCWTNur3KLptz,True,2046857707,511714426,3053015,1526507,1526508,YQC4EUcgeBi9431viwvzvBbZJW3szeHX4dFmowRDyDw,122120601,411762789,-289642188,596
2022-04-06 19:52:10-04:00,14782,HAYyyvAkeSMiGinBzRCDmetVFE7ySzdeUSw3zJ2RoBPL,G5sNGj5DdYCpcfERmSbXAcaueXHEJKZTQ3YyVJdcHKwd,True,13435549457,3358887364,20411251,10205625,10205626,YQC4EUcgeBi9431viwvzvBbZJW3szeHX4dFmowRDyDw,816450061,3131028090,-2314578029,607
2022-04-06 19:52:13-04:00,14783,6Auz7aARPERW9zbV8428yFUWkA9DuitQYiWQzewueU3o,G1xfLGt5twz7MTfEq6NnMZBpr6GmXceKdGUQkc9jugRB,True,27775372,6943843,41396,20698,20698,YQC4EUcgeBi9431viwvzvBbZJW3szeHX4dFmowRDyDw,1655875,7236288,-5580413,596
2022-04-06 19:52:33-04:00,14784,68zbVKnneMQqngbNkeLtPEP2ayNhawc1B2hPgqAEqgXK,HqiFpLr4NC7xJz9bEFusq8bCKaoxAQG1xsLxdUAzg8aa,True,14068156782,2321195715,14456515,7228257,7228258,YQC4EUcgeBi9431viwvzvBbZJW3szeHX4dFmowRDyDw,876171434,1971143509,-1094972075,622
2022-04-06 19:52:40-04:00,14785,GgJXh5hTo4xyVuuGEis971RRXcZECLpjvtMSCZtVu13Q,9BGMfGfMZNXdcygAuqYQudWHhSE5LqVoWsNsruCawnRK,True,40975535,10243883,63106,31553,31553,3zqXX6kzhkbW3d4TwD2CNjMRwxTbREXySekvq37kfCNk,2524245,5071400,-2547155,616
2022-04-06 19:53:14-04:00,14786,A5NXadGWnFZRoHEn1dKTRjcXgWmfMLMyJdpF4rQPZyRR,ALs3Zfotc4c4A6TFDMbd5GM5whK1dTYSnGrHiMBWmApH,True,3023054218,755762972,4684115,2342057,2342058,3zqXX6kzhkbW3d4TwD2CNjMRwxTbREXySekvq37kfCNk,187364788,820944813,-633580025,619
2022-04-06 19:53:36-04:00,14787,Gp1V4ymYEQH9jeZsqPERVfwqoQYUPESUmgKCMaDqoh6u,BBe1Vd8RZuqqC7VkUixgMYA1CfLXMaEvq8J571j8ueMQ,True,2873628849,718407212,4335539,2167769,2167770,3zqXX6kzhkbW3d4TwD2CNjMRwxTbREXySekvq37kfCNk,173421572,528661844,-355240272,603
2022-04-06 19:54:32-04:00,14788,BTwSuuDHNhQAFAzBZRWev5j1ix2RTWvjZAxLpw8grAxu,31NCyUpSXxxJYLSrdK3c5bLomUtMejobMfYnq7j71GtM,True,495932131,123983032,774567,387283,387284,YQC4EUcgeBi9431viwvzvBbZJW3szeHX4dFmowRDyDw,30982690,92325105,-61342415,624
2022-04-06 19:54:40-04:00,14789,5yPGvUz6JWKjkViGwTCpygJii1rP2xv5yx146ULtBiYq,FMnHUCQWTf1UHu5qVFqUAsWh8aba9EQYTEoiXy55totD,True,894175316,84279480,524978,262489,262489,YQC4EUcgeBi9431viwvzvBbZJW3szeHX4dFmowRDyDw,55698348,181584948,-125886600,622
2022-04-06 19:55:25-04:00,14790,niCk6QHFU1kyU56Mdq5RJzKrecdkNSn23ZA6wduFdWS,BQbUYSw1XsuE6LnVd4XjmxAyYgx4drE4FsetJBCdwVZW,True,440156600,110024091,639280,319640,319640,3zqXX6kzhkbW3d4TwD2CNjMRwxTbREXySekvq37kfCNk,25574733,68968142,-43393409,581
2022-04-06 19:56:45-04:00,14791,C3DnHRyndQw1EinnmrayLzuhP9KhXYKVDUpf55BumxG1,6aU3EvNk5CyD5LdGhQksYKkNxvJ5vw23JvMEdwqeDSMo,True,5029101867,1257275466,7807740,3903870,3903870,3zqXX6kzhkbW3d4TwD2CNjMRwxTbREXySekvq37kfCNk,312309608,1406632702,-1094323094,621
2022-04-06 19:56:49-04:00,14792,7yW1M1xeVx4hy3QftnpqdBDRYwamfu3K5i6AEnxgyTWb,7wf7FWS2DYp5RveQAmGNXAEUWPcHziuMLd4hV5LPgxF8,False,12096150,12096150,751658,37582,714076,3zqXX6kzhkbW3d4TwD2CNjMRwxTbREXySekvq37kfCNk,751658,2893786,-2142128,621
2022-04-06 20:46:26-04:00,14793,9cwVnc8zu2wjSnvFuxPddMXSrgNajdn3sZH1qAtQQ8aQ,9xaYkDvEyDmAkWDhhZma9mLbUeB7BkLWtveDsagfJDVa,True,2649296119,662324029,4124105,2062052,2062053,3zqXX6kzhkbW3d4TwD2CNjMRwxTbREXySekvq37kfCNk,164964226,515672909,-350708683,622
2022-04-06 20:50:45-04:00,14794,2yH4iJWVSDWHGjm5J95sbsRbHGA81VNPaox8xz8DWQaG,EHUYNPTqdUDGi3TBrr5BjDByCzLKq27CECCFUNyGRbQR,True,2499392608,624848152,3858827,1929413,1929414,3zqXX6kzhkbW3d4TwD2CNjMRwxTbREXySekvq37kfCNk,154353118,333833884,-179480766,617
2022-04-06 20:50:56-04:00,14795,CVjkHr29t8pzeXU1U1CdMpT6qwf9Jw4XGxvxU7RURPYj,D66Zpxp7q4Tn4KiLa2pHTrADhgtP8tGqNXVPyCo9mcxc,True,253919806,39097761,243915,121957,121958,3zqXX6kzhkbW3d4TwD2CNjMRwxTbREXySekvq37kfCNk,15841042,42114369,-26273327,623
2022-04-06 20:51:56-04:00,14796,GRqv7y5n92vQ7bXcBqUng4vaau6w1tQeou953s8kJNwD,Bk75oioYmUzfdpbxDHTFb2nWhJgNqAt8ud1ehem3VVhh,True,3281470144,820367536,4987895,2493947,2493948,YQC4EUcgeBi9431viwvzvBbZJW3szeHX4dFmowRDyDw,199515822,472864416,-273348594,608
2022-04-06 20:52:08-04:00,14797,6eEifGxGRBnXV5EW2BwmCj8pa67znMjet98Nsq11LCsd,Dd4UCEX7tm6Q82SdSSFX9wBcJNw5TwKu8EyGjvxi9FVc,True,480066357,120016589,746956,373478,373478,3zqXX6kzhkbW3d4TwD2CNjMRwxTbREXySekvq37kfCNk,29878241,91936175,-62057934,622
2022-04-06 20:52:19-04:00,14798,CZhzJ91hP1pFbNNz7YnUKXznvs6ZFVSRNLbe1SaTw29o,X3B4LpHFfeJPmCnEmRQ8V6MNMi7KpTE4MLD7LHYXUwy,True,268670702,24844129,154357,77178,77179,A9TwRM1BMxqb8DCC7YNAMV6zPenEJm3HTZBy7wJKK58U,16692642,47095551,-30402909,621
2022-04-06 20:52:33-04:00,14799,7BEY9qatFJomsayFmky3h3dAbKhY5XkRGwMobJuxXYhQ,J8MK3tAQKreBUG2reXY6gqr1uhbHhcAZEcxsLQmG5Ntt,True,5454037827,1363509456,9690795,4845397,4845398,3zqXX6kzhkbW3d4TwD2CNjMRwxTbREXySekvq37kfCNk,387631831,885765536,-498133705,710
2022-04-06 20:52:34-04:00,14800,GoV8U9c4hjCjeosW1VKsDuRTfUe96sUPAC5RyUbstpUt,D6Y51Trnouo1KiFyyEGGS6QMShbnNN8NretZM8b9y3LT,True,874803108,218700777,1468950,734475,734475,YQC4EUcgeBi9431viwvzvBbZJW3szeHX4dFmowRDyDw,58758001,202207207,-143449206,671
2022-04-06 20:52:48-04:00,14801,7tFD53kPTqrzjCu1Wji78gUqhoRtCUhsP1pM3DQKT7uG,BJvgPLYBDJrQJdQVowrsMwUGMurq4zTihoFwWoEokfu3,True,6223315807,946118098,5909532,2954766,2954766,3zqXX6kzhkbW3d4TwD2CNjMRwxTbREXySekvq37kfCNk,388713550,1105932917,-717219367,624
2022-04-06 20:53:03-04:00,14802,5FewDaMC9U7n5EHcto98GaAmDVxDh5SYimuTP6AtfakM,7DAULUoqV7f9hsBzKEhjQPnWaHSqiMWcBqWcdcadaQv4,True,1385820205,173875975,1047806,523903,523903,3zqXX6kzhkbW3d4TwD2CNjMRwxTbREXySekvq37kfCNk,83511948,196318718,-112806770,602
2022-04-06 20:53:05-04:00,14803,JABfWoDV2wW68XEDANXArYWM7zabdbp5NBVrvzZd3mML,5hYUtd1Uv2pAcrbtSNNVTrRuk8acjmh92mzSm4iz5HJA,True,86740050,11648236,72563,36281,36282,A9TwRM1BMxqb8DCC7YNAMV6zPenEJm3HTZBy7wJKK58U,5403567,16768437,-11364870,622
2022-04-06 20:53:05-04:00,14804,GeYsENPRf2qGZu9rJsi6UPQqHS6sR7LRLWsKbFgtMCSb,7A79wktqPkSpP7o4c1kP9CBpUibHTqycW81ZANgREc5S,True,76846763,19211690,118222,59111,59111,A9TwRM1BMxqb8DCC7YNAMV6zPenEJm3HTZBy7wJKK58U,4728912,17928050,-13199138,615
2022-04-06 20:53:09-04:00,14805,eiLMepBYM3VcWarQJC9fTnxotyMuUTbyMGJECedPEfu,k2ZfwPNBBCK7PvZ6MEvELTHHtQZSXCRGCymvkZwhDDt,True,30731164,3925806,24387,12193,12194,3zqXX6kzhkbW3d4TwD2CNjMRwxTbREXySekvq37kfCNk,1909109,6371291,-4462182,621
2022-04-06 20:53:15-04:00,14806,7AizMrxWWr7qfneuXMy6ifL3BVDTAKkuud4PyZFy92kh,GyAWRRfQkVAXtyhVF14vU3kPMr4kG1VyA9FAHdDTr8ud,True,530677070,132669267,808960,404480,404480,3zqXX6kzhkbW3d4TwD2CNjMRwxTbREXySekvq37kfCNk,32358432,65874112,-33515680,609
2022-04-06 20:53:15-04:00,14807,7CSCMFa9W52tBDVUbXbc3woAy3GByeA1wPJdp3MgznPa,3447ptuVFu6G8B6N63RmS8mRv4n9PfHneypHLvbeaGLn,True,2114717464,318038617,1975018,987509,987509,3zqXX6kzhkbW3d4TwD2CNjMRwxTbREXySekvq37kfCNk,131323840,421106393,-289782553,620
2022-04-06 20:53:20-04:00,14808,6K1Xww22wVZuBwP6oYb3DPR5GvdxsQSiZ4WSmejQjyqf,8RoFHjv1TkGFqjKoSwzvyRNMoBP1ma1Hi2jy6FzD4i2g,True,184939530,44168090,273459,136729,136730,YQC4EUcgeBi9431viwvzvBbZJW3szeHX4dFmowRDyDw,11450249,21982655,-10532406,619
2022-04-06 20:53:21-04:00,14809,67DwuUmzk6uGwmptjYErQssFeJ5fd1ztFwKWZUovr7pK,HKzc15e1QLBrSsbAENyMXSVHDoap1F5MHCHB9L1Dm8HA,True,148461474,37115368,231933,115966,115967,YQC4EUcgeBi9431viwvzvBbZJW3szeHX4dFmowRDyDw,9277343,38268843,-28991500,624
2022-04-06 20:53:25-04:00,14810,FFDTcCW6UXKpkMnCefTRLpF8ZkJtS4sbGTjkcNU31Pxh,9v5oBZNrx4EATT8iHT5wNRJSo2rRPpazAYvPeaNe2Tpc,True,566293333,81895094,580560,290280,290280,3zqXX6kzhkbW3d4TwD2CNjMRwxTbREXySekvq37kfCNk,40144968,128156429,-88011461,708
2022-04-06 20:53:38-04:00,14811,5yPGvUz6JWKjkViGwTCpygJii1rP2xv5yx146ULtBiYq,FMnHUCQWTf1UHu5qVFqUAsWh8aba9EQYTEoiXy55totD,True,804981125,75093643,468636,234318,234318,3zqXX6kzhkbW3d4TwD2CNjMRwxTbREXySekvq37kfCNk,50236413,168882938,-118646525,624
2022-04-06 20:53:45-04:00,14812,5F7WHSYiVtCY8Z9KX9h6AT8qr4hbsSYasG15fq82ZWhr,E5wj8cqKM1ofNv14TspTa8yRwern8y2w6pXekL4cAWX7,True,51955085,12988771,78835,39417,39418,3zqXX6kzhkbW3d4TwD2CNjMRwxTbREXySekvq37kfCNk,3153424,7437264,-4283840,606
2022-04-06 20:54:45-04:00,14813,CZ1snuuBhno2SqfAmMLzEEQhrsH2reAmZrGhFVsydvHD,F4Hj3jxxE8W8TbgpvjRLnrQ1Jdd28ZKTPNyu1h9BnLiH,True,1920724417,480181104,2978934,1489467,1489467,3zqXX6kzhkbW3d4TwD2CNjMRwxTbREXySekvq37kfCNk,119157381,197727987,-78570606,620
2022-04-06 20:54:46-04:00,14814,1EH82ta3wXUyUwW8VWQnVzSG3r1rHcSj2DvDeTKmp3F,B6aMfucYPbCzWBtauLtgTpwR45wKSK8yqscHJR3F5usu,True,1208449870,154524530,958842,479421,479421,3zqXX6kzhkbW3d4TwD2CNjMRwxTbREXySekvq37kfCNk,74985695,26739086,48246609,620
2022-04-06 20:54:47-04:00,14815,AyFWvQUX79sq8L7KhcYrPRbxd6whUvEMETZL8atuuRr2,9LTjofdhGLn2Ltv6XfuHtX8MKEPzScGL669pC8Lrgtnh,True,17789898,4447474,27616,13808,13808,YQC4EUcgeBi9431viwvzvBbZJW3szeHX4dFmowRDyDw,1104664,4057951,-2953287,620
2022-04-06 20:55:23-04:00,14816,H1oYXGZTagwv48FdDe6RNkjNaesedqLKyXxTmPc5k4Fp,Am3rx6XrkrZ4MdeZDyZUv1YW2fBujcz4dLjVCnRQHKZa,True,30968606,7742151,48379,24189,24190,YQC4EUcgeBi9431viwvzvBbZJW3szeHX4dFmowRDyDw,1935181,3465001,-1529820,624
2022-04-06 20:55:26-04:00,14817,DVMLxFACqaNBD7q1TGJUUApJX7etJsxQRRFBP2DfBazJ,4hnRjD7S2KxD7UrgfrApntVxUD7Srh5E9nwPY53v89kz,True,235094372,19584246,128134,64067,64067,3zqXX6kzhkbW3d4TwD2CNjMRwxTbREXySekvq37kfCNk,15381635,54538166,-39156531,654
2022-04-06 20:55:27-04:00,14818,8nFpzAFXELGPsrgFwRjTfUidNme1CvgKQTsHWATtMqkz,ABt8ikXHraZ1bqkDUvMtJ3AUzADDWcCL8kMMDpAoth8V,True,28693141,7173285,44709,22354,22355,YQC4EUcgeBi9431viwvzvBbZJW3szeHX4dFmowRDyDw,1788370,7988851,-6200481,623
2022-04-06 20:55:57-04:00,14819,5YC2wXkdk7D4Ubs9TEAbP1hi88Sy35bzYVWjLbgVxn5s,4Mx69ezqFK2wudZ62oVhx2pwjVbKv8JB1HR29ZUcdEJb,True,2143667303,535916825,3346164,1673082,1673082,3zqXX6kzhkbW3d4TwD2CNjMRwxTbREXySekvq37kfCNk,133846599,310727853,-176881254,624
2022-04-06 20:56:24-04:00,14820,BTq6T9nDzYTPTRvxkhNLn82DF3RCWdRkatZUmSTGCu43,3Uuhmxo4tWMbrqowx2bQSJeWzMykUUcZanj29ptCmEa6,True,5439168605,1050264548,6542574,3271287,3271287,3zqXX6kzhkbW3d4TwD2CNjMRwxTbREXySekvq37kfCNk,338830499,1201083683,-862253184,622
2022-04-06 20:56:26-04:00,14821,J8khFNhJg25xVY7yjEtETTQVVzKHqdVCs1Rh2pJKvJqU,4eUP2YxTapjr6TLrd57XxZan7KJG5AtHK8yPRNVEbavx,True,937159071,126385189,788045,394022,394023,3zqXX6kzhkbW3d4TwD2CNjMRwxTbREXySekvq37kfCNk,58434436,30439660,27994776,623
2022-04-06 20:56:33-04:00,14822,H8wYaRqc2wQuE3AdnSA2bCbukzxZEUCS5KbGYNsLAoho,F4ZEmseEyZfy3ZL6iyrczRZ9bww9HgVd8tYXExfbTcj1,True,81252793,20313198,126835,63417,63418,3zqXX6kzhkbW3d4TwD2CNjMRwxTbREXySekvq37kfCNk,5073423,18834545,-13761122,624
2022-04-06 20:56:56-04:00,14823,AwT3pH9dHjECDnuUiazbD6tZxZHdNwgJ4vBMmxLHMiLo,AjybksvjMT1QT6KvryXCG47pQGT8v9jxM34VkveGPQrs,True,18851664,4712916,28894,14447,14447,YQC4EUcgeBi9431viwvzvBbZJW3szeHX4dFmowRDyDw,1155763,3214344,-2058581,613
2022-04-06 20:56:59-04:00,14824,JABfWoDV2wW68XEDANXArYWM7zabdbp5NBVrvzZd3mML,5hYUtd1Uv2pAcrbtSNNVTrRuk8acjmh92mzSm4iz5HJA,True,74365145,9897124,61278,30639,30639,3zqXX6kzhkbW3d4TwD2CNjMRwxTbREXySekvq37kfCNk,4604335,15375021,-10770686,619
2022-04-06 20:57:23-04:00,14825,FV9CBGGTbppLnBKh79f2LzD1diTiS5g6u89FcpZHZmnK,Fe7mtmCUziFqbbYTvrhAcAq1Ub7YLfTJRtQ1hG7GzJD1,True,19947702,4986925,31166,15583,15583,3zqXX6kzhkbW3d4TwD2CNjMRwxTbREXySekvq37kfCNk,1246663,3776497,-2529834,624
2022-04-06 20:59:10-04:00,14826,CZhzJ91hP1pFbNNz7YnUKXznvs6ZFVSRNLbe1SaTw29o,X3B4LpHFfeJPmCnEmRQ8V6MNMi7KpTE4MLD7LHYXUwy,True,242400915,22633619,141110,70555,70555,YQC4EUcgeBi9431viwvzvBbZJW3szeHX4dFmowRDyDw,15112627,43146920,-28034293,623
2022-04-06 20:59:14-04:00,14827,GHHkWuoUrAsuf1n8Y2GFozQxxv3LSr2zU9DWwKmAGTG9,7Fr2hNXbiNUufq8USBK3HwWN4bQT6H9fcFzDt7fdKy2U,True,548208166749,137052041687,856229769,428114884,428114885,3zqXX6kzhkbW3d4TwD2CNjMRwxTbREXySekvq37kfCNk,34249190776,137197654022,-102948463246,624
2022-04-06 20:59:17-04:00,14828,EBRWnRzoNv5RytEjgrs5TXdiCMApLKHMntJJJzehJJns,5nJiYTa3GEbmaRwY1PvBJ1teXikQKgbUop5ANgaDhhcP,True,22522475,5630618,29867,14933,14934,3zqXX6kzhkbW3d4TwD2CNjMRwxTbREXySekvq37kfCNk,1194708,4775481,-3580773,530
2022-04-06 20:59:17-04:00,14829,3geiQ6Ph1iyCnfEfTmWpVnvdJnYoUb3HNeKXwshQMJuF,3uu2PC2DhTR3iXVEKbq5hC8FrzyTYbwF9Ztm3BD3hjEm,True,423339108,105834777,566539,283269,283270,YQC4EUcgeBi9431viwvzvBbZJW3szeHX4dFmowRDyDw,22661585,99268345,-76606760,535
2022-04-06 20:59:22-04:00,14830,4GbUrgiR6A91h3J9HHpuYCkZzjwrb62n3BURLeWj6Nic,12nUFUGYF1rXbwPeCbdGKdP3RE4g984fmZZggEYSFTZn,True,82836813,20709203,129240,64620,64620,A9TwRM1BMxqb8DCC7YNAMV6zPenEJm3HTZBy7wJKK58U,5169616,23311255,-18141639,624
2022-04-06 20:59:25-04:00,14831,2i5g7q4gD1GEfSz8BkhKn1idQ5U7cFPbMDWugjr7bBQW,Dpx6K9G5uZD63rTzBafZ56WKd1X9M25Mzfppd7Jib4xn,True,1942608515,485652128,3021472,1510736,1510736,3zqXX6kzhkbW3d4TwD2CNjMRwxTbREXySekvq37kfCNk,120858904,560816351,-439957447,622
2022-04-06 21:00:02-04:00,14832,A5NXadGWnFZRoHEn1dKTRjcXgWmfMLMyJdpF4rQPZyRR,ALs3Zfotc4c4A6TFDMbd5GM5whK1dTYSnGrHiMBWmApH,True,2223561111,555889702,3468401,1734200,1734201,3zqXX6kzhkbW3d4TwD2CNjMRwxTbREXySekvq37kfCNk,138736206,657914244,-519178038,623
2022-04-06 21:00:10-04:00,14833,5FewDaMC9U7n5EHcto98GaAmDVxDh5SYimuTP6AtfakM,7DAULUoqV7f9hsBzKEhjQPnWaHSqiMWcBqWcdcadaQv4,True,1204012132,171482186,1060710,530355,530355,3zqXX6kzhkbW3d4TwD2CNjMRwxTbREXySekvq37kfCNk,74474747,181190927,-106716180,618
2022-04-06 22:29:57-04:00,14834,Gp1V4ymYEQH9jeZsqPERVfwqoQYUPESUmgKCMaDqoh6u,BBe1Vd8RZuqqC7VkUixgMYA1CfLXMaEvq8J571j8ueMQ,True,2118479235,529619808,3275203,1637601,1637602,YQC4EUcgeBi9431viwvzvBbZJW3szeHX4dFmowRDyDw,131008126,434549001,-303540875,618
2022-04-07 06:18:26-04:00,14835,DXGapgtgkag6midSCYNhHCNaCqvhUmuSvnVhXxNXBmyt,Csq6W5QkGZL6qE6Z1ERF3bfHtKjnM8hAxiY1YA3rTwSX,True,2310556973,577639243,3605532,1802766,1802766,3zqXX6kzhkbW3d4TwD2CNjMRwxTbREXySekvq37kfCNk,144221292,238801270,-94579978,624
2022-04-07 06:20:08-04:00,14836,CVjkHr29t8pzeXU1U1CdMpT6qwf9Jw4XGxvxU7RURPYj,D66Zpxp7q4Tn4KiLa2pHTrADhgtP8tGqNXVPyCo9mcxc,True,212600099,28618085,178382,89191,89191,3zqXX6kzhkbW3d4TwD2CNjMRwxTbREXySekvq37kfCNk,13251829,38328990,-25077161,623
2022-04-07 10:27:19-04:00,14837,DXGapgtgkag6midSCYNhHCNaCqvhUmuSvnVhXxNXBmyt,Csq6W5QkGZL6qE6Z1ERF3bfHtKjnM8hAxiY1YA3rTwSX,True,1698206249,424551562,2649166,1324583,1324583,3zqXX6kzhkbW3d4TwD2CNjMRwxTbREXySekvq37kfCNk,105966654,211647069,-105680415,623
2022-04-07 10:52:23-04:00,14838,CVjkHr29t8pzeXU1U1CdMpT6qwf9Jw4XGxvxU7RURPYj,D66Zpxp7q4Tn4KiLa2pHTrADhgtP8tGqNXVPyCo9mcxc,True,182277519,24563276,153222,76611,76611,YQC4EUcgeBi9431viwvzvBbZJW3szeHX4dFmowRDyDw,11370271,34883036,-23512765,623
2022-04-07 10:52:52-04:00,14839,G3ZEAY19iDMjF7P57dgFUZiC4bpeFvMPKShenugL7E2Y,D6nUGgpWkQUZcUKZYawfedX67uqQ9Co1wEwtbHPMtc7X,True,6017519281,1049657297,6558332,3279166,3279166,3zqXX6kzhkbW3d4TwD2CNjMRwxTbREXySekvq37kfCNk,375978863,1236603533,-860624670,624
2022-04-07 11:13:24-04:00,14840,niCk6QHFU1kyU56Mdq5RJzKrecdkNSn23ZA6wduFdWS,BQbUYSw1XsuE6LnVd4XjmxAyYgx4drE4FsetJBCdwVZW,True,326033847,81493318,507968,253984,253984,3zqXX6kzhkbW3d4TwD2CNjMRwxTbREXySekvq37kfCNk,20322556,56978032,-36655476,623
2022-04-07 11:13:57-04:00,14841,BTwSuuDHNhQAFAzBZRWev5j1ix2RTWvjZAxLpw8grAxu,31NCyUpSXxxJYLSrdK3c5bLomUtMejobMfYnq7j71GtM,True,364920161,91230040,565086,282543,282543,3zqXX6kzhkbW3d4TwD2CNjMRwxTbREXySekvq37kfCNk,22603442,75650165,-53046723,619
2022-04-07 11:14:20-04:00,14842,CVjkHr29t8pzeXU1U1CdMpT6qwf9Jw4XGxvxU7RURPYj,D66Zpxp7q4Tn4KiLa2pHTrADhgtP8tGqNXVPyCo9mcxc,True,156163630,20899577,129361,64680,64681,YQC4EUcgeBi9431viwvzvBbZJW3szeHX4dFmowRDyDw,9666004,31760841,-22094837,618
2022-04-07 11:15:44-04:00,14843,Aepji2BxpSL2XkT2YPkmJGaFntudcBH4Rmt5q53WQrBL,9b4iP4ebv3ffEkdmphiQt5AByqEoEZK1oxAkq7AcfPFy,True,880113693,220028423,1317989,658994,658995,YQC4EUcgeBi9431viwvzvBbZJW3szeHX4dFmowRDyDw,52719571,201967001,-149247430,599
2022-04-07 11:15:47-04:00,14844,F4hN7ecndZ8Gr5KQNSFaSrMGawMasz7jfWTLTMpk7gaB,AJ23FpXSGjipcqywk88WGsKfqfiiUjPzZLsvLtBAhB12,True,202843830,50710957,312286,156143,156143,A9TwRM1BMxqb8DCC7YNAMV6zPenEJm3HTZBy7wJKK58U,12491455,49083643,-36592188,615
2022-04-07 11:15:48-04:00,14845,9cwVnc8zu2wjSnvFuxPddMXSrgNajdn3sZH1qAtQQ8aQ,9xaYkDvEyDmAkWDhhZma9mLbUeB7BkLWtveDsagfJDVa,True,1948789697,487197424,2989989,1494994,1494995,gjBMZYVujDjD1ECG4i97M8Q3gV9ESnwwTSUGropkusj,119599578,421130174,-301530596,613
2022-04-07 11:28:27-04:00,14846,G3ZEAY19iDMjF7P57dgFUZiC4bpeFvMPKShenugL7E2Y,D6nUGgpWkQUZcUKZYawfedX67uqQ9Co1wEwtbHPMtc7X,True,4903815170,780326848,4859339,2429669,2429670,3zqXX6kzhkbW3d4TwD2CNjMRwxTbREXySekvq37kfCNk,305375952,1084703176,-779327224,622
2022-04-07 11:29:49-04:00,14847,68zbVKnneMQqngbNkeLtPEP2ayNhawc1B2hPgqAEqgXK,HqiFpLr4NC7xJz9bEFusq8bCKaoxAQG1xsLxdUAzg8aa,True,11611745735,1741026508,10837946,5418973,5418973,3zqXX6kzhkbW3d4TwD2CNjMRwxTbREXySekvq37kfCNk,722834971,1765447005,-1042612034,622
2022-04-07 11:31:10-04:00,14848,HooxSzasW3HMoFJ6sAvRQ75Char1J5aBdJtsqfDV6myp,BCmsWwpGeV4NNfeKZKKydty2uueLGHYTJDk1WErpXsVT,True,1189861144,246469035,1539955,769977,769978,3zqXX6kzhkbW3d4TwD2CNjMRwxTbREXySekvq37kfCNk,74343346,207604102,-133260756,624
2022-04-07 11:32:00-04:00,14849,CVjkHr29t8pzeXU1U1CdMpT6qwf9Jw4XGxvxU7RURPYj,D66Zpxp7q4Tn4KiLa2pHTrADhgtP8tGqNXVPyCo9mcxc,True,134106937,17953020,112177,56088,56089,YQC4EUcgeBi9431viwvzvBbZJW3szeHX4dFmowRDyDw,8379527,28615785,-20236258,624
2022-04-07 11:35:31-04:00,14850,DDdxcAmfFWLs79vYC1WUuwBVM1XUfxmAgbYgccL5bgZg,3tKaUfHU3Z7v1LDm581yDd1bpfnxLgGHCWTNur3KLptz,True,1510118128,377529532,2339692,1169846,1169846,YQC4EUcgeBi9431viwvzvBbZJW3szeHX4dFmowRDyDw,93587697,335884381,-242296684,619
2022-04-07 11:35:31-04:00,14851,EDzP8bi8wGytnFoz4RynYddWyVWd5RFhHKcGZdwyAHJH,ELHWRXKjwkmoEj3nkJ9hw2bcL6dRd4znFeoLjitNbrXt,True,41502432,10375608,64201,32100,32101,YQC4EUcgeBi9431viwvzvBbZJW3szeHX4dFmowRDyDw,2568059,10512996,-7944937,618
2022-04-07 11:35:32-04:00,14852,3uUdWwgwtFdPa3FJTSrirqPKMtQb3zmT5Wpp4zPy9sJP,5G7dhz8jvWekGy9Wh3ZCXNXSPbB1QArfFYs7MYNgRDkW,True,174688052,43672013,270435,135217,135218,3zqXX6kzhkbW3d4TwD2CNjMRwxTbREXySekvq37kfCNk,10817412,54092341,-43274929,619
2022-04-07 12:07:29-04:00,14853,9YLh8k2JSzEN8kcH5TgJTTZrfDZdY71jskvgUmmjuwzt,ugXh99GpsExGcaTqkPzXUqEvACZMxkPu71MZoW3yFph,True,4273550700,1068387675,6672419,3336209,3336210,3zqXX6kzhkbW3d4TwD2CNjMRwxTbREXySekvq37kfCNk,266896773,998182539,-731285766,624
2022-04-07 12:51:13-04:00,14854,Gp1V4ymYEQH9jeZsqPERVfwqoQYUPESUmgKCMaDqoh6u,BBe1Vd8RZuqqC7VkUixgMYA1CfLXMaEvq8J571j8ueMQ,True,1559985734,389996433,2433137,1216568,1216569,3zqXX6kzhkbW3d4TwD2CNjMRwxTbREXySekvq37kfCNk,97325512,354060294,-256734782,623
2022-04-07 12:53:16-04:00,14855,BTwSuuDHNhQAFAzBZRWev5j1ix2RTWvjZAxLpw8grAxu,31NCyUpSXxxJYLSrdK3c5bLomUtMejobMfYnq7j71GtM,True,268252425,67063106,414869,207434,207435,A9TwRM1BMxqb8DCC7YNAMV6zPenEJm3HTZBy7wJKK58U,16594795,61823648,-45228853,618
2022-04-07 12:53:16-04:00,14856,niCk6QHFU1kyU56Mdq5RJzKrecdkNSn23ZA6wduFdWS,BQbUYSw1XsuE6LnVd4XjmxAyYgx4drE4FsetJBCdwVZW,True,239342457,59820526,365200,182600,182600,gjBMZYVujDjD1ECG4i97M8Q3gV9ESnwwTSUGropkusj,14611728,47308395,-32696667,610
2022-04-07 16:45:53-04:00,14857,DXZMRSKFgnNdiXHps2xzayuztJNH9EUUz2wkCCneXtW5,9Z2sUfTCZCkmw5n3HSsoLG992AcpJo2qxp7XpJnnBxZM,True,1859766724,460791690,2835045,1417522,1417523,3zqXX6kzhkbW3d4TwD2CNjMRwxTbREXySekvq37kfCNk,114423195,179051723,-64628528,615
2022-04-07 17:16:11-04:00,14858,DXGapgtgkag6midSCYNhHCNaCqvhUmuSvnVhXxNXBmyt,Csq6W5QkGZL6qE6Z1ERF3bfHtKjnM8hAxiY1YA3rTwSX,True,1248265734,312066433,1949614,974807,974807,3zqXX6kzhkbW3d4TwD2CNjMRwxTbREXySekvq37kfCNk,77984587,182652757,-104668170,624
2022-04-07 17:22:56-04:00,14859,6Rk6wVu6pCDFwEWDbiY8wS93nDghyHP9kzdUEa6eFRRq,B5v7eFjSX6dDt1kt84Uvtqmrn7STbQPMbFMvjH6WGXJg,True,362486496,90621624,565469,282734,282735,gjBMZYVujDjD1ECG4i97M8Q3gV9ESnwwTSUGropkusj,22618784,39130061,-16511277,623
2022-04-07 17:25:03-04:00,14860,D85pWm1LS9MvtR4f3QhkFLvNUhZLQ2NZBFQTyAVnmigm,CRN85DYkJJi6irhtVAf4qcJU3ijVodWdXgWe7Fs6Ahka,True,179448967,44862241,279907,139953,139954,3zqXX6kzhkbW3d4TwD2CNjMRwxTbREXySekvq37kfCNk,11196295,24497015,-13300720,623
2022-04-07 19:17:31-04:00,14861,7yW1M1xeVx4hy3QftnpqdBDRYwamfu3K5i6AEnxgyTWb,7wf7FWS2DYp5RveQAmGNXAEUWPcHziuMLd4hV5LPgxF8,True,476215927,119053981,732558,366279,366279,3zqXX6kzhkbW3d4TwD2CNjMRwxTbREXySekvq37kfCNk,29302334,45552952,-16250618,615
2022-04-07 19:17:43-04:00,14862,5qhMCt68ufKGTNVaZvyY8RAUJv62xzWUfFXRPtAriAoX,Bt7QiSUuc6uJQbhzC3qhLPdDA3UAom7zqmihEKwvrpCg,True,615734878,153933719,958386,479193,479193,YQC4EUcgeBi9431viwvzvBbZJW3szeHX4dFmowRDyDw,38335479,58940588,-20605109,622
2022-04-07 19:19:59-04:00,14863,HEQkTetqGuSUdeEFpSTVigmtAroktwPZWeLhWgDWhKjp,3EJQFo1ZWCEYjFu1dbgLMqYeACAEKKtvEbVn1wd8CXm1,True,1313687923,328421980,2320425,1160212,1160213,3zqXX6kzhkbW3d4TwD2CNjMRwxTbREXySekvq37kfCNk,92817029,126709020,-33891991,706
2022-03-27 19:33:20-04:00,13840,HegY1tDz2ki6vSf9FPRSF4dwGKyciGCt6bovVYdFJRk6,soWdvQVu9EW4Mkk5WUY6rZLA3cEXhFUKqNyY7kpg8ZD,True,53281564,5006105,30918,15459,15459,YQC4EUcgeBi9431viwvzvBbZJW3szeHX4dFmowRDyDw,3290763,14759872,-11469109,617
2022-03-27 19:33:23-04:00,13841,FcXe2wJqFzVRpRMSsPwzmwKAQ7f9CfHmwCt99k1cQeE1,BFjwToxLi3yzSDP13XqEXifQXahGyr5BWPBJyiM2iaai,True,49873328,4741492,29509,14754,14755,YQC4EUcgeBi9431viwvzvBbZJW3szeHX4dFmowRDyDw,3103954,13602373,-10498419,622
2022-03-27 19:33:24-04:00,13842,GwfLBmVoBKibVLjH1DHEqsvyrqWGheK59s18BGrtunJg,CizH6WcFyEuTDkERDWxpnfbnHPBQUCLoM8CNaH2wX8Z8,False,14503559,14503559,893954,44697,849257,YQC4EUcgeBi9431viwvzvBbZJW3szeHX4dFmowRDyDw,893954,4052793,-3158839,616
2022-03-27 20:03:10-04:00,13843,HREFGG6Dedwcd81uY8UER88bgX9aNWF3ggADJW5NVpvj,3tMM6Rx63EaQCGQYDBcEdF4pLVLf3qRchsENd7zxDnam,True,762238681,93205781,582072,291036,291036,3zqXX6kzhkbW3d4TwD2CNjMRwxTbREXySekvq37kfCNk,47602018,213305147,-165703129,624
2022-03-27 20:31:09-04:00,13844,GTzLxRn226vTjN4HTSDSCjDLjwNiP4jsarG4umsA4CPc,6BWii3HLmdacnSS1pe8RkbbN6kbe4jpYYbnHqM1hh2G5,True,464967781,116241945,725799,362899,362900,3zqXX6kzhkbW3d4TwD2CNjMRwxTbREXySekvq37kfCNk,29031978,71354958,-42322980,624
2022-03-27 20:31:20-04:00,13845,Bmqae54jhWBLPKUhbE9qJN3Wfy56zR9U6kygyvPjin4Y,EV6XRL5dMERF3yWBQYeXscBiqWwGQ3mYXApdqBUZnhj9,True,294128013,73532003,459440,229720,229720,3zqXX6kzhkbW3d4TwD2CNjMRwxTbREXySekvq37kfCNk,18377626,74905321,-56527695,624
2022-03-27 20:32:27-04:00,13846,2Gfse9HBrkdSHZrKFk2Lbabmw7Mf9SAGpTftge3QCzfh,7bEeqMeSHXDSZzPu6sZEtHCUs1uZRXqWfz9FHwD9gBGS,True,372325895,93081473,581512,290756,290756,3zqXX6kzhkbW3d4TwD2CNjMRwxTbREXySekvq37kfCNk,23260489,58128223,-34867734,624
2022-03-27 20:32:31-04:00,13847,EeztHR1M4PPacJEZ6c5arCRVCuu8aN7eGdpY1u4bev79,9Twdc9Xrzv2oeJ9Fbd8mRvzjbFi7mkGopFS37SMabeAK,False,1973232,1973232,123260,6163,117097,YQC4EUcgeBi9431viwvzvBbZJW3szeHX4dFmowRDyDw,123260,514278,-391018,624
2022-03-27 20:32:35-04:00,13848,DgtZ1dBzCaR4K38CxgyhxaGCdwXM69N4CZDZ4nsZXYE4,8x5yYiS88nDTvj1v11s3J9kQ94S3j94NZvqfV9dxJuWJ,True,1312882517,328220629,2048615,1024307,1024308,3zqXX6kzhkbW3d4TwD2CNjMRwxTbREXySekvq37kfCNk,81944605,193022546,-111077941,624
2022-03-27 20:32:40-04:00,13849,5YC2wXkdk7D4Ubs9TEAbP1hi88Sy35bzYVWjLbgVxn5s,4Mx69ezqFK2wudZ62oVhx2pwjVbKv8JB1HR29ZUcdEJb,True,6234958697,1558739674,9735273,4867636,4867637,3zqXX6kzhkbW3d4TwD2CNjMRwxTbREXySekvq37kfCNk,389410933,1000927533,-611516600,624
2022-03-27 20:32:46-04:00,13850,AxUKatZukyU1PaNZzQFftBbga7GQC7nArZKv6wHCtXVR,HEqbmmGLsuxSSbqx931nFbbhhsNFNEx8Srf8J7wZr7pa,True,49863372,4763870,29757,14878,14879,YQC4EUcgeBi9431viwvzvBbZJW3szeHX4dFmowRDyDw,3114710,13603201,-10488491,624
2022-03-27 20:32:51-04:00,13851,3Gkfjg2BFLhzvTArvUb7t4EqjMevBgjLYHiQ62bMjC5q,oNcVBNCpeMzQDMqat31fDFi8x4G7Af3Rsm4uSMwngdb,True,32005835,8001458,48954,24477,24477,YQC4EUcgeBi9431viwvzvBbZJW3szeHX4dFmowRDyDw,1958161,3962570,-2004409,611
2022-03-27 20:34:03-04:00,13852,7RCDGRGZPnFcUdKEaewrP815tuYDwWDmWytdHK6AaoqA,7WWDb3AVBpkpfpqcGV44LU2QXqsFTQhrJZ7tvae43p5L,True,44443107,8051738,49901,24950,24951,YQC4EUcgeBi9431viwvzvBbZJW3szeHX4dFmowRDyDw,2754410,7729450,-4975040,619
2022-03-27 20:34:05-04:00,13853,HegY1tDz2ki6vSf9FPRSF4dwGKyciGCt6bovVYdFJRk6,soWdvQVu9EW4Mkk5WUY6rZLA3cEXhFUKqNyY7kpg8ZD,True,48507466,4564073,28483,14241,14242,3zqXX6kzhkbW3d4TwD2CNjMRwxTbREXySekvq37kfCNk,3027266,13472273,-10445007,624
2022-03-27 20:34:06-04:00,13854,AdhLnfiTUme12n7GxSwQXVV5EUYFLqFKtwqjc3DHdu4a,GXzNAxZ6x3zDd3Ctvc43Ct1tuq22YG72VtfZ4FNfpFhL,True,51293711,10565268,66002,33001,33001,3zqXX6kzhkbW3d4TwD2CNjMRwxTbREXySekvq37kfCNk,3204365,5395517,-2191152,624
2022-03-27 20:34:12-04:00,13855,FcXe2wJqFzVRpRMSsPwzmwKAQ7f9CfHmwCt99k1cQeE1,BFjwToxLi3yzSDP13XqEXifQXahGyr5BWPBJyiM2iaai,True,45372160,3934063,24569,12284,12285,3zqXX6kzhkbW3d4TwD2CNjMRwxTbREXySekvq37kfCNk,2833641,12768389,-9934748,624
2022-03-27 20:34:28-04:00,13856,2Tm69hQroe4dREXCLHubHfDTkDPohvcMEFuALmCpNZw6,4FH8oJspDa4TPVVXgzJzVM1eTHdnNvSf59C1A8m2PXoc,True,909716359,90394437,564427,282213,282214,3zqXX6kzhkbW3d4TwD2CNjMRwxTbREXySekvq37kfCNk,56803138,104329976,-47526838,624
2022-03-27 20:34:44-04:00,13857,AxUKatZukyU1PaNZzQFftBbga7GQC7nArZKv6wHCtXVR,HEqbmmGLsuxSSbqx931nFbbhhsNFNEx8Srf8J7wZr7pa,True,45351561,3936141,24587,12293,12294,3zqXX6kzhkbW3d4TwD2CNjMRwxTbREXySekvq37kfCNk,2832894,12747068,-9914174,624
2022-03-27 20:35:49-04:00,13858,5rv28YXtxD3bThdni7X4qz6ye1BNPx2S8yXur1vJeVfX,EPvM8N8DFVRHLKbuC9e4P6W2NF8kzGWFjq2eCEKM2Zfr,True,374972598,93743149,585499,292749,292750,YQC4EUcgeBi9431viwvzvBbZJW3szeHX4dFmowRDyDw,23419981,60909210,-37489229,624
2022-03-27 23:04:52-04:00,13859,3Gkfjg2BFLhzvTArvUb7t4EqjMevBgjLYHiQ62bMjC5q,oNcVBNCpeMzQDMqat31fDFi8x4G7Af3Rsm4uSMwngdb,True,24413131,6103282,37490,18745,18745,YQC4EUcgeBi9431viwvzvBbZJW3szeHX4dFmowRDyDw,1499638,3411706,-1912068,614
2022-03-28 00:32:57-04:00,13860,v8PjH3mAe252Zyh1iuPMigysGQZoZL1KncefGDw1ANx,2BDYraDRL6SekAjXy3rbGXCxmPt75gkEfhomEp9FzkUE,True,152142250563,17028277992,106378707,53189353,53189354,3zqXX6kzhkbW3d4TwD2CNjMRwxTbREXySekvq37kfCNk,9504599352,21665043777,-12160444425,624
2022-03-28 01:15:21-04:00,13861,v8PjH3mAe252Zyh1iuPMigysGQZoZL1KncefGDw1ANx,2BDYraDRL6SekAjXy3rbGXCxmPt75gkEfhomEp9FzkUE,True,136019861630,12814516361,79965821,39982910,39982911,3zqXX6kzhkbW3d4TwD2CNjMRwxTbREXySekvq37kfCNk,8487983265,20994343149,-12506359884,624
2022-03-28 01:30:32-04:00,13862,2ix7AR3FgZjmFiXAyrr9Jg63xUxgn8oDp3pcGP3Yfj23,Gm2QCdpM13K99ZMWGijYXM7Ur9sK4n67g4gDCap7r3r5,False,15033,15033,935,46,889,YQC4EUcgeBi9431viwvzvBbZJW3szeHX4dFmowRDyDw,935,3151,-2216,621
2022-03-28 01:31:48-04:00,13863,AkGQxVK2FFRi9doFRx5gwGXBr6WKknvU3evZkDu3Yas4,Abu1FYCyBSutkrvrx56tL61xoDyYSCjwrDU1wnKn2gin,True,99569930,24892482,154184,77092,77092,3zqXX6kzhkbW3d4TwD2CNjMRwxTbREXySekvq37kfCNk,6167396,27878777,-21711381,619
2022-03-28 01:31:51-04:00,13864,AT4qoJDVGXpEm3BGACUhC1zpVNLq4iX2bJ4cpABehpoD,AqaDPXbaY6ksVQwWGKorgBdRQMz3VpqxmHdWXmq17ScF,True,11149702114,2787425528,17386553,8693276,8693277,3zqXX6kzhkbW3d4TwD2CNjMRwxTbREXySekvq37kfCNk,695462151,2961680575,-2266218424,623
2022-03-28 01:31:57-04:00,13865,EG8G1DMZqXByLNtowrEJr9Rb4HnG89REC6NLsg8bdmep,94AvgT7uB6KfmKitJPYwPa6T9TScSnCQ5ziQG5VT5qSA,False,71057,71057,4304,215,4089,YQC4EUcgeBi9431viwvzvBbZJW3szeHX4dFmowRDyDw,4304,16269,-11965,605
2022-03-28 01:31:57-04:00,13866,A11mzoTX3dyc9gACVJkbRGZ6QACJsrF3ZHJUsGEtRnsj,H7z8CfHxnxo3mPrvxfiLLNwrDX1cxGWWDUxXs9EpzSi,True,44831274,11207818,68672,34336,34336,3zqXX6kzhkbW3d4TwD2CNjMRwxTbREXySekvq37kfCNk,2746896,7111951,-4365055,612
2022-03-28 01:31:58-04:00,13867,CLP8qmL8aN9ocJKYnbKSo4k46CU3LBsebspfREQcSGvo,F6tkkFJnvjYyPdSXDNzZMUfhd1o8dFiLyLPRZ5U1sXHE,True,45123800,11280950,67448,33724,33724,3zqXX6kzhkbW3d4TwD2CNjMRwxTbREXySekvq37kfCNk,2697921,12269008,-9571087,597
2022-03-28 01:31:59-04:00,13868,4BHydPKft6s7nYozhJ63rVrkQ22QywsrBQf2BAuW6mDS,8Tz6FZpzjoRBZqEwdPdkr4XGmURu3n1SjV3CTuc3o5yw,True,38258362,9564590,56959,28479,28480,3zqXX6kzhkbW3d4TwD2CNjMRwxTbREXySekvq37kfCNk,2278367,8794695,-6516328,595
2022-03-28 01:31:59-04:00,13869,HegY1tDz2ki6vSf9FPRSF4dwGKyciGCt6bovVYdFJRk6,soWdvQVu9EW4Mkk5WUY6rZLA3cEXhFUKqNyY7kpg8ZD,True,44204343,3843455,23764,11882,11882,YQC4EUcgeBi9431viwvzvBbZJW3szeHX4dFmowRDyDw,2733273,12625152,-9891879,618
2022-03-28 01:31:59-04:00,13870,EENJ9iyTJtHmiY3vGyrZFUqks3k74YPZcHyTLxCNtyNE,E8tKKqgVTy89xSKWG1HrZzyA8Na4mPWA8PmqbTg9ryET,True,9668162302,2417040575,14567597,7283798,7283799,3zqXX6kzhkbW3d4TwD2CNjMRwxTbREXySekvq37kfCNk,582703886,2882519447,-2299815561,602
2022-03-28 01:32:00-04:00,13871,76MxXg67Q8CrmgUHJUQufvLmURy6k2DwpPfzVA8ar8AC,WHd5ddz9UZgSX66YkBPPnJFdqkaJqJ4KPLghCRCE1eP,True,40645970,10161492,61057,30528,30529,3zqXX6kzhkbW3d4TwD2CNjMRwxTbREXySekvq37kfCNk,2442290,6375978,-3933688,600
2022-03-28 01:32:08-04:00,13872,4QJuKV4x6Wo4AsTA2Xsx7MwbjCrSVncnm6dkusWRg48J,EFhoiz3Td7yuFTo3NJBunx3pP4HHuk8yoNxk4gHqYTSt,False,4804,4804,284,14,270,EZEEdtBnevEDeAC4SSzUUgLixHHAukPwHtvyi5yeYbFW,284,1369,-1085,591
2022-03-28 01:33:12-04:00,13873,6Rk6wVu6pCDFwEWDbiY8wS93nDghyHP9kzdUEa6eFRRq,B5v7eFjSX6dDt1kt84Uvtqmrn7STbQPMbFMvjH6WGXJg,True,344278503,86069617,536498,268249,268249,YQC4EUcgeBi9431viwvzvBbZJW3szeHX4dFmowRDyDw,21459962,68318180,-46858218,623
2022-03-28 01:33:16-04:00,13874,Y22tWk4tECzARPFYM87xgBPZXaNsYMbkpRaRZAZZQDR,GPgSj6yDWD1odK4CAwzQgwqnW9RLJNXHo8tVba8DuEa1,False,310202,310202,19149,957,18192,YQC4EUcgeBi9431viwvzvBbZJW3szeHX4dFmowRDyDw,19149,66284,-47135,617
2022-03-28 01:33:20-04:00,13875,FcXe2wJqFzVRpRMSsPwzmwKAQ7f9CfHmwCt99k1cQeE1,BFjwToxLi3yzSDP13XqEXifQXahGyr5BWPBJyiM2iaai,True,41644179,3832148,23910,11955,11955,3zqXX6kzhkbW3d4TwD2CNjMRwxTbREXySekvq37kfCNk,2598423,11758312,-9159889,623
2022-03-28 01:33:29-04:00,13876,5GGcHTFi7PqKJdfyoc3CGNjxeQjcvuvgYf2c8EaJweuB,Cu7qDjNFpac1hHLQbdJ2iNH8o6q4hcd1R7tsV7MMopJv,False,1164667,1164667,72718,3635,69083,YQC4EUcgeBi9431viwvzvBbZJW3szeHX4dFmowRDyDw,72718,268417,-195699,624
2022-03-28 01:34:13-04:00,13877,4J7uT2PQnrfWazv3DJcM82i49WmTugyfpdmDvEjKLDks,HsyGm9ttVqNJp38udSabXHM11MTaNUdxnAT2fWKWz1HZ,True,61661141,15415285,96228,48114,48114,3zqXX6kzhkbW3d4TwD2CNjMRwxTbREXySekvq37kfCNk,3849138,17296837,-13447699,624
2022-03-28 01:34:15-04:00,13878,AzmKB7i1dJucc5Ec1mxpoJor662CDFKAAWRstWDtrmaq,Fd2bPyTR54f8fcTkUokCjcgYgReTGR9vN7ymaGXVcMDK,True,998656057,249664014,1560233,780116,780117,3zqXX6kzhkbW3d4TwD2CNjMRwxTbREXySekvq37kfCNk,62409333,214800119,-152390786,624
2022-03-28 01:35:03-04:00,13879,FjjU3VtoUbcgBtU8pxo96JfvXHppbQVGTyz4hJYiC7k4,8VztSSmeE9EfRwmfr22gdqviqdy7W5sATZLkuGWBMxP6,False,52422,52422,3238,161,3077,YQC4EUcgeBi9431viwvzvBbZJW3szeHX4dFmowRDyDw,3238,14974,-11736,617
2022-03-28 01:35:13-04:00,13880,AYQdtUZRag2htfExQ6oGFby4udBWuTZbhCaH3242MmgW,aiQaN2BxfgY59xzA1mZU12TC686SBxVAS4MGW2pniAJ,False,40661,40661,2508,125,2383,YQC4EUcgeBi9431viwvzvBbZJW3szeHX4dFmowRDyDw,2508,10302,-7794,616
2022-03-28 01:35:14-04:00,13881,HBYoCwAU3bgnxsrUpBcgEs1ppJxn7Firm8sgpQYCYnsM,EZEEdtBnevEDeAC4SSzUUgLixHHAukPwHtvyi5yeYbFW,True,83640866,20910216,130582,65291,65291,YQC4EUcgeBi9431viwvzvBbZJW3szeHX4dFmowRDyDw,5223295,8003848,-2780553,624
2022-03-28 01:35:44-04:00,13882,AxUKatZukyU1PaNZzQFftBbga7GQC7nArZKv6wHCtXVR,HEqbmmGLsuxSSbqx931nFbbhhsNFNEx8Srf8J7wZr7pa,True,41618537,3823669,23892,11946,11946,3zqXX6kzhkbW3d4TwD2CNjMRwxTbREXySekvq37kfCNk,2600634,11734909,-9134275,624
2022-03-28 01:35:51-04:00,13883,4srwVCqLz4ztWwdfMu9jXRy99UwMvWGN13mvLAVCUEg5,CbrNiF6CNCG3RiUHBG5AdoHmqwjDPsfUUtPno9DswcQM,False,3517649,3517649,216177,10808,205369,YQC4EUcgeBi9431viwvzvBbZJW3szeHX4dFmowRDyDw,216177,668257,-452080,614
2022-03-28 01:35:53-04:00,13884,niCk6QHFU1kyU56Mdq5RJzKrecdkNSn23ZA6wduFdWS,BQbUYSw1XsuE6LnVd4XjmxAyYgx4drE4FsetJBCdwVZW,True,167863474,30692705,191799,95899,95900,3zqXX6kzhkbW3d4TwD2CNjMRwxTbREXySekvq37kfCNk,10489861,22705107,-12215246,624
2022-03-28 01:40:50-04:00,13885,2PCcuGzx7sxcdHyNWoP4jyMWRP8wJonHD2Y4UGxBVvfo,4GFTJ1GRrgj64infmM3dH28GiasJgR4co5iR5MUwdSxx,False,144526,144526,9027,451,8576,YQC4EUcgeBi9431viwvzvBbZJW3szeHX4dFmowRDyDw,9027,27487,-18460,624
2022-03-28 01:46:12-04:00,13886,7orEnq4GXQgjZ1Q9TxgivgGquE1ZxZ6wg1MWuiWh9QhU,FrAoUJMdohhjWpJMgRNHrrZbWuXnfP2yZCAqTdc9BRke,False,142474,142474,8867,443,8424,YQC4EUcgeBi9431viwvzvBbZJW3szeHX4dFmowRDyDw,8867,28649,-19782,622
2022-03-28 01:46:17-04:00,13887,AkGQxVK2FFRi9doFRx5gwGXBr6WKknvU3evZkDu3Yas4,Abu1FYCyBSutkrvrx56tL61xoDyYSCjwrDU1wnKn2gin,True,75944927,18986231,118643,59321,59322,3zqXX6kzhkbW3d4TwD2CNjMRwxTbREXySekvq37kfCNk,4745733,22296804,-17551071,624
2022-03-28 01:46:25-04:00,13888,v8PjH3mAe252Zyh1iuPMigysGQZoZL1KncefGDw1ANx,2BDYraDRL6SekAjXy3rbGXCxmPt75gkEfhomEp9FzkUE,True,123874841694,11327287574,70762110,35381055,35381055,3zqXX6kzhkbW3d4TwD2CNjMRwxTbREXySekvq37kfCNk,7738521019,20438521497,-12700000478,624
2022-03-28 01:46:27-04:00,13889,HegY1tDz2ki6vSf9FPRSF4dwGKyciGCt6bovVYdFJRk6,soWdvQVu9EW4Mkk5WUY6rZLA3cEXhFUKqNyY7kpg8ZD,True,40542578,3835288,23912,11956,11956,3zqXX6kzhkbW3d4TwD2CNjMRwxTbREXySekvq37kfCNk,2527819,11711065,-9183246,623
2022-03-28 01:46:27-04:00,13890,AT4qoJDVGXpEm3BGACUhC1zpVNLq4iX2bJ4cpABehpoD,AqaDPXbaY6ksVQwWGKorgBdRQMz3VpqxmHdWXmq17ScF,True,8509086208,2127271552,13281649,6640824,6640825,3zqXX6kzhkbW3d4TwD2CNjMRwxTbREXySekvq37kfCNk,531265976,2378467252,-1847201276,624
2022-03-28 01:46:28-04:00,13891,CLP8qmL8aN9ocJKYnbKSo4k46CU3LBsebspfREQcSGvo,F6tkkFJnvjYyPdSXDNzZMUfhd1o8dFiLyLPRZ5U1sXHE,True,34334888,8583722,53460,26730,26730,YQC4EUcgeBi9431viwvzvBbZJW3szeHX4dFmowRDyDw,2138435,9808800,-7670365,622
2022-03-28 01:46:28-04:00,13892,4BHydPKft6s7nYozhJ63rVrkQ22QywsrBQf2BAuW6mDS,8Tz6FZpzjoRBZqEwdPdkr4XGmURu3n1SjV3CTuc3o5yw,True,29110945,7277736,45105,22552,22553,3zqXX6kzhkbW3d4TwD2CNjMRwxTbREXySekvq37kfCNk,1804235,7108663,-5304428,619
2022-03-28 01:47:19-04:00,13893,76MxXg67Q8CrmgUHJUQufvLmURy6k2DwpPfzVA8ar8AC,WHd5ddz9UZgSX66YkBPPnJFdqkaJqJ4KPLghCRCE1eP,False,31399502,31399502,1466209,73310,1392899,YQC4EUcgeBi9431viwvzvBbZJW3szeHX4dFmowRDyDw,1466209,5331510,-3865301,466
2022-03-28 01:47:19-04:00,13894,2Tm69hQroe4dREXCLHubHfDTkDPohvcMEFuALmCpNZw6,4FH8oJspDa4TPVVXgzJzVM1eTHdnNvSf59C1A8m2PXoc,True,741392005,75786910,434011,217005,217006,3zqXX6kzhkbW3d4TwD2CNjMRwxTbREXySekvq37kfCNk,42457597,92942221,-50484624,572
2022-03-28 01:47:19-04:00,13895,EENJ9iyTJtHmiY3vGyrZFUqks3k74YPZcHyTLxCNtyNE,E8tKKqgVTy89xSKWG1HrZzyA8Na4mPWA8PmqbTg9ryET,False,7469855406,7469855406,349402610,17470130,331932480,YQC4EUcgeBi9431viwvzvBbZJW3szeHX4dFmowRDyDw,349402610,2293520572,-1944117962,467
2022-03-28 01:47:20-04:00,13896,6Rk6wVu6pCDFwEWDbiY8wS93nDghyHP9kzdUEa6eFRRq,B5v7eFjSX6dDt1kt84Uvtqmrn7STbQPMbFMvjH6WGXJg,True,265755364,66438833,334423,167211,167212,3zqXX6kzhkbW3d4TwD2CNjMRwxTbREXySekvq37kfCNk,13376986,56067879,-42690893,503
2022-03-28 01:47:20-04:00,13897,429jPeeFjDTX93YH4wyuZKDsbTikueUnsFG6cvFQC3Nf,9npKGMooVRgrs4DP5JCRkjD5bM2Uu1R5YTCc6CXPe4mh,True,22531254,5632813,29977,14988,14989,3zqXX6kzhkbW3d4TwD2CNjMRwxTbREXySekvq37kfCNk,1199119,4233015,-3033896,532
2022-03-28 01:47:22-04:00,13898,CD72r5bjRGSd1tLsvDC9YQe5nPYBHexpXGPZvyMRdAwk,5syEXm5Dc1UgWAHfCmgooc4Wkjei8V5A1PR5MNWMPT7N,True,33707201,8426800,50109,25054,25055,3zqXX6kzhkbW3d4TwD2CNjMRwxTbREXySekvq37kfCNk,2004385,6308347,-4303962,594
2022-03-28 01:47:22-04:00,13899,9R52LDEW4iXndDw1WuVKCCEdJ4fD1n43wwUDGgVZbf1Y,4jyskz93s8y5nkMzo8x3xEKJaaKcybEnCZDCX5U4vYBF,True,2271014006605,259248174269,1591480523,795740261,795740262,3zqXX6kzhkbW3d4TwD2CNjMRwxTbREXySekvq37kfCNk,139413693887,856771816701,-717358122814,613
2022-03-28 01:47:23-04:00,13900,6qqBmN3Mmy56gXvtBwLUyQwJoh2cYKmMtP61Po9xgxRj,FySpFnWFTZAaYLZ2c8Lb9m89CJxj3ZFMcZTdcwRrEEGH,False,820077494,820077494,39985319,1999265,37986054,3zqXX6kzhkbW3d4TwD2CNjMRwxTbREXySekvq37kfCNk,39985319,149003731,-109018412,487
2022-03-28 01:47:23-04:00,13901,niCk6QHFU1kyU56Mdq5RJzKrecdkNSn23ZA6wduFdWS,BQbUYSw1XsuE6LnVd4XjmxAyYgx4drE4FsetJBCdwVZW,True,140109107,35027276,183992,91996,91996,3zqXX6kzhkbW3d4TwD2CNjMRwxTbREXySekvq37kfCNk,7359724,18132873,-10773149,525
2022-03-28 01:47:23-04:00,13902,2Tm69hQroe4dREXCLHubHfDTkDPohvcMEFuALmCpNZw6,4FH8oJspDa4TPVVXgzJzVM1eTHdnNvSf59C1A8m2PXoc,True,667975969,64326008,381854,190927,190927,3zqXX6kzhkbW3d4TwD2CNjMRwxTbREXySekvq37kfCNk,39652712,88952418,-49299706,593
2022-03-28 01:47:23-04:00,13903,AT4qoJDVGXpEm3BGACUhC1zpVNLq4iX2bJ4cpABehpoD,AqaDPXbaY6ksVQwWGKorgBdRQMz3VpqxmHdWXmq17ScF,True,6541643063,1635410765,8953898,4476949,4476949,3zqXX6kzhkbW3d4TwD2CNjMRwxTbREXySekvq37kfCNk,358155920,1903798191,-1545642271,547
2022-03-28 01:47:24-04:00,13904,A11mzoTX3dyc9gACVJkbRGZ6QACJsrF3ZHJUsGEtRnsj,H7z8CfHxnxo3mPrvxfiLLNwrDX1cxGWWDUxXs9EpzSi,True,34351123,8587780,48763,24381,24382,3zqXX6kzhkbW3d4TwD2CNjMRwxTbREXySekvq37kfCNk,1950557,5952028,-4001471,567
2022-03-28 01:47:24-04:00,13905,3Qauv179unF6Lj5nierv8UzijeYSV5r2eedE7uH5t5zu,TjTYpji1EcSidxX6n1r76Ce8Awbf7jZbTj3o5wUAmgk,False,57513,57513,3319,165,3154,YQC4EUcgeBi9431viwvzvBbZJW3szeHX4dFmowRDyDw,3319,16041,-12722,577
2022-03-28 01:47:25-04:00,13906,3MJWM6aknu6UM3Fhy79zFBqwdgFiJRSKD7vt146oGUWo,3cSepXowxnfbijr3FJuPCVwQuPbhioEvq7RVaJMm9nnq,False,267943,267943,16031,801,15230,YQC4EUcgeBi9431viwvzvBbZJW3szeHX4dFmowRDyDw,16031,51627,-35596,598
2022-03-28 01:47:27-04:00,13907,Fi3t3YvraGMh2meqW3EHC976qLj4WHbG7gZQQ3BF94L9,DSBz6jKDLWfWWFufKjXXwiCUHtDSwufCEpjEQ9yWtVFm,False,1417387,1417387,87108,4355,82753,72FwbpFGoLEazJEdpqNtPNefsadUrimUqma9wSoy4qiS,87108,269394,-182286,614
2022-03-28 01:47:32-04:00,13908,zuCM1fMKnuKrpoy1zB9cQiFrkpiZXmrScN8e1coVEdF,J2eUoBRmW6k4BzKL2EMQ7a8MLreGdtvH6a4rn6vd39Pt,False,171493,171493,10271,513,9758,YQC4EUcgeBi9431viwvzvBbZJW3szeHX4dFmowRDyDw,10271,39757,-29486,598
2022-03-28 01:52:03-04:00,13909,FcXe2wJqFzVRpRMSsPwzmwKAQ7f9CfHmwCt99k1cQeE1,BFjwToxLi3yzSDP13XqEXifQXahGyr5BWPBJyiM2iaai,True,38031207,3591687,22243,11121,11122,3zqXX6kzhkbW3d4TwD2CNjMRwxTbREXySekvq37kfCNk,2355337,10855371,-8500034,619
2022-03-28 01:52:04-04:00,13910,4J7uT2PQnrfWazv3DJcM82i49WmTugyfpdmDvEjKLDks,HsyGm9ttVqNJp38udSabXHM11MTaNUdxnAT2fWKWz1HZ,True,47129394,11782348,71734,35867,35867,YQC4EUcgeBi9431viwvzvBbZJW3szeHX4dFmowRDyDw,2869372,13838706,-10969334,608
2022-03-28 01:52:06-04:00,13911,AzmKB7i1dJucc5Ec1mxpoJor662CDFKAAWRstWDtrmaq,Fd2bPyTR54f8fcTkUokCjcgYgReTGR9vN7ymaGXVcMDK,True,763261879,190815469,1164481,582240,582241,3zqXX6kzhkbW3d4TwD2CNjMRwxTbREXySekvq37kfCNk,46579264,175148377,-128569113,610
2022-03-28 01:52:14-04:00,13912,HBYoCwAU3bgnxsrUpBcgEs1ppJxn7Firm8sgpQYCYnsM,EZEEdtBnevEDeAC4SSzUUgLixHHAukPwHtvyi5yeYbFW,True,63868726,15967181,98865,49432,49433,3zqXX6kzhkbW3d4TwD2CNjMRwxTbREXySekvq37kfCNk,3954637,7178177,-3223540,619
2022-03-28 01:52:57-04:00,13913,5B1hTu14cEQS6SNY45RrFMUhG8nRv1CGMLog4hCBmBoH,CTLp3MQcZzPA275nkCz5D5Sm1tfwDDkV4Tyqqovpzp8f,False,64668,64668,4032,201,3831,YQC4EUcgeBi9431viwvzvBbZJW3szeHX4dFmowRDyDw,4032,15517,-11485,623
2022-03-28 01:53:02-04:00,13914,AxUKatZukyU1PaNZzQFftBbga7GQC7nArZKv6wHCtXVR,HEqbmmGLsuxSSbqx931nFbbhhsNFNEx8Srf8J7wZr7pa,True,37997681,3581324,22374,11187,11187,3zqXX6kzhkbW3d4TwD2CNjMRwxTbREXySekvq37kfCNk,2373929,10840458,-8466529,624
2022-03-28 01:53:53-04:00,13915,v8PjH3mAe252Zyh1iuPMigysGQZoZL1KncefGDw1ANx,2BDYraDRL6SekAjXy3rbGXCxmPt75gkEfhomEp9FzkUE,True,113152082813,9552944483,59631819,29815909,29815910,3zqXX6kzhkbW3d4TwD2CNjMRwxTbREXySekvq37kfCNk,7063230216,18451817086,-11388586870,624
2022-03-28 01:54:17-04:00,13916,HegY1tDz2ki6vSf9FPRSF4dwGKyciGCt6bovVYdFJRk6,soWdvQVu9EW4Mkk5WUY6rZLA3cEXhFUKqNyY7kpg8ZD,True,36905128,3423085,21389,10694,10695,3zqXX6kzhkbW3d4TwD2CNjMRwxTbREXySekvq37kfCNk,2306069,10664361,-8358292,624
2022-03-28 01:54:31-04:00,13917,GP2fiNyYQqm2QuNbTanAwtQzkS5YiXQmiGoLrjCpCJ4X,6sVdFAHGfHbzHFtZb1Zy4xkWyTGrJP9z8r8MWfKNptVG,False,732415,732415,45707,2285,43422,YQC4EUcgeBi9431viwvzvBbZJW3szeHX4dFmowRDyDw,45707,140680,-94973,624
2022-03-28 01:54:41-04:00,13918,AkGQxVK2FFRi9doFRx5gwGXBr6WKknvU3evZkDu3Yas4,Abu1FYCyBSutkrvrx56tL61xoDyYSCjwrDU1wnKn2gin,True,57966792,14491698,90474,45237,45237,3zqXX6kzhkbW3d4TwD2CNjMRwxTbREXySekvq37kfCNk,3618994,17790425,-14171431,624
2022-03-28 01:56:37-04:00,13919,HREFGG6Dedwcd81uY8UER88bgX9aNWF3ggADJW5NVpvj,3tMM6Rx63EaQCGQYDBcEdF4pLVLf3qRchsENd7zxDnam,True,673952605,79092381,492640,246320,246320,3zqXX6kzhkbW3d4TwD2CNjMRwxTbREXySekvq37kfCNk,41978357,189862054,-147883697,622
2022-03-28 07:32:07-04:00,13920,HREFGG6Dedwcd81uY8UER88bgX9aNWF3ggADJW5NVpvj,3tMM6Rx63EaQCGQYDBcEdF4pLVLf3qRchsENd7zxDnam,True,598935647,70569440,439504,219752,219752,YQC4EUcgeBi9431viwvzvBbZJW3szeHX4dFmowRDyDw,37301539,172943238,-135641699,622
2022-03-28 07:46:51-04:00,13921,FcXe2wJqFzVRpRMSsPwzmwKAQ7f9CfHmwCt99k1cQeE1,BFjwToxLi3yzSDP13XqEXifQXahGyr5BWPBJyiM2iaai,True,34606134,3062038,19135,9567,9568,3zqXX6kzhkbW3d4TwD2CNjMRwxTbREXySekvq37kfCNk,2162620,10190702,-8028082,624
2022-03-28 09:36:16-04:00,13922,AxUKatZukyU1PaNZzQFftBbga7GQC7nArZKv6wHCtXVR,HEqbmmGLsuxSSbqx931nFbbhhsNFNEx8Srf8J7wZr7pa,True,34602065,3045149,19016,9508,9508,3zqXX6kzhkbW3d4TwD2CNjMRwxTbREXySekvq37kfCNk,2160902,10184934,-8024032,624
2022-03-28 09:36:18-04:00,13923,4S7Ky4QBiqRWUFYsCcsSnijMTPsNNcDDSAHNyS9Mvzo2,DsdFdR1MT5pdU196PCYM6a5os3TAiAg6fUweGAugHsb8,True,57089171,14272292,88993,44496,44497,3zqXX6kzhkbW3d4TwD2CNjMRwxTbREXySekvq37kfCNk,3559755,18646904,-15087149,623
2022-03-28 09:38:11-04:00,13924,HegY1tDz2ki6vSf9FPRSF4dwGKyciGCt6bovVYdFJRk6,soWdvQVu9EW4Mkk5WUY6rZLA3cEXhFUKqNyY7kpg8ZD,True,33659865,2919729,18233,9116,9117,3zqXX6kzhkbW3d4TwD2CNjMRwxTbREXySekvq37kfCNk,2102018,10027541,-7925523,624
2022-03-28 09:38:12-04:00,13925,6fSdeis6nFxh1SZusjL6cReVZLqVPTK4bo33XY1JRLts,91dgzxhnfPYvnQK5GSbqVJ4XKPMxSoqATS78CEhnXNoG,True,20432593,5108148,31881,15940,15941,3zqXX6kzhkbW3d4TwD2CNjMRwxTbREXySekvq37kfCNk,1275255,3080110,-1804855,624
2022-03-28 09:52:39-04:00,13926,BKh4M4RqABRMxV6WuHRwMtX7f1C7KmJZg7UC85HWBU9,AxnhkR43eVPWrSZwrLkZ9GqERfYRbANwXqPurK21joJW,True,376633590,94158397,585904,292952,292952,3zqXX6kzhkbW3d4TwD2CNjMRwxTbREXySekvq37kfCNk,23436183,62587635,-39151452,622
2022-03-28 09:52:53-04:00,13927,FcXe2wJqFzVRpRMSsPwzmwKAQ7f9CfHmwCt99k1cQeE1,BFjwToxLi3yzSDP13XqEXifQXahGyr5BWPBJyiM2iaai,True,31705318,2912787,18201,9100,9101,3zqXX6kzhkbW3d4TwD2CNjMRwxTbREXySekvq37kfCNk,1981163,9323270,-7342107,624
2022-03-28 09:52:55-04:00,13928,HZ7AK8m2hQ5JSKV6dU97VJjKbhdAj91aLHkmckXGBam6,Aw4qaqgEsxys52J5a97wAjfFavYKFZEAYEpBgkzi4pLW,True,2291268615,572817153,3575059,1787529,1787530,3zqXX6kzhkbW3d4TwD2CNjMRwxTbREXySekvq37kfCNk,143002395,534974571,-391972176,624
2022-03-28 09:54:32-04:00,13929,GTzLxRn226vTjN4HTSDSCjDLjwNiP4jsarG4umsA4CPc,6BWii3HLmdacnSS1pe8RkbbN6kbe4jpYYbnHqM1hh2G5,True,354750939,88687734,552871,276435,276436,YQC4EUcgeBi9431viwvzvBbZJW3szeHX4dFmowRDyDw,22114858,59884339,-37769481,623
2022-03-28 09:55:24-04:00,13930,Bmqae54jhWBLPKUhbE9qJN3Wfy56zR9U6kygyvPjin4Y,EV6XRL5dMERF3yWBQYeXscBiqWwGQ3mYXApdqBUZnhj9,True,224496232,56124058,347822,173911,173911,3zqXX6kzhkbW3d4TwD2CNjMRwxTbREXySekvq37kfCNk,13912895,60209650,-46296755,619
2022-03-28 09:55:45-04:00,13931,AxUKatZukyU1PaNZzQFftBbga7GQC7nArZKv6wHCtXVR,HEqbmmGLsuxSSbqx931nFbbhhsNFNEx8Srf8J7wZr7pa,True,31725534,2914664,18128,9064,9064,YQC4EUcgeBi9431viwvzvBbZJW3szeHX4dFmowRDyDw,1973268,9335612,-7362344,621
2022-03-28 09:56:13-04:00,13932,HREFGG6Dedwcd81uY8UER88bgX9aNWF3ggADJW5NVpvj,3tMM6Rx63EaQCGQYDBcEdF4pLVLf3qRchsENd7zxDnam,True,532022504,60233012,375707,187853,187854,YQC4EUcgeBi9431viwvzvBbZJW3szeHX4dFmowRDyDw,33185254,154763294,-121578040,623
2022-03-28 09:56:15-04:00,13933,A11mzoTX3dyc9gACVJkbRGZ6QACJsrF3ZHJUsGEtRnsj,H7z8CfHxnxo3mPrvxfiLLNwrDX1cxGWWDUxXs9EpzSi,True,26044277,6511069,40542,20271,20271,3zqXX6kzhkbW3d4TwD2CNjMRwxTbREXySekvq37kfCNk,1621711,4903755,-3282044,622
2022-03-28 09:56:28-04:00,13934,4BHydPKft6s7nYozhJ63rVrkQ22QywsrBQf2BAuW6mDS,8Tz6FZpzjoRBZqEwdPdkr4XGmURu3n1SjV3CTuc3o5yw,True,22213103,5553275,34499,17249,17250,3zqXX6kzhkbW3d4TwD2CNjMRwxTbREXySekvq37kfCNk,1379962,5738182,-4358220,621
2022-03-28 09:56:32-04:00,13935,HegY1tDz2ki6vSf9FPRSF4dwGKyciGCt6bovVYdFJRk6,soWdvQVu9EW4Mkk5WUY6rZLA3cEXhFUKqNyY7kpg8ZD,True,30893896,2927030,18285,9142,9143,3zqXX6kzhkbW3d4TwD2CNjMRwxTbREXySekvq37kfCNk,1930025,9304426,-7374401,624
2022-03-28 09:57:28-04:00,13936,CLP8qmL8aN9ocJKYnbKSo4k46CU3LBsebspfREQcSGvo,F6tkkFJnvjYyPdSXDNzZMUfhd1o8dFiLyLPRZ5U1sXHE,True,26201505,6550376,40887,20443,20444,3zqXX6kzhkbW3d4TwD2CNjMRwxTbREXySekvq37kfCNk,1635492,7838611,-6203119,624
2022-03-28 10:32:30-04:00,13937,3Gkfjg2BFLhzvTArvUb7t4EqjMevBgjLYHiQ62bMjC5q,oNcVBNCpeMzQDMqat31fDFi8x4G7Af3Rsm4uSMwngdb,True,18610024,4652506,29000,14500,14500,3zqXX6kzhkbW3d4TwD2CNjMRwxTbREXySekvq37kfCNk,1160000,2894230,-1734230,623
2022-03-28 10:47:36-04:00,13938,v8PjH3mAe252Zyh1iuPMigysGQZoZL1KncefGDw1ANx,2BDYraDRL6SekAjXy3rbGXCxmPt75gkEfhomEp9FzkUE,True,104104468280,8664627700,53970501,26985250,26985251,3zqXX6kzhkbW3d4TwD2CNjMRwxTbREXySekvq37kfCNk,6484491406,18072344441,-11587853035,622
2022-03-28 10:47:37-04:00,13939,CD72r5bjRGSd1tLsvDC9YQe5nPYBHexpXGPZvyMRdAwk,5syEXm5Dc1UgWAHfCmgooc4Wkjei8V5A1PR5MNWMPT7N,True,25646614,6411653,39720,19860,19860,YQC4EUcgeBi9431viwvzvBbZJW3szeHX4dFmowRDyDw,1588831,5183022,-3594191,619
2022-03-28 10:47:38-04:00,13940,6Rk6wVu6pCDFwEWDbiY8wS93nDghyHP9kzdUEa6eFRRq,B5v7eFjSX6dDt1kt84Uvtqmrn7STbQPMbFMvjH6WGXJg,True,200330105,50082518,300873,150436,150437,YQC4EUcgeBi9431viwvzvBbZJW3szeHX4dFmowRDyDw,12034990,45067162,-33032172,600
2022-03-28 10:47:44-04:00,13941,5BSr2tqthLtZfR2Dcq1hndaU2URYFNzdfjh3evp4kUnV,HcTxCpo9CeQMAjvXE9668B2LQHJXNqEUsPABLputs7Nm,True,150271891,37567972,234575,117287,117288,3zqXX6kzhkbW3d4TwD2CNjMRwxTbREXySekvq37kfCNk,9383037,27556804,-18173767,624
2022-03-28 10:47:44-04:00,13942,429jPeeFjDTX93YH4wyuZKDsbTikueUnsFG6cvFQC3Nf,9npKGMooVRgrs4DP5JCRkjD5bM2Uu1R5YTCc6CXPe4mh,True,17014995,4253748,26327,13163,13164,YQC4EUcgeBi9431viwvzvBbZJW3szeHX4dFmowRDyDw,1053097,3445076,-2391979,618
2022-03-28 10:47:59-04:00,13943,AzmKB7i1dJucc5Ec1mxpoJor662CDFKAAWRstWDtrmaq,Fd2bPyTR54f8fcTkUokCjcgYgReTGR9vN7ymaGXVcMDK,True,581542237,145385559,908407,454203,454204,3zqXX6kzhkbW3d4TwD2CNjMRwxTbREXySekvq37kfCNk,36336316,141862491,-105526175,624
2022-03-28 10:48:00-04:00,13944,4J7uT2PQnrfWazv3DJcM82i49WmTugyfpdmDvEjKLDks,HsyGm9ttVqNJp38udSabXHM11MTaNUdxnAT2fWKWz1HZ,True,35936617,8984154,55228,27614,27614,3zqXX6kzhkbW3d4TwD2CNjMRwxTbREXySekvq37kfCNk,2209139,11025723,-8816584,614
2022-03-28 10:48:27-04:00,13945,6NtCMv6nfNhBTXZdoUBYy52hUNWDFZNtdznX3BJsbePF,AEMV8N9T2ci7dny4DJGYWTjj2jdZCFb5rCRAviwDQ6gA,False,404482,404482,25155,1257,23898,3zqXX6kzhkbW3d4TwD2CNjMRwxTbREXySekvq37kfCNk,25155,84436,-59281,621
2022-03-28 10:49:33-04:00,13946,HBYoCwAU3bgnxsrUpBcgEs1ppJxn7Firm8sgpQYCYnsM,EZEEdtBnevEDeAC4SSzUUgLixHHAukPwHtvyi5yeYbFW,True,48718098,12179524,76016,38008,38008,3zqXX6kzhkbW3d4TwD2CNjMRwxTbREXySekvq37kfCNk,3040670,6274906,-3234236,624
2022-03-28 10:50:58-04:00,13947,FcXe2wJqFzVRpRMSsPwzmwKAQ7f9CfHmwCt99k1cQeE1,BFjwToxLi3yzSDP13XqEXifQXahGyr5BWPBJyiM2iaai,True,28946073,2717369,16981,8490,8491,3zqXX6kzhkbW3d4TwD2CNjMRwxTbREXySekvq37kfCNk,1808892,8606589,-6797697,624
2022-03-28 10:51:20-04:00,13948,v8PjH3mAe252Zyh1iuPMigysGQZoZL1KncefGDw1ANx,2BDYraDRL6SekAjXy3rbGXCxmPt75gkEfhomEp9FzkUE,True,95885153166,7141007620,44574594,22287297,22287297,YQC4EUcgeBi9431viwvzvBbZJW3szeHX4dFmowRDyDw,5985208319,16406890045,-10421681726,624
2022-03-28 10:51:21-04:00,13949,5seV37JfFeqX91yaDfiupi2Ms7yYuuZFHwZ42ovhTbdU,KqBKpYuGWPhC8iYvedTYb4k5Lu3y89UMxt46t8gvn6h,True,973709656,243427414,1511457,755728,755729,3zqXX6kzhkbW3d4TwD2CNjMRwxTbREXySekvq37kfCNk,60458295,182600951,-122142656,620
2022-03-28 10:51:37-04:00,13950,AxUKatZukyU1PaNZzQFftBbga7GQC7nArZKv6wHCtXVR,HEqbmmGLsuxSSbqx931nFbbhhsNFNEx8Srf8J7wZr7pa,True,28959471,2710131,16901,8450,8451,3zqXX6kzhkbW3d4TwD2CNjMRwxTbREXySekvq37kfCNk,1806013,8617123,-6811110,623
2022-03-28 10:52:06-04:00,13951,AT4qoJDVGXpEm3BGACUhC1zpVNLq4iX2bJ4cpABehpoD,AqaDPXbaY6ksVQwWGKorgBdRQMz3VpqxmHdWXmq17ScF,True,4946914356,1236728589,7716658,3858329,3858329,3zqXX6kzhkbW3d4TwD2CNjMRwxTbREXySekvq37kfCNk,308666344,1508815222,-1200148878,623
2022-03-28 10:52:33-04:00,13952,AkGQxVK2FFRi9doFRx5gwGXBr6WKknvU3evZkDu3Yas4,Abu1FYCyBSutkrvrx56tL61xoDyYSCjwrDU1wnKn2gin,True,44240334,11060083,69114,34557,34557,3zqXX6kzhkbW3d4TwD2CNjMRwxTbREXySekvq37kfCNk,2764588,14158419,-11393831,624
2022-03-28 10:55:03-04:00,13953,4BHydPKft6s7nYozhJ63rVrkQ22QywsrBQf2BAuW6mDS,8Tz6FZpzjoRBZqEwdPdkr4XGmURu3n1SjV3CTuc3o5yw,True,16958362,4239590,26172,13086,13086,YQC4EUcgeBi9431viwvzvBbZJW3szeHX4dFmowRDyDw,1046886,4614088,-3567202,617
2022-03-28 10:55:06-04:00,13954,A11mzoTX3dyc9gACVJkbRGZ6QACJsrF3ZHJUsGEtRnsj,H7z8CfHxnxo3mPrvxfiLLNwrDX1cxGWWDUxXs9EpzSi,True,19874010,4968502,31007,15503,15504,3zqXX6kzhkbW3d4TwD2CNjMRwxTbREXySekvq37kfCNk,1240316,4042655,-2802339,624
2022-03-28 11:12:19-04:00,13955,2Gfse9HBrkdSHZrKFk2Lbabmw7Mf9SAGpTftge3QCzfh,7bEeqMeSHXDSZzPu6sZEtHCUs1uZRXqWfz9FHwD9gBGS,True,284032243,71008060,443603,221801,221802,3zqXX6kzhkbW3d4TwD2CNjMRwxTbREXySekvq37kfCNk,17744120,48684109,-30939989,624
2022-03-28 11:23:45-04:00,13956,v8PjH3mAe252Zyh1iuPMigysGQZoZL1KncefGDw1ANx,2BDYraDRL6SekAjXy3rbGXCxmPt75gkEfhomEp9FzkUE,True,89115558857,6873346429,42945066,21472533,21472533,3zqXX6kzhkbW3d4TwD2CNjMRwxTbREXySekvq37kfCNk,5567991703,16151260705,-10583269002,624
2022-03-28 11:24:14-04:00,13957,HegY1tDz2ki6vSf9FPRSF4dwGKyciGCt6bovVYdFJRk6,soWdvQVu9EW4Mkk5WUY6rZLA3cEXhFUKqNyY7kpg8ZD,True,28122688,2598791,16217,8108,8109,3zqXX6kzhkbW3d4TwD2CNjMRwxTbREXySekvq37kfCNk,1755013,8467578,-6712565,624
2022-03-28 11:25:45-04:00,13958,DgtZ1dBzCaR4K38CxgyhxaGCdwXM69N4CZDZ4nsZXYE4,8x5yYiS88nDTvj1v11s3J9kQ94S3j94NZvqfV9dxJuWJ,True,1001463025,250365756,1564417,782208,782209,3zqXX6kzhkbW3d4TwD2CNjMRwxTbREXySekvq37kfCNk,62576685,162703454,-100126769,624
2022-03-28 12:20:44-04:00,13959,8qq2gfbca7JXvq4gViBBVT2QAbM4MvBMEQLXgn8UUTvt,3o5jpBVYdFFEYrGRdCUkLrUC85wsuTKgy8iYwnpZyC1B,True,3192400941,420543540,2623668,1311834,1311834,3zqXX6kzhkbW3d4TwD2CNjMRwxTbREXySekvq37kfCNk,199166089,871161224,-671995135,623
2022-03-28 12:46:33-04:00,13960,88awjJ2gbtVpwNCSwDLUbmtQM5xqGbJBwgEngdgUT8uV,7SE7JbDbRgsUzXUAnTrtCyzSCnEkLyYRuTQYRFqQ4rH9,True,115802454,28950613,180800,90400,90400,YQC4EUcgeBi9431viwvzvBbZJW3szeHX4dFmowRDyDw,7232009,14517369,-7285360,624
2022-03-28 13:53:20-04:00,13961,88awjJ2gbtVpwNCSwDLUbmtQM5xqGbJBwgEngdgUT8uV,7SE7JbDbRgsUzXUAnTrtCyzSCnEkLyYRuTQYRFqQ4rH9,True,88406208,22101552,137355,68677,68678,3zqXX6kzhkbW3d4TwD2CNjMRwxTbREXySekvq37kfCNk,5494223,12512690,-7018467,621
2022-03-28 14:22:40-04:00,13962,v8PjH3mAe252Zyh1iuPMigysGQZoZL1KncefGDw1ANx,2BDYraDRL6SekAjXy3rbGXCxmPt75gkEfhomEp9FzkUE,True,82602266336,6447725449,40290275,20145137,20145138,3zqXX6kzhkbW3d4TwD2CNjMRwxTbREXySekvq37kfCNk,5161615714,15487042778,-10325427064,624
2022-03-28 14:46:00-04:00,13963,v8PjH3mAe252Zyh1iuPMigysGQZoZL1KncefGDw1ANx,2BDYraDRL6SekAjXy3rbGXCxmPt75gkEfhomEp9FzkUE,True,76499793229,5625281631,35120037,17560018,17560019,3zqXX6kzhkbW3d4TwD2CNjMRwxTbREXySekvq37kfCNk,4776073097,14285785460,-9509712363,624
2022-03-28 14:48:17-04:00,13964,5YC2wXkdk7D4Ubs9TEAbP1hi88Sy35bzYVWjLbgVxn5s,4Mx69ezqFK2wudZ62oVhx2pwjVbKv8JB1HR29ZUcdEJb,True,4757982144,1189495536,7383365,3691682,3691683,3zqXX6kzhkbW3d4TwD2CNjMRwxTbREXySekvq37kfCNk,295334620,836116781,-540782161,620
2022-03-28 14:49:10-04:00,13965,HREFGG6Dedwcd81uY8UER88bgX9aNWF3ggADJW5NVpvj,3tMM6Rx63EaQCGQYDBcEdF4pLVLf3qRchsENd7zxDnam,True,474972586,53691824,334595,167297,167298,3zqXX6kzhkbW3d4TwD2CNjMRwxTbREXySekvq37kfCNk,29599231,141208045,-111608814,623
2022-03-28 14:52:24-04:00,13966,FcXe2wJqFzVRpRMSsPwzmwKAQ7f9CfHmwCt99k1cQeE1,BFjwToxLi3yzSDP13XqEXifQXahGyr5BWPBJyiM2iaai,True,26379046,2324960,14461,7230,7231,3zqXX6kzhkbW3d4TwD2CNjMRwxTbREXySekvq37kfCNk,1640864,8086375,-6445511,622
2022-03-28 14:52:24-04:00,13967,v8PjH3mAe252Zyh1iuPMigysGQZoZL1KncefGDw1ANx,2BDYraDRL6SekAjXy3rbGXCxmPt75gkEfhomEp9FzkUE,True,71172985109,5193008213,32413748,16206874,16206874,3zqXX6kzhkbW3d4TwD2CNjMRwxTbREXySekvq37kfCNk,4442479549,13821613101,-9379133552,624
2022-03-28 15:18:21-04:00,13968,88awjJ2gbtVpwNCSwDLUbmtQM5xqGbJBwgEngdgUT8uV,7SE7JbDbRgsUzXUAnTrtCyzSCnEkLyYRuTQYRFqQ4rH9,True,67443885,16860971,105205,52602,52603,47z82br5WdW2DZajdnPDPSSRRKsyAggqXqK6oPUwTaLf,4208211,10611335,-6403124,623
2022-03-28 17:03:07-04:00,13969,AxUKatZukyU1PaNZzQFftBbga7GQC7nArZKv6wHCtXVR,HEqbmmGLsuxSSbqx931nFbbhhsNFNEx8Srf8J7wZr7pa,True,26388313,2327677,14538,7269,7269,3zqXX6kzhkbW3d4TwD2CNjMRwxTbREXySekvq37kfCNk,1648182,8102972,-6454790,624
2022-03-28 19:19:34-04:00,13970,7CSCMFa9W52tBDVUbXbc3woAy3GByeA1wPJdp3MgznPa,3447ptuVFu6G8B6N63RmS8mRv4n9PfHneypHLvbeaGLn,True,10316171860,1165651125,7240469,3620234,3620235,47z82br5WdW2DZajdnPDPSSRRKsyAggqXqK6oPUwTaLf,640791493,1092177760,-451386267,621
2022-03-28 19:19:36-04:00,13971,8qq2gfbca7JXvq4gViBBVT2QAbM4MvBMEQLXgn8UUTvt,3o5jpBVYdFFEYrGRdCUkLrUC85wsuTKgy8iYwnpZyC1B,True,2742660140,314916264,1964772,982386,982386,47z82br5WdW2DZajdnPDPSSRRKsyAggqXqK6oPUwTaLf,171115430,822848431,-651733001,623
2022-03-28 19:20:46-04:00,13972,D3mQ4aGmHdD8QHuDzGx1ZGRMaM4eB32LzVp1dnt931wx,86icTdjxoqizRxHTrGPUjFkR7gaapLFMuYVLogWJZ12J,True,35435100,8858775,53039,26519,26520,47z82br5WdW2DZajdnPDPSSRRKsyAggqXqK6oPUwTaLf,2121575,3661281,-1539706,598
2022-03-28 19:20:52-04:00,13973,9GfDDypCCSZVA19wMaqoHLNKMHuHNEgmgUB5V8iAaeoL,8pLnmCLcuFpDbnMuPtM2XyYyxsWJBJR51oxDvL6hq9Hk,True,3321821297,830455324,5711037,2855518,2855519,72FwbpFGoLEazJEdpqNtPNefsadUrimUqma9wSoy4qiS,228441482,345721313,-117279831,687
2022-03-28 19:55:45-04:00,13974,9GfDDypCCSZVA19wMaqoHLNKMHuHNEgmgUB5V8iAaeoL,8pLnmCLcuFpDbnMuPtM2XyYyxsWJBJR51oxDvL6hq9Hk,True,2434811620,608702905,4154402,2077201,2077201,72FwbpFGoLEazJEdpqNtPNefsadUrimUqma9wSoy4qiS,166176092,311681505,-145505413,682
2022-03-28 20:08:21-04:00,13975,9GfDDypCCSZVA19wMaqoHLNKMHuHNEgmgUB5V8iAaeoL,8pLnmCLcuFpDbnMuPtM2XyYyxsWJBJR51oxDvL6hq9Hk,True,1788654016,447163504,3110846,1555423,1555423,72FwbpFGoLEazJEdpqNtPNefsadUrimUqma9wSoy4qiS,124433862,271569172,-147135310,695
2022-03-28 22:34:19-04:00,13976,Gr3vv3TmUeQWxjRfE1mLwhLt7TtdY33x5rrKAzjBTVJs,FZWoYYVfeJN8Y93Yw82jyE8DnC39dWMDjNi2NxffTdey,True,50420103,12605025,77583,38791,38792,3RdfgDvLvsdZG5Cf6hKiKMQMqfidyxHzjYvUx1FZpeHQ,3103334,8503438,-5400104,615
2022-03-28 22:55:51-04:00,13977,88awjJ2gbtVpwNCSwDLUbmtQM5xqGbJBwgEngdgUT8uV,7SE7JbDbRgsUzXUAnTrtCyzSCnEkLyYRuTQYRFqQ4rH9,True,51463608,12865902,80251,40125,40126,YQC4EUcgeBi9431viwvzvBbZJW3szeHX4dFmowRDyDw,3210046,8893108,-5683062,623
2022-03-28 23:00:12-04:00,13978,GNWK9cTrChbcAqTWaonyQ1SKWh1PELcRzATeKra7Cj7m,G5bQaczo8MNq3GHLx9V6UtX6N2EfzQYuEQ64Tm2E8RHK,True,130635248,32658812,204063,102031,102032,3RdfgDvLvsdZG5Cf6hKiKMQMqfidyxHzjYvUx1FZpeHQ,8162549,51393357,-43230808,624
2022-03-28 23:14:47-04:00,13979,9JYkdQkHpsKvahhLjrdPevjQ9YR5WhirDc8N7imwT7P1,2PhTT3abP2XPdjk8KXawH36yRrttxGBGezV5rGiRkcKN,False,2209636,2209636,137942,6897,131045,YQC4EUcgeBi9431viwvzvBbZJW3szeHX4dFmowRDyDw,137943,219055,-81112,624
2022-03-28 23:32:41-04:00,13980,Gr3vv3TmUeQWxjRfE1mLwhLt7TtdY33x5rrKAzjBTVJs,FZWoYYVfeJN8Y93Yw82jyE8DnC39dWMDjNi2NxffTdey,True,38438442,9609610,60022,30011,30011,YQC4EUcgeBi9431viwvzvBbZJW3szeHX4dFmowRDyDw,2400909,7074365,-4673456,624
2022-03-29 00:19:16-04:00,13981,88awjJ2gbtVpwNCSwDLUbmtQM5xqGbJBwgEngdgUT8uV,7SE7JbDbRgsUzXUAnTrtCyzSCnEkLyYRuTQYRFqQ4rH9,True,39293765,9823441,60750,30375,30375,YQC4EUcgeBi9431viwvzvBbZJW3szeHX4dFmowRDyDw,2430004,7388374,-4958370,618
2022-03-29 00:23:14-04:00,13982,GNWK9cTrChbcAqTWaonyQ1SKWh1PELcRzATeKra7Cj7m,G5bQaczo8MNq3GHLx9V6UtX6N2EfzQYuEQ64Tm2E8RHK,True,99999981,24999995,148232,74116,74116,YQC4EUcgeBi9431viwvzvBbZJW3szeHX4dFmowRDyDw,5929302,40376023,-34446721,592
2022-03-29 00:34:52-04:00,13983,Gr3vv3TmUeQWxjRfE1mLwhLt7TtdY33x5rrKAzjBTVJs,FZWoYYVfeJN8Y93Yw82jyE8DnC39dWMDjNi2NxffTdey,True,29340590,7335147,45686,22843,22843,YQC4EUcgeBi9431viwvzvBbZJW3szeHX4dFmowRDyDw,1827477,5844335,-4016858,622
2022-03-29 01:04:23-04:00,13984,v8PjH3mAe252Zyh1iuPMigysGQZoZL1KncefGDw1ANx,2BDYraDRL6SekAjXy3rbGXCxmPt75gkEfhomEp9FzkUE,True,66238491625,4847413282,30282217,15141108,15141109,3zqXX6kzhkbW3d4TwD2CNjMRwxTbREXySekvq37kfCNk,4137976917,13271860975,-9133884058,624
2022-03-29 04:10:47-04:00,13985,7zqJsqdXgv922pDkWtNoVKvX3FpabXQUAuWvqgbqgFeV,46fTwY6ZT3sDuDTX1ABZdUcNDy541inNnzQitEz36e7c,True,93001703135,12321751530,70922268,35461134,35461134,YQC4EUcgeBi9431viwvzvBbZJW3szeHX4dFmowRDyDw,5353047256,7809019702,-2455972446,575
2022-03-29 07:46:09-04:00,13986,HegY1tDz2ki6vSf9FPRSF4dwGKyciGCt6bovVYdFJRk6,soWdvQVu9EW4Mkk5WUY6rZLA3cEXhFUKqNyY7kpg8ZD,True,25661861,2242327,13961,6980,6981,YQC4EUcgeBi9431viwvzvBbZJW3szeHX4dFmowRDyDw,1597764,7958872,-6361108,622
2022-03-29 07:49:30-04:00,13987,FcXe2wJqFzVRpRMSsPwzmwKAQ7f9CfHmwCt99k1cQeE1,BFjwToxLi3yzSDP13XqEXifQXahGyr5BWPBJyiM2iaai,True,24167384,2241354,14006,7003,7003,YQC4EUcgeBi9431viwvzvBbZJW3szeHX4dFmowRDyDw,1510206,7405185,-5894979,624
2022-03-29 08:11:09-04:00,13988,AxUKatZukyU1PaNZzQFftBbga7GQC7nArZKv6wHCtXVR,HEqbmmGLsuxSSbqx931nFbbhhsNFNEx8Srf8J7wZr7pa,True,24181865,2246203,14029,7014,7015,YQC4EUcgeBi9431viwvzvBbZJW3szeHX4dFmowRDyDw,1510406,7419880,-5909474,624
2022-03-29 08:11:44-04:00,13989,v8PjH3mAe252Zyh1iuPMigysGQZoZL1KncefGDw1ANx,2BDYraDRL6SekAjXy3rbGXCxmPt75gkEfhomEp9FzkUE,True,61641260381,4380294599,27371198,13685599,13685599,3zqXX6kzhkbW3d4TwD2CNjMRwxTbREXySekvq37kfCNk,3851784694,12351782375,-8499997681,624
2022-03-29 08:12:28-04:00,13990,HegY1tDz2ki6vSf9FPRSF4dwGKyciGCt6bovVYdFJRk6,soWdvQVu9EW4Mkk5WUY6rZLA3cEXhFUKqNyY7kpg8ZD,True,23534423,2232979,13933,6966,6967,YQC4EUcgeBi9431viwvzvBbZJW3szeHX4dFmowRDyDw,1468584,7363387,-5894803,624
2022-03-29 08:15:05-04:00,13991,8K1GzGeaAuFdjuVZi6DqBcYiA1zSRioMkRvjotr8p7fz,5mqocPwTdjwAPiJf7vx9bo7AzvfQBT2t5bV9u2Jzb2e1,True,2794867483,698716870,4363628,2181814,2181814,3zqXX6kzhkbW3d4TwD2CNjMRwxTbREXySekvq37kfCNk,174545137,271537119,-96991982,624
2022-03-29 08:15:06-04:00,13992,CLP8qmL8aN9ocJKYnbKSo4k46CU3LBsebspfREQcSGvo,F6tkkFJnvjYyPdSXDNzZMUfhd1o8dFiLyLPRZ5U1sXHE,True,20016621,5004155,30773,15386,15387,YQC4EUcgeBi9431viwvzvBbZJW3szeHX4dFmowRDyDw,1230933,6248768,-5017835,614
2022-03-29 08:44:36-04:00,13993,J1hcSpbzFoDTKb78Pk2AEedKHSzQGrB25jAXG4bio8K7,ruzy52ZWcT8J5e3gVancgmiCX8KnH6dq2iGiJnZuv78,False,697002,697002,43143,2157,40986,YQC4EUcgeBi9431viwvzvBbZJW3szeHX4dFmowRDyDw,43143,137698,-94555,618
2022-03-29 08:44:36-04:00,13994,7yW1M1xeVx4hy3QftnpqdBDRYwamfu3K5i6AEnxgyTWb,7wf7FWS2DYp5RveQAmGNXAEUWPcHziuMLd4hV5LPgxF8,True,725235899,181308974,1126893,563446,563447,YQC4EUcgeBi9431viwvzvBbZJW3szeHX4dFmowRDyDw,45075740,70311135,-25235395,621
2022-03-29 08:44:40-04:00,13995,CD72r5bjRGSd1tLsvDC9YQe5nPYBHexpXGPZvyMRdAwk,5syEXm5Dc1UgWAHfCmgooc4Wkjei8V5A1PR5MNWMPT7N,True,19565403,4891350,30512,15256,15256,YQC4EUcgeBi9431viwvzvBbZJW3szeHX4dFmowRDyDw,1220495,4246584,-3026089,623
2022-03-29 08:45:04-04:00,13996,429jPeeFjDTX93YH4wyuZKDsbTikueUnsFG6cvFQC3Nf,9npKGMooVRgrs4DP5JCRkjD5bM2Uu1R5YTCc6CXPe4mh,False,12982868,12982868,806359,40317,766042,YQC4EUcgeBi9431viwvzvBbZJW3szeHX4dFmowRDyDw,806359,2821966,-2015607,621
2022-03-29 08:45:06-04:00,13997,5BSr2tqthLtZfR2Dcq1hndaU2URYFNzdfjh3evp4kUnV,HcTxCpo9CeQMAjvXE9668B2LQHJXNqEUsPABLputs7Nm,True,114786706,28696676,176909,88454,88455,3zqXX6kzhkbW3d4TwD2CNjMRwxTbREXySekvq37kfCNk,7076361,22789616,-15713255,616
2022-03-29 08:45:21-04:00,13998,niCk6QHFU1kyU56Mdq5RJzKrecdkNSn23ZA6wduFdWS,BQbUYSw1XsuE6LnVd4XjmxAyYgx4drE4FsetJBCdwVZW,True,106892496,18106723,113079,56539,56540,YQC4EUcgeBi9431viwvzvBbZJW3szeHX4dFmowRDyDw,6675606,15273991,-8598385,624
2022-03-29 08:45:41-04:00,13999,FcXe2wJqFzVRpRMSsPwzmwKAQ7f9CfHmwCt99k1cQeE1,BFjwToxLi3yzSDP13XqEXifQXahGyr5BWPBJyiM2iaai,True,22049759,2053646,12779,6389,6390,YQC4EUcgeBi9431viwvzvBbZJW3szeHX4dFmowRDyDw,1372124,6810603,-5438479,622
2022-03-29 08:46:27-04:00,14000,4J7uT2PQnrfWazv3DJcM82i49WmTugyfpdmDvEjKLDks,HsyGm9ttVqNJp38udSabXHM11MTaNUdxnAT2fWKWz1HZ,True,27405779,6851444,42578,21289,21289,YQC4EUcgeBi9431viwvzvBbZJW3szeHX4dFmowRDyDw,1703142,8768903,-7065761,621
2022-03-29 08:46:38-04:00,14001,AzmKB7i1dJucc5Ec1mxpoJor662CDFKAAWRstWDtrmaq,Fd2bPyTR54f8fcTkUokCjcgYgReTGR9vN7ymaGXVcMDK,True,444012013,111003003,690345,345172,345173,3zqXX6kzhkbW3d4TwD2CNjMRwxTbREXySekvq37kfCNk,27613831,114615789,-87001958,621
2022-03-29 08:54:46-04:00,14002,v8PjH3mAe252Zyh1iuPMigysGQZoZL1KncefGDw1ANx,2BDYraDRL6SekAjXy3rbGXCxmPt75gkEfhomEp9FzkUE,True,57493396339,3923569625,24513067,12256533,12256534,YQC4EUcgeBi9431viwvzvBbZJW3szeHX4dFmowRDyDw,3591982939,11840036103,-8248053164,624
2022-03-29 08:56:35-04:00,14003,CHhzBk7s3v78eiNfUnHDV2P1VDMPKEQCwS6F49v76fPQ,57DFvkRBc8cYmyQCxrPmpq6fZqaT9BSurRBoRbuFU5kT,False,274491,274491,17037,851,16186,YQC4EUcgeBi9431viwvzvBbZJW3szeHX4dFmowRDyDw,17037,55538,-38501,620
2022-03-29 08:56:40-04:00,14004,EySWgmc7VFSa2kPLu1F5FuajNNN8gNBvKFWof7Q388up,APGDoB8vc1EFxBSbgEmPH5ita4TLDpzrJPY83d4HP6dR,True,5521414088,1380353522,8576415,4288207,4288208,YQC4EUcgeBi9431viwvzvBbZJW3szeHX4dFmowRDyDw,343056633,538789154,-195732521,621
2022-03-29 08:56:48-04:00,14005,5seV37JfFeqX91yaDfiupi2Ms7yYuuZFHwZ42ovhTbdU,KqBKpYuGWPhC8iYvedTYb4k5Lu3y89UMxt46t8gvn6h,True,743025900,185756475,1156798,578399,578399,3zqXX6kzhkbW3d4TwD2CNjMRwxTbREXySekvq37kfCNk,46271933,150628535,-104356602,622
2022-03-29 08:56:55-04:00,14006,CzWT7zuiD3Usn1DB8C87kZ3yaLcAd1GXe62cZ5xDdEKa,2AsTxJr8dyhHmccUngu2f6beGE9iiXH4yXhmQ48SpCXm,True,168951064,42237766,263384,131692,131692,3zqXX6kzhkbW3d4TwD2CNjMRwxTbREXySekvq37kfCNk,10535394,30964339,-20428945,623
2022-03-29 09:36:24-04:00,14007,v8PjH3mAe252Zyh1iuPMigysGQZoZL1KncefGDw1ANx,2BDYraDRL6SekAjXy3rbGXCxmPt75gkEfhomEp9FzkUE,True,53791819725,3731169481,23200214,11600107,11600107,YQC4EUcgeBi9431viwvzvBbZJW3szeHX4dFmowRDyDw,3344746876,11406833997,-8062087121,621
2022-03-29 10:35:26-04:00,14008,88awjJ2gbtVpwNCSwDLUbmtQM5xqGbJBwgEngdgUT8uV,7SE7JbDbRgsUzXUAnTrtCyzSCnEkLyYRuTQYRFqQ4rH9,True,29966945,7491736,46621,23310,23311,YQC4EUcgeBi9431viwvzvBbZJW3szeHX4dFmowRDyDw,1864850,6080256,-4215406,622
2022-03-29 11:01:22-04:00,14009,Gr3vv3TmUeQWxjRfE1mLwhLt7TtdY33x5rrKAzjBTVJs,FZWoYYVfeJN8Y93Yw82jyE8DnC39dWMDjNi2NxffTdey,True,22384856,5596214,34888,17444,17444,YQC4EUcgeBi9431viwvzvBbZJW3szeHX4dFmowRDyDw,1395542,4787603,-3392061,623
2022-03-29 11:53:18-04:00,14010,SEndYVMCKAeZUKSqGrMUSqXFmxtA9M1t4eXsUhVsTBF,3fcQQcbkpqodakamn82pFnMxBEPL2Drsg4jJNZ6dx72M,True,7034159849,1621471572,10982420,5491210,5491210,3zqXX6kzhkbW3d4TwD2CNjMRwxTbREXySekvq37kfCNk,476432053,721190569,-244758516,677
2022-03-29 12:12:37-04:00,14011,9GfDDypCCSZVA19wMaqoHLNKMHuHNEgmgUB5V8iAaeoL,8pLnmCLcuFpDbnMuPtM2XyYyxsWJBJR51oxDvL6hq9Hk,True,1363970060,340992515,2424579,1212289,1212290,3zqXX6kzhkbW3d4TwD2CNjMRwxTbREXySekvq37kfCNk,96983198,231652301,-134669103,711
2022-03-29 12:12:37-04:00,14012,3hEe6AXGjjVzWnsadNZHfeB6CGg8nKSLyhtyqgBtVivt,6Qdu667ChFcRT7J5QHQzUsWpLmxmNvywAaevseSXqxPZ,True,75356542,18839135,132581,66290,66291,YQC4EUcgeBi9431viwvzvBbZJW3szeHX4dFmowRDyDw,5303248,7702395,-2399147,703
2022-03-29 12:13:51-04:00,14013,SEndYVMCKAeZUKSqGrMUSqXFmxtA9M1t4eXsUhVsTBF,3fcQQcbkpqodakamn82pFnMxBEPL2Drsg4jJNZ6dx72M,True,5449773298,1213611686,8463096,4231548,4231548,YQC4EUcgeBi9431viwvzvBbZJW3szeHX4dFmowRDyDw,380038876,647257045,-267218169,697
2022-03-29 12:14:51-04:00,14014,4U5pUaMfeesvncA9JNmMhs7gSV1B8cmPnXJXSRBVS3So,QaYTU1jx464rJqmQtqtb4z5uuT5KEFNQNQiJgo81RzA,True,211313923,52828480,328039,164019,164020,3zqXX6kzhkbW3d4TwD2CNjMRwxTbREXySekvq37kfCNk,13121585,21779713,-8658128,620
2022-03-29 14:09:00-04:00,14015,74MzhjMjDLChEL9RWjUtb6Ztm7Qmq15MUkrbgAiJ8mgK,EY6caxTDF9WQWa7c9ZJCqL92EDcVMcLaSnHhWXvNW6nA,True,134587488,33646872,210049,105024,105025,YQC4EUcgeBi9431viwvzvBbZJW3szeHX4dFmowRDyDw,8401987,29289467,-20887480,624
2022-03-29 14:09:00-04:00,14016,88awjJ2gbtVpwNCSwDLUbmtQM5xqGbJBwgEngdgUT8uV,7SE7JbDbRgsUzXUAnTrtCyzSCnEkLyYRuTQYRFqQ4rH9,True,22871084,5717771,35457,17728,17729,YQC4EUcgeBi9431viwvzvBbZJW3szeHX4dFmowRDyDw,1418316,4975750,-3557434,620
2022-03-29 15:31:56-04:00,14017,Gr3vv3TmUeQWxjRfE1mLwhLt7TtdY33x5rrKAzjBTVJs,FZWoYYVfeJN8Y93Yw82jyE8DnC39dWMDjNi2NxffTdey,True,17085140,4271285,26529,13264,13265,YQC4EUcgeBi9431viwvzvBbZJW3szeHX4dFmowRDyDw,1061179,3901725,-2840546,621
2022-03-29 18:34:50-04:00,14018,SEndYVMCKAeZUKSqGrMUSqXFmxtA9M1t4eXsUhVsTBF,3fcQQcbkpqodakamn82pFnMxBEPL2Drsg4jJNZ6dx72M,True,5094861845,944304101,6488788,3244394,3244394,3zqXX6kzhkbW3d4TwD2CNjMRwxTbREXySekvq37kfCNk,350093615,568425410,-218331795,687
2022-03-29 21:39:59-04:00,14019,3hEe6AXGjjVzWnsadNZHfeB6CGg8nKSLyhtyqgBtVivt,6Qdu667ChFcRT7J5QHQzUsWpLmxmNvywAaevseSXqxPZ,True,55264095,13816023,97616,48808,48808,YQC4EUcgeBi9431viwvzvBbZJW3szeHX4dFmowRDyDw,3904644,6957841,-3053197,706
2022-03-29 21:40:01-04:00,14020,9GfDDypCCSZVA19wMaqoHLNKMHuHNEgmgUB5V8iAaeoL,8pLnmCLcuFpDbnMuPtM2XyYyxsWJBJR51oxDvL6hq9Hk,True,999374184,249843546,1768126,884063,884063,YQC4EUcgeBi9431viwvzvBbZJW3szeHX4dFmowRDyDw,70725075,195513199,-124788124,707
2022-03-29 21:42:04-04:00,14021,7JbCUyTgV4oLjFST9UUvtJkKpK6F99Pwb1Xe6JT8v7s4,9uYeL9R23XRstddnVE6kohfwCkR41E1GXtyduzc9TwEX,True,97543612467,24385903116,149925533,74962766,74962767,YQC4EUcgeBi9431viwvzvBbZJW3szeHX4dFmowRDyDw,5997021356,10075848301,-4078826945,614
2022-03-29 21:43:07-04:00,14022,4U5pUaMfeesvncA9JNmMhs7gSV1B8cmPnXJXSRBVS3So,QaYTU1jx464rJqmQtqtb4z5uuT5KEFNQNQiJgo81RzA,True,155400312,38850078,242656,121328,121328,YQC4EUcgeBi9431viwvzvBbZJW3szeHX4dFmowRDyDw,9706252,19285319,-9579067,624
2022-03-29 21:43:26-04:00,14023,SEndYVMCKAeZUKSqGrMUSqXFmxtA9M1t4eXsUhVsTBF,3fcQQcbkpqodakamn82pFnMxBEPL2Drsg4jJNZ6dx72M,True,4287498691,697219927,4751416,2375708,2375708,3zqXX6kzhkbW3d4TwD2CNjMRwxTbREXySekvq37kfCNk,292184631,507747019,-215562388,681
2022-03-29 21:43:45-04:00,14024,7yW1M1xeVx4hy3QftnpqdBDRYwamfu3K5i6AEnxgyTWb,7wf7FWS2DYp5RveQAmGNXAEUWPcHziuMLd4hV5LPgxF8,True,334741747,83685436,522306,261153,261153,YQC4EUcgeBi9431viwvzvBbZJW3szeHX4dFmowRDyDw,20892248,42156830,-21264582,624
2022-03-30 02:03:39-04:00,14025,3Xbsek5MsEGoWr3G9yhuohREr26B2vSQcjqXdspTFHta,2rPxkUiMo9wGDq8EvAiwY3ngRpKmL223cBWWNTYoBmFp,True,318221562,79555390,563669,281834,281835,YQC4EUcgeBi9431viwvzvBbZJW3szeHX4dFmowRDyDw,22546771,30759310,-8212539,708
2022-03-30 02:54:34-04:00,14026,3Xbsek5MsEGoWr3G9yhuohREr26B2vSQcjqXdspTFHta,2rPxkUiMo9wGDq8EvAiwY3ngRpKmL223cBWWNTYoBmFp,True,243288934,60822233,434008,217004,217004,3zqXX6kzhkbW3d4TwD2CNjMRwxTbREXySekvq37kfCNk,17360340,28151157,-10790817,713
2022-03-30 09:00:01-04:00,14027,niCk6QHFU1kyU56Mdq5RJzKrecdkNSn23ZA6wduFdWS,BQbUYSw1XsuE6LnVd4XjmxAyYgx4drE4FsetJBCdwVZW,True,88130435,13630427,85187,42593,42594,3zqXX6kzhkbW3d4TwD2CNjMRwxTbREXySekvq37kfCNk,5508020,11858696,-6350676,624
2022-03-30 09:28:19-04:00,14028,AT4qoJDVGXpEm3BGACUhC1zpVNLq4iX2bJ4cpABehpoD,AqaDPXbaY6ksVQwWGKorgBdRQMz3VpqxmHdWXmq17ScF,True,3775881948,943970487,5896748,2948374,2948374,YQC4EUcgeBi9431viwvzvBbZJW3szeHX4dFmowRDyDw,235869922,1201810547,-965940625,624
2022-03-30 09:28:24-04:00,14029,AkGQxVK2FFRi9doFRx5gwGXBr6WKknvU3evZkDu3Yas4,Abu1FYCyBSutkrvrx56tL61xoDyYSCjwrDU1wnKn2gin,True,33782742,8445685,52462,26231,26231,YQC4EUcgeBi9431viwvzvBbZJW3szeHX4dFmowRDyDw,2098495,11246369,-9147874,621
2022-03-30 09:28:26-04:00,14030,A11mzoTX3dyc9gACVJkbRGZ6QACJsrF3ZHJUsGEtRnsj,H7z8CfHxnxo3mPrvxfiLLNwrDX1cxGWWDUxXs9EpzSi,False,15171396,15171396,945895,47294,898601,YQC4EUcgeBi9431viwvzvBbZJW3szeHX4dFmowRDyDw,945895,3313539,-2367644,623
2022-03-30 09:28:27-04:00,14031,4BHydPKft6s7nYozhJ63rVrkQ22QywsrBQf2BAuW6mDS,8Tz6FZpzjoRBZqEwdPdkr4XGmURu3n1SjV3CTuc3o5yw,False,12937873,12937873,803722,40186,763536,YQC4EUcgeBi9431viwvzvBbZJW3szeHX4dFmowRDyDw,803722,3698226,-2894504,621
2022-03-30 09:28:36-04:00,14032,CLP8qmL8aN9ocJKYnbKSo4k46CU3LBsebspfREQcSGvo,F6tkkFJnvjYyPdSXDNzZMUfhd1o8dFiLyLPRZ5U1sXHE,False,15272897,15272897,940813,47040,893773,3zqXX6kzhkbW3d4TwD2CNjMRwxTbREXySekvq37kfCNk,940813,4964622,-4023809,616
2022-03-30 09:29:46-04:00,14033,CD72r5bjRGSd1tLsvDC9YQe5nPYBHexpXGPZvyMRdAwk,5syEXm5Dc1UgWAHfCmgooc4Wkjei8V5A1PR5MNWMPT7N,False,14932215,14932215,932878,46643,886235,YQC4EUcgeBi9431viwvzvBbZJW3szeHX4dFmowRDyDw,932878,3460609,-2527731,624
2022-03-30 09:32:33-04:00,14034,5BSr2tqthLtZfR2Dcq1hndaU2URYFNzdfjh3evp4kUnV,HcTxCpo9CeQMAjvXE9668B2LQHJXNqEUsPABLputs7Nm,True,87539194,21884798,136411,68205,68206,3zqXX6kzhkbW3d4TwD2CNjMRwxTbREXySekvq37kfCNk,5456476,18690662,-13234186,623
2022-03-30 09:32:40-04:00,14035,niCk6QHFU1kyU56Mdq5RJzKrecdkNSn23ZA6wduFdWS,BQbUYSw1XsuE6LnVd4XjmxAyYgx4drE4FsetJBCdwVZW,True,74885968,10365519,64604,32302,32302,YQC4EUcgeBi9431viwvzvBbZJW3szeHX4dFmowRDyDw,4667399,9243711,-4576312,623
2022-03-30 09:32:55-04:00,14036,4J7uT2PQnrfWazv3DJcM82i49WmTugyfpdmDvEjKLDks,HsyGm9ttVqNJp38udSabXHM11MTaNUdxnAT2fWKWz1HZ,True,20914821,5228705,32538,16269,16269,YQC4EUcgeBi9431viwvzvBbZJW3szeHX4dFmowRDyDw,1301553,6961364,-5659811,622
2022-03-30 09:33:10-04:00,14037,AzmKB7i1dJucc5Ec1mxpoJor662CDFKAAWRstWDtrmaq,Fd2bPyTR54f8fcTkUokCjcgYgReTGR9vN7ymaGXVcMDK,True,339057483,84764370,522472,261236,261236,YQC4EUcgeBi9431viwvzvBbZJW3szeHX4dFmowRDyDw,20898902,92199974,-71301072,616
2022-03-30 09:37:49-04:00,14038,DXZMRSKFgnNdiXHps2xzayuztJNH9EUUz2wkCCneXtW5,9Z2sUfTCZCkmw5n3HSsoLG992AcpJo2qxp7XpJnnBxZM,True,3270942230,817730981,5014237,2507118,2507119,3zqXX6kzhkbW3d4TwD2CNjMRwxTbREXySekvq37kfCNk,200570644,249964340,-49393696,613
2022-03-30 10:44:14-04:00,14039,EySWgmc7VFSa2kPLu1F5FuajNNN8gNBvKFWof7Q388up,APGDoB8vc1EFxBSbgEmPH5ita4TLDpzrJPY83d4HP6dR,True,4214206061,1053551515,6533368,3266684,3266684,YQC4EUcgeBi9431viwvzvBbZJW3szeHX4dFmowRDyDw,261334723,481488983,-220154260,620
2022-03-30 10:44:22-04:00,14040,9ZVrkxds9vQ17KGWgANMfJeyMCGxuFRLFVBVS1wrPCqH,HyxwwiTVpAoaeKgX2no9Sp4o8hML15xABjRmMnFfJeYS,True,144536058,36134014,224785,112392,112393,YQC4EUcgeBi9431viwvzvBbZJW3szeHX4dFmowRDyDw,8991412,43787154,-34795742,622
2022-03-30 10:44:29-04:00,14041,5seV37JfFeqX91yaDfiupi2Ms7yYuuZFHwZ42ovhTbdU,KqBKpYuGWPhC8iYvedTYb4k5Lu3y89UMxt46t8gvn6h,True,567210243,141802560,880484,440242,440242,3zqXX6kzhkbW3d4TwD2CNjMRwxTbREXySekvq37kfCNk,35219364,123431010,-88211646,620
2022-03-30 10:47:13-04:00,14042,7Q55QWAHVoeaDAMyK1EkjQmsmj51YPu4AiiMJF2uWoG6,2Eziix2N6sX4zutLfENFsBnhy8X73xQvFUAhHZvmho6B,True,29306841,7326710,45645,22822,22823,YQC4EUcgeBi9431viwvzvBbZJW3szeHX4dFmowRDyDw,1825815,10064550,-8238735,622
2022-03-30 10:47:13-04:00,14043,CzWT7zuiD3Usn1DB8C87kZ3yaLcAd1GXe62cZ5xDdEKa,2AsTxJr8dyhHmccUngu2f6beGE9iiXH4yXhmQ48SpCXm,True,128946918,32236729,201215,100607,100608,YQC4EUcgeBi9431viwvzvBbZJW3szeHX4dFmowRDyDw,8048623,25604130,-17555507,624
2022-03-30 10:49:05-04:00,14044,AT4qoJDVGXpEm3BGACUhC1zpVNLq4iX2bJ4cpABehpoD,AqaDPXbaY6ksVQwWGKorgBdRQMz3VpqxmHdWXmq17ScF,True,2882509572,720627393,4485038,2242519,2242519,YQC4EUcgeBi9431viwvzvBbZJW3szeHX4dFmowRDyDw,179401554,954530478,-775128924,622
2022-03-30 10:49:14-04:00,14045,AkGQxVK2FFRi9doFRx5gwGXBr6WKknvU3evZkDu3Yas4,Abu1FYCyBSutkrvrx56tL61xoDyYSCjwrDU1wnKn2gin,True,25818663,6454665,39116,19558,19558,3zqXX6kzhkbW3d4TwD2CNjMRwxTbREXySekvq37kfCNk,1564663,8907180,-7342517,606
2022-03-30 10:49:34-04:00,14046,EToqvQTpzBfLfgPLf2vbpSkLt4isU6hR6E3Dhcx1uCD9,6sJ7wNkr4fL9uWuFcE9AvpzrNvCp3XX168DwjMLkaM4z,True,73572804978,18393201244,114503157,57251578,57251579,3zqXX6kzhkbW3d4TwD2CNjMRwxTbREXySekvq37kfCNk,4580126283,16115925143,-11535798860,622
2022-03-30 10:50:03-04:00,14047,5BSr2tqthLtZfR2Dcq1hndaU2URYFNzdfjh3evp4kUnV,HcTxCpo9CeQMAjvXE9668B2LQHJXNqEUsPABLputs7Nm,True,66874209,16718552,102521,51260,51261,3zqXX6kzhkbW3d4TwD2CNjMRwxTbREXySekvq37kfCNk,4100862,15246360,-11145498,613
2022-03-30 10:53:18-04:00,14048,niCk6QHFU1kyU56Mdq5RJzKrecdkNSn23ZA6wduFdWS,BQbUYSw1XsuE6LnVd4XjmxAyYgx4drE4FsetJBCdwVZW,True,65116487,8359307,51780,25890,25890,3zqXX6kzhkbW3d4TwD2CNjMRwxTbREXySekvq37kfCNk,4033571,7139039,-3105468,619
2022-03-30 10:53:19-04:00,14049,4J7uT2PQnrfWazv3DJcM82i49WmTugyfpdmDvEjKLDks,HsyGm9ttVqNJp38udSabXHM11MTaNUdxnAT2fWKWz1HZ,False,15968289,15968289,986987,49349,937638,3zqXX6kzhkbW3d4TwD2CNjMRwxTbREXySekvq37kfCNk,986987,5514020,-4527033,618
2022-03-30 10:53:19-04:00,14050,AzmKB7i1dJucc5Ec1mxpoJor662CDFKAAWRstWDtrmaq,Fd2bPyTR54f8fcTkUokCjcgYgReTGR9vN7ymaGXVcMDK,True,258597186,64649296,401867,200933,200934,3RdfgDvLvsdZG5Cf6hKiKMQMqfidyxHzjYvUx1FZpeHQ,16074713,73855231,-57780518,621
2022-03-30 10:53:46-04:00,14051,Hya9U3Ao61oebVBPEnUiqinqvpzTguAZhbAWDmEQpm3a,FdYMMqoYPe5Jgj8R2ovKVUKxRPK1xppR59XRGPdvHRAx,True,280506305,70126576,437650,218825,218825,YQC4EUcgeBi9431viwvzvBbZJW3szeHX4dFmowRDyDw,17506014,97953389,-80447375,624
2022-03-30 10:53:52-04:00,14052,EySWgmc7VFSa2kPLu1F5FuajNNN8gNBvKFWof7Q388up,APGDoB8vc1EFxBSbgEmPH5ita4TLDpzrJPY83d4HP6dR,True,3215338097,803834524,5002945,2501472,2501473,YQC4EUcgeBi9431viwvzvBbZJW3szeHX4dFmowRDyDw,200117804,420035847,-219918043,622
2022-03-30 10:54:27-04:00,14053,9ZVrkxds9vQ17KGWgANMfJeyMCGxuFRLFVBVS1wrPCqH,HyxwwiTVpAoaeKgX2no9Sp4o8hML15xABjRmMnFfJeYS,True,110297110,27574277,171789,85894,85895,YQC4EUcgeBi9431viwvzvBbZJW3szeHX4dFmowRDyDw,6871561,34863545,-27991984,623
2022-03-30 10:54:33-04:00,14054,5seV37JfFeqX91yaDfiupi2Ms7yYuuZFHwZ42ovhTbdU,KqBKpYuGWPhC8iYvedTYb4k5Lu3y89UMxt46t8gvn6h,True,432765898,108191474,674516,337258,337258,3zqXX6kzhkbW3d4TwD2CNjMRwxTbREXySekvq37kfCNk,26980665,100499531,-73518866,623
2022-03-30 10:54:33-04:00,14055,HUS4p17tsXBKEDpErqmWw8obXz7Wbnre8Ep9WvYTDebx,6TcAWZZhCUMpEsXrjqEknWFTPgj8edhkLuJJ1pVFcPZ7,False,611200,611200,37957,1897,36060,3zqXX6kzhkbW3d4TwD2CNjMRwxTbREXySekvq37kfCNk,37957,120883,-82926,621
2022-03-30 10:54:45-04:00,14056,ECghAuNBATf1BCewpLJDi3XFrW3ULgyVkb37hURNARWB,DU6fWUBnqXTMiUBMTz8MSGD68j89K8LZhUhj1WpxbZwM,True,2501999196,625499799,3908699,1954349,1954350,3zqXX6kzhkbW3d4TwD2CNjMRwxTbREXySekvq37kfCNk,156347972,310755987,-154408015,624
2022-03-30 10:54:56-04:00,14057,7Q55QWAHVoeaDAMyK1EkjQmsmj51YPu4AiiMJF2uWoG6,2Eziix2N6sX4zutLfENFsBnhy8X73xQvFUAhHZvmho6B,True,22368291,5592072,34800,17400,17400,3zqXX6kzhkbW3d4TwD2CNjMRwxTbREXySekvq37kfCNk,1392010,7959225,-6567215,622
2022-03-30 10:54:57-04:00,14058,CzWT7zuiD3Usn1DB8C87kZ3yaLcAd1GXe62cZ5xDdEKa,2AsTxJr8dyhHmccUngu2f6beGE9iiXH4yXhmQ48SpCXm,True,98427256,24606814,153258,76629,76629,3zqXX6kzhkbW3d4TwD2CNjMRwxTbREXySekvq37kfCNk,6130341,21014139,-14883798,622
2022-03-30 11:06:06-04:00,14059,4Bi1PEYPfA5VEoBqzGbt5fSd6PwuVsrF5SfLWXtpNxFA,3aApRXGYkRs9AZXchR5i7HnWXiRvBQgg3fz1bb4gMx2U,True,63309043,9457126,58654,29327,29327,YQC4EUcgeBi9431viwvzvBbZJW3szeHX4dFmowRDyDw,3926546,16000566,-12074020,620
2022-03-30 11:06:11-04:00,14060,AkGQxVK2FFRi9doFRx5gwGXBr6WKknvU3evZkDu3Yas4,Abu1FYCyBSutkrvrx56tL61xoDyYSCjwrDU1wnKn2gin,True,19667649,4916912,30552,15276,15276,YQC4EUcgeBi9431viwvzvBbZJW3szeHX4dFmowRDyDw,1222083,7032625,-5810542,621
2022-03-30 11:06:11-04:00,14061,7yW1M1xeVx4hy3QftnpqdBDRYwamfu3K5i6AEnxgyTWb,7wf7FWS2DYp5RveQAmGNXAEUWPcHziuMLd4hV5LPgxF8,True,384798226,96199556,600932,300466,300466,YQC4EUcgeBi9431viwvzvBbZJW3szeHX4dFmowRDyDw,24037308,37829958,-13792650,624
2022-03-30 11:06:13-04:00,14062,AT4qoJDVGXpEm3BGACUhC1zpVNLq4iX2bJ4cpABehpoD,AqaDPXbaY6ksVQwWGKorgBdRQMz3VpqxmHdWXmq17ScF,True,2200154255,550038563,3416634,1708317,1708317,YQC4EUcgeBi9431viwvzvBbZJW3szeHX4dFmowRDyDw,136665371,756326895,-619661524,621
2022-03-30 11:15:34-04:00,14063,niCk6QHFU1kyU56Mdq5RJzKrecdkNSn23ZA6wduFdWS,BQbUYSw1XsuE6LnVd4XjmxAyYgx4drE4FsetJBCdwVZW,True,56853767,7988534,49583,24791,24792,YQC4EUcgeBi9431viwvzvBbZJW3szeHX4dFmowRDyDw,3528847,7986976,-4458129,620
2022-03-30 11:19:37-04:00,14064,5LtcaH2KubtMvwgj6bXBuq5wPH41uiwe7h25L5r2sTKc,3yxQpcC5s557FY8mJrQHp6jxRLnfjsemDiL87ZvLnVkT,False,3328834,3328834,203985,10199,193786,YQC4EUcgeBi9431viwvzvBbZJW3szeHX4dFmowRDyDw,203985,1032819,-828834,612
2022-03-30 11:19:38-04:00,14065,EToqvQTpzBfLfgPLf2vbpSkLt4isU6hR6E3Dhcx1uCD9,6sJ7wNkr4fL9uWuFcE9AvpzrNvCp3XX168DwjMLkaM4z,True,56188675049,14047168762,86427053,43213526,43213527,3zqXX6kzhkbW3d4TwD2CNjMRwxTbREXySekvq37kfCNk,3457082151,13150041955,-9692959804,615
2022-03-30 11:19:40-04:00,14066,5BSr2tqthLtZfR2Dcq1hndaU2URYFNzdfjh3evp4kUnV,HcTxCpo9CeQMAjvXE9668B2LQHJXNqEUsPABLputs7Nm,True,51047956,12761989,77663,38831,38832,3zqXX6kzhkbW3d4TwD2CNjMRwxTbREXySekvq37kfCNk,3106524,12357972,-9251448,608
2022-03-30 11:24:48-04:00,14067,AzmKB7i1dJucc5Ec1mxpoJor662CDFKAAWRstWDtrmaq,Fd2bPyTR54f8fcTkUokCjcgYgReTGR9vN7ymaGXVcMDK,True,197344107,49336026,306962,153481,153481,3zqXX6kzhkbW3d4TwD2CNjMRwxTbREXySekvq37kfCNk,12278491,59010460,-46731969,622
2022-03-30 11:35:45-04:00,14068,6yjPfkAHVeT6pnwwa2iAGnAvmHZc1nirWw1ByjesoTHD,9MwcpCovRfMMbCf1z3PsoqhNY4RmgYXU385bKWFwqMuC,True,902856451,225714112,1408879,704439,704440,3zqXX6kzhkbW3d4TwD2CNjMRwxTbREXySekvq37kfCNk,56355164,206033519,-149678355,624
2022-03-30 11:35:55-04:00,14069,Hya9U3Ao61oebVBPEnUiqinqvpzTguAZhbAWDmEQpm3a,FdYMMqoYPe5Jgj8R2ovKVUKxRPK1xppR59XRGPdvHRAx,True,214073531,53518382,334414,167207,167207,YQC4EUcgeBi9431viwvzvBbZJW3szeHX4dFmowRDyDw,13376578,77406304,-64029726,624
2022-03-30 11:36:08-04:00,14070,AxUKatZukyU1PaNZzQFftBbga7GQC7nArZKv6wHCtXVR,HEqbmmGLsuxSSbqx931nFbbhhsNFNEx8Srf8J7wZr7pa,True,22056628,2009350,12532,6266,6266,YQC4EUcgeBi9431viwvzvBbZJW3szeHX4dFmowRDyDw,1375755,6821113,-5445358,623
2022-03-30 11:37:54-04:00,14071,9ZVrkxds9vQ17KGWgANMfJeyMCGxuFRLFVBVS1wrPCqH,HyxwwiTVpAoaeKgX2no9Sp4o8hML15xABjRmMnFfJeYS,True,84250566,21062641,129320,64660,64660,YQC4EUcgeBi9431viwvzvBbZJW3szeHX4dFmowRDyDw,5172830,27694614,-22521784,613
2022-03-30 11:37:54-04:00,14072,5seV37JfFeqX91yaDfiupi2Ms7yYuuZFHwZ42ovhTbdU,KqBKpYuGWPhC8iYvedTYb4k5Lu3y89UMxt46t8gvn6h,True,330496841,82624210,509670,254835,254835,3zqXX6kzhkbW3d4TwD2CNjMRwxTbREXySekvq37kfCNk,20386834,81449487,-61062653,616
2022-03-30 11:37:54-04:00,14073,FcXe2wJqFzVRpRMSsPwzmwKAQ7f9CfHmwCt99k1cQeE1,BFjwToxLi3yzSDP13XqEXifQXahGyr5BWPBJyiM2iaai,True,20101961,1875292,11697,5848,5849,YQC4EUcgeBi9431viwvzvBbZJW3szeHX4dFmowRDyDw,1253892,6405703,-5151811,623
2022-03-30 11:42:31-04:00,14074,CzWT7zuiD3Usn1DB8C87kZ3yaLcAd1GXe62cZ5xDdEKa,2AsTxJr8dyhHmccUngu2f6beGE9iiXH4yXhmQ48SpCXm,True,75190928,18797732,115182,57591,57591,YQC4EUcgeBi9431viwvzvBbZJW3szeHX4dFmowRDyDw,4607301,17140693,-12533392,612
2022-03-30 11:42:32-04:00,14075,HhU3H9e4SDu2n1FobL8gxS1pg3ayQBFQ84psbLqdcUw2,H1Z7WqJXn3T16xSFUQGpthMmvSbQNBkbhk1qbufChW3x,True,8764945553,2191236388,13401995,6700997,6700998,3zqXX6kzhkbW3d4TwD2CNjMRwxTbREXySekvq37kfCNk,536079839,1173274307,-637194468,611
2022-03-30 11:42:34-04:00,14076,7Q55QWAHVoeaDAMyK1EkjQmsmj51YPu4AiiMJF2uWoG6,2Eziix2N6sX4zutLfENFsBnhy8X73xQvFUAhHZvmho6B,True,17095475,4273868,25952,12976,12976,3zqXX6kzhkbW3d4TwD2CNjMRwxTbREXySekvq37kfCNk,1038114,6282784,-5244670,607
2022-03-30 11:42:39-04:00,14077,HegY1tDz2ki6vSf9FPRSF4dwGKyciGCt6bovVYdFJRk6,soWdvQVu9EW4Mkk5WUY6rZLA3cEXhFUKqNyY7kpg8ZD,True,21420568,1920788,11978,5989,5989,YQC4EUcgeBi9431viwvzvBbZJW3szeHX4dFmowRDyDw,1335850,6698826,-5362976,623
2022-03-30 11:43:05-04:00,14078,AkGQxVK2FFRi9doFRx5gwGXBr6WKknvU3evZkDu3Yas4,Abu1FYCyBSutkrvrx56tL61xoDyYSCjwrDU1wnKn2gin,False,15008058,15008058,934210,46710,887500,YQC4EUcgeBi9431viwvzvBbZJW3szeHX4dFmowRDyDw,934210,5549439,-4615229,622
2022-03-30 11:43:12-04:00,14079,AT4qoJDVGXpEm3BGACUhC1zpVNLq4iX2bJ4cpABehpoD,AqaDPXbaY6ksVQwWGKorgBdRQMz3VpqxmHdWXmq17ScF,True,1678817563,419704390,2613671,1306835,1306836,3zqXX6kzhkbW3d4TwD2CNjMRwxTbREXySekvq37kfCNk,104546866,598019140,-493472274,622
2022-03-30 11:43:17-04:00,14080,7yW1M1xeVx4hy3QftnpqdBDRYwamfu3K5i6AEnxgyTWb,7wf7FWS2DYp5RveQAmGNXAEUWPcHziuMLd4hV5LPgxF8,True,293680141,73420035,458872,229436,229436,3zqXX6kzhkbW3d4TwD2CNjMRwxTbREXySekvq37kfCNk,18354905,33781859,-15426954,624
2022-03-30 11:43:19-04:00,14081,niCk6QHFU1kyU56Mdq5RJzKrecdkNSn23ZA6wduFdWS,BQbUYSw1XsuE6LnVd4XjmxAyYgx4drE4FsetJBCdwVZW,True,49391008,6241247,38973,19486,19487,YQC4EUcgeBi9431viwvzvBbZJW3szeHX4dFmowRDyDw,3084211,6192844,-3108633,624
2022-03-30 11:43:21-04:00,14082,4Bi1PEYPfA5VEoBqzGbt5fSd6PwuVsrF5SfLWXtpNxFA,3aApRXGYkRs9AZXchR5i7HnWXiRvBQgg3fz1bb4gMx2U,True,54528049,7237605,44941,22470,22471,3zqXX6kzhkbW3d4TwD2CNjMRwxTbREXySekvq37kfCNk,3385942,13672452,-10286510,620
2022-03-30 11:43:38-04:00,14083,GMpoV2jRyLdf2V3Gb5TQZ5gEs5ftMjD3JhFUzkA6fWVz,5bi814d5gdToTLVWCmbdB6J15kMdsTQk74cZTRd62p81,True,770037468,192509367,1123965,561982,561983,3zqXX6kzhkbW3d4TwD2CNjMRwxTbREXySekvq37kfCNk,44958633,250325080,-205366447,583
2022-03-30 11:43:38-04:00,14084,v8PjH3mAe252Zyh1iuPMigysGQZoZL1KncefGDw1ANx,2BDYraDRL6SekAjXy3rbGXCxmPt75gkEfhomEp9FzkUE,True,50257492254,3338004226,20671631,10335815,10335816,YQC4EUcgeBi9431viwvzvBbZJW3szeHX4dFmowRDyDw,3112351901,10611664694,-7499312793,619
2022-03-30 11:43:39-04:00,14085,AzmKB7i1dJucc5Ec1mxpoJor662CDFKAAWRstWDtrmaq,Fd2bPyTR54f8fcTkUokCjcgYgReTGR9vN7ymaGXVcMDK,True,150809857,37702464,229243,114621,114622,YQC4EUcgeBi9431viwvzvBbZJW3szeHX4dFmowRDyDw,9169753,47020712,-37850959,608
2022-03-30 11:43:39-04:00,14086,AxUKatZukyU1PaNZzQFftBbga7GQC7nArZKv6wHCtXVR,HEqbmmGLsuxSSbqx931nFbbhhsNFNEx8Srf8J7wZr7pa,True,20178394,1901206,11608,5804,5804,3zqXX6kzhkbW3d4TwD2CNjMRwxTbREXySekvq37kfCNk,1232107,6460360,-5228253,610
2022-03-30 11:43:39-04:00,14087,5BSr2tqthLtZfR2Dcq1hndaU2URYFNzdfjh3evp4kUnV,HcTxCpo9CeQMAjvXE9668B2LQHJXNqEUsPABLputs7Nm,True,39064288,9766072,56263,28131,28132,YQC4EUcgeBi9431viwvzvBbZJW3szeHX4dFmowRDyDw,2250540,9967461,-7716921,576
2022-03-30 11:43:39-04:00,14088,EToqvQTpzBfLfgPLf2vbpSkLt4isU6hR6E3Dhcx1uCD9,6sJ7wNkr4fL9uWuFcE9AvpzrNvCp3XX168DwjMLkaM4z,True,42998957736,10749739434,62830091,31415045,31415046,3zqXX6kzhkbW3d4TwD2CNjMRwxTbREXySekvq37kfCNk,2513203649,10658539302,-8145335653,584
2022-03-30 11:43:40-04:00,14089,Arwi3Qcu5ncs5u6fHHyHuWh567vzKFaGzMZh7WkXza9s,8JpfHYSbBN2bW1QtWmQwmah4KdE4evg3yHEU4nwbi684,True,1084719359686,271179839921,1527973316,763986658,763986658,3zqXX6kzhkbW3d4TwD2CNjMRwxTbREXySekvq37kfCNk,61118932648,402497463494,-341378530846,563
2022-03-30 11:43:40-04:00,14090,EToqvQTpzBfLfgPLf2vbpSkLt4isU6hR6E3Dhcx1uCD9,6sJ7wNkr4fL9uWuFcE9AvpzrNvCp3XX168DwjMLkaM4z,True,32897023407,8224255851,45064211,22532105,22532106,3zqXX6kzhkbW3d4TwD2CNjMRwxTbREXySekvq37kfCNk,1802568453,8569686805,-6767118352,547
2022-03-30 11:43:40-04:00,14091,FcXe2wJqFzVRpRMSsPwzmwKAQ7f9CfHmwCt99k1cQeE1,BFjwToxLi3yzSDP13XqEXifQXahGyr5BWPBJyiM2iaai,True,18433242,3150791,17701,8850,8851,YQC4EUcgeBi9431viwvzvBbZJW3szeHX4dFmowRDyDw,1035622,5764561,-4728939,561
2022-03-30 11:43:42-04:00,14092,6yjPfkAHVeT6pnwwa2iAGnAvmHZc1nirWw1ByjesoTHD,9MwcpCovRfMMbCf1z3PsoqhNY4RmgYXU385bKWFwqMuC,True,691150194,172787548,1023460,511730,511730,3zqXX6kzhkbW3d4TwD2CNjMRwxTbREXySekvq37kfCNk,40938430,167209773,-126271343,592
2022-03-30 11:43:43-04:00,14093,Hya9U3Ao61oebVBPEnUiqinqvpzTguAZhbAWDmEQpm3a,FdYMMqoYPe5Jgj8R2ovKVUKxRPK1xppR59XRGPdvHRAx,True,163751300,40937825,246150,123075,123075,3zqXX6kzhkbW3d4TwD2CNjMRwxTbREXySekvq37kfCNk,9846013,61064681,-51218668,601
2022-03-30 11:43:43-04:00,14094,HegY1tDz2ki6vSf9FPRSF4dwGKyciGCt6bovVYdFJRk6,soWdvQVu9EW4Mkk5WUY6rZLA3cEXhFUKqNyY7kpg8ZD,True,19604000,1816856,11303,5651,5652,YQC4EUcgeBi9431viwvzvBbZJW3szeHX4dFmowRDyDw,1219652,6348087,-5128435,622
2022-03-30 11:43:45-04:00,14095,9ZVrkxds9vQ17KGWgANMfJeyMCGxuFRLFVBVS1wrPCqH,HyxwwiTVpAoaeKgX2no9Sp4o8hML15xABjRmMnFfJeYS,True,64235565,16058891,99896,49948,49948,3zqXX6kzhkbW3d4TwD2CNjMRwxTbREXySekvq37kfCNk,3995870,21934884,-17939014,622
2022-03-30 11:43:48-04:00,14096,5seV37JfFeqX91yaDfiupi2Ms7yYuuZFHwZ42ovhTbdU,KqBKpYuGWPhC8iYvedTYb4k5Lu3y89UMxt46t8gvn6h,True,252105023,63026255,391119,195559,195560,3zqXX6kzhkbW3d4TwD2CNjMRwxTbREXySekvq37kfCNk,15644772,65674771,-50029999,620
2022-03-30 11:44:14-04:00,14097,CzWT7zuiD3Usn1DB8C87kZ3yaLcAd1GXe62cZ5xDdEKa,2AsTxJr8dyhHmccUngu2f6beGE9iiXH4yXhmQ48SpCXm,True,57360207,14340051,88127,44063,44064,3zqXX6kzhkbW3d4TwD2CNjMRwxTbREXySekvq37kfCNk,3525108,13892195,-10367087,614
2022-03-30 11:44:16-04:00,14098,5XoMaFny1TovLRJe7cXZt5pzJ9ptQKLm4cLstdNDZhFA,ExGHaJpqzRVMqG59McEpsa7Zfg12bjLAu4KRpR4ThQsZ,False,9808460,9808460,610732,30536,580196,3zqXX6kzhkbW3d4TwD2CNjMRwxTbREXySekvq37kfCNk,610732,2148607,-1537875,622
2022-03-30 11:44:16-04:00,14099,HhU3H9e4SDu2n1FobL8gxS1pg3ayQBFQ84psbLqdcUw2,H1Z7WqJXn3T16xSFUQGpthMmvSbQNBkbhk1qbufChW3x,True,6686306354,1671576588,10252016,5126008,5126008,3zqXX6kzhkbW3d4TwD2CNjMRwxTbREXySekvq37kfCNk,410080655,1001067036,-590986381,613
2022-03-30 11:44:17-04:00,14100,niCk6QHFU1kyU56Mdq5RJzKrecdkNSn23ZA6wduFdWS,BQbUYSw1XsuE6LnVd4XjmxAyYgx4drE4FsetJBCdwVZW,True,43479823,6189020,38648,19324,19324,YQC4EUcgeBi9431viwvzvBbZJW3szeHX4dFmowRDyDw,2715176,6800242,-4085066,624
2022-03-30 11:44:19-04:00,14101,7Q55QWAHVoeaDAMyK1EkjQmsmj51YPu4AiiMJF2uWoG6,2Eziix2N6sX4zutLfENFsBnhy8X73xQvFUAhHZvmho6B,False,13040332,13040332,793437,39671,753766,YQC4EUcgeBi9431viwvzvBbZJW3szeHX4dFmowRDyDw,793437,4945666,-4152229,608
2022-03-30 11:44:19-04:00,14102,2GdkcQGpbeyY168AZsiVnw2FFSv7SJikveN5ux2b6DPJ,B8fAPFAAu75P8HCFftLFEXGvHYJtGAeJWjtdxgvdZKzz,False,4923560,4923560,306482,15324,291158,3zqXX6kzhkbW3d4TwD2CNjMRwxTbREXySekvq37kfCNk,306482,487104,-180622,622
2022-03-30 11:45:09-04:00,14103,v8PjH3mAe252Zyh1iuPMigysGQZoZL1KncefGDw1ANx,2BDYraDRL6SekAjXy3rbGXCxmPt75gkEfhomEp9FzkUE,True,47071333448,3023991675,18886306,9443153,9443153,3zqXX6kzhkbW3d4TwD2CNjMRwxTbREXySekvq37kfCNk,2939834850,10174200599,-7234365749,624
2022-03-30 11:45:43-04:00,14104,29JVska5UEG3axs63EmtHpPvkswNEqYpZ3PKMSfupiAG,DCftNBUsuogxyaJe9G9m3eWipH6o3qo4Rn4TuQXdVaBF,True,525544182,131386045,794461,397230,397231,YQC4EUcgeBi9431viwvzvBbZJW3szeHX4dFmowRDyDw,31778473,67341291,-35562818,604
2022-03-30 11:45:43-04:00,14105,6qqBmN3Mmy56gXvtBwLUyQwJoh2cYKmMtP61Po9xgxRj,FySpFnWFTZAaYLZ2c8Lb9m89CJxj3ZFMcZTdcwRrEEGH,True,840354507,210088626,1308130,654065,654065,3RdfgDvLvsdZG5Cf6hKiKMQMqfidyxHzjYvUx1FZpeHQ,52325225,148244656,-95919431,622
2022-03-30 11:45:44-04:00,14106,7yW1M1xeVx4hy3QftnpqdBDRYwamfu3K5i6AEnxgyTWb,7wf7FWS2DYp5RveQAmGNXAEUWPcHziuMLd4hV5LPgxF8,True,224719988,56179997,335903,167951,167952,3zqXX6kzhkbW3d4TwD2CNjMRwxTbREXySekvq37kfCNk,13436151,29466813,-16030662,597
2022-03-30 11:45:45-04:00,14107,AT4qoJDVGXpEm3BGACUhC1zpVNLq4iX2bJ4cpABehpoD,AqaDPXbaY6ksVQwWGKorgBdRQMz3VpqxmHdWXmq17ScF,True,1284833287,321208321,1905327,952663,952664,3zqXX6kzhkbW3d4TwD2CNjMRwxTbREXySekvq37kfCNk,76213081,472051165,-395838084,593
2022-03-30 11:45:45-04:00,14108,6Z21rKncoJkLt4pkCrfiWw4m9bmkbF3ZNgocQ6WxViKf,14bbVwC4hEJMKRHM2v6N416HMQcr9fmTnt5anBGYTM5L,False,4619766,4619766,285493,14274,271219,3zqXX6kzhkbW3d4TwD2CNjMRwxTbREXySekvq37kfCNk,285493,1527017,-1241524,617
2022-03-30 11:45:53-04:00,14109,84CS9aD3YJABQUpuaKrzQrGDZmHDAT7sGGEVJCr9iWs,Du7MR89dZzrBMidrVXVqbZ71dJ3PthHrcA9G6HyNcSw9,True,575783539,143945884,895687,447843,447844,3zqXX6kzhkbW3d4TwD2CNjMRwxTbREXySekvq37kfCNk,35827491,55134179,-19306688,622
2022-03-30 11:46:01-04:00,14110,4Bi1PEYPfA5VEoBqzGbt5fSd6PwuVsrF5SfLWXtpNxFA,3aApRXGYkRs9AZXchR5i7HnWXiRvBQgg3fz1bb4gMx2U,True,47807776,6412379,39801,19900,19901,3RdfgDvLvsdZG5Cf6hKiKMQMqfidyxHzjYvUx1FZpeHQ,2967445,11780652,-8813207,620
2022-03-30 11:46:01-04:00,14111,5BSr2tqthLtZfR2Dcq1hndaU2URYFNzdfjh3evp4kUnV,HcTxCpo9CeQMAjvXE9668B2LQHJXNqEUsPABLputs7Nm,True,29649204,7412301,46082,23041,23041,3zqXX6kzhkbW3d4TwD2CNjMRwxTbREXySekvq37kfCNk,1843289,7981976,-6138687,621
2022-03-30 11:46:02-04:00,14112,GMpoV2jRyLdf2V3Gb5TQZ5gEs5ftMjD3JhFUzkA6fWVz,5bi814d5gdToTLVWCmbdB6J15kMdsTQk74cZTRd62p81,True,584898886,146224721,911597,455798,455799,3zqXX6kzhkbW3d4TwD2CNjMRwxTbREXySekvq37kfCNk,36463883,197862496,-161398613,623
2022-03-30 11:46:06-04:00,14113,7Sb2rfir31fWQsrcc632C1xQWB3jJ6WZUsK29KHLeBTg,HCHJ24w5nPf545Z75D2sX9Le9MAHQ4GhXw2URrud4s87,True,804702224,201175556,1252718,626359,626359,3zqXX6kzhkbW3d4TwD2CNjMRwxTbREXySekvq37kfCNk,50108759,141927953,-91819194,622
2022-03-30 11:46:06-04:00,14114,Fqv7VT7nfxUGb18xwFJLTo8gsdjhpAJpMveqDK4aRw83,Ha9N6X6oL8kkoDpXtrybq2ocSPJUEeYHwqoAjxiTJ7rV,False,14690799,14690799,916777,45838,870939,YQC4EUcgeBi9431viwvzvBbZJW3szeHX4dFmowRDyDw,916777,4833557,-3916780,624
2022-03-30 11:46:51-04:00,14115,8fSFsWaVRYHg5fdFQFQ89aBTjqsodGyc4sinV5UbWxtc,8evZpC24viqM8NaVFRjR91jLjXHLkW6GYAdywY8h2wys,True,83525366,12741583,78194,39097,39097,3zqXX6kzhkbW3d4TwD2CNjMRwxTbREXySekvq37kfCNk,5125923,26920344,-21794421,613
2022-03-30 11:47:06-04:00,14116,v8PjH3mAe252Zyh1iuPMigysGQZoZL1KncefGDw1ANx,2BDYraDRL6SekAjXy3rbGXCxmPt75gkEfhomEp9FzkUE,True,44205868944,2893595186,18082054,9041027,9041027,3zqXX6kzhkbW3d4TwD2CNjMRwxTbREXySekvq37kfCNk,2762421373,9359462042,-6597040669,624
2022-03-30 11:48:55-04:00,14117,AxUKatZukyU1PaNZzQFftBbga7GQC7nArZKv6wHCtXVR,HEqbmmGLsuxSSbqx931nFbbhhsNFNEx8Srf8J7wZr7pa,True,18353292,1636208,10202,5101,5101,YQC4EUcgeBi9431viwvzvBbZJW3szeHX4dFmowRDyDw,1144395,5793395,-4649000,623
2022-03-30 11:49:04-04:00,14118,v8PjH3mAe252Zyh1iuPMigysGQZoZL1KncefGDw1ANx,2BDYraDRL6SekAjXy3rbGXCxmPt75gkEfhomEp9FzkUE,True,41475906428,2524861756,15710150,7855075,7855075,3zqXX6kzhkbW3d4TwD2CNjMRwxTbREXySekvq37kfCNk,2580706649,9083734867,-6503028218,622
2022-03-30 11:52:58-04:00,14119,8fSFsWaVRYHg5fdFQFQ89aBTjqsodGyc4sinV5UbWxtc,8evZpC24viqM8NaVFRjR91jLjXHLkW6GYAdywY8h2wys,True,71372869,9730137,60783,30391,30392,YQC4EUcgeBi9431viwvzvBbZJW3szeHX4dFmowRDyDw,4458643,23040485,-18581842,624
2022-03-30 11:55:02-04:00,14120,v8PjH3mAe252Zyh1iuPMigysGQZoZL1KncefGDw1ANx,2BDYraDRL6SekAjXy3rbGXCxmPt75gkEfhomEp9FzkUE,True,39074253566,2256175531,14099057,7049528,7049529,YQC4EUcgeBi9431viwvzvBbZJW3szeHX4dFmowRDyDw,2441787605,8733657203,-6291869598,624
2022-03-30 12:02:02-04:00,14121,A7hz3xtcAyJPPrT1ohKncL3ny1KbYPxBTNUyFtCYUGoX,CtTZnDDVEMjnxuYigLQcQvhuDkVAg4y9MET7mAuyhDe5,True,248103127,62025781,385932,192966,192966,3zqXX6kzhkbW3d4TwD2CNjMRwxTbREXySekvq37kfCNk,15437300,43565426,-28128126,622
2022-03-30 12:03:03-04:00,14122,v8PjH3mAe252Zyh1iuPMigysGQZoZL1KncefGDw1ANx,2BDYraDRL6SekAjXy3rbGXCxmPt75gkEfhomEp9FzkUE,True,36946825168,2246382883,13975895,6987947,6987948,YQC4EUcgeBi9431viwvzvBbZJW3szeHX4dFmowRDyDw,2298650730,8133871832,-5835221102,622
2022-03-30 12:25:34-04:00,14123,HegY1tDz2ki6vSf9FPRSF4dwGKyciGCt6bovVYdFJRk6,soWdvQVu9EW4Mkk5WUY6rZLA3cEXhFUKqNyY7kpg8ZD,True,17880489,1655498,10325,5162,5163,YQC4EUcgeBi9431viwvzvBbZJW3szeHX4dFmowRDyDw,1115235,5706681,-4591446,623
2022-03-30 12:40:46-04:00,14124,8fSFsWaVRYHg5fdFQFQ89aBTjqsodGyc4sinV5UbWxtc,8evZpC24viqM8NaVFRjR91jLjXHLkW6GYAdywY8h2wys,True,62165864,7404535,46151,23075,23076,YQC4EUcgeBi9431viwvzvBbZJW3szeHX4dFmowRDyDw,3874723,19954493,-16079770,623
2022-03-30 12:40:55-04:00,14125,v8PjH3mAe252Zyh1iuPMigysGQZoZL1KncefGDw1ANx,2BDYraDRL6SekAjXy3rbGXCxmPt75gkEfhomEp9FzkUE,True,34815837699,1914587563,11929270,5964635,5964635,3zqXX6kzhkbW3d4TwD2CNjMRwxTbREXySekvq37kfCNk,2169279421,7850066884,-5680787463,623
2022-03-30 13:02:42-04:00,14126,v8PjH3mAe252Zyh1iuPMigysGQZoZL1KncefGDw1ANx,2BDYraDRL6SekAjXy3rbGXCxmPt75gkEfhomEp9FzkUE,True,32997532749,1750177602,10930102,5465051,5465051,3zqXX6kzhkbW3d4TwD2CNjMRwxTbREXySekvq37kfCNk,2060741833,7565861274,-5505119441,624
2022-03-30 13:02:49-04:00,14127,FDxmgdXDyVzQuMRydb9dCm71chEkwYsM4xtwqvTWUNZC,82LTSgmRbSb25GSVvgPmFSvcva7yCHHnAHrn8FmCCCqb,True,9384711400,1468415564,9176873,4588436,4588437,3zqXX6kzhkbW3d4TwD2CNjMRwxTbREXySekvq37kfCNk,586498225,1031571050,-445072825,624
2022-03-30 13:02:50-04:00,14128,AzmKB7i1dJucc5Ec1mxpoJor662CDFKAAWRstWDtrmaq,Fd2bPyTR54f8fcTkUokCjcgYgReTGR9vN7ymaGXVcMDK,True,114904924,28726231,178718,89359,89359,YQC4EUcgeBi9431viwvzvBbZJW3szeHX4dFmowRDyDw,7148747,37334614,-30185867,622
2022-03-30 13:17:24-04:00,14129,88awjJ2gbtVpwNCSwDLUbmtQM5xqGbJBwgEngdgUT8uV,7SE7JbDbRgsUzXUAnTrtCyzSCnEkLyYRuTQYRFqQ4rH9,True,17437422,4359355,27114,13557,13557,YQC4EUcgeBi9431viwvzvBbZJW3szeHX4dFmowRDyDw,1084566,4036753,-2952187,621
2022-03-30 13:21:36-04:00,14130,74MzhjMjDLChEL9RWjUtb6Ztm7Qmq15MUkrbgAiJ8mgK,EY6caxTDF9WQWa7c9ZJCqL92EDcVMcLaSnHhWXvNW6nA,True,102634713,25658678,160359,80179,80180,3zqXX6kzhkbW3d4TwD2CNjMRwxTbREXySekvq37kfCNk,6414370,23774169,-17359799,624
2022-03-30 13:26:13-04:00,14131,v8PjH3mAe252Zyh1iuPMigysGQZoZL1KncefGDw1ANx,2BDYraDRL6SekAjXy3rbGXCxmPt75gkEfhomEp9FzkUE,True,31339919046,1696156184,10592873,5296436,5296437,YQC4EUcgeBi9431viwvzvBbZJW3szeHX4dFmowRDyDw,1957247832,7244547720,-5287299888,624
2022-03-30 13:43:09-04:00,14132,v8PjH3mAe252Zyh1iuPMigysGQZoZL1KncefGDw1ANx,2BDYraDRL6SekAjXy3rbGXCxmPt75gkEfhomEp9FzkUE,True,29740475468,1694282302,10538918,5269459,5269459,YQC4EUcgeBi9431viwvzvBbZJW3szeHX4dFmowRDyDw,1849942353,6790702374,-4940760021,622
2022-03-30 13:51:28-04:00,14133,A7hz3xtcAyJPPrT1ohKncL3ny1KbYPxBTNUyFtCYUGoX,CtTZnDDVEMjnxuYigLQcQvhuDkVAg4y9MET7mAuyhDe5,True,189468866,47367216,291419,145709,145710,YQC4EUcgeBi9431viwvzvBbZJW3szeHX4dFmowRDyDw,11656777,36144812,-24488035,615
2022-03-30 13:52:53-04:00,14134,v8PjH3mAe252Zyh1iuPMigysGQZoZL1KncefGDw1ANx,2BDYraDRL6SekAjXy3rbGXCxmPt75gkEfhomEp9FzkUE,True,28128134784,1671912743,10446205,5223102,5223103,3zqXX6kzhkbW3d4TwD2CNjMRwxTbREXySekvq37kfCNk,1757461817,6568058201,-4810596384,624
2022-03-30 13:54:02-04:00,14135,AxUKatZukyU1PaNZzQFftBbga7GQC7nArZKv6wHCtXVR,HEqbmmGLsuxSSbqx931nFbbhhsNFNEx8Srf8J7wZr7pa,True,16801789,1524628,9525,4762,4763,YQC4EUcgeBi9431viwvzvBbZJW3szeHX4dFmowRDyDw,1049796,5393133,-4343337,624
2022-03-30 13:54:47-04:00,14136,8fSFsWaVRYHg5fdFQFQ89aBTjqsodGyc4sinV5UbWxtc,8evZpC24viqM8NaVFRjR91jLjXHLkW6GYAdywY8h2wys,True,55143532,5658717,35366,17683,17683,YQC4EUcgeBi9431viwvzvBbZJW3szeHX4dFmowRDyDw,3446405,17532539,-14086134,624
2022-03-30 13:55:58-04:00,14137,HegY1tDz2ki6vSf9FPRSF4dwGKyciGCt6bovVYdFJRk6,soWdvQVu9EW4Mkk5WUY6rZLA3cEXhFUKqNyY7kpg8ZD,True,16311450,1457344,9099,4549,4550,YQC4EUcgeBi9431viwvzvBbZJW3szeHX4dFmowRDyDw,1018534,5286790,-4268256,624
2022-03-30 14:01:29-04:00,14138,FcXe2wJqFzVRpRMSsPwzmwKAQ7f9CfHmwCt99k1cQeE1,BFjwToxLi3yzSDP13XqEXifQXahGyr5BWPBJyiM2iaai,False,15342111,15342111,958558,47927,910631,3zqXX6kzhkbW3d4TwD2CNjMRwxTbREXySekvq37kfCNk,958560,5088058,-4129498,624
2022-03-30 21:48:54-04:00,14139,8fSFsWaVRYHg5fdFQFQ89aBTjqsodGyc4sinV5UbWxtc,8evZpC24viqM8NaVFRjR91jLjXHLkW6GYAdywY8h2wys,True,49793463,5576445,34729,17364,17365,YQC4EUcgeBi9431viwvzvBbZJW3szeHX4dFmowRDyDw,3101149,15608734,-12507585,622
2022-03-31 06:25:19-04:00,14140,6yjPfkAHVeT6pnwwa2iAGnAvmHZc1nirWw1ByjesoTHD,9MwcpCovRfMMbCf1z3PsoqhNY4RmgYXU385bKWFwqMuC,True,526222595,131555648,803918,401959,401959,3RdfgDvLvsdZG5Cf6hKiKMQMqfidyxHzjYvUx1FZpeHQ,32156726,134722866,-102566140,611
2022-03-31 06:25:21-04:00,14141,Hya9U3Ao61oebVBPEnUiqinqvpzTguAZhbAWDmEQpm3a,FdYMMqoYPe5Jgj8R2ovKVUKxRPK1xppR59XRGPdvHRAx,True,124765422,31191355,191800,95900,95900,YQC4EUcgeBi9431viwvzvBbZJW3szeHX4dFmowRDyDw,7672012,48038086,-40366074,614
2022-03-31 06:25:21-04:00,14142,winXxFA6HNBu1BTxfeecCfFfYrgQd9JHrF67zU5Xake,H8kGL9rpbEjDZitZfyezJ9bfaEDXe3teAvnb62iLFFVr,False,1189739,1189739,72920,3646,69274,YQC4EUcgeBi9431viwvzvBbZJW3szeHX4dFmowRDyDw,72920,361968,-289048,612
2022-03-31 06:25:29-04:00,14143,9ZVrkxds9vQ17KGWgANMfJeyMCGxuFRLFVBVS1wrPCqH,HyxwwiTVpAoaeKgX2no9Sp4o8hML15xABjRmMnFfJeYS,True,49026141,12256535,76399,38199,38200,YQC4EUcgeBi9431viwvzvBbZJW3szeHX4dFmowRDyDw,3055960,17359708,-14303748,623
2022-03-31 06:25:31-04:00,14144,5seV37JfFeqX91yaDfiupi2Ms7yYuuZFHwZ42ovhTbdU,KqBKpYuGWPhC8iYvedTYb4k5Lu3y89UMxt46t8gvn6h,True,192398747,48099686,299268,149634,149634,YQC4EUcgeBi9431viwvzvBbZJW3szeHX4dFmowRDyDw,11970756,52813584,-40842828,622
2022-03-31 06:25:32-04:00,14145,54rcQUxBXFfoNq8n9RxsxH1Lp4VHR2CfE71vCCVy6rPQ,4exavmUP5CfqEmqVusSNuW9Ha2rhPBAy2gg6rP2d5tvu,True,351784375,87946093,549308,274654,274654,3zqXX6kzhkbW3d4TwD2CNjMRwxTbREXySekvq37kfCNk,21972326,138375342,-116403016,624
2022-03-31 06:25:37-04:00,14146,CzWT7zuiD3Usn1DB8C87kZ3yaLcAd1GXe62cZ5xDdEKa,2AsTxJr8dyhHmccUngu2f6beGE9iiXH4yXhmQ48SpCXm,True,43734148,10933537,68285,34142,34143,YQC4EUcgeBi9431viwvzvBbZJW3szeHX4dFmowRDyDw,2731413,11220738,-8489325,624
2022-03-31 06:25:40-04:00,14147,6Voi3FJ96g3v6FqWWoa46Ct7qbbFAfMSdujpvZCyQvf1,AugWTJjZdpcpo9UCEVGtqprswAgKVSCtvKuV1roHS3QG,True,17324381158,4331095289,26920509,13460254,13460255,3zqXX6kzhkbW3d4TwD2CNjMRwxTbREXySekvq37kfCNk,1076820362,1660625196,-583804834,621
2022-03-31 06:25:40-04:00,14148,HhU3H9e4SDu2n1FobL8gxS1pg3ayQBFQ84psbLqdcUw2,H1Z7WqJXn3T16xSFUQGpthMmvSbQNBkbhk1qbufChW3x,True,5100239953,1275059988,7882500,3941250,3941250,3zqXX6kzhkbW3d4TwD2CNjMRwxTbREXySekvq37kfCNk,315300009,844329813,-529029804,618
2022-03-31 06:26:13-04:00,14149,AxUKatZukyU1PaNZzQFftBbga7GQC7nArZKv6wHCtXVR,HEqbmmGLsuxSSbqx931nFbbhhsNFNEx8Srf8J7wZr7pa,False,15363446,15363446,954513,47725,906788,3RdfgDvLvsdZG5Cf6hKiKMQMqfidyxHzjYvUx1FZpeHQ,954514,5105354,-4150840,621
2022-03-31 06:26:15-04:00,14150,7yW1M1xeVx4hy3QftnpqdBDRYwamfu3K5i6AEnxgyTWb,7wf7FWS2DYp5RveQAmGNXAEUWPcHziuMLd4hV5LPgxF8,True,171051114,42762778,265548,132774,132774,YQC4EUcgeBi9431viwvzvBbZJW3szeHX4dFmowRDyDw,10621939,25156379,-14534440,620
2022-03-31 06:26:15-04:00,14151,AT4qoJDVGXpEm3BGACUhC1zpVNLq4iX2bJ4cpABehpoD,AqaDPXbaY6ksVQwWGKorgBdRQMz3VpqxmHdWXmq17ScF,True,977936139,244484034,1504604,752302,752302,3zqXX6kzhkbW3d4TwD2CNjMRwxTbREXySekvq37kfCNk,60184181,371381738,-311197557,615
2022-03-31 06:26:15-04:00,14152,AFYRpYG4Nm818mSXVrBX9SScLSHfe9VJynGZUgvBsgMc,5zbZnbBHauM6tKDJFhDdgTKVkhAgZ4V5WSyTDLUX2Mqs,True,197126451,49281612,303574,151787,151787,3zqXX6kzhkbW3d4TwD2CNjMRwxTbREXySekvq37kfCNk,12142971,59269733,-47126762,615
2022-03-31 06:27:20-04:00,14153,6qqBmN3Mmy56gXvtBwLUyQwJoh2cYKmMtP61Po9xgxRj,FySpFnWFTZAaYLZ2c8Lb9m89CJxj3ZFMcZTdcwRrEEGH,True,641446847,160361711,998970,499485,499485,3zqXX6kzhkbW3d4TwD2CNjMRwxTbREXySekvq37kfCNk,39958838,123083661,-83124823,622
2022-03-31 06:27:30-04:00,14154,HegY1tDz2ki6vSf9FPRSF4dwGKyciGCt6bovVYdFJRk6,soWdvQVu9EW4Mkk5WUY6rZLA3cEXhFUKqNyY7kpg8ZD,False,14933497,14933497,930550,46527,884023,3zqXX6kzhkbW3d4TwD2CNjMRwxTbREXySekvq37kfCNk,930551,5007374,-4076823,623
2022-03-31 06:27:31-04:00,14155,84CS9aD3YJABQUpuaKrzQrGDZmHDAT7sGGEVJCr9iWs,Du7MR89dZzrBMidrVXVqbZ71dJ3PthHrcA9G6HyNcSw9,True,439376825,109844206,686030,343015,343015,3zqXX6kzhkbW3d4TwD2CNjMRwxTbREXySekvq37kfCNk,27441221,49462600,-22021379,624
2022-03-31 06:28:42-04:00,14156,CL6fgytwKTdnFQYQBUPwwe1FdTQbYnNtYb5G8Sr2Cj72,iB5cVXErZ1Ais6NJ4PtqvP8oJdd6YpxaQub8uHeyTpC,True,983858273,245964568,1530464,765232,765232,YQC4EUcgeBi9431viwvzvBbZJW3szeHX4dFmowRDyDw,61218596,292800796,-231582200,622
2022-03-31 06:29:52-04:00,14157,5BSr2tqthLtZfR2Dcq1hndaU2URYFNzdfjh3evp4kUnV,HcTxCpo9CeQMAjvXE9668B2LQHJXNqEUsPABLputs7Nm,True,22631444,5657861,35174,17587,17587,YQC4EUcgeBi9431viwvzvBbZJW3szeHX4dFmowRDyDw,1406989,6405550,-4998561,621
2022-03-31 06:30:24-04:00,14158,EToqvQTpzBfLfgPLf2vbpSkLt4isU6hR6E3Dhcx1uCD9,6sJ7wNkr4fL9uWuFcE9AvpzrNvCp3XX168DwjMLkaM4z,True,24880593796,6220148449,38860644,19430322,19430322,3zqXX6kzhkbW3d4TwD2CNjMRwxTbREXySekvq37kfCNk,1554425767,6843444934,-5289019167,624
2022-03-31 06:30:24-04:00,14159,GMpoV2jRyLdf2V3Gb5TQZ5gEs5ftMjD3JhFUzkA6fWVz,5bi814d5gdToTLVWCmbdB6J15kMdsTQk74cZTRd62p81,True,446427498,111606874,697104,348552,348552,3zqXX6kzhkbW3d4TwD2CNjMRwxTbREXySekvq37kfCNk,27884178,156688165,-128803987,624
2022-03-31 06:30:30-04:00,14160,8fSFsWaVRYHg5fdFQFQ89aBTjqsodGyc4sinV5UbWxtc,8evZpC24viqM8NaVFRjR91jLjXHLkW6GYAdywY8h2wys,True,44509018,4287480,26705,13352,13353,YQC4EUcgeBi9431viwvzvBbZJW3szeHX4dFmowRDyDw,2772335,14480616,-11708281,622
2022-03-31 06:33:24-04:00,14161,6KGKhfpWXmDyPbXsBbisR5XyebepKXaK9DQuxu3zHVY,EkEvXBiDuHtF8S1rW5H2uGGaPcAsypaHF6VuJeeD8aP7,True,181572622081,45393155520,282341310,141170655,141170655,3zqXX6kzhkbW3d4TwD2CNjMRwxTbREXySekvq37kfCNk,11293652414,19291116589,-7997464175,621
2022-03-31 06:36:52-04:00,14162,7zqJsqdXgv922pDkWtNoVKvX3FpabXQUAuWvqgbqgFeV,46fTwY6ZT3sDuDTX1ABZdUcNDy541inNnzQitEz36e7c,False,91063745086,87561293351,3301138517,165056925,3136081592,3RdfgDvLvsdZG5Cf6hKiKMQMqfidyxHzjYvUx1FZpeHQ,3433184058,9911007288,-6477823230,377
2022-03-31 06:36:55-04:00,14163,7zqJsqdXgv922pDkWtNoVKvX3FpabXQUAuWvqgbqgFeV,46fTwY6ZT3sDuDTX1ABZdUcNDy541inNnzQitEz36e7c,True,3443724956,860931239,4769308,2384654,2384654,3zqXX6kzhkbW3d4TwD2CNjMRwxTbREXySekvq37kfCNk,190772320,413545208,-222772888,553
2022-03-31 07:26:05-04:00,14164,AzmKB7i1dJucc5Ec1mxpoJor662CDFKAAWRstWDtrmaq,Fd2bPyTR54f8fcTkUokCjcgYgReTGR9vN7ymaGXVcMDK,True,87688642,21922160,136825,68412,68413,YQC4EUcgeBi9431viwvzvBbZJW3szeHX4dFmowRDyDw,5473014,29622429,-24149415,624
2022-03-31 07:46:21-04:00,14165,6yjPfkAHVeT6pnwwa2iAGnAvmHZc1nirWw1ByjesoTHD,9MwcpCovRfMMbCf1z3PsoqhNY4RmgYXU385bKWFwqMuC,True,400977433,100244358,626123,313061,313062,3zqXX6kzhkbW3d4TwD2CNjMRwxTbREXySekvq37kfCNk,25044929,108281541,-83236612,624
2022-03-31 07:46:28-04:00,14166,Hya9U3Ao61oebVBPEnUiqinqvpzTguAZhbAWDmEQpm3a,FdYMMqoYPe5Jgj8R2ovKVUKxRPK1xppR59XRGPdvHRAx,True,95131138,23782784,148093,74046,74047,YQC4EUcgeBi9431viwvzvBbZJW3szeHX4dFmowRDyDw,5923758,37755456,-31831698,622
2022-03-31 07:47:14-04:00,14167,5seV37JfFeqX91yaDfiupi2Ms7yYuuZFHwZ42ovhTbdU,KqBKpYuGWPhC8iYvedTYb4k5Lu3y89UMxt46t8gvn6h,True,146856414,36714103,227877,113938,113939,YQC4EUcgeBi9431viwvzvBbZJW3szeHX4dFmowRDyDw,9115085,42304757,-33189672,620
2022-03-31 07:47:15-04:00,14168,54rcQUxBXFfoNq8n9RxsxH1Lp4VHR2CfE71vCCVy6rPQ,4exavmUP5CfqEmqVusSNuW9Ha2rhPBAy2gg6rP2d5tvu,True,268603842,67150960,416479,208239,208240,YQC4EUcgeBi9431viwvzvBbZJW3szeHX4dFmowRDyDw,16659196,108727582,-92068386,620
2022-03-31 07:47:16-04:00,14169,9ZVrkxds9vQ17KGWgANMfJeyMCGxuFRLFVBVS1wrPCqH,HyxwwiTVpAoaeKgX2no9Sp4o8hML15xABjRmMnFfJeYS,True,37453000,9363250,57410,28705,28705,3RdfgDvLvsdZG5Cf6hKiKMQMqfidyxHzjYvUx1FZpeHQ,2296409,13707625,-11411216,613
2022-03-31 07:47:18-04:00,14170,GJEpUi39AeUjdeErnCQpn7zUPx3P9bxzobvvhDumh4Ng,FJCLDutMmBES32m2RR8ZW7kf89JroJHc8DWuVR7kTysM,False,2667758,2667758,166388,8319,158069,YQC4EUcgeBi9431viwvzvBbZJW3szeHX4dFmowRDyDw,166388,996747,-830359,623
2022-03-31 07:47:20-04:00,14171,CzWT7zuiD3Usn1DB8C87kZ3yaLcAd1GXe62cZ5xDdEKa,2AsTxJr8dyhHmccUngu2f6beGE9iiXH4yXhmQ48SpCXm,True,33378254,8344563,52142,26071,26071,YQC4EUcgeBi9431viwvzvBbZJW3szeHX4dFmowRDyDw,2085701,9030348,-6944647,624
2022-03-31 07:47:21-04:00,14172,HhU3H9e4SDu2n1FobL8gxS1pg3ayQBFQ84psbLqdcUw2,H1Z7WqJXn3T16xSFUQGpthMmvSbQNBkbhk1qbufChW3x,True,3889694985,972423746,6073191,3036595,3036596,3zqXX6kzhkbW3d4TwD2CNjMRwxTbREXySekvq37kfCNk,242927656,704373753,-461446097,624
2022-03-31 09:04:31-04:00,14173,8fSFsWaVRYHg5fdFQFQ89aBTjqsodGyc4sinV5UbWxtc,8evZpC24viqM8NaVFRjR91jLjXHLkW6GYAdywY8h2wys,True,40439360,4290978,26817,13408,13409,YQC4EUcgeBi9431viwvzvBbZJW3szeHX4dFmowRDyDw,2527428,13529905,-11002477,624
2022-03-31 09:04:50-04:00,14174,AT4qoJDVGXpEm3BGACUhC1zpVNLq4iX2bJ4cpABehpoD,AqaDPXbaY6ksVQwWGKorgBdRQMz3VpqxmHdWXmq17ScF,True,745793150,186448287,1158727,579363,579364,3zqXX6kzhkbW3d4TwD2CNjMRwxTbREXySekvq37kfCNk,46349098,292092742,-245743644,621
2022-03-31 09:04:50-04:00,14175,AFYRpYG4Nm818mSXVrBX9SScLSHfe9VJynGZUgvBsgMc,5zbZnbBHauM6tKDJFhDdgTKVkhAgZ4V5WSyTDLUX2Mqs,True,150333923,37583480,233811,116905,116906,YQC4EUcgeBi9431viwvzvBbZJW3szeHX4dFmowRDyDw,9352442,47186798,-37834356,622
2022-03-31 09:04:56-04:00,14176,7yW1M1xeVx4hy3QftnpqdBDRYwamfu3K5i6AEnxgyTWb,7wf7FWS2DYp5RveQAmGNXAEUWPcHziuMLd4hV5LPgxF8,True,130910213,32727553,193409,96704,96705,YQC4EUcgeBi9431viwvzvBbZJW3szeHX4dFmowRDyDw,7736362,21259251,-13522889,590
2022-03-31 09:59:43-04:00,14177,F2AU2PjaSmHxWWhkz8XxMggkCMWbMVgawt89tSnYS6RL,ET9febRJiW197DYMaJbgk3kWsAeFv5f4peQ4vFCVppK6,True,639081038,159770259,1130734,565367,565367,3zqXX6kzhkbW3d4TwD2CNjMRwxTbREXySekvq37kfCNk,45229361,65150394,-19921033,707
2022-03-31 09:59:59-04:00,14178,GCweck6iuscBsVbXW9ZYfMytdgwSYWwNifTWLaUbaSmA,6HwGWKGduMGvLnHmTJo6ZioZ3EMUZYHo2pG4tBFXgB4Y,True,940205522,235051380,1655145,827572,827573,YQC4EUcgeBi9431viwvzvBbZJW3szeHX4dFmowRDyDw,66205819,95901024,-29695205,704
2022-03-31 09:59:59-04:00,14179,EHLV9s6E1s5SUbzZVzsGWH2vVRGHyxynM4GDJtfKEuYe,4hAx9osegpeocSSmJbMVBYMKCwo5WY3QVJuK7cuzz4b4,True,941153191,235288297,1678768,839384,839384,YQC4EUcgeBi9431viwvzvBbZJW3szeHX4dFmowRDyDw,67150740,95900862,-28750122,713
2022-03-31 10:02:24-04:00,14180,Gw37fsD8M3AaZ22tSx9WeszxsAkWQ6Ap2XV3zXYhe3EJ,FbKeJsWR5ggVBy1R5sxNiWz5GAsxeyZD8nmyk5yCBqSz,True,1058876226,264719056,1868077,934038,934039,YQC4EUcgeBi9431viwvzvBbZJW3szeHX4dFmowRDyDw,74723105,109806181,-35083076,705
2022-03-31 10:03:05-04:00,14181,F2AU2PjaSmHxWWhkz8XxMggkCMWbMVgawt89tSnYS6RL,ET9febRJiW197DYMaJbgk3kWsAeFv5f4peQ4vFCVppK6,True,468653816,117163454,836417,418208,418209,YQC4EUcgeBi9431viwvzvBbZJW3szeHX4dFmowRDyDw,33456715,59091949,-25635234,713
2022-03-31 10:03:57-04:00,14182,GCweck6iuscBsVbXW9ZYfMytdgwSYWwNifTWLaUbaSmA,6HwGWKGduMGvLnHmTJo6ZioZ3EMUZYHo2pG4tBFXgB4Y,True,689035744,172258936,1211363,605681,605682,YQC4EUcgeBi9431viwvzvBbZJW3szeHX4dFmowRDyDw,48454529,86925716,-38471187,703
2022-03-31 10:04:12-04:00,14183,EHLV9s6E1s5SUbzZVzsGWH2vVRGHyxynM4GDJtfKEuYe,4hAx9osegpeocSSmJbMVBYMKCwo5WY3QVJuK7cuzz4b4,True,689187929,172296982,1220432,610216,610216,YQC4EUcgeBi9431viwvzvBbZJW3szeHX4dFmowRDyDw,48817287,87138320,-38321033,708
2022-03-31 10:05:10-04:00,14184,5nALef7nAfNkSQSuTBLwewDby4pUx74Gzqib33Znmmt6,8xNTWK2xNK2xZPpgXfcE4QxPT2i6YvNYakiLgdQ2FqEt,True,1748911986,437227996,2620032,1310016,1310016,YQC4EUcgeBi9431viwvzvBbZJW3szeHX4dFmowRDyDw,104801304,181025937,-76224633,599
2022-03-31 10:09:21-04:00,14185,Gw37fsD8M3AaZ22tSx9WeszxsAkWQ6Ap2XV3zXYhe3EJ,FbKeJsWR5ggVBy1R5sxNiWz5GAsxeyZD8nmyk5yCBqSz,True,772786262,193196565,1287103,643551,643552,3zqXX6kzhkbW3d4TwD2CNjMRwxTbREXySekvq37kfCNk,51484120,99271222,-47787102,666
2022-03-31 10:09:25-04:00,14186,SEndYVMCKAeZUKSqGrMUSqXFmxtA9M1t4eXsUhVsTBF,3fcQQcbkpqodakamn82pFnMxBEPL2Drsg4jJNZ6dx72M,True,3989120484,520237781,3415811,1707905,1707906,YQC4EUcgeBi9431viwvzvBbZJW3szeHX4dFmowRDyDw,261920335,449670681,-187750346,656
2022-03-31 10:18:08-04:00,14187,F2AU2PjaSmHxWWhkz8XxMggkCMWbMVgawt89tSnYS6RL,ET9febRJiW197DYMaJbgk3kWsAeFv5f4peQ4vFCVppK6,True,343213586,85803396,608588,304294,304294,3zqXX6kzhkbW3d4TwD2CNjMRwxTbREXySekvq37kfCNk,24343522,51867583,-27524061,709
2022-03-31 10:26:11-04:00,14188,GCweck6iuscBsVbXW9ZYfMytdgwSYWwNifTWLaUbaSmA,6HwGWKGduMGvLnHmTJo6ZioZ3EMUZYHo2pG4tBFXgB4Y,True,505329736,126332434,894902,447451,447451,3zqXX6kzhkbW3d4TwD2CNjMRwxTbREXySekvq37kfCNk,35796094,76141818,-40345724,708
2022-03-31 10:26:27-04:00,14189,EHLV9s6E1s5SUbzZVzsGWH2vVRGHyxynM4GDJtfKEuYe,4hAx9osegpeocSSmJbMVBYMKCwo5WY3QVJuK7cuzz4b4,True,504913201,126228300,890477,445238,445239,3zqXX6kzhkbW3d4TwD2CNjMRwxTbREXySekvq37kfCNk,35619109,76382925,-40763816,705
2022-03-31 10:26:27-04:00,14190,5qY8ZrqpHPqkAuXp6HpE2zC8qTfzsP8MXWSoxkZQV5jx,GPs3ap45TuHwHwmDb5bnKYHLBa5wj3AyuEsXcfHjEcAL,True,228500818,57125204,405435,202717,202718,YQC4EUcgeBi9431viwvzvBbZJW3szeHX4dFmowRDyDw,16217426,23196533,-6979107,709
2022-03-31 10:26:44-04:00,14191,3hEe6AXGjjVzWnsadNZHfeB6CGg8nKSLyhtyqgBtVivt,6Qdu667ChFcRT7J5QHQzUsWpLmxmNvywAaevseSXqxPZ,True,40484149,10121037,70668,35334,35334,YQC4EUcgeBi9431viwvzvBbZJW3szeHX4dFmowRDyDw,2826736,6080849,-3254113,698
2022-03-31 10:31:08-04:00,14192,4Bi1PEYPfA5VEoBqzGbt5fSd6PwuVsrF5SfLWXtpNxFA,3aApRXGYkRs9AZXchR5i7HnWXiRvBQgg3fz1bb4gMx2U,True,40680861,5499368,34261,17130,17131,YQC4EUcgeBi9431viwvzvBbZJW3szeHX4dFmowRDyDw,2534471,11033864,-8499393,623
2022-03-31 10:34:10-04:00,14193,CFisddf8emSH3T9DK5vHXVkBZMo26SmjoCCpLJZ6auet,9S9cGvBN3sRb5J1TbH24cTFgKcX7R63YSvKWedd7SLBS,True,800355395,200088848,1228307,614153,614154,YQC4EUcgeBi9431viwvzvBbZJW3szeHX4dFmowRDyDw,49132297,82519459,-33387162,613
2022-03-31 10:34:10-04:00,14194,BFWNfNhm4RUFJs3721We8Dyocw1okinoUA3JtHshAHkU,7czPpWxLYgLgAGmvxiKA6zRGQ97FdLVB83FvNqEuKnFj,True,15309208161,3827302040,22923225,11461612,11461613,YQC4EUcgeBi9431viwvzvBbZJW3szeHX4dFmowRDyDw,916929026,1576119415,-659190389,598
2022-03-31 10:41:16-04:00,14195,niCk6QHFU1kyU56Mdq5RJzKrecdkNSn23ZA6wduFdWS,BQbUYSw1XsuE6LnVd4XjmxAyYgx4drE4FsetJBCdwVZW,True,37541656,4718815,28964,14482,14482,YQC4EUcgeBi9431viwvzvBbZJW3szeHX4dFmowRDyDw,2304337,5248919,-2944582,613
2022-03-31 10:46:03-04:00,14196,4Bi1PEYPfA5VEoBqzGbt5fSd6PwuVsrF5SfLWXtpNxFA,3aApRXGYkRs9AZXchR5i7HnWXiRvBQgg3fz1bb4gMx2U,True,35872155,4722299,29239,14619,14620,3RdfgDvLvsdZG5Cf6hKiKMQMqfidyxHzjYvUx1FZpeHQ,2221168,9543293,-7322125,619
2022-03-31 10:50:34-04:00,14197,6qqBmN3Mmy56gXvtBwLUyQwJoh2cYKmMtP61Po9xgxRj,FySpFnWFTZAaYLZ2c8Lb9m89CJxj3ZFMcZTdcwRrEEGH,True,489828062,122457015,755675,377837,377838,3zqXX6kzhkbW3d4TwD2CNjMRwxTbREXySekvq37kfCNk,30227031,101316005,-71088974,617
2022-03-31 10:50:37-04:00,14198,84CS9aD3YJABQUpuaKrzQrGDZmHDAT7sGGEVJCr9iWs,Du7MR89dZzrBMidrVXVqbZ71dJ3PthHrcA9G6HyNcSw9,True,335526800,83881700,519197,259598,259599,3zqXX6kzhkbW3d4TwD2CNjMRwxTbREXySekvq37kfCNk,20767917,43279376,-22511459,618
2022-03-31 10:50:40-04:00,14199,5BSr2tqthLtZfR2Dcq1hndaU2URYFNzdfjh3evp4kUnV,HcTxCpo9CeQMAjvXE9668B2LQHJXNqEUsPABLputs7Nm,True,17270476,4317619,26881,13440,13441,YQC4EUcgeBi9431viwvzvBbZJW3szeHX4dFmowRDyDw,1075277,5121093,-4045816,622
2022-03-31 10:50:56-04:00,14200,EToqvQTpzBfLfgPLf2vbpSkLt4isU6hR6E3Dhcx1uCD9,6sJ7wNkr4fL9uWuFcE9AvpzrNvCp3XX168DwjMLkaM4z,True,18993709595,4748427398,29567278,14783639,14783639,3zqXX6kzhkbW3d4TwD2CNjMRwxTbREXySekvq37kfCNk,1182691146,5486024851,-4303333705,622
2022-03-31 10:50:58-04:00,14201,GMpoV2jRyLdf2V3Gb5TQZ5gEs5ftMjD3JhFUzkA6fWVz,5bi814d5gdToTLVWCmbdB6J15kMdsTQk74cZTRd62p81,True,340916010,85229002,527467,263733,263734,3zqXX6kzhkbW3d4TwD2CNjMRwxTbREXySekvq37kfCNk,21098695,123798032,-102699337,618
2022-03-31 12:07:43-04:00,14202,SEndYVMCKAeZUKSqGrMUSqXFmxtA9M1t4eXsUhVsTBF,3fcQQcbkpqodakamn82pFnMxBEPL2Drsg4jJNZ6dx72M,True,3437624048,386852918,2546536,1273268,1273268,3zqXX6kzhkbW3d4TwD2CNjMRwxTbREXySekvq37kfCNk,226288508,404123841,-177835333,658
2022-03-31 12:08:03-04:00,14203,5yPGvUz6JWKjkViGwTCpygJii1rP2xv5yx146ULtBiYq,FMnHUCQWTf1UHu5qVFqUAsWh8aba9EQYTEoiXy55totD,True,3820423030,516489813,3194498,1597249,1597249,3zqXX6kzhkbW3d4TwD2CNjMRwxTbREXySekvq37kfCNk,236293800,418851051,-182557251,618
2022-03-31 12:09:20-04:00,14204,EN2YBXcj7E1eAaYJYXJjc6Rfsu6Awjgv9kN3bT3uiprp,HYDG5mqfCy2xwrYKixNzoWyDiqb9KbpnA8H3TQG2EDDG,True,1308675177,327168692,2041015,1020507,1020508,YQC4EUcgeBi9431viwvzvBbZJW3szeHX4dFmowRDyDw,81640644,165157445,-83516801,623
2022-03-31 12:29:39-04:00,14205,Gw37fsD8M3AaZ22tSx9WeszxsAkWQ6Ap2XV3zXYhe3EJ,FbKeJsWR5ggVBy1R5sxNiWz5GAsxeyZD8nmyk5yCBqSz,True,570139784,142534946,1016835,508417,508418,3zqXX6kzhkbW3d4TwD2CNjMRwxTbREXySekvq37kfCNk,40673432,86021330,-45347898,713
2022-03-31 12:31:20-04:00,14206,SEndYVMCKAeZUKSqGrMUSqXFmxtA9M1t4eXsUhVsTBF,3fcQQcbkpqodakamn82pFnMxBEPL2Drsg4jJNZ6dx72M,True,3022207834,427861592,2816303,1408151,1408152,3zqXX6kzhkbW3d4TwD2CNjMRwxTbREXySekvq37kfCNk,198930098,366540302,-167610204,658
2022-03-31 12:31:20-04:00,14207,5yPGvUz6JWKjkViGwTCpygJii1rP2xv5yx146ULtBiYq,FMnHUCQWTf1UHu5qVFqUAsWh8aba9EQYTEoiXy55totD,True,3275300884,384663322,2401334,1200667,1200667,3zqXX6kzhkbW3d4TwD2CNjMRwxTbREXySekvq37kfCNk,204466969,390464481,-185997512,624
2022-03-31 12:34:02-04:00,14208,F2AU2PjaSmHxWWhkz8XxMggkCMWbMVgawt89tSnYS6RL,ET9febRJiW197DYMaJbgk3kWsAeFv5f4peQ4vFCVppK6,True,251646920,62911730,448470,224235,224235,YQC4EUcgeBi9431viwvzvBbZJW3szeHX4dFmowRDyDw,17938804,44356716,-26417912,712
2022-03-31 12:34:09-04:00,14209,82RokGTDMqEDvdofWoJhm3LbGX3aE1FopbQWNQWP4dHj,F2mNSbKHJEQyr8yWxnSf96tajULmpYAQDok5PzjsmxJt,True,3808874183,952218545,5910665,2955332,2955333,3zqXX6kzhkbW3d4TwD2CNjMRwxTbREXySekvq37kfCNk,236426623,500850295,-264423672,620
2022-03-31 12:34:41-04:00,14210,niCk6QHFU1kyU56Mdq5RJzKrecdkNSn23ZA6wduFdWS,BQbUYSw1XsuE6LnVd4XjmxAyYgx4drE4FsetJBCdwVZW,True,32402892,4582302,28579,14289,14290,YQC4EUcgeBi9431viwvzvBbZJW3szeHX4dFmowRDyDw,2020977,4013401,-1992424,623
2022-03-31 14:14:12-04:00,14211,AwT3pH9dHjECDnuUiazbD6tZxZHdNwgJ4vBMmxLHMiLo,AjybksvjMT1QT6KvryXCG47pQGT8v9jxM34VkveGPQrs,True,64560849,16140212,100383,50191,50192,YQC4EUcgeBi9431viwvzvBbZJW3szeHX4dFmowRDyDw,4015351,5540957,-1525606,621
2022-03-31 14:16:56-04:00,14212,7JbCUyTgV4oLjFST9UUvtJkKpK6F99Pwb1Xe6JT8v7s4,9uYeL9R23XRstddnVE6kohfwCkR41E1GXtyduzc9TwEX,True,74658472167,18664616474,114258082,57129041,57129041,3RdfgDvLvsdZG5Cf6hKiKMQMqfidyxHzjYvUx1FZpeHQ,4570323691,7980644674,-3410320983,612
2022-03-31 14:16:56-04:00,14213,5zSoXxVZYYQAtq3urfcUQmJkjFDBXkUJYSNFdq759Tof,3C459gJnmj4EYTG3tDFJEEf1aAT915sxRLs2THEdQqha,True,20407298579,2425655701,15141908,7570954,7570954,3zqXX6kzhkbW3d4TwD2CNjMRwxTbREXySekvq37kfCNk,1273904811,2049003018,-775098207,624
2022-03-31 14:18:45-04:00,14214,5yPGvUz6JWKjkViGwTCpygJii1rP2xv5yx146ULtBiYq,FMnHUCQWTf1UHu5qVFqUAsWh8aba9EQYTEoiXy55totD,True,2866415425,286849351,1778287,889143,889144,3zqXX6kzhkbW3d4TwD2CNjMRwxTbREXySekvq37kfCNk,177699920,366287296,-188587376,619
2022-03-31 14:18:45-04:00,14215,BFWNfNhm4RUFJs3721We8Dyocw1okinoUA3JtHshAHkU,7czPpWxLYgLgAGmvxiKA6zRGQ97FdLVB83FvNqEuKnFj,True,11286471037,2821617759,17436220,8718110,8718110,YQC4EUcgeBi9431viwvzvBbZJW3szeHX4dFmowRDyDw,697448820,1390998969,-693550149,617
2022-03-31 15:56:53-04:00,14216,GCweck6iuscBsVbXW9ZYfMytdgwSYWwNifTWLaUbaSmA,6HwGWKGduMGvLnHmTJo6ZioZ3EMUZYHo2pG4tBFXgB4Y,True,370633627,92658406,661408,330704,330704,YQC4EUcgeBi9431viwvzvBbZJW3szeHX4dFmowRDyDw,26456347,65104495,-38648148,713
2022-03-31 15:57:36-04:00,14217,EHLV9s6E1s5SUbzZVzsGWH2vVRGHyxynM4GDJtfKEuYe,4hAx9osegpeocSSmJbMVBYMKCwo5WY3QVJuK7cuzz4b4,True,370183798,92545949,653656,326828,326828,3zqXX6kzhkbW3d4TwD2CNjMRwxTbREXySekvq37kfCNk,26146259,65245410,-39099151,706
2022-03-31 15:58:10-04:00,14218,5qY8ZrqpHPqkAuXp6HpE2zC8qTfzsP8MXWSoxkZQV5jx,GPs3ap45TuHwHwmDb5bnKYHLBa5wj3AyuEsXcfHjEcAL,True,167493428,41873357,297325,148662,148663,YQC4EUcgeBi9431viwvzvBbZJW3szeHX4dFmowRDyDw,11893011,21014448,-9121437,710
2022-03-31 19:45:44-04:00,14219,3hEe6AXGjjVzWnsadNZHfeB6CGg8nKSLyhtyqgBtVivt,6Qdu667ChFcRT7J5QHQzUsWpLmxmNvywAaevseSXqxPZ,True,29614735,7403683,49838,24919,24919,YQC4EUcgeBi9431viwvzvBbZJW3szeHX4dFmowRDyDw,1993534,5182659,-3189125,673
2022-03-31 19:45:46-04:00,14220,SEndYVMCKAeZUKSqGrMUSqXFmxtA9M1t4eXsUhVsTBF,3fcQQcbkpqodakamn82pFnMxBEPL2Drsg4jJNZ6dx72M,True,2567300350,281864201,1839377,919688,919689,3zqXX6kzhkbW3d4TwD2CNjMRwxTbREXySekvq37kfCNk,167535856,354828203,-187292347,652
2022-03-31 19:45:49-04:00,14221,Gw37fsD8M3AaZ22tSx9WeszxsAkWQ6Ap2XV3zXYhe3EJ,FbKeJsWR5ggVBy1R5sxNiWz5GAsxeyZD8nmyk5yCBqSz,True,417731168,104432792,740957,370478,370479,3zqXX6kzhkbW3d4TwD2CNjMRwxTbREXySekvq37kfCNk,29638306,73555072,-43916766,709
2022-03-31 21:27:45-04:00,14222,2ssYxbmFPYBdse9a6NJ26M8hsscYpjv5MyqyYkjftdrL,FKvvXz9eYXW2zgy37eaUW9u2K9LnnDsNx3DcgtATpizY,True,370012838,92503209,539529,269764,269765,3zqXX6kzhkbW3d4TwD2CNjMRwxTbREXySekvq37kfCNk,21581163,38286574,-16705411,583
2022-03-31 22:00:49-04:00,14223,EN2YBXcj7E1eAaYJYXJjc6Rfsu6Awjgv9kN3bT3uiprp,HYDG5mqfCy2xwrYKixNzoWyDiqb9KbpnA8H3TQG2EDDG,True,961525047,240381162,1487692,743846,743846,YQC4EUcgeBi9431viwvzvBbZJW3szeHX4dFmowRDyDw,59507755,142158456,-82650701,618
2022-03-31 22:22:28-04:00,14224,GgJXh5hTo4xyVuuGEis971RRXcZECLpjvtMSCZtVu13Q,9BGMfGfMZNXdcygAuqYQudWHhSE5LqVoWsNsruCawnRK,True,55764064,13941016,86994,43497,43497,YQC4EUcgeBi9431viwvzvBbZJW3szeHX4dFmowRDyDw,3479767,5745825,-2266058,624
2022-03-31 22:25:17-04:00,14225,5yPGvUz6JWKjkViGwTCpygJii1rP2xv5yx146ULtBiYq,FMnHUCQWTf1UHu5qVFqUAsWh8aba9EQYTEoiXy55totD,True,2564140955,285097943,1780722,890361,890361,3zqXX6kzhkbW3d4TwD2CNjMRwxTbREXySekvq37kfCNk,160156337,346277341,-186121004,624
2022-03-31 22:26:09-04:00,14226,7JbCUyTgV4oLjFST9UUvtJkKpK6F99Pwb1Xe6JT8v7s4,9uYeL9R23XRstddnVE6kohfwCkR41E1GXtyduzc9TwEX,True,57437242537,14359309090,88892938,44446469,44446469,3zqXX6kzhkbW3d4TwD2CNjMRwxTbREXySekvq37kfCNk,3555717921,7057559541,-3501841620,619
2022-03-31 22:26:24-04:00,14227,7yW1M1xeVx4hy3QftnpqdBDRYwamfu3K5i6AEnxgyTWb,7wf7FWS2DYp5RveQAmGNXAEUWPcHziuMLd4hV5LPgxF8,True,71260850,17815212,110538,55269,55269,YQC4EUcgeBi9431viwvzvBbZJW3szeHX4dFmowRDyDw,4421528,8130809,-3709281,620
2022-03-31 22:28:52-04:00,14228,SEndYVMCKAeZUKSqGrMUSqXFmxtA9M1t4eXsUhVsTBF,3fcQQcbkpqodakamn82pFnMxBEPL2Drsg4jJNZ6dx72M,True,2251314141,315415999,1990068,995034,995034,YQC4EUcgeBi9431viwvzvBbZJW3szeHX4dFmowRDyDw,142043229,318300324,-176257095,630
2022-03-31 22:28:53-04:00,14229,F2AU2PjaSmHxWWhkz8XxMggkCMWbMVgawt89tSnYS6RL,ET9febRJiW197DYMaJbgk3kWsAeFv5f4peQ4vFCVppK6,True,184345647,46086411,325737,162868,162869,3zqXX6kzhkbW3d4TwD2CNjMRwxTbREXySekvq37kfCNk,13029518,37238945,-24209427,706
2022-03-31 22:29:35-04:00,14230,82RokGTDMqEDvdofWoJhm3LbGX3aE1FopbQWNQWP4dHj,F2mNSbKHJEQyr8yWxnSf96tajULmpYAQDok5PzjsmxJt,True,2800351183,700087795,4332877,2166438,2166439,3zqXX6kzhkbW3d4TwD2CNjMRwxTbREXySekvq37kfCNk,173315083,428174625,-254859542,618
2022-03-31 22:31:18-04:00,14231,5yPGvUz6JWKjkViGwTCpygJii1rP2xv5yx146ULtBiYq,FMnHUCQWTf1UHu5qVFqUAsWh8aba9EQYTEoiXy55totD,True,2261995350,211761662,1323072,661536,661536,YQC4EUcgeBi9431viwvzvBbZJW3szeHX4dFmowRDyDw,141327953,323314050,-181986097,624
2022-03-31 22:49:14-04:00,14232,7ueXVhSvXvttkeQ18w2cLh65naoEPvYF86RrdUK2Vc5Q,CKTehY1W6bw85cS4o7g2qXKjP4656Vwo37244BAEAiw1,True,78220039662,8913478118,55696746,27848373,27848373,YQC4EUcgeBi9431viwvzvBbZJW3szeHX4dFmowRDyDw,4887656305,9845264996,-4957608691,624
2022-03-31 22:49:25-04:00,14233,BhhVhLVZkSd3aHDMd6ojTgtJtbgAdMCA9Xj8jL2GMXoL,G8HUQp2yGSw9T6it5ej91cqkd82naca8heji453g2jEH,True,16436299326,2696784116,16844671,8422335,8422336,YQC4EUcgeBi9431viwvzvBbZJW3szeHX4dFmowRDyDw,1026645278,968248056,58397222,624
2022-03-31 22:52:06-04:00,14234,EC8fafqtuQzqbm2TZs3GeuXB9qXomkykrTG1na2rfFpx,A72f7W58h3r8nut45RmqdTk1J31NGYT2sVWMn18dK885,True,136474370,34118592,208167,104083,104084,3zqXX6kzhkbW3d4TwD2CNjMRwxTbREXySekvq37kfCNk,8326714,14270363,-5943649,610
2022-03-31 22:52:38-04:00,14235,jLcMvWkdEDweLB1otEdmsnL48kQPF5esSKx5WDzrdei,3VtwkSQaVnPv8MFuyDDj6dGQGnuY5GDUY2wYkBFRkfdF,True,19918536726,4979634181,30987971,15493985,15493986,3zqXX6kzhkbW3d4TwD2CNjMRwxTbREXySekvq37kfCNk,1239518876,2573091215,-1333572339,622
2022-03-31 22:53:29-04:00,14236,GCweck6iuscBsVbXW9ZYfMytdgwSYWwNifTWLaUbaSmA,6HwGWKGduMGvLnHmTJo6ZioZ3EMUZYHo2pG4tBFXgB4Y,True,271646082,67911520,484621,242310,242311,YQC4EUcgeBi9431viwvzvBbZJW3szeHX4dFmowRDyDw,19384857,54714116,-35329259,713
2022-03-31 22:53:45-04:00,14237,EHLV9s6E1s5SUbzZVzsGWH2vVRGHyxynM4GDJtfKEuYe,4hAx9osegpeocSSmJbMVBYMKCwo5WY3QVJuK7cuzz4b4,True,271592720,67898180,484160,242080,242080,YQC4EUcgeBi9431viwvzvBbZJW3szeHX4dFmowRDyDw,19366431,54749932,-35383501,713
2022-03-31 22:53:49-04:00,14238,GHEUXeGuGYwqM1e4Gq8FvKi8ZVCJ8vZSBQXZr1dsVz9L,BvPGL2pEXFRfed9pmDNqCzW8SmPv38C28rij12BCHoHs,True,50783683251,12695920812,79281149,39640574,39640575,3zqXX6kzhkbW3d4TwD2CNjMRwxTbREXySekvq37kfCNk,3171245965,5930984155,-2759738190,624
2022-03-31 22:53:49-04:00,14239,6Rk6wVu6pCDFwEWDbiY8wS93nDghyHP9kzdUEa6eFRRq,B5v7eFjSX6dDt1kt84Uvtqmrn7STbQPMbFMvjH6WGXJg,True,564943998,141235992,875779,437889,437890,YQC4EUcgeBi9431viwvzvBbZJW3szeHX4dFmowRDyDw,35031220,57821674,-22790454,620
2022-03-31 22:53:57-04:00,14240,AwT3pH9dHjECDnuUiazbD6tZxZHdNwgJ4vBMmxLHMiLo,AjybksvjMT1QT6KvryXCG47pQGT8v9jxM34VkveGPQrs,True,47481270,11870317,74094,37047,37047,3RdfgDvLvsdZG5Cf6hKiKMQMqfidyxHzjYvUx1FZpeHQ,2963796,5047434,-2083638,624
2022-03-31 22:54:00-04:00,14241,5qY8ZrqpHPqkAuXp6HpE2zC8qTfzsP8MXWSoxkZQV5jx,GPs3ap45TuHwHwmDb5bnKYHLBa5wj3AyuEsXcfHjEcAL,True,122831041,30707760,219249,109624,109625,YQC4EUcgeBi9431viwvzvBbZJW3szeHX4dFmowRDyDw,8769965,18402809,-9632844,713
2022-03-31 22:54:12-04:00,14242,3hEe6AXGjjVzWnsadNZHfeB6CGg8nKSLyhtyqgBtVivt,6Qdu667ChFcRT7J5QHQzUsWpLmxmNvywAaevseSXqxPZ,True,21823859,5455964,38892,19446,19446,YQC4EUcgeBi9431viwvzvBbZJW3szeHX4dFmowRDyDw,1555697,4334824,-2779127,712
2022-03-31 22:54:23-04:00,14243,2ssYxbmFPYBdse9a6NJ26M8hsscYpjv5MyqyYkjftdrL,FKvvXz9eYXW2zgy37eaUW9u2K9LnnDsNx3DcgtATpizY,True,273438364,68359591,424169,212084,212085,3zqXX6kzhkbW3d4TwD2CNjMRwxTbREXySekvq37kfCNk,16966782,33568680,-16601898,620
2022-03-31 22:54:38-04:00,14244,7JbCUyTgV4oLjFST9UUvtJkKpK6F99Pwb1Xe6JT8v7s4,9uYeL9R23XRstddnVE6kohfwCkR41E1GXtyduzc9TwEX,True,42236884148,10559219516,65644382,32822191,32822191,YQC4EUcgeBi9431viwvzvBbZJW3szeHX4dFmowRDyDw,2625775684,6120782187,-3495006503,621
2022-03-31 22:55:20-04:00,14245,64nf6XvL2L7Tx4vZJkAsATE66fiDvgueHryriiesW3JF,2mXMvWYphTBSo1TJY7HJ5UM62r5q6t8bVmh6TMybCh2A,True,34136721361,2721118170,17605627,8802813,8802814,YQC4EUcgeBi9431viwvzvBbZJW3szeHX4dFmowRDyDw,2208645042,2920596900,-711951858,646
2022-03-31 22:55:29-04:00,14246,7ueXVhSvXvttkeQ18w2cLh65naoEPvYF86RrdUK2Vc5Q,CKTehY1W6bw85cS4o7g2qXKjP4656Vwo37244BAEAiw1,True,68772229553,7054987518,44087139,22043569,22043570,YQC4EUcgeBi9431viwvzvBbZJW3szeHX4dFmowRDyDw,4297627568,9217705571,-4920078003,624
2022-03-31 22:55:29-04:00,14247,4su8C6mT6H9x81kp65dmaLN8g7K4Bvhps2hExaq7Ltwd,J4qMKYGBiDMq4We6rXTe46hpw7u7dkXEtReYXZVcYMTP,True,95776134059,15801050678,98376726,49188363,49188363,3zqXX6kzhkbW3d4TwD2CNjMRwxTbREXySekvq37kfCNk,5962984803,8931482550,-2968497747,622
2022-03-31 22:55:46-04:00,14248,BFWNfNhm4RUFJs3721We8Dyocw1okinoUA3JtHshAHkU,7czPpWxLYgLgAGmvxiKA6zRGQ97FdLVB83FvNqEuKnFj,True,8304285816,2076071454,12934266,6467133,6467133,YQC4EUcgeBi9431viwvzvBbZJW3szeHX4dFmowRDyDw,517370661,1200177752,-682807091,623
2022-03-31 22:55:50-04:00,14249,5yPGvUz6JWKjkViGwTCpygJii1rP2xv5yx146ULtBiYq,FMnHUCQWTf1UHu5qVFqUAsWh8aba9EQYTEoiXy55totD,True,2036399242,210069517,1301540,650770,650770,3zqXX6kzhkbW3d4TwD2CNjMRwxTbREXySekvq37kfCNk,126170435,305186199,-179015764,619
2022-03-31 22:55:50-04:00,14250,7yW1M1xeVx4hy3QftnpqdBDRYwamfu3K5i6AEnxgyTWb,7wf7FWS2DYp5RveQAmGNXAEUWPcHziuMLd4hV5LPgxF8,True,52208113,13052028,76836,38418,38418,YQC4EUcgeBi9431viwvzvBbZJW3szeHX4dFmowRDyDw,3073465,7092988,-4019523,588
2022-03-31 22:56:10-04:00,14251,BhhVhLVZkSd3aHDMd6ojTgtJtbgAdMCA9Xj8jL2GMXoL,G8HUQp2yGSw9T6it5ej91cqkd82naca8heji453g2jEH,True,13576663006,2003337557,12497353,6248676,6248677,3zqXX6kzhkbW3d4TwD2CNjMRwxTbREXySekvq37kfCNk,846948403,992036419,-145088016,623
2022-03-31 22:58:47-04:00,14252,8qq2gfbca7JXvq4gViBBVT2QAbM4MvBMEQLXgn8UUTvt,3o5jpBVYdFFEYrGRdCUkLrUC85wsuTKgy8iYwnpZyC1B,True,2282600730,221273965,1381851,690925,690926,3zqXX6kzhkbW3d4TwD2CNjMRwxTbREXySekvq37kfCNk,142547964,786451443,-643903479,624
2022-03-31 22:59:46-04:00,14253,7CSCMFa9W52tBDVUbXbc3woAy3GByeA1wPJdp3MgznPa,3447ptuVFu6G8B6N63RmS8mRv4n9PfHneypHLvbeaGLn,True,4995287996,1046091981,6510099,3255049,3255050,3zqXX6kzhkbW3d4TwD2CNjMRwxTbREXySekvq37kfCNk,310869612,687595990,-376726378,622
2022-04-01 03:49:57-04:00,14254,H7wVZszBQdmFuwMUYAw4SSYbjxeFY1QvNBuT8QiqTxZS,CUm235keNKnVd2BaCNp5a6HePtWGMo8dq8S1KXf2KRR4,True,129949630,32487407,202456,101228,101228,3zqXX6kzhkbW3d4TwD2CNjMRwxTbREXySekvq37kfCNk,8098253,12438472,-4340219,623
2022-04-01 03:58:54-04:00,14255,4Bi1PEYPfA5VEoBqzGbt5fSd6PwuVsrF5SfLWXtpNxFA,3aApRXGYkRs9AZXchR5i7HnWXiRvBQgg3fz1bb4gMx2U,True,30546355,4206192,26144,13072,13072,3zqXX6kzhkbW3d4TwD2CNjMRwxTbREXySekvq37kfCNk,1898654,8890826,-6992172,621
2022-04-01 04:04:30-04:00,14256,FMdKLXhQEnNJtvM17ZX8jhaeMaSD9UgDuN3Kw7kMrd7K,5pURHYWB5LUGwJmWVBGH8p6oyR9NJvXnZk7uDVoiassv,True,1711697411,427924352,2662539,1331269,1331270,3zqXX6kzhkbW3d4TwD2CNjMRwxTbREXySekvq37kfCNk,106501582,163967528,-57465946,622
2022-04-01 04:04:42-04:00,14257,DmrkajG3SrTXnYSYxGRfkzfvhkevD6RdtFk4SdLC2G6Q,5r7vkWH985E2mGSDBtznduhuu5PbZJ7d4zxjzhzEEZG1,True,8019110395,1012515780,6326996,3163498,3163498,YQC4EUcgeBi9431viwvzvBbZJW3szeHX4dFmowRDyDw,501097206,1256432480,-755335274,624
2022-04-01 09:13:34-04:00,14258,4Bi1PEYPfA5VEoBqzGbt5fSd6PwuVsrF5SfLWXtpNxFA,3aApRXGYkRs9AZXchR5i7HnWXiRvBQgg3fz1bb4gMx2U,True,26494741,3420891,21184,10592,10592,3u7uYrYWGhL1rNaQfaT1E4Lc1EbfzR8ZudfMhbesRBZ5,1640752,7689640,-6048888,619
2022-04-01 09:13:35-04:00,14259,H7wVZszBQdmFuwMUYAw4SSYbjxeFY1QvNBuT8QiqTxZS,CUm235keNKnVd2BaCNp5a6HePtWGMo8dq8S1KXf2KRR4,True,99415421,24853855,148589,74294,74295,YQC4EUcgeBi9431viwvzvBbZJW3szeHX4dFmowRDyDw,5943575,11152048,-5208473,597
2022-04-01 09:14:19-04:00,14260,niCk6QHFU1kyU56Mdq5RJzKrecdkNSn23ZA6wduFdWS,BQbUYSw1XsuE6LnVd4XjmxAyYgx4drE4FsetJBCdwVZW,True,28303738,3606147,22538,11269,11269,YQC4EUcgeBi9431viwvzvBbZJW3szeHX4dFmowRDyDw,1768979,4366209,-2597230,624
2022-04-01 09:17:37-04:00,14261,FMdKLXhQEnNJtvM17ZX8jhaeMaSD9UgDuN3Kw7kMrd7K,5pURHYWB5LUGwJmWVBGH8p6oyR9NJvXnZk7uDVoiassv,True,1306458528,326614632,2029104,1014552,1014552,3zqXX6kzhkbW3d4TwD2CNjMRwxTbREXySekvq37kfCNk,81164178,146968315,-65804137,621
2022-04-01 09:26:49-04:00,14262,5QxR9QPTADFys9VQNm473RgprTikCXC23vhsBc9ojyAQ,H9zdf8nJ4JCF7jrwGsxiuiFoa14gzDmYsZ5N5ig3UGna,True,942540396,235635099,1469942,734971,734971,3zqXX6kzhkbW3d4TwD2CNjMRwxTbREXySekvq37kfCNk,58797685,84249676,-25451991,623
2022-04-01 09:32:06-04:00,14263,DmrkajG3SrTXnYSYxGRfkzfvhkevD6RdtFk4SdLC2G6Q,5r7vkWH985E2mGSDBtznduhuu5PbZJ7d4zxjzhzEEZG1,True,7106422110,1011217359,6305467,3152733,3152734,3zqXX6kzhkbW3d4TwD2CNjMRwxTbREXySekvq37kfCNk,443122477,1381353777,-938231300,623
2022-04-01 09:34:02-04:00,14264,AzmKB7i1dJucc5Ec1mxpoJor662CDFKAAWRstWDtrmaq,Fd2bPyTR54f8fcTkUokCjcgYgReTGR9vN7ymaGXVcMDK,True,66970845,16742711,103486,51743,51743,YQC4EUcgeBi9431viwvzvBbZJW3szeHX4dFmowRDyDw,4139470,23455932,-19316462,618
2022-04-01 09:34:03-04:00,14265,6yjPfkAHVeT6pnwwa2iAGnAvmHZc1nirWw1ByjesoTHD,9MwcpCovRfMMbCf1z3PsoqhNY4RmgYXU385bKWFwqMuC,True,306114578,76528644,476806,238403,238403,YQC4EUcgeBi9431viwvzvBbZJW3szeHX4dFmowRDyDw,19072241,86882065,-67809824,623
2022-04-01 10:06:51-04:00,14266,Hya9U3Ao61oebVBPEnUiqinqvpzTguAZhbAWDmEQpm3a,FdYMMqoYPe5Jgj8R2ovKVUKxRPK1xppR59XRGPdvHRAx,True,72612407,18153101,113003,56501,56502,YQC4EUcgeBi9431viwvzvBbZJW3szeHX4dFmowRDyDw,4520150,29658017,-25137867,622
2022-04-01 10:07:10-04:00,14267,4Bi1PEYPfA5VEoBqzGbt5fSd6PwuVsrF5SfLWXtpNxFA,3aApRXGYkRs9AZXchR5i7HnWXiRvBQgg3fz1bb4gMx2U,True,23351732,3257829,20328,10164,10164,YQC4EUcgeBi9431viwvzvBbZJW3szeHX4dFmowRDyDw,1457120,7084769,-5627649,623
2022-04-01 10:07:11-04:00,14268,H7wVZszBQdmFuwMUYAw4SSYbjxeFY1QvNBuT8QiqTxZS,CUm235keNKnVd2BaCNp5a6HePtWGMo8dq8S1KXf2KRR4,True,75842689,18960672,112853,56426,56427,YQC4EUcgeBi9431viwvzvBbZJW3szeHX4dFmowRDyDw,4514133,9701674,-5187541,595
2022-04-01 10:07:15-04:00,14269,9ZVrkxds9vQ17KGWgANMfJeyMCGxuFRLFVBVS1wrPCqH,HyxwwiTVpAoaeKgX2no9Sp4o8hML15xABjRmMnFfJeYS,True,28608149,7152037,43098,21549,21549,YQC4EUcgeBi9431viwvzvBbZJW3szeHX4dFmowRDyDw,1723949,10800766,-9076817,602
2022-04-01 10:07:16-04:00,14270,5seV37JfFeqX91yaDfiupi2Ms7yYuuZFHwZ42ovhTbdU,KqBKpYuGWPhC8iYvedTYb4k5Lu3y89UMxt46t8gvn6h,True,112233793,28058448,170221,85110,85111,3RdfgDvLvsdZG5Cf6hKiKMQMqfidyxHzjYvUx1FZpeHQ,6808865,33792713,-26983848,606
2022-04-01 10:07:17-04:00,14271,HhU3H9e4SDu2n1FobL8gxS1pg3ayQBFQ84psbLqdcUw2,H1Z7WqJXn3T16xSFUQGpthMmvSbQNBkbhk1qbufChW3x,True,2970837004,742709251,4590911,2295455,2295456,YQC4EUcgeBi9431viwvzvBbZJW3szeHX4dFmowRDyDw,183636469,583376832,-399740363,618
2022-04-01 10:07:17-04:00,14272,CzWT7zuiD3Usn1DB8C87kZ3yaLcAd1GXe62cZ5xDdEKa,2AsTxJr8dyhHmccUngu2f6beGE9iiXH4yXhmQ48SpCXm,True,25501459,6375364,39219,19609,19610,3RdfgDvLvsdZG5Cf6hKiKMQMqfidyxHzjYvUx1FZpeHQ,1568776,7245035,-5676259,615
2022-04-01 10:07:17-04:00,14273,54rcQUxBXFfoNq8n9RxsxH1Lp4VHR2CfE71vCCVy6rPQ,4exavmUP5CfqEmqVusSNuW9Ha2rhPBAy2gg6rP2d5tvu,True,205228857,51307214,312269,156134,156135,3zqXX6kzhkbW3d4TwD2CNjMRwxTbREXySekvq37kfCNk,12490764,85318348,-72827584,608
2022-04-01 10:07:19-04:00,14274,A1PrrpsFRrxg7un9ouqsufUHapPjjA9X8MDSkYYEGHDx,6cKet3aoRgP3VtVeXaCbZN5QK58R2nwfKdcRRub6464G,False,18579,18579,1100,55,1045,YQC4EUcgeBi9431viwvzvBbZJW3szeHX4dFmowRDyDw,1100,6728,-5628,592
2022-04-01 10:07:20-04:00,14275,6BQVtmNsxihi4PcA7MurtguTwa6SmbmKyP14RHyjVZkf,7ZFv5ms4HzVKiw7KgE8RUoKxW9rB6JUD7ujZxMx4DwnM,True,27786284,6946571,42032,21016,21016,YQC4EUcgeBi9431viwvzvBbZJW3szeHX4dFmowRDyDw,1681308,8667592,-6986284,605
2022-04-01 10:07:24-04:00,14276,AFYRpYG4Nm818mSXVrBX9SScLSHfe9VJynGZUgvBsgMc,5zbZnbBHauM6tKDJFhDdgTKVkhAgZ4V5WSyTDLUX2Mqs,True,114899121,28724780,174562,87281,87281,3zqXX6kzhkbW3d4TwD2CNjMRwxTbREXySekvq37kfCNk,6982482,37507041,-30524559,607
2022-04-01 10:07:25-04:00,14277,AT4qoJDVGXpEm3BGACUhC1zpVNLq4iX2bJ4cpABehpoD,AqaDPXbaY6ksVQwWGKorgBdRQMz3VpqxmHdWXmq17ScF,True,570089445,142522361,862698,431349,431349,YQC4EUcgeBi9431viwvzvBbZJW3szeHX4dFmowRDyDw,34507944,229562772,-195054828,605
2022-04-01 10:15:00-04:00,14278,6qqBmN3Mmy56gXvtBwLUyQwJoh2cYKmMtP61Po9xgxRj,FySpFnWFTZAaYLZ2c8Lb9m89CJxj3ZFMcZTdcwRrEEGH,True,373549348,93387337,583283,291641,291642,3zqXX6kzhkbW3d4TwD2CNjMRwxTbREXySekvq37kfCNk,23331327,82827738,-59496411,624
2022-04-01 10:18:25-04:00,14279,84CS9aD3YJABQUpuaKrzQrGDZmHDAT7sGGEVJCr9iWs,Du7MR89dZzrBMidrVXVqbZ71dJ3PthHrcA9G6HyNcSw9,True,256028492,64007123,396706,198353,198353,YQC4EUcgeBi9431viwvzvBbZJW3szeHX4dFmowRDyDw,15868277,37135969,-21267692,619
2022-04-01 10:18:26-04:00,14280,FMdKLXhQEnNJtvM17ZX8jhaeMaSD9UgDuN3Kw7kMrd7K,5pURHYWB5LUGwJmWVBGH8p6oyR9NJvXnZk7uDVoiassv,True,996872435,249218108,1552751,776375,776376,YQC4EUcgeBi9431viwvzvBbZJW3szeHX4dFmowRDyDw,62110067,128502608,-66392541,623
2022-04-01 10:18:34-04:00,14281,5BSr2tqthLtZfR2Dcq1hndaU2URYFNzdfjh3evp4kUnV,HcTxCpo9CeQMAjvXE9668B2LQHJXNqEUsPABLputs7Nm,False,13182810,13182810,819791,40989,778802,YQC4EUcgeBi9431viwvzvBbZJW3szeHX4dFmowRDyDw,819791,4084107,-3264316,621
2022-04-01 10:29:43-04:00,14282,EToqvQTpzBfLfgPLf2vbpSkLt4isU6hR6E3Dhcx1uCD9,6sJ7wNkr4fL9uWuFcE9AvpzrNvCp3XX168DwjMLkaM4z,True,14501896714,3625474178,22449739,11224869,11224870,3zqXX6kzhkbW3d4TwD2CNjMRwxTbREXySekvq37kfCNk,897989589,4383979285,-3485989696,619
2022-04-01 10:48:27-04:00,14283,5QxR9QPTADFys9VQNm473RgprTikCXC23vhsBc9ojyAQ,H9zdf8nJ4JCF7jrwGsxiuiFoa14gzDmYsZ5N5ig3UGna,True,719395761,179848940,1120814,560407,560407,YQC4EUcgeBi9431viwvzvBbZJW3szeHX4dFmowRDyDw,44832583,76437654,-31605071,623
2022-04-01 10:48:36-04:00,14284,AzmKB7i1dJucc5Ec1mxpoJor662CDFKAAWRstWDtrmaq,Fd2bPyTR54f8fcTkUokCjcgYgReTGR9vN7ymaGXVcMDK,True,51077783,12769445,79662,39831,39831,YQC4EUcgeBi9431viwvzvBbZJW3szeHX4dFmowRDyDw,3186515,18523532,-15337017,623
2022-04-01 10:48:36-04:00,14285,2f5wSFQfcN5ogh4Ln9d7EeyzAVdmZ64NsB56mtoNFMst,9JhD3JQmGDxefbeZaw1Ynw1uwL3hdVaicyZH6RjL9Mi6,True,5195122646,750231069,4672378,2336189,2336189,YQC4EUcgeBi9431viwvzvBbZJW3szeHX4dFmowRDyDw,323548072,1100223018,-776674946,622
2022-04-01 10:49:54-04:00,14286,6yjPfkAHVeT6pnwwa2iAGnAvmHZc1nirWw1ByjesoTHD,9MwcpCovRfMMbCf1z3PsoqhNY4RmgYXU385bKWFwqMuC,True,233590301,58397575,364797,182398,182399,YQC4EUcgeBi9431viwvzvBbZJW3szeHX4dFmowRDyDw,14591891,69454115,-54862224,624
2022-04-01 10:49:54-04:00,14287,GTzLxRn226vTjN4HTSDSCjDLjwNiP4jsarG4umsA4CPc,6BWii3HLmdacnSS1pe8RkbbN6kbe4jpYYbnHqM1hh2G5,True,458926914,114731728,716991,358495,358496,3zqXX6kzhkbW3d4TwD2CNjMRwxTbREXySekvq37kfCNk,28679655,49575272,-20895617,624
2022-04-01 10:52:11-04:00,14288,Hya9U3Ao61oebVBPEnUiqinqvpzTguAZhbAWDmEQpm3a,FdYMMqoYPe5Jgj8R2ovKVUKxRPK1xppR59XRGPdvHRAx,True,55512594,13878148,83846,41923,41923,YQC4EUcgeBi9431viwvzvBbZJW3szeHX4dFmowRDyDw,3353859,23260570,-19906711,604
2022-04-01 10:52:13-04:00,14289,9ZVrkxds9vQ17KGWgANMfJeyMCGxuFRLFVBVS1wrPCqH,HyxwwiTVpAoaeKgX2no9Sp4o8hML15xABjRmMnFfJeYS,True,21788351,5447087,33715,16857,16858,3zqXX6kzhkbW3d4TwD2CNjMRwxTbREXySekvq37kfCNk,1348612,8488467,-7139855,618
2022-04-01 10:52:17-04:00,14290,5seV37JfFeqX91yaDfiupi2Ms7yYuuZFHwZ42ovhTbdU,KqBKpYuGWPhC8iYvedTYb4k5Lu3y89UMxt46t8gvn6h,True,85498160,21374540,132895,66447,66448,YQC4EUcgeBi9431viwvzvBbZJW3szeHX4dFmowRDyDw,5315829,26876594,-21560765,621
2022-04-01 10:52:19-04:00,14291,54rcQUxBXFfoNq8n9RxsxH1Lp4VHR2CfE71vCCVy6rPQ,4exavmUP5CfqEmqVusSNuW9Ha2rhPBAy2gg6rP2d5tvu,True,156344556,39086139,243889,121944,121945,YQC4EUcgeBi9431viwvzvBbZJW3szeHX4dFmowRDyDw,9755582,66799364,-57043782,623
2022-04-01 10:52:23-04:00,14292,FDxmgdXDyVzQuMRydb9dCm71chEkwYsM4xtwqvTWUNZC,82LTSgmRbSb25GSVvgPmFSvcva7yCHHnAHrn8FmCCCqb,True,6802702442,835494627,5215225,2607612,2607613,3zqXX6kzhkbW3d4TwD2CNjMRwxTbREXySekvq37kfCNk,424630228,768042343,-343412115,624
2022-04-01 10:52:23-04:00,14293,CzWT7zuiD3Usn1DB8C87kZ3yaLcAd1GXe62cZ5xDdEKa,2AsTxJr8dyhHmccUngu2f6beGE9iiXH4yXhmQ48SpCXm,True,19441109,4860277,30363,15181,15182,YQC4EUcgeBi9431viwvzvBbZJW3szeHX4dFmowRDyDw,1214543,5786754,-4572211,624
2022-04-01 10:52:37-04:00,14294,HhU3H9e4SDu2n1FobL8gxS1pg3ayQBFQ84psbLqdcUw2,H1Z7WqJXn3T16xSFUQGpthMmvSbQNBkbhk1qbufChW3x,True,2265612345,566403086,3539024,1769512,1769512,YQC4EUcgeBi9431viwvzvBbZJW3szeHX4dFmowRDyDw,141560966,478901929,-337340963,624
2022-04-01 11:01:30-04:00,14295,6BQVtmNsxihi4PcA7MurtguTwa6SmbmKyP14RHyjVZkf,7ZFv5ms4HzVKiw7KgE8RUoKxW9rB6JUD7ujZxMx4DwnM,True,21158149,5289537,33025,16512,16513,YQC4EUcgeBi9431viwvzvBbZJW3szeHX4dFmowRDyDw,1321017,6879170,-5558153,624
2022-04-01 11:01:50-04:00,14296,AT4qoJDVGXpEm3BGACUhC1zpVNLq4iX2bJ4cpABehpoD,AqaDPXbaY6ksVQwWGKorgBdRQMz3VpqxmHdWXmq17ScF,True,434105507,108526376,677761,338880,338881,YQC4EUcgeBi9431viwvzvBbZJW3szeHX4dFmowRDyDw,27110457,179941428,-152830971,624
2022-04-01 11:01:56-04:00,14297,AFYRpYG4Nm818mSXVrBX9SScLSHfe9VJynGZUgvBsgMc,5zbZnbBHauM6tKDJFhDdgTKVkhAgZ4V5WSyTDLUX2Mqs,True,87523588,21880897,136485,68242,68243,YQC4EUcgeBi9431viwvzvBbZJW3szeHX4dFmowRDyDw,5459405,29702136,-24242731,623
2022-04-01 11:10:22-04:00,14298,6qqBmN3Mmy56gXvtBwLUyQwJoh2cYKmMtP61Po9xgxRj,FySpFnWFTZAaYLZ2c8Lb9m89CJxj3ZFMcZTdcwRrEEGH,True,285303717,71325929,440217,220108,220109,YQC4EUcgeBi9431viwvzvBbZJW3szeHX4dFmowRDyDw,17608715,67373512,-49764797,617
2022-04-01 11:10:25-04:00,14299,84CS9aD3YJABQUpuaKrzQrGDZmHDAT7sGGEVJCr9iWs,Du7MR89dZzrBMidrVXVqbZ71dJ3PthHrcA9G6HyNcSw9,True,195347839,48836959,303668,151834,151834,YQC4EUcgeBi9431viwvzvBbZJW3szeHX4dFmowRDyDw,12146728,31424367,-19277639,621
2022-04-01 11:10:32-04:00,14300,FMdKLXhQEnNJtvM17ZX8jhaeMaSD9UgDuN3Kw7kMrd7K,5pURHYWB5LUGwJmWVBGH8p6oyR9NJvXnZk7uDVoiassv,True,760711676,190177919,1187657,593828,593829,3zqXX6kzhkbW3d4TwD2CNjMRwxTbREXySekvq37kfCNk,47506304,110364243,-62857939,624
2022-04-01 11:11:04-04:00,14301,2f5wSFQfcN5ogh4Ln9d7EeyzAVdmZ64NsB56mtoNFMst,9JhD3JQmGDxefbeZaw1Ynw1uwL3hdVaicyZH6RjL9Mi6,True,4484647842,570262792,3549216,1774608,1774608,3zqXX6kzhkbW3d4TwD2CNjMRwxTbREXySekvq37kfCNk,279116751,970302998,-691186247,622
2022-04-01 12:10:55-04:00,14302,niCk6QHFU1kyU56Mdq5RJzKrecdkNSn23ZA6wduFdWS,BQbUYSw1XsuE6LnVd4XjmxAyYgx4drE4FsetJBCdwVZW,True,25422736,3540630,22119,11059,11060,YQC4EUcgeBi9431viwvzvBbZJW3szeHX4dFmowRDyDw,1588277,3371940,-1783663,624
2022-04-01 12:14:07-04:00,14303,EToqvQTpzBfLfgPLf2vbpSkLt4isU6hR6E3Dhcx1uCD9,6sJ7wNkr4fL9uWuFcE9AvpzrNvCp3XX168DwjMLkaM4z,True,11063254086,2765813521,17222084,8611042,8611042,3zqXX6kzhkbW3d4TwD2CNjMRwxTbREXySekvq37kfCNk,688883362,3491269894,-2802386532,622
2022-04-01 12:14:43-04:00,14304,6yjPfkAHVeT6pnwwa2iAGnAvmHZc1nirWw1ByjesoTHD,9MwcpCovRfMMbCf1z3PsoqhNY4RmgYXU385bKWFwqMuC,True,178352261,44588065,276759,138379,138380,YQC4EUcgeBi9431viwvzvBbZJW3szeHX4dFmowRDyDw,11070373,55376853,-44306480,620
2022-04-01 12:14:43-04:00,14305,AzmKB7i1dJucc5Ec1mxpoJor662CDFKAAWRstWDtrmaq,Fd2bPyTR54f8fcTkUokCjcgYgReTGR9vN7ymaGXVcMDK,True,39023272,9755818,59813,29906,29907,3zqXX6kzhkbW3d4TwD2CNjMRwxTbREXySekvq37kfCNk,2392534,14610243,-12217709,613
2022-04-01 12:14:50-04:00,14306,Hya9U3Ao61oebVBPEnUiqinqvpzTguAZhbAWDmEQpm3a,FdYMMqoYPe5Jgj8R2ovKVUKxRPK1xppR59XRGPdvHRAx,True,42271123,10567780,65850,32925,32925,3zqXX6kzhkbW3d4TwD2CNjMRwxTbREXySekvq37kfCNk,2634002,18200725,-15566723,623
2022-04-01 12:14:50-04:00,14307,DmrkajG3SrTXnYSYxGRfkzfvhkevD6RdtFk4SdLC2G6Q,5r7vkWH985E2mGSDBtznduhuu5PbZJ7d4zxjzhzEEZG1,True,6283233290,787465843,4919940,2459970,2459970,3zqXX6kzhkbW3d4TwD2CNjMRwxTbREXySekvq37kfCNk,392564755,1036551792,-643987037,624
2022-04-01 12:19:10-04:00,14308,FDxmgdXDyVzQuMRydb9dCm71chEkwYsM4xtwqvTWUNZC,82LTSgmRbSb25GSVvgPmFSvcva7yCHHnAHrn8FmCCCqb,True,6021863996,635373995,3958619,1979309,1979310,3zqXX6kzhkbW3d4TwD2CNjMRwxTbREXySekvq37kfCNk,375184867,629090268,-253905401,623
2022-04-01 12:19:22-04:00,14309,9ZVrkxds9vQ17KGWgANMfJeyMCGxuFRLFVBVS1wrPCqH,HyxwwiTVpAoaeKgX2no9Sp4o8hML15xABjRmMnFfJeYS,True,16623761,4155940,25816,12908,12908,3zqXX6kzhkbW3d4TwD2CNjMRwxTbREXySekvq37kfCNk,1032661,6670051,-5637390,621
2022-04-01 12:19:27-04:00,14310,5seV37JfFeqX91yaDfiupi2Ms7yYuuZFHwZ42ovhTbdU,KqBKpYuGWPhC8iYvedTYb4k5Lu3y89UMxt46t8gvn6h,True,65234766,16308691,101820,50910,50910,3zqXX6kzhkbW3d4TwD2CNjMRwxTbREXySekvq37kfCNk,4072814,21354570,-17281756,624
2022-04-01 12:19:49-04:00,14311,54rcQUxBXFfoNq8n9RxsxH1Lp4VHR2CfE71vCCVy6rPQ,4exavmUP5CfqEmqVusSNuW9Ha2rhPBAy2gg6rP2d5tvu,True,119334071,29833517,185947,92973,92974,YQC4EUcgeBi9431viwvzvBbZJW3szeHX4dFmowRDyDw,7437914,52296507,-44858593,623
2022-04-01 12:21:12-04:00,14312,4Bi1PEYPfA5VEoBqzGbt5fSd6PwuVsrF5SfLWXtpNxFA,3aApRXGYkRs9AZXchR5i7HnWXiRvBQgg3fz1bb4gMx2U,True,20624223,2627775,16411,8205,8206,YQC4EUcgeBi9431viwvzvBbZJW3szeHX4dFmowRDyDw,1288043,6081028,-4792985,624
2022-04-01 12:22:13-04:00,14313,CzWT7zuiD3Usn1DB8C87kZ3yaLcAd1GXe62cZ5xDdEKa,2AsTxJr8dyhHmccUngu2f6beGE9iiXH4yXhmQ48SpCXm,False,14838452,14838452,926793,46339,880454,YQC4EUcgeBi9431viwvzvBbZJW3szeHX4dFmowRDyDw,926793,4613573,-3686780,624
2022-04-01 12:23:13-04:00,14314,HhU3H9e4SDu2n1FobL8gxS1pg3ayQBFQ84psbLqdcUw2,H1Z7WqJXn3T16xSFUQGpthMmvSbQNBkbhk1qbufChW3x,True,1729572620,432393155,2692143,1346071,1346072,3zqXX6kzhkbW3d4TwD2CNjMRwxTbREXySekvq37kfCNk,107685736,391083772,-283398036,622
2022-04-01 12:25:24-04:00,14315,6BQVtmNsxihi4PcA7MurtguTwa6SmbmKyP14RHyjVZkf,7ZFv5ms4HzVKiw7KgE8RUoKxW9rB6JUD7ujZxMx4DwnM,True,16148709,4037177,25200,12600,12600,YQC4EUcgeBi9431viwvzvBbZJW3szeHX4dFmowRDyDw,1008015,5456729,-4448714,624
2022-04-01 12:25:43-04:00,14316,2f5wSFQfcN5ogh4Ln9d7EeyzAVdmZ64NsB56mtoNFMst,9JhD3JQmGDxefbeZaw1Ynw1uwL3hdVaicyZH6RjL9Mi6,True,3943567009,553080207,3455522,1727761,1727761,3zqXX6kzhkbW3d4TwD2CNjMRwxTbREXySekvq37kfCNk,246385339,865208707,-618823368,624
2022-04-01 13:35:59-04:00,14317,3cv1G1bJ6WyRbguvWy1t6jEmabAvKwp6F4KuGiKu7ph8,C7gwgoLhkKSndGRC5zcHuzEjLtPNCcMFFEnYPY9UkGuf,False,50340,35437,0,0,0,3RdfgDvLvsdZG5Cf6hKiKMQMqfidyxHzjYvUx1FZpeHQ,0,8756,-10163,0
2022-04-01 13:36:02-04:00,14318,3cv1G1bJ6WyRbguvWy1t6jEmabAvKwp6F4KuGiKu7ph8,C7gwgoLhkKSndGRC5zcHuzEjLtPNCcMFFEnYPY9UkGuf,False,14903,14903,0,0,0,3RdfgDvLvsdZG5Cf6hKiKMQMqfidyxHzjYvUx1FZpeHQ,0,8240,-9647,0
2022-04-01 13:39:22-04:00,14319,8fSFsWaVRYHg5fdFQFQ89aBTjqsodGyc4sinV5UbWxtc,8evZpC24viqM8NaVFRjR91jLjXHLkW6GYAdywY8h2wys,True,36381162,3422560,21342,10671,10671,YQC4EUcgeBi9431viwvzvBbZJW3szeHX4dFmowRDyDw,2268742,12041660,-9772918,623
2022-04-01 13:40:09-04:00,14320,5QxR9QPTADFys9VQNm473RgprTikCXC23vhsBc9ojyAQ,H9zdf8nJ4JCF7jrwGsxiuiFoa14gzDmYsZ5N5ig3UGna,True,548980517,137245129,856687,428343,428344,YQC4EUcgeBi9431viwvzvBbZJW3szeHX4dFmowRDyDw,34267494,67419368,-33151874,624
2022-04-01 13:59:26-04:00,14321,AT4qoJDVGXpEm3BGACUhC1zpVNLq4iX2bJ4cpABehpoD,AqaDPXbaY6ksVQwWGKorgBdRQMz3VpqxmHdWXmq17ScF,True,331322780,82830695,517343,258671,258672,YQC4EUcgeBi9431viwvzvBbZJW3szeHX4dFmowRDyDw,20693758,141061443,-120367685,624
2022-04-01 13:59:27-04:00,14322,AFYRpYG4Nm818mSXVrBX9SScLSHfe9VJynGZUgvBsgMc,5zbZnbBHauM6tKDJFhDdgTKVkhAgZ4V5WSyTDLUX2Mqs,True,66821234,16705308,103633,51816,51817,YQC4EUcgeBi9431viwvzvBbZJW3szeHX4dFmowRDyDw,4145326,23505953,-19360627,620
2022-04-01 13:59:45-04:00,14323,H7wVZszBQdmFuwMUYAw4SSYbjxeFY1QvNBuT8QiqTxZS,CUm235keNKnVd2BaCNp5a6HePtWGMo8dq8S1KXf2KRR4,True,41676746,10419186,64909,32454,32455,YQC4EUcgeBi9431viwvzvBbZJW3szeHX4dFmowRDyDw,2596399,3995150,-1398751,622
2022-04-01 14:04:44-04:00,14324,8fSFsWaVRYHg5fdFQFQ89aBTjqsodGyc4sinV5UbWxtc,8evZpC24viqM8NaVFRjR91jLjXHLkW6GYAdywY8h2wys,True,33134792,3182738,19891,9945,9946,YQC4EUcgeBi9431viwvzvBbZJW3szeHX4dFmowRDyDw,2070882,11120320,-9049438,624
2022-04-01 14:52:36-04:00,14325,FDxmgdXDyVzQuMRydb9dCm71chEkwYsM4xtwqvTWUNZC,82LTSgmRbSb25GSVvgPmFSvcva7yCHHnAHrn8FmCCCqb,True,5405120794,530323095,3313147,1656573,1656574,YQC4EUcgeBi9431viwvzvBbZJW3szeHX4dFmowRDyDw,337680265,516042922,-178362657,624
2022-04-01 15:35:59-04:00,14326,DmrkajG3SrTXnYSYxGRfkzfvhkevD6RdtFk4SdLC2G6Q,5r7vkWH985E2mGSDBtznduhuu5PbZJ7d4zxjzhzEEZG1,True,5498446643,778129862,4858731,2429365,2429366,3zqXX6kzhkbW3d4TwD2CNjMRwxTbREXySekvq37kfCNk,343329296,748633668,-405304372,624
2022-04-01 15:37:14-04:00,14327,6qqBmN3Mmy56gXvtBwLUyQwJoh2cYKmMtP61Po9xgxRj,FySpFnWFTZAaYLZ2c8Lb9m89CJxj3ZFMcZTdcwRrEEGH,True,217556742,54389185,339839,169919,169920,3zqXX6kzhkbW3d4TwD2CNjMRwxTbREXySekvq37kfCNk,13593595,54496590,-40902995,624
2022-04-01 15:37:21-04:00,14328,84CS9aD3YJABQUpuaKrzQrGDZmHDAT7sGGEVJCr9iWs,Du7MR89dZzrBMidrVXVqbZ71dJ3PthHrcA9G6HyNcSw9,True,149090655,37272663,231651,115825,115826,YQC4EUcgeBi9431viwvzvBbZJW3szeHX4dFmowRDyDw,9266058,26304289,-17038231,621
2022-04-01 15:37:21-04:00,14329,FMdKLXhQEnNJtvM17ZX8jhaeMaSD9UgDuN3Kw7kMrd7K,5pURHYWB5LUGwJmWVBGH8p6oyR9NJvXnZk7uDVoiassv,True,580693408,145173352,904244,452122,452122,3zqXX6kzhkbW3d4TwD2CNjMRwxTbREXySekvq37kfCNk,36169794,93476404,-57306610,622
2022-04-01 15:46:40-04:00,14330,6yjPfkAHVeT6pnwwa2iAGnAvmHZc1nirWw1ByjesoTHD,9MwcpCovRfMMbCf1z3PsoqhNY4RmgYXU385bKWFwqMuC,True,136081737,34020434,211939,105969,105970,YQC4EUcgeBi9431viwvzvBbZJW3szeHX4dFmowRDyDw,8477589,44025147,-35547558,622
2022-04-01 15:46:47-04:00,14331,Hya9U3Ao61oebVBPEnUiqinqvpzTguAZhbAWDmEQpm3a,FdYMMqoYPe5Jgj8R2ovKVUKxRPK1xppR59XRGPdvHRAx,True,32257804,8064451,50351,25175,25176,YQC4EUcgeBi9431viwvzvBbZJW3szeHX4dFmowRDyDw,2014050,14243561,-12229511,624
2022-04-01 15:46:54-04:00,14332,niCk6QHFU1kyU56Mdq5RJzKrecdkNSn23ZA6wduFdWS,BQbUYSw1XsuE6LnVd4XjmxAyYgx4drE4FsetJBCdwVZW,True,22258327,2884158,18007,9003,9004,YQC4EUcgeBi9431viwvzvBbZJW3szeHX4dFmowRDyDw,1389691,3743479,-2353788,624
2022-04-01 15:46:55-04:00,14333,3bprArD4auGxKGrBunvBCC65h8AuF42EqRHagn7azHZE,9Zerp7yNQC88vhmu8gsLGbP2kNN8KF2gzCPqVe1MmHTu,True,1357514313,339378578,2119740,1059870,1059870,3zqXX6kzhkbW3d4TwD2CNjMRwxTbREXySekvq37kfCNk,84789620,208830250,-124040630,624
2022-04-01 15:47:08-04:00,14334,FDxmgdXDyVzQuMRydb9dCm71chEkwYsM4xtwqvTWUNZC,82LTSgmRbSb25GSVvgPmFSvcva7yCHHnAHrn8FmCCCqb,True,4893215904,485013141,3029691,1514845,1514846,3zqXX6kzhkbW3d4TwD2CNjMRwxTbREXySekvq37kfCNk,305660466,578586473,-272926007,624
2022-04-01 15:47:34-04:00,14335,2f5wSFQfcN5ogh4Ln9d7EeyzAVdmZ64NsB56mtoNFMst,9JhD3JQmGDxefbeZaw1Ynw1uwL3hdVaicyZH6RjL9Mi6,True,3419752979,437913099,2735888,1367944,1367944,3zqXX6kzhkbW3d4TwD2CNjMRwxTbREXySekvq37kfCNk,213651156,788397872,-574746716,624
2022-04-01 15:51:24-04:00,14336,9ZVrkxds9vQ17KGWgANMfJeyMCGxuFRLFVBVS1wrPCqH,HyxwwiTVpAoaeKgX2no9Sp4o8hML15xABjRmMnFfJeYS,False,12687124,12687124,787682,39384,748298,YQC4EUcgeBi9431viwvzvBbZJW3szeHX4dFmowRDyDw,787682,5235028,-4447346,620
