ts,record_id,user_authority,user,partial,base_asset_value,base_asset_value_closed,liquidation_fee,fee_to_liquidator,fee_to_insurance_fund,liquidator,total_collateral,collateral,unrealized_pnl,margin_ratio
2022-04-11 15:32:58-04:00,15361,1EH82ta3wXUyUwW8VWQnVzSG3r1rHcSj2DvDeTKmp3F,B6aMfucYPbCzWBtauLtgTpwR45wKSK8yqscHJR3F5usu,True,223834897,55958724,349491,174745,174746,3zqXX6kzhkbW3d4TwD2CNjMRwxTbREXySekvq37kfCNk,13979640,46272749,-32293109,624
2022-04-11 15:33:23-04:00,15362,68zbVKnneMQqngbNkeLtPEP2ayNhawc1B2hPgqAEqgXK,HqiFpLr4NC7xJz9bEFusq8bCKaoxAQG1xsLxdUAzg8aa,True,2473007716,181928964,1132412,566206,566206,3zqXX6kzhkbW3d4TwD2CNjMRwxTbREXySekvq37kfCNk,153931835,665728050,-511796215,622
2022-04-11 15:33:26-04:00,15363,AKcGcqFMxvVWFHpc9oUJYGZsLN4DUHVkMSLGYrMcCYYN,4dWje79e7kH8GWJwwfB76BQUVUSgnYHTVxrtfNyG5A4K,True,6256596291,896868078,5602348,2801174,2801174,68sueyVfmy5ToEGtLFGDkwebX47xAmzyXE29z8JrmcWv,390822675,1444340784,-1053518109,624
2022-04-11 15:33:28-04:00,15364,4qqThJTwuoaWDtEh4agoqM9EwcJbznzGVJW8nbSsEVdS,Aub7UJXkAGC9gn1XybeW1yjYZ97c3kkWd7wbQpTFsYrG,True,595191917,80581368,501975,250987,250988,68sueyVfmy5ToEGtLFGDkwebX47xAmzyXE29z8JrmcWv,37077001,110002021,-72925020,622
2022-04-11 15:33:51-04:00,15365,5g5EaEMiM2WQcfDpL3R3caYziX9xvGCFs9eVmmQdcgzS,J71CftCqiK1873fkVx9NGc7v7nvRZMYVBkGN3GhSPyeX,True,168055099,42013774,299581,149790,149791,3zqXX6kzhkbW3d4TwD2CNjMRwxTbREXySekvq37kfCNk,11983262,38778947,-26795685,713
2022-04-11 15:33:51-04:00,15366,9WH1YzDrdvZs8aDuFLwQHHXa2e66ZcwdfDi7qXEjQxFy,3Tpc8DqJwg1tTDgk6qH1UhvtwvhXxsp5GRFYMWxa8NKX,True,751481454,187870363,1171718,585859,585859,YQC4EUcgeBi9431viwvzvBbZJW3szeHX4dFmowRDyDw,46868758,228741618,-181872860,623
2022-04-11 15:37:16-04:00,15367,G3ZEAY19iDMjF7P57dgFUZiC4bpeFvMPKShenugL7E2Y,D6nUGgpWkQUZcUKZYawfedX67uqQ9Co1wEwtbHPMtc7X,True,408124591,53101477,331640,165820,165820,YQC4EUcgeBi9431viwvzvBbZJW3szeHX4dFmowRDyDw,25489058,166623379,-141134321,624
2022-04-11 15:37:17-04:00,15368,AX2VRZoWZDfZT4QdwuXUSyRCx4N6B9eHAR75FSmcrVFG,FBgLGmbouri9wCV92UXZaDjwK6fcpjhDDD5NLVWmuRRK,True,1847408186,461852046,2865824,1432912,1432912,YQC4EUcgeBi9431viwvzvBbZJW3szeHX4dFmowRDyDw,114632983,651566816,-536933833,620
2022-04-11 16:06:28-04:00,15369,GRqv7y5n92vQ7bXcBqUng4vaau6w1tQeou953s8kJNwD,Bk75oioYmUzfdpbxDHTFb2nWhJgNqAt8ud1ehem3VVhh,True,963044145,240761036,1497027,748513,748514,YQC4EUcgeBi9431viwvzvBbZJW3szeHX4dFmowRDyDw,59881084,221753528,-161872444,621
2022-04-11 16:06:30-04:00,15370,9eWpSyu71Z6dmx7yTh7WrbVScdrrZN14d5tfmqEGFgXt,2r89PFKSD9zmSp2Wyx4CQ75HAtmUgwhAS2oG5MuYuiV6,True,3778008041,944502010,5855685,2927842,2927843,68sueyVfmy5ToEGtLFGDkwebX47xAmzyXE29z8JrmcWv,234227422,1140039710,-905812288,619
2022-04-11 16:06:40-04:00,15371,BjCNaM7YbE9SjFi7tzi4677zg1fKXGJwtecz2GWwWuhd,6rNsSrKZezQrLb2whToNjnizpnurDXrobHqfEK3QqU1M,True,1506354841,144930884,897811,448905,448906,YQC4EUcgeBi9431viwvzvBbZJW3szeHX4dFmowRDyDw,93315038,433841620,-340526582,619
2022-04-11 16:06:55-04:00,15372,AQr9mVmcXCNQhBVCfx63MwR6c4WqDSC9K2BZqr7N8LCx,CB7TWUaL381ounsLw6neAUaKRxJL9P1HC9uGX5e1Uxod,True,1428303356,92285663,575721,287860,287861,3zqXX6kzhkbW3d4TwD2CNjMRwxTbREXySekvq37kfCNk,89104317,359064859,-269960542,623
2022-04-11 16:07:12-04:00,15373,BSDeCyJsPs6y1pbDVHNq5rs6tdxcrbY3NDjXPBxwRjHz,DjHD3jawBVikzjcQ5dXBRLdUmEeBHKt6JZLhvmjScDku,True,1266932341,148938221,911780,455890,455890,3zqXX6kzhkbW3d4TwD2CNjMRwxTbREXySekvq37kfCNk,77559981,279370577,-201810596,612
2022-04-11 16:07:14-04:00,15374,H9pFRayNBHTAhsbtGyfs1XXUWGxAbw7SgpT1xdrSRWEY,9LNreyXuhgyLCDYViNyA1jUw6h1nv4GmDtTYMoUQBqCG,True,12902088947,837717877,5170677,2585338,2585339,3zqXX6kzhkbW3d4TwD2CNjMRwxTbREXySekvq37kfCNk,796360456,3333540359,-2537179903,617
2022-04-11 16:07:21-04:00,15375,7AizMrxWWr7qfneuXMy6ifL3BVDTAKkuud4PyZFy92kh,GyAWRRfQkVAXtyhVF14vU3kPMr4kG1VyA9FAHdDTr8ud,True,114350179,28587544,178289,89144,89145,A9TwRM1BMxqb8DCC7YNAMV6zPenEJm3HTZBy7wJKK58U,7131594,26671527,-19539933,623
2022-04-11 16:07:23-04:00,15376,7CSCMFa9W52tBDVUbXbc3woAy3GByeA1wPJdp3MgznPa,3447ptuVFu6G8B6N63RmS8mRv4n9PfHneypHLvbeaGLn,True,364940625,38553831,238613,119306,119307,3zqXX6kzhkbW3d4TwD2CNjMRwxTbREXySekvq37kfCNk,22586573,119990871,-97404298,618
2022-04-11 16:07:23-04:00,15377,B6Wc3euMqUf6QjzCqDtNeAEUM7MvADFaiReEq9VYH2Qg,2pzhsqXYd5u7h4xTN8bMS3GbicVnJ6KY3MQn7spSXroA,True,326465925,42374383,263713,131856,131857,3zqXX6kzhkbW3d4TwD2CNjMRwxTbREXySekvq37kfCNk,20317382,55506121,-35188739,622
2022-04-11 16:07:26-04:00,15378,BhhVhLVZkSd3aHDMd6ojTgtJtbgAdMCA9Xj8jL2GMXoL,G8HUQp2yGSw9T6it5ej91cqkd82naca8heji453g2jEH,True,1147244475,157934827,977744,488872,488872,YQC4EUcgeBi9431viwvzvBbZJW3szeHX4dFmowRDyDw,71023776,290173090,-219149314,619
2022-04-11 16:07:34-04:00,15379,HHp8dRc1YMWE93uyLdM98DkUhM8U8zm3JC59chrbbWrk,AdqFuGe28VeAwwjRPZCBGVy5ftf9zNNQkg413i66wyig,True,121404493,30351123,188094,94047,94047,YQC4EUcgeBi9431viwvzvBbZJW3szeHX4dFmowRDyDw,7523781,30422269,-22898488,619
2022-04-11 16:08:06-04:00,15380,6TvTxJWSPeyaTVm8PmarVDzxhbTqnkyoabQTgihXyGMj,62ngTMHaRDFjpvzasDgfmgyJ5T6jS9PmYgy97HCkyQS4,True,18211854,4552963,28229,14114,14115,YQC4EUcgeBi9431viwvzvBbZJW3szeHX4dFmowRDyDw,1129177,3024463,-1895286,620
2022-04-11 16:08:09-04:00,15381,EC8fafqtuQzqbm2TZs3GeuXB9qXomkykrTG1na2rfFpx,A72f7W58h3r8nut45RmqdTk1J31NGYT2sVWMn18dK885,True,21653260,5413315,33657,16828,16829,YQC4EUcgeBi9431viwvzvBbZJW3szeHX4dFmowRDyDw,1346280,5040537,-3694257,621
2022-04-11 16:08:20-04:00,15382,JABfWoDV2wW68XEDANXArYWM7zabdbp5NBVrvzZd3mML,5hYUtd1Uv2pAcrbtSNNVTrRuk8acjmh92mzSm4iz5HJA,True,18788012,2540118,15816,7908,7908,A9TwRM1BMxqb8DCC7YNAMV6zPenEJm3HTZBy7wJKK58U,1169913,5662730,-4492817,622
2022-04-11 16:15:01-04:00,15383,5yPGvUz6JWKjkViGwTCpygJii1rP2xv5yx146ULtBiYq,FMnHUCQWTf1UHu5qVFqUAsWh8aba9EQYTEoiXy55totD,True,53052708,13263177,94643,47321,47322,YQC4EUcgeBi9431viwvzvBbZJW3szeHX4dFmowRDyDw,3785738,9034421,-5248683,713
2022-04-11 16:21:42-04:00,15384,AQr9mVmcXCNQhBVCfx63MwR6c4WqDSC9K2BZqr7N8LCx,CB7TWUaL381ounsLw6neAUaKRxJL9P1HC9uGX5e1Uxod,True,1329804036,90779041,561922,280961,280961,A9TwRM1BMxqb8DCC7YNAMV6zPenEJm3HTZBy7wJKK58U,82314939,346514020,-264199081,619
2022-04-11 16:21:42-04:00,15385,6Rk6wVu6pCDFwEWDbiY8wS93nDghyHP9kzdUEa6eFRRq,B5v7eFjSX6dDt1kt84Uvtqmrn7STbQPMbFMvjH6WGXJg,True,22569663,5642415,31885,15942,15943,68sueyVfmy5ToEGtLFGDkwebX47xAmzyXE29z8JrmcWv,1275407,7162988,-5887581,565
2022-04-11 16:21:42-04:00,15386,BjCNaM7YbE9SjFi7tzi4677zg1fKXGJwtecz2GWwWuhd,6rNsSrKZezQrLb2whToNjnizpnurDXrobHqfEK3QqU1M,True,1353181805,118799170,738993,369496,369497,A9TwRM1BMxqb8DCC7YNAMV6zPenEJm3HTZBy7wJKK58U,84175075,393153102,-308978027,622
2022-04-11 16:21:42-04:00,15387,AKcGcqFMxvVWFHpc9oUJYGZsLN4DUHVkMSLGYrMcCYYN,4dWje79e7kH8GWJwwfB76BQUVUSgnYHTVxrtfNyG5A4K,True,5304352131,667447203,4148981,2074490,2074491,A9TwRM1BMxqb8DCC7YNAMV6zPenEJm3HTZBy7wJKK58U,329728805,1307781325,-978052520,621
2022-04-11 16:21:42-04:00,15388,4qqThJTwuoaWDtEh4agoqM9EwcJbznzGVJW8nbSsEVdS,Aub7UJXkAGC9gn1XybeW1yjYZ97c3kkWd7wbQpTFsYrG,True,509007213,68074270,413985,206992,206993,DQCvC9mR68hJ3tJsUiddh6JwcBJAmntqGJR2nUsEq7yj,30954669,103903428,-72948759,608
2022-04-11 16:21:46-04:00,15389,G3ZEAY19iDMjF7P57dgFUZiC4bpeFvMPKShenugL7E2Y,D6nUGgpWkQUZcUKZYawfedX67uqQ9Co1wEwtbHPMtc7X,True,351834804,47992979,299668,149834,149834,68sueyVfmy5ToEGtLFGDkwebX47xAmzyXE29z8JrmcWv,21968582,149388730,-127420148,624
2022-04-11 16:22:01-04:00,15390,A5NXadGWnFZRoHEn1dKTRjcXgWmfMLMyJdpF4rQPZyRR,ALs3Zfotc4c4A6TFDMbd5GM5whK1dTYSnGrHiMBWmApH,True,651150678,162787141,1011503,505751,505752,68sueyVfmy5ToEGtLFGDkwebX47xAmzyXE29z8JrmcWv,40460284,257298267,-216837983,621
2022-04-11 16:22:24-04:00,15391,5BjBPqumCb9KC82ZNNch3dcRzbpGdRLJneru7o9a1D9R,FuZtBWKktxFu4yoiLVMzxq8fMhQyN8SGzGPz49xs3m6P,True,469097424,63650452,397738,198869,198869,YQC4EUcgeBi9431viwvzvBbZJW3szeHX4dFmowRDyDw,29312964,130525683,-101212719,624
2022-04-11 16:23:20-04:00,15392,EDFNynTdSf9HfMkEuNJUeoeG6guc6zsg7zrmQuoA4Npn,A6DrZZWdZE1TbyXFthYNtyJUZMFhtCtwPqnREn5ECZcs,True,74846691,18711672,114219,57109,57110,68sueyVfmy5ToEGtLFGDkwebX47xAmzyXE29z8JrmcWv,4568760,18623538,-14054778,610
2022-04-11 16:24:16-04:00,15393,AoXamAP5a8TQVU1iASScAtAE6Dh2U6VwXTS2q7ksNfVp,FqffL8e7uWNqnu6ueuYQyKpoFhNxPjoKsR2gBkEgJcAM,True,19423579,4855894,29160,14580,14580,68sueyVfmy5ToEGtLFGDkwebX47xAmzyXE29z8JrmcWv,1166439,6781652,-5615213,600
2022-04-11 16:24:47-04:00,15394,H9pFRayNBHTAhsbtGyfs1XXUWGxAbw7SgpT1xdrSRWEY,9LNreyXuhgyLCDYViNyA1jUw6h1nv4GmDtTYMoUQBqCG,True,12024581965,805247986,5031890,2515945,2515945,YQC4EUcgeBi9431viwvzvBbZJW3szeHX4dFmowRDyDw,751400674,3182989377,-2431588703,624
2022-04-11 16:25:20-04:00,15395,AQr9mVmcXCNQhBVCfx63MwR6c4WqDSC9K2BZqr7N8LCx,CB7TWUaL381ounsLw6neAUaKRxJL9P1HC9uGX5e1Uxod,True,1234290207,88326852,551148,275574,275574,YQC4EUcgeBi9431viwvzvBbZJW3szeHX4dFmowRDyDw,77018229,321465462,-244447233,623
2022-04-11 16:43:15-04:00,15396,BjCNaM7YbE9SjFi7tzi4677zg1fKXGJwtecz2GWwWuhd,6rNsSrKZezQrLb2whToNjnizpnurDXrobHqfEK3QqU1M,True,1227644880,110648640,691288,345644,345644,YQC4EUcgeBi9431viwvzvBbZJW3szeHX4dFmowRDyDw,76698327,375179545,-298481218,624
2022-04-11 16:43:18-04:00,15397,9eWpSyu71Z6dmx7yTh7WrbVScdrrZN14d5tfmqEGFgXt,2r89PFKSD9zmSp2Wyx4CQ75HAtmUgwhAS2oG5MuYuiV6,True,2777266870,694316717,4303314,2151657,2151657,3zqXX6kzhkbW3d4TwD2CNjMRwxTbREXySekvq37kfCNk,172132576,908024255,-735891679,619
2022-04-11 16:45:38-04:00,15398,8qq2gfbca7JXvq4gViBBVT2QAbM4MvBMEQLXgn8UUTvt,3o5jpBVYdFFEYrGRdCUkLrUC85wsuTKgy8iYwnpZyC1B,True,757394385,63328682,394618,197309,197309,68sueyVfmy5ToEGtLFGDkwebX47xAmzyXE29z8JrmcWv,47195327,371829688,-324634361,623
2022-04-11 16:58:25-04:00,15399,DXGapgtgkag6midSCYNhHCNaCqvhUmuSvnVhXxNXBmyt,Csq6W5QkGZL6qE6Z1ERF3bfHtKjnM8hAxiY1YA3rTwSX,True,57442118,14360529,89224,44612,44612,YQC4EUcgeBi9431viwvzvBbZJW3szeHX4dFmowRDyDw,3568971,22318233,-18749262,621
2022-04-11 16:58:33-04:00,15400,BhhVhLVZkSd3aHDMd6ojTgtJtbgAdMCA9Xj8jL2GMXoL,G8HUQp2yGSw9T6it5ej91cqkd82naca8heji453g2jEH,True,980500198,125931840,786499,393249,393250,YQC4EUcgeBi9431viwvzvBbZJW3szeHX4dFmowRDyDw,61236582,255203335,-193966753,624
2022-04-11 17:06:34-04:00,15401,AQr9mVmcXCNQhBVCfx63MwR6c4WqDSC9K2BZqr7N8LCx,CB7TWUaL381ounsLw6neAUaKRxJL9P1HC9uGX5e1Uxod,True,1140804291,82051708,512750,256375,256375,68sueyVfmy5ToEGtLFGDkwebX47xAmzyXE29z8JrmcWv,71290233,306089944,-234799711,624
2022-04-11 17:07:03-04:00,15402,BjCNaM7YbE9SjFi7tzi4677zg1fKXGJwtecz2GWwWuhd,6rNsSrKZezQrLb2whToNjnizpnurDXrobHqfEK3QqU1M,True,1110352825,106163537,662975,331487,331488,3zqXX6kzhkbW3d4TwD2CNjMRwxTbREXySekvq37kfCNk,69339873,344158900,-274819027,624
2022-04-11 17:07:13-04:00,15403,JABfWoDV2wW68XEDANXArYWM7zabdbp5NBVrvzZd3mML,5hYUtd1Uv2pAcrbtSNNVTrRuk8acjmh92mzSm4iz5HJA,True,16099670,2119843,13238,6619,6619,YQC4EUcgeBi9431viwvzvBbZJW3szeHX4dFmowRDyDw,1005432,5108948,-4103516,624
2022-04-11 17:07:13-04:00,15404,6Rk6wVu6pCDFwEWDbiY8wS93nDghyHP9kzdUEa6eFRRq,B5v7eFjSX6dDt1kt84Uvtqmrn7STbQPMbFMvjH6WGXJg,True,16718924,4179731,25879,12939,12940,DQCvC9mR68hJ3tJsUiddh6JwcBJAmntqGJR2nUsEq7yj,1035188,5659203,-4624015,619
2022-04-11 17:07:40-04:00,15405,4qqThJTwuoaWDtEh4agoqM9EwcJbznzGVJW8nbSsEVdS,Aub7UJXkAGC9gn1XybeW1yjYZ97c3kkWd7wbQpTFsYrG,True,437731057,58425209,364704,182352,182352,68sueyVfmy5ToEGtLFGDkwebX47xAmzyXE29z8JrmcWv,27324257,90682689,-63358432,624
2022-04-02 09:12:44-04:00,14382,6qqBmN3Mmy56gXvtBwLUyQwJoh2cYKmMtP61Po9xgxRj,FySpFnWFTZAaYLZ2c8Lb9m89CJxj3ZFMcZTdcwRrEEGH,True,126730169,31682542,197930,98965,98965,3RdfgDvLvsdZG5Cf6hKiKMQMqfidyxHzjYvUx1FZpeHQ,7917223,35279989,-27362766,624
2022-04-02 09:13:00-04:00,14383,84CS9aD3YJABQUpuaKrzQrGDZmHDAT7sGGEVJCr9iWs,Du7MR89dZzrBMidrVXVqbZ71dJ3PthHrcA9G6HyNcSw9,True,86837541,21709385,134784,67392,67392,YQC4EUcgeBi9431viwvzvBbZJW3szeHX4dFmowRDyDw,5391385,17949605,-12558220,620
2022-04-02 09:13:00-04:00,14384,8fSFsWaVRYHg5fdFQFQ89aBTjqsodGyc4sinV5UbWxtc,8evZpC24viqM8NaVFRjR91jLjXHLkW6GYAdywY8h2wys,True,21520405,1853217,11572,5786,5786,3zqXX6kzhkbW3d4TwD2CNjMRwxTbREXySekvq37kfCNk,1343849,7453135,-6109286,624
2022-04-02 09:13:32-04:00,14385,FMdKLXhQEnNJtvM17ZX8jhaeMaSD9UgDuN3Kw7kMrd7K,5pURHYWB5LUGwJmWVBGH8p6oyR9NJvXnZk7uDVoiassv,True,338189577,84547394,528041,264020,264021,YQC4EUcgeBi9431viwvzvBbZJW3szeHX4dFmowRDyDw,21121650,64908767,-43787117,624
2022-04-02 09:22:08-04:00,14386,7yW1M1xeVx4hy3QftnpqdBDRYwamfu3K5i6AEnxgyTWb,7wf7FWS2DYp5RveQAmGNXAEUWPcHziuMLd4hV5LPgxF8,True,83259626,20814906,129692,64846,64846,YQC4EUcgeBi9431viwvzvBbZJW3szeHX4dFmowRDyDw,5187693,8447399,-3259706,623
2022-04-02 09:25:12-04:00,14387,GLXb8fHTTJ5njY9j1TzdSs98ZLfmy1QWwKLVHeiwiHhZ,BKoqP2E4J2CoHMhiDHk9W1LbW1DUNF5wuvFPswwnC1kT,True,3059035114,394470961,2458408,1229204,1229204,YQC4EUcgeBi9431viwvzvBbZJW3szeHX4dFmowRDyDw,190644153,838055933,-647411780,623
2022-04-02 09:26:05-04:00,14388,2f5wSFQfcN5ogh4Ln9d7EeyzAVdmZ64NsB56mtoNFMst,9JhD3JQmGDxefbeZaw1Ynw1uwL3hdVaicyZH6RjL9Mi6,True,2286035061,316973364,1979336,989668,989668,3zqXX6kzhkbW3d4TwD2CNjMRwxTbREXySekvq37kfCNk,142751222,558720468,-415969246,624
2022-04-02 09:29:54-04:00,14389,6yjPfkAHVeT6pnwwa2iAGnAvmHZc1nirWw1ByjesoTHD,9MwcpCovRfMMbCf1z3PsoqhNY4RmgYXU385bKWFwqMuC,True,79253525,19813381,123700,61850,61850,YQC4EUcgeBi9431viwvzvBbZJW3szeHX4dFmowRDyDw,4948003,27651168,-22703165,624
2022-04-02 09:30:40-04:00,14390,Hya9U3Ao61oebVBPEnUiqinqvpzTguAZhbAWDmEQpm3a,FdYMMqoYPe5Jgj8R2ovKVUKxRPK1xppR59XRGPdvHRAx,True,18790982,4697745,29256,14628,14628,YQC4EUcgeBi9431viwvzvBbZJW3szeHX4dFmowRDyDw,1170267,8695339,-7525072,622
2022-04-02 09:30:55-04:00,14391,3bprArD4auGxKGrBunvBCC65h8AuF42EqRHagn7azHZE,9Zerp7yNQC88vhmu8gsLGbP2kNN8KF2gzCPqVe1MmHTu,True,790791651,197697912,1233265,616632,616633,3zqXX6kzhkbW3d4TwD2CNjMRwxTbREXySekvq37kfCNk,49330633,146307705,-96977072,623
2022-04-02 09:31:36-04:00,14392,J1GAxgxftvYFrwMwjQN2dEG9tBzKmP9tuCrSwAhLvPf7,E4xChajb4ScoVfjaQsDuD9NQ3x3jryNQ5ksJ8UTWUfyb,True,26223572576,3982922195,24886176,12443088,12443088,3zqXX6kzhkbW3d4TwD2CNjMRwxTbREXySekvq37kfCNk,1638506669,11739274696,-10100768027,624
2022-04-02 09:32:10-04:00,14393,5seV37JfFeqX91yaDfiupi2Ms7yYuuZFHwZ42ovhTbdU,KqBKpYuGWPhC8iYvedTYb4k5Lu3y89UMxt46t8gvn6h,True,29022086,7255521,44744,22372,22372,YQC4EUcgeBi9431viwvzvBbZJW3szeHX4dFmowRDyDw,1789793,10581728,-8791935,616
2022-04-02 09:32:13-04:00,14394,54rcQUxBXFfoNq8n9RxsxH1Lp4VHR2CfE71vCCVy6rPQ,4exavmUP5CfqEmqVusSNuW9Ha2rhPBAy2gg6rP2d5tvu,True,53059621,13264905,82368,41184,41184,YQC4EUcgeBi9431viwvzvBbZJW3szeHX4dFmowRDyDw,3294737,24935091,-21640354,620
2022-04-02 09:32:22-04:00,14395,8fSFsWaVRYHg5fdFQFQ89aBTjqsodGyc4sinV5UbWxtc,8evZpC24viqM8NaVFRjR91jLjXHLkW6GYAdywY8h2wys,True,19766409,1560777,9736,4868,4868,YQC4EUcgeBi9431viwvzvBbZJW3szeHX4dFmowRDyDw,1233056,6781677,-5548621,623
2022-04-02 09:32:24-04:00,14396,HhU3H9e4SDu2n1FobL8gxS1pg3ayQBFQ84psbLqdcUw2,H1Z7WqJXn3T16xSFUQGpthMmvSbQNBkbhk1qbufChW3x,True,768504406,192126101,1198974,599487,599487,3zqXX6kzhkbW3d4TwD2CNjMRwxTbREXySekvq37kfCNk,47958965,206379970,-158421005,624
2022-04-02 09:33:00-04:00,14397,DmrkajG3SrTXnYSYxGRfkzfvhkevD6RdtFk4SdLC2G6Q,5r7vkWH985E2mGSDBtznduhuu5PbZJ7d4zxjzhzEEZG1,True,4245649668,592158629,3690990,1845495,1845495,YQC4EUcgeBi9431viwvzvBbZJW3szeHX4dFmowRDyDw,264636072,622052434,-357416362,623
2022-04-02 09:34:15-04:00,14398,niCk6QHFU1kyU56Mdq5RJzKrecdkNSn23ZA6wduFdWS,BQbUYSw1XsuE6LnVd4XjmxAyYgx4drE4FsetJBCdwVZW,True,17139384,2256373,14018,7009,7009,YQC4EUcgeBi9431viwvzvBbZJW3szeHX4dFmowRDyDw,1064898,3130643,-2065745,621
2022-04-02 09:34:15-04:00,14399,AFYRpYG4Nm818mSXVrBX9SScLSHfe9VJynGZUgvBsgMc,5zbZnbBHauM6tKDJFhDdgTKVkhAgZ4V5WSyTDLUX2Mqs,True,29709638,7427409,45645,22822,22823,YQC4EUcgeBi9431viwvzvBbZJW3szeHX4dFmowRDyDw,1825826,11513047,-9687221,614
2022-04-02 09:34:17-04:00,14400,AT4qoJDVGXpEm3BGACUhC1zpVNLq4iX2bJ4cpABehpoD,AqaDPXbaY6ksVQwWGKorgBdRQMz3VpqxmHdWXmq17ScF,True,147383709,36845927,226809,113404,113405,YQC4EUcgeBi9431viwvzvBbZJW3szeHX4dFmowRDyDw,9072377,67460004,-58387627,615
2022-04-02 09:34:57-04:00,14401,H7wVZszBQdmFuwMUYAw4SSYbjxeFY1QvNBuT8QiqTxZS,CUm235keNKnVd2BaCNp5a6HePtWGMo8dq8S1KXf2KRR4,True,18532732,4633183,28670,14335,14335,3RdfgDvLvsdZG5Cf6hKiKMQMqfidyxHzjYvUx1FZpeHQ,1146818,2687283,-1540465,618
2022-04-02 09:35:32-04:00,14402,CVjkHr29t8pzeXU1U1CdMpT6qwf9Jw4XGxvxU7RURPYj,D66Zpxp7q4Tn4KiLa2pHTrADhgtP8tGqNXVPyCo9mcxc,True,492787381,63754540,397913,198956,198957,YQC4EUcgeBi9431viwvzvBbZJW3szeHX4dFmowRDyDw,30756544,100390231,-69633687,624
2022-04-02 09:35:37-04:00,14403,6qqBmN3Mmy56gXvtBwLUyQwJoh2cYKmMtP61Po9xgxRj,FySpFnWFTZAaYLZ2c8Lb9m89CJxj3ZFMcZTdcwRrEEGH,True,96726206,24181551,151017,75508,75509,YQC4EUcgeBi9431viwvzvBbZJW3szeHX4dFmowRDyDw,6040714,28241448,-22200734,624
2022-04-02 09:35:46-04:00,14404,84CS9aD3YJABQUpuaKrzQrGDZmHDAT7sGGEVJCr9iWs,Du7MR89dZzrBMidrVXVqbZ71dJ3PthHrcA9G6HyNcSw9,True,66247406,16561851,103433,51716,51717,YQC4EUcgeBi9431viwvzvBbZJW3szeHX4dFmowRDyDw,4137351,14675307,-10537956,624
2022-04-02 09:35:53-04:00,14405,GLXb8fHTTJ5njY9j1TzdSs98ZLfmy1QWwKLVHeiwiHhZ,BKoqP2E4J2CoHMhiDHk9W1LbW1DUNF5wuvFPswwnC1kT,True,2685081845,375418597,2344274,1172137,1172137,3RdfgDvLvsdZG5Cf6hKiKMQMqfidyxHzjYvUx1FZpeHQ,167668053,796296499,-628628446,624
2022-04-02 09:36:11-04:00,14406,FMdKLXhQEnNJtvM17ZX8jhaeMaSD9UgDuN3Kw7kMrd7K,5pURHYWB5LUGwJmWVBGH8p6oyR9NJvXnZk7uDVoiassv,True,258107455,64526863,403208,201604,201604,YQC4EUcgeBi9431viwvzvBbZJW3szeHX4dFmowRDyDw,16128337,53434586,-37306249,624
2022-04-02 12:08:44-04:00,14407,74MzhjMjDLChEL9RWjUtb6Ztm7Qmq15MUkrbgAiJ8mgK,EY6caxTDF9WQWa7c9ZJCqL92EDcVMcLaSnHhWXvNW6nA,True,59687600,14921900,92397,46198,46199,YQC4EUcgeBi9431viwvzvBbZJW3szeHX4dFmowRDyDw,3695891,15416419,-11720528,619
2022-04-02 14:09:04-04:00,14408,3uUdWwgwtFdPa3FJTSrirqPKMtQb3zmT5Wpp4zPy9sJP,5G7dhz8jvWekGy9Wh3ZCXNXSPbB1QArfFYs7MYNgRDkW,True,2787977292,696994323,4354669,2177334,2177335,3zqXX6kzhkbW3d4TwD2CNjMRwxTbREXySekvq37kfCNk,174186782,288804973,-114618191,624
2022-04-02 18:17:50-04:00,14409,74MzhjMjDLChEL9RWjUtb6Ztm7Qmq15MUkrbgAiJ8mgK,EY6caxTDF9WQWa7c9ZJCqL92EDcVMcLaSnHhWXvNW6nA,True,45517085,11379271,70997,35498,35499,3zqXX6kzhkbW3d4TwD2CNjMRwxTbREXySekvq37kfCNk,2839890,12381687,-9541797,623
2022-04-02 19:09:09-04:00,14410,63RJUGNb2mPuiVvqCacwZ9BDvnqoPuBFbogvHNZukUSW,FyLe7q7PNK9VjdVv2xJyT4q9Wwj5BikVu3xhBirYPhVS,True,5613665854,1403416463,9931422,4965711,4965711,YQC4EUcgeBi9431viwvzvBbZJW3szeHX4dFmowRDyDw,397256893,753693988,-356437095,707
2022-04-02 19:29:54-04:00,14411,6Rk6wVu6pCDFwEWDbiY8wS93nDghyHP9kzdUEa6eFRRq,B5v7eFjSX6dDt1kt84Uvtqmrn7STbQPMbFMvjH6WGXJg,True,396385358,86776381,541206,270603,270603,3zqXX6kzhkbW3d4TwD2CNjMRwxTbREXySekvq37kfCNk,24721770,41231461,-16509691,623
2022-04-02 19:41:41-04:00,14412,APkYocxQ6tyDDnBtJ2Q5Uss6dfdyRD9QNj6CRKK6Wd89,51JqAwqsEgCTUBK3BqJVQKSabipGYGVgkjhFvSzo6v74,True,94059785,23514946,167658,83829,83829,3zqXX6kzhkbW3d4TwD2CNjMRwxTbREXySekvq37kfCNk,6706322,9596643,-2890321,712
2022-04-02 19:48:06-04:00,14413,7fKMVJH9YcTX8mFB4g3K27MvMvTjgno36tRMqAboGM9T,He9yWYM9bcc7Ni8B4XYuboJPbrTyazs5C92HoZm2ejxy,True,769146027,192286506,1195759,597879,597880,3zqXX6kzhkbW3d4TwD2CNjMRwxTbREXySekvq37kfCNk,47830376,79623522,-31793146,621
2022-04-02 19:49:13-04:00,14414,4ue8S7izJAMVKLrioQiTQb4AbLexsbYyvDF5fcV6ycQR,57m6mmGfpvP7vNNzw9fNeNkaEk2W7jYRF22ux61PTdty,True,137090914,34272728,213679,106839,106840,YQC4EUcgeBi9431viwvzvBbZJW3szeHX4dFmowRDyDw,8547173,14135959,-5588786,623
2022-04-02 19:49:45-04:00,14415,3uUdWwgwtFdPa3FJTSrirqPKMtQb3zmT5Wpp4zPy9sJP,5G7dhz8jvWekGy9Wh3ZCXNXSPbB1QArfFYs7MYNgRDkW,True,2049147777,512286944,3201295,1600647,1600648,3zqXX6kzhkbW3d4TwD2CNjMRwxTbREXySekvq37kfCNk,128051802,255912802,-127861000,624
2022-04-02 19:56:04-04:00,14416,6Auz7aARPERW9zbV8428yFUWkA9DuitQYiWQzewueU3o,G1xfLGt5twz7MTfEq6NnMZBpr6GmXceKdGUQkc9jugRB,True,238863693,59715923,373140,186570,186570,3zqXX6kzhkbW3d4TwD2CNjMRwxTbREXySekvq37kfCNk,14925634,24777332,-9851698,624
2022-04-02 21:14:11-04:00,14417,AUEU926CvNMZ4cVLmnkif7auWEHjoLTGdJ7RTYnSTWtk,HCgu9BWTQYkQx1xb4de9T3BtCLsHhynSzzbcoJmreBxD,True,441569990,110392497,689225,344612,344613,3zqXX6kzhkbW3d4TwD2CNjMRwxTbREXySekvq37kfCNk,27569035,45538841,-17969806,624
2022-04-02 21:21:42-04:00,14418,CZ1snuuBhno2SqfAmMLzEEQhrsH2reAmZrGhFVsydvHD,F4Hj3jxxE8W8TbgpvjRLnrQ1Jdd28ZKTPNyu1h9BnLiH,True,4324176008,1081044002,6746427,3373213,3373214,3zqXX6kzhkbW3d4TwD2CNjMRwxTbREXySekvq37kfCNk,269857113,445492841,-175635728,624
2022-04-02 21:21:55-04:00,14419,FU7X4DWnGTbxwXULBq3v9SACzYhQyFGqsXjUDzyFqiem,925BaEnWxTfEv4oQb9Xf1wyyEEWEr8kXeSdXTtRfShfw,True,124816195975,11370858225,71012771,35506385,35506386,3zqXX6kzhkbW3d4TwD2CNjMRwxTbREXySekvq37kfCNk,7794964821,7714458459,80506362,624
2022-04-02 21:22:25-04:00,14420,8nFpzAFXELGPsrgFwRjTfUidNme1CvgKQTsHWATtMqkz,ABt8ikXHraZ1bqkDUvMtJ3AUzADDWcCL8kMMDpAoth8V,True,400852280,100213070,626118,313059,313059,3zqXX6kzhkbW3d4TwD2CNjMRwxTbREXySekvq37kfCNk,25044750,41302970,-16258220,624
2022-04-03 01:34:37-04:00,14421,29JVska5UEG3axs63EmtHpPvkswNEqYpZ3PKMSfupiAG,DCftNBUsuogxyaJe9G9m3eWipH6o3qo4Rn4TuQXdVaBF,True,199420658,49855164,309229,154614,154615,3zqXX6kzhkbW3d4TwD2CNjMRwxTbREXySekvq37kfCNk,12369191,21593407,-9224216,620
2022-04-03 02:34:11-04:00,14422,6Rk6wVu6pCDFwEWDbiY8wS93nDghyHP9kzdUEa6eFRRq,B5v7eFjSX6dDt1kt84Uvtqmrn7STbQPMbFMvjH6WGXJg,True,337169558,71850693,446295,223147,223148,3zqXX6kzhkbW3d4TwD2CNjMRwxTbREXySekvq37kfCNk,20943077,36254847,-15311770,621
2022-04-03 02:34:14-04:00,14423,6eG79A3rpgHtLxUV85npfsYYhQNa3AhbBx8pYs7FQ4ic,8Prjuk5w1quKtSwZXqPwNuRF5FLewKhEBAcG3qQM2gKf,True,55267196,13816799,85872,42936,42936,YQC4EUcgeBi9431viwvzvBbZJW3szeHX4dFmowRDyDw,3434887,17804184,-14369297,621
2022-04-03 02:35:04-04:00,14424,74MzhjMjDLChEL9RWjUtb6Ztm7Qmq15MUkrbgAiJ8mgK,EY6caxTDF9WQWa7c9ZJCqL92EDcVMcLaSnHhWXvNW6nA,True,34741427,8685356,53750,26875,26875,YQC4EUcgeBi9431viwvzvBbZJW3szeHX4dFmowRDyDw,2150022,9909992,-7759970,618
2022-04-03 05:46:00-04:00,14425,8ayr4AZAcNN17UCJUXe5VJtaj6ziTmGpER4fpHGpdbiT,uRK1KLx2bX5xGSAkviLApXew2aT9ar4ATb24yu7ELRR,True,109856718,27464179,170432,85216,85216,3zqXX6kzhkbW3d4TwD2CNjMRwxTbREXySekvq37kfCNk,6817318,10513695,-3696377,620
2022-04-03 13:23:04-04:00,14426,Gw37fsD8M3AaZ22tSx9WeszxsAkWQ6Ap2XV3zXYhe3EJ,FbKeJsWR5ggVBy1R5sxNiWz5GAsxeyZD8nmyk5yCBqSz,True,306658739,76664684,538467,269233,269234,YQC4EUcgeBi9431viwvzvBbZJW3szeHX4dFmowRDyDw,21538697,61133798,-39595101,702
2022-04-03 13:23:58-04:00,14427,F2AU2PjaSmHxWWhkz8XxMggkCMWbMVgawt89tSnYS6RL,ET9febRJiW197DYMaJbgk3kWsAeFv5f4peQ4vFCVppK6,True,135508952,33877238,240947,120473,120474,YQC4EUcgeBi9431viwvzvBbZJW3szeHX4dFmowRDyDw,9637894,30548835,-20910941,711
2022-04-03 13:24:10-04:00,14428,63RJUGNb2mPuiVvqCacwZ9BDvnqoPuBFbogvHNZukUSW,FyLe7q7PNK9VjdVv2xJyT4q9Wwj5BikVu3xhBirYPhVS,True,4116566043,1029141510,7278979,3639489,3639490,3zqXX6kzhkbW3d4TwD2CNjMRwxTbREXySekvq37kfCNk,291159174,655297175,-364138001,707
2022-04-03 13:24:13-04:00,14429,AyFWvQUX79sq8L7KhcYrPRbxd6whUvEMETZL8atuuRr2,9LTjofdhGLn2Ltv6XfuHtX8MKEPzScGL669pC8Lrgtnh,True,115830201,22156978,152168,76084,76084,YQC4EUcgeBi9431viwvzvBbZJW3szeHX4dFmowRDyDw,7954959,19610572,-11655613,686
2022-04-03 13:24:13-04:00,14430,GCweck6iuscBsVbXW9ZYfMytdgwSYWwNifTWLaUbaSmA,6HwGWKGduMGvLnHmTJo6ZioZ3EMUZYHo2pG4tBFXgB4Y,True,199489635,49872408,354716,177358,177358,3zqXX6kzhkbW3d4TwD2CNjMRwxTbREXySekvq37kfCNk,14188662,44938324,-30749662,711
2022-04-03 13:28:33-04:00,14431,EHLV9s6E1s5SUbzZVzsGWH2vVRGHyxynM4GDJtfKEuYe,4hAx9osegpeocSSmJbMVBYMKCwo5WY3QVJuK7cuzz4b4,True,199442838,49860709,354083,177041,177042,3zqXX6kzhkbW3d4TwD2CNjMRwxTbREXySekvq37kfCNk,14163347,44960469,-30797122,710
2022-04-03 13:28:37-04:00,14432,5qY8ZrqpHPqkAuXp6HpE2zC8qTfzsP8MXWSoxkZQV5jx,GPs3ap45TuHwHwmDb5bnKYHLBa5wj3AyuEsXcfHjEcAL,True,90173829,22543457,159743,79871,79872,YQC4EUcgeBi9431viwvzvBbZJW3szeHX4dFmowRDyDw,6389740,15565347,-9175607,708
2022-04-03 13:28:37-04:00,14433,APkYocxQ6tyDDnBtJ2Q5Uss6dfdyRD9QNj6CRKK6Wd89,51JqAwqsEgCTUBK3BqJVQKSabipGYGVgkjhFvSzo6v74,True,68923551,17230887,121893,60946,60947,YQC4EUcgeBi9431viwvzvBbZJW3szeHX4dFmowRDyDw,4875726,8665608,-3789882,707
2022-04-03 13:28:39-04:00,14434,3hEe6AXGjjVzWnsadNZHfeB6CGg8nKSLyhtyqgBtVivt,6Qdu667ChFcRT7J5QHQzUsWpLmxmNvywAaevseSXqxPZ,True,16024799,4006199,28402,14201,14201,YQC4EUcgeBi9431viwvzvBbZJW3szeHX4dFmowRDyDw,1136119,3563611,-2427492,708
2022-04-03 13:29:52-04:00,14435,Gw37fsD8M3AaZ22tSx9WeszxsAkWQ6Ap2XV3zXYhe3EJ,FbKeJsWR5ggVBy1R5sxNiWz5GAsxeyZD8nmyk5yCBqSz,True,224326297,56081574,383311,191655,191656,3zqXX6kzhkbW3d4TwD2CNjMRwxTbREXySekvq37kfCNk,15332472,50706513,-35374041,683
2022-04-03 13:30:25-04:00,14436,5nALef7nAfNkSQSuTBLwewDby4pUx74Gzqib33Znmmt6,8xNTWK2xNK2xZPpgXfcE4QxPT2i6YvNYakiLgdQ2FqEt,True,1581181258,395295314,2462971,1231485,1231486,3zqXX6kzhkbW3d4TwD2CNjMRwxTbREXySekvq37kfCNk,98518859,143403442,-44884583,623
2022-04-03 18:24:44-04:00,14437,GTzLxRn226vTjN4HTSDSCjDLjwNiP4jsarG4umsA4CPc,6BWii3HLmdacnSS1pe8RkbbN6kbe4jpYYbnHqM1hh2G5,True,290542475,72635618,439523,219761,219762,3zqXX6kzhkbW3d4TwD2CNjMRwxTbREXySekvq37kfCNk,17580949,37538509,-19957560,605
2022-04-04 05:54:24-04:00,14438,F2AU2PjaSmHxWWhkz8XxMggkCMWbMVgawt89tSnYS6RL,ET9febRJiW197DYMaJbgk3kWsAeFv5f4peQ4vFCVppK6,True,99331816,24832954,176488,88244,88244,YQC4EUcgeBi9431viwvzvBbZJW3szeHX4dFmowRDyDw,7059527,25044628,-17985101,710
2022-04-04 06:04:09-04:00,14439,4rLtMQSN7dkQMAB1RiQwtQepNcvrpsGgshMmzpDNa5ta,ESnuS85iexRfPoCGQSHKxMB28FoDNc4sPwnWSC9RvKKs,True,28011457,7002864,49305,24652,24653,YQC4EUcgeBi9431viwvzvBbZJW3szeHX4dFmowRDyDw,1972213,3953698,-1981485,704
2022-04-04 06:04:09-04:00,14440,63RJUGNb2mPuiVvqCacwZ9BDvnqoPuBFbogvHNZukUSW,FyLe7q7PNK9VjdVv2xJyT4q9Wwj5BikVu3xhBirYPhVS,True,3019315999,754828999,5366197,2683098,2683099,3zqXX6kzhkbW3d4TwD2CNjMRwxTbREXySekvq37kfCNk,214647887,557601224,-342953337,710
2022-04-04 06:04:12-04:00,14441,GCweck6iuscBsVbXW9ZYfMytdgwSYWwNifTWLaUbaSmA,6HwGWKGduMGvLnHmTJo6ZioZ3EMUZYHo2pG4tBFXgB4Y,True,146212440,36553110,259369,129684,129685,YQC4EUcgeBi9431viwvzvBbZJW3szeHX4dFmowRDyDw,10374778,36846148,-26471370,709
2022-04-04 06:38:29-04:00,14442,EHLV9s6E1s5SUbzZVzsGWH2vVRGHyxynM4GDJtfKEuYe,4hAx9osegpeocSSmJbMVBYMKCwo5WY3QVJuK7cuzz4b4,True,146147620,36536905,258007,129003,129004,3zqXX6kzhkbW3d4TwD2CNjMRwxTbREXySekvq37kfCNk,10320307,36856996,-26536689,706
2022-04-04 06:39:13-04:00,14443,APkYocxQ6tyDDnBtJ2Q5Uss6dfdyRD9QNj6CRKK6Wd89,51JqAwqsEgCTUBK3BqJVQKSabipGYGVgkjhFvSzo6v74,True,50545415,12636353,89693,44846,44847,YQC4EUcgeBi9431viwvzvBbZJW3szeHX4dFmowRDyDw,3587743,7577878,-3990135,709
2022-04-04 06:39:16-04:00,14444,3hEe6AXGjjVzWnsadNZHfeB6CGg8nKSLyhtyqgBtVivt,6Qdu667ChFcRT7J5QHQzUsWpLmxmNvywAaevseSXqxPZ,False,11731445,11731445,816182,40809,775373,YQC4EUcgeBi9431viwvzvBbZJW3szeHX4dFmowRDyDw,816182,2923985,-2107803,695
2022-04-04 06:39:18-04:00,14445,5qY8ZrqpHPqkAuXp6HpE2zC8qTfzsP8MXWSoxkZQV5jx,GPs3ap45TuHwHwmDb5bnKYHLBa5wj3AyuEsXcfHjEcAL,True,66012328,16503082,114682,57341,57341,3zqXX6kzhkbW3d4TwD2CNjMRwxTbREXySekvq37kfCNk,4587303,13087900,-8500597,694
2022-04-04 06:39:30-04:00,14446,Gw37fsD8M3AaZ22tSx9WeszxsAkWQ6Ap2XV3zXYhe3EJ,FbKeJsWR5ggVBy1R5sxNiWz5GAsxeyZD8nmyk5yCBqSz,True,164705036,41176259,283690,141845,141845,3zqXX6kzhkbW3d4TwD2CNjMRwxTbREXySekvq37kfCNk,11347623,41423373,-30075750,688
2022-04-04 06:41:12-04:00,14447,13QjvYYcM5izdJ49PzRWqrw8ZCT3zH818AuTUJhw5Mbz,7Uxmf8a4rpKW1Z163MQygUqmqj2mMqjxih3ppwv3G8ee,True,410191400,102547850,630027,315013,315014,3zqXX6kzhkbW3d4TwD2CNjMRwxTbREXySekvq37kfCNk,25201093,42289436,-17088343,614
2022-04-04 08:45:43-04:00,14448,jLcMvWkdEDweLB1otEdmsnL48kQPF5esSKx5WDzrdei,3VtwkSQaVnPv8MFuyDDj6dGQGnuY5GDUY2wYkBFRkfdF,True,174706906379,43676726594,270831702,135415851,135415851,3zqXX6kzhkbW3d4TwD2CNjMRwxTbREXySekvq37kfCNk,10833268099,19109585136,-8276317037,620
2022-04-04 08:46:21-04:00,14449,6RuQVU9nu2Ecp177M9ggWczLACvQ8PfT31RTcmfwe9Hq,DZgsgqvMNLTXkBxySZC7Monak2JGsXRMJT4hBQzpf6Xm,True,15060105876,2379579293,14871473,7435736,7435737,3zqXX6kzhkbW3d4TwD2CNjMRwxTbREXySekvq37kfCNk,941199845,729173285,212026560,624
2022-04-04 08:48:24-04:00,14450,EYyXFfLaPc2JeUwi2G5WewrK6KNjZnvwg6CCKJYPUvi1,AEz7KTmSsrHmMdeDiFWNioj9zbEucHieMqrqnZY3zTcL,True,677040802,169260200,1200325,600162,600163,3zqXX6kzhkbW3d4TwD2CNjMRwxTbREXySekvq37kfCNk,48013012,73376365,-25363353,709
2022-04-04 08:51:33-04:00,14451,BFWNfNhm4RUFJs3721We8Dyocw1okinoUA3JtHshAHkU,7czPpWxLYgLgAGmvxiKA6zRGQ97FdLVB83FvNqEuKnFj,True,13659758679,3414939669,21325096,10662548,10662548,3zqXX6kzhkbW3d4TwD2CNjMRwxTbREXySekvq37kfCNk,853003874,1537712629,-684708755,624
2022-04-04 09:16:56-04:00,14452,5nALef7nAfNkSQSuTBLwewDby4pUx74Gzqib33Znmmt6,8xNTWK2xNK2xZPpgXfcE4QxPT2i6YvNYakiLgdQ2FqEt,True,1161055546,290263886,1796582,898291,898291,3zqXX6kzhkbW3d4TwD2CNjMRwxTbREXySekvq37kfCNk,71863296,130372348,-58509052,618
2022-04-04 09:17:12-04:00,14453,AiP6Qy3zAqKCVpsoQbNxLJKpEGrWYA2BBWRf3ECcLmSZ,3awK8LVFcHCeSZm25AhuhLzpHYjaaVgDhQba1FGrYCKr,True,1200249663,300062415,1874284,937142,937142,3zqXX6kzhkbW3d4TwD2CNjMRwxTbREXySekvq37kfCNk,74971385,123717936,-48746551,624
2022-04-04 09:32:12-04:00,14454,3uUdWwgwtFdPa3FJTSrirqPKMtQb3zmT5Wpp4zPy9sJP,5G7dhz8jvWekGy9Wh3ZCXNXSPbB1QArfFYs7MYNgRDkW,True,1502676163,375669040,2276718,1138359,1138359,YQC4EUcgeBi9431viwvzvBbZJW3szeHX4dFmowRDyDw,91068724,221183762,-130115038,606
2022-04-04 09:32:15-04:00,14455,6RuQVU9nu2Ecp177M9ggWczLACvQ8PfT31RTcmfwe9Hq,DZgsgqvMNLTXkBxySZC7Monak2JGsXRMJT4hBQzpf6Xm,True,12536519470,1762288037,10998851,5499425,5499426,3zqXX6kzhkbW3d4TwD2CNjMRwxTbREXySekvq37kfCNk,782433512,634582850,147850662,624
2022-04-04 09:32:15-04:00,14456,6Auz7aARPERW9zbV8428yFUWkA9DuitQYiWQzewueU3o,G1xfLGt5twz7MTfEq6NnMZBpr6GmXceKdGUQkc9jugRB,True,176288013,44072003,271564,135782,135782,3zqXX6kzhkbW3d4TwD2CNjMRwxTbREXySekvq37kfCNk,10862599,21988122,-11125523,616
2022-04-04 09:32:15-04:00,14457,5xpiEvfY9hpdUW1c85fQSTBPgVbcrjD5hkmUCYvSF2DR,AhJe4Y7uima7HC8eYfZs7xJZrWth12UczAa2fHyUjfbp,True,4321048561,1080262140,6704400,3352200,3352200,3zqXX6kzhkbW3d4TwD2CNjMRwxTbREXySekvq37kfCNk,268176022,446727791,-178551769,620
2022-04-04 11:03:11-04:00,14458,13QjvYYcM5izdJ49PzRWqrw8ZCT3zH818AuTUJhw5Mbz,7Uxmf8a4rpKW1Z163MQygUqmqj2mMqjxih3ppwv3G8ee,True,301932025,75483006,471363,235681,235682,3zqXX6kzhkbW3d4TwD2CNjMRwxTbREXySekvq37kfCNk,18854540,37383476,-18528936,624
2022-04-04 11:03:30-04:00,14459,8nFpzAFXELGPsrgFwRjTfUidNme1CvgKQTsHWATtMqkz,ABt8ikXHraZ1bqkDUvMtJ3AUzADDWcCL8kMMDpAoth8V,True,333573555,83393388,520611,260305,260306,3zqXX6kzhkbW3d4TwD2CNjMRwxTbREXySekvq37kfCNk,20824448,34475987,-13651539,624
2022-04-04 11:04:58-04:00,14460,D85pWm1LS9MvtR4f3QhkFLvNUhZLQ2NZBFQTyAVnmigm,CRN85DYkJJi6irhtVAf4qcJU3ijVodWdXgWe7Fs6Ahka,True,1158826307,289706576,1780343,890171,890172,3zqXX6kzhkbW3d4TwD2CNjMRwxTbREXySekvq37kfCNk,71213751,132548378,-61334627,614
2022-04-04 11:05:10-04:00,14461,29JVska5UEG3axs63EmtHpPvkswNEqYpZ3PKMSfupiAG,DCftNBUsuogxyaJe9G9m3eWipH6o3qo4Rn4TuQXdVaBF,True,123172043,30793010,191275,95637,95638,YQC4EUcgeBi9431viwvzvBbZJW3szeHX4dFmowRDyDw,7651013,13443894,-5792881,621
2022-04-04 11:06:57-04:00,14462,8K1GzGeaAuFdjuVZi6DqBcYiA1zSRioMkRvjotr8p7fz,5mqocPwTdjwAPiJf7vx9bo7AzvfQBT2t5bV9u2Jzb2e1,True,6584663338,1646165834,9747235,4873617,4873618,YQC4EUcgeBi9431viwvzvBbZJW3szeHX4dFmowRDyDw,389889428,295775250,94114178,592
2022-04-04 11:06:58-04:00,14463,AiP6Qy3zAqKCVpsoQbNxLJKpEGrWYA2BBWRf3ECcLmSZ,3awK8LVFcHCeSZm25AhuhLzpHYjaaVgDhQba1FGrYCKr,True,879483897,219870974,1309607,654803,654804,3zqXX6kzhkbW3d4TwD2CNjMRwxTbREXySekvq37kfCNk,52384290,109657468,-57273178,595
2022-04-04 11:09:22-04:00,14464,F2AU2PjaSmHxWWhkz8XxMggkCMWbMVgawt89tSnYS6RL,ET9febRJiW197DYMaJbgk3kWsAeFv5f4peQ4vFCVppK6,True,72745363,18186340,128215,64107,64108,YQC4EUcgeBi9431viwvzvBbZJW3szeHX4dFmowRDyDw,5128601,20372037,-15243436,705
2022-04-04 11:10:36-04:00,14465,4rLtMQSN7dkQMAB1RiQwtQepNcvrpsGgshMmzpDNa5ta,ESnuS85iexRfPoCGQSHKxMB28FoDNc4sPwnWSC9RvKKs,True,20518607,5129651,35812,17906,17906,YQC4EUcgeBi9431viwvzvBbZJW3szeHX4dFmowRDyDw,1432499,3408680,-1976181,698
2022-04-04 11:10:38-04:00,14466,63RJUGNb2mPuiVvqCacwZ9BDvnqoPuBFbogvHNZukUSW,FyLe7q7PNK9VjdVv2xJyT4q9Wwj5BikVu3xhBirYPhVS,True,2211130094,552782523,3896976,1948488,1948488,3zqXX6kzhkbW3d4TwD2CNjMRwxTbREXySekvq37kfCNk,155879050,467420460,-311541410,704
2022-04-04 11:10:46-04:00,14467,APkYocxQ6tyDDnBtJ2Q5Uss6dfdyRD9QNj6CRKK6Wd89,51JqAwqsEgCTUBK3BqJVQKSabipGYGVgkjhFvSzo6v74,True,37023992,9255998,65305,32652,32653,YQC4EUcgeBi9431viwvzvBbZJW3szeHX4dFmowRDyDw,2612214,6490149,-3877935,705
2022-04-04 11:10:49-04:00,14468,5qY8ZrqpHPqkAuXp6HpE2zC8qTfzsP8MXWSoxkZQV5jx,GPs3ap45TuHwHwmDb5bnKYHLBa5wj3AyuEsXcfHjEcAL,True,48439790,12109947,85054,42527,42527,YQC4EUcgeBi9431viwvzvBbZJW3szeHX4dFmowRDyDw,3402163,10847538,-7445375,702
2022-04-04 11:10:53-04:00,14469,GCweck6iuscBsVbXW9ZYfMytdgwSYWwNifTWLaUbaSmA,6HwGWKGduMGvLnHmTJo6ZioZ3EMUZYHo2pG4tBFXgB4Y,True,106854494,26713623,182709,91354,91355,YQC4EUcgeBi9431viwvzvBbZJW3szeHX4dFmowRDyDw,7308361,29969136,-22660775,683
2022-04-04 11:10:53-04:00,14470,H69q3Q8E74xm7swmMQpsJLVp2Q9JuBwBbxraAMX5Drzm,5RiCCwr1YLn1136t6pprm9FAvcrJNG8VA394CYHpYbtA,True,12933057417,3233264354,20143396,10071698,10071698,3zqXX6kzhkbW3d4TwD2CNjMRwxTbREXySekvq37kfCNk,805735875,1506759882,-701024007,623
2022-04-04 11:10:58-04:00,14471,EHLV9s6E1s5SUbzZVzsGWH2vVRGHyxynM4GDJtfKEuYe,4hAx9osegpeocSSmJbMVBYMKCwo5WY3QVJuK7cuzz4b4,True,106878395,26719598,183194,91597,91597,YQC4EUcgeBi9431viwvzvBbZJW3szeHX4dFmowRDyDw,7327765,29965015,-22637250,685
2022-04-04 11:11:21-04:00,14472,67DwuUmzk6uGwmptjYErQssFeJ5fd1ztFwKWZUovr7pK,HKzc15e1QLBrSsbAENyMXSVHDoap1F5MHCHB9L1Dm8HA,True,1277200150,319300037,1986253,993126,993127,3zqXX6kzhkbW3d4TwD2CNjMRwxTbREXySekvq37kfCNk,79450151,131594636,-52144485,622
2022-04-04 11:11:43-04:00,14473,DXGapgtgkag6midSCYNhHCNaCqvhUmuSvnVhXxNXBmyt,Csq6W5QkGZL6qE6Z1ERF3bfHtKjnM8hAxiY1YA3rTwSX,True,3472116787,868029196,5411426,2705713,2705713,YQC4EUcgeBi9431viwvzvBbZJW3szeHX4dFmowRDyDw,216457075,408514541,-192057466,623
2022-04-04 11:11:49-04:00,14474,3uUdWwgwtFdPa3FJTSrirqPKMtQb3zmT5Wpp4zPy9sJP,5G7dhz8jvWekGy9Wh3ZCXNXSPbB1QArfFYs7MYNgRDkW,True,1107184674,276796168,1724110,862055,862055,3zqXX6kzhkbW3d4TwD2CNjMRwxTbREXySekvq37kfCNk,68964416,186392399,-117427983,622
2022-04-04 11:12:56-04:00,14475,13QjvYYcM5izdJ49PzRWqrw8ZCT3zH818AuTUJhw5Mbz,7Uxmf8a4rpKW1Z163MQygUqmqj2mMqjxih3ppwv3G8ee,False,218909399,218909399,10843557,542177,10301380,3zqXX6kzhkbW3d4TwD2CNjMRwxTbREXySekvq37kfCNk,10843557,32280522,-21436965,495
2022-04-04 11:12:59-04:00,14476,2xgQaQTs7bkK34jSBZ2dFZf1DJKjMVW9LA3D9Pwtfims,6rniSBeGcJAcrqWhhnKCcRV58yYnjuqXj9b4Zu8DUwQ9,True,190495895,47061660,286732,143366,143366,3zqXX6kzhkbW3d4TwD2CNjMRwxTbREXySekvq37kfCNk,11606336,19863474,-8257138,609
2022-04-04 11:13:00-04:00,14477,CZ1snuuBhno2SqfAmMLzEEQhrsH2reAmZrGhFVsydvHD,F4Hj3jxxE8W8TbgpvjRLnrQ1Jdd28ZKTPNyu1h9BnLiH,True,3141437945,785359486,4029473,2014736,2014737,YQC4EUcgeBi9431viwvzvBbZJW3szeHX4dFmowRDyDw,161178948,394729064,-233550116,513
2022-04-04 11:13:00-04:00,14478,6eEifGxGRBnXV5EW2BwmCj8pa67znMjet98Nsq11LCsd,Dd4UCEX7tm6Q82SdSSFX9wBcJNw5TwKu8EyGjvxi9FVc,True,1917949621,479487405,2873081,1436540,1436541,YQC4EUcgeBi9431viwvzvBbZJW3szeHX4dFmowRDyDw,114923259,135892579,-20969320,599
2022-04-04 11:13:01-04:00,14479,8nFpzAFXELGPsrgFwRjTfUidNme1CvgKQTsHWATtMqkz,ABt8ikXHraZ1bqkDUvMtJ3AUzADDWcCL8kMMDpAoth8V,True,242905582,60726395,325731,162865,162866,3zqXX6kzhkbW3d4TwD2CNjMRwxTbREXySekvq37kfCNk,13029252,30543262,-17514010,536
2022-04-04 11:13:02-04:00,14480,29JVska5UEG3axs63EmtHpPvkswNEqYpZ3PKMSfupiAG,DCftNBUsuogxyaJe9G9m3eWipH6o3qo4Rn4TuQXdVaBF,True,90016217,22504054,127423,63711,63712,3zqXX6kzhkbW3d4TwD2CNjMRwxTbREXySekvq37kfCNk,5096922,11804505,-6707583,566
2022-04-04 11:13:02-04:00,14481,8K1GzGeaAuFdjuVZi6DqBcYiA1zSRioMkRvjotr8p7fz,5mqocPwTdjwAPiJf7vx9bo7AzvfQBT2t5bV9u2Jzb2e1,True,4859785788,1214946447,7535761,3767880,3767881,YQC4EUcgeBi9431viwvzvBbZJW3szeHX4dFmowRDyDw,301430477,309842486,-8412009,620
2022-04-04 13:40:52-04:00,14482,6Auz7aARPERW9zbV8428yFUWkA9DuitQYiWQzewueU3o,G1xfLGt5twz7MTfEq6NnMZBpr6GmXceKdGUQkc9jugRB,True,129726899,32431724,202530,101265,101265,YQC4EUcgeBi9431viwvzvBbZJW3szeHX4dFmowRDyDw,8101217,18934730,-10833513,624
2022-04-04 13:41:11-04:00,14483,Gw37fsD8M3AaZ22tSx9WeszxsAkWQ6Ap2XV3zXYhe3EJ,FbKeJsWR5ggVBy1R5sxNiWz5GAsxeyZD8nmyk5yCBqSz,True,121045641,30261410,215164,107582,107582,YQC4EUcgeBi9431viwvzvBbZJW3szeHX4dFmowRDyDw,8606574,33649602,-25043028,711
2022-04-04 13:41:14-04:00,14484,5xpiEvfY9hpdUW1c85fQSTBPgVbcrjD5hkmUCYvSF2DR,AhJe4Y7uima7HC8eYfZs7xJZrWth12UczAa2fHyUjfbp,True,3177487272,794371818,4953878,2476939,2476939,3zqXX6kzhkbW3d4TwD2CNjMRwxTbREXySekvq37kfCNk,198155130,395520721,-197365591,623
2022-04-04 13:42:44-04:00,14485,eiLMepBYM3VcWarQJC9fTnxotyMuUTbyMGJECedPEfu,k2ZfwPNBBCK7PvZ6MEvELTHHtQZSXCRGCymvkZwhDDt,True,149067259,31793448,197883,98941,98942,YQC4EUcgeBi9431viwvzvBbZJW3szeHX4dFmowRDyDw,9278007,19582497,-10304490,622
2022-04-04 13:42:44-04:00,14486,7yW1M1xeVx4hy3QftnpqdBDRYwamfu3K5i6AEnxgyTWb,7wf7FWS2DYp5RveQAmGNXAEUWPcHziuMLd4hV5LPgxF8,True,76399550,19099887,118501,59250,59251,YQC4EUcgeBi9431viwvzvBbZJW3szeHX4dFmowRDyDw,4740047,8340282,-3600235,620
2022-04-04 13:42:55-04:00,14487,FU7X4DWnGTbxwXULBq3v9SACzYhQyFGqsXjUDzyFqiem,925BaEnWxTfEv4oQb9Xf1wyyEEWEr8kXeSdXTtRfShfw,True,112750952897,11091574079,69019013,34509506,34509507,3zqXX6kzhkbW3d4TwD2CNjMRwxTbREXySekvq37kfCNk,7016100224,7869046502,-852946278,622
2022-04-04 13:43:40-04:00,14488,67DwuUmzk6uGwmptjYErQssFeJ5fd1ztFwKWZUovr7pK,HKzc15e1QLBrSsbAENyMXSVHDoap1F5MHCHB9L1Dm8HA,True,938907872,234726968,1461428,730714,730714,3zqXX6kzhkbW3d4TwD2CNjMRwxTbREXySekvq37kfCNk,58457151,116569126,-58111975,622
2022-04-04 13:43:42-04:00,14489,5zSoXxVZYYQAtq3urfcUQmJkjFDBXkUJYSNFdq759Tof,3C459gJnmj4EYTG3tDFJEEf1aAT915sxRLs2THEdQqha,True,15706714357,1173394743,7290106,3645053,3645053,3zqXX6kzhkbW3d4TwD2CNjMRwxTbREXySekvq37kfCNk,975832024,1364709820,-388877796,621
2022-04-04 13:44:11-04:00,14490,CZ1snuuBhno2SqfAmMLzEEQhrsH2reAmZrGhFVsydvHD,F4Hj3jxxE8W8TbgpvjRLnrQ1Jdd28ZKTPNyu1h9BnLiH,True,2345526020,586381505,3664019,1832009,1832010,3zqXX6kzhkbW3d4TwD2CNjMRwxTbREXySekvq37kfCNk,146560782,332347373,-185786591,624
2022-04-04 13:45:58-04:00,14491,F2AU2PjaSmHxWWhkz8XxMggkCMWbMVgawt89tSnYS6RL,ET9febRJiW197DYMaJbgk3kWsAeFv5f4peQ4vFCVppK6,True,53297202,13324300,93779,46889,46890,YQC4EUcgeBi9431viwvzvBbZJW3szeHX4dFmowRDyDw,3751183,16446199,-12695016,703
2022-04-04 13:49:47-04:00,14492,4rLtMQSN7dkQMAB1RiQwtQepNcvrpsGgshMmzpDNa5ta,ESnuS85iexRfPoCGQSHKxMB28FoDNc4sPwnWSC9RvKKs,True,15063338,3765834,26866,13433,13433,YQC4EUcgeBi9431viwvzvBbZJW3szeHX4dFmowRDyDw,1074640,2882439,-1807799,713
2022-04-04 13:52:05-04:00,14493,SEndYVMCKAeZUKSqGrMUSqXFmxtA9M1t4eXsUhVsTBF,3fcQQcbkpqodakamn82pFnMxBEPL2Drsg4jJNZ6dx72M,True,1919060956,250643889,1652819,826409,826410,3zqXX6kzhkbW3d4TwD2CNjMRwxTbREXySekvq37kfCNk,126548576,302402875,-175854299,659
2022-04-04 14:07:50-04:00,14494,GCweck6iuscBsVbXW9ZYfMytdgwSYWwNifTWLaUbaSmA,6HwGWKGduMGvLnHmTJo6ZioZ3EMUZYHo2pG4tBFXgB4Y,True,78574592,19643648,139450,69725,69725,3zqXX6kzhkbW3d4TwD2CNjMRwxTbREXySekvq37kfCNk,5578030,24141230,-18563200,709
2022-04-04 14:07:57-04:00,14495,FU7X4DWnGTbxwXULBq3v9SACzYhQyFGqsXjUDzyFqiem,925BaEnWxTfEv4oQb9Xf1wyyEEWEr8kXeSdXTtRfShfw,True,101025185785,8465135722,52893080,26446540,26446540,3zqXX6kzhkbW3d4TwD2CNjMRwxTbREXySekvq37kfCNk,6312401179,7674736842,-1362335663,624
2022-04-04 14:08:09-04:00,14496,EHLV9s6E1s5SUbzZVzsGWH2vVRGHyxynM4GDJtfKEuYe,4hAx9osegpeocSSmJbMVBYMKCwo5WY3QVJuK7cuzz4b4,True,78502956,19625739,137685,68842,68843,3zqXX6kzhkbW3d4TwD2CNjMRwxTbREXySekvq37kfCNk,5507410,24142529,-18635119,701
2022-04-04 14:08:09-04:00,14497,63RJUGNb2mPuiVvqCacwZ9BDvnqoPuBFbogvHNZukUSW,FyLe7q7PNK9VjdVv2xJyT4q9Wwj5BikVu3xhBirYPhVS,True,1619927213,404981803,2848687,1424343,1424344,3zqXX6kzhkbW3d4TwD2CNjMRwxTbREXySekvq37kfCNk,113947515,386563177,-272615662,703
2022-04-04 14:08:15-04:00,14498,5qY8ZrqpHPqkAuXp6HpE2zC8qTfzsP8MXWSoxkZQV5jx,GPs3ap45TuHwHwmDb5bnKYHLBa5wj3AyuEsXcfHjEcAL,True,35524364,8881091,63002,31501,31501,3zqXX6kzhkbW3d4TwD2CNjMRwxTbREXySekvq37kfCNk,2520087,8909860,-6389773,709
2022-04-04 14:08:19-04:00,14499,APkYocxQ6tyDDnBtJ2Q5Uss6dfdyRD9QNj6CRKK6Wd89,51JqAwqsEgCTUBK3BqJVQKSabipGYGVgkjhFvSzo6v74,True,27152754,6788188,48453,24226,24227,3zqXX6kzhkbW3d4TwD2CNjMRwxTbREXySekvq37kfCNk,1938133,5461971,-3523838,713
2022-04-04 18:48:22-04:00,14500,5T5GLsPG2F8zjjMuMcyD8cRY6fgGzEyNwM4AuFAD6Pmc,GKVFcaysgYpNqDzFdrYhPKmeLU22qEZ8xAxiVJPPvy8w,True,2163946754,540986688,3360329,1680164,1680165,YQC4EUcgeBi9431viwvzvBbZJW3szeHX4dFmowRDyDw,134413191,204462609,-70049418,621
2022-04-04 18:49:54-04:00,14501,GTzLxRn226vTjN4HTSDSCjDLjwNiP4jsarG4umsA4CPc,6BWii3HLmdacnSS1pe8RkbbN6kbe4jpYYbnHqM1hh2G5,True,283259921,70814980,442099,221049,221050,3zqXX6kzhkbW3d4TwD2CNjMRwxTbREXySekvq37kfCNk,17683973,32069123,-14385150,624
2022-04-04 20:49:55-04:00,14502,6Rk6wVu6pCDFwEWDbiY8wS93nDghyHP9kzdUEa6eFRRq,B5v7eFjSX6dDt1kt84Uvtqmrn7STbQPMbFMvjH6WGXJg,True,301708607,62948872,392889,196444,196445,3zqXX6kzhkbW3d4TwD2CNjMRwxTbREXySekvq37kfCNk,18830916,31610200,-12779284,624
2022-04-04 20:50:50-04:00,14503,7f9TE7GqXHaQPRfC2qjASdDXyoDgeimPtvAxUi36uupJ,7E6mmcAeNged5bsLsDUfu8ZPSL757BAP3h4ya7mK3Zpo,True,57949361,14487340,90522,45261,45261,YQC4EUcgeBi9431viwvzvBbZJW3szeHX4dFmowRDyDw,3620913,18635096,-15014183,624
2022-04-05 07:56:28-04:00,14504,5T5GLsPG2F8zjjMuMcyD8cRY6fgGzEyNwM4AuFAD6Pmc,GKVFcaysgYpNqDzFdrYhPKmeLU22qEZ8xAxiVJPPvy8w,True,1651340202,412835050,2567703,1283851,1283852,YQC4EUcgeBi9431viwvzvBbZJW3szeHX4dFmowRDyDw,102708153,183655326,-80947173,621
2022-04-05 08:30:18-04:00,14505,2Tm69hQroe4dREXCLHubHfDTkDPohvcMEFuALmCpNZw6,4FH8oJspDa4TPVVXgzJzVM1eTHdnNvSf59C1A8m2PXoc,True,745086222,102781204,641450,320725,320725,3zqXX6kzhkbW3d4TwD2CNjMRwxTbREXySekvq37kfCNk,46500338,128302635,-81802297,624
2022-04-05 10:09:15-04:00,14506,niCk6QHFU1kyU56Mdq5RJzKrecdkNSn23ZA6wduFdWS,BQbUYSw1XsuE6LnVd4XjmxAyYgx4drE4FsetJBCdwVZW,True,4008088817,1001897751,6189053,3094526,3094527,3zqXX6kzhkbW3d4TwD2CNjMRwxTbREXySekvq37kfCNk,247592902,419673983,-172081081,617
2022-04-05 12:04:52-04:00,14507,BTwSuuDHNhQAFAzBZRWev5j1ix2RTWvjZAxLpw8grAxu,31NCyUpSXxxJYLSrdK3c5bLomUtMejobMfYnq7j71GtM,True,1692887646,423221911,2636500,1318250,1318250,3zqXX6kzhkbW3d4TwD2CNjMRwxTbREXySekvq37kfCNk,105460031,173424869,-67964838,622
2022-04-05 13:54:03-04:00,14508,niCk6QHFU1kyU56Mdq5RJzKrecdkNSn23ZA6wduFdWS,BQbUYSw1XsuE6LnVd4XjmxAyYgx4drE4FsetJBCdwVZW,True,2944647968,736036690,4482760,2241380,2241380,YQC4EUcgeBi9431viwvzvBbZJW3szeHX4dFmowRDyDw,179340985,370624350,-191283365,609
2022-04-05 14:37:07-04:00,14509,BTwSuuDHNhQAFAzBZRWev5j1ix2RTWvjZAxLpw8grAxu,31NCyUpSXxxJYLSrdK3c5bLomUtMejobMfYnq7j71GtM,True,1240707265,310176816,1842480,921240,921240,YQC4EUcgeBi9431viwvzvBbZJW3szeHX4dFmowRDyDw,73699212,153745176,-80045964,594
2022-04-05 16:40:22-04:00,14510,niCk6QHFU1kyU56Mdq5RJzKrecdkNSn23ZA6wduFdWS,BQbUYSw1XsuE6LnVd4XjmxAyYgx4drE4FsetJBCdwVZW,True,2169336649,542211100,3382119,1691059,1691060,3zqXX6kzhkbW3d4TwD2CNjMRwxTbREXySekvq37kfCNk,135315498,318425946,-183110448,623
2022-04-05 19:52:27-04:00,14511,BTwSuuDHNhQAFAzBZRWev5j1ix2RTWvjZAxLpw8grAxu,31NCyUpSXxxJYLSrdK3c5bLomUtMejobMfYnq7j71GtM,True,913090381,228272595,1358926,679463,679463,3zqXX6kzhkbW3d4TwD2CNjMRwxTbREXySekvq37kfCNk,54357049,131894914,-77537865,595
2022-04-05 19:52:29-04:00,14512,niCk6QHFU1kyU56Mdq5RJzKrecdkNSn23ZA6wduFdWS,BQbUYSw1XsuE6LnVd4XjmxAyYgx4drE4FsetJBCdwVZW,True,1736935701,434113255,2705903,1352951,1352952,3zqXX6kzhkbW3d4TwD2CNjMRwxTbREXySekvq37kfCNk,108266259,269354136,-161087877,623
2022-04-05 19:53:28-04:00,14513,GeYsENPRf2qGZu9rJsi6UPQqHS6sR7LRLWsKbFgtMCSb,7A79wktqPkSpP7o4c1kP9CBpUibHTqycW81ZANgREc5S,True,486866768,121716692,759989,379994,379995,3zqXX6kzhkbW3d4TwD2CNjMRwxTbREXySekvq37kfCNk,30399573,49462538,-19062965,624
2022-04-05 20:08:56-04:00,14514,3uUdWwgwtFdPa3FJTSrirqPKMtQb3zmT5Wpp4zPy9sJP,5G7dhz8jvWekGy9Wh3ZCXNXSPbB1QArfFYs7MYNgRDkW,True,813414180,203353545,1261705,630852,630853,YQC4EUcgeBi9431viwvzvBbZJW3szeHX4dFmowRDyDw,50468213,155524263,-105056050,620
2022-04-05 20:09:39-04:00,14515,5xpiEvfY9hpdUW1c85fQSTBPgVbcrjD5hkmUCYvSF2DR,AhJe4Y7uima7HC8eYfZs7xJZrWth12UczAa2fHyUjfbp,True,2334294570,583573642,3624102,1812051,1812051,3zqXX6kzhkbW3d4TwD2CNjMRwxTbREXySekvq37kfCNk,144964105,341894193,-196930088,621
2022-04-05 20:09:39-04:00,14516,6Auz7aARPERW9zbV8428yFUWkA9DuitQYiWQzewueU3o,G1xfLGt5twz7MTfEq6NnMZBpr6GmXceKdGUQkc9jugRB,True,95209289,23802322,145915,72957,72958,YQC4EUcgeBi9431viwvzvBbZJW3szeHX4dFmowRDyDw,5836608,16047774,-10211166,613
2022-04-05 20:09:46-04:00,14517,5zSoXxVZYYQAtq3urfcUQmJkjFDBXkUJYSNFdq759Tof,3C459gJnmj4EYTG3tDFJEEf1aAT915sxRLs2THEdQqha,True,9422746132,496338542,3079534,1539767,1539767,YQC4EUcgeBi9431viwvzvBbZJW3szeHX4dFmowRDyDw,584634657,1027483734,-442849077,620
2022-04-05 20:10:28-04:00,14518,8nFpzAFXELGPsrgFwRjTfUidNme1CvgKQTsHWATtMqkz,ABt8ikXHraZ1bqkDUvMtJ3AUzADDWcCL8kMMDpAoth8V,True,181568725,45392181,282822,141411,141411,3zqXX6kzhkbW3d4TwD2CNjMRwxTbREXySekvq37kfCNk,11312893,25798359,-14485466,623
2022-04-05 20:13:23-04:00,14519,29JVska5UEG3axs63EmtHpPvkswNEqYpZ3PKMSfupiAG,DCftNBUsuogxyaJe9G9m3eWipH6o3qo4Rn4TuQXdVaBF,True,66722041,16680510,104111,52055,52056,3zqXX6kzhkbW3d4TwD2CNjMRwxTbREXySekvq37kfCNk,4164468,9985337,-5820869,624
2022-04-05 20:13:38-04:00,14520,5zSoXxVZYYQAtq3urfcUQmJkjFDBXkUJYSNFdq759Tof,3C459gJnmj4EYTG3tDFJEEf1aAT915sxRLs2THEdQqha,True,8898585227,471852361,2936198,1468099,1468099,YQC4EUcgeBi9431viwvzvBbZJW3szeHX4dFmowRDyDw,553732760,1021778784,-468046024,622
2022-04-05 20:13:45-04:00,14521,EN2YBXcj7E1eAaYJYXJjc6Rfsu6Awjgv9kN3bT3uiprp,HYDG5mqfCy2xwrYKixNzoWyDiqb9KbpnA8H3TQG2EDDG,True,835185971,208796389,1303095,651547,651548,3zqXX6kzhkbW3d4TwD2CNjMRwxTbREXySekvq37kfCNk,52123865,120783463,-68659598,624
2022-04-05 20:13:54-04:00,14522,DVMLxFACqaNBD7q1TGJUUApJX7etJsxQRRFBP2DfBazJ,4hnRjD7S2KxD7UrgfrApntVxUD7Srh5E9nwPY53v89kz,True,830189069,88807829,585371,292685,292686,YQC4EUcgeBi9431viwvzvBbZJW3szeHX4dFmowRDyDw,54721464,124596944,-69875480,659
2022-04-05 20:14:19-04:00,14523,6eEifGxGRBnXV5EW2BwmCj8pa67znMjet98Nsq11LCsd,Dd4UCEX7tm6Q82SdSSFX9wBcJNw5TwKu8EyGjvxi9FVc,True,1414354073,353588518,2190596,1095298,1095298,3zqXX6kzhkbW3d4TwD2CNjMRwxTbREXySekvq37kfCNk,87623869,127484101,-39860232,619
2022-04-05 20:14:19-04:00,14524,5zSoXxVZYYQAtq3urfcUQmJkjFDBXkUJYSNFdq759Tof,3C459gJnmj4EYTG3tDFJEEf1aAT915sxRLs2THEdQqha,True,8392206209,464036628,2854650,1427325,1427325,3zqXX6kzhkbW3d4TwD2CNjMRwxTbREXySekvq37kfCNk,516269905,996151791,-479881886,615
2022-04-05 20:14:39-04:00,14525,2xgQaQTs7bkK34jSBZ2dFZf1DJKjMVW9LA3D9Pwtfims,6rniSBeGcJAcrqWhhnKCcRV58yYnjuqXj9b4Zu8DUwQ9,True,140846494,34666372,214133,107066,107067,3zqXX6kzhkbW3d4TwD2CNjMRwxTbREXySekvq37kfCNk,8700083,17453615,-8753532,617
2022-04-05 20:14:54-04:00,14526,eiLMepBYM3VcWarQJC9fTnxotyMuUTbyMGJECedPEfu,k2ZfwPNBBCK7PvZ6MEvELTHHtQZSXCRGCymvkZwhDDt,True,115384735,23349435,145271,72635,72636,YQC4EUcgeBi9431viwvzvBbZJW3szeHX4dFmowRDyDw,7178825,16967521,-9788696,622
2022-04-05 20:15:03-04:00,14527,7yW1M1xeVx4hy3QftnpqdBDRYwamfu3K5i6AEnxgyTWb,7wf7FWS2DYp5RveQAmGNXAEUWPcHziuMLd4hV5LPgxF8,True,56055027,14013756,84127,42063,42064,3zqXX6kzhkbW3d4TwD2CNjMRwxTbREXySekvq37kfCNk,3365117,7309971,-3944854,600
2022-04-05 20:15:08-04:00,14528,GeYsENPRf2qGZu9rJsi6UPQqHS6sR7LRLWsKbFgtMCSb,7A79wktqPkSpP7o4c1kP9CBpUibHTqycW81ZANgREc5S,True,357514968,89378742,549649,274824,274825,YQC4EUcgeBi9431viwvzvBbZJW3szeHX4dFmowRDyDw,21985988,43919984,-21933996,614
2022-04-05 20:15:12-04:00,14529,5zSoXxVZYYQAtq3urfcUQmJkjFDBXkUJYSNFdq759Tof,3C459gJnmj4EYTG3tDFJEEf1aAT915sxRLs2THEdQqha,True,7907708351,460044956,2867847,1433923,1433924,3zqXX6kzhkbW3d4TwD2CNjMRwxTbREXySekvq37kfCNk,492954025,960525436,-467571411,623
2022-04-05 20:15:15-04:00,14530,SEndYVMCKAeZUKSqGrMUSqXFmxtA9M1t4eXsUhVsTBF,3fcQQcbkpqodakamn82pFnMxBEPL2Drsg4jJNZ6dx72M,True,1646294572,191897311,1276453,638226,638227,3zqXX6kzhkbW3d4TwD2CNjMRwxTbREXySekvq37kfCNk,109507452,305519518,-196012066,665
2022-04-05 20:15:22-04:00,14531,67DwuUmzk6uGwmptjYErQssFeJ5fd1ztFwKWZUovr7pK,HKzc15e1QLBrSsbAENyMXSVHDoap1F5MHCHB9L1Dm8HA,True,690334271,172583567,1075088,537544,537544,YQC4EUcgeBi9431viwvzvBbZJW3szeHX4dFmowRDyDw,43003544,100440491,-57436947,622
2022-04-05 20:15:35-04:00,14532,CZ1snuuBhno2SqfAmMLzEEQhrsH2reAmZrGhFVsydvHD,F4Hj3jxxE8W8TbgpvjRLnrQ1Jdd28ZKTPNyu1h9BnLiH,True,1722740963,430685240,2653236,1326618,1326618,YQC4EUcgeBi9431viwvzvBbZJW3szeHX4dFmowRDyDw,106129465,281913127,-175783662,616
2022-04-05 20:15:49-04:00,14533,8nFpzAFXELGPsrgFwRjTfUidNme1CvgKQTsHWATtMqkz,ABt8ikXHraZ1bqkDUvMtJ3AUzADDWcCL8kMMDpAoth8V,True,133472990,33368247,208162,104081,104081,YQC4EUcgeBi9431viwvzvBbZJW3szeHX4dFmowRDyDw,8326517,21894412,-13567895,623
2022-04-05 20:19:03-04:00,14534,FU7X4DWnGTbxwXULBq3v9SACzYhQyFGqsXjUDzyFqiem,925BaEnWxTfEv4oQb9Xf1wyyEEWEr8kXeSdXTtRfShfw,True,92008413961,8238940768,51157848,25578924,25578924,YQC4EUcgeBi9431viwvzvBbZJW3szeHX4dFmowRDyDw,5713055464,7733586832,-2020531368,620
2022-04-05 20:19:24-04:00,14535,DVMLxFACqaNBD7q1TGJUUApJX7etJsxQRRFBP2DfBazJ,4hnRjD7S2KxD7UrgfrApntVxUD7Srh5E9nwPY53v89kz,True,735438438,66022966,432648,216324,216324,YQC4EUcgeBi9431viwvzvBbZJW3szeHX4dFmowRDyDw,48193291,112818593,-64625302,655
2022-04-05 20:19:58-04:00,14536,D85pWm1LS9MvtR4f3QhkFLvNUhZLQ2NZBFQTyAVnmigm,CRN85DYkJJi6irhtVAf4qcJU3ijVodWdXgWe7Fs6Ahka,True,1202201193,211785304,1323565,661782,661783,3zqXX6kzhkbW3d4TwD2CNjMRwxTbREXySekvq37kfCNk,75132345,166149341,-91016996,624
2022-04-05 20:20:07-04:00,14537,GRqv7y5n92vQ7bXcBqUng4vaau6w1tQeou953s8kJNwD,Bk75oioYmUzfdpbxDHTFb2nWhJgNqAt8ud1ehem3VVhh,True,6080613567,1520153391,9490723,4745361,4745362,3zqXX6kzhkbW3d4TwD2CNjMRwxTbREXySekvq37kfCNk,379628938,617710493,-238081555,624
2022-04-05 20:20:29-04:00,14538,3uUdWwgwtFdPa3FJTSrirqPKMtQb3zmT5Wpp4zPy9sJP,5G7dhz8jvWekGy9Wh3ZCXNXSPbB1QArfFYs7MYNgRDkW,True,598115728,149528932,931540,465770,465770,YQC4EUcgeBi9431viwvzvBbZJW3szeHX4dFmowRDyDw,37261601,128004523,-90742922,622
2022-04-05 20:20:38-04:00,14539,5zSoXxVZYYQAtq3urfcUQmJkjFDBXkUJYSNFdq759Tof,3C459gJnmj4EYTG3tDFJEEf1aAT915sxRLs2THEdQqha,True,7420288818,449608080,2803649,1401824,1401825,3zqXX6kzhkbW3d4TwD2CNjMRwxTbREXySekvq37kfCNk,462711601,919091146,-456379545,623
2022-04-05 20:21:06-04:00,14540,EBRWnRzoNv5RytEjgrs5TXdiCMApLKHMntJJJzehJJns,5nJiYTa3GEbmaRwY1PvBJ1teXikQKgbUop5ANgaDhhcP,True,105661070,26415267,163284,81642,81642,47z82br5WdW2DZajdnPDPSSRRKsyAggqXqK6oPUwTaLf,6531370,10868839,-4337469,618
2022-04-05 20:21:09-04:00,14541,29JVska5UEG3axs63EmtHpPvkswNEqYpZ3PKMSfupiAG,DCftNBUsuogxyaJe9G9m3eWipH6o3qo4Rn4TuQXdVaBF,True,49017566,12254391,75909,37954,37955,YQC4EUcgeBi9431viwvzvBbZJW3szeHX4dFmowRDyDw,3036392,8426042,-5389650,619
2022-04-05 20:21:11-04:00,14542,FU7X4DWnGTbxwXULBq3v9SACzYhQyFGqsXjUDzyFqiem,925BaEnWxTfEv4oQb9Xf1wyyEEWEr8kXeSdXTtRfShfw,True,83278965726,6275665780,38970123,19485061,19485062,3zqXX6kzhkbW3d4TwD2CNjMRwxTbREXySekvq37kfCNk,5171390149,7488727793,-2317337644,620
2022-04-05 20:21:21-04:00,14543,6Auz7aARPERW9zbV8428yFUWkA9DuitQYiWQzewueU3o,G1xfLGt5twz7MTfEq6NnMZBpr6GmXceKdGUQkc9jugRB,True,70047288,17511822,108275,54137,54138,YQC4EUcgeBi9431viwvzvBbZJW3szeHX4dFmowRDyDw,4331014,13349149,-9018135,618
2022-04-05 20:21:23-04:00,14544,HooxSzasW3HMoFJ6sAvRQ75Char1J5aBdJtsqfDV6myp,BCmsWwpGeV4NNfeKZKKydty2uueLGHYTJDk1WErpXsVT,True,3540241722,885060430,5512948,2756474,2756474,3zqXX6kzhkbW3d4TwD2CNjMRwxTbREXySekvq37kfCNk,220517952,483867271,-263349319,622
2022-04-05 20:21:25-04:00,14545,DVMLxFACqaNBD7q1TGJUUApJX7etJsxQRRFBP2DfBazJ,4hnRjD7S2KxD7UrgfrApntVxUD7Srh5E9nwPY53v89kz,True,663987036,71165220,453710,226855,226855,3zqXX6kzhkbW3d4TwD2CNjMRwxTbREXySekvq37kfCNk,42332207,103402235,-61070028,637
2022-04-05 20:21:31-04:00,14546,8K1GzGeaAuFdjuVZi6DqBcYiA1zSRioMkRvjotr8p7fz,5mqocPwTdjwAPiJf7vx9bo7AzvfQBT2t5bV9u2Jzb2e1,True,2974516188,743629047,4696842,2348421,2348421,3zqXX6kzhkbW3d4TwD2CNjMRwxTbREXySekvq37kfCNk,187873698,306552422,-118678724,631
2022-04-05 20:21:43-04:00,14547,5xpiEvfY9hpdUW1c85fQSTBPgVbcrjD5hkmUCYvSF2DR,AhJe4Y7uima7HC8eYfZs7xJZrWth12UczAa2fHyUjfbp,True,1716665122,429166280,2682104,1341052,1341052,YQC4EUcgeBi9431viwvzvBbZJW3szeHX4dFmowRDyDw,107284197,289084898,-181800701,624
2022-04-05 20:21:51-04:00,14548,5zSoXxVZYYQAtq3urfcUQmJkjFDBXkUJYSNFdq759Tof,3C459gJnmj4EYTG3tDFJEEf1aAT915sxRLs2THEdQqha,True,6941726577,365753011,2270654,1135327,1135327,YQC4EUcgeBi9431viwvzvBbZJW3szeHX4dFmowRDyDw,430953791,888746341,-457792550,620
2022-04-05 20:21:54-04:00,14549,DXGapgtgkag6midSCYNhHCNaCqvhUmuSvnVhXxNXBmyt,Csq6W5QkGZL6qE6Z1ERF3bfHtKjnM8hAxiY1YA3rTwSX,True,2063674389,515918597,3222328,1611164,1611164,YQC4EUcgeBi9431viwvzvBbZJW3szeHX4dFmowRDyDw,128893139,214340767,-85447628,624
2022-04-05 20:23:33-04:00,14550,6eEifGxGRBnXV5EW2BwmCj8pa67znMjet98Nsq11LCsd,Dd4UCEX7tm6Q82SdSSFX9wBcJNw5TwKu8EyGjvxi9FVc,True,1039757992,259939498,1610642,805321,805321,3zqXX6kzhkbW3d4TwD2CNjMRwxTbREXySekvq37kfCNk,64425710,115342447,-50916737,619
2022-04-05 20:23:33-04:00,14551,D85pWm1LS9MvtR4f3QhkFLvNUhZLQ2NZBFQTyAVnmigm,CRN85DYkJJi6irhtVAf4qcJU3ijVodWdXgWe7Fs6Ahka,True,977528037,156394352,974671,487335,487336,3zqXX6kzhkbW3d4TwD2CNjMRwxTbREXySekvq37kfCNk,60920928,147839960,-86919032,623
2022-04-05 20:23:34-04:00,14552,J5q3HYmNhEHPz4DzVGHnSwBAwTqTn8jPwkjCaoQRs9t1,FbgqAegQKWQ8jVVVcJV6okGHgP1fhL2uoJpzfX3mYoH6,True,405833686,101458421,630303,315151,315152,3zqXX6kzhkbW3d4TwD2CNjMRwxTbREXySekvq37kfCNk,25212153,52391335,-27179182,621
2022-04-05 20:23:34-04:00,14553,eiLMepBYM3VcWarQJC9fTnxotyMuUTbyMGJECedPEfu,k2ZfwPNBBCK7PvZ6MEvELTHHtQZSXCRGCymvkZwhDDt,True,90655377,17238194,107503,53751,53752,YQC4EUcgeBi9431viwvzvBbZJW3szeHX4dFmowRDyDw,5653631,14522895,-8869264,623
2022-04-05 20:26:15-04:00,14554,BFWNfNhm4RUFJs3721We8Dyocw1okinoUA3JtHshAHkU,7czPpWxLYgLgAGmvxiKA6zRGQ97FdLVB83FvNqEuKnFj,True,9588085643,2397021410,14937381,7468690,7468691,3zqXX6kzhkbW3d4TwD2CNjMRwxTbREXySekvq37kfCNk,597495276,1365714257,-768218981,623
2022-04-05 21:12:37-04:00,14555,7JbCUyTgV4oLjFST9UUvtJkKpK6F99Pwb1Xe6JT8v7s4,9uYeL9R23XRstddnVE6kohfwCkR41E1GXtyduzc9TwEX,True,32822248102,8205560235,51229860,25614930,25614930,3zqXX6kzhkbW3d4TwD2CNjMRwxTbREXySekvq37kfCNk,2049194911,3367243482,-1318048571,624
2022-04-05 21:43:14-04:00,14556,AUEU926CvNMZ4cVLmnkif7auWEHjoLTGdJ7RTYnSTWtk,HCgu9BWTQYkQx1xb4de9T3BtCLsHhynSzzbcoJmreBxD,True,192478681,48119670,337558,168779,168779,YQC4EUcgeBi9431viwvzvBbZJW3szeHX4dFmowRDyDw,13502336,19669565,-6167229,701
2022-04-05 21:54:05-04:00,14557,8K1GzGeaAuFdjuVZi6DqBcYiA1zSRioMkRvjotr8p7fz,5mqocPwTdjwAPiJf7vx9bo7AzvfQBT2t5bV9u2Jzb2e1,True,1607169402,401792350,2748848,1374424,1374424,YQC4EUcgeBi9431viwvzvBbZJW3szeHX4dFmowRDyDw,109953944,180344974,-70391030,684
2022-04-06 04:12:31-04:00,14558,niCk6QHFU1kyU56Mdq5RJzKrecdkNSn23ZA6wduFdWS,BQbUYSw1XsuE6LnVd4XjmxAyYgx4drE4FsetJBCdwVZW,True,2073641967,518291637,3198353,1599176,1599177,3zqXX6kzhkbW3d4TwD2CNjMRwxTbREXySekvq37kfCNk,127963483,225488655,-97525172,617
2022-04-06 06:05:04-04:00,14559,AUEU926CvNMZ4cVLmnkif7auWEHjoLTGdJ7RTYnSTWtk,HCgu9BWTQYkQx1xb4de9T3BtCLsHhynSzzbcoJmreBxD,True,141084207,35271051,247241,123620,123621,3zqXX6kzhkbW3d4TwD2CNjMRwxTbREXySekvq37kfCNk,9889656,17793272,-7903616,700
2022-04-06 06:12:52-04:00,14560,8K1GzGeaAuFdjuVZi6DqBcYiA1zSRioMkRvjotr8p7fz,5mqocPwTdjwAPiJf7vx9bo7AzvfQBT2t5bV9u2Jzb2e1,True,1182545198,295636299,2109263,1054631,1054632,3zqXX6kzhkbW3d4TwD2CNjMRwxTbREXySekvq37kfCNk,84370559,160235620,-75865061,713
2022-04-06 06:18:28-04:00,14561,5UDGqNpkcMDjByBNi7WYMg8VJ81EzNJu48zsXbW9irSd,FmtUoQNiG25v8sn4pveM6wAWvja9u6FvZ2gdxWHSRjur,True,3751036835,937759208,6393325,3196662,3196663,YQC4EUcgeBi9431viwvzvBbZJW3szeHX4dFmowRDyDw,255733015,643810910,-388077895,681
2022-04-06 06:19:27-04:00,14562,2xgQaQTs7bkK34jSBZ2dFZf1DJKjMVW9LA3D9Pwtfims,6rniSBeGcJAcrqWhhnKCcRV58yYnjuqXj9b4Zu8DUwQ9,True,104125936,25486184,157036,78518,78518,3zqXX6kzhkbW3d4TwD2CNjMRwxTbREXySekvq37kfCNk,6415850,15025075,-8609225,616
2022-04-06 06:59:32-04:00,14563,niCk6QHFU1kyU56Mdq5RJzKrecdkNSn23ZA6wduFdWS,BQbUYSw1XsuE6LnVd4XjmxAyYgx4drE4FsetJBCdwVZW,True,1525871048,381351209,2381279,1190639,1190640,YQC4EUcgeBi9431viwvzvBbZJW3szeHX4dFmowRDyDw,95280313,198088067,-102807754,624
2022-04-06 07:01:40-04:00,14564,7yW1M1xeVx4hy3QftnpqdBDRYwamfu3K5i6AEnxgyTWb,7wf7FWS2DYp5RveQAmGNXAEUWPcHziuMLd4hV5LPgxF8,True,41350148,10337537,64567,32283,32284,A9TwRM1BMxqb8DCC7YNAMV6zPenEJm3HTZBy7wJKK58U,2582685,6232472,-3649787,624
2022-04-06 07:02:55-04:00,14565,5zSoXxVZYYQAtq3urfcUQmJkjFDBXkUJYSNFdq759Tof,3C459gJnmj4EYTG3tDFJEEf1aAT915sxRLs2THEdQqha,True,6557327614,346516151,2165037,1082518,1082519,3zqXX6kzhkbW3d4TwD2CNjMRwxTbREXySekvq37kfCNk,409702681,877660980,-467958299,624
2022-04-06 07:03:00-04:00,14566,GeYsENPRf2qGZu9rJsi6UPQqHS6sR7LRLWsKbFgtMCSb,7A79wktqPkSpP7o4c1kP9CBpUibHTqycW81ZANgREc5S,True,263112749,65778187,409175,204587,204588,3zqXX6kzhkbW3d4TwD2CNjMRwxTbREXySekvq37kfCNk,16367016,37841917,-21474901,622
2022-04-06 07:03:24-04:00,14567,67DwuUmzk6uGwmptjYErQssFeJ5fd1ztFwKWZUovr7pK,HKzc15e1QLBrSsbAENyMXSVHDoap1F5MHCHB9L1Dm8HA,True,507589777,126897444,791972,395986,395986,3zqXX6kzhkbW3d4TwD2CNjMRwxTbREXySekvq37kfCNk,31678896,84921061,-53242165,624
2022-04-06 07:03:59-04:00,14568,5zSoXxVZYYQAtq3urfcUQmJkjFDBXkUJYSNFdq759Tof,3C459gJnmj4EYTG3tDFJEEf1aAT915sxRLs2THEdQqha,True,6189906194,342591555,2139886,1069943,1069943,YQC4EUcgeBi9431viwvzvBbZJW3szeHX4dFmowRDyDw,386632375,849342838,-462710463,624
2022-04-06 07:04:30-04:00,14569,AyFWvQUX79sq8L7KhcYrPRbxd6whUvEMETZL8atuuRr2,9LTjofdhGLn2Ltv6XfuHtX8MKEPzScGL669pC8Lrgtnh,True,60824390,15206097,94552,47276,47276,YQC4EUcgeBi9431viwvzvBbZJW3szeHX4dFmowRDyDw,3782108,8516317,-4734209,621
2022-04-06 07:07:20-04:00,14570,8nFpzAFXELGPsrgFwRjTfUidNme1CvgKQTsHWATtMqkz,ABt8ikXHraZ1bqkDUvMtJ3AUzADDWcCL8kMMDpAoth8V,True,98055678,24513919,151303,75651,75652,A9TwRM1BMxqb8DCC7YNAMV6zPenEJm3HTZBy7wJKK58U,6052126,18277247,-12225121,617
2022-04-06 07:08:08-04:00,14571,A5NXadGWnFZRoHEn1dKTRjcXgWmfMLMyJdpF4rQPZyRR,ALs3Zfotc4c4A6TFDMbd5GM5whK1dTYSnGrHiMBWmApH,True,5586302918,1396575110,8579058,4289529,4289529,3zqXX6kzhkbW3d4TwD2CNjMRwxTbREXySekvq37kfCNk,343162481,1255573240,-912410759,614
2022-04-06 07:08:58-04:00,14572,BAkPsWHtpVcEGqUgKTKjwZ6d5aaUcaUhdgYxBnpSTDW2,BDwDmVaZnXh22sf8nsDtjVfgxMAswbM3PW3si3k4nbRK,True,677292338,169323084,1057502,528751,528751,YQC4EUcgeBi9431viwvzvBbZJW3szeHX4dFmowRDyDw,42300119,118968417,-76668298,624
2022-04-06 07:09:02-04:00,14573,FV9CBGGTbppLnBKh79f2LzD1diTiS5g6u89FcpZHZmnK,Fe7mtmCUziFqbbYTvrhAcAq1Ub7YLfTJRtQ1hG7GzJD1,True,68274852,17068713,106677,53338,53339,YQC4EUcgeBi9431viwvzvBbZJW3szeHX4dFmowRDyDw,4267084,7032214,-2765130,624
2022-04-06 07:10:04-04:00,14574,niCk6QHFU1kyU56Mdq5RJzKrecdkNSn23ZA6wduFdWS,BQbUYSw1XsuE6LnVd4XjmxAyYgx4drE4FsetJBCdwVZW,True,1115532549,278767864,1595398,797699,797699,3zqXX6kzhkbW3d4TwD2CNjMRwxTbREXySekvq37kfCNk,63842353,170049303,-106206950,572
2022-04-06 07:10:05-04:00,14575,GNohZMtk1VAuhLAgNGT8J3HYCKDCiyjvLeAWr64d7Duy,6soTLVj9DzFht8DzvjRfNPAWhZuiDBS5fDE1fpeuDSSz,True,2541850449,519502475,3136041,1568020,1568021,3zqXX6kzhkbW3d4TwD2CNjMRwxTbREXySekvq37kfCNk,153441967,355557627,-202115660,603
2022-04-06 07:10:08-04:00,14576,BTwSuuDHNhQAFAzBZRWev5j1ix2RTWvjZAxLpw8grAxu,31NCyUpSXxxJYLSrdK3c5bLomUtMejobMfYnq7j71GtM,True,673666807,168416701,1041098,520549,520549,YQC4EUcgeBi9431viwvzvBbZJW3szeHX4dFmowRDyDw,41643924,110983591,-69339667,618
2022-04-06 07:11:27-04:00,14577,5zSoXxVZYYQAtq3urfcUQmJkjFDBXkUJYSNFdq759Tof,3C459gJnmj4EYTG3tDFJEEf1aAT915sxRLs2THEdQqha,True,5826900621,337162257,2106668,1053334,1053334,3zqXX6kzhkbW3d4TwD2CNjMRwxTbREXySekvq37kfCNk,364078471,818875821,-454797350,624
2022-04-06 07:12:27-04:00,14578,JABfWoDV2wW68XEDANXArYWM7zabdbp5NBVrvzZd3mML,5hYUtd1Uv2pAcrbtSNNVTrRuk8acjmh92mzSm4iz5HJA,True,231759611,39022538,243230,121615,121615,3zqXX6kzhkbW3d4TwD2CNjMRwxTbREXySekvq37kfCNk,14445793,28823709,-14377916,623
2022-04-06 07:13:51-04:00,14579,EBRWnRzoNv5RytEjgrs5TXdiCMApLKHMntJJJzehJJns,5nJiYTa3GEbmaRwY1PvBJ1teXikQKgbUop5ANgaDhhcP,True,77744160,19436040,121319,60659,60660,A9TwRM1BMxqb8DCC7YNAMV6zPenEJm3HTZBy7wJKK58U,4852790,9607615,-4754825,624
2022-04-06 07:13:53-04:00,14580,3uUdWwgwtFdPa3FJTSrirqPKMtQb3zmT5Wpp4zPy9sJP,5G7dhz8jvWekGy9Wh3ZCXNXSPbB1QArfFYs7MYNgRDkW,True,439684693,109921173,684537,342268,342269,YQC4EUcgeBi9431viwvzvBbZJW3szeHX4dFmowRDyDw,27381481,104344105,-76962624,622
2022-04-06 07:14:04-04:00,14581,FU7X4DWnGTbxwXULBq3v9SACzYhQyFGqsXjUDzyFqiem,925BaEnWxTfEv4oQb9Xf1wyyEEWEr8kXeSdXTtRfShfw,True,76644819157,6139623949,38249676,19124838,19124838,3zqXX6kzhkbW3d4TwD2CNjMRwxTbREXySekvq37kfCNk,4774949746,7452024210,-2677074464,622
2022-04-06 07:14:05-04:00,14582,29JVska5UEG3axs63EmtHpPvkswNEqYpZ3PKMSfupiAG,DCftNBUsuogxyaJe9G9m3eWipH6o3qo4Rn4TuQXdVaBF,True,36020177,9005044,55278,27639,27639,YQC4EUcgeBi9431viwvzvBbZJW3szeHX4dFmowRDyDw,2211150,6996405,-4785255,613
2022-04-06 07:14:07-04:00,14583,4GbUrgiR6A91h3J9HHpuYCkZzjwrb62n3BURLeWj6Nic,12nUFUGYF1rXbwPeCbdGKdP3RE4g984fmZZggEYSFTZn,True,283122053,70780513,438290,219145,219145,3zqXX6kzhkbW3d4TwD2CNjMRwxTbREXySekvq37kfCNk,17531610,53549064,-36017454,619
2022-04-06 07:14:57-04:00,14584,DVMLxFACqaNBD7q1TGJUUApJX7etJsxQRRFBP2DfBazJ,4hnRjD7S2KxD7UrgfrApntVxUD7Srh5E9nwPY53v89kz,True,589470502,49034552,320119,160059,160060,3zqXX6kzhkbW3d4TwD2CNjMRwxTbREXySekvq37kfCNk,38483353,99070757,-60587404,652
2022-04-06 07:15:02-04:00,14585,8qq2gfbca7JXvq4gViBBVT2QAbM4MvBMEQLXgn8UUTvt,3o5jpBVYdFFEYrGRdCUkLrUC85wsuTKgy8iYwnpZyC1B,True,2065907376,176604843,1102989,551494,551495,YQC4EUcgeBi9431viwvzvBbZJW3szeHX4dFmowRDyDw,129026728,774268808,-645242080,624
2022-04-06 07:15:13-04:00,14586,6Auz7aARPERW9zbV8428yFUWkA9DuitQYiWQzewueU3o,G1xfLGt5twz7MTfEq6NnMZBpr6GmXceKdGUQkc9jugRB,True,51524744,12881186,80164,40082,40082,YQC4EUcgeBi9431viwvzvBbZJW3szeHX4dFmowRDyDw,3206564,10980933,-7774369,622
2022-04-06 07:15:18-04:00,14587,8K1GzGeaAuFdjuVZi6DqBcYiA1zSRioMkRvjotr8p7fz,5mqocPwTdjwAPiJf7vx9bo7AzvfQBT2t5bV9u2Jzb2e1,True,866505023,216626255,1546393,773196,773197,3zqXX6kzhkbW3d4TwD2CNjMRwxTbREXySekvq37kfCNk,61855757,139292153,-77436396,713
2022-04-06 07:26:44-04:00,14588,Gw37fsD8M3AaZ22tSx9WeszxsAkWQ6Ap2XV3zXYhe3EJ,FbKeJsWR5ggVBy1R5sxNiWz5GAsxeyZD8nmyk5yCBqSz,True,88674674,22168668,156239,78119,78120,YQC4EUcgeBi9431viwvzvBbZJW3szeHX4dFmowRDyDw,6249597,27143140,-20893543,704
2022-04-06 07:28:02-04:00,14589,D85pWm1LS9MvtR4f3QhkFLvNUhZLQ2NZBFQTyAVnmigm,CRN85DYkJJi6irhtVAf4qcJU3ijVodWdXgWe7Fs6Ahka,True,811888797,116357167,725596,362798,362798,3zqXX6kzhkbW3d4TwD2CNjMRwxTbREXySekvq37kfCNk,50628907,131601564,-80972657,623
2022-04-06 07:28:16-04:00,14590,DXGapgtgkag6midSCYNhHCNaCqvhUmuSvnVhXxNXBmyt,Csq6W5QkGZL6qE6Z1ERF3bfHtKjnM8hAxiY1YA3rTwSX,True,1516517133,379129283,2356784,1178392,1178392,YQC4EUcgeBi9431viwvzvBbZJW3szeHX4dFmowRDyDw,94271388,189631647,-95360259,621
2022-04-06 07:28:22-04:00,14591,5zSoXxVZYYQAtq3urfcUQmJkjFDBXkUJYSNFdq759Tof,3C459gJnmj4EYTG3tDFJEEf1aAT915sxRLs2THEdQqha,True,5467752315,334912503,2082491,1041245,1041246,3zqXX6kzhkbW3d4TwD2CNjMRwxTbREXySekvq37kfCNk,339985754,779959731,-439973977,621
2022-04-06 07:28:27-04:00,14592,J5q3HYmNhEHPz4DzVGHnSwBAwTqTn8jPwkjCaoQRs9t1,FbgqAegQKWQ8jVVVcJV6okGHgP1fhL2uoJpzfX3mYoH6,True,298467440,74616860,465531,232765,232766,A9TwRM1BMxqb8DCC7YNAMV6zPenEJm3HTZBy7wJKK58U,18621251,44914671,-26293420,623
2022-04-06 07:28:28-04:00,14593,FoGtu9wcVbBmATBKtBMWvbRd558yzSDT5dPBTBJgzqFT,9rnvQvgQtkT7RSdDpZHnkTVd2V9CMRBSB7v79GDip4hS,True,812930208,203232552,1243027,621513,621514,YQC4EUcgeBi9431viwvzvBbZJW3szeHX4dFmowRDyDw,49721098,83862803,-34141705,611
2022-04-06 07:28:54-04:00,14594,eiLMepBYM3VcWarQJC9fTnxotyMuUTbyMGJECedPEfu,k2ZfwPNBBCK7PvZ6MEvELTHHtQZSXCRGCymvkZwhDDt,True,72400754,12675222,79156,39578,39578,YQC4EUcgeBi9431viwvzvBbZJW3szeHX4dFmowRDyDw,4521471,12408736,-7887265,624
2022-04-06 07:29:18-04:00,14595,AX2VRZoWZDfZT4QdwuXUSyRCx4N6B9eHAR75FSmcrVFG,FBgLGmbouri9wCV92UXZaDjwK6fcpjhDDD5NLVWmuRRK,True,3908539676,977134919,6077721,3038860,3038861,3zqXX6kzhkbW3d4TwD2CNjMRwxTbREXySekvq37kfCNk,243108861,573131998,-330023137,621
2022-04-06 07:29:20-04:00,14596,2xgQaQTs7bkK34jSBZ2dFZf1DJKjMVW9LA3D9Pwtfims,6rniSBeGcJAcrqWhhnKCcRV58yYnjuqXj9b4Zu8DUwQ9,True,77114213,18738546,114983,57491,57492,YQC4EUcgeBi9431viwvzvBbZJW3szeHX4dFmowRDyDw,4731919,12704155,-7972236,613
2022-04-06 07:29:36-04:00,14597,FU7X4DWnGTbxwXULBq3v9SACzYhQyFGqsXjUDzyFqiem,925BaEnWxTfEv4oQb9Xf1wyyEEWEr8kXeSdXTtRfShfw,True,70151924216,5057922611,31604328,15802164,15802164,YQC4EUcgeBi9431viwvzvBbZJW3szeHX4dFmowRDyDw,4383429078,7217507327,-2834078249,624
2022-04-06 09:01:34-04:00,14598,F2AU2PjaSmHxWWhkz8XxMggkCMWbMVgawt89tSnYS6RL,ET9febRJiW197DYMaJbgk3kWsAeFv5f4peQ4vFCVppK6,True,39108593,9777148,69426,34713,34713,YQC4EUcgeBi9431viwvzvBbZJW3szeHX4dFmowRDyDw,2777075,13162990,-10385915,710
2022-04-06 09:01:35-04:00,14599,SEndYVMCKAeZUKSqGrMUSqXFmxtA9M1t4eXsUhVsTBF,3fcQQcbkpqodakamn82pFnMxBEPL2Drsg4jJNZ6dx72M,True,1434549150,181714482,1198650,599325,599325,YQC4EUcgeBi9431viwvzvBbZJW3szeHX4dFmowRDyDw,94627720,258654162,-164026442,659
2022-04-06 09:03:28-04:00,14600,4rLtMQSN7dkQMAB1RiQwtQepNcvrpsGgshMmzpDNa5ta,ESnuS85iexRfPoCGQSHKxMB28FoDNc4sPwnWSC9RvKKs,False,11038706,11038706,784442,39222,745220,YQC4EUcgeBi9431viwvzvBbZJW3szeHX4dFmowRDyDw,784442,2399115,-1614673,710
2022-04-06 09:17:40-04:00,14601,EHLV9s6E1s5SUbzZVzsGWH2vVRGHyxynM4GDJtfKEuYe,4hAx9osegpeocSSmJbMVBYMKCwo5WY3QVJuK7cuzz4b4,True,57646707,14411676,102887,51443,51444,YQC4EUcgeBi9431viwvzvBbZJW3szeHX4dFmowRDyDw,4115499,19323095,-15207596,713
2022-04-06 09:17:40-04:00,14602,GCweck6iuscBsVbXW9ZYfMytdgwSYWwNifTWLaUbaSmA,6HwGWKGduMGvLnHmTJo6ZioZ3EMUZYHo2pG4tBFXgB4Y,True,57574862,14393715,101470,50735,50735,3zqXX6kzhkbW3d4TwD2CNjMRwxTbREXySekvq37kfCNk,4058811,19338040,-15279229,704
2022-04-06 09:36:40-04:00,14603,niCk6QHFU1kyU56Mdq5RJzKrecdkNSn23ZA6wduFdWS,BQbUYSw1XsuE6LnVd4XjmxAyYgx4drE4FsetJBCdwVZW,True,1257015537,314138284,1951376,975688,975688,YQC4EUcgeBi9431viwvzvBbZJW3szeHX4dFmowRDyDw,78083805,141452500,-63368695,621
2022-04-06 09:38:41-04:00,14604,5qY8ZrqpHPqkAuXp6HpE2zC8qTfzsP8MXWSoxkZQV5jx,GPs3ap45TuHwHwmDb5bnKYHLBa5wj3AyuEsXcfHjEcAL,True,26047648,6511912,46268,23134,23134,YQC4EUcgeBi9431viwvzvBbZJW3szeHX4dFmowRDyDw,1850724,7238825,-5388101,710
2022-04-06 09:41:55-04:00,14605,5UDGqNpkcMDjByBNi7WYMg8VJ81EzNJu48zsXbW9irSd,FmtUoQNiG25v8sn4pveM6wAWvja9u6FvZ2gdxWHSRjur,True,2757918994,689479748,4849188,2424594,2424594,YQC4EUcgeBi9431viwvzvBbZJW3szeHX4dFmowRDyDw,193967537,541786214,-347818677,703
2022-04-06 09:42:44-04:00,14606,FFDTcCW6UXKpkMnCefTRLpF8ZkJtS4sbGTjkcNU31Pxh,9v5oBZNrx4EATT8iHT5wNRJSo2rRPpazAYvPeaNe2Tpc,True,1050396593,149336913,1065197,532598,532599,YQC4EUcgeBi9431viwvzvBbZJW3szeHX4dFmowRDyDw,74923204,172335370,-97412166,713
2022-04-06 09:42:52-04:00,14607,DVMLxFACqaNBD7q1TGJUUApJX7etJsxQRRFBP2DfBazJ,4hnRjD7S2KxD7UrgfrApntVxUD7Srh5E9nwPY53v89kz,True,537113038,53495512,346799,173399,173400,YQC4EUcgeBi9431viwvzvBbZJW3szeHX4dFmowRDyDw,34819863,91506323,-56686460,648
2022-04-06 09:42:56-04:00,14608,JABfWoDV2wW68XEDANXArYWM7zabdbp5NBVrvzZd3mML,5hYUtd1Uv2pAcrbtSNNVTrRuk8acjmh92mzSm4iz5HJA,True,190290574,28797683,177553,88776,88777,3zqXX6kzhkbW3d4TwD2CNjMRwxTbREXySekvq37kfCNk,11732474,26591356,-14858882,616
2022-04-06 09:42:56-04:00,14609,D8BtQirMEk3W9Pq29B6KkKWrwPfmsUNpwz5npx7aGMLY,J7LMZwaSoh5hbGcwee6oPsnN4ZFD7Zp3LQWkJGNUHRfJ,True,4085625583,663024662,4340547,2170273,2170274,3zqXX6kzhkbW3d4TwD2CNjMRwxTbREXySekvq37kfCNk,267468981,554190713,-286721732,654
2022-04-06 09:43:12-04:00,14610,BEATjyYuro1xc1kbgBoxBnVEk3usoUk9qwmdRndXdYW5,9RGBffhSMgab1KCM6dMvwiBENbnp5pERfCEjw4q5ckFS,True,215787809,53946952,371997,185998,185999,3zqXX6kzhkbW3d4TwD2CNjMRwxTbREXySekvq37kfCNk,14879882,49597800,-34717918,689
2022-04-06 09:43:17-04:00,14611,Gw37fsD8M3AaZ22tSx9WeszxsAkWQ6Ap2XV3zXYhe3EJ,FbKeJsWR5ggVBy1R5sxNiWz5GAsxeyZD8nmyk5yCBqSz,True,64819508,16204877,110102,55051,55051,YQC4EUcgeBi9431viwvzvBbZJW3szeHX4dFmowRDyDw,4404112,21761721,-17357609,679
2022-04-06 09:44:29-04:00,14612,8qq2gfbca7JXvq4gViBBVT2QAbM4MvBMEQLXgn8UUTvt,3o5jpBVYdFFEYrGRdCUkLrUC85wsuTKgy8iYwnpZyC1B,True,1873315456,169374509,1058129,529064,529065,3zqXX6kzhkbW3d4TwD2CNjMRwxTbREXySekvq37kfCNk,117031247,699658344,-582627097,624
2022-04-06 09:48:20-04:00,14613,SEndYVMCKAeZUKSqGrMUSqXFmxtA9M1t4eXsUhVsTBF,3fcQQcbkpqodakamn82pFnMxBEPL2Drsg4jJNZ6dx72M,True,1236746578,138065578,917450,458725,458725,3zqXX6kzhkbW3d4TwD2CNjMRwxTbREXySekvq37kfCNk,82182270,255082945,-172900675,664
2022-04-06 09:48:23-04:00,14614,Br1j5Ftafei7ysu5SmqVZSoRe4uS4qCPeKSPHg55pyiE,G8fc7QvXjfkgBFvAVUgJFQS3VaF1biL9rktBExGa87Ks,True,2732489984,548962204,3429101,1714550,1714551,3zqXX6kzhkbW3d4TwD2CNjMRwxTbREXySekvq37kfCNk,170685459,163614759,7070700,624
2022-04-06 09:48:51-04:00,14615,DVMLxFACqaNBD7q1TGJUUApJX7etJsxQRRFBP2DfBazJ,4hnRjD7S2KxD7UrgfrApntVxUD7Srh5E9nwPY53v89kz,True,480234422,44493749,288048,144024,144024,3zqXX6kzhkbW3d4TwD2CNjMRwxTbREXySekvq37kfCNk,31089960,88404565,-57314605,647
2022-04-06 09:48:53-04:00,14616,5zSoXxVZYYQAtq3urfcUQmJkjFDBXkUJYSNFdq759Tof,3C459gJnmj4EYTG3tDFJEEf1aAT915sxRLs2THEdQqha,True,5114152907,266277129,1660774,830387,830387,3zqXX6kzhkbW3d4TwD2CNjMRwxTbREXySekvq37kfCNk,318970409,754637497,-435667088,623
2022-04-06 09:49:03-04:00,14617,5FewDaMC9U7n5EHcto98GaAmDVxDh5SYimuTP6AtfakM,7DAULUoqV7f9hsBzKEhjQPnWaHSqiMWcBqWcdcadaQv4,True,2562693181,322445556,2014923,1007461,1007462,YQC4EUcgeBi9431viwvzvBbZJW3szeHX4dFmowRDyDw,160139677,261514644,-101374967,624
2022-04-06 09:49:22-04:00,14618,7yW1M1xeVx4hy3QftnpqdBDRYwamfu3K5i6AEnxgyTWb,7wf7FWS2DYp5RveQAmGNXAEUWPcHziuMLd4hV5LPgxF8,True,30259458,7564864,44092,22046,22046,3zqXX6kzhkbW3d4TwD2CNjMRwxTbREXySekvq37kfCNk,1763706,5254213,-3490507,582
2022-04-06 09:49:27-04:00,14619,6eEifGxGRBnXV5EW2BwmCj8pa67znMjet98Nsq11LCsd,Dd4UCEX7tm6Q82SdSSFX9wBcJNw5TwKu8EyGjvxi9FVc,True,1202910659,300727664,1781286,890643,890643,3zqXX6kzhkbW3d4TwD2CNjMRwxTbREXySekvq37kfCNk,71251464,153343180,-82091716,592
2022-04-06 09:49:29-04:00,14620,FU7X4DWnGTbxwXULBq3v9SACzYhQyFGqsXjUDzyFqiem,925BaEnWxTfEv4oQb9Xf1wyyEEWEr8kXeSdXTtRfShfw,True,64689918227,4700421807,28658804,14329402,14329402,3zqXX6kzhkbW3d4TwD2CNjMRwxTbREXySekvq37kfCNk,3944190116,6784381985,-2840191869,609
2022-04-06 09:49:30-04:00,14621,D85pWm1LS9MvtR4f3QhkFLvNUhZLQ2NZBFQTyAVnmigm,CRN85DYkJJi6irhtVAf4qcJU3ijVodWdXgWe7Fs6Ahka,True,687852136,86266556,529168,264584,264584,3zqXX6kzhkbW3d4TwD2CNjMRwxTbREXySekvq37kfCNk,42193640,118509704,-76316064,613
2022-04-06 09:49:30-04:00,14622,8K1GzGeaAuFdjuVZi6DqBcYiA1zSRioMkRvjotr8p7fz,5mqocPwTdjwAPiJf7vx9bo7AzvfQBT2t5bV9u2Jzb2e1,True,632973658,158243414,1085058,542529,542529,3zqXX6kzhkbW3d4TwD2CNjMRwxTbREXySekvq37kfCNk,43402337,118459112,-75056775,685
2022-04-06 09:49:31-04:00,14623,GeYsENPRf2qGZu9rJsi6UPQqHS6sR7LRLWsKbFgtMCSb,7A79wktqPkSpP7o4c1kP9CBpUibHTqycW81ZANgREc5S,True,193153768,48288442,294225,147112,147113,A9TwRM1BMxqb8DCC7YNAMV6zPenEJm3HTZBy7wJKK58U,11769009,32056495,-20287486,609
2022-04-06 09:49:35-04:00,14624,FFDTcCW6UXKpkMnCefTRLpF8ZkJtS4sbGTjkcNU31Pxh,9v5oBZNrx4EATT8iHT5wNRJSo2rRPpazAYvPeaNe2Tpc,True,890494078,111874303,795153,397576,397577,3zqXX6kzhkbW3d4TwD2CNjMRwxTbREXySekvq37kfCNk,63292405,163217210,-99924805,710
2022-04-06 09:49:47-04:00,14625,7CSCMFa9W52tBDVUbXbc3woAy3GByeA1wPJdp3MgznPa,3447ptuVFu6G8B6N63RmS8mRv4n9PfHneypHLvbeaGLn,True,4013436232,784244292,4890043,2445021,2445022,3zqXX6kzhkbW3d4TwD2CNjMRwxTbREXySekvq37kfCNk,250252126,599329785,-349077659,623
2022-04-06 09:49:48-04:00,14626,JABfWoDV2wW68XEDANXArYWM7zabdbp5NBVrvzZd3mML,5hYUtd1Uv2pAcrbtSNNVTrRuk8acjmh92mzSm4iz5HJA,True,159922240,21451717,133927,66963,66964,YQC4EUcgeBi9431viwvzvBbZJW3szeHX4dFmowRDyDw,9984270,24470252,-14485982,624
2022-04-06 09:49:48-04:00,14627,5UDGqNpkcMDjByBNi7WYMg8VJ81EzNJu48zsXbW9irSd,FmtUoQNiG25v8sn4pveM6wAWvja9u6FvZ2gdxWHSRjur,True,2019419112,504854778,3502455,1751227,1751228,3zqXX6kzhkbW3d4TwD2CNjMRwxTbREXySekvq37kfCNk,140098215,450763594,-310665379,693
2022-04-06 09:49:51-04:00,14628,J8khFNhJg25xVY7yjEtETTQVVzKHqdVCs1Rh2pJKvJqU,4eUP2YxTapjr6TLrd57XxZan7KJG5AtHK8yPRNVEbavx,True,1921749718,179450496,1120708,560354,560354,YQC4EUcgeBi9431viwvzvBbZJW3szeHX4dFmowRDyDw,120017556,84478585,35538971,624
2022-04-06 09:49:52-04:00,14629,5yPGvUz6JWKjkViGwTCpygJii1rP2xv5yx146ULtBiYq,FMnHUCQWTf1UHu5qVFqUAsWh8aba9EQYTEoiXy55totD,True,1813164220,156744254,975116,487558,487558,YQC4EUcgeBi9431viwvzvBbZJW3szeHX4dFmowRDyDw,112798186,285329082,-172530896,622
2022-04-06 09:49:53-04:00,14630,9x6AswVgr6MiayhvYFjqj4Fw8LYS795JcL5VrfSsoxi5,BLrbag9VCFCmTinyvVuitmkzXmZLqgaFR9gbRNyftiRX,True,7927620787,1359216390,8482071,4241035,4241036,3zqXX6kzhkbW3d4TwD2CNjMRwxTbREXySekvq37kfCNk,494716301,1361230292,-866513991,624
2022-04-06 09:49:54-04:00,14631,EN2YBXcj7E1eAaYJYXJjc6Rfsu6Awjgv9kN3bT3uiprp,HYDG5mqfCy2xwrYKixNzoWyDiqb9KbpnA8H3TQG2EDDG,True,613101562,153275292,937750,468875,468875,3zqXX6kzhkbW3d4TwD2CNjMRwxTbREXySekvq37kfCNk,37510053,102306025,-64795972,611
2022-04-06 09:50:02-04:00,14632,67DwuUmzk6uGwmptjYErQssFeJ5fd1ztFwKWZUovr7pK,HKzc15e1QLBrSsbAENyMXSVHDoap1F5MHCHB9L1Dm8HA,True,373139363,93284840,582960,291480,291480,3zqXX6kzhkbW3d4TwD2CNjMRwxTbREXySekvq37kfCNk,23318414,70804972,-47486558,624
2022-04-06 09:50:10-04:00,14633,B3NyyoWNzyzvpWv1G6a9gZJMjD1sTQBdZojBaH18mNjY,BCj3EGFMhJ9wh4KvF9cqYsuNHug7kCbALFMLMtuh24bq,True,4750166588,1187541647,7268255,3634127,3634128,3zqXX6kzhkbW3d4TwD2CNjMRwxTbREXySekvq37kfCNk,290730207,679484086,-388753879,612
2022-04-06 09:50:37-04:00,14634,7mhEMbGEpSYgYoZx6WvApjysTxsPqpCDSJCmKF45x3n6,12J2purUC4QYjaPKZwL3Y5P1JikTBD3oY9pLgY6yt6am,True,8899601711,2224900427,13877826,6938913,6938913,3zqXX6kzhkbW3d4TwD2CNjMRwxTbREXySekvq37kfCNk,555113065,916163037,-361049972,623
2022-04-06 09:50:39-04:00,14635,5zSoXxVZYYQAtq3urfcUQmJkjFDBXkUJYSNFdq759Tof,3C459gJnmj4EYTG3tDFJEEf1aAT915sxRLs2THEdQqha,True,4831442868,259932058,1618719,809359,809360,3zqXX6kzhkbW3d4TwD2CNjMRwxTbREXySekvq37kfCNk,300876725,738573186,-437696461,622
2022-04-06 09:50:42-04:00,14636,AyFWvQUX79sq8L7KhcYrPRbxd6whUvEMETZL8atuuRr2,9LTjofdhGLn2Ltv6XfuHtX8MKEPzScGL669pC8Lrgtnh,True,44709309,11177327,69417,34708,34709,YQC4EUcgeBi9431viwvzvBbZJW3szeHX4dFmowRDyDw,2776709,7236378,-4459669,621
2022-04-06 09:51:00-04:00,14637,D8BtQirMEk3W9Pq29B6KkKWrwPfmsUNpwz5npx7aGMLY,J7LMZwaSoh5hbGcwee6oPsnN4ZFD7Zp3LQWkJGNUHRfJ,True,3383369856,492397547,3258482,1629241,1629241,3zqXX6kzhkbW3d4TwD2CNjMRwxTbREXySekvq37kfCNk,223897369,516810132,-292912763,661
2022-04-06 09:51:29-04:00,14638,1EH82ta3wXUyUwW8VWQnVzSG3r1rHcSj2DvDeTKmp3F,B6aMfucYPbCzWBtauLtgTpwR45wKSK8yqscHJR3F5usu,True,2291075434,213721397,1335583,667791,667792,YQC4EUcgeBi9431viwvzvBbZJW3szeHX4dFmowRDyDw,143173516,73905761,69267755,624
2022-04-06 09:51:42-04:00,14639,HooxSzasW3HMoFJ6sAvRQ75Char1J5aBdJtsqfDV6myp,BCmsWwpGeV4NNfeKZKKydty2uueLGHYTJDk1WErpXsVT,True,2135428742,533857185,3302903,1651451,1651452,3zqXX6kzhkbW3d4TwD2CNjMRwxTbREXySekvq37kfCNk,132116150,340779474,-208663324,618
2022-04-06 09:52:12-04:00,14640,FU7X4DWnGTbxwXULBq3v9SACzYhQyFGqsXjUDzyFqiem,925BaEnWxTfEv4oQb9Xf1wyyEEWEr8kXeSdXTtRfShfw,True,59807511501,4516347729,28193772,14096886,14096886,3zqXX6kzhkbW3d4TwD2CNjMRwxTbREXySekvq37kfCNk,3733546393,6747290797,-3013744404,624
2022-04-06 09:53:45-04:00,14641,A5NXadGWnFZRoHEn1dKTRjcXgWmfMLMyJdpF4rQPZyRR,ALs3Zfotc4c4A6TFDMbd5GM5whK1dTYSnGrHiMBWmApH,True,4111804961,1027950635,6406315,3203157,3203158,3zqXX6kzhkbW3d4TwD2CNjMRwxTbREXySekvq37kfCNk,256252782,1019330187,-763077405,623
2022-04-06 09:55:41-04:00,14642,F2AU2PjaSmHxWWhkz8XxMggkCMWbMVgawt89tSnYS6RL,ET9febRJiW197DYMaJbgk3kWsAeFv5f4peQ4vFCVppK6,True,28641445,7160361,50441,25220,25221,YQC4EUcgeBi9431viwvzvBbZJW3szeHX4dFmowRDyDw,2017649,10497277,-8479628,704
2022-04-06 09:59:21-04:00,14643,3uUdWwgwtFdPa3FJTSrirqPKMtQb3zmT5Wpp4zPy9sJP,5G7dhz8jvWekGy9Wh3ZCXNXSPbB1QArfFYs7MYNgRDkW,True,323225607,80806401,503578,251789,251789,3zqXX6kzhkbW3d4TwD2CNjMRwxTbREXySekvq37kfCNk,20143134,84404870,-64261736,623
2022-04-06 10:00:57-04:00,14644,5yPGvUz6JWKjkViGwTCpygJii1rP2xv5yx146ULtBiYq,FMnHUCQWTf1UHu5qVFqUAsWh8aba9EQYTEoiXy55totD,True,1647363853,155202378,967676,483838,483838,3zqXX6kzhkbW3d4TwD2CNjMRwxTbREXySekvq37kfCNk,102712004,268748093,-166036089,623
2022-04-06 10:02:27-04:00,14645,8nFpzAFXELGPsrgFwRjTfUidNme1CvgKQTsHWATtMqkz,ABt8ikXHraZ1bqkDUvMtJ3AUzADDWcCL8kMMDpAoth8V,True,72113962,18028490,111718,55859,55859,3zqXX6kzhkbW3d4TwD2CNjMRwxTbREXySekvq37kfCNk,4468742,15065455,-10596713,619
2022-04-06 10:03:13-04:00,14646,DVMLxFACqaNBD7q1TGJUUApJX7etJsxQRRFBP2DfBazJ,4hnRjD7S2KxD7UrgfrApntVxUD7Srh5E9nwPY53v89kz,True,433162535,35568823,231719,115859,115860,3zqXX6kzhkbW3d4TwD2CNjMRwxTbREXySekvq37kfCNk,28219164,82606056,-54386892,651
2022-04-06 10:03:39-04:00,14647,BAkPsWHtpVcEGqUgKTKjwZ6d5aaUcaUhdgYxBnpSTDW2,BDwDmVaZnXh22sf8nsDtjVfgxMAswbM3PW3si3k4nbRK,True,497486138,124371534,768247,384123,384124,3zqXX6kzhkbW3d4TwD2CNjMRwxTbREXySekvq37kfCNk,30729893,98717762,-67987869,617
2022-04-06 10:03:39-04:00,14648,FV9CBGGTbppLnBKh79f2LzD1diTiS5g6u89FcpZHZmnK,Fe7mtmCUziFqbbYTvrhAcAq1Ub7YLfTJRtQ1hG7GzJD1,True,50150319,12537579,77540,38770,38770,3zqXX6kzhkbW3d4TwD2CNjMRwxTbREXySekvq37kfCNk,3101603,6231305,-3129702,618
2022-04-06 10:03:56-04:00,14649,D85pWm1LS9MvtR4f3QhkFLvNUhZLQ2NZBFQTyAVnmigm,CRN85DYkJJi6irhtVAf4qcJU3ijVodWdXgWe7Fs6Ahka,True,597201349,85195665,531651,265825,265826,3zqXX6kzhkbW3d4TwD2CNjMRwxTbREXySekvq37kfCNk,37267548,107712190,-70444642,624
2022-04-06 10:03:57-04:00,14650,5FewDaMC9U7n5EHcto98GaAmDVxDh5SYimuTP6AtfakM,7DAULUoqV7f9hsBzKEhjQPnWaHSqiMWcBqWcdcadaQv4,True,2218346730,315641982,1935831,967915,967916,A9TwRM1BMxqb8DCC7YNAMV6zPenEJm3HTZBy7wJKK58U,136051131,247772121,-111720990,613
2022-04-06 10:04:08-04:00,14651,eiLMepBYM3VcWarQJC9fTnxotyMuUTbyMGJECedPEfu,k2ZfwPNBBCK7PvZ6MEvELTHHtQZSXCRGCymvkZwhDDt,True,58966821,9388828,58611,29305,29306,3zqXX6kzhkbW3d4TwD2CNjMRwxTbREXySekvq37kfCNk,3681122,10574837,-6893715,624
2022-04-06 10:04:09-04:00,14652,J8khFNhJg25xVY7yjEtETTQVVzKHqdVCs1Rh2pJKvJqU,4eUP2YxTapjr6TLrd57XxZan7KJG5AtHK8yPRNVEbavx,True,1731545066,150005981,935969,467984,467985,YQC4EUcgeBi9431viwvzvBbZJW3szeHX4dFmowRDyDw,108040632,122990015,-14949383,623
2022-04-06 10:04:09-04:00,14653,DDdxcAmfFWLs79vYC1WUuwBVM1XUfxmAgbYgccL5bgZg,3tKaUfHU3Z7v1LDm581yDd1bpfnxLgGHCWTNur3KLptz,True,2792280672,698070168,4362552,2181276,2181276,3zqXX6kzhkbW3d4TwD2CNjMRwxTbREXySekvq37kfCNk,174502087,497458972,-322956885,624
2022-04-06 10:04:17-04:00,14654,29JVska5UEG3axs63EmtHpPvkswNEqYpZ3PKMSfupiAG,DCftNBUsuogxyaJe9G9m3eWipH6o3qo4Rn4TuQXdVaBF,True,26513284,6628321,41311,20655,20656,YQC4EUcgeBi9431viwvzvBbZJW3szeHX4dFmowRDyDw,1652442,5743243,-4090801,623
2022-04-06 10:04:20-04:00,14655,EBRWnRzoNv5RytEjgrs5TXdiCMApLKHMntJJJzehJJns,5nJiYTa3GEbmaRwY1PvBJ1teXikQKgbUop5ANgaDhhcP,True,57129047,14282261,88724,44362,44362,YQC4EUcgeBi9431viwvzvBbZJW3szeHX4dFmowRDyDw,3548990,8294227,-4745237,621
2022-04-06 10:04:23-04:00,14656,5zSoXxVZYYQAtq3urfcUQmJkjFDBXkUJYSNFdq759Tof,3C459gJnmj4EYTG3tDFJEEf1aAT915sxRLs2THEdQqha,True,4555978711,250362474,1558101,779050,779051,YQC4EUcgeBi9431viwvzvBbZJW3szeHX4dFmowRDyDw,283536033,717159441,-433623408,622
2022-04-06 10:04:26-04:00,14657,2i5g7q4gD1GEfSz8BkhKn1idQ5U7cFPbMDWugjr7bBQW,Dpx6K9G5uZD63rTzBafZ56WKd1X9M25Mzfppd7Jib4xn,True,4882447912,1220611978,7579829,3789914,3789915,3zqXX6kzhkbW3d4TwD2CNjMRwxTbREXySekvq37kfCNk,303193161,1067719473,-764526312,620
2022-04-06 10:04:28-04:00,14658,4GbUrgiR6A91h3J9HHpuYCkZzjwrb62n3BURLeWj6Nic,12nUFUGYF1rXbwPeCbdGKdP3RE4g984fmZZggEYSFTZn,True,208220184,52055046,323988,161994,161994,3zqXX6kzhkbW3d4TwD2CNjMRwxTbREXySekvq37kfCNk,12959533,44094606,-31135073,622
2022-04-06 10:04:44-04:00,14659,6Auz7aARPERW9zbV8428yFUWkA9DuitQYiWQzewueU3o,G1xfLGt5twz7MTfEq6NnMZBpr6GmXceKdGUQkc9jugRB,True,37878989,9469747,58943,29471,29472,3zqXX6kzhkbW3d4TwD2CNjMRwxTbREXySekvq37kfCNk,2357729,8953100,-6595371,622
2022-04-06 10:04:58-04:00,14660,FU7X4DWnGTbxwXULBq3v9SACzYhQyFGqsXjUDzyFqiem,925BaEnWxTfEv4oQb9Xf1wyyEEWEr8kXeSdXTtRfShfw,True,55013041231,3746137347,23334296,11667148,11667148,3zqXX6kzhkbW3d4TwD2CNjMRwxTbREXySekvq37kfCNk,3426704573,6476535333,-3049830760,622
2022-04-06 10:05:14-04:00,14661,FoGtu9wcVbBmATBKtBMWvbRd558yzSDT5dPBTBJgzqFT,9rnvQvgQtkT7RSdDpZHnkTVd2V9CMRBSB7v79GDip4hS,True,596074284,149018571,870470,435235,435235,3zqXX6kzhkbW3d4TwD2CNjMRwxTbREXySekvq37kfCNk,34818818,74053250,-39234432,584
2022-04-06 10:05:15-04:00,14662,AX2VRZoWZDfZT4QdwuXUSyRCx4N6B9eHAR75FSmcrVFG,FBgLGmbouri9wCV92UXZaDjwK6fcpjhDDD5NLVWmuRRK,True,2871064225,717766056,4412944,2206472,2206472,3zqXX6kzhkbW3d4TwD2CNjMRwxTbREXySekvq37kfCNk,176517766,484490776,-307973010,614
2022-04-06 10:05:18-04:00,14663,6eEifGxGRBnXV5EW2BwmCj8pa67znMjet98Nsq11LCsd,Dd4UCEX7tm6Q82SdSSFX9wBcJNw5TwKu8EyGjvxi9FVc,True,887945990,221986497,1380431,690215,690216,YQC4EUcgeBi9431viwvzvBbZJW3szeHX4dFmowRDyDw,55217266,131033827,-75816561,621
2022-04-06 10:05:18-04:00,14664,7yW1M1xeVx4hy3QftnpqdBDRYwamfu3K5i6AEnxgyTWb,7wf7FWS2DYp5RveQAmGNXAEUWPcHziuMLd4hV5LPgxF8,True,22335583,5583895,34005,17002,17003,3zqXX6kzhkbW3d4TwD2CNjMRwxTbREXySekvq37kfCNk,1360203,4337102,-2976899,608
2022-04-06 10:05:18-04:00,14665,DVMLxFACqaNBD7q1TGJUUApJX7etJsxQRRFBP2DfBazJ,4hnRjD7S2KxD7UrgfrApntVxUD7Srh5E9nwPY53v89kz,True,395070159,39574720,255075,127537,127538,3zqXX6kzhkbW3d4TwD2CNjMRwxTbREXySekvq37kfCNk,25463892,75747421,-50283529,644
2022-04-06 10:05:21-04:00,14666,C3DnHRyndQw1EinnmrayLzuhP9KhXYKVDUpf55BumxG1,6aU3EvNk5CyD5LdGhQksYKkNxvJ5vw23JvMEdwqeDSMo,True,9278995066,2319748766,13964220,6982110,6982110,YQC4EUcgeBi9431viwvzvBbZJW3szeHX4dFmowRDyDw,558568834,2164013078,-1605444244,601
2022-04-06 10:05:23-04:00,14667,5zSoXxVZYYQAtq3urfcUQmJkjFDBXkUJYSNFdq759Tof,3C459gJnmj4EYTG3tDFJEEf1aAT915sxRLs2THEdQqha,True,4291837713,247292752,1545346,772673,772673,3zqXX6kzhkbW3d4TwD2CNjMRwxTbREXySekvq37kfCNk,268199408,687768560,-419569152,624
2022-04-06 10:05:23-04:00,14668,2xgQaQTs7bkK34jSBZ2dFZf1DJKjMVW9LA3D9Pwtfims,6rniSBeGcJAcrqWhhnKCcRV58yYnjuqXj9b4Zu8DUwQ9,True,57148883,13755552,81517,40758,40759,3zqXX6kzhkbW3d4TwD2CNjMRwxTbREXySekvq37kfCNk,3386737,10587735,-7200998,592
2022-04-06 10:05:27-04:00,14669,1EH82ta3wXUyUwW8VWQnVzSG3r1rHcSj2DvDeTKmp3F,B6aMfucYPbCzWBtauLtgTpwR45wKSK8yqscHJR3F5usu,True,2058358963,205507109,1225369,612684,612685,3zqXX6kzhkbW3d4TwD2CNjMRwxTbREXySekvq37kfCNk,122733046,59377795,63355251,596
2022-04-06 10:05:30-04:00,14670,3BKX31xq3f13J2Zo8Wue4SYpCMWLXjgUt2nkwTTNfU2T,2pTxNAaV4pXRRUDE97ZFteBJn9tyktjh3FW1CWfwebci,True,299634013,74908503,468047,234023,234024,3zqXX6kzhkbW3d4TwD2CNjMRwxTbREXySekvq37kfCNk,18721909,46318360,-27596451,624
2022-04-06 10:05:38-04:00,14671,J5q3HYmNhEHPz4DzVGHnSwBAwTqTn8jPwkjCaoQRs9t1,FbgqAegQKWQ8jVVVcJV6okGHgP1fhL2uoJpzfX3mYoH6,True,219205024,54801256,337424,168712,168712,72FwbpFGoLEazJEdpqNtPNefsadUrimUqma9wSoy4qiS,13496991,37863285,-24366294,615
2022-04-06 10:05:59-04:00,14672,DXGapgtgkag6midSCYNhHCNaCqvhUmuSvnVhXxNXBmyt,Csq6W5QkGZL6qE6Z1ERF3bfHtKjnM8hAxiY1YA3rTwSX,True,1114687619,278671904,1727335,863667,863668,YQC4EUcgeBi9431viwvzvBbZJW3szeHX4dFmowRDyDw,69093430,163333834,-94240404,619
2022-04-06 10:06:29-04:00,14673,5yPGvUz6JWKjkViGwTCpygJii1rP2xv5yx146ULtBiYq,FMnHUCQWTf1UHu5qVFqUAsWh8aba9EQYTEoiXy55totD,True,1482783274,138130232,860446,430223,430223,3zqXX6kzhkbW3d4TwD2CNjMRwxTbREXySekvq37kfCNk,92366127,251551904,-159185777,622
2022-04-06 10:06:39-04:00,14674,GRqv7y5n92vQ7bXcBqUng4vaau6w1tQeou953s8kJNwD,Bk75oioYmUzfdpbxDHTFb2nWhJgNqAt8ud1ehem3VVhh,True,4468782700,1117195675,6963139,3481569,3481570,3zqXX6kzhkbW3d4TwD2CNjMRwxTbREXySekvq37kfCNk,278525568,549187142,-270661574,623
2022-04-06 10:06:54-04:00,14675,SEndYVMCKAeZUKSqGrMUSqXFmxtA9M1t4eXsUhVsTBF,3fcQQcbkpqodakamn82pFnMxBEPL2Drsg4jJNZ6dx72M,True,1085696116,133372100,876033,438016,438017,3zqXX6kzhkbW3d4TwD2CNjMRwxTbREXySekvq37kfCNk,71312203,214131211,-142819008,656
2022-04-06 10:07:09-04:00,14676,GCweck6iuscBsVbXW9ZYfMytdgwSYWwNifTWLaUbaSmA,6HwGWKGduMGvLnHmTJo6ZioZ3EMUZYHo2pG4tBFXgB4Y,True,42197583,10549395,74344,37172,37172,YQC4EUcgeBi9431viwvzvBbZJW3szeHX4dFmowRDyDw,2973777,15417178,-12443401,704
2022-04-06 10:09:09-04:00,14677,JABfWoDV2wW68XEDANXArYWM7zabdbp5NBVrvzZd3mML,5hYUtd1Uv2pAcrbtSNNVTrRuk8acjmh92mzSm4iz5HJA,True,137180780,18364556,114457,57228,57229,3zqXX6kzhkbW3d4TwD2CNjMRwxTbREXySekvq37kfCNk,8549833,22721248,-14171415,623
2022-04-06 10:15:15-04:00,14678,J8khFNhJg25xVY7yjEtETTQVVzKHqdVCs1Rh2pJKvJqU,4eUP2YxTapjr6TLrd57XxZan7KJG5AtHK8yPRNVEbavx,True,1572692252,148179665,925788,462894,462894,3zqXX6kzhkbW3d4TwD2CNjMRwxTbREXySekvq37kfCNk,98257830,103566712,-5308882,624
2022-04-06 11:11:59-04:00,14679,GeYsENPRf2qGZu9rJsi6UPQqHS6sR7LRLWsKbFgtMCSb,7A79wktqPkSpP7o4c1kP9CBpUibHTqycW81ZANgREc5S,True,142281554,35570388,222096,111048,111048,3zqXX6kzhkbW3d4TwD2CNjMRwxTbREXySekvq37kfCNk,8883874,26683548,-17799674,624
2022-04-06 11:18:43-04:00,14680,D85pWm1LS9MvtR4f3QhkFLvNUhZLQ2NZBFQTyAVnmigm,CRN85DYkJJi6irhtVAf4qcJU3ijVodWdXgWe7Fs6Ahka,True,506970331,63666875,397818,198909,198909,3zqXX6kzhkbW3d4TwD2CNjMRwxTbREXySekvq37kfCNk,31677790,97837392,-66159602,624
2022-04-06 11:18:58-04:00,14681,FU7X4DWnGTbxwXULBq3v9SACzYhQyFGqsXjUDzyFqiem,925BaEnWxTfEv4oQb9Xf1wyyEEWEr8kXeSdXTtRfShfw,True,51047232714,3490915959,21756952,10878476,10878476,3zqXX6kzhkbW3d4TwD2CNjMRwxTbREXySekvq37kfCNk,3181492245,6103858575,-2922366330,623
2022-04-06 11:19:07-04:00,14682,eiLMepBYM3VcWarQJC9fTnxotyMuUTbyMGJECedPEfu,k2ZfwPNBBCK7PvZ6MEvELTHHtQZSXCRGCymvkZwhDDt,True,48950085,6922304,42332,21166,21166,A9TwRM1BMxqb8DCC7YNAMV6zPenEJm3HTZBy7wJKK58U,2993507,9083337,-6089830,611
2022-04-06 11:19:07-04:00,14683,8nFpzAFXELGPsrgFwRjTfUidNme1CvgKQTsHWATtMqkz,ABt8ikXHraZ1bqkDUvMtJ3AUzADDWcCL8kMMDpAoth8V,True,53004958,13251239,81869,40934,40935,A9TwRM1BMxqb8DCC7YNAMV6zPenEJm3HTZBy7wJKK58U,3274794,12302885,-9028091,617
2022-04-06 11:19:08-04:00,14684,7mhEMbGEpSYgYoZx6WvApjysTxsPqpCDSJCmKF45x3n6,12J2purUC4QYjaPKZwL3Y5P1JikTBD3oY9pLgY6yt6am,True,6532335059,1633083764,9963489,4981744,4981745,3zqXX6kzhkbW3d4TwD2CNjMRwxTbREXySekvq37kfCNk,398539566,812267815,-413728249,610
2022-04-06 11:19:10-04:00,14685,67DwuUmzk6uGwmptjYErQssFeJ5fd1ztFwKWZUovr7pK,HKzc15e1QLBrSsbAENyMXSVHDoap1F5MHCHB9L1Dm8HA,True,273673939,68418484,413526,206763,206763,3zqXX6kzhkbW3d4TwD2CNjMRwxTbREXySekvq37kfCNk,16541070,58337667,-41796597,604
2022-04-06 11:19:10-04:00,14686,5YC2wXkdk7D4Ubs9TEAbP1hi88Sy35bzYVWjLbgVxn5s,4Mx69ezqFK2wudZ62oVhx2pwjVbKv8JB1HR29ZUcdEJb,True,3963724359,990931089,6174650,3087325,3087325,YQC4EUcgeBi9431viwvzvBbZJW3szeHX4dFmowRDyDw,246986002,408413613,-161427611,623
2022-04-06 11:19:11-04:00,14687,AyFWvQUX79sq8L7KhcYrPRbxd6whUvEMETZL8atuuRr2,9LTjofdhGLn2Ltv6XfuHtX8MKEPzScGL669pC8Lrgtnh,True,32810900,8202725,49613,24806,24807,47z82br5WdW2DZajdnPDPSSRRKsyAggqXqK6oPUwTaLf,1984556,6050406,-4065850,604
2022-04-06 11:19:15-04:00,14688,5zSoXxVZYYQAtq3urfcUQmJkjFDBXkUJYSNFdq759Tof,3C459gJnmj4EYTG3tDFJEEf1aAT915sxRLs2THEdQqha,True,4028278643,246424612,1530524,765262,765262,3zqXX6kzhkbW3d4TwD2CNjMRwxTbREXySekvq37kfCNk,250193362,664866846,-414673484,621
2022-04-06 11:19:34-04:00,14689,AwT3pH9dHjECDnuUiazbD6tZxZHdNwgJ4vBMmxLHMiLo,AjybksvjMT1QT6KvryXCG47pQGT8v9jxM34VkveGPQrs,True,34902234,8725558,54398,27199,27199,YQC4EUcgeBi9431viwvzvBbZJW3szeHX4dFmowRDyDw,2175940,4447425,-2271485,623
2022-04-06 11:21:29-04:00,14690,FV9CBGGTbppLnBKh79f2LzD1diTiS5g6u89FcpZHZmnK,Fe7mtmCUziFqbbYTvrhAcAq1Ub7YLfTJRtQ1hG7GzJD1,True,36883957,9220989,57352,28676,28676,A9TwRM1BMxqb8DCC7YNAMV6zPenEJm3HTZBy7wJKK58U,2294085,5370164,-3076079,621
2022-04-06 11:21:29-04:00,14691,BAkPsWHtpVcEGqUgKTKjwZ6d5aaUcaUhdgYxBnpSTDW2,BDwDmVaZnXh22sf8nsDtjVfgxMAswbM3PW3si3k4nbRK,True,365884606,91471151,567994,283997,283997,A9TwRM1BMxqb8DCC7YNAMV6zPenEJm3HTZBy7wJKK58U,22719788,80942653,-58222865,620
2022-04-06 11:21:32-04:00,14692,niCk6QHFU1kyU56Mdq5RJzKrecdkNSn23ZA6wduFdWS,BQbUYSw1XsuE6LnVd4XjmxAyYgx4drE4FsetJBCdwVZW,True,924564785,231030438,1439867,719933,719934,3zqXX6kzhkbW3d4TwD2CNjMRwxTbREXySekvq37kfCNk,57622346,123513564,-65891218,623
2022-04-06 11:30:58-04:00,14693,EN2YBXcj7E1eAaYJYXJjc6Rfsu6Awjgv9kN3bT3uiprp,HYDG5mqfCy2xwrYKixNzoWyDiqb9KbpnA8H3TQG2EDDG,True,451330468,112832521,701548,350774,350774,3zqXX6kzhkbW3d4TwD2CNjMRwxTbREXySekvq37kfCNk,28061975,85162129,-57100154,621
2022-04-06 11:32:55-04:00,14694,5yPGvUz6JWKjkViGwTCpygJii1rP2xv5yx146ULtBiYq,FMnHUCQWTf1UHu5qVFqUAsWh8aba9EQYTEoiXy55totD,True,1335960678,116329604,720527,360263,360264,3zqXX6kzhkbW3d4TwD2CNjMRwxTbREXySekvq37kfCNk,82747395,236079717,-153332322,619
2022-04-06 11:32:58-04:00,14695,Br1j5Ftafei7ysu5SmqVZSoRe4uS4qCPeKSPHg55pyiE,G8fc7QvXjfkgBFvAVUgJFQS3VaF1biL9rktBExGa87Ks,True,2150009381,405565755,2519537,1259768,1259769,3zqXX6kzhkbW3d4TwD2CNjMRwxTbREXySekvq37kfCNk,133567266,177679785,-44112519,621
2022-04-06 11:32:59-04:00,14696,5zSoXxVZYYQAtq3urfcUQmJkjFDBXkUJYSNFdq759Tof,3C459gJnmj4EYTG3tDFJEEf1aAT915sxRLs2THEdQqha,True,3768246721,195025100,1216526,608263,608263,47z82br5WdW2DZajdnPDPSSRRKsyAggqXqK6oPUwTaLf,235055528,629274861,-394219333,623
2022-04-06 11:33:00-04:00,14697,CZhzJ91hP1pFbNNz7YnUKXznvs6ZFVSRNLbe1SaTw29o,X3B4LpHFfeJPmCnEmRQ8V6MNMi7KpTE4MLD7LHYXUwy,True,384162237,47437012,294223,147111,147112,A9TwRM1BMxqb8DCC7YNAMV6zPenEJm3HTZBy7wJKK58U,23827355,54572410,-30745055,620
2022-04-06 11:33:00-04:00,14698,EHLV9s6E1s5SUbzZVzsGWH2vVRGHyxynM4GDJtfKEuYe,4hAx9osegpeocSSmJbMVBYMKCwo5WY3QVJuK7cuzz4b4,True,42223695,10555923,75040,37520,37520,YQC4EUcgeBi9431viwvzvBbZJW3szeHX4dFmowRDyDw,3001613,15419062,-12417449,710
2022-04-06 11:33:39-04:00,14699,5qY8ZrqpHPqkAuXp6HpE2zC8qTfzsP8MXWSoxkZQV5jx,GPs3ap45TuHwHwmDb5bnKYHLBa5wj3AyuEsXcfHjEcAL,True,19093741,4773435,34065,17032,17033,YQC4EUcgeBi9431viwvzvBbZJW3szeHX4dFmowRDyDw,1362613,5845765,-4483152,713
2022-04-06 12:31:17-04:00,14700,CVjkHr29t8pzeXU1U1CdMpT6qwf9Jw4XGxvxU7RURPYj,D66Zpxp7q4Tn4KiLa2pHTrADhgtP8tGqNXVPyCo9mcxc,True,308817240,51802716,323204,161602,161602,YQC4EUcgeBi9431viwvzvBbZJW3szeHX4dFmowRDyDw,19267528,47331085,-28063557,623
2022-04-06 12:32:27-04:00,14701,6K1Xww22wVZuBwP6oYb3DPR5GvdxsQSiZ4WSmejQjyqf,8RoFHjv1TkGFqjKoSwzvyRNMoBP1ma1Hi2jy6FzD4i2g,True,248592598,60033047,374510,187255,187255,YQC4EUcgeBi9431viwvzvBbZJW3szeHX4dFmowRDyDw,15508215,24635818,-9127603,623
2022-04-06 12:36:08-04:00,14702,DVMLxFACqaNBD7q1TGJUUApJX7etJsxQRRFBP2DfBazJ,4hnRjD7S2KxD7UrgfrApntVxUD7Srh5E9nwPY53v89kz,True,353328843,32462295,211351,105675,105676,YQC4EUcgeBi9431viwvzvBbZJW3szeHX4dFmowRDyDw,23004131,72840495,-49836364,651
2022-04-06 12:38:07-04:00,14703,Gw37fsD8M3AaZ22tSx9WeszxsAkWQ6Ap2XV3zXYhe3EJ,FbKeJsWR5ggVBy1R5sxNiWz5GAsxeyZD8nmyk5yCBqSz,True,47707971,11926992,84446,42223,42223,YQC4EUcgeBi9431viwvzvBbZJW3szeHX4dFmowRDyDw,3377870,17303267,-13925397,708
2022-04-06 12:38:26-04:00,14704,7CSCMFa9W52tBDVUbXbc3woAy3GByeA1wPJdp3MgznPa,3447ptuVFu6G8B6N63RmS8mRv4n9PfHneypHLvbeaGLn,True,3183090834,580090753,3619277,1809638,1809639,YQC4EUcgeBi9431viwvzvBbZJW3szeHX4dFmowRDyDw,198598042,531385206,-332787164,623
2022-04-06 12:38:34-04:00,14705,FU7X4DWnGTbxwXULBq3v9SACzYhQyFGqsXjUDzyFqiem,925BaEnWxTfEv4oQb9Xf1wyyEEWEr8kXeSdXTtRfShfw,True,47328148729,3362607528,20812872,10406436,10406436,YQC4EUcgeBi9431viwvzvBbZJW3szeHX4dFmowRDyDw,2929377591,6037463781,-3108086190,618
2022-04-06 12:38:34-04:00,14706,FFDTcCW6UXKpkMnCefTRLpF8ZkJtS4sbGTjkcNU31Pxh,9v5oBZNrx4EATT8iHT5wNRJSo2rRPpazAYvPeaNe2Tpc,True,770356580,110190434,774711,387355,387356,3zqXX6kzhkbW3d4TwD2CNjMRwxTbREXySekvq37kfCNk,54161178,144718743,-90557565,703
2022-04-06 12:38:38-04:00,14707,BEATjyYuro1xc1kbgBoxBnVEk3usoUk9qwmdRndXdYW5,9RGBffhSMgab1KCM6dMvwiBENbnp5pERfCEjw4q5ckFS,True,158021183,39505295,266416,133208,133208,YQC4EUcgeBi9431viwvzvBbZJW3szeHX4dFmowRDyDw,10656648,40520132,-29863484,674
2022-04-06 12:38:43-04:00,14708,H1oYXGZTagwv48FdDe6RNkjNaesedqLKyXxTmPc5k4Fp,Am3rx6XrkrZ4MdeZDyZUv1YW2fBujcz4dLjVCnRQHKZa,True,42111786,10527946,65777,32888,32889,47z82br5WdW2DZajdnPDPSSRRKsyAggqXqK6oPUwTaLf,2631098,3850518,-1219420,624
2022-04-06 12:38:46-04:00,14709,J7YiZCKE32Em1wYdwPNQAivCRcwrWx4UcXvc7zTzmauT,4XNuM7skYZpRfJpzLSDTK3dTvq8vrhb8Eqa53Z5CqLRv,True,11012759469,2753189867,19481746,9740873,9740873,3zqXX6kzhkbW3d4TwD2CNjMRwxTbREXySekvq37kfCNk,779269861,4080592217,-3301322356,707
2022-04-06 12:39:06-04:00,14710,D85pWm1LS9MvtR4f3QhkFLvNUhZLQ2NZBFQTyAVnmigm,CRN85DYkJJi6irhtVAf4qcJU3ijVodWdXgWe7Fs6Ahka,True,439201390,62699007,387538,193769,193769,YQC4EUcgeBi9431viwvzvBbZJW3szeHX4dFmowRDyDw,27146738,88682350,-61535612,618
2022-04-06 12:39:08-04:00,14711,3BKX31xq3f13J2Zo8Wue4SYpCMWLXjgUt2nkwTTNfU2T,2pTxNAaV4pXRRUDE97ZFteBJn9tyktjh3FW1CWfwebci,True,219714813,54928703,330938,165469,165469,3zqXX6kzhkbW3d4TwD2CNjMRwxTbREXySekvq37kfCNk,13237553,38947505,-25709952,602
2022-04-06 12:39:10-04:00,14712,5yPGvUz6JWKjkViGwTCpygJii1rP2xv5yx146ULtBiYq,FMnHUCQWTf1UHu5qVFqUAsWh8aba9EQYTEoiXy55totD,True,1211928030,114278080,700121,350060,350061,3zqXX6kzhkbW3d4TwD2CNjMRwxTbREXySekvq37kfCNk,74248430,222389059,-148140629,612
2022-04-06 12:40:09-04:00,14713,29JVska5UEG3axs63EmtHpPvkswNEqYpZ3PKMSfupiAG,DCftNBUsuogxyaJe9G9m3eWipH6o3qo4Rn4TuQXdVaBF,True,19438279,4859569,29068,14534,14534,YQC4EUcgeBi9431viwvzvBbZJW3szeHX4dFmowRDyDw,1162732,4677523,-3514791,598
2022-04-06 12:40:09-04:00,14714,9WH1YzDrdvZs8aDuFLwQHHXa2e66ZcwdfDi7qXEjQxFy,3Tpc8DqJwg1tTDgk6qH1UhvtwvhXxsp5GRFYMWxa8NKX,True,6461116693,1615279173,9845469,4922734,4922735,YQC4EUcgeBi9431viwvzvBbZJW3szeHX4dFmowRDyDw,393818798,923514865,-529696067,609
2022-04-06 12:40:09-04:00,14715,DVMLxFACqaNBD7q1TGJUUApJX7etJsxQRRFBP2DfBazJ,4hnRjD7S2KxD7UrgfrApntVxUD7Srh5E9nwPY53v89kz,True,318579769,26138479,168245,84122,84123,YQC4EUcgeBi9431viwvzvBbZJW3szeHX4dFmowRDyDw,20506001,67591629,-47085628,643
2022-04-06 12:40:09-04:00,14716,2i5g7q4gD1GEfSz8BkhKn1idQ5U7cFPbMDWugjr7bBQW,Dpx6K9G5uZD63rTzBafZ56WKd1X9M25Mzfppd7Jib4xn,True,3582202498,895550624,5391589,2695794,2695795,YQC4EUcgeBi9431viwvzvBbZJW3szeHX4dFmowRDyDw,215663594,868884570,-653220976,602
2022-04-06 12:40:15-04:00,14717,EBRWnRzoNv5RytEjgrs5TXdiCMApLKHMntJJJzehJJns,5nJiYTa3GEbmaRwY1PvBJ1teXikQKgbUop5ANgaDhhcP,True,41876431,10469107,62155,31077,31078,A9TwRM1BMxqb8DCC7YNAMV6zPenEJm3HTZBy7wJKK58U,2486214,7015522,-4529308,593
2022-04-06 12:40:21-04:00,14718,SEndYVMCKAeZUKSqGrMUSqXFmxtA9M1t4eXsUhVsTBF,3fcQQcbkpqodakamn82pFnMxBEPL2Drsg4jJNZ6dx72M,True,942082438,101012766,669721,334860,334861,3zqXX6kzhkbW3d4TwD2CNjMRwxTbREXySekvq37kfCNk,62460743,208469764,-146009021,663
2022-04-06 12:40:21-04:00,14719,4GbUrgiR6A91h3J9HHpuYCkZzjwrb62n3BURLeWj6Nic,12nUFUGYF1rXbwPeCbdGKdP3RE4g984fmZZggEYSFTZn,True,152748239,38187059,230128,115064,115064,3zqXX6kzhkbW3d4TwD2CNjMRwxTbREXySekvq37kfCNk,9205159,35973712,-26768553,602
2022-04-06 12:42:17-04:00,14720,FoGtu9wcVbBmATBKtBMWvbRd558yzSDT5dPBTBJgzqFT,9rnvQvgQtkT7RSdDpZHnkTVd2V9CMRBSB7v79GDip4hS,True,440664666,110166166,687959,343979,343980,3zqXX6kzhkbW3d4TwD2CNjMRwxTbREXySekvq37kfCNk,27518371,63337902,-35819531,624
2022-04-06 13:04:27-04:00,14721,CZhzJ91hP1pFbNNz7YnUKXznvs6ZFVSRNLbe1SaTw29o,X3B4LpHFfeJPmCnEmRQ8V6MNMi7KpTE4MLD7LHYXUwy,True,334007208,35418759,220267,110133,110134,A9TwRM1BMxqb8DCC7YNAMV6zPenEJm3HTZBy7wJKK58U,20771791,51581821,-30810030,621
2022-04-06 13:04:39-04:00,14722,EC8fafqtuQzqbm2TZs3GeuXB9qXomkykrTG1na2rfFpx,A72f7W58h3r8nut45RmqdTk1J31NGYT2sVWMn18dK885,True,100498419,25124604,156505,78252,78253,YQC4EUcgeBi9431viwvzvBbZJW3szeHX4dFmowRDyDw,6260226,12575538,-6315312,622
2022-04-06 13:04:40-04:00,14723,B3NyyoWNzyzvpWv1G6a9gZJMjD1sTQBdZojBaH18mNjY,BCj3EGFMhJ9wh4KvF9cqYsuNHug7kCbALFMLMtuh24bq,True,3497043071,874260767,5438028,2719014,2719014,A9TwRM1BMxqb8DCC7YNAMV6zPenEJm3HTZBy7wJKK58U,217521133,575392358,-357871225,622
2022-04-06 13:04:44-04:00,14724,7BEY9qatFJomsayFmky3h3dAbKhY5XkRGwMobJuxXYhQ,J8MK3tAQKreBUG2reXY6gqr1uhbHhcAZEcxsLQmG5Ntt,True,7438449106,1859612276,13168313,6584156,6584157,YQC4EUcgeBi9431viwvzvBbZJW3szeHX4dFmowRDyDw,526732545,1017205342,-490472797,708
2022-04-06 13:04:48-04:00,14725,FU7X4DWnGTbxwXULBq3v9SACzYhQyFGqsXjUDzyFqiem,925BaEnWxTfEv4oQb9Xf1wyyEEWEr8kXeSdXTtRfShfw,True,43762887483,3087999964,19083255,9541627,9541628,A9TwRM1BMxqb8DCC7YNAMV6zPenEJm3HTZBy7wJKK58U,2704463705,5805442494,-3100978789,617
2022-04-06 13:05:18-04:00,14726,eiLMepBYM3VcWarQJC9fTnxotyMuUTbyMGJECedPEfu,k2ZfwPNBBCK7PvZ6MEvELTHHtQZSXCRGCymvkZwhDDt,True,41666805,5267491,32709,16354,16355,A9TwRM1BMxqb8DCC7YNAMV6zPenEJm3HTZBy7wJKK58U,2587370,7845009,-5257639,620
2022-04-06 13:05:28-04:00,14727,7AizMrxWWr7qfneuXMy6ifL3BVDTAKkuud4PyZFy92kh,GyAWRRfQkVAXtyhVF14vU3kPMr4kG1VyA9FAHdDTr8ud,True,722301711,180575427,1118964,559482,559482,3zqXX6kzhkbW3d4TwD2CNjMRwxTbREXySekvq37kfCNk,44758582,74702497,-29943915,619
2022-04-06 13:05:42-04:00,14728,2xgQaQTs7bkK34jSBZ2dFZf1DJKjMVW9LA3D9Pwtfims,6rniSBeGcJAcrqWhhnKCcRV58yYnjuqXj9b4Zu8DUwQ9,True,42763550,10165890,63463,31731,31732,72FwbpFGoLEazJEdpqNtPNefsadUrimUqma9wSoy4qiS,2669651,8703538,-6033887,624
2022-04-06 13:06:23-04:00,14729,JABfWoDV2wW68XEDANXArYWM7zabdbp5NBVrvzZd3mML,5hYUtd1Uv2pAcrbtSNNVTrRuk8acjmh92mzSm4iz5HJA,True,117746730,15838454,98587,49293,49294,YQC4EUcgeBi9431viwvzvBbZJW3szeHX4dFmowRDyDw,7329261,20388923,-13059662,622
2022-04-06 13:06:26-04:00,14730,5yPGvUz6JWKjkViGwTCpygJii1rP2xv5yx146ULtBiYq,FMnHUCQWTf1UHu5qVFqUAsWh8aba9EQYTEoiXy55totD,True,1092344282,101487104,633240,316620,316620,3zqXX6kzhkbW3d4TwD2CNjMRwxTbREXySekvq37kfCNk,68158153,207306002,-139147849,623
2022-04-06 13:06:28-04:00,14731,8qq2gfbca7JXvq4gViBBVT2QAbM4MvBMEQLXgn8UUTvt,3o5jpBVYdFFEYrGRdCUkLrUC85wsuTKgy8iYwnpZyC1B,True,1658307655,163290927,1008723,504361,504362,3zqXX6kzhkbW3d4TwD2CNjMRwxTbREXySekvq37kfCNk,102441284,617725583,-515284299,617
2022-04-06 13:06:35-04:00,14732,5F7WHSYiVtCY8Z9KX9h6AT8qr4hbsSYasG15fq82ZWhr,E5wj8cqKM1ofNv14TspTa8yRwern8y2w6pXekL4cAWX7,True,70539999,17634999,105798,52899,52899,YQC4EUcgeBi9431viwvzvBbZJW3szeHX4dFmowRDyDw,4231940,8677061,-4445121,599
2022-04-06 13:06:36-04:00,14733,F2AU2PjaSmHxWWhkz8XxMggkCMWbMVgawt89tSnYS6RL,ET9febRJiW197DYMaJbgk3kWsAeFv5f4peQ4vFCVppK6,True,21014367,5253591,37406,18703,18703,3zqXX6kzhkbW3d4TwD2CNjMRwxTbREXySekvq37kfCNk,1496263,8322808,-6826545,712
2022-04-06 13:10:34-04:00,14734,D85pWm1LS9MvtR4f3QhkFLvNUhZLQ2NZBFQTyAVnmigm,CRN85DYkJJi6irhtVAf4qcJU3ijVodWdXgWe7Fs6Ahka,True,373083419,46765495,292214,146107,146107,3zqXX6kzhkbW3d4TwD2CNjMRwxTbREXySekvq37kfCNk,23312179,80078320,-56766141,624
2022-04-06 13:11:23-04:00,14735,EHLV9s6E1s5SUbzZVzsGWH2vVRGHyxynM4GDJtfKEuYe,4hAx9osegpeocSSmJbMVBYMKCwo5WY3QVJuK7cuzz4b4,True,30952244,7738061,55077,27538,27539,YQC4EUcgeBi9431viwvzvBbZJW3szeHX4dFmowRDyDw,2203109,12231956,-10028847,711
2022-04-06 13:11:23-04:00,14736,GCweck6iuscBsVbXW9ZYfMytdgwSYWwNifTWLaUbaSmA,6HwGWKGduMGvLnHmTJo6ZioZ3EMUZYHo2pG4tBFXgB4Y,True,30913879,7728469,53936,26968,26968,YQC4EUcgeBi9431viwvzvBbZJW3szeHX4dFmowRDyDw,2157451,12224542,-10067091,697
2022-04-06 13:12:01-04:00,14737,5FewDaMC9U7n5EHcto98GaAmDVxDh5SYimuTP6AtfakM,7DAULUoqV7f9hsBzKEhjQPnWaHSqiMWcBqWcdcadaQv4,True,1887163656,238507198,1490541,745270,745271,3zqXX6kzhkbW3d4TwD2CNjMRwxTbREXySekvq37kfCNk,117937576,228892810,-110955234,624
2022-04-06 13:12:31-04:00,14738,DVMLxFACqaNBD7q1TGJUUApJX7etJsxQRRFBP2DfBazJ,4hnRjD7S2KxD7UrgfrApntVxUD7Srh5E9nwPY53v89kz,True,290928801,29218133,188933,94466,94467,3zqXX6kzhkbW3d4TwD2CNjMRwxTbREXySekvq37kfCNk,18812416,61901147,-43088731,646
2022-04-06 13:12:38-04:00,14739,7CSCMFa9W52tBDVUbXbc3woAy3GByeA1wPJdp3MgznPa,3447ptuVFu6G8B6N63RmS8mRv4n9PfHneypHLvbeaGLn,True,2567291876,428232343,2653268,1326634,1326634,YQC4EUcgeBi9431viwvzvBbZJW3szeHX4dFmowRDyDw,159065867,472602162,-313536295,619
2022-04-06 13:12:57-04:00,14740,5yPGvUz6JWKjkViGwTCpygJii1rP2xv5yx146ULtBiYq,FMnHUCQWTf1UHu5qVFqUAsWh8aba9EQYTEoiXy55totD,True,984876341,85636499,535134,267567,267567,3zqXX6kzhkbW3d4TwD2CNjMRwxTbREXySekvq37kfCNk,61544076,193649571,-132105495,624
2022-04-06 13:13:12-04:00,14741,2NQ897mWoc9mBoxsVdEaYNpwPyy83KUrTkizRBZQPbEq,2QpX34D9y2WVGcCkbRgjkADpR313NqRbTr5pAVXvSjqz,True,496545780,124136445,774107,387053,387054,3zqXX6kzhkbW3d4TwD2CNjMRwxTbREXySekvq37kfCNk,30964285,98401496,-67437211,623
2022-04-06 14:02:52-04:00,14742,DXGapgtgkag6midSCYNhHCNaCqvhUmuSvnVhXxNXBmyt,Csq6W5QkGZL6qE6Z1ERF3bfHtKjnM8hAxiY1YA3rTwSX,True,4011051799,1002762949,6263584,3131792,3131792,3zqXX6kzhkbW3d4TwD2CNjMRwxTbREXySekvq37kfCNk,250543374,386820027,-136276653,624
2022-04-06 14:15:35-04:00,14743,niCk6QHFU1kyU56Mdq5RJzKrecdkNSn23ZA6wduFdWS,BQbUYSw1XsuE6LnVd4XjmxAyYgx4drE4FsetJBCdwVZW,True,991728695,247821075,1518285,759142,759143,3zqXX6kzhkbW3d4TwD2CNjMRwxTbREXySekvq37kfCNk,60758672,105343924,-44585252,612
2022-04-06 14:24:15-04:00,14744,2ssYxbmFPYBdse9a6NJ26M8hsscYpjv5MyqyYkjftdrL,FKvvXz9eYXW2zgy37eaUW9u2K9LnnDsNx3DcgtATpizY,True,201025914,50256478,311943,155971,155972,3zqXX6kzhkbW3d4TwD2CNjMRwxTbREXySekvq37kfCNk,12477745,28982907,-16505162,620
2022-04-06 14:24:32-04:00,14745,FncFHJooh1hy9Gc2y5sKdcYkZ5uHzsxHG4vHT9cVZGcK,BkFa4b5Jyv4ZJCCpwDYv355ezVFiZfAtn18AV7kstd2v,True,3478112122,869528030,5382946,2691473,2691473,3zqXX6kzhkbW3d4TwD2CNjMRwxTbREXySekvq37kfCNk,215317861,360488687,-145170826,619
2022-04-06 14:24:40-04:00,14746,EVzAZ7gH1v4VtRXiTdNnkp2PGS3W4M5PkSXGMDyLwUmC,2FkTeSCVRjNE5i9qRnKLZjBGsXL2sWEurxLERYo1cQsd,True,239906821,59976705,369173,184586,184587,3zqXX6kzhkbW3d4TwD2CNjMRwxTbREXySekvq37kfCNk,14766946,24684270,-9917324,615
2022-04-06 14:24:47-04:00,14747,FFDTcCW6UXKpkMnCefTRLpF8ZkJtS4sbGTjkcNU31Pxh,9v5oBZNrx4EATT8iHT5wNRJSo2rRPpazAYvPeaNe2Tpc,True,652693934,81732668,571758,285879,285879,YQC4EUcgeBi9431viwvzvBbZJW3szeHX4dFmowRDyDw,45659033,135821600,-90162567,699
2022-04-06 14:25:01-04:00,14748,8K1GzGeaAuFdjuVZi6DqBcYiA1zSRioMkRvjotr8p7fz,5mqocPwTdjwAPiJf7vx9bo7AzvfQBT2t5bV9u2Jzb2e1,True,463690153,115922538,781309,390654,390655,3zqXX6kzhkbW3d4TwD2CNjMRwxTbREXySekvq37kfCNk,31252378,98626343,-67373965,673
2022-04-06 14:25:04-04:00,14749,FU7X4DWnGTbxwXULBq3v9SACzYhQyFGqsXjUDzyFqiem,925BaEnWxTfEv4oQb9Xf1wyyEEWEr8kXeSdXTtRfShfw,True,40525777510,2747810107,17162830,8581415,8581415,3zqXX6kzhkbW3d4TwD2CNjMRwxTbREXySekvq37kfCNk,2531241327,5563539040,-3032297713,624
2022-04-06 18:14:24-04:00,14750,niCk6QHFU1kyU56Mdq5RJzKrecdkNSn23ZA6wduFdWS,BQbUYSw1XsuE6LnVd4XjmxAyYgx4drE4FsetJBCdwVZW,True,817011928,204237304,1249111,624555,624556,3zqXX6kzhkbW3d4TwD2CNjMRwxTbREXySekvq37kfCNk,49968285,92487214,-42518929,611
2022-04-06 18:59:27-04:00,14751,AwT3pH9dHjECDnuUiazbD6tZxZHdNwgJ4vBMmxLHMiLo,AjybksvjMT1QT6KvryXCG47pQGT8v9jxM34VkveGPQrs,True,25656876,6414219,39703,19851,19852,A9TwRM1BMxqb8DCC7YNAMV6zPenEJm3HTZBy7wJKK58U,1588147,3811582,-2223435,618
2022-04-06 18:59:38-04:00,14752,niCk6QHFU1kyU56Mdq5RJzKrecdkNSn23ZA6wduFdWS,BQbUYSw1XsuE6LnVd4XjmxAyYgx4drE4FsetJBCdwVZW,True,601647895,150396599,939774,469887,469887,YQC4EUcgeBi9431viwvzvBbZJW3szeHX4dFmowRDyDw,37594875,80638954,-43044079,624
2022-04-06 18:59:57-04:00,14753,6RuQVU9nu2Ecp177M9ggWczLACvQ8PfT31RTcmfwe9Hq,DZgsgqvMNLTXkBxySZC7Monak2JGsXRMJT4hBQzpf6Xm,True,7808246712,1952061678,12083670,6041835,6041835,YQC4EUcgeBi9431viwvzvBbZJW3szeHX4dFmowRDyDw,483346825,770024035,-286677210,619
2022-04-06 19:00:00-04:00,14754,JABfWoDV2wW68XEDANXArYWM7zabdbp5NBVrvzZd3mML,5hYUtd1Uv2pAcrbtSNNVTrRuk8acjmh92mzSm4iz5HJA,True,101008709,13459204,83948,41974,41974,3zqXX6kzhkbW3d4TwD2CNjMRwxTbREXySekvq37kfCNk,6300164,18805769,-12505605,623
2022-04-06 19:00:13-04:00,14755,C3DnHRyndQw1EinnmrayLzuhP9KhXYKVDUpf55BumxG1,6aU3EvNk5CyD5LdGhQksYKkNxvJ5vw23JvMEdwqeDSMo,True,6844490417,1711122604,10681424,5340712,5340712,3zqXX6kzhkbW3d4TwD2CNjMRwxTbREXySekvq37kfCNk,427256978,1746805447,-1319548469,624
2022-04-06 19:06:23-04:00,14756,7tFD53kPTqrzjCu1Wji78gUqhoRtCUhsP1pM3DQKT7uG,BJvgPLYBDJrQJdQVowrsMwUGMurq4zTihoFwWoEokfu3,True,7572002387,1276943138,7903198,3951599,3951599,3zqXX6kzhkbW3d4TwD2CNjMRwxTbREXySekvq37kfCNk,468642979,1247022610,-778379631,618
2022-04-06 19:06:40-04:00,14757,7yW1M1xeVx4hy3QftnpqdBDRYwamfu3K5i6AEnxgyTWb,7wf7FWS2DYp5RveQAmGNXAEUWPcHziuMLd4hV5LPgxF8,True,16450832,4112708,25477,12738,12739,A9TwRM1BMxqb8DCC7YNAMV6zPenEJm3HTZBy7wJKK58U,1019109,3552644,-2533535,619
2022-04-06 19:08:49-04:00,14758,EN2YBXcj7E1eAaYJYXJjc6Rfsu6Awjgv9kN3bT3uiprp,HYDG5mqfCy2xwrYKixNzoWyDiqb9KbpnA8H3TQG2EDDG,True,331866625,82966561,516683,258341,258342,YQC4EUcgeBi9431viwvzvBbZJW3szeHX4dFmowRDyDw,20667396,70127939,-49460543,622
2022-04-06 19:38:34-04:00,14759,CZhzJ91hP1pFbNNz7YnUKXznvs6ZFVSRNLbe1SaTw29o,X3B4LpHFfeJPmCnEmRQ8V6MNMi7KpTE4MLD7LHYXUwy,True,296653204,26327012,164407,82203,82204,YQC4EUcgeBi9431viwvzvBbZJW3szeHX4dFmowRDyDw,18525544,49121851,-30596307,624
2022-04-06 19:42:02-04:00,14760,6eEifGxGRBnXV5EW2BwmCj8pa67znMjet98Nsq11LCsd,Dd4UCEX7tm6Q82SdSSFX9wBcJNw5TwKu8EyGjvxi9FVc,True,652891887,163222971,1013035,506517,506518,YQC4EUcgeBi9431viwvzvBbZJW3szeHX4dFmowRDyDw,40521409,110457446,-69936037,620
2022-04-06 19:42:16-04:00,14761,GeYsENPRf2qGZu9rJsi6UPQqHS6sR7LRLWsKbFgtMCSb,7A79wktqPkSpP7o4c1kP9CBpUibHTqycW81ZANgREc5S,True,104534100,26133525,161208,80604,80604,3zqXX6kzhkbW3d4TwD2CNjMRwxTbREXySekvq37kfCNk,6448359,21975341,-15526982,616
2022-04-06 19:42:51-04:00,14762,67DwuUmzk6uGwmptjYErQssFeJ5fd1ztFwKWZUovr7pK,HKzc15e1QLBrSsbAENyMXSVHDoap1F5MHCHB9L1Dm8HA,True,201300732,50325183,302563,151281,151282,3zqXX6kzhkbW3d4TwD2CNjMRwxTbREXySekvq37kfCNk,12102540,47405320,-35302780,601
2022-04-06 19:42:52-04:00,14763,AyFWvQUX79sq8L7KhcYrPRbxd6whUvEMETZL8atuuRr2,9LTjofdhGLn2Ltv6XfuHtX8MKEPzScGL669pC8Lrgtnh,True,24135150,6033787,36337,18168,18169,YQC4EUcgeBi9431viwvzvBbZJW3szeHX4dFmowRDyDw,1453492,4975914,-3522422,602
2022-04-06 19:42:54-04:00,14764,8nFpzAFXELGPsrgFwRjTfUidNme1CvgKQTsHWATtMqkz,ABt8ikXHraZ1bqkDUvMtJ3AUzADDWcCL8kMMDpAoth8V,True,38919690,9729922,58632,29316,29316,3zqXX6kzhkbW3d4TwD2CNjMRwxTbREXySekvq37kfCNk,2345286,9950407,-7605121,602
2022-04-06 19:42:54-04:00,14765,5YC2wXkdk7D4Ubs9TEAbP1hi88Sy35bzYVWjLbgVxn5s,4Mx69ezqFK2wudZ62oVhx2pwjVbKv8JB1HR29ZUcdEJb,True,2911014674,727753668,4450366,2225183,2225183,3zqXX6kzhkbW3d4TwD2CNjMRwxTbREXySekvq37kfCNk,178014664,360979203,-182964539,611
2022-04-06 19:42:56-04:00,14766,FV9CBGGTbppLnBKh79f2LzD1diTiS5g6u89FcpZHZmnK,Fe7mtmCUziFqbbYTvrhAcAq1Ub7YLfTJRtQ1hG7GzJD1,True,27110835,6777708,41877,20938,20939,3zqXX6kzhkbW3d4TwD2CNjMRwxTbREXySekvq37kfCNk,1675119,4534322,-2859203,617
2022-04-06 19:45:50-04:00,14767,29JVska5UEG3axs63EmtHpPvkswNEqYpZ3PKMSfupiAG,DCftNBUsuogxyaJe9G9m3eWipH6o3qo4Rn4TuQXdVaBF,False,14322491,14322491,873233,43661,829572,3zqXX6kzhkbW3d4TwD2CNjMRwxTbREXySekvq37kfCNk,873233,3765549,-2892316,609
2022-04-06 19:45:50-04:00,14768,EBRWnRzoNv5RytEjgrs5TXdiCMApLKHMntJJJzehJJns,5nJiYTa3GEbmaRwY1PvBJ1teXikQKgbUop5ANgaDhhcP,True,30849257,7712314,46422,23211,23211,3zqXX6kzhkbW3d4TwD2CNjMRwxTbREXySekvq37kfCNk,1856916,5811978,-3955062,601
2022-04-06 19:45:53-04:00,14769,4GbUrgiR6A91h3J9HHpuYCkZzjwrb62n3BURLeWj6Nic,12nUFUGYF1rXbwPeCbdGKdP3RE4g984fmZZggEYSFTZn,True,112517279,28129319,172450,86225,86225,3zqXX6kzhkbW3d4TwD2CNjMRwxTbREXySekvq37kfCNk,6898022,29018532,-22120510,613
2022-04-06 19:45:59-04:00,14770,9WH1YzDrdvZs8aDuFLwQHHXa2e66ZcwdfDi7qXEjQxFy,3Tpc8DqJwg1tTDgk6qH1UhvtwvhXxsp5GRFYMWxa8NKX,True,4758524000,1189631000,7381482,3690741,3690741,47z82br5WdW2DZajdnPDPSSRRKsyAggqXqK6oPUwTaLf,295259297,780164224,-484904927,620
2022-04-06 19:46:00-04:00,14771,2i5g7q4gD1GEfSz8BkhKn1idQ5U7cFPbMDWugjr7bBQW,Dpx6K9G5uZD63rTzBafZ56WKd1X9M25Mzfppd7Jib4xn,True,2638180487,659545121,4025603,2012801,2012802,A9TwRM1BMxqb8DCC7YNAMV6zPenEJm3HTZBy7wJKK58U,161024151,699518546,-538494395,610
2022-04-06 19:46:03-04:00,14772,eiLMepBYM3VcWarQJC9fTnxotyMuUTbyMGJECedPEfu,k2ZfwPNBBCK7PvZ6MEvELTHHtQZSXCRGCymvkZwhDDt,True,36093002,5063400,31427,15713,15714,A9TwRM1BMxqb8DCC7YNAMV6zPenEJm3HTZBy7wJKK58U,2240230,7427180,-5186950,620
2022-04-06 19:46:25-04:00,14773,5FewDaMC9U7n5EHcto98GaAmDVxDh5SYimuTP6AtfakM,7DAULUoqV7f9hsBzKEhjQPnWaHSqiMWcBqWcdcadaQv4,True,1634187560,231709403,1441183,720591,720592,3zqXX6kzhkbW3d4TwD2CNjMRwxTbREXySekvq37kfCNk,101643049,215056230,-113413181,621
2022-04-06 19:46:27-04:00,14774,EDzP8bi8wGytnFoz4RynYddWyVWd5RFhHKcGZdwyAHJH,ELHWRXKjwkmoEj3nkJ9hw2bcL6dRd4znFeoLjitNbrXt,True,56471694,14117923,87997,43998,43999,3zqXX6kzhkbW3d4TwD2CNjMRwxTbREXySekvq37kfCNk,3519892,12977981,-9458089,623
2022-04-06 19:46:33-04:00,14775,3uUdWwgwtFdPa3FJTSrirqPKMtQb3zmT5Wpp4zPy9sJP,5G7dhz8jvWekGy9Wh3ZCXNXSPbB1QArfFYs7MYNgRDkW,True,237694188,59423547,370579,185289,185290,3zqXX6kzhkbW3d4TwD2CNjMRwxTbREXySekvq37kfCNk,14823181,67745534,-52922353,623
2022-04-06 19:46:49-04:00,14776,DVMLxFACqaNBD7q1TGJUUApJX7etJsxQRRFBP2DfBazJ,4hnRjD7S2KxD7UrgfrApntVxUD7Srh5E9nwPY53v89kz,True,260087004,23690394,153695,76847,76848,3zqXX6kzhkbW3d4TwD2CNjMRwxTbREXySekvq37kfCNk,16873597,59162414,-42288817,648
2022-04-06 19:46:55-04:00,14777,BTq6T9nDzYTPTRvxkhNLn82DF3RCWdRkatZUmSTGCu43,3Uuhmxo4tWMbrqowx2bQSJeWzMykUUcZanj29ptCmEa6,True,6944328243,1420222385,8853260,4426630,4426630,3zqXX6kzhkbW3d4TwD2CNjMRwxTbREXySekvq37kfCNk,432889598,1432337437,-999447839,623
2022-04-06 19:49:24-04:00,14778,FoGtu9wcVbBmATBKtBMWvbRd558yzSDT5dPBTBJgzqFT,9rnvQvgQtkT7RSdDpZHnkTVd2V9CMRBSB7v79GDip4hS,True,323851073,80962768,502185,251092,251093,3zqXX6kzhkbW3d4TwD2CNjMRwxTbREXySekvq37kfCNk,20087422,53600983,-33513561,620
2022-04-06 19:50:56-04:00,14779,2xgQaQTs7bkK34jSBZ2dFZf1DJKjMVW9LA3D9Pwtfims,6rniSBeGcJAcrqWhhnKCcRV58yYnjuqXj9b4Zu8DUwQ9,True,31998251,7475795,46701,23350,23351,YQC4EUcgeBi9431viwvzvBbZJW3szeHX4dFmowRDyDw,1998955,7133796,-5134841,624
2022-04-06 19:51:42-04:00,14780,8qq2gfbca7JXvq4gViBBVT2QAbM4MvBMEQLXgn8UUTvt,3o5jpBVYdFFEYrGRdCUkLrUC85wsuTKgy8iYwnpZyC1B,True,1480175574,125617406,783825,391912,391913,3zqXX6kzhkbW3d4TwD2CNjMRwxTbREXySekvq37kfCNk,92359835,611478448,-519118613,623
2022-04-06 19:52:09-04:00,14781,DDdxcAmfFWLs79vYC1WUuwBVM1XUfxmAgbYgccL5bgZg,3tKaUfHU3Z7v1LDm581yDd1bpfnxLgGHCWTNur3KLptz,True,2046857707,511714426,3053015,1526507,1526508,YQC4EUcgeBi9431viwvzvBbZJW3szeHX4dFmowRDyDw,122120601,411762789,-289642188,596
2022-04-06 19:52:10-04:00,14782,HAYyyvAkeSMiGinBzRCDmetVFE7ySzdeUSw3zJ2RoBPL,G5sNGj5DdYCpcfERmSbXAcaueXHEJKZTQ3YyVJdcHKwd,True,13435549457,3358887364,20411251,10205625,10205626,YQC4EUcgeBi9431viwvzvBbZJW3szeHX4dFmowRDyDw,816450061,3131028090,-2314578029,607
2022-04-06 19:52:13-04:00,14783,6Auz7aARPERW9zbV8428yFUWkA9DuitQYiWQzewueU3o,G1xfLGt5twz7MTfEq6NnMZBpr6GmXceKdGUQkc9jugRB,True,27775372,6943843,41396,20698,20698,YQC4EUcgeBi9431viwvzvBbZJW3szeHX4dFmowRDyDw,1655875,7236288,-5580413,596
2022-04-06 19:52:33-04:00,14784,68zbVKnneMQqngbNkeLtPEP2ayNhawc1B2hPgqAEqgXK,HqiFpLr4NC7xJz9bEFusq8bCKaoxAQG1xsLxdUAzg8aa,True,14068156782,2321195715,14456515,7228257,7228258,YQC4EUcgeBi9431viwvzvBbZJW3szeHX4dFmowRDyDw,876171434,1971143509,-1094972075,622
2022-04-06 19:52:40-04:00,14785,GgJXh5hTo4xyVuuGEis971RRXcZECLpjvtMSCZtVu13Q,9BGMfGfMZNXdcygAuqYQudWHhSE5LqVoWsNsruCawnRK,True,40975535,10243883,63106,31553,31553,3zqXX6kzhkbW3d4TwD2CNjMRwxTbREXySekvq37kfCNk,2524245,5071400,-2547155,616
2022-04-06 19:53:14-04:00,14786,A5NXadGWnFZRoHEn1dKTRjcXgWmfMLMyJdpF4rQPZyRR,ALs3Zfotc4c4A6TFDMbd5GM5whK1dTYSnGrHiMBWmApH,True,3023054218,755762972,4684115,2342057,2342058,3zqXX6kzhkbW3d4TwD2CNjMRwxTbREXySekvq37kfCNk,187364788,820944813,-633580025,619
2022-04-06 19:53:36-04:00,14787,Gp1V4ymYEQH9jeZsqPERVfwqoQYUPESUmgKCMaDqoh6u,BBe1Vd8RZuqqC7VkUixgMYA1CfLXMaEvq8J571j8ueMQ,True,2873628849,718407212,4335539,2167769,2167770,3zqXX6kzhkbW3d4TwD2CNjMRwxTbREXySekvq37kfCNk,173421572,528661844,-355240272,603
2022-04-06 19:54:32-04:00,14788,BTwSuuDHNhQAFAzBZRWev5j1ix2RTWvjZAxLpw8grAxu,31NCyUpSXxxJYLSrdK3c5bLomUtMejobMfYnq7j71GtM,True,495932131,123983032,774567,387283,387284,YQC4EUcgeBi9431viwvzvBbZJW3szeHX4dFmowRDyDw,30982690,92325105,-61342415,624
2022-04-06 19:54:40-04:00,14789,5yPGvUz6JWKjkViGwTCpygJii1rP2xv5yx146ULtBiYq,FMnHUCQWTf1UHu5qVFqUAsWh8aba9EQYTEoiXy55totD,True,894175316,84279480,524978,262489,262489,YQC4EUcgeBi9431viwvzvBbZJW3szeHX4dFmowRDyDw,55698348,181584948,-125886600,622
2022-04-06 19:55:25-04:00,14790,niCk6QHFU1kyU56Mdq5RJzKrecdkNSn23ZA6wduFdWS,BQbUYSw1XsuE6LnVd4XjmxAyYgx4drE4FsetJBCdwVZW,True,440156600,110024091,639280,319640,319640,3zqXX6kzhkbW3d4TwD2CNjMRwxTbREXySekvq37kfCNk,25574733,68968142,-43393409,581
2022-04-06 19:56:45-04:00,14791,C3DnHRyndQw1EinnmrayLzuhP9KhXYKVDUpf55BumxG1,6aU3EvNk5CyD5LdGhQksYKkNxvJ5vw23JvMEdwqeDSMo,True,5029101867,1257275466,7807740,3903870,3903870,3zqXX6kzhkbW3d4TwD2CNjMRwxTbREXySekvq37kfCNk,312309608,1406632702,-1094323094,621
2022-04-06 19:56:49-04:00,14792,7yW1M1xeVx4hy3QftnpqdBDRYwamfu3K5i6AEnxgyTWb,7wf7FWS2DYp5RveQAmGNXAEUWPcHziuMLd4hV5LPgxF8,False,12096150,12096150,751658,37582,714076,3zqXX6kzhkbW3d4TwD2CNjMRwxTbREXySekvq37kfCNk,751658,2893786,-2142128,621
2022-04-06 20:46:26-04:00,14793,9cwVnc8zu2wjSnvFuxPddMXSrgNajdn3sZH1qAtQQ8aQ,9xaYkDvEyDmAkWDhhZma9mLbUeB7BkLWtveDsagfJDVa,True,2649296119,662324029,4124105,2062052,2062053,3zqXX6kzhkbW3d4TwD2CNjMRwxTbREXySekvq37kfCNk,164964226,515672909,-350708683,622
2022-04-06 20:50:45-04:00,14794,2yH4iJWVSDWHGjm5J95sbsRbHGA81VNPaox8xz8DWQaG,EHUYNPTqdUDGi3TBrr5BjDByCzLKq27CECCFUNyGRbQR,True,2499392608,624848152,3858827,1929413,1929414,3zqXX6kzhkbW3d4TwD2CNjMRwxTbREXySekvq37kfCNk,154353118,333833884,-179480766,617
2022-04-06 20:50:56-04:00,14795,CVjkHr29t8pzeXU1U1CdMpT6qwf9Jw4XGxvxU7RURPYj,D66Zpxp7q4Tn4KiLa2pHTrADhgtP8tGqNXVPyCo9mcxc,True,253919806,39097761,243915,121957,121958,3zqXX6kzhkbW3d4TwD2CNjMRwxTbREXySekvq37kfCNk,15841042,42114369,-26273327,623
2022-04-06 20:51:56-04:00,14796,GRqv7y5n92vQ7bXcBqUng4vaau6w1tQeou953s8kJNwD,Bk75oioYmUzfdpbxDHTFb2nWhJgNqAt8ud1ehem3VVhh,True,3281470144,820367536,4987895,2493947,2493948,YQC4EUcgeBi9431viwvzvBbZJW3szeHX4dFmowRDyDw,199515822,472864416,-273348594,608
2022-04-06 20:52:08-04:00,14797,6eEifGxGRBnXV5EW2BwmCj8pa67znMjet98Nsq11LCsd,Dd4UCEX7tm6Q82SdSSFX9wBcJNw5TwKu8EyGjvxi9FVc,True,480066357,120016589,746956,373478,373478,3zqXX6kzhkbW3d4TwD2CNjMRwxTbREXySekvq37kfCNk,29878241,91936175,-62057934,622
2022-04-06 20:52:19-04:00,14798,CZhzJ91hP1pFbNNz7YnUKXznvs6ZFVSRNLbe1SaTw29o,X3B4LpHFfeJPmCnEmRQ8V6MNMi7KpTE4MLD7LHYXUwy,True,268670702,24844129,154357,77178,77179,A9TwRM1BMxqb8DCC7YNAMV6zPenEJm3HTZBy7wJKK58U,16692642,47095551,-30402909,621
2022-04-06 20:52:33-04:00,14799,7BEY9qatFJomsayFmky3h3dAbKhY5XkRGwMobJuxXYhQ,J8MK3tAQKreBUG2reXY6gqr1uhbHhcAZEcxsLQmG5Ntt,True,5454037827,1363509456,9690795,4845397,4845398,3zqXX6kzhkbW3d4TwD2CNjMRwxTbREXySekvq37kfCNk,387631831,885765536,-498133705,710
2022-04-06 20:52:34-04:00,14800,GoV8U9c4hjCjeosW1VKsDuRTfUe96sUPAC5RyUbstpUt,D6Y51Trnouo1KiFyyEGGS6QMShbnNN8NretZM8b9y3LT,True,874803108,218700777,1468950,734475,734475,YQC4EUcgeBi9431viwvzvBbZJW3szeHX4dFmowRDyDw,58758001,202207207,-143449206,671
2022-04-06 20:52:48-04:00,14801,7tFD53kPTqrzjCu1Wji78gUqhoRtCUhsP1pM3DQKT7uG,BJvgPLYBDJrQJdQVowrsMwUGMurq4zTihoFwWoEokfu3,True,6223315807,946118098,5909532,2954766,2954766,3zqXX6kzhkbW3d4TwD2CNjMRwxTbREXySekvq37kfCNk,388713550,1105932917,-717219367,624
2022-04-06 20:53:03-04:00,14802,5FewDaMC9U7n5EHcto98GaAmDVxDh5SYimuTP6AtfakM,7DAULUoqV7f9hsBzKEhjQPnWaHSqiMWcBqWcdcadaQv4,True,1385820205,173875975,1047806,523903,523903,3zqXX6kzhkbW3d4TwD2CNjMRwxTbREXySekvq37kfCNk,83511948,196318718,-112806770,602
2022-04-06 20:53:05-04:00,14803,JABfWoDV2wW68XEDANXArYWM7zabdbp5NBVrvzZd3mML,5hYUtd1Uv2pAcrbtSNNVTrRuk8acjmh92mzSm4iz5HJA,True,86740050,11648236,72563,36281,36282,A9TwRM1BMxqb8DCC7YNAMV6zPenEJm3HTZBy7wJKK58U,5403567,16768437,-11364870,622
2022-04-06 20:53:05-04:00,14804,GeYsENPRf2qGZu9rJsi6UPQqHS6sR7LRLWsKbFgtMCSb,7A79wktqPkSpP7o4c1kP9CBpUibHTqycW81ZANgREc5S,True,76846763,19211690,118222,59111,59111,A9TwRM1BMxqb8DCC7YNAMV6zPenEJm3HTZBy7wJKK58U,4728912,17928050,-13199138,615
2022-04-06 20:53:09-04:00,14805,eiLMepBYM3VcWarQJC9fTnxotyMuUTbyMGJECedPEfu,k2ZfwPNBBCK7PvZ6MEvELTHHtQZSXCRGCymvkZwhDDt,True,30731164,3925806,24387,12193,12194,3zqXX6kzhkbW3d4TwD2CNjMRwxTbREXySekvq37kfCNk,1909109,6371291,-4462182,621
2022-04-06 20:53:15-04:00,14806,7AizMrxWWr7qfneuXMy6ifL3BVDTAKkuud4PyZFy92kh,GyAWRRfQkVAXtyhVF14vU3kPMr4kG1VyA9FAHdDTr8ud,True,530677070,132669267,808960,404480,404480,3zqXX6kzhkbW3d4TwD2CNjMRwxTbREXySekvq37kfCNk,32358432,65874112,-33515680,609
2022-04-06 20:53:15-04:00,14807,7CSCMFa9W52tBDVUbXbc3woAy3GByeA1wPJdp3MgznPa,3447ptuVFu6G8B6N63RmS8mRv4n9PfHneypHLvbeaGLn,True,2114717464,318038617,1975018,987509,987509,3zqXX6kzhkbW3d4TwD2CNjMRwxTbREXySekvq37kfCNk,131323840,421106393,-289782553,620
2022-04-06 20:53:20-04:00,14808,6K1Xww22wVZuBwP6oYb3DPR5GvdxsQSiZ4WSmejQjyqf,8RoFHjv1TkGFqjKoSwzvyRNMoBP1ma1Hi2jy6FzD4i2g,True,184939530,44168090,273459,136729,136730,YQC4EUcgeBi9431viwvzvBbZJW3szeHX4dFmowRDyDw,11450249,21982655,-10532406,619
2022-04-06 20:53:21-04:00,14809,67DwuUmzk6uGwmptjYErQssFeJ5fd1ztFwKWZUovr7pK,HKzc15e1QLBrSsbAENyMXSVHDoap1F5MHCHB9L1Dm8HA,True,148461474,37115368,231933,115966,115967,YQC4EUcgeBi9431viwvzvBbZJW3szeHX4dFmowRDyDw,9277343,38268843,-28991500,624
2022-04-06 20:53:25-04:00,14810,FFDTcCW6UXKpkMnCefTRLpF8ZkJtS4sbGTjkcNU31Pxh,9v5oBZNrx4EATT8iHT5wNRJSo2rRPpazAYvPeaNe2Tpc,True,566293333,81895094,580560,290280,290280,3zqXX6kzhkbW3d4TwD2CNjMRwxTbREXySekvq37kfCNk,40144968,128156429,-88011461,708
2022-04-06 20:53:38-04:00,14811,5yPGvUz6JWKjkViGwTCpygJii1rP2xv5yx146ULtBiYq,FMnHUCQWTf1UHu5qVFqUAsWh8aba9EQYTEoiXy55totD,True,804981125,75093643,468636,234318,234318,3zqXX6kzhkbW3d4TwD2CNjMRwxTbREXySekvq37kfCNk,50236413,168882938,-118646525,624
2022-04-06 20:53:45-04:00,14812,5F7WHSYiVtCY8Z9KX9h6AT8qr4hbsSYasG15fq82ZWhr,E5wj8cqKM1ofNv14TspTa8yRwern8y2w6pXekL4cAWX7,True,51955085,12988771,78835,39417,39418,3zqXX6kzhkbW3d4TwD2CNjMRwxTbREXySekvq37kfCNk,3153424,7437264,-4283840,606
2022-04-06 20:54:45-04:00,14813,CZ1snuuBhno2SqfAmMLzEEQhrsH2reAmZrGhFVsydvHD,F4Hj3jxxE8W8TbgpvjRLnrQ1Jdd28ZKTPNyu1h9BnLiH,True,1920724417,480181104,2978934,1489467,1489467,3zqXX6kzhkbW3d4TwD2CNjMRwxTbREXySekvq37kfCNk,119157381,197727987,-78570606,620
2022-04-06 20:54:46-04:00,14814,1EH82ta3wXUyUwW8VWQnVzSG3r1rHcSj2DvDeTKmp3F,B6aMfucYPbCzWBtauLtgTpwR45wKSK8yqscHJR3F5usu,True,1208449870,154524530,958842,479421,479421,3zqXX6kzhkbW3d4TwD2CNjMRwxTbREXySekvq37kfCNk,74985695,26739086,48246609,620
2022-04-06 20:54:47-04:00,14815,AyFWvQUX79sq8L7KhcYrPRbxd6whUvEMETZL8atuuRr2,9LTjofdhGLn2Ltv6XfuHtX8MKEPzScGL669pC8Lrgtnh,True,17789898,4447474,27616,13808,13808,YQC4EUcgeBi9431viwvzvBbZJW3szeHX4dFmowRDyDw,1104664,4057951,-2953287,620
2022-04-06 20:55:23-04:00,14816,H1oYXGZTagwv48FdDe6RNkjNaesedqLKyXxTmPc5k4Fp,Am3rx6XrkrZ4MdeZDyZUv1YW2fBujcz4dLjVCnRQHKZa,True,30968606,7742151,48379,24189,24190,YQC4EUcgeBi9431viwvzvBbZJW3szeHX4dFmowRDyDw,1935181,3465001,-1529820,624
2022-04-06 20:55:26-04:00,14817,DVMLxFACqaNBD7q1TGJUUApJX7etJsxQRRFBP2DfBazJ,4hnRjD7S2KxD7UrgfrApntVxUD7Srh5E9nwPY53v89kz,True,235094372,19584246,128134,64067,64067,3zqXX6kzhkbW3d4TwD2CNjMRwxTbREXySekvq37kfCNk,15381635,54538166,-39156531,654
2022-04-06 20:55:27-04:00,14818,8nFpzAFXELGPsrgFwRjTfUidNme1CvgKQTsHWATtMqkz,ABt8ikXHraZ1bqkDUvMtJ3AUzADDWcCL8kMMDpAoth8V,True,28693141,7173285,44709,22354,22355,YQC4EUcgeBi9431viwvzvBbZJW3szeHX4dFmowRDyDw,1788370,7988851,-6200481,623
2022-04-06 20:55:57-04:00,14819,5YC2wXkdk7D4Ubs9TEAbP1hi88Sy35bzYVWjLbgVxn5s,4Mx69ezqFK2wudZ62oVhx2pwjVbKv8JB1HR29ZUcdEJb,True,2143667303,535916825,3346164,1673082,1673082,3zqXX6kzhkbW3d4TwD2CNjMRwxTbREXySekvq37kfCNk,133846599,310727853,-176881254,624
2022-04-06 20:56:24-04:00,14820,BTq6T9nDzYTPTRvxkhNLn82DF3RCWdRkatZUmSTGCu43,3Uuhmxo4tWMbrqowx2bQSJeWzMykUUcZanj29ptCmEa6,True,5439168605,1050264548,6542574,3271287,3271287,3zqXX6kzhkbW3d4TwD2CNjMRwxTbREXySekvq37kfCNk,338830499,1201083683,-862253184,622
2022-04-06 20:56:26-04:00,14821,J8khFNhJg25xVY7yjEtETTQVVzKHqdVCs1Rh2pJKvJqU,4eUP2YxTapjr6TLrd57XxZan7KJG5AtHK8yPRNVEbavx,True,937159071,126385189,788045,394022,394023,3zqXX6kzhkbW3d4TwD2CNjMRwxTbREXySekvq37kfCNk,58434436,30439660,27994776,623
2022-04-06 20:56:33-04:00,14822,H8wYaRqc2wQuE3AdnSA2bCbukzxZEUCS5KbGYNsLAoho,F4ZEmseEyZfy3ZL6iyrczRZ9bww9HgVd8tYXExfbTcj1,True,81252793,20313198,126835,63417,63418,3zqXX6kzhkbW3d4TwD2CNjMRwxTbREXySekvq37kfCNk,5073423,18834545,-13761122,624
2022-04-06 20:56:56-04:00,14823,AwT3pH9dHjECDnuUiazbD6tZxZHdNwgJ4vBMmxLHMiLo,AjybksvjMT1QT6KvryXCG47pQGT8v9jxM34VkveGPQrs,True,18851664,4712916,28894,14447,14447,YQC4EUcgeBi9431viwvzvBbZJW3szeHX4dFmowRDyDw,1155763,3214344,-2058581,613
2022-04-06 20:56:59-04:00,14824,JABfWoDV2wW68XEDANXArYWM7zabdbp5NBVrvzZd3mML,5hYUtd1Uv2pAcrbtSNNVTrRuk8acjmh92mzSm4iz5HJA,True,74365145,9897124,61278,30639,30639,3zqXX6kzhkbW3d4TwD2CNjMRwxTbREXySekvq37kfCNk,4604335,15375021,-10770686,619
2022-04-06 20:57:23-04:00,14825,FV9CBGGTbppLnBKh79f2LzD1diTiS5g6u89FcpZHZmnK,Fe7mtmCUziFqbbYTvrhAcAq1Ub7YLfTJRtQ1hG7GzJD1,True,19947702,4986925,31166,15583,15583,3zqXX6kzhkbW3d4TwD2CNjMRwxTbREXySekvq37kfCNk,1246663,3776497,-2529834,624
2022-04-06 20:59:10-04:00,14826,CZhzJ91hP1pFbNNz7YnUKXznvs6ZFVSRNLbe1SaTw29o,X3B4LpHFfeJPmCnEmRQ8V6MNMi7KpTE4MLD7LHYXUwy,True,242400915,22633619,141110,70555,70555,YQC4EUcgeBi9431viwvzvBbZJW3szeHX4dFmowRDyDw,15112627,43146920,-28034293,623
2022-04-06 20:59:14-04:00,14827,GHHkWuoUrAsuf1n8Y2GFozQxxv3LSr2zU9DWwKmAGTG9,7Fr2hNXbiNUufq8USBK3HwWN4bQT6H9fcFzDt7fdKy2U,True,548208166749,137052041687,856229769,428114884,428114885,3zqXX6kzhkbW3d4TwD2CNjMRwxTbREXySekvq37kfCNk,34249190776,137197654022,-102948463246,624
2022-04-06 20:59:17-04:00,14828,EBRWnRzoNv5RytEjgrs5TXdiCMApLKHMntJJJzehJJns,5nJiYTa3GEbmaRwY1PvBJ1teXikQKgbUop5ANgaDhhcP,True,22522475,5630618,29867,14933,14934,3zqXX6kzhkbW3d4TwD2CNjMRwxTbREXySekvq37kfCNk,1194708,4775481,-3580773,530
2022-04-06 20:59:17-04:00,14829,3geiQ6Ph1iyCnfEfTmWpVnvdJnYoUb3HNeKXwshQMJuF,3uu2PC2DhTR3iXVEKbq5hC8FrzyTYbwF9Ztm3BD3hjEm,True,423339108,105834777,566539,283269,283270,YQC4EUcgeBi9431viwvzvBbZJW3szeHX4dFmowRDyDw,22661585,99268345,-76606760,535
2022-04-06 20:59:22-04:00,14830,4GbUrgiR6A91h3J9HHpuYCkZzjwrb62n3BURLeWj6Nic,12nUFUGYF1rXbwPeCbdGKdP3RE4g984fmZZggEYSFTZn,True,82836813,20709203,129240,64620,64620,A9TwRM1BMxqb8DCC7YNAMV6zPenEJm3HTZBy7wJKK58U,5169616,23311255,-18141639,624
2022-04-06 20:59:25-04:00,14831,2i5g7q4gD1GEfSz8BkhKn1idQ5U7cFPbMDWugjr7bBQW,Dpx6K9G5uZD63rTzBafZ56WKd1X9M25Mzfppd7Jib4xn,True,1942608515,485652128,3021472,1510736,1510736,3zqXX6kzhkbW3d4TwD2CNjMRwxTbREXySekvq37kfCNk,120858904,560816351,-439957447,622
2022-04-06 21:00:02-04:00,14832,A5NXadGWnFZRoHEn1dKTRjcXgWmfMLMyJdpF4rQPZyRR,ALs3Zfotc4c4A6TFDMbd5GM5whK1dTYSnGrHiMBWmApH,True,2223561111,555889702,3468401,1734200,1734201,3zqXX6kzhkbW3d4TwD2CNjMRwxTbREXySekvq37kfCNk,138736206,657914244,-519178038,623
2022-04-06 21:00:10-04:00,14833,5FewDaMC9U7n5EHcto98GaAmDVxDh5SYimuTP6AtfakM,7DAULUoqV7f9hsBzKEhjQPnWaHSqiMWcBqWcdcadaQv4,True,1204012132,171482186,1060710,530355,530355,3zqXX6kzhkbW3d4TwD2CNjMRwxTbREXySekvq37kfCNk,74474747,181190927,-106716180,618
2022-04-06 22:29:57-04:00,14834,Gp1V4ymYEQH9jeZsqPERVfwqoQYUPESUmgKCMaDqoh6u,BBe1Vd8RZuqqC7VkUixgMYA1CfLXMaEvq8J571j8ueMQ,True,2118479235,529619808,3275203,1637601,1637602,YQC4EUcgeBi9431viwvzvBbZJW3szeHX4dFmowRDyDw,131008126,434549001,-303540875,618
2022-04-07 06:18:26-04:00,14835,DXGapgtgkag6midSCYNhHCNaCqvhUmuSvnVhXxNXBmyt,Csq6W5QkGZL6qE6Z1ERF3bfHtKjnM8hAxiY1YA3rTwSX,True,2310556973,577639243,3605532,1802766,1802766,3zqXX6kzhkbW3d4TwD2CNjMRwxTbREXySekvq37kfCNk,144221292,238801270,-94579978,624
2022-04-07 06:20:08-04:00,14836,CVjkHr29t8pzeXU1U1CdMpT6qwf9Jw4XGxvxU7RURPYj,D66Zpxp7q4Tn4KiLa2pHTrADhgtP8tGqNXVPyCo9mcxc,True,212600099,28618085,178382,89191,89191,3zqXX6kzhkbW3d4TwD2CNjMRwxTbREXySekvq37kfCNk,13251829,38328990,-25077161,623
2022-04-07 10:27:19-04:00,14837,DXGapgtgkag6midSCYNhHCNaCqvhUmuSvnVhXxNXBmyt,Csq6W5QkGZL6qE6Z1ERF3bfHtKjnM8hAxiY1YA3rTwSX,True,1698206249,424551562,2649166,1324583,1324583,3zqXX6kzhkbW3d4TwD2CNjMRwxTbREXySekvq37kfCNk,105966654,211647069,-105680415,623
2022-04-07 10:52:23-04:00,14838,CVjkHr29t8pzeXU1U1CdMpT6qwf9Jw4XGxvxU7RURPYj,D66Zpxp7q4Tn4KiLa2pHTrADhgtP8tGqNXVPyCo9mcxc,True,182277519,24563276,153222,76611,76611,YQC4EUcgeBi9431viwvzvBbZJW3szeHX4dFmowRDyDw,11370271,34883036,-23512765,623
2022-04-07 10:52:52-04:00,14839,G3ZEAY19iDMjF7P57dgFUZiC4bpeFvMPKShenugL7E2Y,D6nUGgpWkQUZcUKZYawfedX67uqQ9Co1wEwtbHPMtc7X,True,6017519281,1049657297,6558332,3279166,3279166,3zqXX6kzhkbW3d4TwD2CNjMRwxTbREXySekvq37kfCNk,375978863,1236603533,-860624670,624
2022-04-07 11:13:24-04:00,14840,niCk6QHFU1kyU56Mdq5RJzKrecdkNSn23ZA6wduFdWS,BQbUYSw1XsuE6LnVd4XjmxAyYgx4drE4FsetJBCdwVZW,True,326033847,81493318,507968,253984,253984,3zqXX6kzhkbW3d4TwD2CNjMRwxTbREXySekvq37kfCNk,20322556,56978032,-36655476,623
2022-04-07 11:13:57-04:00,14841,BTwSuuDHNhQAFAzBZRWev5j1ix2RTWvjZAxLpw8grAxu,31NCyUpSXxxJYLSrdK3c5bLomUtMejobMfYnq7j71GtM,True,364920161,91230040,565086,282543,282543,3zqXX6kzhkbW3d4TwD2CNjMRwxTbREXySekvq37kfCNk,22603442,75650165,-53046723,619
2022-04-07 11:14:20-04:00,14842,CVjkHr29t8pzeXU1U1CdMpT6qwf9Jw4XGxvxU7RURPYj,D66Zpxp7q4Tn4KiLa2pHTrADhgtP8tGqNXVPyCo9mcxc,True,156163630,20899577,129361,64680,64681,YQC4EUcgeBi9431viwvzvBbZJW3szeHX4dFmowRDyDw,9666004,31760841,-22094837,618
2022-04-07 11:15:44-04:00,14843,Aepji2BxpSL2XkT2YPkmJGaFntudcBH4Rmt5q53WQrBL,9b4iP4ebv3ffEkdmphiQt5AByqEoEZK1oxAkq7AcfPFy,True,880113693,220028423,1317989,658994,658995,YQC4EUcgeBi9431viwvzvBbZJW3szeHX4dFmowRDyDw,52719571,201967001,-149247430,599
2022-04-07 11:15:47-04:00,14844,F4hN7ecndZ8Gr5KQNSFaSrMGawMasz7jfWTLTMpk7gaB,AJ23FpXSGjipcqywk88WGsKfqfiiUjPzZLsvLtBAhB12,True,202843830,50710957,312286,156143,156143,A9TwRM1BMxqb8DCC7YNAMV6zPenEJm3HTZBy7wJKK58U,12491455,49083643,-36592188,615
2022-04-07 11:15:48-04:00,14845,9cwVnc8zu2wjSnvFuxPddMXSrgNajdn3sZH1qAtQQ8aQ,9xaYkDvEyDmAkWDhhZma9mLbUeB7BkLWtveDsagfJDVa,True,1948789697,487197424,2989989,1494994,1494995,gjBMZYVujDjD1ECG4i97M8Q3gV9ESnwwTSUGropkusj,119599578,421130174,-301530596,613
2022-04-07 11:28:27-04:00,14846,G3ZEAY19iDMjF7P57dgFUZiC4bpeFvMPKShenugL7E2Y,D6nUGgpWkQUZcUKZYawfedX67uqQ9Co1wEwtbHPMtc7X,True,4903815170,780326848,4859339,2429669,2429670,3zqXX6kzhkbW3d4TwD2CNjMRwxTbREXySekvq37kfCNk,305375952,1084703176,-779327224,622
2022-04-07 11:29:49-04:00,14847,68zbVKnneMQqngbNkeLtPEP2ayNhawc1B2hPgqAEqgXK,HqiFpLr4NC7xJz9bEFusq8bCKaoxAQG1xsLxdUAzg8aa,True,11611745735,1741026508,10837946,5418973,5418973,3zqXX6kzhkbW3d4TwD2CNjMRwxTbREXySekvq37kfCNk,722834971,1765447005,-1042612034,622
2022-04-07 11:31:10-04:00,14848,HooxSzasW3HMoFJ6sAvRQ75Char1J5aBdJtsqfDV6myp,BCmsWwpGeV4NNfeKZKKydty2uueLGHYTJDk1WErpXsVT,True,1189861144,246469035,1539955,769977,769978,3zqXX6kzhkbW3d4TwD2CNjMRwxTbREXySekvq37kfCNk,74343346,207604102,-133260756,624
2022-04-07 11:32:00-04:00,14849,CVjkHr29t8pzeXU1U1CdMpT6qwf9Jw4XGxvxU7RURPYj,D66Zpxp7q4Tn4KiLa2pHTrADhgtP8tGqNXVPyCo9mcxc,True,134106937,17953020,112177,56088,56089,YQC4EUcgeBi9431viwvzvBbZJW3szeHX4dFmowRDyDw,8379527,28615785,-20236258,624
2022-04-07 11:35:31-04:00,14850,DDdxcAmfFWLs79vYC1WUuwBVM1XUfxmAgbYgccL5bgZg,3tKaUfHU3Z7v1LDm581yDd1bpfnxLgGHCWTNur3KLptz,True,1510118128,377529532,2339692,1169846,1169846,YQC4EUcgeBi9431viwvzvBbZJW3szeHX4dFmowRDyDw,93587697,335884381,-242296684,619
2022-04-07 11:35:31-04:00,14851,EDzP8bi8wGytnFoz4RynYddWyVWd5RFhHKcGZdwyAHJH,ELHWRXKjwkmoEj3nkJ9hw2bcL6dRd4znFeoLjitNbrXt,True,41502432,10375608,64201,32100,32101,YQC4EUcgeBi9431viwvzvBbZJW3szeHX4dFmowRDyDw,2568059,10512996,-7944937,618
2022-04-07 11:35:32-04:00,14852,3uUdWwgwtFdPa3FJTSrirqPKMtQb3zmT5Wpp4zPy9sJP,5G7dhz8jvWekGy9Wh3ZCXNXSPbB1QArfFYs7MYNgRDkW,True,174688052,43672013,270435,135217,135218,3zqXX6kzhkbW3d4TwD2CNjMRwxTbREXySekvq37kfCNk,10817412,54092341,-43274929,619
2022-04-07 12:07:29-04:00,14853,9YLh8k2JSzEN8kcH5TgJTTZrfDZdY71jskvgUmmjuwzt,ugXh99GpsExGcaTqkPzXUqEvACZMxkPu71MZoW3yFph,True,4273550700,1068387675,6672419,3336209,3336210,3zqXX6kzhkbW3d4TwD2CNjMRwxTbREXySekvq37kfCNk,266896773,998182539,-731285766,624
2022-04-07 12:51:13-04:00,14854,Gp1V4ymYEQH9jeZsqPERVfwqoQYUPESUmgKCMaDqoh6u,BBe1Vd8RZuqqC7VkUixgMYA1CfLXMaEvq8J571j8ueMQ,True,1559985734,389996433,2433137,1216568,1216569,3zqXX6kzhkbW3d4TwD2CNjMRwxTbREXySekvq37kfCNk,97325512,354060294,-256734782,623
2022-04-07 12:53:16-04:00,14855,BTwSuuDHNhQAFAzBZRWev5j1ix2RTWvjZAxLpw8grAxu,31NCyUpSXxxJYLSrdK3c5bLomUtMejobMfYnq7j71GtM,True,268252425,67063106,414869,207434,207435,A9TwRM1BMxqb8DCC7YNAMV6zPenEJm3HTZBy7wJKK58U,16594795,61823648,-45228853,618
2022-04-07 12:53:16-04:00,14856,niCk6QHFU1kyU56Mdq5RJzKrecdkNSn23ZA6wduFdWS,BQbUYSw1XsuE6LnVd4XjmxAyYgx4drE4FsetJBCdwVZW,True,239342457,59820526,365200,182600,182600,gjBMZYVujDjD1ECG4i97M8Q3gV9ESnwwTSUGropkusj,14611728,47308395,-32696667,610
2022-04-07 16:45:53-04:00,14857,DXZMRSKFgnNdiXHps2xzayuztJNH9EUUz2wkCCneXtW5,9Z2sUfTCZCkmw5n3HSsoLG992AcpJo2qxp7XpJnnBxZM,True,1859766724,460791690,2835045,1417522,1417523,3zqXX6kzhkbW3d4TwD2CNjMRwxTbREXySekvq37kfCNk,114423195,179051723,-64628528,615
2022-04-07 17:16:11-04:00,14858,DXGapgtgkag6midSCYNhHCNaCqvhUmuSvnVhXxNXBmyt,Csq6W5QkGZL6qE6Z1ERF3bfHtKjnM8hAxiY1YA3rTwSX,True,1248265734,312066433,1949614,974807,974807,3zqXX6kzhkbW3d4TwD2CNjMRwxTbREXySekvq37kfCNk,77984587,182652757,-104668170,624
2022-04-07 17:22:56-04:00,14859,6Rk6wVu6pCDFwEWDbiY8wS93nDghyHP9kzdUEa6eFRRq,B5v7eFjSX6dDt1kt84Uvtqmrn7STbQPMbFMvjH6WGXJg,True,362486496,90621624,565469,282734,282735,gjBMZYVujDjD1ECG4i97M8Q3gV9ESnwwTSUGropkusj,22618784,39130061,-16511277,623
2022-04-07 17:25:03-04:00,14860,D85pWm1LS9MvtR4f3QhkFLvNUhZLQ2NZBFQTyAVnmigm,CRN85DYkJJi6irhtVAf4qcJU3ijVodWdXgWe7Fs6Ahka,True,179448967,44862241,279907,139953,139954,3zqXX6kzhkbW3d4TwD2CNjMRwxTbREXySekvq37kfCNk,11196295,24497015,-13300720,623
2022-04-07 19:17:31-04:00,14861,7yW1M1xeVx4hy3QftnpqdBDRYwamfu3K5i6AEnxgyTWb,7wf7FWS2DYp5RveQAmGNXAEUWPcHziuMLd4hV5LPgxF8,True,476215927,119053981,732558,366279,366279,3zqXX6kzhkbW3d4TwD2CNjMRwxTbREXySekvq37kfCNk,29302334,45552952,-16250618,615
2022-04-07 19:17:43-04:00,14862,5qhMCt68ufKGTNVaZvyY8RAUJv62xzWUfFXRPtAriAoX,Bt7QiSUuc6uJQbhzC3qhLPdDA3UAom7zqmihEKwvrpCg,True,615734878,153933719,958386,479193,479193,YQC4EUcgeBi9431viwvzvBbZJW3szeHX4dFmowRDyDw,38335479,58940588,-20605109,622
2022-04-07 19:19:59-04:00,14863,HEQkTetqGuSUdeEFpSTVigmtAroktwPZWeLhWgDWhKjp,3EJQFo1ZWCEYjFu1dbgLMqYeACAEKKtvEbVn1wd8CXm1,True,1313687923,328421980,2320425,1160212,1160213,3zqXX6kzhkbW3d4TwD2CNjMRwxTbREXySekvq37kfCNk,92817029,126709020,-33891991,706
2022-04-07 20:18:31-04:00,14864,BFWNfNhm4RUFJs3721We8Dyocw1okinoUA3JtHshAHkU,7czPpWxLYgLgAGmvxiKA6zRGQ97FdLVB83FvNqEuKnFj,True,9154110669,2288527667,14217619,7108809,7108810,gjBMZYVujDjD1ECG4i97M8Q3gV9ESnwwTSUGropkusj,568704795,876038439,-307333644,621
2022-04-07 20:18:32-04:00,14865,7yW1M1xeVx4hy3QftnpqdBDRYwamfu3K5i6AEnxgyTWb,7wf7FWS2DYp5RveQAmGNXAEUWPcHziuMLd4hV5LPgxF8,True,363398270,90849567,558350,279175,279175,gjBMZYVujDjD1ECG4i97M8Q3gV9ESnwwTSUGropkusj,22334031,40759847,-18425816,614
2022-04-07 20:18:49-04:00,14866,5qhMCt68ufKGTNVaZvyY8RAUJv62xzWUfFXRPtAriAoX,Bt7QiSUuc6uJQbhzC3qhLPdDA3UAom7zqmihEKwvrpCg,True,469904196,117476049,731870,365935,365935,3zqXX6kzhkbW3d4TwD2CNjMRwxTbREXySekvq37kfCNk,29274804,52834228,-23559424,622
2022-04-07 22:19:11-04:00,14867,HEQkTetqGuSUdeEFpSTVigmtAroktwPZWeLhWgDWhKjp,3EJQFo1ZWCEYjFu1dbgLMqYeACAEKKtvEbVn1wd8CXm1,True,1004886606,251221651,1771770,885885,885885,3zqXX6kzhkbW3d4TwD2CNjMRwxTbREXySekvq37kfCNk,70870829,116066501,-45195672,705
2022-04-08 01:41:16-04:00,14868,HEQkTetqGuSUdeEFpSTVigmtAroktwPZWeLhWgDWhKjp,3EJQFo1ZWCEYjFu1dbgLMqYeACAEKKtvEbVn1wd8CXm1,True,768383627,192095906,1359462,679731,679731,YQC4EUcgeBi9431viwvzvBbZJW3szeHX4dFmowRDyDw,54378507,103082536,-48704029,707
2022-04-08 06:09:59-04:00,14869,5xWq61GfGvA9dHug4Z9Uo14L8vgUgV6EUxEae3WhTKy8,gii3qjcY11PBrEGVtFSU7WNyazAcP1p6MDFUqbWmRH4,True,1665704420,416426105,2600851,1300425,1300426,2py1FiYeL2f7J3HU36qiJz6TD6HCmiTN36RyxYtapQCZ,104034064,158191515,-54157451,624
2022-04-08 07:20:24-04:00,14870,AKcGcqFMxvVWFHpc9oUJYGZsLN4DUHVkMSLGYrMcCYYN,4dWje79e7kH8GWJwwfB76BQUVUSgnYHTVxrtfNyG5A4K,True,24852185556,4818383026,29795753,14897876,14897877,YQC4EUcgeBi9431viwvzvBbZJW3szeHX4dFmowRDyDw,1536801010,3366317663,-1829516653,618
2022-04-08 07:32:49-04:00,14871,8K1GzGeaAuFdjuVZi6DqBcYiA1zSRioMkRvjotr8p7fz,5mqocPwTdjwAPiJf7vx9bo7AzvfQBT2t5bV9u2Jzb2e1,True,356099422,89024855,627710,313855,313855,3zqXX6kzhkbW3d4TwD2CNjMRwxTbREXySekvq37kfCNk,25108431,36392356,-11283925,705
2022-04-08 08:31:24-04:00,14872,DXGapgtgkag6midSCYNhHCNaCqvhUmuSvnVhXxNXBmyt,Csq6W5QkGZL6qE6Z1ERF3bfHtKjnM8hAxiY1YA3rTwSX,True,917248760,229312190,1433095,716547,716548,3zqXX6kzhkbW3d4TwD2CNjMRwxTbREXySekvq37kfCNk,57323830,154786027,-97462197,624
2022-04-08 08:45:13-04:00,14873,6Rk6wVu6pCDFwEWDbiY8wS93nDghyHP9kzdUEa6eFRRq,B5v7eFjSX6dDt1kt84Uvtqmrn7STbQPMbFMvjH6WGXJg,True,266354482,66588620,415320,207660,207660,YQC4EUcgeBi9431viwvzvBbZJW3szeHX4dFmowRDyDw,16612811,34507518,-17894707,623
2022-04-08 08:46:11-04:00,14874,BhhVhLVZkSd3aHDMd6ojTgtJtbgAdMCA9Xj8jL2GMXoL,G8HUQp2yGSw9T6it5ej91cqkd82naca8heji453g2jEH,True,11421542567,1498338055,9364281,4682140,4682141,3zqXX6kzhkbW3d4TwD2CNjMRwxTbREXySekvq37kfCNk,713821122,1021599418,-307778296,624
2022-04-08 08:47:11-04:00,14875,D85pWm1LS9MvtR4f3QhkFLvNUhZLQ2NZBFQTyAVnmigm,CRN85DYkJJi6irhtVAf4qcJU3ijVodWdXgWe7Fs6Ahka,True,131876584,32969146,206022,103011,103011,YQC4EUcgeBi9431viwvzvBbZJW3szeHX4dFmowRDyDw,8240909,20926808,-12685899,624
2022-04-08 08:47:43-04:00,14876,G3ZEAY19iDMjF7P57dgFUZiC4bpeFvMPKShenugL7E2Y,D6nUGgpWkQUZcUKZYawfedX67uqQ9Co1wEwtbHPMtc7X,True,4076558278,564122269,3518567,1759283,1759284,3zqXX6kzhkbW3d4TwD2CNjMRwxTbREXySekvq37kfCNk,254264804,964543119,-710278315,623
2022-04-08 08:54:07-04:00,14877,AKcGcqFMxvVWFHpc9oUJYGZsLN4DUHVkMSLGYrMcCYYN,4dWje79e7kH8GWJwwfB76BQUVUSgnYHTVxrtfNyG5A4K,True,19742222770,3544929244,21822273,10911136,10911137,3zqXX6kzhkbW3d4TwD2CNjMRwxTbREXySekvq37kfCNk,1215313938,2908485824,-1693171886,615
2022-04-08 09:06:10-04:00,14878,J8khFNhJg25xVY7yjEtETTQVVzKHqdVCs1Rh2pJKvJqU,4eUP2YxTapjr6TLrd57XxZan7KJG5AtHK8yPRNVEbavx,True,1188868304,157006043,980553,490276,490277,3zqXX6kzhkbW3d4TwD2CNjMRwxTbREXySekvq37kfCNk,74248709,50685466,23563243,624
2022-04-08 09:08:30-04:00,14879,7yW1M1xeVx4hy3QftnpqdBDRYwamfu3K5i6AEnxgyTWb,7wf7FWS2DYp5RveQAmGNXAEUWPcHziuMLd4hV5LPgxF8,True,240086037,60021509,374132,187066,187066,3zqXX6kzhkbW3d4TwD2CNjMRwxTbREXySekvq37kfCNk,14965292,24864224,-9898932,623
2022-04-08 09:09:31-04:00,14880,BhhVhLVZkSd3aHDMd6ojTgtJtbgAdMCA9Xj8jL2GMXoL,G8HUQp2yGSw9T6it5ej91cqkd82naca8heji453g2jEH,True,9832947879,1344708286,8399161,4199580,4199581,3zqXX6kzhkbW3d4TwD2CNjMRwxTbREXySekvq37kfCNk,614174268,1016047985,-401873717,624
2022-04-08 09:21:02-04:00,14881,bYUscp4qgQap7iDu5R8tyBz73dov4j3zDV2FgDUvSDx,E4d8ank6Ymezu4ubD2tU5B5fXuoh2E1RQkrdaLgMfuaT,True,3913721583,978430395,5947657,2973828,2973829,YQC4EUcgeBi9431viwvzvBbZJW3szeHX4dFmowRDyDw,237906303,404259632,-166353329,607
2022-04-08 09:26:58-04:00,14882,G3ZEAY19iDMjF7P57dgFUZiC4bpeFvMPKShenugL7E2Y,D6nUGgpWkQUZcUKZYawfedX67uqQ9Co1wEwtbHPMtc7X,True,3478215611,448995904,2794971,1397485,1397486,3zqXX6kzhkbW3d4TwD2CNjMRwxTbREXySekvq37kfCNk,216516792,852877284,-636360492,622
2022-04-08 13:17:51-04:00,14883,DXGapgtgkag6midSCYNhHCNaCqvhUmuSvnVhXxNXBmyt,Csq6W5QkGZL6qE6Z1ERF3bfHtKjnM8hAxiY1YA3rTwSX,True,674048336,168512084,1051141,525570,525571,3zqXX6kzhkbW3d4TwD2CNjMRwxTbREXySekvq37kfCNk,42045662,129036406,-86990744,623
2022-04-08 13:31:12-04:00,14884,bYUscp4qgQap7iDu5R8tyBz73dov4j3zDV2FgDUvSDx,E4d8ank6Ymezu4ubD2tU5B5fXuoh2E1RQkrdaLgMfuaT,True,2881622111,720405527,4466979,2233489,2233490,3zqXX6kzhkbW3d4TwD2CNjMRwxTbREXySekvq37kfCNk,178679188,357694943,-179015755,620
2022-04-08 13:31:29-04:00,14885,FU7X4DWnGTbxwXULBq3v9SACzYhQyFGqsXjUDzyFqiem,925BaEnWxTfEv4oQb9Xf1wyyEEWEr8kXeSdXTtRfShfw,True,20992976897,2857186801,17848061,8924030,8924031,3zqXX6kzhkbW3d4TwD2CNjMRwxTbREXySekvq37kfCNk,1311373646,2689857890,-1378484244,624
2022-04-08 13:32:14-04:00,14886,6Rk6wVu6pCDFwEWDbiY8wS93nDghyHP9kzdUEa6eFRRq,B5v7eFjSX6dDt1kt84Uvtqmrn7STbQPMbFMvjH6WGXJg,True,195668542,48917135,302819,151409,151410,3zqXX6kzhkbW3d4TwD2CNjMRwxTbREXySekvq37kfCNk,12112771,29631600,-17518829,619
2022-04-08 13:32:42-04:00,14887,BhhVhLVZkSd3aHDMd6ojTgtJtbgAdMCA9Xj8jL2GMXoL,G8HUQp2yGSw9T6it5ej91cqkd82naca8heji453g2jEH,True,8403529556,1101709500,6834782,3417391,3417391,3zqXX6kzhkbW3d4TwD2CNjMRwxTbREXySekvq37kfCNk,521337935,915245446,-393907511,620
2022-04-08 13:35:00-04:00,14888,D85pWm1LS9MvtR4f3QhkFLvNUhZLQ2NZBFQTyAVnmigm,CRN85DYkJJi6irhtVAf4qcJU3ijVodWdXgWe7Fs6Ahka,True,96859967,24214991,149841,74920,74921,YQC4EUcgeBi9431viwvzvBbZJW3szeHX4dFmowRDyDw,5993665,17555681,-11562016,618
2022-04-08 14:12:33-04:00,14889,EC8fafqtuQzqbm2TZs3GeuXB9qXomkykrTG1na2rfFpx,A72f7W58h3r8nut45RmqdTk1J31NGYT2sVWMn18dK885,True,73872138,18468034,112256,56128,56128,YQC4EUcgeBi9431viwvzvBbZJW3szeHX4dFmowRDyDw,4490258,10728540,-6238282,607
2022-04-08 14:12:55-04:00,14890,2ssYxbmFPYBdse9a6NJ26M8hsscYpjv5MyqyYkjftdrL,FKvvXz9eYXW2zgy37eaUW9u2K9LnnDsNx3DcgtATpizY,True,147950810,36987702,228264,114132,114132,YQC4EUcgeBi9431viwvzvBbZJW3szeHX4dFmowRDyDw,9130564,24328551,-15197987,617
2022-04-08 14:13:51-04:00,14891,G3ZEAY19iDMjF7P57dgFUZiC4bpeFvMPKShenugL7E2Y,D6nUGgpWkQUZcUKZYawfedX67uqQ9Co1wEwtbHPMtc7X,True,3002617870,415463644,2590790,1295395,1295395,A9TwRM1BMxqb8DCC7YNAMV6zPenEJm3HTZBy7wJKK58U,187240313,774815171,-587574858,623
2022-04-08 14:14:00-04:00,14892,AKcGcqFMxvVWFHpc9oUJYGZsLN4DUHVkMSLGYrMcCYYN,4dWje79e7kH8GWJwwfB76BQUVUSgnYHTVxrtfNyG5A4K,True,16002517171,2617104305,16342449,8171224,8171225,3zqXX6kzhkbW3d4TwD2CNjMRwxTbREXySekvq37kfCNk,999273636,2496295455,-1497021819,624
2022-04-08 17:15:47-04:00,14893,FU7X4DWnGTbxwXULBq3v9SACzYhQyFGqsXjUDzyFqiem,925BaEnWxTfEv4oQb9Xf1wyyEEWEr8kXeSdXTtRfShfw,True,17962229221,2362877228,14738079,7369039,7369040,3zqXX6kzhkbW3d4TwD2CNjMRwxTbREXySekvq37kfCNk,1120366145,2555375924,-1435009779,623
2022-04-08 17:26:28-04:00,14894,DXGapgtgkag6midSCYNhHCNaCqvhUmuSvnVhXxNXBmyt,Csq6W5QkGZL6qE6Z1ERF3bfHtKjnM8hAxiY1YA3rTwSX,True,495477415,123869353,773784,386892,386892,YQC4EUcgeBi9431viwvzvBbZJW3szeHX4dFmowRDyDw,30951398,106256558,-75305160,624
2022-04-08 17:27:10-04:00,14895,BhhVhLVZkSd3aHDMd6ojTgtJtbgAdMCA9Xj8jL2GMXoL,G8HUQp2yGSw9T6it5ej91cqkd82naca8heji453g2jEH,True,7239515274,996092702,6223125,3111562,3111563,3zqXX6kzhkbW3d4TwD2CNjMRwxTbREXySekvq37kfCNk,452291397,889238420,-436947023,624
2022-04-08 17:27:20-04:00,14896,FU7X4DWnGTbxwXULBq3v9SACzYhQyFGqsXjUDzyFqiem,925BaEnWxTfEv4oQb9Xf1wyyEEWEr8kXeSdXTtRfShfw,True,15450167638,2102941807,13018275,6509137,6509138,3zqXX6kzhkbW3d4TwD2CNjMRwxTbREXySekvq37kfCNk,956443711,2290517788,-1334074077,619
2022-04-08 17:27:20-04:00,14897,bYUscp4qgQap7iDu5R8tyBz73dov4j3zDV2FgDUvSDx,E4d8ank6Ymezu4ubD2tU5B5fXuoh2E1RQkrdaLgMfuaT,True,2115392876,528848219,3210360,1605180,1605180,3zqXX6kzhkbW3d4TwD2CNjMRwxTbREXySekvq37kfCNk,128414417,308824240,-180409823,607
2022-04-08 17:30:45-04:00,14898,7yW1M1xeVx4hy3QftnpqdBDRYwamfu3K5i6AEnxgyTWb,7wf7FWS2DYp5RveQAmGNXAEUWPcHziuMLd4hV5LPgxF8,True,176498610,44124652,275598,137799,137799,3zqXX6kzhkbW3d4TwD2CNjMRwxTbREXySekvq37kfCNk,11023925,22014469,-10990544,624
2022-04-08 17:38:24-04:00,14899,G3ZEAY19iDMjF7P57dgFUZiC4bpeFvMPKShenugL7E2Y,D6nUGgpWkQUZcUKZYawfedX67uqQ9Co1wEwtbHPMtc7X,True,2562561392,332421038,2076587,1038293,1038294,YQC4EUcgeBi9431viwvzvBbZJW3szeHX4dFmowRDyDw,160079634,683498602,-523418968,624
2022-04-08 17:40:00-04:00,14900,EFHg5FatMRRSZnKJPJF9e1iw2cjPJRmwTTZYtkHno9DP,84LnLKhZDJgWFnbBYnYjqWkjymemXfidecPFwnUAvuFj,True,8992887557,2248221889,14022089,7011044,7011045,YQC4EUcgeBi9431viwvzvBbZJW3szeHX4dFmowRDyDw,560883581,1031086185,-470202604,623
2022-04-08 17:40:14-04:00,14901,J8khFNhJg25xVY7yjEtETTQVVzKHqdVCs1Rh2pJKvJqU,4eUP2YxTapjr6TLrd57XxZan7KJG5AtHK8yPRNVEbavx,True,672933286,168233321,1049382,524691,524691,3zqXX6kzhkbW3d4TwD2CNjMRwxTbREXySekvq37kfCNk,41975294,70992213,-29016919,623
2022-04-08 17:47:18-04:00,14902,AKcGcqFMxvVWFHpc9oUJYGZsLN4DUHVkMSLGYrMcCYYN,4dWje79e7kH8GWJwwfB76BQUVUSgnYHTVxrtfNyG5A4K,True,13226561295,1938038379,12076179,6038089,6038090,3zqXX6kzhkbW3d4TwD2CNjMRwxTbREXySekvq37kfCNk,824164999,2144625325,-1320460326,623
2022-04-08 17:53:19-04:00,14903,6Rk6wVu6pCDFwEWDbiY8wS93nDghyHP9kzdUEa6eFRRq,B5v7eFjSX6dDt1kt84Uvtqmrn7STbQPMbFMvjH6WGXJg,True,143790834,35947708,221349,110674,110675,A9TwRM1BMxqb8DCC7YNAMV6zPenEJm3HTZBy7wJKK58U,8853966,24953928,-16099962,615
2022-04-08 17:53:29-04:00,14904,D85pWm1LS9MvtR4f3QhkFLvNUhZLQ2NZBFQTyAVnmigm,CRN85DYkJJi6irhtVAf4qcJU3ijVodWdXgWe7Fs6Ahka,True,71251480,17812870,111315,55657,55658,YQC4EUcgeBi9431viwvzvBbZJW3szeHX4dFmowRDyDw,4452603,14517679,-10065076,624
2022-04-08 17:53:38-04:00,14905,HHp8dRc1YMWE93uyLdM98DkUhM8U8zm3JC59chrbbWrk,AdqFuGe28VeAwwjRPZCBGVy5ftf9zNNQkg413i66wyig,True,596981032,149245258,930495,465247,465248,3zqXX6kzhkbW3d4TwD2CNjMRwxTbREXySekvq37kfCNk,37219821,66810247,-29590426,623
2022-04-08 18:00:05-04:00,14906,BhhVhLVZkSd3aHDMd6ojTgtJtbgAdMCA9Xj8jL2GMXoL,G8HUQp2yGSw9T6it5ej91cqkd82naca8heji453g2jEH,True,6183817663,806443939,5039877,2519938,2519939,3zqXX6kzhkbW3d4TwD2CNjMRwxTbREXySekvq37kfCNk,386458155,800967406,-414509251,624
2022-04-08 18:03:41-04:00,14907,G3ZEAY19iDMjF7P57dgFUZiC4bpeFvMPKShenugL7E2Y,D6nUGgpWkQUZcUKZYawfedX67uqQ9Co1wEwtbHPMtc7X,True,2209883673,304091283,1895490,947745,947745,3zqXX6kzhkbW3d4TwD2CNjMRwxTbREXySekvq37kfCNk,137748587,620545891,-482797304,623
2022-04-08 18:05:08-04:00,14908,EDFNynTdSf9HfMkEuNJUeoeG6guc6zsg7zrmQuoA4Npn,A6DrZZWdZE1TbyXFthYNtyJUZMFhtCtwPqnREn5ECZcs,True,475336894,118834223,742529,371264,371265,3zqXX6kzhkbW3d4TwD2CNjMRwxTbREXySekvq37kfCNk,29701170,53864378,-24163208,624
2022-04-08 18:07:52-04:00,14909,BjCNaM7YbE9SjFi7tzi4677zg1fKXGJwtecz2GWwWuhd,6rNsSrKZezQrLb2whToNjnizpnurDXrobHqfEK3QqU1M,True,8234383088,937826012,5859933,2929966,2929967,YQC4EUcgeBi9431viwvzvBbZJW3szeHX4dFmowRDyDw,514519064,1312024753,-797505689,624
2022-04-08 18:14:48-04:00,14910,HhPoDtvrMxUEt4rCV26ToaomDtbpzu63c3VmPHzjYquH,DqBGCnJjZ8xopZLmdRM74EdGVxdwQG9jirfEp1n89J5m,True,19172834,4793208,29946,14973,14973,YQC4EUcgeBi9431viwvzvBbZJW3szeHX4dFmowRDyDw,1197863,1979440,-781577,624
2022-04-08 18:15:10-04:00,14911,FU7X4DWnGTbxwXULBq3v9SACzYhQyFGqsXjUDzyFqiem,925BaEnWxTfEv4oQb9Xf1wyyEEWEr8kXeSdXTtRfShfw,True,13224427034,1738418371,10787861,5393930,5393931,3zqXX6kzhkbW3d4TwD2CNjMRwxTbREXySekvq37kfCNk,820649921,2147581435,-1326931514,620
2022-04-08 18:15:10-04:00,14912,AKcGcqFMxvVWFHpc9oUJYGZsLN4DUHVkMSLGYrMcCYYN,4dWje79e7kH8GWJwwfB76BQUVUSgnYHTVxrtfNyG5A4K,True,11170192842,1435443009,8914518,4457259,4457259,3zqXX6kzhkbW3d4TwD2CNjMRwxTbREXySekvq37kfCNk,693701515,1855793697,-1162092182,621
2022-04-08 18:16:46-04:00,14913,8K1GzGeaAuFdjuVZi6DqBcYiA1zSRioMkRvjotr8p7fz,5mqocPwTdjwAPiJf7vx9bo7AzvfQBT2t5bV9u2Jzb2e1,True,260979847,65244961,459693,229846,229847,YQC4EUcgeBi9431viwvzvBbZJW3szeHX4dFmowRDyDw,18387725,32957517,-14569792,704
2022-04-08 18:17:24-04:00,14914,3DEyi4Dnfxc7d91JbTpQjdAP1Ypgx5kaTSm4wwh8Zbm2,Cb2aqg5MyjopPzx5zd4zU81RUwJDeNTGV1jfiCLmgNTL,True,65805203,16451300,102237,51118,51119,3zqXX6kzhkbW3d4TwD2CNjMRwxTbREXySekvq37kfCNk,4089492,9381468,-5291976,621
2022-04-08 18:17:25-04:00,14915,9WH1YzDrdvZs8aDuFLwQHHXa2e66ZcwdfDi7qXEjQxFy,3Tpc8DqJwg1tTDgk6qH1UhvtwvhXxsp5GRFYMWxa8NKX,True,3499801422,874950355,5443205,2721602,2721603,3zqXX6kzhkbW3d4TwD2CNjMRwxTbREXySekvq37kfCNk,217728231,650676536,-432948305,622
2022-04-08 18:21:13-04:00,14916,2xgQaQTs7bkK34jSBZ2dFZf1DJKjMVW9LA3D9Pwtfims,6rniSBeGcJAcrqWhhnKCcRV58yYnjuqXj9b4Zu8DUwQ9,True,24068422,5492324,34014,17007,17007,72FwbpFGoLEazJEdpqNtPNefsadUrimUqma9wSoy4qiS,1490576,5806982,-4316406,619
2022-04-08 18:21:17-04:00,14917,DXGapgtgkag6midSCYNhHCNaCqvhUmuSvnVhXxNXBmyt,Csq6W5QkGZL6qE6Z1ERF3bfHtKjnM8hAxiY1YA3rTwSX,True,363760863,90940215,558290,279145,279145,YQC4EUcgeBi9431viwvzvBbZJW3szeHX4dFmowRDyDw,22331613,86659500,-64327887,613
2022-04-08 18:21:17-04:00,14918,BhhVhLVZkSd3aHDMd6ojTgtJtbgAdMCA9Xj8jL2GMXoL,G8HUQp2yGSw9T6it5ej91cqkd82naca8heji453g2jEH,True,5328814510,733817460,4583825,2291912,2291913,3zqXX6kzhkbW3d4TwD2CNjMRwxTbREXySekvq37kfCNk,332866950,761592238,-428725288,624
2022-04-08 18:21:17-04:00,14919,5BjBPqumCb9KC82ZNNch3dcRzbpGdRLJneru7o9a1D9R,FuZtBWKktxFu4yoiLVMzxq8fMhQyN8SGzGPz49xs3m6P,True,2940964292,404016820,2523335,1261667,1261668,3zqXX6kzhkbW3d4TwD2CNjMRwxTbREXySekvq37kfCNk,183681497,446756229,-263074732,624
2022-04-08 18:21:17-04:00,14920,BjCNaM7YbE9SjFi7tzi4677zg1fKXGJwtecz2GWwWuhd,6rNsSrKZezQrLb2whToNjnizpnurDXrobHqfEK3QqU1M,True,7239996353,732449133,4573485,2286742,2286743,YQC4EUcgeBi9431viwvzvBbZJW3szeHX4dFmowRDyDw,452072675,1188206657,-736133982,624
2022-04-08 18:44:10-04:00,14921,85w2wxozVA7Zfm1FdA1yWb8D43jdC9mefYzNqFyRe5iU,BHieDhQaBUbsWGmqNerfbCAMMGGAjEPpiNiSWAQS57D5,True,589038218,147259554,886765,443382,443383,3zqXX6kzhkbW3d4TwD2CNjMRwxTbREXySekvq37kfCNk,35470602,64707016,-29236414,602
2022-04-08 18:44:11-04:00,14922,C3DnHRyndQw1EinnmrayLzuhP9KhXYKVDUpf55BumxG1,6aU3EvNk5CyD5LdGhQksYKkNxvJ5vw23JvMEdwqeDSMo,True,3693042174,923260543,5614819,2807409,2807410,3zqXX6kzhkbW3d4TwD2CNjMRwxTbREXySekvq37kfCNk,224592782,1124339718,-899746936,608
2022-04-08 19:01:12-04:00,14923,GeYsENPRf2qGZu9rJsi6UPQqHS6sR7LRLWsKbFgtMCSb,7A79wktqPkSpP7o4c1kP9CBpUibHTqycW81ZANgREc5S,True,56572216,14143054,88339,44169,44170,YQC4EUcgeBi9431viwvzvBbZJW3szeHX4dFmowRDyDw,3533583,14495844,-10962261,624
2022-04-08 19:06:07-04:00,14924,Drkw9ZfordJrXzMqEbeQHQ3phh7U6xgxRi5s36mSs5uZ,EoJmZX1JEwEeN65Gx4bGiKxbWjWfQ4SvTGMWSQmR9xY7,True,10545747605,1561846364,9749845,4874922,4874923,YQC4EUcgeBi9431viwvzvBbZJW3szeHX4dFmowRDyDw,658319663,1764207161,-1105887498,624
2022-04-08 19:07:46-04:00,14925,G3ZEAY19iDMjF7P57dgFUZiC4bpeFvMPKShenugL7E2Y,D6nUGgpWkQUZcUKZYawfedX67uqQ9Co1wEwtbHPMtc7X,True,1887252217,243962278,1516438,758219,758219,3zqXX6kzhkbW3d4TwD2CNjMRwxTbREXySekvq37kfCNk,117309199,544569170,-427259971,621
2022-04-08 19:07:52-04:00,14926,5BjBPqumCb9KC82ZNNch3dcRzbpGdRLJneru7o9a1D9R,FuZtBWKktxFu4yoiLVMzxq8fMhQyN8SGzGPz49xs3m6P,True,2511055200,327379048,2023690,1011845,1011845,3zqXX6kzhkbW3d4TwD2CNjMRwxTbREXySekvq37kfCNk,155220675,395587957,-240367282,618
2022-04-08 19:07:54-04:00,14927,EFHg5FatMRRSZnKJPJF9e1iw2cjPJRmwTTZYtkHno9DP,84LnLKhZDJgWFnbBYnYjqWkjymemXfidecPFwnUAvuFj,True,6600609740,1650152435,10068954,5034477,5034477,YQC4EUcgeBi9431viwvzvBbZJW3szeHX4dFmowRDyDw,402758196,900077509,-497319313,610
2022-04-08 19:07:54-04:00,14928,5YC2wXkdk7D4Ubs9TEAbP1hi88Sy35bzYVWjLbgVxn5s,4Mx69ezqFK2wudZ62oVhx2pwjVbKv8JB1HR29ZUcdEJb,True,1574491095,393622773,2421048,1210524,1210524,YQC4EUcgeBi9431viwvzvBbZJW3szeHX4dFmowRDyDw,96841953,262798033,-165956080,615
2022-04-08 19:07:58-04:00,14929,EBRWnRzoNv5RytEjgrs5TXdiCMApLKHMntJJJzehJJns,5nJiYTa3GEbmaRwY1PvBJ1teXikQKgbUop5ANgaDhhcP,True,16737715,4184428,25161,12580,12581,YQC4EUcgeBi9431viwvzvBbZJW3szeHX4dFmowRDyDw,1006456,3846183,-2839727,601
2022-04-08 19:07:58-04:00,14930,J8khFNhJg25xVY7yjEtETTQVVzKHqdVCs1Rh2pJKvJqU,4eUP2YxTapjr6TLrd57XxZan7KJG5AtHK8yPRNVEbavx,True,494082160,123520540,757614,378807,378807,3zqXX6kzhkbW3d4TwD2CNjMRwxTbREXySekvq37kfCNk,30304561,62688451,-32383890,613
2022-04-08 19:07:58-04:00,14931,3geiQ6Ph1iyCnfEfTmWpVnvdJnYoUb3HNeKXwshQMJuF,3uu2PC2DhTR3iXVEKbq5hC8FrzyTYbwF9Ztm3BD3hjEm,True,314606512,78651628,477936,238968,238968,3zqXX6kzhkbW3d4TwD2CNjMRwxTbREXySekvq37kfCNk,19117460,79471880,-60354420,607
2022-04-08 19:07:58-04:00,14932,7yW1M1xeVx4hy3QftnpqdBDRYwamfu3K5i6AEnxgyTWb,7wf7FWS2DYp5RveQAmGNXAEUWPcHziuMLd4hV5LPgxF8,True,129317611,32329402,192276,96138,96138,YQC4EUcgeBi9431viwvzvBbZJW3szeHX4dFmowRDyDw,7691052,18990545,-11299493,594
2022-04-08 19:07:59-04:00,14933,68zbVKnneMQqngbNkeLtPEP2ayNhawc1B2hPgqAEqgXK,HqiFpLr4NC7xJz9bEFusq8bCKaoxAQG1xsLxdUAzg8aa,True,9768465403,1312274894,8199153,4099576,4099577,3zqXX6kzhkbW3d4TwD2CNjMRwxTbREXySekvq37kfCNk,610338178,1613426797,-1003088619,624
2022-04-08 19:07:59-04:00,14934,eiLMepBYM3VcWarQJC9fTnxotyMuUTbyMGJECedPEfu,k2ZfwPNBBCK7PvZ6MEvELTHHtQZSXCRGCymvkZwhDDt,True,26511873,3663761,21911,10955,10956,YQC4EUcgeBi9431viwvzvBbZJW3szeHX4dFmowRDyDw,1585614,6033715,-4448101,598
2022-04-08 19:08:01-04:00,14935,67DwuUmzk6uGwmptjYErQssFeJ5fd1ztFwKWZUovr7pK,HKzc15e1QLBrSsbAENyMXSVHDoap1F5MHCHB9L1Dm8HA,True,108650045,27162511,158045,79022,79023,47z82br5WdW2DZajdnPDPSSRRKsyAggqXqK6oPUwTaLf,6321800,30761676,-24439876,581
2022-04-08 19:08:06-04:00,14936,H8wYaRqc2wQuE3AdnSA2bCbukzxZEUCS5KbGYNsLAoho,F4ZEmseEyZfy3ZL6iyrczRZ9bww9HgVd8tYXExfbTcj1,True,59695103,14923775,92174,46087,46087,3zqXX6kzhkbW3d4TwD2CNjMRwxTbREXySekvq37kfCNk,3686960,15252350,-11565390,617
2022-04-08 19:08:14-04:00,14937,GRqv7y5n92vQ7bXcBqUng4vaau6w1tQeou953s8kJNwD,Bk75oioYmUzfdpbxDHTFb2nWhJgNqAt8ud1ehem3VVhh,True,2419832489,604958122,3753577,1876788,1876789,3zqXX6kzhkbW3d4TwD2CNjMRwxTbREXySekvq37kfCNk,150143100,396555774,-246412674,620
2022-04-08 19:08:15-04:00,14938,CZhzJ91hP1pFbNNz7YnUKXznvs6ZFVSRNLbe1SaTw29o,X3B4LpHFfeJPmCnEmRQ8V6MNMi7KpTE4MLD7LHYXUwy,True,218621755,19273517,120447,60223,60224,YQC4EUcgeBi9431viwvzvBbZJW3szeHX4dFmowRDyDw,13662541,40478578,-26816037,624
2022-04-08 19:08:20-04:00,14939,8nFpzAFXELGPsrgFwRjTfUidNme1CvgKQTsHWATtMqkz,ABt8ikXHraZ1bqkDUvMtJ3AUzADDWcCL8kMMDpAoth8V,True,21036880,5259220,31383,15691,15692,47z82br5WdW2DZajdnPDPSSRRKsyAggqXqK6oPUwTaLf,1255350,6388695,-5133345,596
2022-04-08 19:08:22-04:00,14940,AyFWvQUX79sq8L7KhcYrPRbxd6whUvEMETZL8atuuRr2,9LTjofdhGLn2Ltv6XfuHtX8MKEPzScGL669pC8Lrgtnh,False,13024462,13024462,755783,37789,717994,47z82br5WdW2DZajdnPDPSSRRKsyAggqXqK6oPUwTaLf,755783,3288714,-2532931,580
2022-04-08 19:11:56-04:00,14941,HHp8dRc1YMWE93uyLdM98DkUhM8U8zm3JC59chrbbWrk,AdqFuGe28VeAwwjRPZCBGVy5ftf9zNNQkg413i66wyig,True,438684597,109671149,680522,340261,340261,3zqXX6kzhkbW3d4TwD2CNjMRwxTbREXySekvq37kfCNk,27220914,58467993,-31247079,620
2022-04-08 19:11:56-04:00,14942,1EH82ta3wXUyUwW8VWQnVzSG3r1rHcSj2DvDeTKmp3F,B6aMfucYPbCzWBtauLtgTpwR45wKSK8yqscHJR3F5usu,True,875699402,218924850,1353627,676813,676814,3zqXX6kzhkbW3d4TwD2CNjMRwxTbREXySekvq37kfCNk,54145116,104983523,-50838407,618
2022-04-08 19:11:58-04:00,14943,2i5g7q4gD1GEfSz8BkhKn1idQ5U7cFPbMDWugjr7bBQW,Dpx6K9G5uZD63rTzBafZ56WKd1X9M25Mzfppd7Jib4xn,True,1425205692,356301423,2143092,1071546,1071546,3zqXX6kzhkbW3d4TwD2CNjMRwxTbREXySekvq37kfCNk,85723697,447475809,-361752112,601
2022-04-08 19:12:08-04:00,14944,HhPoDtvrMxUEt4rCV26ToaomDtbpzu63c3VmPHzjYquH,DqBGCnJjZ8xopZLmdRM74EdGVxdwQG9jirfEp1n89J5m,False,14050863,14050863,839079,41953,797126,YQC4EUcgeBi9431viwvzvBbZJW3szeHX4dFmowRDyDw,839079,1754028,-914949,597
2022-04-08 19:12:08-04:00,14945,9WH1YzDrdvZs8aDuFLwQHHXa2e66ZcwdfDi7qXEjQxFy,3Tpc8DqJwg1tTDgk6qH1UhvtwvhXxsp5GRFYMWxa8NKX,True,2570540690,642635172,3949018,1974509,1974509,3zqXX6kzhkbW3d4TwD2CNjMRwxTbREXySekvq37kfCNk,157960750,537081533,-379120783,614
2022-04-08 19:12:10-04:00,14946,4GbUrgiR6A91h3J9HHpuYCkZzjwrb62n3BURLeWj6Nic,12nUFUGYF1rXbwPeCbdGKdP3RE4g984fmZZggEYSFTZn,True,60766507,15191626,91594,45797,45797,YQC4EUcgeBi9431viwvzvBbZJW3szeHX4dFmowRDyDw,3663794,18631187,-14967393,602
2022-04-08 19:12:29-04:00,14947,AKcGcqFMxvVWFHpc9oUJYGZsLN4DUHVkMSLGYrMcCYYN,4dWje79e7kH8GWJwwfB76BQUVUSgnYHTVxrtfNyG5A4K,True,9649930087,1338022636,8317151,4158575,4158576,YQC4EUcgeBi9431viwvzvBbZJW3szeHX4dFmowRDyDw,599839916,1620947560,-1021107644,621
2022-04-08 19:12:29-04:00,14948,2xgQaQTs7bkK34jSBZ2dFZf1DJKjMVW9LA3D9Pwtfims,6rniSBeGcJAcrqWhhnKCcRV58yYnjuqXj9b4Zu8DUwQ9,True,18238794,4037504,24774,12387,12387,YQC4EUcgeBi9431viwvzvBbZJW3szeHX4dFmowRDyDw,1119161,4703994,-3584833,613
2022-04-08 19:12:30-04:00,14949,HT2SuCbePhjNZaar24uVwihYowCNvSjdvhJ8BRSVw9nX,98Ts4LCnapHVoCJ5PW3Armvh4jvDtpfs3SYRLRxiAgzZ,True,21775647401,5443911850,33001227,16500613,16500614,3zqXX6kzhkbW3d4TwD2CNjMRwxTbREXySekvq37kfCNk,1320049114,2976100771,-1656051657,606
2022-04-08 19:23:48-04:00,14950,Drkw9ZfordJrXzMqEbeQHQ3phh7U6xgxRi5s36mSs5uZ,EoJmZX1JEwEeN65Gx4bGiKxbWjWfQ4SvTGMWSQmR9xY7,True,8944857673,1157110263,7228771,3614385,3614386,3zqXX6kzhkbW3d4TwD2CNjMRwxTbREXySekvq37kfCNk,558808730,1550474162,-991665432,624
2022-04-08 19:25:19-04:00,14951,85w2wxozVA7Zfm1FdA1yWb8D43jdC9mefYzNqFyRe5iU,BHieDhQaBUbsWGmqNerfbCAMMGGAjEPpiNiSWAQS57D5,True,434331005,108582751,678345,339172,339173,3zqXX6kzhkbW3d4TwD2CNjMRwxTbREXySekvq37kfCNk,27133822,56511426,-29377604,624
2022-04-08 19:27:23-04:00,14952,C3DnHRyndQw1EinnmrayLzuhP9KhXYKVDUpf55BumxG1,6aU3EvNk5CyD5LdGhQksYKkNxvJ5vw23JvMEdwqeDSMo,True,2720775159,680193789,4248917,2124458,2124459,3zqXX6kzhkbW3d4TwD2CNjMRwxTbREXySekvq37kfCNk,169956714,893896066,-723939352,624
2022-04-08 19:33:23-04:00,14953,DVMLxFACqaNBD7q1TGJUUApJX7etJsxQRRFBP2DfBazJ,4hnRjD7S2KxD7UrgfrApntVxUD7Srh5E9nwPY53v89kz,True,214211785,21818798,141620,70810,70810,YQC4EUcgeBi9431viwvzvBbZJW3szeHX4dFmowRDyDw,13903940,50206576,-36302636,649
2022-04-08 19:35:29-04:00,14954,BjCNaM7YbE9SjFi7tzi4677zg1fKXGJwtecz2GWwWuhd,6rNsSrKZezQrLb2whToNjnizpnurDXrobHqfEK3QqU1M,True,6463783418,700972232,4377823,2188911,2188912,3zqXX6kzhkbW3d4TwD2CNjMRwxTbREXySekvq37kfCNk,403686491,1151830687,-748144196,624
2022-04-08 19:45:33-04:00,14955,G3ZEAY19iDMjF7P57dgFUZiC4bpeFvMPKShenugL7E2Y,D6nUGgpWkQUZcUKZYawfedX67uqQ9Co1wEwtbHPMtc7X,True,1629199786,226245184,1412332,706166,706166,YQC4EUcgeBi9431viwvzvBbZJW3szeHX4dFmowRDyDw,101702608,492033811,-390331203,624
2022-04-08 22:35:05-04:00,14956,bYUscp4qgQap7iDu5R8tyBz73dov4j3zDV2FgDUvSDx,E4d8ank6Ymezu4ubD2tU5B5fXuoh2E1RQkrdaLgMfuaT,True,1558485692,389621423,2425840,1212920,1212920,3zqXX6kzhkbW3d4TwD2CNjMRwxTbREXySekvq37kfCNk,97033635,260580486,-163546851,622
2022-04-08 22:35:51-04:00,14957,FU7X4DWnGTbxwXULBq3v9SACzYhQyFGqsXjUDzyFqiem,925BaEnWxTfEv4oQb9Xf1wyyEEWEr8kXeSdXTtRfShfw,True,11373780174,1535457523,9412956,4706478,4706478,YQC4EUcgeBi9431viwvzvBbZJW3szeHX4dFmowRDyDw,697257312,1914807212,-1217549900,613
2022-04-08 22:38:06-04:00,14958,FV9CBGGTbppLnBKh79f2LzD1diTiS5g6u89FcpZHZmnK,Fe7mtmCUziFqbbYTvrhAcAq1Ub7YLfTJRtQ1hG7GzJD1,True,192322750,42417437,264672,132336,132336,A9TwRM1BMxqb8DCC7YNAMV6zPenEJm3HTZBy7wJKK58U,12000408,37631947,-25631539,623
2022-04-08 22:41:00-04:00,14959,GHHkWuoUrAsuf1n8Y2GFozQxxv3LSr2zU9DWwKmAGTG9,7Fr2hNXbiNUufq8USBK3HwWN4bQT6H9fcFzDt7fdKy2U,True,403048717892,100762179473,629267397,314633698,314633699,3zqXX6kzhkbW3d4TwD2CNjMRwxTbREXySekvq37kfCNk,25170695914,113070752462,-87900056548,624
2022-04-08 22:41:00-04:00,14960,B6Wc3euMqUf6QjzCqDtNeAEUM7MvADFaiReEq9VYH2Qg,2pzhsqXYd5u7h4xTN8bMS3GbicVnJ6KY3MQn7spSXroA,True,1061106199,190894668,1102215,551107,551108,3zqXX6kzhkbW3d4TwD2CNjMRwxTbREXySekvq37kfCNk,61267731,84630880,-23363149,577
2022-04-08 22:41:07-04:00,14961,8nFpzAFXELGPsrgFwRjTfUidNme1CvgKQTsHWATtMqkz,ABt8ikXHraZ1bqkDUvMtJ3AUzADDWcCL8kMMDpAoth8V,False,15487910,15487910,933840,46692,887148,3zqXX6kzhkbW3d4TwD2CNjMRwxTbREXySekvq37kfCNk,933840,5073603,-4139763,602
2022-04-08 22:41:07-04:00,14962,EBRWnRzoNv5RytEjgrs5TXdiCMApLKHMntJJJzehJJns,5nJiYTa3GEbmaRwY1PvBJ1teXikQKgbUop5ANgaDhhcP,False,12319636,12319636,747344,37367,709977,3zqXX6kzhkbW3d4TwD2CNjMRwxTbREXySekvq37kfCNk,747344,3110793,-2363449,606
2022-04-08 22:41:08-04:00,14963,67DwuUmzk6uGwmptjYErQssFeJ5fd1ztFwKWZUovr7pK,HKzc15e1QLBrSsbAENyMXSVHDoap1F5MHCHB9L1Dm8HA,True,79977440,19994360,116292,58146,58146,3zqXX6kzhkbW3d4TwD2CNjMRwxTbREXySekvq37kfCNk,4651713,24491820,-19840107,581
2022-04-08 22:41:08-04:00,14964,5YC2wXkdk7D4Ubs9TEAbP1hi88Sy35bzYVWjLbgVxn5s,4Mx69ezqFK2wudZ62oVhx2pwjVbKv8JB1HR29ZUcdEJb,True,1158638889,289659722,1804080,902040,902040,3zqXX6kzhkbW3d4TwD2CNjMRwxTbREXySekvq37kfCNk,72163238,218879636,-146716398,622
2022-04-08 22:41:08-04:00,14965,3geiQ6Ph1iyCnfEfTmWpVnvdJnYoUb3HNeKXwshQMJuF,3uu2PC2DhTR3iXVEKbq5hC8FrzyTYbwF9Ztm3BD3hjEm,True,231575033,57893758,356350,178175,178175,3zqXX6kzhkbW3d4TwD2CNjMRwxTbREXySekvq37kfCNk,14254030,63900554,-49646524,615
2022-04-08 22:41:08-04:00,14966,EFHg5FatMRRSZnKJPJF9e1iw2cjPJRmwTTZYtkHno9DP,84LnLKhZDJgWFnbBYnYjqWkjymemXfidecPFwnUAvuFj,True,4856993251,1214248312,7477670,3738835,3738835,3zqXX6kzhkbW3d4TwD2CNjMRwxTbREXySekvq37kfCNk,299106810,765900639,-466793829,615
2022-04-08 22:41:09-04:00,14967,GeYsENPRf2qGZu9rJsi6UPQqHS6sR7LRLWsKbFgtMCSb,7A79wktqPkSpP7o4c1kP9CBpUibHTqycW81ZANgREc5S,True,41366171,10341542,59531,29765,29766,3zqXX6kzhkbW3d4TwD2CNjMRwxTbREXySekvq37kfCNk,2381245,11665960,-9284715,575
2022-04-08 22:41:09-04:00,14968,J8khFNhJg25xVY7yjEtETTQVVzKHqdVCs1Rh2pJKvJqU,4eUP2YxTapjr6TLrd57XxZan7KJG5AtHK8yPRNVEbavx,True,363644488,90911122,565523,282761,282762,3zqXX6kzhkbW3d4TwD2CNjMRwxTbREXySekvq37kfCNk,22620953,53827893,-31206940,622
2022-04-08 22:41:11-04:00,14969,BhhVhLVZkSd3aHDMd6ojTgtJtbgAdMCA9Xj8jL2GMXoL,G8HUQp2yGSw9T6it5ej91cqkd82naca8heji453g2jEH,True,4541600361,601525303,3640383,1820191,1820192,3zqXX6kzhkbW3d4TwD2CNjMRwxTbREXySekvq37kfCNk,274854042,682137530,-407283488,605
2022-04-08 22:41:12-04:00,14970,eiLMepBYM3VcWarQJC9fTnxotyMuUTbyMGJECedPEfu,k2ZfwPNBBCK7PvZ6MEvELTHHtQZSXCRGCymvkZwhDDt,True,22653928,2965141,17916,8958,8958,3zqXX6kzhkbW3d4TwD2CNjMRwxTbREXySekvq37kfCNk,1368869,5109960,-3741091,604
2022-04-08 22:52:58-04:00,14971,bYUscp4qgQap7iDu5R8tyBz73dov4j3zDV2FgDUvSDx,E4d8ank6Ymezu4ubD2tU5B5fXuoh2E1RQkrdaLgMfuaT,True,1144707529,286176882,1761276,880638,880638,3zqXX6kzhkbW3d4TwD2CNjMRwxTbREXySekvq37kfCNk,70451055,217368592,-146917537,615
2022-04-08 22:53:25-04:00,14972,FU7X4DWnGTbxwXULBq3v9SACzYhQyFGqsXjUDzyFqiem,925BaEnWxTfEv4oQb9Xf1wyyEEWEr8kXeSdXTtRfShfw,True,9756942422,1302213620,8094193,4047096,4047097,YQC4EUcgeBi9431viwvzvBbZJW3szeHX4dFmowRDyDw,606464127,1764946423,-1158482296,621
2022-04-08 22:53:41-04:00,14973,7ueXVhSvXvttkeQ18w2cLh65naoEPvYF86RrdUK2Vc5Q,CKTehY1W6bw85cS4o7g2qXKjP4656Vwo37244BAEAiw1,True,10153173771,2538289961,15656179,7828089,7828090,3zqXX6kzhkbW3d4TwD2CNjMRwxTbREXySekvq37kfCNk,626248078,1095329125,-469081047,616
2022-04-08 22:53:45-04:00,14974,niCk6QHFU1kyU56Mdq5RJzKrecdkNSn23ZA6wduFdWS,BQbUYSw1XsuE6LnVd4XjmxAyYgx4drE4FsetJBCdwVZW,True,721375745,180329449,1082604,541302,541302,A9TwRM1BMxqb8DCC7YNAMV6zPenEJm3HTZBy7wJKK58U,43307662,38493238,4814424,600
2022-04-08 23:04:09-04:00,14975,6Rk6wVu6pCDFwEWDbiY8wS93nDghyHP9kzdUEa6eFRRq,B5v7eFjSX6dDt1kt84Uvtqmrn7STbQPMbFMvjH6WGXJg,True,105640259,26410064,160786,80393,80393,A9TwRM1BMxqb8DCC7YNAMV6zPenEJm3HTZBy7wJKK58U,6431459,20709446,-14277987,608
2022-04-08 23:04:15-04:00,14976,D85pWm1LS9MvtR4f3QhkFLvNUhZLQ2NZBFQTyAVnmigm,CRN85DYkJJi6irhtVAf4qcJU3ijVodWdXgWe7Fs6Ahka,True,52358252,13089563,81544,40772,40772,YQC4EUcgeBi9431viwvzvBbZJW3szeHX4dFmowRDyDw,3261777,11890980,-8629203,622
2022-04-08 23:09:36-04:00,14977,AKcGcqFMxvVWFHpc9oUJYGZsLN4DUHVkMSLGYrMcCYYN,4dWje79e7kH8GWJwwfB76BQUVUSgnYHTVxrtfNyG5A4K,True,8234806454,1060032723,6618952,3309476,3309476,3zqXX6kzhkbW3d4TwD2CNjMRwxTbREXySekvq37kfCNk,514189756,1529097589,-1014907833,624
2022-04-08 23:27:28-04:00,14978,EDFNynTdSf9HfMkEuNJUeoeG6guc6zsg7zrmQuoA4Npn,A6DrZZWdZE1TbyXFthYNtyJUZMFhtCtwPqnREn5ECZcs,True,349020262,87255065,537018,268509,268509,3zqXX6kzhkbW3d4TwD2CNjMRwxTbREXySekvq37kfCNk,21480757,47087108,-25606351,615
2022-04-09 03:33:53-04:00,14979,FV9CBGGTbppLnBKh79f2LzD1diTiS5g6u89FcpZHZmnK,Fe7mtmCUziFqbbYTvrhAcAq1Ub7YLfTJRtQ1hG7GzJD1,True,147336634,31089691,193488,96744,96744,3zqXX6kzhkbW3d4TwD2CNjMRwxTbREXySekvq37kfCNk,9169630,31801993,-22632363,622
2022-04-09 03:34:41-04:00,14980,9cwVnc8zu2wjSnvFuxPddMXSrgNajdn3sZH1qAtQQ8aQ,9xaYkDvEyDmAkWDhhZma9mLbUeB7BkLWtveDsagfJDVa,True,2760025625,690006406,4308511,2154255,2154256,YQC4EUcgeBi9431viwvzvBbZJW3szeHX4dFmowRDyDw,172340449,412317290,-239976841,624
2022-04-09 03:34:45-04:00,14981,FU7X4DWnGTbxwXULBq3v9SACzYhQyFGqsXjUDzyFqiem,925BaEnWxTfEv4oQb9Xf1wyyEEWEr8kXeSdXTtRfShfw,True,8379273916,1117503470,6975461,3487730,3487731,YQC4EUcgeBi9431viwvzvBbZJW3szeHX4dFmowRDyDw,523034645,1589009563,-1065974918,624
2022-04-09 03:34:56-04:00,14982,bYUscp4qgQap7iDu5R8tyBz73dov4j3zDV2FgDUvSDx,E4d8ank6Ymezu4ubD2tU5B5fXuoh2E1RQkrdaLgMfuaT,True,841428058,210357014,1290102,645051,645051,3zqXX6kzhkbW3d4TwD2CNjMRwxTbREXySekvq37kfCNk,51604093,178950875,-127346782,613
2022-04-09 08:19:41-04:00,14983,niCk6QHFU1kyU56Mdq5RJzKrecdkNSn23ZA6wduFdWS,BQbUYSw1XsuE6LnVd4XjmxAyYgx4drE4FsetJBCdwVZW,True,548461494,137100713,854834,427417,427417,3zqXX6kzhkbW3d4TwD2CNjMRwxTbREXySekvq37kfCNk,34197065,38643062,-4445997,623
2022-04-09 08:19:41-04:00,14984,7ueXVhSvXvttkeQ18w2cLh65naoEPvYF86RrdUK2Vc5Q,CKTehY1W6bw85cS4o7g2qXKjP4656Vwo37244BAEAiw1,True,7740444446,1935107618,12060262,6030131,6030131,3zqXX6kzhkbW3d4TwD2CNjMRwxTbREXySekvq37kfCNk,482411364,966569998,-484158634,623
2022-04-09 10:36:22-04:00,14985,niCk6QHFU1kyU56Mdq5RJzKrecdkNSn23ZA6wduFdWS,BQbUYSw1XsuE6LnVd4XjmxAyYgx4drE4FsetJBCdwVZW,True,470489302,117607622,733169,366584,366585,3zqXX6kzhkbW3d4TwD2CNjMRwxTbREXySekvq37kfCNk,29330451,36626896,-7296445,623
2022-04-09 11:29:15-04:00,14986,FV9CBGGTbppLnBKh79f2LzD1diTiS5g6u89FcpZHZmnK,Fe7mtmCUziFqbbYTvrhAcAq1Ub7YLfTJRtQ1hG7GzJD1,True,114036255,22790480,135365,67682,67683,YQC4EUcgeBi9431viwvzvBbZJW3szeHX4dFmowRDyDw,6773283,26716510,-19943227,593
2022-04-09 11:34:35-04:00,14987,9cwVnc8zu2wjSnvFuxPddMXSrgNajdn3sZH1qAtQQ8aQ,9xaYkDvEyDmAkWDhhZma9mLbUeB7BkLWtveDsagfJDVa,True,2024875465,506218866,3076254,1538127,1538127,3zqXX6kzhkbW3d4TwD2CNjMRwxTbREXySekvq37kfCNk,123050192,348493008,-225442816,607
2022-04-09 11:55:04-04:00,14988,bYUscp4qgQap7iDu5R8tyBz73dov4j3zDV2FgDUvSDx,E4d8ank6Ymezu4ubD2tU5B5fXuoh2E1RQkrdaLgMfuaT,True,618760197,154690049,951317,475658,475659,3zqXX6kzhkbW3d4TwD2CNjMRwxTbREXySekvq37kfCNk,38052704,145904848,-107852144,614
2022-04-09 19:54:02-04:00,14989,CVjkHr29t8pzeXU1U1CdMpT6qwf9Jw4XGxvxU7RURPYj,D66Zpxp7q4Tn4KiLa2pHTrADhgtP8tGqNXVPyCo9mcxc,True,264722043,66180510,411934,205967,205967,3zqXX6kzhkbW3d4TwD2CNjMRwxTbREXySekvq37kfCNk,16477392,25320911,-8843519,622
2022-04-10 01:52:53-04:00,14990,niCk6QHFU1kyU56Mdq5RJzKrecdkNSn23ZA6wduFdWS,BQbUYSw1XsuE6LnVd4XjmxAyYgx4drE4FsetJBCdwVZW,True,515690139,128907616,786479,393239,393240,3zqXX6kzhkbW3d4TwD2CNjMRwxTbREXySekvq37kfCNk,31462862,34028479,-2565617,610
2022-04-10 09:17:51-04:00,14991,niCk6QHFU1kyU56Mdq5RJzKrecdkNSn23ZA6wduFdWS,BQbUYSw1XsuE6LnVd4XjmxAyYgx4drE4FsetJBCdwVZW,True,379789580,94932604,592156,296078,296078,3zqXX6kzhkbW3d4TwD2CNjMRwxTbREXySekvq37kfCNk,23689978,32618754,-8928776,623
2022-04-10 12:11:22-04:00,14992,5yPGvUz6JWKjkViGwTCpygJii1rP2xv5yx146ULtBiYq,FMnHUCQWTf1UHu5qVFqUAsWh8aba9EQYTEoiXy55totD,True,283418285,49406128,330199,165099,165100,3zqXX6kzhkbW3d4TwD2CNjMRwxTbREXySekvq37kfCNk,18941937,33438365,-14496428,668
2022-04-10 12:20:59-04:00,14993,5yPGvUz6JWKjkViGwTCpygJii1rP2xv5yx146ULtBiYq,FMnHUCQWTf1UHu5qVFqUAsWh8aba9EQYTEoiXy55totD,True,238262120,38117087,229758,114879,114879,gjBMZYVujDjD1ECG4i97M8Q3gV9ESnwwTSUGropkusj,14361775,29368043,-15006268,602
2022-04-10 13:06:42-04:00,14994,5yPGvUz6JWKjkViGwTCpygJii1rP2xv5yx146ULtBiYq,FMnHUCQWTf1UHu5qVFqUAsWh8aba9EQYTEoiXy55totD,True,202332798,28941459,193084,96542,96542,YQC4EUcgeBi9431viwvzvBbZJW3szeHX4dFmowRDyDw,13498764,25277338,-11778574,667
2022-04-10 13:36:50-04:00,14995,91PHFbjP3wsdXAnuRyat9QBjPUsHxNtxGCUp89QsNRX,BAXFngHf8fnQ7MXUD86WCVT41BkCdwuRYVjP86x478Yv,True,524515927,131128862,817290,408645,408645,3zqXX6kzhkbW3d4TwD2CNjMRwxTbREXySekvq37kfCNk,32691667,50541787,-17850120,623
2022-04-10 13:37:58-04:00,14996,DZHhvYM7HgnwRtgdbmio4pRA9r1jHdd1dWcxwycx6aGT,3u9E35HEg3go9H3PT5jVfriYXenpKF6ZQHeM3QexnPzU,True,1850509651,462627412,2888785,1444392,1444393,3zqXX6kzhkbW3d4TwD2CNjMRwxTbREXySekvq37kfCNk,115551401,160636063,-45084662,624
2022-04-10 14:02:47-04:00,14997,CAeUB4VbyVdcNRTfj7PQShbkx7HgYsBz5JK1NcHfUYQa,Duarumo4Amf86Dkd2pFyJP73NimC9i4dBttxZC6rEiJE,True,4117308535,1029327133,6413990,3206995,3206995,YQC4EUcgeBi9431viwvzvBbZJW3szeHX4dFmowRDyDw,256559622,394053529,-137493907,623
2022-04-10 18:17:05-04:00,14998,niCk6QHFU1kyU56Mdq5RJzKrecdkNSn23ZA6wduFdWS,BQbUYSw1XsuE6LnVd4XjmxAyYgx4drE4FsetJBCdwVZW,True,324724479,81166160,492919,246459,246460,3zqXX6kzhkbW3d4TwD2CNjMRwxTbREXySekvq37kfCNk,19720428,29781759,-10061331,607
2022-04-10 18:32:38-04:00,14999,7ueXVhSvXvttkeQ18w2cLh65naoEPvYF86RrdUK2Vc5Q,CKTehY1W6bw85cS4o7g2qXKjP4656Vwo37244BAEAiw1,True,5679384470,1419842635,8658578,4329289,4329289,YQC4EUcgeBi9431viwvzvBbZJW3szeHX4dFmowRDyDw,346344019,837856679,-491512660,609
2022-04-10 18:32:39-04:00,15000,J6ndjmic8buVqwa4URRRgv2iTc4ekbYUHdcpa3DUCufN,7qvvczUw8ngwdQae49BiQwQmdV2SSWsAVV2tmZYL7gw6,True,34366906940,8591726735,52020717,26010358,26010359,3zqXX6kzhkbW3d4TwD2CNjMRwxTbREXySekvq37kfCNk,2080828680,4276989431,-2196160751,605
2022-04-10 18:32:42-04:00,15001,6RuQVU9nu2Ecp177M9ggWczLACvQ8PfT31RTcmfwe9Hq,DZgsgqvMNLTXkBxySZC7Monak2JGsXRMJT4hBQzpf6Xm,True,5318593796,1329648449,7814618,3907309,3907309,3zqXX6kzhkbW3d4TwD2CNjMRwxTbREXySekvq37kfCNk,312584733,471915030,-159330297,587
2022-04-10 18:32:42-04:00,15002,niCk6QHFU1kyU56Mdq5RJzKrecdkNSn23ZA6wduFdWS,BQbUYSw1XsuE6LnVd4XjmxAyYgx4drE4FsetJBCdwVZW,True,238787511,59682017,361347,180673,180674,68sueyVfmy5ToEGtLFGDkwebX47xAmzyXE29z8JrmcWv,14457497,26780208,-12322711,605
2022-04-10 18:35:38-04:00,15003,5yPGvUz6JWKjkViGwTCpygJii1rP2xv5yx146ULtBiYq,FMnHUCQWTf1UHu5qVFqUAsWh8aba9EQYTEoiXy55totD,True,172194517,21780408,145744,72872,72872,68sueyVfmy5ToEGtLFGDkwebX47xAmzyXE29z8JrmcWv,11522453,21836043,-10313590,669
2022-04-10 18:36:33-04:00,15004,AU9vtUZ67mcXMyPDf32gEg9RCDwMu1Emk2LiuYfrvdQT,5vyahLZJeuVbKxfPvoxsYG65y9Jrz7ehMXUFQXk4dLdd,False,286514,286514,17896,894,17002,gjBMZYVujDjD1ECG4i97M8Q3gV9ESnwwTSUGropkusj,17896,31382,-13486,624
2022-04-10 18:39:32-04:00,15005,9cwVnc8zu2wjSnvFuxPddMXSrgNajdn3sZH1qAtQQ8aQ,9xaYkDvEyDmAkWDhhZma9mLbUeB7BkLWtveDsagfJDVa,True,1489420988,372355247,2279138,1139569,1139569,YQC4EUcgeBi9431viwvzvBbZJW3szeHX4dFmowRDyDw,91165542,289659350,-198493808,612
2022-04-10 18:45:12-04:00,15006,H1oYXGZTagwv48FdDe6RNkjNaesedqLKyXxTmPc5k4Fp,Am3rx6XrkrZ4MdeZDyZUv1YW2fBujcz4dLjVCnRQHKZa,True,22808264,5702066,35506,17753,17753,68sueyVfmy5ToEGtLFGDkwebX47xAmzyXE29z8JrmcWv,1420264,2985832,-1565568,622
2022-04-10 18:45:44-04:00,15007,6TvTxJWSPeyaTVm8PmarVDzxhbTqnkyoabQTgihXyGMj,62ngTMHaRDFjpvzasDgfmgyJ5T6jS9PmYgy97HCkyQS4,True,45839844,11459961,71562,35781,35781,YQC4EUcgeBi9431viwvzvBbZJW3szeHX4dFmowRDyDw,2862517,4683959,-1821442,624
2022-04-10 18:46:03-04:00,15008,EC8fafqtuQzqbm2TZs3GeuXB9qXomkykrTG1na2rfFpx,A72f7W58h3r8nut45RmqdTk1J31NGYT2sVWMn18dK885,True,54465708,13616427,84615,42307,42308,YQC4EUcgeBi9431viwvzvBbZJW3szeHX4dFmowRDyDw,3384623,9001798,-5617175,621
2022-04-10 18:46:40-04:00,15009,FV9CBGGTbppLnBKh79f2LzD1diTiS5g6u89FcpZHZmnK,Fe7mtmCUziFqbbYTvrhAcAq1Ub7YLfTJRtQ1hG7GzJD1,True,90127269,16747288,102913,51456,51457,68sueyVfmy5ToEGtLFGDkwebX47xAmzyXE29z8JrmcWv,5538431,22398203,-16859772,614
2022-04-10 18:51:57-04:00,15010,Br1j5Ftafei7ysu5SmqVZSoRe4uS4qCPeKSPHg55pyiE,G8fc7QvXjfkgBFvAVUgJFQS3VaF1biL9rktBExGa87Ks,True,1163074485,290768621,1806800,903400,903400,68sueyVfmy5ToEGtLFGDkwebX47xAmzyXE29z8JrmcWv,72272008,104799983,-32527975,621
2022-04-10 19:49:29-04:00,15011,bYUscp4qgQap7iDu5R8tyBz73dov4j3zDV2FgDUvSDx,E4d8ank6Ymezu4ubD2tU5B5fXuoh2E1RQkrdaLgMfuaT,True,455197149,113799287,709028,354514,354514,3zqXX6kzhkbW3d4TwD2CNjMRwxTbREXySekvq37kfCNk,28361137,118140629,-89779492,623
2022-04-10 19:54:16-04:00,15012,7ueXVhSvXvttkeQ18w2cLh65naoEPvYF86RrdUK2Vc5Q,CKTehY1W6bw85cS4o7g2qXKjP4656Vwo37244BAEAiw1,True,4169409403,1042348872,6189282,3094641,3094641,YQC4EUcgeBi9431viwvzvBbZJW3szeHX4dFmowRDyDw,247572156,707698209,-460126053,593
2022-04-10 19:54:16-04:00,15013,6RuQVU9nu2Ecp177M9ggWczLACvQ8PfT31RTcmfwe9Hq,DZgsgqvMNLTXkBxySZC7Monak2JGsXRMJT4hBQzpf6Xm,True,3928476566,982119141,6107983,3053991,3053992,YQC4EUcgeBi9431viwvzvBbZJW3szeHX4dFmowRDyDw,244319357,425419600,-181100243,621
2022-04-10 19:57:28-04:00,15014,6Auz7aARPERW9zbV8428yFUWkA9DuitQYiWQzewueU3o,G1xfLGt5twz7MTfEq6NnMZBpr6GmXceKdGUQkc9jugRB,True,20520531,5130132,32059,16029,16030,YQC4EUcgeBi9431viwvzvBbZJW3szeHX4dFmowRDyDw,1282363,5778679,-4496316,624
2022-04-10 19:58:07-04:00,15015,AKcGcqFMxvVWFHpc9oUJYGZsLN4DUHVkMSLGYrMcCYYN,4dWje79e7kH8GWJwwfB76BQUVUSgnYHTVxrtfNyG5A4K,True,25580409963,5410127498,32836043,16418021,16418022,68sueyVfmy5ToEGtLFGDkwebX47xAmzyXE29z8JrmcWv,1552568714,3322602085,-1770033371,606
2022-04-10 19:58:26-04:00,15016,DXGapgtgkag6midSCYNhHCNaCqvhUmuSvnVhXxNXBmyt,Csq6W5QkGZL6qE6Z1ERF3bfHtKjnM8hAxiY1YA3rTwSX,True,267523808,66880952,414207,207103,207104,68sueyVfmy5ToEGtLFGDkwebX47xAmzyXE29z8JrmcWv,16568311,70112079,-53543768,619
2022-04-10 19:58:28-04:00,15017,7CSCMFa9W52tBDVUbXbc3woAy3GByeA1wPJdp3MgznPa,3447ptuVFu6G8B6N63RmS8mRv4n9PfHneypHLvbeaGLn,True,1780077144,236790255,1473055,736527,736528,YQC4EUcgeBi9431viwvzvBbZJW3szeHX4dFmowRDyDw,110737375,377891455,-267154080,622
2022-04-10 19:58:39-04:00,15018,HHp8dRc1YMWE93uyLdM98DkUhM8U8zm3JC59chrbbWrk,AdqFuGe28VeAwwjRPZCBGVy5ftf9zNNQkg413i66wyig,True,563568735,140892183,849960,424980,424980,3zqXX6kzhkbW3d4TwD2CNjMRwxTbREXySekvq37kfCNk,33998400,78509611,-44511211,603
2022-04-10 19:58:45-04:00,15019,68zbVKnneMQqngbNkeLtPEP2ayNhawc1B2hPgqAEqgXK,HqiFpLr4NC7xJz9bEFusq8bCKaoxAQG1xsLxdUAzg8aa,True,8374144633,986501743,6165335,3082667,3082668,3zqXX6kzhkbW3d4TwD2CNjMRwxTbREXySekvq37kfCNk,523358596,1507977427,-984618831,624
2022-04-10 19:58:46-04:00,15020,HooxSzasW3HMoFJ6sAvRQ75Char1J5aBdJtsqfDV6myp,BCmsWwpGeV4NNfeKZKKydty2uueLGHYTJDk1WErpXsVT,True,731732834,91604872,572481,286240,286241,3zqXX6kzhkbW3d4TwD2CNjMRwxTbREXySekvq37kfCNk,45729368,134771313,-89041945,624
2022-04-10 20:07:50-04:00,15021,niCk6QHFU1kyU56Mdq5RJzKrecdkNSn23ZA6wduFdWS,BQbUYSw1XsuE6LnVd4XjmxAyYgx4drE4FsetJBCdwVZW,True,175647498,43897136,265934,132967,132967,YQC4EUcgeBi9431viwvzvBbZJW3szeHX4dFmowRDyDw,10640991,23344793,-12703802,605
2022-04-10 20:08:29-04:00,15022,BjCNaM7YbE9SjFi7tzi4677zg1fKXGJwtecz2GWwWuhd,6rNsSrKZezQrLb2whToNjnizpnurDXrobHqfEK3QqU1M,True,5720748364,547042271,3414338,1707169,1707169,68sueyVfmy5ToEGtLFGDkwebX47xAmzyXE29z8JrmcWv,357057795,1056373269,-699315474,624
2022-04-10 20:08:53-04:00,15023,JABfWoDV2wW68XEDANXArYWM7zabdbp5NBVrvzZd3mML,5hYUtd1Uv2pAcrbtSNNVTrRuk8acjmh92mzSm4iz5HJA,True,63967484,8580241,53180,26590,26590,68sueyVfmy5ToEGtLFGDkwebX47xAmzyXE29z8JrmcWv,3964711,13575989,-9611278,619
2022-04-10 20:09:31-04:00,15024,AQr9mVmcXCNQhBVCfx63MwR6c4WqDSC9K2BZqr7N8LCx,CB7TWUaL381ounsLw6neAUaKRxJL9P1HC9uGX5e1Uxod,True,4407702606,414711951,2584249,1292124,1292125,3zqXX6kzhkbW3d4TwD2CNjMRwxTbREXySekvq37kfCNk,274663035,738461919,-463798884,623
2022-04-10 20:09:31-04:00,15025,6Rk6wVu6pCDFwEWDbiY8wS93nDghyHP9kzdUEa6eFRRq,B5v7eFjSX6dDt1kt84Uvtqmrn7STbQPMbFMvjH6WGXJg,True,77740518,19435129,120175,60087,60088,A9TwRM1BMxqb8DCC7YNAMV6zPenEJm3HTZBy7wJKK58U,4807025,17005276,-12198251,618
2022-04-10 20:10:00-04:00,15026,FV9CBGGTbppLnBKh79f2LzD1diTiS5g6u89FcpZHZmnK,Fe7mtmCUziFqbbYTvrhAcAq1Ub7YLfTJRtQ1hG7GzJD1,True,72465577,12365759,77158,38579,38579,YQC4EUcgeBi9431viwvzvBbZJW3szeHX4dFmowRDyDw,4521652,18798618,-14276966,623
2022-04-10 20:10:00-04:00,15027,D85pWm1LS9MvtR4f3QhkFLvNUhZLQ2NZBFQTyAVnmigm,CRN85DYkJJi6irhtVAf4qcJU3ijVodWdXgWe7Fs6Ahka,True,38471517,9617879,59899,29949,29950,YQC4EUcgeBi9431viwvzvBbZJW3szeHX4dFmowRDyDw,2395971,9665067,-7269096,622
2022-04-10 20:10:29-04:00,15028,7CSCMFa9W52tBDVUbXbc3woAy3GByeA1wPJdp3MgznPa,3447ptuVFu6G8B6N63RmS8mRv4n9PfHneypHLvbeaGLn,True,1528903335,180567397,1120162,560081,560081,68sueyVfmy5ToEGtLFGDkwebX47xAmzyXE29z8JrmcWv,94846578,345210199,-250363621,620
2022-04-10 20:10:46-04:00,15029,9cwVnc8zu2wjSnvFuxPddMXSrgNajdn3sZH1qAtQQ8aQ,9xaYkDvEyDmAkWDhhZma9mLbUeB7BkLWtveDsagfJDVa,True,1096626949,274156737,1711482,855741,855741,YQC4EUcgeBi9431viwvzvBbZJW3szeHX4dFmowRDyDw,68459308,237866564,-169407256,624
2022-04-10 20:11:06-04:00,15030,4ZF1wtHKAnxmEZGACgbgphHvuo5aK4wC4MCNJzLYVkMX,5UXyhRP3Rjsc1RbV8BouJVQoTbWWbuPtVJY15KcHJFCN,True,1743625267,352978625,2205574,1102787,1102787,3zqXX6kzhkbW3d4TwD2CNjMRwxTbREXySekvq37kfCNk,108949823,194446482,-85496659,624
2022-04-10 20:22:35-04:00,15031,7AizMrxWWr7qfneuXMy6ifL3BVDTAKkuud4PyZFy92kh,GyAWRRfQkVAXtyhVF14vU3kPMr4kG1VyA9FAHdDTr8ud,True,391275759,97818939,607087,303543,303544,3zqXX6kzhkbW3d4TwD2CNjMRwxTbREXySekvq37kfCNk,24283512,56157065,-31873553,620
2022-04-10 20:22:43-04:00,15032,bYUscp4qgQap7iDu5R8tyBz73dov4j3zDV2FgDUvSDx,E4d8ank6Ymezu4ubD2tU5B5fXuoh2E1RQkrdaLgMfuaT,True,333350728,83337682,490175,245087,245088,3zqXX6kzhkbW3d4TwD2CNjMRwxTbREXySekvq37kfCNk,19607000,94998439,-75391439,588
2022-04-10 20:22:54-04:00,15033,5BjBPqumCb9KC82ZNNch3dcRzbpGdRLJneru7o9a1D9R,FuZtBWKktxFu4yoiLVMzxq8fMhQyN8SGzGPz49xs3m6P,True,2164450011,295570246,1818564,909282,909282,YQC4EUcgeBi9431viwvzvBbZJW3szeHX4dFmowRDyDw,133172827,371830399,-238657572,615
2022-04-10 20:22:54-04:00,15034,BjCNaM7YbE9SjFi7tzi4677zg1fKXGJwtecz2GWwWuhd,6rNsSrKZezQrLb2whToNjnizpnurDXrobHqfEK3QqU1M,True,5134605828,507509185,3108973,1554486,1554487,YQC4EUcgeBi9431viwvzvBbZJW3szeHX4dFmowRDyDw,314543192,1026820793,-712277601,612
2022-04-10 20:22:59-04:00,15035,AKcGcqFMxvVWFHpc9oUJYGZsLN4DUHVkMSLGYrMcCYYN,4dWje79e7kH8GWJwwfB76BQUVUSgnYHTVxrtfNyG5A4K,True,19889751721,4003006814,24938953,12469476,12469477,YQC4EUcgeBi9431viwvzvBbZJW3szeHX4dFmowRDyDw,1239142541,2931742892,-1692600351,623
2022-04-10 20:23:12-04:00,15036,BdT4uGiqiKnWRumvsGn329vVgTQyBFHe9Ew5oFNtt1Be,2oEF2Vjc7mLzhxeXqeANwLBM1kLMvnMLA2mSh17tDxTa,False,283924,283924,17613,880,16733,2py1FiYeL2f7J3HU36qiJz6TD6HCmiTN36RyxYtapQCZ,17613,33689,-16076,620
2022-04-10 20:23:12-04:00,15037,2ssYxbmFPYBdse9a6NJ26M8hsscYpjv5MyqyYkjftdrL,FKvvXz9eYXW2zgy37eaUW9u2K9LnnDsNx3DcgtATpizY,True,108945380,27236345,169151,84575,84576,YQC4EUcgeBi9431viwvzvBbZJW3szeHX4dFmowRDyDw,6766051,20182542,-13416491,621
2022-04-10 20:23:19-04:00,15038,G3ZEAY19iDMjF7P57dgFUZiC4bpeFvMPKShenugL7E2Y,D6nUGgpWkQUZcUKZYawfedX67uqQ9Co1wEwtbHPMtc7X,True,1387636288,182610270,1121180,560590,560590,72FwbpFGoLEazJEdpqNtPNefsadUrimUqma9wSoy4qiS,85197372,433460249,-348262877,613
2022-04-10 20:23:26-04:00,15039,68zbVKnneMQqngbNkeLtPEP2ayNhawc1B2hPgqAEqgXK,HqiFpLr4NC7xJz9bEFusq8bCKaoxAQG1xsLxdUAzg8aa,True,7328365800,737663149,4609311,2304655,2304656,68sueyVfmy5ToEGtLFGDkwebX47xAmzyXE29z8JrmcWv,457915283,1428331296,-970416013,624
2022-04-10 20:23:52-04:00,15040,HooxSzasW3HMoFJ6sAvRQ75Char1J5aBdJtsqfDV6myp,BCmsWwpGeV4NNfeKZKKydty2uueLGHYTJDk1WErpXsVT,True,634642686,90684955,566737,283368,283369,YQC4EUcgeBi9431viwvzvBbZJW3szeHX4dFmowRDyDw,39662195,124664754,-85002559,624
2022-04-10 20:24:00-04:00,15041,7ueXVhSvXvttkeQ18w2cLh65naoEPvYF86RrdUK2Vc5Q,CKTehY1W6bw85cS4o7g2qXKjP4656Vwo37244BAEAiw1,True,3071913311,767974876,4656344,2328172,2328172,3zqXX6kzhkbW3d4TwD2CNjMRwxTbREXySekvq37kfCNk,186254606,587252813,-400998207,606
2022-04-10 20:24:09-04:00,15042,JABfWoDV2wW68XEDANXArYWM7zabdbp5NBVrvzZd3mML,5hYUtd1Uv2pAcrbtSNNVTrRuk8acjmh92mzSm4iz5HJA,True,54750814,7368822,44051,22025,22026,gjBMZYVujDjD1ECG4i97M8Q3gV9ESnwwTSUGropkusj,3273118,12374231,-9101113,597
2022-04-10 20:24:10-04:00,15043,AQr9mVmcXCNQhBVCfx63MwR6c4WqDSC9K2BZqr7N8LCx,CB7TWUaL381ounsLw6neAUaKRxJL9P1HC9uGX5e1Uxod,True,3964194674,310508551,1905592,952796,952796,gjBMZYVujDjD1ECG4i97M8Q3gV9ESnwwTSUGropkusj,243282805,711391364,-468108559,613
2022-04-10 20:24:13-04:00,15044,5F7WHSYiVtCY8Z9KX9h6AT8qr4hbsSYasG15fq82ZWhr,E5wj8cqKM1ofNv14TspTa8yRwern8y2w6pXekL4cAWX7,True,38310519,9577629,59157,29578,29579,YQC4EUcgeBi9431viwvzvBbZJW3szeHX4dFmowRDyDw,2366311,6235033,-3868722,617
2022-04-10 20:24:13-04:00,15045,8qq2gfbca7JXvq4gViBBVT2QAbM4MvBMEQLXgn8UUTvt,3o5jpBVYdFFEYrGRdCUkLrUC85wsuTKgy8iYwnpZyC1B,True,1309617396,117844617,704270,352135,352135,68sueyVfmy5ToEGtLFGDkwebX47xAmzyXE29z8JrmcWv,78266254,548799819,-470533565,597
2022-04-10 20:24:15-04:00,15046,BhhVhLVZkSd3aHDMd6ojTgtJtbgAdMCA9Xj8jL2GMXoL,G8HUQp2yGSw9T6it5ej91cqkd82naca8heji453g2jEH,True,3912673698,543311577,3394271,1697135,1697136,3zqXX6kzhkbW3d4TwD2CNjMRwxTbREXySekvq37kfCNk,244439446,650028485,-405589039,624
2022-04-10 20:24:33-04:00,15047,1EH82ta3wXUyUwW8VWQnVzSG3r1rHcSj2DvDeTKmp3F,B6aMfucYPbCzWBtauLtgTpwR45wKSK8yqscHJR3F5usu,True,766371806,191592951,1192672,596336,596336,gjBMZYVujDjD1ECG4i97M8Q3gV9ESnwwTSUGropkusj,47706895,90809798,-43102903,622
2022-04-10 22:04:18-04:00,15048,EDFNynTdSf9HfMkEuNJUeoeG6guc6zsg7zrmQuoA4Npn,A6DrZZWdZE1TbyXFthYNtyJUZMFhtCtwPqnREn5ECZcs,True,256762951,64190737,400783,200391,200392,3zqXX6kzhkbW3d4TwD2CNjMRwxTbREXySekvq37kfCNk,16031334,40239199,-24207865,624
2022-04-10 22:04:31-04:00,15049,EDzP8bi8wGytnFoz4RynYddWyVWd5RFhHKcGZdwyAHJH,ELHWRXKjwkmoEj3nkJ9hw2bcL6dRd4znFeoLjitNbrXt,True,30553605,7638401,47629,23814,23815,YQC4EUcgeBi9431viwvzvBbZJW3szeHX4dFmowRDyDw,1905160,8437100,-6531940,623
2022-04-10 22:04:32-04:00,15050,3uUdWwgwtFdPa3FJTSrirqPKMtQb3zmT5Wpp4zPy9sJP,5G7dhz8jvWekGy9Wh3ZCXNXSPbB1QArfFYs7MYNgRDkW,True,128601097,32150274,200619,100309,100310,YQC4EUcgeBi9431viwvzvBbZJW3szeHX4dFmowRDyDw,8024788,42896248,-34871460,624
2022-04-10 22:04:38-04:00,15051,6Auz7aARPERW9zbV8428yFUWkA9DuitQYiWQzewueU3o,G1xfLGt5twz7MTfEq6NnMZBpr6GmXceKdGUQkc9jugRB,False,15084039,15084039,942570,47128,895442,YQC4EUcgeBi9431viwvzvBbZJW3szeHX4dFmowRDyDw,942570,4621172,-3678602,624
2022-04-10 22:09:34-04:00,15052,HHp8dRc1YMWE93uyLdM98DkUhM8U8zm3JC59chrbbWrk,AdqFuGe28VeAwwjRPZCBGVy5ftf9zNNQkg413i66wyig,True,414707543,103676885,628533,314266,314267,68sueyVfmy5ToEGtLFGDkwebX47xAmzyXE29z8JrmcWv,25141354,66496665,-41355311,606
2022-04-10 22:09:47-04:00,15053,7CSCMFa9W52tBDVUbXbc3woAy3GByeA1wPJdp3MgznPa,3447ptuVFu6G8B6N63RmS8mRv4n9PfHneypHLvbeaGLn,True,1337963822,175604192,1092854,546427,546427,3zqXX6kzhkbW3d4TwD2CNjMRwxTbREXySekvq37kfCNk,83266807,310541808,-227275001,622
2022-04-10 22:21:27-04:00,15054,HooxSzasW3HMoFJ6sAvRQ75Char1J5aBdJtsqfDV6myp,BCmsWwpGeV4NNfeKZKKydty2uueLGHYTJDk1WErpXsVT,True,538520269,67513857,421796,210898,210898,3zqXX6kzhkbW3d4TwD2CNjMRwxTbREXySekvq37kfCNk,33644396,110707466,-77063070,624
2022-04-10 22:25:41-04:00,15055,DXGapgtgkag6midSCYNhHCNaCqvhUmuSvnVhXxNXBmyt,Csq6W5QkGZL6qE6Z1ERF3bfHtKjnM8hAxiY1YA3rTwSX,True,196766420,49191605,307019,153509,153510,3zqXX6kzhkbW3d4TwD2CNjMRwxTbREXySekvq37kfCNk,12280767,56315593,-44034826,624
2022-04-10 22:30:37-04:00,15056,6Rk6wVu6pCDFwEWDbiY8wS93nDghyHP9kzdUEa6eFRRq,B5v7eFjSX6dDt1kt84Uvtqmrn7STbQPMbFMvjH6WGXJg,True,57190173,14297543,89308,44654,44654,YQC4EUcgeBi9431viwvzvBbZJW3szeHX4dFmowRDyDw,3572356,13836307,-10263951,624
2022-04-10 22:33:31-04:00,15057,AKcGcqFMxvVWFHpc9oUJYGZsLN4DUHVkMSLGYrMcCYYN,4dWje79e7kH8GWJwwfB76BQUVUSgnYHTVxrtfNyG5A4K,True,15650228585,2959895657,18489053,9244526,9244527,3zqXX6kzhkbW3d4TwD2CNjMRwxTbREXySekvq37kfCNk,977595014,2582206075,-1604611061,624
2022-04-10 22:36:38-04:00,15058,D85pWm1LS9MvtR4f3QhkFLvNUhZLQ2NZBFQTyAVnmigm,CRN85DYkJJi6irhtVAf4qcJU3ijVodWdXgWe7Fs6Ahka,True,28263585,7065896,43659,21829,21830,YQC4EUcgeBi9431viwvzvBbZJW3szeHX4dFmowRDyDw,1746377,7788264,-6041887,617
2022-04-10 22:37:01-04:00,15059,7sgoB9mHcUoNFFdQSsBvyC4tXYzYR86ct11WQsS1FvAp,5k2QtQPgMUvj88Tmizf1pABHtC3VHJDc6BYNkB9gp19M,True,867438757,216859689,1348031,674015,674016,3zqXX6kzhkbW3d4TwD2CNjMRwxTbREXySekvq37kfCNk,53921260,114710047,-60788787,621
2022-04-10 22:37:40-04:00,15060,BjCNaM7YbE9SjFi7tzi4677zg1fKXGJwtecz2GWwWuhd,6rNsSrKZezQrLb2whToNjnizpnurDXrobHqfEK3QqU1M,True,4603415586,409598070,2559502,1279751,1279751,YQC4EUcgeBi9431viwvzvBbZJW3szeHX4dFmowRDyDw,287658945,937203206,-649544261,624
2022-04-10 22:41:45-04:00,15061,G3ZEAY19iDMjF7P57dgFUZiC4bpeFvMPKShenugL7E2Y,D6nUGgpWkQUZcUKZYawfedX67uqQ9Co1wEwtbHPMtc7X,True,1195553297,161277094,1006490,503245,503245,3zqXX6kzhkbW3d4TwD2CNjMRwxTbREXySekvq37kfCNk,74611586,393717895,-319106309,624
2022-04-10 22:46:39-04:00,15062,AQr9mVmcXCNQhBVCfx63MwR6c4WqDSC9K2BZqr7N8LCx,CB7TWUaL381ounsLw6neAUaKRxJL9P1HC9uGX5e1Uxod,True,3639895493,282626964,1765863,882931,882932,68sueyVfmy5ToEGtLFGDkwebX47xAmzyXE29z8JrmcWv,227421968,690392737,-462970769,624
2022-04-10 22:46:41-04:00,15063,HooxSzasW3HMoFJ6sAvRQ75Char1J5aBdJtsqfDV6myp,BCmsWwpGeV4NNfeKZKKydty2uueLGHYTJDk1WErpXsVT,True,466965939,66707597,416876,208438,208438,YQC4EUcgeBi9431viwvzvBbZJW3szeHX4dFmowRDyDw,29182127,101951946,-72769819,624
2022-04-10 22:46:51-04:00,15064,EDFNynTdSf9HfMkEuNJUeoeG6guc6zsg7zrmQuoA4Npn,A6DrZZWdZE1TbyXFthYNtyJUZMFhtCtwPqnREn5ECZcs,True,188669015,47167253,293183,146591,146592,gjBMZYVujDjD1ECG4i97M8Q3gV9ESnwwTSUGropkusj,11727352,33786927,-22059575,621
2022-04-10 22:46:57-04:00,15065,BhhVhLVZkSd3aHDMd6ojTgtJtbgAdMCA9Xj8jL2GMXoL,G8HUQp2yGSw9T6it5ej91cqkd82naca8heji453g2jEH,True,3336472280,425714003,2656211,1328105,1328106,YQC4EUcgeBi9431viwvzvBbZJW3szeHX4dFmowRDyDw,208176794,583445048,-375268254,623
2022-04-10 22:47:04-04:00,15066,68zbVKnneMQqngbNkeLtPEP2ayNhawc1B2hPgqAEqgXK,HqiFpLr4NC7xJz9bEFusq8bCKaoxAQG1xsLxdUAzg8aa,True,6546101004,550605617,3437900,1718950,1718950,YQC4EUcgeBi9431viwvzvBbZJW3szeHX4dFmowRDyDw,408728962,1366203758,-957474796,624
2022-04-10 22:47:14-04:00,15067,7CSCMFa9W52tBDVUbXbc3woAy3GByeA1wPJdp3MgznPa,3447ptuVFu6G8B6N63RmS8mRv4n9PfHneypHLvbeaGLn,True,1152151984,132086434,825044,412522,412522,3zqXX6kzhkbW3d4TwD2CNjMRwxTbREXySekvq37kfCNk,71966307,284072824,-212106517,624
2022-04-10 22:47:41-04:00,15068,BjCNaM7YbE9SjFi7tzi4677zg1fKXGJwtecz2GWwWuhd,6rNsSrKZezQrLb2whToNjnizpnurDXrobHqfEK3QqU1M,True,4168551429,371384869,2314908,1157454,1157454,YQC4EUcgeBi9431viwvzvBbZJW3szeHX4dFmowRDyDw,259833356,914340568,-654507212,623
2022-04-10 22:47:46-04:00,15069,AwT3pH9dHjECDnuUiazbD6tZxZHdNwgJ4vBMmxLHMiLo,AjybksvjMT1QT6KvryXCG47pQGT8v9jxM34VkveGPQrs,False,13899381,13899381,867232,43361,823871,YQC4EUcgeBi9431viwvzvBbZJW3szeHX4dFmowRDyDw,867232,2650542,-1783310,623
2022-04-10 22:48:40-04:00,15070,EDzP8bi8wGytnFoz4RynYddWyVWd5RFhHKcGZdwyAHJH,ELHWRXKjwkmoEj3nkJ9hw2bcL6dRd4znFeoLjitNbrXt,True,22460694,5615173,35075,17537,17538,gjBMZYVujDjD1ECG4i97M8Q3gV9ESnwwTSUGropkusj,1403021,6756496,-5353475,624
2022-04-10 22:49:03-04:00,15071,3uUdWwgwtFdPa3FJTSrirqPKMtQb3zmT5Wpp4zPy9sJP,5G7dhz8jvWekGy9Wh3ZCXNXSPbB1QArfFYs7MYNgRDkW,True,94534733,23633683,147701,73850,73851,YQC4EUcgeBi9431viwvzvBbZJW3szeHX4dFmowRDyDw,5908079,33977943,-28069864,624
2022-04-10 22:50:34-04:00,15072,J8khFNhJg25xVY7yjEtETTQVVzKHqdVCs1Rh2pJKvJqU,4eUP2YxTapjr6TLrd57XxZan7KJG5AtHK8yPRNVEbavx,True,353589300,88397325,548989,274494,274495,3zqXX6kzhkbW3d4TwD2CNjMRwxTbREXySekvq37kfCNk,21959569,45386699,-23427130,621
2022-04-10 22:50:34-04:00,15073,5BjBPqumCb9KC82ZNNch3dcRzbpGdRLJneru7o9a1D9R,FuZtBWKktxFu4yoiLVMzxq8fMhQyN8SGzGPz49xs3m6P,True,1852960858,244601107,1522900,761450,761450,3zqXX6kzhkbW3d4TwD2CNjMRwxTbREXySekvq37kfCNk,115366410,326021816,-210655406,622
2022-04-10 22:50:53-04:00,15074,G3ZEAY19iDMjF7P57dgFUZiC4bpeFvMPKShenugL7E2Y,D6nUGgpWkQUZcUKZYawfedX67uqQ9Co1wEwtbHPMtc7X,True,1024592979,136343946,850616,425308,425308,3zqXX6kzhkbW3d4TwD2CNjMRwxTbREXySekvq37kfCNk,63921872,341261621,-277339749,623
2022-04-10 22:50:56-04:00,15075,DXGapgtgkag6midSCYNhHCNaCqvhUmuSvnVhXxNXBmyt,Csq6W5QkGZL6qE6Z1ERF3bfHtKjnM8hAxiY1YA3rTwSX,True,144561738,36140434,224016,112008,112008,gjBMZYVujDjD1ECG4i97M8Q3gV9ESnwwTSUGropkusj,8960671,45000182,-36039511,619
2022-04-10 22:51:01-04:00,15076,AQr9mVmcXCNQhBVCfx63MwR6c4WqDSC9K2BZqr7N8LCx,CB7TWUaL381ounsLw6neAUaKRxJL9P1HC9uGX5e1Uxod,True,3339681286,231381462,1441552,720776,720776,YQC4EUcgeBi9431viwvzvBbZJW3szeHX4dFmowRDyDw,208068862,649252241,-441183379,623
2022-04-10 22:51:09-04:00,15077,68zbVKnneMQqngbNkeLtPEP2ayNhawc1B2hPgqAEqgXK,HqiFpLr4NC7xJz9bEFusq8bCKaoxAQG1xsLxdUAzg8aa,True,5962617800,506679749,3164622,1582311,1582311,3zqXX6kzhkbW3d4TwD2CNjMRwxTbREXySekvq37kfCNk,372413475,1316843340,-944429865,624
2022-04-10 22:51:28-04:00,15078,BjCNaM7YbE9SjFi7tzi4677zg1fKXGJwtecz2GWwWuhd,6rNsSrKZezQrLb2whToNjnizpnurDXrobHqfEK3QqU1M,True,3775583689,363751019,2273073,1136536,1136537,YQC4EUcgeBi9431viwvzvBbZJW3szeHX4dFmowRDyDw,235935577,837953704,-602018127,624
2022-04-10 22:51:49-04:00,15079,BhhVhLVZkSd3aHDMd6ojTgtJtbgAdMCA9Xj8jL2GMXoL,G8HUQp2yGSw9T6it5ej91cqkd82naca8heji453g2jEH,True,2885488948,404691142,2528031,1264015,1264016,3zqXX6kzhkbW3d4TwD2CNjMRwxTbREXySekvq37kfCNk,180251254,533519169,-353267915,624
2022-04-10 22:53:42-04:00,15080,D5VZNThkv6XD6bimPshD2J3PvbPXgCbivZuPfkVxgdjc,8C77LmMk4C3KvyEb1N3scdbAgwN7J45nAcv9tkL5namB,True,81590074129,20397518532,127200227,63600113,63600114,YQC4EUcgeBi9431viwvzvBbZJW3szeHX4dFmowRDyDw,5088009107,7504977242,-2416968135,623
2022-04-10 22:53:42-04:00,15081,BTq6T9nDzYTPTRvxkhNLn82DF3RCWdRkatZUmSTGCu43,3Uuhmxo4tWMbrqowx2bQSJeWzMykUUcZanj29ptCmEa6,True,4327450624,764641778,4753111,2376555,2376556,68sueyVfmy5ToEGtLFGDkwebX47xAmzyXE29z8JrmcWv,268999881,1011087702,-742087821,621
2022-04-10 23:01:50-04:00,15082,3BKX31xq3f13J2Zo8Wue4SYpCMWLXjgUt2nkwTTNfU2T,2pTxNAaV4pXRRUDE97ZFteBJn9tyktjh3FW1CWfwebci,True,92392015,23098003,143702,71851,71851,68sueyVfmy5ToEGtLFGDkwebX47xAmzyXE29z8JrmcWv,5748118,23797888,-18049770,622
2022-04-10 23:03:02-04:00,15083,7tFD53kPTqrzjCu1Wji78gUqhoRtCUhsP1pM3DQKT7uG,BJvgPLYBDJrQJdQVowrsMwUGMurq4zTihoFwWoEokfu3,True,4352271165,1088067791,6798331,3399165,3399166,YQC4EUcgeBi9431viwvzvBbZJW3szeHX4dFmowRDyDw,271933266,807970138,-536036872,624
2022-04-10 23:19:10-04:00,15084,AKcGcqFMxvVWFHpc9oUJYGZsLN4DUHVkMSLGYrMcCYYN,4dWje79e7kH8GWJwwfB76BQUVUSgnYHTVxrtfNyG5A4K,True,12513434404,2183835280,13646822,6823411,6823411,3zqXX6kzhkbW3d4TwD2CNjMRwxTbREXySekvq37kfCNk,781966597,2276930069,-1494963472,624
2022-04-10 23:23:02-04:00,15085,6Rk6wVu6pCDFwEWDbiY8wS93nDghyHP9kzdUEa6eFRRq,B5v7eFjSX6dDt1kt84Uvtqmrn7STbQPMbFMvjH6WGXJg,True,42029383,10507345,65489,32744,32745,68sueyVfmy5ToEGtLFGDkwebX47xAmzyXE29z8JrmcWv,2619599,11180835,-8561236,623
2022-04-10 23:27:13-04:00,15086,8qq2gfbca7JXvq4gViBBVT2QAbM4MvBMEQLXgn8UUTvt,3o5jpBVYdFFEYrGRdCUkLrUC85wsuTKgy8iYwnpZyC1B,True,1190355913,118031642,734005,367002,367003,3zqXX6kzhkbW3d4TwD2CNjMRwxTbREXySekvq37kfCNk,74024869,478387036,-404362167,621
2022-04-10 23:27:13-04:00,15087,4qqThJTwuoaWDtEh4agoqM9EwcJbznzGVJW8nbSsEVdS,Aub7UJXkAGC9gn1XybeW1yjYZ97c3kkWd7wbQpTFsYrG,True,1096916510,146602780,915395,457697,457698,3zqXX6kzhkbW3d4TwD2CNjMRwxTbREXySekvq37kfCNk,68492082,159325682,-90833600,624
2022-04-10 23:27:15-04:00,15088,HooxSzasW3HMoFJ6sAvRQ75Char1J5aBdJtsqfDV6myp,BCmsWwpGeV4NNfeKZKKydty2uueLGHYTJDk1WErpXsVT,True,396200832,49878545,310907,155453,155454,3zqXX6kzhkbW3d4TwD2CNjMRwxTbREXySekvq37kfCNk,24696327,90184256,-65487929,623
2022-04-10 23:27:17-04:00,15089,D85pWm1LS9MvtR4f3QhkFLvNUhZLQ2NZBFQTyAVnmigm,CRN85DYkJJi6irhtVAf4qcJU3ijVodWdXgWe7Fs6Ahka,True,20769850,5192462,31869,15934,15935,68sueyVfmy5ToEGtLFGDkwebX47xAmzyXE29z8JrmcWv,1274779,6234041,-4959262,613
2022-04-10 23:33:17-04:00,15090,EDFNynTdSf9HfMkEuNJUeoeG6guc6zsg7zrmQuoA4Npn,A6DrZZWdZE1TbyXFthYNtyJUZMFhtCtwPqnREn5ECZcs,True,138734850,34683712,216664,108332,108332,YQC4EUcgeBi9431viwvzvBbZJW3szeHX4dFmowRDyDw,8666584,27978443,-19311859,624
2022-04-10 23:33:49-04:00,15091,G3ZEAY19iDMjF7P57dgFUZiC4bpeFvMPKShenugL7E2Y,D6nUGgpWkQUZcUKZYawfedX67uqQ9Co1wEwtbHPMtc7X,True,880172361,118235268,738714,369357,369357,3zqXX6kzhkbW3d4TwD2CNjMRwxTbREXySekvq37kfCNk,54991723,310820360,-255828637,624
2022-04-10 23:34:20-04:00,15092,AQr9mVmcXCNQhBVCfx63MwR6c4WqDSC9K2BZqr7N8LCx,CB7TWUaL381ounsLw6neAUaKRxJL9P1HC9uGX5e1Uxod,True,3095132474,225893081,1411238,705619,705619,3zqXX6kzhkbW3d4TwD2CNjMRwxTbREXySekvq37kfCNk,193364567,631997447,-438632880,624
2022-04-11 05:10:01-04:00,15093,5BjBPqumCb9KC82ZNNch3dcRzbpGdRLJneru7o9a1D9R,FuZtBWKktxFu4yoiLVMzxq8fMhQyN8SGzGPz49xs3m6P,True,1592378792,215174842,1320552,660276,660276,YQC4EUcgeBi9431viwvzvBbZJW3szeHX4dFmowRDyDw,97726113,307721600,-209995487,613
2022-04-11 05:11:14-04:00,15094,A5NXadGWnFZRoHEn1dKTRjcXgWmfMLMyJdpF4rQPZyRR,ALs3Zfotc4c4A6TFDMbd5GM5whK1dTYSnGrHiMBWmApH,True,1638534531,409633067,2554327,1277163,1277164,3zqXX6kzhkbW3d4TwD2CNjMRwxTbREXySekvq37kfCNk,102173244,520840141,-418666897,623
2022-04-11 05:16:51-04:00,15095,niCk6QHFU1kyU56Mdq5RJzKrecdkNSn23ZA6wduFdWS,BQbUYSw1XsuE6LnVd4XjmxAyYgx4drE4FsetJBCdwVZW,True,144732340,36168629,225781,112890,112891,YQC4EUcgeBi9431viwvzvBbZJW3szeHX4dFmowRDyDw,9034904,19897330,-10862426,624
2022-04-11 05:17:45-04:00,15096,4mBubA5j5dBNQFRKSZFkkvS9DEUVP2vScZd63vmGnUbx,y8qk2Krm3VFtz3RqidYz78TEz7sdcF72NGYtsckRJSy,True,1266794921,316698629,1979090,989545,989545,3zqXX6kzhkbW3d4TwD2CNjMRwxTbREXySekvq37kfCNk,79163669,275833977,-196670308,624
2022-04-11 05:17:59-04:00,15097,68zbVKnneMQqngbNkeLtPEP2ayNhawc1B2hPgqAEqgXK,HqiFpLr4NC7xJz9bEFusq8bCKaoxAQG1xsLxdUAzg8aa,True,5424778629,439956729,2743042,1371521,1371521,68sueyVfmy5ToEGtLFGDkwebX47xAmzyXE29z8JrmcWv,338224156,1217379901,-879155745,623
2022-04-11 05:18:19-04:00,15098,FV9CBGGTbppLnBKh79f2LzD1diTiS5g6u89FcpZHZmnK,Fe7mtmCUziFqbbYTvrhAcAq1Ub7YLfTJRtQ1hG7GzJD1,True,59320771,9198906,56860,28430,28430,YQC4EUcgeBi9431viwvzvBbZJW3szeHX4dFmowRDyDw,3666745,15905049,-12238304,618
2022-04-11 05:18:19-04:00,15099,5BjBPqumCb9KC82ZNNch3dcRzbpGdRLJneru7o9a1D9R,FuZtBWKktxFu4yoiLVMzxq8fMhQyN8SGzGPz49xs3m6P,True,1365252078,181113336,1120356,560178,560178,68sueyVfmy5ToEGtLFGDkwebX47xAmzyXE29z8JrmcWv,84453689,266941286,-182487597,618
2022-04-11 05:18:21-04:00,15100,7yW1M1xeVx4hy3QftnpqdBDRYwamfu3K5i6AEnxgyTWb,7wf7FWS2DYp5RveQAmGNXAEUWPcHziuMLd4hV5LPgxF8,True,95418273,23854568,148196,74098,74098,gjBMZYVujDjD1ECG4i97M8Q3gV9ESnwwTSUGropkusj,5927870,15972559,-10044689,621
2022-04-11 05:18:34-04:00,15101,eiLMepBYM3VcWarQJC9fTnxotyMuUTbyMGJECedPEfu,k2ZfwPNBBCK7PvZ6MEvELTHHtQZSXCRGCymvkZwhDDt,True,19560860,2701639,16817,8408,8409,68sueyVfmy5ToEGtLFGDkwebX47xAmzyXE29z8JrmcWv,1217693,4876820,-3659127,622
2022-04-11 05:18:47-04:00,15102,EN2YBXcj7E1eAaYJYXJjc6Rfsu6Awjgv9kN3bT3uiprp,HYDG5mqfCy2xwrYKixNzoWyDiqb9KbpnA8H3TQG2EDDG,True,244063327,61015743,376538,188269,188269,68sueyVfmy5ToEGtLFGDkwebX47xAmzyXE29z8JrmcWv,15061598,56996025,-41934427,617
2022-04-11 05:19:22-04:00,15103,JABfWoDV2wW68XEDANXArYWM7zabdbp5NBVrvzZd3mML,5hYUtd1Uv2pAcrbtSNNVTrRuk8acjmh92mzSm4iz5HJA,True,47088099,6315393,39187,19593,19594,68sueyVfmy5ToEGtLFGDkwebX47xAmzyXE29z8JrmcWv,2921901,11017914,-8096013,620
2022-04-11 05:21:17-04:00,15104,BjCNaM7YbE9SjFi7tzi4677zg1fKXGJwtecz2GWwWuhd,6rNsSrKZezQrLb2whToNjnizpnurDXrobHqfEK3QqU1M,True,3390147106,300070302,1874842,937421,937421,3zqXX6kzhkbW3d4TwD2CNjMRwxTbREXySekvq37kfCNk,211816733,761468694,-549651961,624
2022-04-11 05:21:23-04:00,15105,BhhVhLVZkSd3aHDMd6ojTgtJtbgAdMCA9Xj8jL2GMXoL,G8HUQp2yGSw9T6it5ej91cqkd82naca8heji453g2jEH,True,2456344020,313510971,1956534,978267,978267,3zqXX6kzhkbW3d4TwD2CNjMRwxTbREXySekvq37kfCNk,153293629,480797982,-327504353,624
2022-04-11 05:21:34-04:00,15106,H8wYaRqc2wQuE3AdnSA2bCbukzxZEUCS5KbGYNsLAoho,F4ZEmseEyZfy3ZL6iyrczRZ9bww9HgVd8tYXExfbTcj1,True,43885496,10971374,67712,33856,33856,68sueyVfmy5ToEGtLFGDkwebX47xAmzyXE29z8JrmcWv,2708506,12268412,-9559906,617
2022-04-11 05:21:37-04:00,15107,68zbVKnneMQqngbNkeLtPEP2ayNhawc1B2hPgqAEqgXK,HqiFpLr4NC7xJz9bEFusq8bCKaoxAQG1xsLxdUAzg8aa,True,4959023571,408585299,2551547,1275773,1275774,68sueyVfmy5ToEGtLFGDkwebX47xAmzyXE29z8JrmcWv,309682785,1119169417,-809486632,624
2022-04-11 05:21:40-04:00,15108,2i5g7q4gD1GEfSz8BkhKn1idQ5U7cFPbMDWugjr7bBQW,Dpx6K9G5uZD63rTzBafZ56WKd1X9M25Mzfppd7Jib4xn,True,1051018364,262754591,1642098,821049,821049,3zqXX6kzhkbW3d4TwD2CNjMRwxTbREXySekvq37kfCNk,65683953,354902486,-289218533,624
2022-04-11 05:25:10-04:00,15109,4GbUrgiR6A91h3J9HHpuYCkZzjwrb62n3BURLeWj6Nic,12nUFUGYF1rXbwPeCbdGKdP3RE4g984fmZZggEYSFTZn,True,44801724,11200431,69964,34982,34982,YQC4EUcgeBi9431viwvzvBbZJW3szeHX4dFmowRDyDw,2798585,14797321,-11998736,624
2022-04-11 05:25:21-04:00,15110,1EH82ta3wXUyUwW8VWQnVzSG3r1rHcSj2DvDeTKmp3F,B6aMfucYPbCzWBtauLtgTpwR45wKSK8yqscHJR3F5usu,True,563472864,140868216,880135,440067,440068,3zqXX6kzhkbW3d4TwD2CNjMRwxTbREXySekvq37kfCNk,35205416,78843098,-43637682,624
2022-04-11 05:25:32-04:00,15111,J8khFNhJg25xVY7yjEtETTQVVzKHqdVCs1Rh2pJKvJqU,4eUP2YxTapjr6TLrd57XxZan7KJG5AtHK8yPRNVEbavx,True,259916087,64979021,403335,201667,201668,68sueyVfmy5ToEGtLFGDkwebX47xAmzyXE29z8JrmcWv,16133434,38980640,-22847206,620
2022-04-11 05:25:32-04:00,15112,9WH1YzDrdvZs8aDuFLwQHHXa2e66ZcwdfDi7qXEjQxFy,3Tpc8DqJwg1tTDgk6qH1UhvtwvhXxsp5GRFYMWxa8NKX,True,1892045831,473011457,2953316,1476658,1476658,68sueyVfmy5ToEGtLFGDkwebX47xAmzyXE29z8JrmcWv,118132660,438388145,-320255485,624
2022-04-11 05:25:42-04:00,15113,2xgQaQTs7bkK34jSBZ2dFZf1DJKjMVW9LA3D9Pwtfims,6rniSBeGcJAcrqWhhnKCcRV58yYnjuqXj9b4Zu8DUwQ9,False,13978462,13978462,872850,43642,829208,YQC4EUcgeBi9431viwvzvBbZJW3szeHX4dFmowRDyDw,872851,3797113,-2924262,624
2022-04-11 05:25:47-04:00,15114,B6Wc3euMqUf6QjzCqDtNeAEUM7MvADFaiReEq9VYH2Qg,2pzhsqXYd5u7h4xTN8bMS3GbicVnJ6KY3MQn7spSXroA,True,864258594,142322636,888525,444262,444263,3zqXX6kzhkbW3d4TwD2CNjMRwxTbREXySekvq37kfCNk,53956009,83235912,-29279903,624
2022-04-11 05:30:46-04:00,15115,G3ZEAY19iDMjF7P57dgFUZiC4bpeFvMPKShenugL7E2Y,D6nUGgpWkQUZcUKZYawfedX67uqQ9Co1wEwtbHPMtc7X,True,754699342,100220445,624457,312228,312229,3zqXX6kzhkbW3d4TwD2CNjMRwxTbREXySekvq37kfCNk,47024094,268778969,-221754875,623
2022-04-11 05:31:20-04:00,15116,7CSCMFa9W52tBDVUbXbc3woAy3GByeA1wPJdp3MgznPa,3447ptuVFu6G8B6N63RmS8mRv4n9PfHneypHLvbeaGLn,True,1012073256,129640539,807015,403507,403508,3zqXX6kzhkbW3d4TwD2CNjMRwxTbREXySekvq37kfCNk,63001865,254663683,-191661818,622
2022-04-11 05:31:24-04:00,15117,AQr9mVmcXCNQhBVCfx63MwR6c4WqDSC9K2BZqr7N8LCx,CB7TWUaL381ounsLw6neAUaKRxJL9P1HC9uGX5e1Uxod,True,2854772379,210171127,1305556,652778,652778,3zqXX6kzhkbW3d4TwD2CNjMRwxTbREXySekvq37kfCNk,177334814,583127952,-405793138,621
2022-04-11 05:31:26-04:00,15118,BjCNaM7YbE9SjFi7tzi4677zg1fKXGJwtecz2GWwWuhd,6rNsSrKZezQrLb2whToNjnizpnurDXrobHqfEK3QqU1M,True,3071635512,272415758,1698371,849185,849186,68sueyVfmy5ToEGtLFGDkwebX47xAmzyXE29z8JrmcWv,191500599,737229189,-545728590,623
2022-04-11 05:31:29-04:00,15119,HHp8dRc1YMWE93uyLdM98DkUhM8U8zm3JC59chrbbWrk,AdqFuGe28VeAwwjRPZCBGVy5ftf9zNNQkg413i66wyig,True,305380601,76345150,470391,235195,235196,gjBMZYVujDjD1ECG4i97M8Q3gV9ESnwwTSUGropkusj,18815643,55483796,-36668153,616
2022-04-11 05:31:31-04:00,15120,5BjBPqumCb9KC82ZNNch3dcRzbpGdRLJneru7o9a1D9R,FuZtBWKktxFu4yoiLVMzxq8fMhQyN8SGzGPz49xs3m6P,True,1173896437,159165506,991021,495510,495511,3zqXX6kzhkbW3d4TwD2CNjMRwxTbREXySekvq37kfCNk,73091028,250999495,-177908467,622
2022-04-11 05:31:32-04:00,15121,BhhVhLVZkSd3aHDMd6ojTgtJtbgAdMCA9Xj8jL2GMXoL,G8HUQp2yGSw9T6it5ej91cqkd82naca8heji453g2jEH,True,2124157646,297555982,1858349,929174,929175,YQC4EUcgeBi9431viwvzvBbZJW3szeHX4dFmowRDyDw,132661692,437605155,-304943463,624
2022-04-11 05:31:52-04:00,15122,DXGapgtgkag6midSCYNhHCNaCqvhUmuSvnVhXxNXBmyt,Csq6W5QkGZL6qE6Z1ERF3bfHtKjnM8hAxiY1YA3rTwSX,True,106219193,26554798,163427,81713,81714,YQC4EUcgeBi9431viwvzvBbZJW3szeHX4dFmowRDyDw,6537106,35769026,-29231920,615
2022-04-11 05:31:54-04:00,15123,AKcGcqFMxvVWFHpc9oUJYGZsLN4DUHVkMSLGYrMcCYYN,4dWje79e7kH8GWJwwfB76BQUVUSgnYHTVxrtfNyG5A4K,True,10193392181,1608423260,9971076,4985538,4985538,YQC4EUcgeBi9431viwvzvBbZJW3szeHX4dFmowRDyDw,631917623,2011640245,-1379722622,619
2022-04-11 05:32:41-04:00,15124,7AizMrxWWr7qfneuXMy6ifL3BVDTAKkuud4PyZFy92kh,GyAWRRfQkVAXtyhVF14vU3kPMr4kG1VyA9FAHdDTr8ud,True,287734782,71933695,447104,223552,223552,A9TwRM1BMxqb8DCC7YNAMV6zPenEJm3HTZBy7wJKK58U,17884185,47514037,-29629852,621
2022-04-11 05:32:52-04:00,15125,85w2wxozVA7Zfm1FdA1yWb8D43jdC9mefYzNqFyRe5iU,BHieDhQaBUbsWGmqNerfbCAMMGGAjEPpiNiSWAQS57D5,True,319248897,79812224,498820,249410,249410,3zqXX6kzhkbW3d4TwD2CNjMRwxTbREXySekvq37kfCNk,19952834,48486864,-28534030,624
2022-04-11 05:32:52-04:00,15126,BTq6T9nDzYTPTRvxkhNLn82DF3RCWdRkatZUmSTGCu43,3Uuhmxo4tWMbrqowx2bQSJeWzMykUUcZanj29ptCmEa6,True,3517308043,562591741,3498955,1749477,1749478,3zqXX6kzhkbW3d4TwD2CNjMRwxTbREXySekvq37kfCNk,218753763,847005303,-628251540,621
2022-04-11 05:32:52-04:00,15127,68zbVKnneMQqngbNkeLtPEP2ayNhawc1B2hPgqAEqgXK,HqiFpLr4NC7xJz9bEFusq8bCKaoxAQG1xsLxdUAzg8aa,True,4526138348,371707280,2322740,1161370,1161370,3zqXX6kzhkbW3d4TwD2CNjMRwxTbREXySekvq37kfCNk,282831314,1077737417,-794906103,624
2022-04-11 05:34:43-04:00,15128,4qqThJTwuoaWDtEh4agoqM9EwcJbznzGVJW8nbSsEVdS,Aub7UJXkAGC9gn1XybeW1yjYZ97c3kkWd7wbQpTFsYrG,True,941486277,127266961,793810,396905,396905,3zqXX6kzhkbW3d4TwD2CNjMRwxTbREXySekvq37kfCNk,58723991,151815244,-93091253,623
2022-04-11 05:34:44-04:00,15129,AQr9mVmcXCNQhBVCfx63MwR6c4WqDSC9K2BZqr7N8LCx,CB7TWUaL381ounsLw6neAUaKRxJL9P1HC9uGX5e1Uxod,True,2632096382,171256635,1063966,531983,531983,YQC4EUcgeBi9431viwvzvBbZJW3szeHX4dFmowRDyDw,163524388,550482033,-386957645,621
2022-04-11 05:34:52-04:00,15130,5yPGvUz6JWKjkViGwTCpygJii1rP2xv5yx146ULtBiYq,FMnHUCQWTf1UHu5qVFqUAsWh8aba9EQYTEoiXy55totD,True,98725691,24681422,175811,87905,87906,YQC4EUcgeBi9431viwvzvBbZJW3szeHX4dFmowRDyDw,7032449,11951449,-4919000,712
2022-04-11 05:34:53-04:00,15131,8qq2gfbca7JXvq4gViBBVT2QAbM4MvBMEQLXgn8UUTvt,3o5jpBVYdFFEYrGRdCUkLrUC85wsuTKgy8iYwnpZyC1B,True,1063306061,90036530,560571,280285,280286,68sueyVfmy5ToEGtLFGDkwebX47xAmzyXE29z8JrmcWv,66201935,478188889,-411986954,622
2022-04-11 05:34:55-04:00,15132,6Rk6wVu6pCDFwEWDbiY8wS93nDghyHP9kzdUEa6eFRRq,B5v7eFjSX6dDt1kt84Uvtqmrn7STbQPMbFMvjH6WGXJg,True,30882550,7720637,47888,23944,23944,YQC4EUcgeBi9431viwvzvBbZJW3szeHX4dFmowRDyDw,1915521,8975951,-7060430,620
2022-04-11 05:34:56-04:00,15133,5F7WHSYiVtCY8Z9KX9h6AT8qr4hbsSYasG15fq82ZWhr,E5wj8cqKM1ofNv14TspTa8yRwern8y2w6pXekL4cAWX7,True,28184762,7046190,43803,21901,21902,YQC4EUcgeBi9431viwvzvBbZJW3szeHX4dFmowRDyDw,1752126,5201822,-3449696,621
2022-04-11 05:34:58-04:00,15134,eiLMepBYM3VcWarQJC9fTnxotyMuUTbyMGJECedPEfu,k2ZfwPNBBCK7PvZ6MEvELTHHtQZSXCRGCymvkZwhDDt,True,16701423,2173769,13575,6787,6788,68sueyVfmy5ToEGtLFGDkwebX47xAmzyXE29z8JrmcWv,1043078,4137925,-3094847,624
2022-04-11 05:35:10-04:00,15135,C3DnHRyndQw1EinnmrayLzuhP9KhXYKVDUpf55BumxG1,6aU3EvNk5CyD5LdGhQksYKkNxvJ5vw23JvMEdwqeDSMo,True,1999836959,499959239,3123569,1561784,1561785,YQC4EUcgeBi9431viwvzvBbZJW3szeHX4dFmowRDyDw,124942776,708710099,-583767323,624
2022-04-11 05:35:35-04:00,15136,BjCNaM7YbE9SjFi7tzi4677zg1fKXGJwtecz2GWwWuhd,6rNsSrKZezQrLb2whToNjnizpnurDXrobHqfEK3QqU1M,True,2783340798,270350617,1689345,844672,844673,68sueyVfmy5ToEGtLFGDkwebX47xAmzyXE29z8JrmcWv,173923272,679576520,-505653248,624
2022-04-11 05:36:07-04:00,15137,JABfWoDV2wW68XEDANXArYWM7zabdbp5NBVrvzZd3mML,5hYUtd1Uv2pAcrbtSNNVTrRuk8acjmh92mzSm4iz5HJA,True,40411943,5408220,33750,16875,16875,YQC4EUcgeBi9431viwvzvBbZJW3szeHX4dFmowRDyDw,2521951,9998984,-7477033,624
2022-04-11 05:36:46-04:00,15138,D85pWm1LS9MvtR4f3QhkFLvNUhZLQ2NZBFQTyAVnmigm,CRN85DYkJJi6irhtVAf4qcJU3ijVodWdXgWe7Fs6Ahka,False,15287337,15287337,953305,47665,905640,YQC4EUcgeBi9431viwvzvBbZJW3szeHX4dFmowRDyDw,953305,4962807,-4009502,623
2022-04-11 05:44:25-04:00,15139,DVMLxFACqaNBD7q1TGJUUApJX7etJsxQRRFBP2DfBazJ,4hnRjD7S2KxD7UrgfrApntVxUD7Srh5E9nwPY53v89kz,True,191098298,15033899,98031,49015,49016,3zqXX6kzhkbW3d4TwD2CNjMRwxTbREXySekvq37kfCNk,12460893,48145538,-35684645,652
2022-04-11 05:44:45-04:00,15140,7sgoB9mHcUoNFFdQSsBvyC4tXYzYR86ct11WQsS1FvAp,5k2QtQPgMUvj88Tmizf1pABHtC3VHJDc6BYNkB9gp19M,True,637490315,159372578,984628,492314,492314,3zqXX6kzhkbW3d4TwD2CNjMRwxTbREXySekvq37kfCNk,39385144,98072377,-58687233,617
2022-04-11 05:44:50-04:00,15141,7CSCMFa9W52tBDVUbXbc3woAy3GByeA1wPJdp3MgznPa,3447ptuVFu6G8B6N63RmS8mRv4n9PfHneypHLvbeaGLn,True,874584932,97373962,605085,302542,302543,3zqXX6kzhkbW3d4TwD2CNjMRwxTbREXySekvq37kfCNk,54347065,232757970,-178410905,621
2022-04-11 05:46:30-04:00,15142,5j5R1o3wXaL7cS9fxodLkrFjxPnujuX8boG7Zb9Fh9fs,4SZXsGqPoUy11ZKK5kNUpxCPK3ZcSxWMn12h4YREr9tS,True,833836331,208459082,1289084,644542,644542,YQC4EUcgeBi9431viwvzvBbZJW3szeHX4dFmowRDyDw,51563365,119279480,-67716115,618
2022-04-11 05:46:30-04:00,15143,CDVtXFbo4Rg2aHsXKv5P3uRJq9ZTgsRd7GXPTxgH5xv9,6zj37qQnaiJT7xGEZmSKx5yQvisQFcs5KhGsG43SGd5y,True,1241109791,187111889,1160817,580408,580409,68sueyVfmy5ToEGtLFGDkwebX47xAmzyXE29z8JrmcWv,76996854,240703947,-163707093,620
2022-04-11 05:46:31-04:00,15144,G3ZEAY19iDMjF7P57dgFUZiC4bpeFvMPKShenugL7E2Y,D6nUGgpWkQUZcUKZYawfedX67uqQ9Co1wEwtbHPMtc7X,True,648379109,87348346,542911,271455,271456,68sueyVfmy5ToEGtLFGDkwebX47xAmzyXE29z8JrmcWv,40299849,243924992,-203625143,621
2022-04-11 05:46:53-04:00,15145,GgJXh5hTo4xyVuuGEis971RRXcZECLpjvtMSCZtVu13Q,9BGMfGfMZNXdcygAuqYQudWHhSE5LqVoWsNsruCawnRK,True,30139409,7534852,46880,23440,23440,68sueyVfmy5ToEGtLFGDkwebX47xAmzyXE29z8JrmcWv,1875209,4377873,-2502664,622
2022-04-11 05:48:56-04:00,15146,GeYsENPRf2qGZu9rJsi6UPQqHS6sR7LRLWsKbFgtMCSb,7A79wktqPkSpP7o4c1kP9CBpUibHTqycW81ZANgREc5S,True,30614234,7653558,47793,23896,23897,YQC4EUcgeBi9431viwvzvBbZJW3szeHX4dFmowRDyDw,1911758,9285705,-7373947,624
2022-04-11 05:49:20-04:00,15147,68zbVKnneMQqngbNkeLtPEP2ayNhawc1B2hPgqAEqgXK,HqiFpLr4NC7xJz9bEFusq8bCKaoxAQG1xsLxdUAzg8aa,True,4131530677,323557461,2017437,1008718,1008719,3zqXX6kzhkbW3d4TwD2CNjMRwxTbREXySekvq37kfCNk,257608183,994771180,-737162997,623
2022-04-11 05:49:24-04:00,15148,AQr9mVmcXCNQhBVCfx63MwR6c4WqDSC9K2BZqr7N8LCx,CB7TWUaL381ounsLw6neAUaKRxJL9P1HC9uGX5e1Uxod,True,2451271127,167166639,1042659,521329,521330,3zqXX6kzhkbW3d4TwD2CNjMRwxTbREXySekvq37kfCNk,152891802,535338065,-382446263,623
2022-04-11 05:49:35-04:00,15149,67DwuUmzk6uGwmptjYErQssFeJ5fd1ztFwKWZUovr7pK,HKzc15e1QLBrSsbAENyMXSVHDoap1F5MHCHB9L1Dm8HA,True,59118661,14779665,91796,45898,45898,68sueyVfmy5ToEGtLFGDkwebX47xAmzyXE29z8JrmcWv,3671852,19416411,-15744559,621
2022-04-11 05:49:38-04:00,15150,FV9CBGGTbppLnBKh79f2LzD1diTiS5g6u89FcpZHZmnK,Fe7mtmCUziFqbbYTvrhAcAq1Ub7YLfTJRtQ1hG7GzJD1,True,49527493,6846786,41686,20843,20843,68sueyVfmy5ToEGtLFGDkwebX47xAmzyXE29z8JrmcWv,3015513,13659442,-10643929,608
2022-04-11 05:49:45-04:00,15151,8gxJEB4eSp5R8Z4Vy8TChcbLWPG93cVhpGLYWPuo4UMz,5dykor5kUojjBccSkbKqsHJ61voZWnD2MDuSNvsF6ohA,True,363569636,90892409,555073,277536,277537,YQC4EUcgeBi9431viwvzvBbZJW3szeHX4dFmowRDyDw,22202955,88091816,-65888861,610
2022-04-11 05:50:22-04:00,15152,A5NXadGWnFZRoHEn1dKTRjcXgWmfMLMyJdpF4rQPZyRR,ALs3Zfotc4c4A6TFDMbd5GM5whK1dTYSnGrHiMBWmApH,True,1204303848,301075406,1875528,937764,937764,68sueyVfmy5ToEGtLFGDkwebX47xAmzyXE29z8JrmcWv,75021301,413700810,-338679509,622
2022-04-11 05:51:07-04:00,15153,AKcGcqFMxvVWFHpc9oUJYGZsLN4DUHVkMSLGYrMcCYYN,4dWje79e7kH8GWJwwfB76BQUVUSgnYHTVxrtfNyG5A4K,True,8493602875,1192374527,7448554,3724277,3724277,68sueyVfmy5ToEGtLFGDkwebX47xAmzyXE29z8JrmcWv,530580501,1783377751,-1252797250,624
2022-04-11 05:51:17-04:00,15154,6RuQVU9nu2Ecp177M9ggWczLACvQ8PfT31RTcmfwe9Hq,DZgsgqvMNLTXkBxySZC7Monak2JGsXRMJT4hBQzpf6Xm,True,3406538372,851634593,5216975,2608487,2608488,3zqXX6kzhkbW3d4TwD2CNjMRwxTbREXySekvq37kfCNk,208679000,322290529,-113611529,612
2022-04-11 05:51:41-04:00,15155,BhhVhLVZkSd3aHDMd6ojTgtJtbgAdMCA9Xj8jL2GMXoL,G8HUQp2yGSw9T6it5ej91cqkd82naca8heji453g2jEH,True,1808653206,230085851,1435671,717835,717836,3zqXX6kzhkbW3d4TwD2CNjMRwxTbREXySekvq37kfCNk,112854885,392111903,-279257018,623
2022-04-11 05:51:41-04:00,15156,EDFNynTdSf9HfMkEuNJUeoeG6guc6zsg7zrmQuoA4Npn,A6DrZZWdZE1TbyXFthYNtyJUZMFhtCtwPqnREn5ECZcs,True,101912257,25478064,157850,78925,78925,68sueyVfmy5ToEGtLFGDkwebX47xAmzyXE29z8JrmcWv,6314033,22936957,-16622924,619
2022-04-11 05:54:16-04:00,15157,9cwVnc8zu2wjSnvFuxPddMXSrgNajdn3sZH1qAtQQ8aQ,9xaYkDvEyDmAkWDhhZma9mLbUeB7BkLWtveDsagfJDVa,True,805896025,201474006,1255124,627562,627562,68sueyVfmy5ToEGtLFGDkwebX47xAmzyXE29z8JrmcWv,50204989,193889304,-143684315,622
2022-04-11 05:54:33-04:00,15158,3uUdWwgwtFdPa3FJTSrirqPKMtQb3zmT5Wpp4zPy9sJP,5G7dhz8jvWekGy9Wh3ZCXNXSPbB1QArfFYs7MYNgRDkW,True,69482746,17370686,108280,54140,54140,YQC4EUcgeBi9431viwvzvBbZJW3szeHX4dFmowRDyDw,4331205,26802007,-22470802,623
2022-04-11 05:54:35-04:00,15159,EDzP8bi8wGytnFoz4RynYddWyVWd5RFhHKcGZdwyAHJH,ELHWRXKjwkmoEj3nkJ9hw2bcL6dRd4znFeoLjitNbrXt,True,16507078,4126769,25673,12836,12837,68sueyVfmy5ToEGtLFGDkwebX47xAmzyXE29z8JrmcWv,1026921,5380476,-4353555,622
2022-04-11 05:57:11-04:00,15160,6zLsQakpDaa2cggm9g5BbrrUY3e6tsEEi4jQYrB1GucR,HYs4PktD8Kh89iDVTSnoHwMY619mffCwo9Uog8u17KbK,True,435200608,87336680,553153,276576,276577,3zqXX6kzhkbW3d4TwD2CNjMRwxTbREXySekvq37kfCNk,27563787,70853537,-43289750,633
2022-04-11 05:57:11-04:00,15161,3BKX31xq3f13J2Zo8Wue4SYpCMWLXjgUt2nkwTTNfU2T,2pTxNAaV4pXRRUDE97ZFteBJn9tyktjh3FW1CWfwebci,True,67908697,16977174,105393,52696,52697,YQC4EUcgeBi9431viwvzvBbZJW3szeHX4dFmowRDyDw,4215740,19138592,-14922852,620
2022-04-11 05:57:38-04:00,15162,5BjBPqumCb9KC82ZNNch3dcRzbpGdRLJneru7o9a1D9R,FuZtBWKktxFu4yoiLVMzxq8fMhQyN8SGzGPz49xs3m6P,True,1005458854,133375671,833422,416711,416711,3zqXX6kzhkbW3d4TwD2CNjMRwxTbREXySekvq37kfCNk,62827930,218189185,-155361255,624
2022-04-11 05:58:10-04:00,15163,6K1Xww22wVZuBwP6oYb3DPR5GvdxsQSiZ4WSmejQjyqf,8RoFHjv1TkGFqjKoSwzvyRNMoBP1ma1Hi2jy6FzD4i2g,True,138196693,32536025,202883,101441,101442,68sueyVfmy5ToEGtLFGDkwebX47xAmzyXE29z8JrmcWv,8617482,19205736,-10588254,623
2022-04-11 05:58:31-04:00,15164,bYUscp4qgQap7iDu5R8tyBz73dov4j3zDV2FgDUvSDx,E4d8ank6Ymezu4ubD2tU5B5fXuoh2E1RQkrdaLgMfuaT,True,246278614,61569653,384799,192399,192400,3zqXX6kzhkbW3d4TwD2CNjMRwxTbREXySekvq37kfCNk,15391981,75675377,-60283396,624
2022-04-11 05:58:36-04:00,15165,BjCNaM7YbE9SjFi7tzi4677zg1fKXGJwtecz2GWwWuhd,6rNsSrKZezQrLb2whToNjnizpnurDXrobHqfEK3QqU1M,True,2496359805,221014814,1377633,688816,688817,3zqXX6kzhkbW3d4TwD2CNjMRwxTbREXySekvq37kfCNk,155603551,614137291,-458533740,623
2022-04-11 05:58:39-04:00,15166,DVMLxFACqaNBD7q1TGJUUApJX7etJsxQRRFBP2DfBazJ,4hnRjD7S2KxD7UrgfrApntVxUD7Srh5E9nwPY53v89kz,True,175001721,16560551,106934,53467,53467,YQC4EUcgeBi9431viwvzvBbZJW3szeHX4dFmowRDyDw,11300184,45278722,-33978538,645
2022-04-11 05:58:39-04:00,15167,niCk6QHFU1kyU56Mdq5RJzKrecdkNSn23ZA6wduFdWS,BQbUYSw1XsuE6LnVd4XjmxAyYgx4drE4FsetJBCdwVZW,True,106327551,26567789,164307,82153,82154,68sueyVfmy5ToEGtLFGDkwebX47xAmzyXE29z8JrmcWv,6575823,16958839,-10383016,618
2022-04-11 05:58:43-04:00,15168,AQr9mVmcXCNQhBVCfx63MwR6c4WqDSC9K2BZqr7N8LCx,CB7TWUaL381ounsLw6neAUaKRxJL9P1HC9uGX5e1Uxod,True,2274149955,160805649,1003339,501669,501670,YQC4EUcgeBi9431viwvzvBbZJW3szeHX4dFmowRDyDw,141894610,496554830,-354660220,623
2022-04-11 05:58:44-04:00,15169,7CSCMFa9W52tBDVUbXbc3woAy3GByeA1wPJdp3MgznPa,3447ptuVFu6G8B6N63RmS8mRv4n9PfHneypHLvbeaGLn,True,771063802,95689141,590652,295326,295326,3zqXX6kzhkbW3d4TwD2CNjMRwxTbREXySekvq37kfCNk,47594812,209132992,-161538180,617
2022-04-11 05:58:45-04:00,15170,68zbVKnneMQqngbNkeLtPEP2ayNhawc1B2hPgqAEqgXK,HqiFpLr4NC7xJz9bEFusq8bCKaoxAQG1xsLxdUAzg8aa,True,3788887634,303386713,1893762,946881,946881,YQC4EUcgeBi9431viwvzvBbZJW3szeHX4dFmowRDyDw,236505164,914731849,-678226685,624
2022-04-11 05:58:48-04:00,15171,7yW1M1xeVx4hy3QftnpqdBDRYwamfu3K5i6AEnxgyTWb,7wf7FWS2DYp5RveQAmGNXAEUWPcHziuMLd4hV5LPgxF8,True,70134003,17533500,108749,54374,54375,gjBMZYVujDjD1ECG4i97M8Q3gV9ESnwwTSUGropkusj,4349972,13313265,-8963293,620
2022-04-11 05:58:52-04:00,15172,BTq6T9nDzYTPTRvxkhNLn82DF3RCWdRkatZUmSTGCu43,3Uuhmxo4tWMbrqowx2bQSJeWzMykUUcZanj29ptCmEa6,True,2921609179,418461332,2608896,1304448,1304448,3zqXX6kzhkbW3d4TwD2CNjMRwxTbREXySekvq37kfCNk,182147685,713077407,-530929722,623
2022-04-11 05:59:11-04:00,15173,EFHg5FatMRRSZnKJPJF9e1iw2cjPJRmwTTZYtkHno9DP,84LnLKhZDJgWFnbBYnYjqWkjymemXfidecPFwnUAvuFj,True,3572328863,893082215,5531617,2765808,2765809,68sueyVfmy5ToEGtLFGDkwebX47xAmzyXE29z8JrmcWv,221264698,641965765,-420701067,619
2022-04-11 05:59:11-04:00,15174,FV9CBGGTbppLnBKh79f2LzD1diTiS5g6u89FcpZHZmnK,Fe7mtmCUziFqbbYTvrhAcAq1Ub7YLfTJRtQ1hG7GzJD1,True,42340200,5506732,34248,17124,17124,68sueyVfmy5ToEGtLFGDkwebX47xAmzyXE29z8JrmcWv,2633320,11923773,-9290453,621
2022-04-11 05:59:11-04:00,15175,3geiQ6Ph1iyCnfEfTmWpVnvdJnYoUb3HNeKXwshQMJuF,3uu2PC2DhTR3iXVEKbq5hC8FrzyTYbwF9Ztm3BD3hjEm,True,170238712,42559678,261439,130719,130720,68sueyVfmy5ToEGtLFGDkwebX47xAmzyXE29z8JrmcWv,10457578,51135512,-40677934,614
2022-04-11 05:59:16-04:00,15176,3DEyi4Dnfxc7d91JbTpQjdAP1Ypgx5kaTSm4wwh8Zbm2,Cb2aqg5MyjopPzx5zd4zU81RUwJDeNTGV1jfiCLmgNTL,True,48323752,12080938,72564,36282,36282,68sueyVfmy5ToEGtLFGDkwebX47xAmzyXE29z8JrmcWv,2902587,7901774,-4999187,600
2022-04-11 05:59:16-04:00,15177,AoXamAP5a8TQVU1iASScAtAE6Dh2U6VwXTS2q7ksNfVp,FqffL8e7uWNqnu6ueuYQyKpoFhNxPjoKsR2gBkEgJcAM,True,35983419,8995854,55313,27656,27657,gjBMZYVujDjD1ECG4i97M8Q3gV9ESnwwTSUGropkusj,2212525,10742423,-8529898,614
2022-04-11 05:59:16-04:00,15178,5YC2wXkdk7D4Ubs9TEAbP1hi88Sy35bzYVWjLbgVxn5s,4Mx69ezqFK2wudZ62oVhx2pwjVbKv8JB1HR29ZUcdEJb,True,851604237,212901059,1324913,662456,662457,3zqXX6kzhkbW3d4TwD2CNjMRwxTbREXySekvq37kfCNk,52996542,180419862,-127423320,622
2022-04-11 05:59:18-04:00,15179,9CPdihNEnbQXUdvVx21jZJoy8YJpobbXXecQsXQ7vaz8,DXNhRC63N5wufnFG2K5u4B3UtdKHh1ZniB1r5cVxHcqm,False,282427,282427,17638,881,16757,A9TwRM1BMxqb8DCC7YNAMV6zPenEJm3HTZBy7wJKK58U,17638,35212,-17574,624
2022-04-11 05:59:18-04:00,15180,GHHkWuoUrAsuf1n8Y2GFozQxxv3LSr2zU9DWwKmAGTG9,7Fr2hNXbiNUufq8USBK3HwWN4bQT6H9fcFzDt7fdKy2U,True,296253514694,74063378673,462818496,231409248,231409248,68sueyVfmy5ToEGtLFGDkwebX47xAmzyXE29z8JrmcWv,18512739861,91921810021,-73409070160,624
2022-04-11 05:59:20-04:00,15181,H8wYaRqc2wQuE3AdnSA2bCbukzxZEUCS5KbGYNsLAoho,F4ZEmseEyZfy3ZL6iyrczRZ9bww9HgVd8tYXExfbTcj1,True,32106541,8026635,45830,22915,22915,YQC4EUcgeBi9431viwvzvBbZJW3szeHX4dFmowRDyDw,1833213,9810741,-7977528,570
2022-04-11 05:59:22-04:00,15182,eiLMepBYM3VcWarQJC9fTnxotyMuUTbyMGJECedPEfu,k2ZfwPNBBCK7PvZ6MEvELTHHtQZSXCRGCymvkZwhDDt,False,14368339,14368339,870187,43509,826678,68sueyVfmy5ToEGtLFGDkwebX47xAmzyXE29z8JrmcWv,870188,3916845,-3046657,605
2022-04-11 05:59:22-04:00,15183,4U5pUaMfeesvncA9JNmMhs7gSV1B8cmPnXJXSRBVS3So,QaYTU1jx464rJqmQtqtb4z5uuT5KEFNQNQiJgo81RzA,True,113773028,28443257,161897,80948,80949,68sueyVfmy5ToEGtLFGDkwebX47xAmzyXE29z8JrmcWv,6475905,16437601,-9961696,569
2022-04-11 05:59:23-04:00,15184,J8khFNhJg25xVY7yjEtETTQVVzKHqdVCs1Rh2pJKvJqU,4eUP2YxTapjr6TLrd57XxZan7KJG5AtHK8yPRNVEbavx,True,190799082,47699770,289802,144901,144901,3zqXX6kzhkbW3d4TwD2CNjMRwxTbREXySekvq37kfCNk,11592115,32866045,-21273930,607
2022-04-11 05:59:23-04:00,15185,9WH1YzDrdvZs8aDuFLwQHHXa2e66ZcwdfDi7qXEjQxFy,3Tpc8DqJwg1tTDgk6qH1UhvtwvhXxsp5GRFYMWxa8NKX,True,1390778312,347694578,2173082,1086541,1086541,3zqXX6kzhkbW3d4TwD2CNjMRwxTbREXySekvq37kfCNk,86923282,355401725,-268478443,624
2022-04-11 05:59:24-04:00,15186,HHp8dRc1YMWE93uyLdM98DkUhM8U8zm3JC59chrbbWrk,AdqFuGe28VeAwwjRPZCBGVy5ftf9zNNQkg413i66wyig,True,224699847,56174961,350241,175120,175121,A9TwRM1BMxqb8DCC7YNAMV6zPenEJm3HTZBy7wJKK58U,14009648,45847266,-31837618,623
2022-04-11 05:59:24-04:00,15187,G3ZEAY19iDMjF7P57dgFUZiC4bpeFvMPKShenugL7E2Y,D6nUGgpWkQUZcUKZYawfedX67uqQ9Co1wEwtbHPMtc7X,True,555147211,73745276,449970,224985,224985,YQC4EUcgeBi9431viwvzvBbZJW3szeHX4dFmowRDyDw,33873386,211069443,-177196057,610
2022-04-11 05:59:24-04:00,15188,2i5g7q4gD1GEfSz8BkhKn1idQ5U7cFPbMDWugjr7bBQW,Dpx6K9G5uZD63rTzBafZ56WKd1X9M25Mzfppd7Jib4xn,True,770997506,192749376,1169389,584694,584695,gjBMZYVujDjD1ECG4i97M8Q3gV9ESnwwTSUGropkusj,46775588,280966099,-234190511,606
2022-04-11 05:59:24-04:00,15189,JABfWoDV2wW68XEDANXArYWM7zabdbp5NBVrvzZd3mML,5hYUtd1Uv2pAcrbtSNNVTrRuk8acjmh92mzSm4iz5HJA,True,34676360,4662402,29052,14526,14526,YQC4EUcgeBi9431viwvzvBbZJW3szeHX4dFmowRDyDw,2160838,8872586,-6711748,623
2022-04-11 05:59:24-04:00,15190,D3mQ4aGmHdD8QHuDzGx1ZGRMaM4eB32LzVp1dnt931wx,86icTdjxoqizRxHTrGPUjFkR7gaapLFMuYVLogWJZ12J,True,26105961,6526490,38700,19350,19350,A9TwRM1BMxqb8DCC7YNAMV6zPenEJm3HTZBy7wJKK58U,1548035,3173189,-1625154,592
2022-04-11 05:59:24-04:00,15191,4qqThJTwuoaWDtEh4agoqM9EwcJbznzGVJW8nbSsEVdS,Aub7UJXkAGC9gn1XybeW1yjYZ97c3kkWd7wbQpTFsYrG,True,806697517,106849812,667675,333837,333838,3zqXX6kzhkbW3d4TwD2CNjMRwxTbREXySekvq37kfCNk,50408382,134529196,-84120814,624
2022-04-11 05:59:24-04:00,15192,1EH82ta3wXUyUwW8VWQnVzSG3r1rHcSj2DvDeTKmp3F,B6aMfucYPbCzWBtauLtgTpwR45wKSK8yqscHJR3F5usu,True,413840148,103460037,639019,319509,319510,3zqXX6kzhkbW3d4TwD2CNjMRwxTbREXySekvq37kfCNk,25560781,67056057,-41495276,617
2022-04-11 05:59:24-04:00,15193,B6Wc3euMqUf6QjzCqDtNeAEUM7MvADFaiReEq9VYH2Qg,2pzhsqXYd5u7h4xTN8bMS3GbicVnJ6KY3MQn7spSXroA,True,711555010,104735754,628314,314157,314157,YQC4EUcgeBi9431viwvzvBbZJW3szeHX4dFmowRDyDw,42686536,81470006,-38783470,599
2022-04-11 05:59:30-04:00,15194,4GbUrgiR6A91h3J9HHpuYCkZzjwrb62n3BURLeWj6Nic,12nUFUGYF1rXbwPeCbdGKdP3RE4g984fmZZggEYSFTZn,True,32903633,8225908,50774,25387,25387,A9TwRM1BMxqb8DCC7YNAMV6zPenEJm3HTZBy7wJKK58U,2030961,11727692,-9696731,617
2022-04-11 05:59:44-04:00,15195,A7bxZn4tYkEvYHu2SEqUbouNoSBSGMeqK4Kx4qySkNEZ,DNajWLThK1wtHsiGVcd9hNPyAch6BsX5Np1jxy9kHSJ8,True,26066553,6516638,40694,20347,20347,DQCvC9mR68hJ3tJsUiddh6JwcBJAmntqGJR2nUsEq7yj,1627773,6074081,-4446308,624
2022-04-11 05:59:50-04:00,15196,BjCNaM7YbE9SjFi7tzi4677zg1fKXGJwtecz2GWwWuhd,6rNsSrKZezQrLb2whToNjnizpnurDXrobHqfEK3QqU1M,True,2262180983,200504135,1250275,625137,625138,YQC4EUcgeBi9431viwvzvBbZJW3szeHX4dFmowRDyDw,141061910,591943228,-450881318,623
2022-04-11 06:00:00-04:00,15197,CDVtXFbo4Rg2aHsXKv5P3uRJq9ZTgsRd7GXPTxgH5xv9,6zj37qQnaiJT7xGEZmSKx5yQvisQFcs5KhGsG43SGd5y,True,1043036795,138659404,862435,431217,431218,YQC4EUcgeBi9431viwvzvBbZJW3szeHX4dFmowRDyDw,64874997,207722904,-142847907,621
2022-04-11 06:00:00-04:00,15198,68zbVKnneMQqngbNkeLtPEP2ayNhawc1B2hPgqAEqgXK,HqiFpLr4NC7xJz9bEFusq8bCKaoxAQG1xsLxdUAzg8aa,True,3466965005,274701948,1712006,856003,856003,3zqXX6kzhkbW3d4TwD2CNjMRwxTbREXySekvq37kfCNk,216069339,880580376,-664511037,623
2022-04-11 06:00:03-04:00,15199,BhhVhLVZkSd3aHDMd6ojTgtJtbgAdMCA9Xj8jL2GMXoL,G8HUQp2yGSw9T6it5ej91cqkd82naca8heji453g2jEH,True,1564903288,219707744,1372381,686190,686191,3zqXX6kzhkbW3d4TwD2CNjMRwxTbREXySekvq37kfCNk,97750042,354691217,-256941175,624
2022-04-11 06:00:03-04:00,15200,AQr9mVmcXCNQhBVCfx63MwR6c4WqDSC9K2BZqr7N8LCx,CB7TWUaL381ounsLw6neAUaKRxJL9P1HC9uGX5e1Uxod,True,2103586433,154458102,962808,481404,481404,68sueyVfmy5ToEGtLFGDkwebX47xAmzyXE29z8JrmcWv,131126288,473004998,-341878710,623
2022-04-11 06:00:04-04:00,15201,H9pFRayNBHTAhsbtGyfs1XXUWGxAbw7SgpT1xdrSRWEY,9LNreyXuhgyLCDYViNyA1jUw6h1nv4GmDtTYMoUQBqCG,True,23307589363,2653439098,16494798,8247399,8247399,68sueyVfmy5ToEGtLFGDkwebX47xAmzyXE29z8JrmcWv,1448889489,4221090740,-2772201251,621
2022-04-11 06:00:08-04:00,15202,5BjBPqumCb9KC82ZNNch3dcRzbpGdRLJneru7o9a1D9R,FuZtBWKktxFu4yoiLVMzxq8fMhQyN8SGzGPz49xs3m6P,True,864065492,116976911,730324,365162,365162,gjBMZYVujDjD1ECG4i97M8Q3gV9ESnwwTSUGropkusj,53946415,203748114,-149801699,624
2022-04-11 06:00:10-04:00,15203,7ueXVhSvXvttkeQ18w2cLh65naoEPvYF86RrdUK2Vc5Q,CKTehY1W6bw85cS4o7g2qXKjP4656Vwo37244BAEAiw1,True,2258183494,564542452,3398272,1699136,1699136,A9TwRM1BMxqb8DCC7YNAMV6zPenEJm3HTZBy7wJKK58U,135931722,482856960,-346925238,601
2022-04-11 06:00:10-04:00,15204,DXGapgtgkag6midSCYNhHCNaCqvhUmuSvnVhXxNXBmyt,Csq6W5QkGZL6qE6Z1ERF3bfHtKjnM8hAxiY1YA3rTwSX,True,78156442,19539110,121647,60823,60824,gjBMZYVujDjD1ECG4i97M8Q3gV9ESnwwTSUGropkusj,4865904,28297895,-23431991,622
2022-04-11 06:00:46-04:00,15205,GRqv7y5n92vQ7bXcBqUng4vaau6w1tQeou953s8kJNwD,Bk75oioYmUzfdpbxDHTFb2nWhJgNqAt8ud1ehem3VVhh,True,1781588098,445397024,2777897,1388948,1388949,68sueyVfmy5ToEGtLFGDkwebX47xAmzyXE29z8JrmcWv,111115884,329284793,-218168909,623
2022-04-11 06:01:01-04:00,15206,7AizMrxWWr7qfneuXMy6ifL3BVDTAKkuud4PyZFy92kh,GyAWRRfQkVAXtyhVF14vU3kPMr4kG1VyA9FAHdDTr8ud,True,211517811,52879452,328774,164387,164387,A9TwRM1BMxqb8DCC7YNAMV6zPenEJm3HTZBy7wJKK58U,13150991,39658132,-26507141,621
2022-04-11 06:01:37-04:00,15207,7Zib2ZfUnrBSfYBYbRErc3h8iTq7m5sBAtsbUtmNwv3C,DthmdM3S1YeWHF6TfZc3MWnufN38P42tHFVhi6hoZbcp,False,281026,281026,17562,878,16684,gjBMZYVujDjD1ECG4i97M8Q3gV9ESnwwTSUGropkusj,17562,36531,-18969,624
2022-04-11 06:01:48-04:00,15208,DVMLxFACqaNBD7q1TGJUUApJX7etJsxQRRFBP2DfBazJ,4hnRjD7S2KxD7UrgfrApntVxUD7Srh5E9nwPY53v89kz,True,157482165,15872533,103144,51572,51572,YQC4EUcgeBi9431viwvzvBbZJW3szeHX4dFmowRDyDw,10233718,40638089,-30404371,649
2022-04-11 06:02:17-04:00,15209,7CSCMFa9W52tBDVUbXbc3woAy3GByeA1wPJdp3MgznPa,3447ptuVFu6G8B6N63RmS8mRv4n9PfHneypHLvbeaGLn,True,670250617,72111175,450375,225187,225188,68sueyVfmy5ToEGtLFGDkwebX47xAmzyXE29z8JrmcWv,41860973,191155681,-149294708,624
2022-04-11 06:02:26-04:00,15210,7tFD53kPTqrzjCu1Wji78gUqhoRtCUhsP1pM3DQKT7uG,BJvgPLYBDJrQJdQVowrsMwUGMurq4zTihoFwWoEokfu3,True,3197662025,799415506,4955897,2477948,2477949,3zqXX6kzhkbW3d4TwD2CNjMRwxTbREXySekvq37kfCNk,198235885,667202711,-468966826,619
2022-04-11 06:02:27-04:00,15211,D5VZNThkv6XD6bimPshD2J3PvbPXgCbivZuPfkVxgdjc,8C77LmMk4C3KvyEb1N3scdbAgwN7J45nAcv9tkL5namB,True,59918271745,14979567936,92243627,46121813,46121814,68sueyVfmy5ToEGtLFGDkwebX47xAmzyXE29z8JrmcWv,3689745112,6983946250,-3294201138,615
2022-04-11 06:02:27-04:00,15212,8fVwuVA2CL5sZoHh6Dg4MBpcX3cvoUm7mnitnpQSdPBD,4F4ccaNm1KQu29XvsKvdjFkmpsbWqNvXkV41851EYQyu,True,243255822,33458022,200544,100272,100272,68sueyVfmy5ToEGtLFGDkwebX47xAmzyXE29z8JrmcWv,14580525,59385164,-44804639,599
2022-04-11 06:02:32-04:00,15213,AKcGcqFMxvVWFHpc9oUJYGZsLN4DUHVkMSLGYrMcCYYN,4dWje79e7kH8GWJwwfB76BQUVUSgnYHTVxrtfNyG5A4K,True,7229890382,919131387,5741361,2870680,2870681,3zqXX6kzhkbW3d4TwD2CNjMRwxTbREXySekvq37kfCNk,451615703,1597949313,-1146333610,624
2022-04-11 06:02:34-04:00,15214,H1oYXGZTagwv48FdDe6RNkjNaesedqLKyXxTmPc5k4Fp,Am3rx6XrkrZ4MdeZDyZUv1YW2fBujcz4dLjVCnRQHKZa,True,16774440,4193610,26209,13104,13105,68sueyVfmy5ToEGtLFGDkwebX47xAmzyXE29z8JrmcWv,1048382,2554323,-1505941,624
2022-04-11 06:02:35-04:00,15215,5F7WHSYiVtCY8Z9KX9h6AT8qr4hbsSYasG15fq82ZWhr,E5wj8cqKM1ofNv14TspTa8yRwern8y2w6pXekL4cAWX7,True,20686572,5171643,31401,15700,15701,YQC4EUcgeBi9431viwvzvBbZJW3szeHX4dFmowRDyDw,1256047,4295334,-3039287,607
2022-04-11 06:02:47-04:00,15216,EN2YBXcj7E1eAaYJYXJjc6Rfsu6Awjgv9kN3bT3uiprp,HYDG5mqfCy2xwrYKixNzoWyDiqb9KbpnA8H3TQG2EDDG,True,179469641,44867324,277540,138770,138770,YQC4EUcgeBi9431viwvzvBbZJW3szeHX4dFmowRDyDw,11101667,46131703,-35030036,618
2022-04-11 06:02:47-04:00,15217,AQr9mVmcXCNQhBVCfx63MwR6c4WqDSC9K2BZqr7N8LCx,CB7TWUaL381ounsLw6neAUaKRxJL9P1HC9uGX5e1Uxod,True,1940033722,125982425,786030,393015,393015,3zqXX6kzhkbW3d4TwD2CNjMRwxTbREXySekvq37kfCNk,121042820,445334817,-324291997,623
2022-04-11 06:03:47-04:00,15218,AesBjn477pGAHDWvrqc84sK5qNQoMYC5MZrkNvYZFGW3,Ek3BWeDxvBVpxJCyQQKiTtpWmB7YoVAp37suDuB37hBG,False,280202,280202,17501,875,16626,DQCvC9mR68hJ3tJsUiddh6JwcBJAmntqGJR2nUsEq7yj,17501,37300,-19799,624
2022-04-11 06:03:47-04:00,15219,D8FAC4KB4tpPkPXb9dgqmADMRzwtryF4x4JZGtsrw5op,Gvku7d9nDmsKejX2wZHKoDHvocHSQP4DW7Bx3zyCBfqM,False,280202,280202,17507,875,16632,DQCvC9mR68hJ3tJsUiddh6JwcBJAmntqGJR2nUsEq7yj,17507,37306,-19799,624
2022-04-11 06:35:36-04:00,15220,8qq2gfbca7JXvq4gViBBVT2QAbM4MvBMEQLXgn8UUTvt,3o5jpBVYdFFEYrGRdCUkLrUC85wsuTKgy8iYwnpZyC1B,True,960483938,87377644,545936,272968,272968,3zqXX6kzhkbW3d4TwD2CNjMRwxTbREXySekvq37kfCNk,60011164,427031467,-367020303,624
2022-04-11 06:44:48-04:00,15221,SEndYVMCKAeZUKSqGrMUSqXFmxtA9M1t4eXsUhVsTBF,3fcQQcbkpqodakamn82pFnMxBEPL2Drsg4jJNZ6dx72M,True,806859073,94763848,611852,305926,305926,3zqXX6kzhkbW3d4TwD2CNjMRwxTbREXySekvq37kfCNk,52095698,174718922,-122623224,645
2022-04-11 06:44:51-04:00,15222,5qY8ZrqpHPqkAuXp6HpE2zC8qTfzsP8MXWSoxkZQV5jx,GPs3ap45TuHwHwmDb5bnKYHLBa5wj3AyuEsXcfHjEcAL,False,14015800,14015800,989286,49464,939822,DQCvC9mR68hJ3tJsUiddh6JwcBJAmntqGJR2nUsEq7yj,989286,4656202,-3666916,705
2022-04-11 06:44:52-04:00,15223,DVMLxFACqaNBD7q1TGJUUApJX7etJsxQRRFBP2DfBazJ,4hnRjD7S2KxD7UrgfrApntVxUD7Srh5E9nwPY53v89kz,True,140482043,10917700,69967,34983,34984,DQCvC9mR68hJ3tJsUiddh6JwcBJAmntqGJR2nUsEq7yj,9002985,38608759,-29605774,640
2022-04-11 07:23:27-04:00,15224,AnHimvBh3qdpMxL98ZhjxHAsjFixByuXrzdzz54aAjBz,XzZUyCy5pUXLEfzkP1NeroMpvjipeEEUVEcFoDEQH61,True,6969740842,957191279,5958796,2979398,2979398,YQC4EUcgeBi9431viwvzvBbZJW3szeHX4dFmowRDyDw,433886811,731984847,-298098036,622
2022-04-11 07:23:43-04:00,15225,5yPGvUz6JWKjkViGwTCpygJii1rP2xv5yx146ULtBiYq,FMnHUCQWTf1UHu5qVFqUAsWh8aba9EQYTEoiXy55totD,True,72182108,18045527,124863,62431,62432,A9TwRM1BMxqb8DCC7YNAMV6zPenEJm3HTZBy7wJKK58U,4994533,10546903,-5552370,691
2022-04-11 07:23:43-04:00,15226,85w2wxozVA7Zfm1FdA1yWb8D43jdC9mefYzNqFyRe5iU,BHieDhQaBUbsWGmqNerfbCAMMGGAjEPpiNiSWAQS57D5,True,234637515,58659378,366234,183117,183117,3zqXX6kzhkbW3d4TwD2CNjMRwxTbREXySekvq37kfCNk,14649368,40849867,-26200499,624
2022-04-11 07:25:46-04:00,15227,6TvTxJWSPeyaTVm8PmarVDzxhbTqnkyoabQTgihXyGMj,62ngTMHaRDFjpvzasDgfmgyJ5T6jS9PmYgy97HCkyQS4,True,33692615,8423153,52319,26159,26160,YQC4EUcgeBi9431viwvzvBbZJW3szeHX4dFmowRDyDw,2092760,4146135,-2053375,621
2022-04-11 07:25:46-04:00,15228,EC8fafqtuQzqbm2TZs3GeuXB9qXomkykrTG1na2rfFpx,A72f7W58h3r8nut45RmqdTk1J31NGYT2sVWMn18dK885,True,40059313,10014828,62426,31213,31213,68sueyVfmy5ToEGtLFGDkwebX47xAmzyXE29z8JrmcWv,2497048,7499935,-5002887,623
2022-04-11 07:26:06-04:00,15229,B6Wc3euMqUf6QjzCqDtNeAEUM7MvADFaiReEq9VYH2Qg,2pzhsqXYd5u7h4xTN8bMS3GbicVnJ6KY3MQn7spSXroA,True,602333462,78134457,486981,243490,243491,3zqXX6kzhkbW3d4TwD2CNjMRwxTbREXySekvq37kfCNk,37541113,78145058,-40603945,623
2022-04-11 07:26:21-04:00,15230,JABfWoDV2wW68XEDANXArYWM7zabdbp5NBVrvzZd3mML,5hYUtd1Uv2pAcrbtSNNVTrRuk8acjmh92mzSm4iz5HJA,True,29742054,3989463,24911,12455,12456,68sueyVfmy5ToEGtLFGDkwebX47xAmzyXE29z8JrmcWv,1857218,8031914,-6174696,624
2022-04-11 07:27:36-04:00,15231,5j5R1o3wXaL7cS9fxodLkrFjxPnujuX8boG7Zb9Fh9fs,4SZXsGqPoUy11ZKK5kNUpxCPK3ZcSxWMn12h4YREr9tS,True,613421795,153355448,957611,478805,478806,3zqXX6kzhkbW3d4TwD2CNjMRwxTbREXySekvq37kfCNk,38304465,101052550,-62748085,624
2022-04-11 07:27:50-04:00,15232,C3DnHRyndQw1EinnmrayLzuhP9KhXYKVDUpf55BumxG1,6aU3EvNk5CyD5LdGhQksYKkNxvJ5vw23JvMEdwqeDSMo,True,1469956508,367489127,2296589,1148294,1148295,3zqXX6kzhkbW3d4TwD2CNjMRwxTbREXySekvq37kfCNk,91863576,559648370,-467784794,624
2022-04-11 07:31:43-04:00,15233,GgJXh5hTo4xyVuuGEis971RRXcZECLpjvtMSCZtVu13Q,9BGMfGfMZNXdcygAuqYQudWHhSE5LqVoWsNsruCawnRK,True,22157600,5539400,34528,17264,17264,YQC4EUcgeBi9431viwvzvBbZJW3szeHX4dFmowRDyDw,1381147,3705133,-2323986,623
2022-04-11 07:31:43-04:00,15234,3BKX31xq3f13J2Zo8Wue4SYpCMWLXjgUt2nkwTTNfU2T,2pTxNAaV4pXRRUDE97ZFteBJn9tyktjh3FW1CWfwebci,True,49928744,12482186,77491,38745,38746,A9TwRM1BMxqb8DCC7YNAMV6zPenEJm3HTZBy7wJKK58U,3099674,15294709,-12195035,620
2022-04-11 07:32:03-04:00,15235,H9pFRayNBHTAhsbtGyfs1XXUWGxAbw7SgpT1xdrSRWEY,9LNreyXuhgyLCDYViNyA1jUw6h1nv4GmDtTYMoUQBqCG,True,20504445594,1973783447,12335738,6167869,6167869,3zqXX6kzhkbW3d4TwD2CNjMRwxTbREXySekvq37kfCNk,1281485484,4084123329,-2802637845,624
2022-04-11 07:34:20-04:00,15236,6zLsQakpDaa2cggm9g5BbrrUY3e6tsEEi4jQYrB1GucR,HYs4PktD8Kh89iDVTSnoHwMY619mffCwo9Uog8u17KbK,True,342708908,64440445,410850,205425,205425,68sueyVfmy5ToEGtLFGDkwebX47xAmzyXE29z8JrmcWv,21849961,61863561,-40013600,637
2022-04-11 07:34:54-04:00,15237,FCJeVA3JuuW1y2BHNKje3ZLgd74z7tasSztYTxjHnsVH,GEFUehF3zWqd3Uyf9UNMkRHV9o56XnsKRUjXKWiuZLTh,True,2550916164,637729041,3970052,1985026,1985026,3zqXX6kzhkbW3d4TwD2CNjMRwxTbREXySekvq37kfCNk,158802102,343329947,-184527845,622
2022-04-11 07:34:54-04:00,15238,6fxUEgnR8SRihBVA4ZAxzXQTLPCeHsQatzUpB9XheY44,7Ds71dQsLTzuSy9LRG5P4wjmrofgQwJMJ5kXXvxpXiG2,True,3027692590,756923147,4720262,2360131,2360131,3zqXX6kzhkbW3d4TwD2CNjMRwxTbREXySekvq37kfCNk,188810491,496112154,-307301663,623
2022-04-11 07:34:58-04:00,15239,HV3BVN9zLURqQBJyUFFeytFvjhhoYYJ3VXTCDYpML7Fd,ZCesJgyYoyWb3wfUP6BusxEBtVAYb2AAe94QbxVkFsb,True,288894889,72223722,446898,223449,223449,YQC4EUcgeBi9431viwvzvBbZJW3szeHX4dFmowRDyDw,17875951,39422037,-21546086,618
2022-04-11 07:35:07-04:00,15240,GeYsENPRf2qGZu9rJsi6UPQqHS6sR7LRLWsKbFgtMCSb,7A79wktqPkSpP7o4c1kP9CBpUibHTqycW81ZANgREc5S,True,22496078,5624019,34970,17485,17485,68sueyVfmy5ToEGtLFGDkwebX47xAmzyXE29z8JrmcWv,1398839,7393907,-5995068,621
2022-04-11 07:35:08-04:00,15241,DVMLxFACqaNBD7q1TGJUUApJX7etJsxQRRFBP2DfBazJ,4hnRjD7S2KxD7UrgfrApntVxUD7Srh5E9nwPY53v89kz,True,128987992,12209361,79092,39546,39546,YQC4EUcgeBi9431viwvzvBbZJW3szeHX4dFmowRDyDw,8355892,36103513,-27747621,647
2022-04-11 07:35:47-04:00,15242,7sgoB9mHcUoNFFdQSsBvyC4tXYzYR86ct11WQsS1FvAp,5k2QtQPgMUvj88Tmizf1pABHtC3VHJDc6BYNkB9gp19M,True,469080089,117270022,732933,366466,366467,3zqXX6kzhkbW3d4TwD2CNjMRwxTbREXySekvq37kfCNk,29317352,82374262,-53056910,624
2022-04-11 07:35:47-04:00,15243,Br1j5Ftafei7ysu5SmqVZSoRe4uS4qCPeKSPHg55pyiE,G8fc7QvXjfkgBFvAVUgJFQS3VaF1biL9rktBExGa87Ks,True,855532237,213883059,1335341,667670,667671,YQC4EUcgeBi9431viwvzvBbZJW3szeHX4dFmowRDyDw,53413674,94599105,-41185431,624
2022-04-11 07:35:52-04:00,15244,6K1Xww22wVZuBwP6oYb3DPR5GvdxsQSiZ4WSmejQjyqf,8RoFHjv1TkGFqjKoSwzvyRNMoBP1ma1Hi2jy6FzD4i2g,True,103703244,23944182,149052,74526,74526,YQC4EUcgeBi9431viwvzvBbZJW3szeHX4dFmowRDyDw,6455541,16521563,-10066022,622
2022-04-11 07:35:52-04:00,15245,67DwuUmzk6uGwmptjYErQssFeJ5fd1ztFwKWZUovr7pK,HKzc15e1QLBrSsbAENyMXSVHDoap1F5MHCHB9L1Dm8HA,True,43436211,10859052,66906,33453,33453,A9TwRM1BMxqb8DCC7YNAMV6zPenEJm3HTZBy7wJKK58U,2676250,15387488,-12711238,616
2022-04-11 07:36:00-04:00,15246,8fVwuVA2CL5sZoHh6Dg4MBpcX3cvoUm7mnitnpQSdPBD,4F4ccaNm1KQu29XvsKvdjFkmpsbWqNvXkV41851EYQyu,True,208384099,27222004,169314,84657,84657,gjBMZYVujDjD1ECG4i97M8Q3gV9ESnwwTSUGropkusj,12961065,49838195,-36877130,621
2022-04-11 07:36:10-04:00,15247,5o4EAqBTiUKn41QhPL5kRjrGTgQVdP7xLtxC7xNxjkwn,E8gDreu3LxW1EHJ8hnqChK9QdffGh5GocJYKdrbYat8E,True,2945453435,736363358,4598002,2299001,2299001,68sueyVfmy5ToEGtLFGDkwebX47xAmzyXE29z8JrmcWv,183920112,492193190,-308273078,624
2022-04-11 07:36:36-04:00,15248,7CSCMFa9W52tBDVUbXbc3woAy3GByeA1wPJdp3MgznPa,3447ptuVFu6G8B6N63RmS8mRv4n9PfHneypHLvbeaGLn,True,593719930,70896599,441467,220733,220734,YQC4EUcgeBi9431viwvzvBbZJW3szeHX4dFmowRDyDw,36970477,172499765,-135529288,622
2022-04-11 07:36:38-04:00,15249,68zbVKnneMQqngbNkeLtPEP2ayNhawc1B2hPgqAEqgXK,HqiFpLr4NC7xJz9bEFusq8bCKaoxAQG1xsLxdUAzg8aa,True,3176304466,242239589,1512920,756460,756460,YQC4EUcgeBi9431viwvzvBbZJW3szeHX4dFmowRDyDw,198377842,814277581,-615899739,624
2022-04-11 07:36:38-04:00,15250,8K1GzGeaAuFdjuVZi6DqBcYiA1zSRioMkRvjotr8p7fz,5mqocPwTdjwAPiJf7vx9bo7AzvfQBT2t5bV9u2Jzb2e1,True,191320287,47830071,339692,169846,169846,YQC4EUcgeBi9431viwvzvBbZJW3szeHX4dFmowRDyDw,13587711,28936399,-15348688,710
2022-04-11 07:37:10-04:00,15251,D8BtQirMEk3W9Pq29B6KkKWrwPfmsUNpwz5npx7aGMLY,J7LMZwaSoh5hbGcwee6oPsnN4ZFD7Zp3LQWkJGNUHRfJ,True,1348695197,337173799,2101325,1050662,1050663,3zqXX6kzhkbW3d4TwD2CNjMRwxTbREXySekvq37kfCNk,84053026,301968833,-217915807,623
2022-04-11 07:37:44-04:00,15252,AQr9mVmcXCNQhBVCfx63MwR6c4WqDSC9K2BZqr7N8LCx,CB7TWUaL381ounsLw6neAUaKRxJL9P1HC9uGX5e1Uxod,True,1806042726,121905983,757253,378626,378627,YQC4EUcgeBi9431viwvzvBbZJW3szeHX4dFmowRDyDw,112187557,431461253,-319273696,621
2022-04-11 07:38:01-04:00,15253,EN2YBXcj7E1eAaYJYXJjc6Rfsu6Awjgv9kN3bT3uiprp,HYDG5mqfCy2xwrYKixNzoWyDiqb9KbpnA8H3TQG2EDDG,True,132037056,33009178,206266,103133,103133,YQC4EUcgeBi9431viwvzvBbZJW3szeHX4dFmowRDyDw,8250712,37089210,-28838498,624
2022-04-11 07:38:20-04:00,15254,2ssYxbmFPYBdse9a6NJ26M8hsscYpjv5MyqyYkjftdrL,FKvvXz9eYXW2zgy37eaUW9u2K9LnnDsNx3DcgtATpizY,True,80137746,20034436,125143,62571,62572,68sueyVfmy5ToEGtLFGDkwebX47xAmzyXE29z8JrmcWv,5005752,16639562,-11633810,624
2022-04-11 07:55:31-04:00,15255,A5NXadGWnFZRoHEn1dKTRjcXgWmfMLMyJdpF4rQPZyRR,ALs3Zfotc4c4A6TFDMbd5GM5whK1dTYSnGrHiMBWmApH,True,884747202,221186254,1361803,680901,680902,68sueyVfmy5ToEGtLFGDkwebX47xAmzyXE29z8JrmcWv,54472319,327008737,-272536418,615
2022-04-11 08:07:57-04:00,15256,7yW1M1xeVx4hy3QftnpqdBDRYwamfu3K5i6AEnxgyTWb,7wf7FWS2DYp5RveQAmGNXAEUWPcHziuMLd4hV5LPgxF8,True,51581534,12895383,80506,40253,40253,A9TwRM1BMxqb8DCC7YNAMV6zPenEJm3HTZBy7wJKK58U,3220261,10961742,-7741481,624
2022-04-11 08:08:10-04:00,15257,4U5pUaMfeesvncA9JNmMhs7gSV1B8cmPnXJXSRBVS3So,QaYTU1jx464rJqmQtqtb4z5uuT5KEFNQNQiJgo81RzA,True,84242601,21060650,130589,65294,65295,68sueyVfmy5ToEGtLFGDkwebX47xAmzyXE29z8JrmcWv,5223577,13782124,-8558547,620
2022-04-11 08:08:15-04:00,15258,3geiQ6Ph1iyCnfEfTmWpVnvdJnYoUb3HNeKXwshQMJuF,3uu2PC2DhTR3iXVEKbq5hC8FrzyTYbwF9Ztm3BD3hjEm,True,125281179,31320294,194835,97417,97418,YQC4EUcgeBi9431viwvzvBbZJW3szeHX4dFmowRDyDw,7793435,40700007,-32906572,622
2022-04-11 08:08:16-04:00,15259,H8wYaRqc2wQuE3AdnSA2bCbukzxZEUCS5KbGYNsLAoho,F4ZEmseEyZfy3ZL6iyrczRZ9bww9HgVd8tYXExfbTcj1,True,23772941,5943235,36987,18493,18494,68sueyVfmy5ToEGtLFGDkwebX47xAmzyXE29z8JrmcWv,1479498,7769619,-6290121,622
2022-04-11 08:08:20-04:00,15260,EFHg5FatMRRSZnKJPJF9e1iw2cjPJRmwTTZYtkHno9DP,84LnLKhZDJgWFnbBYnYjqWkjymemXfidecPFwnUAvuFj,True,2627531274,656882818,4097899,2048949,2048950,68sueyVfmy5ToEGtLFGDkwebX47xAmzyXE29z8JrmcWv,163915962,531262770,-367346808,623
2022-04-11 08:10:52-04:00,15261,5YC2wXkdk7D4Ubs9TEAbP1hi88Sy35bzYVWjLbgVxn5s,4Mx69ezqFK2wudZ62oVhx2pwjVbKv8JB1HR29ZUcdEJb,True,626117816,156529454,976550,488275,488275,3zqXX6kzhkbW3d4TwD2CNjMRwxTbREXySekvq37kfCNk,39062002,147221031,-108159029,623
2022-04-11 08:11:09-04:00,15262,D3mQ4aGmHdD8QHuDzGx1ZGRMaM4eB32LzVp1dnt931wx,86icTdjxoqizRxHTrGPUjFkR7gaapLFMuYVLogWJZ12J,True,19275522,4818880,30115,15057,15058,A9TwRM1BMxqb8DCC7YNAMV6zPenEJm3HTZBy7wJKK58U,1204639,2727459,-1522820,624
2022-04-11 08:35:14-04:00,15263,Drkw9ZfordJrXzMqEbeQHQ3phh7U6xgxRi5s36mSs5uZ,EoJmZX1JEwEeN65Gx4bGiKxbWjWfQ4SvTGMWSQmR9xY7,True,7168575215,826613418,5163349,2581674,2581675,3zqXX6kzhkbW3d4TwD2CNjMRwxTbREXySekvq37kfCNk,447777166,1372758981,-924981815,624
2022-04-11 09:06:50-04:00,15264,2i5g7q4gD1GEfSz8BkhKn1idQ5U7cFPbMDWugjr7bBQW,Dpx6K9G5uZD63rTzBafZ56WKd1X9M25Mzfppd7Jib4xn,True,567737626,141934406,876661,438330,438331,68sueyVfmy5ToEGtLFGDkwebX47xAmzyXE29z8JrmcWv,35066451,221225593,-186159142,617
2022-04-11 09:06:55-04:00,15265,5BjBPqumCb9KC82ZNNch3dcRzbpGdRLJneru7o9a1D9R,FuZtBWKktxFu4yoiLVMzxq8fMhQyN8SGzGPz49xs3m6P,True,740180955,97308166,607651,303825,303826,3zqXX6kzhkbW3d4TwD2CNjMRwxTbREXySekvq37kfCNk,46221424,176664104,-130442680,624
2022-04-11 09:06:55-04:00,15266,4GbUrgiR6A91h3J9HHpuYCkZzjwrb62n3BURLeWj6Nic,12nUFUGYF1rXbwPeCbdGKdP3RE4g984fmZZggEYSFTZn,True,24205209,6051302,37660,18830,18830,68sueyVfmy5ToEGtLFGDkwebX47xAmzyXE29z8JrmcWv,1506425,9251500,-7745075,622
2022-04-11 09:07:13-04:00,15267,J8khFNhJg25xVY7yjEtETTQVVzKHqdVCs1Rh2pJKvJqU,4eUP2YxTapjr6TLrd57XxZan7KJG5AtHK8yPRNVEbavx,True,140505718,35126429,217536,108768,108768,68sueyVfmy5ToEGtLFGDkwebX47xAmzyXE29z8JrmcWv,8701474,27250817,-18549343,619
2022-04-11 09:07:18-04:00,15268,1EH82ta3wXUyUwW8VWQnVzSG3r1rHcSj2DvDeTKmp3F,B6aMfucYPbCzWBtauLtgTpwR45wKSK8yqscHJR3F5usu,True,304382393,76095598,472708,236354,236354,3zqXX6kzhkbW3d4TwD2CNjMRwxTbREXySekvq37kfCNk,18908347,56028922,-37120575,621
2022-04-11 09:08:39-04:00,15269,EDzP8bi8wGytnFoz4RynYddWyVWd5RFhHKcGZdwyAHJH,ELHWRXKjwkmoEj3nkJ9hw2bcL6dRd4znFeoLjitNbrXt,False,12139866,12139866,758593,37929,720664,68sueyVfmy5ToEGtLFGDkwebX47xAmzyXE29z8JrmcWv,758593,4264206,-3505613,624
2022-04-11 09:09:51-04:00,15270,9WH1YzDrdvZs8aDuFLwQHHXa2e66ZcwdfDi7qXEjQxFy,3Tpc8DqJwg1tTDgk6qH1UhvtwvhXxsp5GRFYMWxa8NKX,True,1021456504,255364126,1576755,788377,788378,YQC4EUcgeBi9431viwvzvBbZJW3szeHX4dFmowRDyDw,63070219,286073416,-223003197,617
2022-04-11 09:11:27-04:00,15271,3uUdWwgwtFdPa3FJTSrirqPKMtQb3zmT5Wpp4zPy9sJP,5G7dhz8jvWekGy9Wh3ZCXNXSPbB1QArfFYs7MYNgRDkW,True,51091468,12772867,79825,39912,39913,A9TwRM1BMxqb8DCC7YNAMV6zPenEJm3HTZBy7wJKK58U,3193021,21066771,-17873750,624
2022-04-11 09:12:06-04:00,15272,BTq6T9nDzYTPTRvxkhNLn82DF3RCWdRkatZUmSTGCu43,3Uuhmxo4tWMbrqowx2bQSJeWzMykUUcZanj29ptCmEa6,True,2478523836,314418530,1964181,982090,982091,3zqXX6kzhkbW3d4TwD2CNjMRwxTbREXySekvq37kfCNk,154834142,609063478,-454229336,624
2022-04-11 09:12:16-04:00,15273,BjCNaM7YbE9SjFi7tzi4677zg1fKXGJwtecz2GWwWuhd,6rNsSrKZezQrLb2whToNjnizpnurDXrobHqfEK3QqU1M,True,2049694082,202375261,1261101,630550,630551,3zqXX6kzhkbW3d4TwD2CNjMRwxTbREXySekvq37kfCNk,127726748,544807197,-417080449,623
2022-04-11 09:12:30-04:00,15274,GHHkWuoUrAsuf1n8Y2GFozQxxv3LSr2zU9DWwKmAGTG9,7Fr2hNXbiNUufq8USBK3HwWN4bQT6H9fcFzDt7fdKy2U,True,217759868648,54439967162,340207589,170103794,170103795,3zqXX6kzhkbW3d4TwD2CNjMRwxTbREXySekvq37kfCNk,13608303573,73908990680,-60300687107,624
2022-04-11 09:12:32-04:00,15275,B6Wc3euMqUf6QjzCqDtNeAEUM7MvADFaiReEq9VYH2Qg,2pzhsqXYd5u7h4xTN8bMS3GbicVnJ6KY3MQn7spSXroA,True,518775850,72279124,440079,220039,220040,3zqXX6kzhkbW3d4TwD2CNjMRwxTbREXySekvq37kfCNk,31586248,75196413,-43610165,608
2022-04-11 09:20:44-04:00,15276,FV9CBGGTbppLnBKh79f2LzD1diTiS5g6u89FcpZHZmnK,Fe7mtmCUziFqbbYTvrhAcAq1Ub7YLfTJRtQ1hG7GzJD1,True,36516195,5112010,31927,15963,15964,68sueyVfmy5ToEGtLFGDkwebX47xAmzyXE29z8JrmcWv,2280682,10893096,-8612414,624
2022-04-11 09:20:59-04:00,15277,H9pFRayNBHTAhsbtGyfs1XXUWGxAbw7SgpT1xdrSRWEY,9LNreyXuhgyLCDYViNyA1jUw6h1nv4GmDtTYMoUQBqCG,True,18413888751,1522171562,9513489,4756744,4756745,3zqXX6kzhkbW3d4TwD2CNjMRwxTbREXySekvq37kfCNk,1150858093,3963930388,-2813072295,624
2022-04-11 09:26:07-04:00,15278,85w2wxozVA7Zfm1FdA1yWb8D43jdC9mefYzNqFyRe5iU,BHieDhQaBUbsWGmqNerfbCAMMGGAjEPpiNiSWAQS57D5,True,172464315,43116078,269112,134556,134556,68sueyVfmy5ToEGtLFGDkwebX47xAmzyXE29z8JrmcWv,10764485,33929137,-23164652,624
2022-04-11 09:26:18-04:00,15279,5j5R1o3wXaL7cS9fxodLkrFjxPnujuX8boG7Zb9Fh9fs,4SZXsGqPoUy11ZKK5kNUpxCPK3ZcSxWMn12h4YREr9tS,True,450706782,112676695,699366,349683,349683,3zqXX6kzhkbW3d4TwD2CNjMRwxTbREXySekvq37kfCNk,27974659,84398377,-56423718,620
2022-04-11 09:26:18-04:00,15280,C3DnHRyndQw1EinnmrayLzuhP9KhXYKVDUpf55BumxG1,6aU3EvNk5CyD5LdGhQksYKkNxvJ5vw23JvMEdwqeDSMo,True,1080091837,270022959,1679029,839514,839515,3zqXX6kzhkbW3d4TwD2CNjMRwxTbREXySekvq37kfCNk,67161173,440396524,-373235351,621
2022-04-11 09:26:25-04:00,15281,6zLsQakpDaa2cggm9g5BbrrUY3e6tsEEi4jQYrB1GucR,HYs4PktD8Kh89iDVTSnoHwMY619mffCwo9Uog8u17KbK,True,274320472,47349844,301829,150914,150915,68sueyVfmy5ToEGtLFGDkwebX47xAmzyXE29z8JrmcWv,17486444,54062154,-36575710,637
2022-04-11 09:26:39-04:00,15282,DVMLxFACqaNBD7q1TGJUUApJX7etJsxQRRFBP2DfBazJ,4hnRjD7S2KxD7UrgfrApntVxUD7Srh5E9nwPY53v89kz,True,116037345,11729328,76166,38083,38083,A9TwRM1BMxqb8DCC7YNAMV6zPenEJm3HTZBy7wJKK58U,7535101,32413058,-24877957,649
2022-04-11 09:26:45-04:00,15283,HV3BVN9zLURqQBJyUFFeytFvjhhoYYJ3VXTCDYpML7Fd,ZCesJgyYoyWb3wfUP6BusxEBtVAYb2AAe94QbxVkFsb,True,212523440,53130860,331884,165942,165942,68sueyVfmy5ToEGtLFGDkwebX47xAmzyXE29z8JrmcWv,13275364,33583325,-20307961,624
2022-04-11 09:26:49-04:00,15284,3BKX31xq3f13J2Zo8Wue4SYpCMWLXjgUt2nkwTTNfU2T,2pTxNAaV4pXRRUDE97ZFteBJn9tyktjh3FW1CWfwebci,True,36696585,9174146,56692,28346,28346,68sueyVfmy5ToEGtLFGDkwebX47xAmzyXE29z8JrmcWv,2267714,12164029,-9896315,617
2022-04-11 09:26:49-04:00,15285,5BjBPqumCb9KC82ZNNch3dcRzbpGdRLJneru7o9a1D9R,FuZtBWKktxFu4yoiLVMzxq8fMhQyN8SGzGPz49xs3m6P,True,636912412,86900116,541029,270514,270515,YQC4EUcgeBi9431viwvzvBbZJW3szeHX4dFmowRDyDw,39653396,163148898,-123495502,622
2022-04-11 09:30:28-04:00,15286,Drkw9ZfordJrXzMqEbeQHQ3phh7U6xgxRi5s36mSs5uZ,EoJmZX1JEwEeN65Gx4bGiKxbWjWfQ4SvTGMWSQmR9xY7,True,6253101955,610898624,3797553,1898776,1898777,3zqXX6kzhkbW3d4TwD2CNjMRwxTbREXySekvq37kfCNk,388714052,1200643235,-811929183,621
2022-04-11 09:31:14-04:00,15287,HHp8dRc1YMWE93uyLdM98DkUhM8U8zm3JC59chrbbWrk,AdqFuGe28VeAwwjRPZCBGVy5ftf9zNNQkg413i66wyig,True,165208650,41302162,257822,128911,128911,3zqXX6kzhkbW3d4TwD2CNjMRwxTbREXySekvq37kfCNk,10312892,37507843,-27194951,624
2022-04-11 09:31:25-04:00,15288,FoGtu9wcVbBmATBKtBMWvbRd558yzSDT5dPBTBJgzqFT,9rnvQvgQtkT7RSdDpZHnkTVd2V9CMRBSB7v79GDip4hS,True,869043424,217260856,1352267,676133,676134,YQC4EUcgeBi9431viwvzvBbZJW3szeHX4dFmowRDyDw,54090682,118994596,-64903914,622
2022-04-11 09:31:35-04:00,15289,GeYsENPRf2qGZu9rJsi6UPQqHS6sR7LRLWsKbFgtMCSb,7A79wktqPkSpP7o4c1kP9CBpUibHTqycW81ZANgREc5S,True,16526415,4131603,25444,12722,12722,68sueyVfmy5ToEGtLFGDkwebX47xAmzyXE29z8JrmcWv,1017761,5859711,-4841950,615
2022-04-11 09:31:38-04:00,15290,67DwuUmzk6uGwmptjYErQssFeJ5fd1ztFwKWZUovr7pK,HKzc15e1QLBrSsbAENyMXSVHDoap1F5MHCHB9L1Dm8HA,True,31950241,7987560,49538,24769,24769,68sueyVfmy5ToEGtLFGDkwebX47xAmzyXE29z8JrmcWv,1981528,12141894,-10160366,620
2022-04-11 09:31:41-04:00,15291,2E6u6NSx6ZJbM5Ez9As6a4zSQrGU9hfsndLdd7jok9HC,8HQCmFnRyzVzrvoYgvRbYa65q9A5FcxbqgHGsFKiZeVc,True,1106021914,276505478,1709103,854551,854552,A9TwRM1BMxqb8DCC7YNAMV6zPenEJm3HTZBy7wJKK58U,68364145,115828213,-47464068,618
2022-04-11 09:31:45-04:00,15292,7CSCMFa9W52tBDVUbXbc3woAy3GByeA1wPJdp3MgznPa,3447ptuVFu6G8B6N63RmS8mRv4n9PfHneypHLvbeaGLn,True,518624572,53094971,330599,165299,165300,3zqXX6kzhkbW3d4TwD2CNjMRwxTbREXySekvq37kfCNk,32292545,158123457,-125830912,622
2022-04-11 09:31:52-04:00,15293,JABfWoDV2wW68XEDANXArYWM7zabdbp5NBVrvzZd3mML,5hYUtd1Uv2pAcrbtSNNVTrRuk8acjmh92mzSm4iz5HJA,True,25515448,3415563,21321,10660,10661,YQC4EUcgeBi9431viwvzvBbZJW3szeHX4dFmowRDyDw,1592836,7118482,-5525646,624
2022-04-11 09:31:53-04:00,15294,8qq2gfbca7JXvq4gViBBVT2QAbM4MvBMEQLXgn8UUTvt,3o5jpBVYdFFEYrGRdCUkLrUC85wsuTKgy8iYwnpZyC1B,True,861768947,84880031,528877,264438,264439,YQC4EUcgeBi9431viwvzvBbZJW3szeHX4dFmowRDyDw,53695775,428040877,-374345102,623
2022-04-11 09:31:56-04:00,15295,G3ZEAY19iDMjF7P57dgFUZiC4bpeFvMPKShenugL7E2Y,D6nUGgpWkQUZcUKZYawfedX67uqQ9Co1wEwtbHPMtc7X,True,477847760,65768429,410976,205488,205488,3zqXX6kzhkbW3d4TwD2CNjMRwxTbREXySekvq37kfCNk,29859942,191017327,-161157385,624
2022-04-11 09:32:53-04:00,15296,3DEyi4Dnfxc7d91JbTpQjdAP1Ypgx5kaTSm4wwh8Zbm2,Cb2aqg5MyjopPzx5zd4zU81RUwJDeNTGV1jfiCLmgNTL,True,35644264,8911066,55593,27796,27797,68sueyVfmy5ToEGtLFGDkwebX47xAmzyXE29z8JrmcWv,2223759,6571729,-4347970,623
2022-04-11 09:33:00-04:00,15297,BTq6T9nDzYTPTRvxkhNLn82DF3RCWdRkatZUmSTGCu43,3Uuhmxo4tWMbrqowx2bQSJeWzMykUUcZanj29ptCmEa6,True,2145294109,302394963,1889656,944828,944828,3zqXX6kzhkbW3d4TwD2CNjMRwxTbREXySekvq37kfCNk,134058764,578263137,-444204373,624
2022-04-11 09:33:04-04:00,15298,68zbVKnneMQqngbNkeLtPEP2ayNhawc1B2hPgqAEqgXK,HqiFpLr4NC7xJz9bEFusq8bCKaoxAQG1xsLxdUAzg8aa,True,2917663579,221508937,1369869,684934,684935,YQC4EUcgeBi9431viwvzvBbZJW3szeHX4dFmowRDyDw,180435962,753785890,-573349928,618
2022-04-11 09:33:06-04:00,15299,C4k1drtNpR2axjxWk6DMreczYo3kdRc95u49HUAzpS42,2xRS27CLv9ynXa6F7w7SESPtK1ryBcf5BFeAB59N5cWF,True,49648149,12412037,77416,38708,38708,YQC4EUcgeBi9431viwvzvBbZJW3szeHX4dFmowRDyDw,3096647,13778113,-10681466,623
2022-04-11 09:33:07-04:00,15300,H9pFRayNBHTAhsbtGyfs1XXUWGxAbw7SgpT1xdrSRWEY,9LNreyXuhgyLCDYViNyA1jUw6h1nv4GmDtTYMoUQBqCG,True,16788165907,1468732152,9079255,4539627,4539628,gjBMZYVujDjD1ECG4i97M8Q3gV9ESnwwTSUGropkusj,1037793322,3730196596,-2692403274,618
2022-04-11 09:33:18-04:00,15301,8gxJEB4eSp5R8Z4Vy8TChcbLWPG93cVhpGLYWPuo4UMz,5dykor5kUojjBccSkbKqsHJ61voZWnD2MDuSNvsF6ohA,True,267653511,66913377,415509,207754,207755,YQC4EUcgeBi9431viwvzvBbZJW3szeHX4dFmowRDyDw,16620361,71066915,-54446554,620
2022-04-11 09:33:19-04:00,15302,FV9CBGGTbppLnBKh79f2LzD1diTiS5g6u89FcpZHZmnK,Fe7mtmCUziFqbbYTvrhAcAq1Ub7YLfTJRtQ1hG7GzJD1,True,31047697,3981638,24266,12133,12133,A9TwRM1BMxqb8DCC7YNAMV6zPenEJm3HTZBy7wJKK58U,1892267,9567586,-7675319,609
2022-04-11 09:33:23-04:00,15303,7tFD53kPTqrzjCu1Wji78gUqhoRtCUhsP1pM3DQKT7uG,BJvgPLYBDJrQJdQVowrsMwUGMurq4zTihoFwWoEokfu3,True,2351780241,587945060,3656423,1828211,1828212,A9TwRM1BMxqb8DCC7YNAMV6zPenEJm3HTZBy7wJKK58U,146256940,544669863,-398412923,621
2022-04-11 09:34:00-04:00,15304,AoXamAP5a8TQVU1iASScAtAE6Dh2U6VwXTS2q7ksNfVp,FqffL8e7uWNqnu6ueuYQyKpoFhNxPjoKsR2gBkEgJcAM,True,26491973,6622993,41366,20683,20683,A9TwRM1BMxqb8DCC7YNAMV6zPenEJm3HTZBy7wJKK58U,1654678,8547732,-6893054,624
2022-04-11 09:35:51-04:00,15305,A7bxZn4tYkEvYHu2SEqUbouNoSBSGMeqK4Kx4qySkNEZ,DNajWLThK1wtHsiGVcd9hNPyAch6BsX5Np1jxy9kHSJ8,True,19141588,4785397,29418,14709,14709,YQC4EUcgeBi9431viwvzvBbZJW3szeHX4dFmowRDyDw,1176747,4919818,-3743071,614
2022-04-11 10:46:42-04:00,15306,7yW1M1xeVx4hy3QftnpqdBDRYwamfu3K5i6AEnxgyTWb,7wf7FWS2DYp5RveQAmGNXAEUWPcHziuMLd4hV5LPgxF8,True,37892452,9473113,58633,29316,29317,68sueyVfmy5ToEGtLFGDkwebX47xAmzyXE29z8JrmcWv,2345347,8945180,-6599833,618
2022-04-11 10:46:51-04:00,15307,4U5pUaMfeesvncA9JNmMhs7gSV1B8cmPnXJXSRBVS3So,QaYTU1jx464rJqmQtqtb4z5uuT5KEFNQNQiJgo81RzA,True,61960725,15490181,96765,48382,48383,YQC4EUcgeBi9431viwvzvBbZJW3szeHX4dFmowRDyDw,3870602,11510797,-7640195,624
2022-04-11 10:46:52-04:00,15308,H8wYaRqc2wQuE3AdnSA2bCbukzxZEUCS5KbGYNsLAoho,F4ZEmseEyZfy3ZL6iyrczRZ9bww9HgVd8tYXExfbTcj1,True,17478070,4369517,27263,13631,13632,68sueyVfmy5ToEGtLFGDkwebX47xAmzyXE29z8JrmcWv,1090548,6159781,-5069233,623
2022-04-11 10:46:53-04:00,15309,3geiQ6Ph1iyCnfEfTmWpVnvdJnYoUb3HNeKXwshQMJuF,3uu2PC2DhTR3iXVEKbq5hC8FrzyTYbwF9Ztm3BD3hjEm,True,92107724,23026931,143592,71796,71796,YQC4EUcgeBi9431viwvzvBbZJW3szeHX4dFmowRDyDw,5743713,32276952,-26533239,623
2022-04-11 11:56:22-04:00,15310,7frvVhg1eWJpsvG7ndjppb8Bmd1tFq5H1g26UiKZxqTP,3Ugo9b53e6e8PLnvKjqRP8pvvoubSPV6qiKtxey7mrGt,True,930111093,232527773,1451110,725555,725555,3zqXX6kzhkbW3d4TwD2CNjMRwxTbREXySekvq37kfCNk,58044423,166912130,-108867707,624
2022-04-11 11:56:37-04:00,15311,GRqv7y5n92vQ7bXcBqUng4vaau6w1tQeou953s8kJNwD,Bk75oioYmUzfdpbxDHTFb2nWhJgNqAt8ud1ehem3VVhh,True,1309448495,327362123,2030086,1015043,1015043,3zqXX6kzhkbW3d4TwD2CNjMRwxTbREXySekvq37kfCNk,81203447,271613470,-190410023,620
2022-04-11 11:56:37-04:00,15312,B6Wc3euMqUf6QjzCqDtNeAEUM7MvADFaiReEq9VYH2Qg,2pzhsqXYd5u7h4xTN8bMS3GbicVnJ6KY3MQn7spSXroA,True,442841385,57097032,354094,177047,177047,YQC4EUcgeBi9431viwvzvBbZJW3szeHX4dFmowRDyDw,27463420,66826908,-39363488,620
2022-04-11 11:57:08-04:00,15313,BjCNaM7YbE9SjFi7tzi4677zg1fKXGJwtecz2GWwWuhd,6rNsSrKZezQrLb2whToNjnizpnurDXrobHqfEK3QqU1M,True,1835557194,159320023,995246,497623,497623,A9TwRM1BMxqb8DCC7YNAMV6zPenEJm3HTZBy7wJKK58U,114664344,495302014,-380637670,624
2022-04-11 11:57:08-04:00,15314,AQr9mVmcXCNQhBVCfx63MwR6c4WqDSC9K2BZqr7N8LCx,CB7TWUaL381ounsLw6neAUaKRxJL9P1HC9uGX5e1Uxod,True,1677505707,121742784,759829,379914,379915,A9TwRM1BMxqb8DCC7YNAMV6zPenEJm3HTZBy7wJKK58U,104697646,398823812,-294126166,624
2022-04-11 12:00:15-04:00,15315,BhhVhLVZkSd3aHDMd6ojTgtJtbgAdMCA9Xj8jL2GMXoL,G8HUQp2yGSw9T6it5ej91cqkd82naca8heji453g2jEH,True,1332020318,173724764,1084655,542327,542328,3zqXX6kzhkbW3d4TwD2CNjMRwxTbREXySekvq37kfCNk,83165114,317090809,-233925695,624
2022-04-11 12:00:29-04:00,15316,D5VZNThkv6XD6bimPshD2J3PvbPXgCbivZuPfkVxgdjc,8C77LmMk4C3KvyEb1N3scdbAgwN7J45nAcv9tkL5namB,True,44072110877,11018027719,68269847,34134923,34134924,3zqXX6kzhkbW3d4TwD2CNjMRwxTbREXySekvq37kfCNk,2730793919,6184031234,-3453237315,619
2022-04-11 12:01:10-04:00,15317,AXBfrbCpYAWKN5jgDVVMiKXscQ96YtotKV3DT6XSzm9o,Dh3SiHAqrQzPQnTLRMxtBn2EFyHNgyfnYGpgcuNGTvyL,True,2905884793,726471198,4527940,2263970,2263970,68sueyVfmy5ToEGtLFGDkwebX47xAmzyXE29z8JrmcWv,181117602,664615916,-483498314,623
2022-04-11 12:26:39-04:00,15318,4qqThJTwuoaWDtEh4agoqM9EwcJbznzGVJW8nbSsEVdS,Aub7UJXkAGC9gn1XybeW1yjYZ97c3kkWd7wbQpTFsYrG,True,693603046,92754930,579710,289855,289855,3zqXX6kzhkbW3d4TwD2CNjMRwxTbREXySekvq37kfCNk,43349663,125684438,-82334775,624
2022-04-11 12:27:48-04:00,15319,DxmkdZiygge1YAwbL8U6LudY3QJkSnZMHThQXkE4Z5qy,Gi8oNcSDphbtosjFudeEPtX88bUnYid1tL9FnXnLfASU,True,991397306,247849326,1547906,773953,773953,3zqXX6kzhkbW3d4TwD2CNjMRwxTbREXySekvq37kfCNk,61916276,142463389,-80547113,624
2022-04-11 12:27:59-04:00,15320,BSDeCyJsPs6y1pbDVHNq5rs6tdxcrbY3NDjXPBxwRjHz,DjHD3jawBVikzjcQ5dXBRLdUmEeBHKt6JZLhvmjScDku,True,1436265276,158204165,988209,494104,494105,3zqXX6kzhkbW3d4TwD2CNjMRwxTbREXySekvq37kfCNk,89715150,304634139,-214918989,624
2022-04-11 12:28:41-04:00,15321,7AizMrxWWr7qfneuXMy6ifL3BVDTAKkuud4PyZFy92kh,GyAWRRfQkVAXtyhVF14vU3kPMr4kG1VyA9FAHdDTr8ud,True,155508631,38877157,241550,120775,120775,DQCvC9mR68hJ3tJsUiddh6JwcBJAmntqGJR2nUsEq7yj,9662011,32672917,-23010906,621
2022-04-11 12:28:41-04:00,15322,AQr9mVmcXCNQhBVCfx63MwR6c4WqDSC9K2BZqr7N8LCx,CB7TWUaL381ounsLw6neAUaKRxJL9P1HC9uGX5e1Uxod,True,1548528840,113333136,707686,353843,353843,3zqXX6kzhkbW3d4TwD2CNjMRwxTbREXySekvq37kfCNk,96694811,382287675,-285592864,624
2022-04-11 12:28:44-04:00,15323,D8BtQirMEk3W9Pq29B6KkKWrwPfmsUNpwz5npx7aGMLY,J7LMZwaSoh5hbGcwee6oPsnN4ZFD7Zp3LQWkJGNUHRfJ,True,991391945,247847986,1536556,768278,768278,3zqXX6kzhkbW3d4TwD2CNjMRwxTbREXySekvq37kfCNk,61462274,245067926,-183605652,619
2022-04-11 12:29:41-04:00,15324,GgJXh5hTo4xyVuuGEis971RRXcZECLpjvtMSCZtVu13Q,9BGMfGfMZNXdcygAuqYQudWHhSE5LqVoWsNsruCawnRK,True,16289515,4072378,25449,12724,12725,YQC4EUcgeBi9431viwvzvBbZJW3szeHX4dFmowRDyDw,1017986,3089678,-2071692,624
2022-04-11 12:30:06-04:00,15325,H9pFRayNBHTAhsbtGyfs1XXUWGxAbw7SgpT1xdrSRWEY,9LNreyXuhgyLCDYViNyA1jUw6h1nv4GmDtTYMoUQBqCG,True,15242237955,1120838510,6989061,3494530,3494531,3zqXX6kzhkbW3d4TwD2CNjMRwxTbREXySekvq37kfCNk,950439725,3628347465,-2677907740,623
2022-04-11 12:30:07-04:00,15326,6K1Xww22wVZuBwP6oYb3DPR5GvdxsQSiZ4WSmejQjyqf,8RoFHjv1TkGFqjKoSwzvyRNMoBP1ma1Hi2jy6FzD4i2g,True,78310988,17621632,109273,54636,54637,68sueyVfmy5ToEGtLFGDkwebX47xAmzyXE29z8JrmcWv,4856193,14052465,-9196272,620
2022-04-11 12:30:21-04:00,15327,FCJeVA3JuuW1y2BHNKje3ZLgd74z7tasSztYTxjHnsVH,GEFUehF3zWqd3Uyf9UNMkRHV9o56XnsKRUjXKWiuZLTh,True,1875522382,468880595,2929333,1464666,1464667,68sueyVfmy5ToEGtLFGDkwebX47xAmzyXE29z8JrmcWv,117173341,293448049,-176274708,624
2022-04-11 12:32:39-04:00,15328,6fxUEgnR8SRihBVA4ZAxzXQTLPCeHsQatzUpB9XheY44,7Ds71dQsLTzuSy9LRG5P4wjmrofgQwJMJ5kXXvxpXiG2,True,2225101691,556275422,3460740,1730370,1730370,3zqXX6kzhkbW3d4TwD2CNjMRwxTbREXySekvq37kfCNk,138429638,414883465,-276453827,622
2022-04-11 12:32:43-04:00,15329,BjCNaM7YbE9SjFi7tzi4677zg1fKXGJwtecz2GWwWuhd,6rNsSrKZezQrLb2whToNjnizpnurDXrobHqfEK3QqU1M,True,1666616347,150530578,939591,469795,469796,YQC4EUcgeBi9431viwvzvBbZJW3szeHX4dFmowRDyDw,104027982,472230230,-368202248,624
2022-04-11 12:32:54-04:00,15330,JABfWoDV2wW68XEDANXArYWM7zabdbp5NBVrvzZd3mML,5hYUtd1Uv2pAcrbtSNNVTrRuk8acjmh92mzSm4iz5HJA,True,21897015,2929871,18299,9149,9150,68sueyVfmy5ToEGtLFGDkwebX47xAmzyXE29z8JrmcWv,1367693,6408251,-5040558,624
2022-04-11 13:16:54-04:00,15331,H1oYXGZTagwv48FdDe6RNkjNaesedqLKyXxTmPc5k4Fp,Am3rx6XrkrZ4MdeZDyZUv1YW2fBujcz4dLjVCnRQHKZa,False,12329105,12329105,765445,38272,727173,YQC4EUcgeBi9431viwvzvBbZJW3szeHX4dFmowRDyDw,765445,2146630,-1381185,620
2022-04-11 13:17:39-04:00,15332,6TvTxJWSPeyaTVm8PmarVDzxhbTqnkyoabQTgihXyGMj,62ngTMHaRDFjpvzasDgfmgyJ5T6jS9PmYgy97HCkyQS4,True,24786903,6196725,38725,19362,19363,YQC4EUcgeBi9431viwvzvBbZJW3szeHX4dFmowRDyDw,1549026,3571631,-2022605,624
2022-04-11 13:57:23-04:00,15333,EC8fafqtuQzqbm2TZs3GeuXB9qXomkykrTG1na2rfFpx,A72f7W58h3r8nut45RmqdTk1J31NGYT2sVWMn18dK885,True,29449922,7362480,45738,22869,22869,68sueyVfmy5ToEGtLFGDkwebX47xAmzyXE29z8JrmcWv,1829530,6176280,-4346750,621
2022-04-11 13:58:56-04:00,15334,niCk6QHFU1kyU56Mdq5RJzKrecdkNSn23ZA6wduFdWS,BQbUYSw1XsuE6LnVd4XjmxAyYgx4drE4FsetJBCdwVZW,True,130721253,32666644,201583,100791,100792,68sueyVfmy5ToEGtLFGDkwebX47xAmzyXE29z8JrmcWv,8066733,14148576,-6081843,617
2022-04-11 14:20:00-04:00,15335,niCk6QHFU1kyU56Mdq5RJzKrecdkNSn23ZA6wduFdWS,BQbUYSw1XsuE6LnVd4XjmxAyYgx4drE4FsetJBCdwVZW,True,96194700,24035081,150059,75029,75030,A9TwRM1BMxqb8DCC7YNAMV6zPenEJm3HTZBy7wJKK58U,6005771,12428384,-6422613,624
2022-04-11 14:20:25-04:00,15336,Br1j5Ftafei7ysu5SmqVZSoRe4uS4qCPeKSPHg55pyiE,G8fc7QvXjfkgBFvAVUgJFQS3VaF1biL9rktBExGa87Ks,True,628963476,157240869,978329,489164,489165,68sueyVfmy5ToEGtLFGDkwebX47xAmzyXE29z8JrmcWv,39133174,82716764,-43583590,622
2022-04-11 15:23:02-04:00,15337,2ssYxbmFPYBdse9a6NJ26M8hsscYpjv5MyqyYkjftdrL,FKvvXz9eYXW2zgy37eaUW9u2K9LnnDsNx3DcgtATpizY,True,58853654,14713413,90114,45057,45057,A9TwRM1BMxqb8DCC7YNAMV6zPenEJm3HTZBy7wJKK58U,3604588,13579687,-9975099,612
2022-04-11 15:25:36-04:00,15338,7CSCMFa9W52tBDVUbXbc3woAy3GByeA1wPJdp3MgznPa,3447ptuVFu6G8B6N63RmS8mRv4n9PfHneypHLvbeaGLn,True,462520628,52527829,328137,164068,164069,YQC4EUcgeBi9431viwvzvBbZJW3szeHX4dFmowRDyDw,28893380,143105754,-114212374,624
2022-04-11 15:26:19-04:00,15339,7sgoB9mHcUoNFFdQSsBvyC4tXYzYR86ct11WQsS1FvAp,5k2QtQPgMUvj88Tmizf1pABHtC3VHJDc6BYNkB9gp19M,True,344875462,86218865,538817,269408,269409,A9TwRM1BMxqb8DCC7YNAMV6zPenEJm3HTZBy7wJKK58U,21552694,68282120,-46729426,624
2022-04-11 15:27:32-04:00,15340,niCk6QHFU1kyU56Mdq5RJzKrecdkNSn23ZA6wduFdWS,BQbUYSw1XsuE6LnVd4XjmxAyYgx4drE4FsetJBCdwVZW,True,70679446,17656316,109314,54657,54657,A9TwRM1BMxqb8DCC7YNAMV6zPenEJm3HTZBy7wJKK58U,4375931,10674214,-6298283,619
2022-04-11 15:28:03-04:00,15341,EN2YBXcj7E1eAaYJYXJjc6Rfsu6Awjgv9kN3bT3uiprp,HYDG5mqfCy2xwrYKixNzoWyDiqb9KbpnA8H3TQG2EDDG,True,97086675,24271585,151412,75706,75706,YQC4EUcgeBi9431viwvzvBbZJW3szeHX4dFmowRDyDw,6056538,29627010,-23570472,623
2022-04-11 15:28:32-04:00,15342,3DEyi4Dnfxc7d91JbTpQjdAP1Ypgx5kaTSm4wwh8Zbm2,Cb2aqg5MyjopPzx5zd4zU81RUwJDeNTGV1jfiCLmgNTL,True,26187687,6546921,40360,20180,20180,YQC4EUcgeBi9431viwvzvBbZJW3szeHX4dFmowRDyDw,1614434,5420940,-3806506,616
2022-04-11 15:28:33-04:00,15343,B6Wc3euMqUf6QjzCqDtNeAEUM7MvADFaiReEq9VYH2Qg,2pzhsqXYd5u7h4xTN8bMS3GbicVnJ6KY3MQn7spSXroA,True,382446479,52868269,328571,164285,164286,3zqXX6kzhkbW3d4TwD2CNjMRwxTbREXySekvq37kfCNk,23768750,63113266,-39344516,621
2022-04-11 15:28:47-04:00,15344,5F7WHSYiVtCY8Z9KX9h6AT8qr4hbsSYasG15fq82ZWhr,E5wj8cqKM1ofNv14TspTa8yRwern8y2w6pXekL4cAWX7,False,15246658,15246658,952674,47633,905041,68sueyVfmy5ToEGtLFGDkwebX47xAmzyXE29z8JrmcWv,952674,3500419,-2547745,624
2022-04-11 15:29:36-04:00,15345,68zbVKnneMQqngbNkeLtPEP2ayNhawc1B2hPgqAEqgXK,HqiFpLr4NC7xJz9bEFusq8bCKaoxAQG1xsLxdUAzg8aa,True,2679170747,199210357,1205221,602610,602611,3zqXX6kzhkbW3d4TwD2CNjMRwxTbREXySekvq37kfCNk,162089730,722181738,-560092008,604
2022-04-11 15:29:36-04:00,15346,H9pFRayNBHTAhsbtGyfs1XXUWGxAbw7SgpT1xdrSRWEY,9LNreyXuhgyLCDYViNyA1jUw6h1nv4GmDtTYMoUQBqCG,True,14032893191,1079409761,6572851,3286425,3286426,3zqXX6kzhkbW3d4TwD2CNjMRwxTbREXySekvq37kfCNk,854505188,3431385825,-2576880637,608
2022-04-11 15:30:22-04:00,15347,HooxSzasW3HMoFJ6sAvRQ75Char1J5aBdJtsqfDV6myp,BCmsWwpGeV4NNfeKZKKydty2uueLGHYTJDk1WErpXsVT,True,215397445,53849361,336435,168217,168218,A9TwRM1BMxqb8DCC7YNAMV6zPenEJm3HTZBy7wJKK58U,13457416,53193740,-39736324,624
2022-04-11 15:31:13-04:00,15348,EFHg5FatMRRSZnKJPJF9e1iw2cjPJRmwTTZYtkHno9DP,84LnLKhZDJgWFnbBYnYjqWkjymemXfidecPFwnUAvuFj,True,1930003534,482500883,2977828,1488914,1488914,68sueyVfmy5ToEGtLFGDkwebX47xAmzyXE29z8JrmcWv,119113129,435327004,-316213875,617
2022-04-11 15:31:19-04:00,15349,5YC2wXkdk7D4Ubs9TEAbP1hi88Sy35bzYVWjLbgVxn5s,4Mx69ezqFK2wudZ62oVhx2pwjVbKv8JB1HR29ZUcdEJb,True,460020394,115005098,712579,356289,356290,YQC4EUcgeBi9431viwvzvBbZJW3szeHX4dFmowRDyDw,28503172,119193852,-90690680,619
2022-04-11 15:31:24-04:00,15350,D3mQ4aGmHdD8QHuDzGx1ZGRMaM4eB32LzVp1dnt931wx,86icTdjxoqizRxHTrGPUjFkR7gaapLFMuYVLogWJZ12J,False,14159957,14159957,877399,43869,833530,A9TwRM1BMxqb8DCC7YNAMV6zPenEJm3HTZBy7wJKK58U,877399,2316203,-1438804,619
2022-04-11 15:31:32-04:00,15351,2i5g7q4gD1GEfSz8BkhKn1idQ5U7cFPbMDWugjr7bBQW,Dpx6K9G5uZD63rTzBafZ56WKd1X9M25Mzfppd7Jib4xn,True,417718106,104429526,652425,326212,326213,68sueyVfmy5ToEGtLFGDkwebX47xAmzyXE29z8JrmcWv,26097036,173804715,-147707679,624
2022-04-11 15:31:38-04:00,15352,5o4EAqBTiUKn41QhPL5kRjrGTgQVdP7xLtxC7xNxjkwn,E8gDreu3LxW1EHJ8hnqChK9QdffGh5GocJYKdrbYat8E,True,2165709619,541427404,3383244,1691622,1691622,A9TwRM1BMxqb8DCC7YNAMV6zPenEJm3HTZBy7wJKK58U,135329783,409998822,-274669039,624
2022-04-11 15:31:38-04:00,15353,5BjBPqumCb9KC82ZNNch3dcRzbpGdRLJneru7o9a1D9R,FuZtBWKktxFu4yoiLVMzxq8fMhQyN8SGzGPz49xs3m6P,True,544967090,71587886,447193,223596,223597,3zqXX6kzhkbW3d4TwD2CNjMRwxTbREXySekvq37kfCNk,34042853,142048266,-108005413,624
2022-04-11 15:31:58-04:00,15354,7BEY9qatFJomsayFmky3h3dAbKhY5XkRGwMobJuxXYhQ,J8MK3tAQKreBUG2reXY6gqr1uhbHhcAZEcxsLQmG5Ntt,True,3998265694,999566423,7130112,3565056,3565056,YQC4EUcgeBi9431viwvzvBbZJW3szeHX4dFmowRDyDw,285204497,754120281,-468915784,713
2022-04-11 15:32:09-04:00,15355,BTq6T9nDzYTPTRvxkhNLn82DF3RCWdRkatZUmSTGCu43,3Uuhmxo4tWMbrqowx2bQSJeWzMykUUcZanj29ptCmEa6,True,1823523192,230832890,1427314,713657,713657,3zqXX6kzhkbW3d4TwD2CNjMRwxTbREXySekvq37kfCNk,112754342,488878803,-376124461,618
2022-04-11 15:32:27-04:00,15356,4GbUrgiR6A91h3J9HHpuYCkZzjwrb62n3BURLeWj6Nic,12nUFUGYF1rXbwPeCbdGKdP3RE4g984fmZZggEYSFTZn,True,17797805,4449451,27808,13904,13904,A9TwRM1BMxqb8DCC7YNAMV6zPenEJm3HTZBy7wJKK58U,1112338,7277253,-6164915,624
2022-04-11 15:32:34-04:00,15357,7CSCMFa9W52tBDVUbXbc3woAy3GByeA1wPJdp3MgznPa,3447ptuVFu6G8B6N63RmS8mRv4n9PfHneypHLvbeaGLn,True,406848740,39327653,245731,122865,122866,YQC4EUcgeBi9431viwvzvBbZJW3szeHX4dFmowRDyDw,25421184,131709451,-106288267,624
2022-04-11 15:32:44-04:00,15358,3uUdWwgwtFdPa3FJTSrirqPKMtQb3zmT5Wpp4zPy9sJP,5G7dhz8jvWekGy9Wh3ZCXNXSPbB1QArfFYs7MYNgRDkW,True,37549384,9387346,58415,29207,29208,YQC4EUcgeBi9431viwvzvBbZJW3szeHX4dFmowRDyDw,2336601,16511162,-14174561,622
2022-04-11 15:32:44-04:00,15359,J8khFNhJg25xVY7yjEtETTQVVzKHqdVCs1Rh2pJKvJqU,4eUP2YxTapjr6TLrd57XxZan7KJG5AtHK8yPRNVEbavx,True,103334969,25833742,160943,80471,80472,YQC4EUcgeBi9431viwvzvBbZJW3szeHX4dFmowRDyDw,6437725,22394220,-15956495,622
2022-04-11 15:32:54-04:00,15360,FV9CBGGTbppLnBKh79f2LzD1diTiS5g6u89FcpZHZmnK,Fe7mtmCUziFqbbYTvrhAcAq1Ub7YLfTJRtQ1hG7GzJD1,True,26872361,3755085,23388,11694,11694,68sueyVfmy5ToEGtLFGDkwebX47xAmzyXE29z8JrmcWv,1673722,8647843,-6974121,622
