ts,record_id,user_authority,user,partial,base_asset_value,base_asset_value_closed,liquidation_fee,fee_to_liquidator,fee_to_insurance_fund,liquidator,total_collateral,collateral,unrealized_pnl,margin_ratio
2022-01-20 20:48:36-05:00,4097,D9VKhnfLLCrntDGFYSfoxFaY76VnHmYZ1ZbyFXdKdibz,2hRCRH2pMDyQGYcXHa8Y6BZo6FbcGZf5VJC1v8Bp6tGa,True,88779150,22194787,138766,69383,69383,3zqXX6kzhkbW3d4TwD2CNjMRwxTbREXySekvq37kfCNk,5550664,34578467,-29027803,625
2022-01-20 20:48:36-05:00,4098,2bikYf33ZxxDmvkMNjWDGGqEpbYJPvWv5At3hzyeLEQK,5FtirUBjRAZ3k5arFFVwKz42ixWzhkEBLkaK9PraRZ78,True,54386,13596,84,42,42,3zqXX6kzhkbW3d4TwD2CNjMRwxTbREXySekvq37kfCNk,3394,23348,-19954,624
2022-01-20 20:48:36-05:00,4099,7g4NJBHwDTRm58GqX7Tz1JzqwbAhF6EWJUQH3SoDxSf7,82Ypv7STZeSCBPf3HckWdyatELpvaDaWxFXhD5dNSML4,True,8639,2159,13,6,7,3zqXX6kzhkbW3d4TwD2CNjMRwxTbREXySekvq37kfCNk,539,4323,-3784,623
2022-01-20 20:48:38-05:00,4100,399591e8XgY52yCMorCQ2WL6dQZTC485ZooHtmGuirhZ,JCiXAooFmKmEPQ2S7C8iSk6CLcTyrPEe1SsPSLyUGySe,True,1033252,258313,1605,802,803,3zqXX6kzhkbW3d4TwD2CNjMRwxTbREXySekvq37kfCNk,64210,607587,-543377,621
2022-01-20 20:48:38-05:00,4101,DJiXXW7sjNsAAxWupDKBUsFhXSgPoerVYaAtJqqNgVbn,2MsqvNuJw1xQhJ3UnXt9i7oNHDuZpR9w7iE1WQcGqt5m,True,54386,13596,84,42,42,3zqXX6kzhkbW3d4TwD2CNjMRwxTbREXySekvq37kfCNk,3390,23342,-19952,623
2022-01-20 20:48:38-05:00,4102,CCHzYXr5zMXFu8MMZNkfUWGyUcF8xy7Vvhq7tNCtZg2L,AuEXkCJTTJ3HK8iP4qTWpQr4vp6HPRJZyZwfRjF8zjfp,True,54386,13596,84,42,42,3zqXX6kzhkbW3d4TwD2CNjMRwxTbREXySekvq37kfCNk,3394,23347,-19953,624
2022-01-20 20:48:38-05:00,4103,DvuRmJkfn6FQczUKgYeaSCqwy2NTMunuAKNrnmxMvnzS,7LpWTX9dgBtW75kfEoB5WuNsDwEdw5s8CYSHh3J4qagM,True,60989068,15247267,94870,47435,47435,3zqXX6kzhkbW3d4TwD2CNjMRwxTbREXySekvq37kfCNk,3794839,32356871,-28562032,622
2022-01-20 20:48:43-05:00,4104,921FBgLS3A1wA77uWitsnTvW737Q2jY7tzvgWtWLXNC7,E4eJ9H7cqP9zNpMH5xRBTAp9yaBCBihuJBNd6pqzteDG,True,54380,13595,84,42,42,3zqXX6kzhkbW3d4TwD2CNjMRwxTbREXySekvq37kfCNk,3390,23348,-19958,623
2022-01-20 20:48:44-05:00,4105,6gFbxvPafnpqZjWW94MMmL8mGp2FHZGqoJC5fWqgwNxS,C6WcDycp3Ff3xYmb81i8JbD39Xv1o5G2AdtPs1FdXtr4,True,854383942,213595985,1330390,665195,665195,3zqXX6kzhkbW3d4TwD2CNjMRwxTbREXySekvq37kfCNk,53215635,211237196,-158021561,622
2022-01-20 20:48:44-05:00,4106,duKo8riX1qpX1K1qpgwZniMtUeWqu2eYgchTu5n7Rbu,9vAVwfVtdsaZMbeZvoymjHqwASeuM38gfEJkbTVwDqya,True,24865118,6216279,38837,19418,19419,3zqXX6kzhkbW3d4TwD2CNjMRwxTbREXySekvq37kfCNk,1553483,12122334,-10568851,624
2022-01-20 20:48:44-05:00,4107,2p2fGXdKrmxjomLSnyaNg84J82cBBBNympZ6qQc8UZgU,HKAM8bazuLMUY6yapZJqYsgaWkTBqKHyMs1hSfpYsZGi,True,301280422,75320105,468479,234239,234240,3zqXX6kzhkbW3d4TwD2CNjMRwxTbREXySekvq37kfCNk,18739189,183325822,-164586633,621
2022-01-20 20:48:49-05:00,4108,8kJu5aqVSmW8FSZR9h6F75ftn9V2U9uMLBEKeqRaC855,FhVHByujkvwwtjTVpZ4mqSUqoMoBgeLUc5H7rbz3FgAt,True,85285949,21321487,133148,66574,66574,3zqXX6kzhkbW3d4TwD2CNjMRwxTbREXySekvq37kfCNk,5325934,50206598,-44880664,624
2022-01-20 20:48:51-05:00,4109,7W6ih2ZGXaE6tvuQFUPCvc7NvEJHy7UffgoVX3ZPdLXt,6uQCkeMjEXHBQxE2HD33RM1zyTsSko1fYZA1mWUggJ5B,True,9545,2386,14,7,7,3zqXX6kzhkbW3d4TwD2CNjMRwxTbREXySekvq37kfCNk,597,4899,-4302,625
2022-01-20 20:49:02-05:00,4110,2jDRvE3pQNjWy1NRFa4tzB3KmU5UkbUCHw8sQRFujo66,C4zNi2szDrEEh4coTF3WRUghfP4ZwAVVSYTLWfkejQRu,True,340473972,85118493,532092,266046,266046,3zqXX6kzhkbW3d4TwD2CNjMRwxTbREXySekvq37kfCNk,21283698,136264806,-114981108,625
2022-01-20 20:49:05-05:00,4111,FLQcLhAsRBKnLcSYkK94Za6NhGudrCGhGGxFTdDhVC6L,7vr92sRGp6DopaDv3wJr7gw4BFmxY74K8kFheKyxZdLX,True,193042,48260,301,150,151,3zqXX6kzhkbW3d4TwD2CNjMRwxTbREXySekvq37kfCNk,12061,70485,-58424,624
2022-01-20 20:49:10-05:00,4112,FnAT8HKGgisYfeAbxKU2gSbCp8KbZHULRpaJX1NVijHy,2u637Crc2QzfSJmCnRNqeib3aZQVn4NGncpgM3Ph6jvm,True,33046725,8261681,50952,25476,25476,3zqXX6kzhkbW3d4TwD2CNjMRwxTbREXySekvq37kfCNk,2038104,11388910,-9350806,616
2022-01-20 20:49:17-05:00,4113,FsMiJiJZibohKoV5QRisWCjzuFd86xSxFb4m73AQmu93,7p3TSKBaG9SV2YNDnhutQKacPKpTTmgsEfzmK51t6sYb,True,201188736,50297184,313612,156806,156806,3zqXX6kzhkbW3d4TwD2CNjMRwxTbREXySekvq37kfCNk,12544488,69450156,-56905668,623
2022-01-20 20:49:17-05:00,4114,4kbcrzH6o2LvLUCNphyL52i8uGzVD8wcUNEqoQ14z3VG,5Q1atmEBs2AqaDZsiZFG5stHzj1fE6ZvypgfkEc9LYqE,True,66156561,16539140,103240,51620,51620,3zqXX6kzhkbW3d4TwD2CNjMRwxTbREXySekvq37kfCNk,4129634,42918316,-38788682,624
2022-01-20 20:49:17-05:00,4115,AUH6YGBV8tDVX1E1WTo92Mubfx1DGsqfGeyUBqxo4fSr,33QZgMwmW32WuvmxD8XNbmF9ea88bLe3YTtNwHV73Wwu,True,201306419,50326604,313323,156661,156662,3zqXX6kzhkbW3d4TwD2CNjMRwxTbREXySekvq37kfCNk,12532936,71095758,-58562822,622
2022-01-20 20:49:21-05:00,4116,9KD2AifD5wFD4QkHYuawXbJgLWHrfj2QPF3fT8jhGVA5,Ga9gAqmkuHbqrr31sUFPqa1xa5WNxLWJWGPUaMxQqLdj,True,937735,234433,1444,722,722,3zqXX6kzhkbW3d4TwD2CNjMRwxTbREXySekvq37kfCNk,57774,561099,-503325,616
2022-01-20 20:49:22-05:00,4117,H3394S5wdbwXB4scjGAY8NsXxCdGy1Xebct18s42FM1K,Hz84L1EquzhCvBJP75ScKug46hYGdNMVNH16AdG4y5D8,True,45246242,11311560,70214,35107,35107,3zqXX6kzhkbW3d4TwD2CNjMRwxTbREXySekvq37kfCNk,2808588,18374763,-15566175,620
2022-01-20 20:49:28-05:00,4118,3VdSA9CED9f5swRwHX2U15U7J6Muaq8VPnCNy9CaGDHe,2YYstfnfdYic5NWmEbcUEHpccNUVd1EhuCkExvMsoMk8,True,4824117,1206029,7405,3702,3703,3zqXX6kzhkbW3d4TwD2CNjMRwxTbREXySekvq37kfCNk,296236,2858510,-2562274,614
2022-01-20 20:49:32-05:00,4119,HkRKcvAWLM5sCDL6a5DvYsH55bg5BnZnyP9WwX7wLUDF,GXtDJS8BCoZKnvviGaUb2QfKs2LQQZPMa9564tf5Jq8Y,True,566226892,141556723,885263,442631,442632,3uL2NSR2ZdDqCiKfzA5SwwpddAnit22DBJo6uvvz1rRs,35410557,166966022,-131555465,625
2022-01-20 20:49:33-05:00,4120,A36aouot1oFLUtswuBUM4EVcis9chKaSJu53MRoPDjab,33U9gpq1RRFMGWDrWa3ezXXkwgBewdAS6QGgGVPtGvqb,True,259111159,64777789,397957,198978,198979,3zqXX6kzhkbW3d4TwD2CNjMRwxTbREXySekvq37kfCNk,15918297,89087502,-73169205,614
2022-01-20 20:49:45-05:00,4121,5kwvkEtRFFD84j4ntVgxkacadgJaFvQ9JLhJqzLR7Y3G,GpMMkTv9T7y8DTiizuoJUsWvnSk3GSxADjRMGyYpryxm,True,22613056,5653264,35111,17555,17556,3zqXX6kzhkbW3d4TwD2CNjMRwxTbREXySekvq37kfCNk,1404460,7469158,-6064698,621
2022-01-20 20:49:50-05:00,4122,GWkVXmZNQdcdWNNu8dvRqct4aMhLoDNqijrTvxbfEdKN,6LKRNbJv2XkyjJQKCFAqFRPzvANrRBSTmu8doRWqTicU,True,40229802,10057450,62704,31352,31352,3zqXX6kzhkbW3d4TwD2CNjMRwxTbREXySekvq37kfCNk,2508177,10816558,-8308381,623
2022-01-20 20:50:02-05:00,4123,GH6Q9E1jZPTTp46aDd57UNZPNS2D6PBSwyLL3EHSjGn2,2XvwZXNsrPWx4EfPvhTP933bzCC3SJHDQ8xARfrXdVY9,True,7319770,1829942,11436,5718,5718,3zqXX6kzhkbW3d4TwD2CNjMRwxTbREXySekvq37kfCNk,457465,7043741,-6586276,624
2022-01-20 20:50:08-05:00,4124,4D7mDXe7SdmbAx7kaD1mBNuEa7DzMi6TAwXURxtLEazk,5pSnT91PHoLdN6uhPnUtoD7cboLmndn26y1XouPx8vwW,True,549795,137448,859,429,430,3zqXX6kzhkbW3d4TwD2CNjMRwxTbREXySekvq37kfCNk,34360,235265,-200905,624
2022-01-20 20:50:11-05:00,4125,5Rxuqgs4CaSKbfDXqBMFXkLTQ9dxrUjThXzoy3ouYVtK,BgvbKru66ebrGUcFFymGTmsaQv6GgcGMybiWaXqzBtwX,True,148869,37217,231,115,116,3zqXX6kzhkbW3d4TwD2CNjMRwxTbREXySekvq37kfCNk,9271,93026,-83755,622
2022-01-20 20:50:22-05:00,4126,AvwHizRhHUSahmvSg4jmTUErc7vAFSmkRAEsiKhXfW1m,3UrWYx8y9N5o9GYneSe6zyyHRTZzxwvcipQfHHYh7tEs,True,1847032,461758,2859,1429,1430,3zqXX6kzhkbW3d4TwD2CNjMRwxTbREXySekvq37kfCNk,114377,769166,-654789,619
2022-01-20 20:50:27-05:00,4127,DC4UVUDFWL3gVtgkX9hPtFgtxaA8DH5p94i4k9U3wyWv,3HCWqVvQQfRgSKitsTjGTduJ82ointZUSNtj13uea4kD,True,1254740959,313685239,1919616,959808,959808,3zqXX6kzhkbW3d4TwD2CNjMRwxTbREXySekvq37kfCNk,76784678,504910684,-428126006,611
2022-01-20 20:50:27-05:00,4128,EeztHR1M4PPacJEZ6c5arCRVCuu8aN7eGdpY1u4bev79,9Twdc9Xrzv2oeJ9Fbd8mRvzjbFi7mkGopFS37SMabeAK,True,65777783,16444445,102004,51002,51002,3zqXX6kzhkbW3d4TwD2CNjMRwxTbREXySekvq37kfCNk,4080173,26308853,-22228680,620
2022-01-20 20:50:28-05:00,4129,AA9zFZTXqBR8Mw1fwEH59edzBiswoGasRNWsi6aLeysB,4VeitxYqqtRxyfdSVpshdJ3EDcgksRVnaHvAqWxTeujH,True,629914,157478,978,489,489,3zqXX6kzhkbW3d4TwD2CNjMRwxTbREXySekvq37kfCNk,39125,223467,-184342,621
2022-01-20 20:50:33-05:00,4130,5jin5wXjQQ25nGM2ECrCXcg1a95vquh6kM7rMRru6Ke7,EKM657EQ8HWWgf4cssByoYHoXGjFfTspTKXAGmygAPQG,True,13928510,3482127,21724,10862,10862,3zqXX6kzhkbW3d4TwD2CNjMRwxTbREXySekvq37kfCNk,868990,8120316,-7251326,623
2022-01-20 20:50:34-05:00,4131,FpqCxvTkSiwDwD5qEt6hXJxzFDLFLAQ8VevK8zwRqYun,A3p6YQisCJKpNkF7vkjZRbEfbnUt7vTZdR2zPBUSdTkk,True,152022457,38005614,236715,118357,118358,3uL2NSR2ZdDqCiKfzA5SwwpddAnit22DBJo6uvvz1rRs,9468616,68650382,-59181766,622
2022-01-20 20:50:34-05:00,4132,H6fVnghBUSJRKp2mxSG7Fq2Lr4dE3YMS7yM1XTrxoe3Z,JjgtLi79grUZXofhWukB1yNXZkXFMUX5jm9HcXNDsB6,True,11232661,2808165,17561,8780,8781,3zqXX6kzhkbW3d4TwD2CNjMRwxTbREXySekvq37kfCNk,702447,4468271,-3765824,625
2022-01-20 20:50:34-05:00,4133,DAku12iueL13vRoTpKLyqdGaLQ2rWF6REe8Dr8soFvNs,H2vVH3LxkhGe6x6Mdwy67BYwTKNQM6XayKx7mhrwyfJM,True,165171,41292,257,128,129,DddJ7EWCmYEEZETCBNgAUSg81Ls6fZtiAaY5ekJ5sXx1,10302,98546,-88244,623
2022-01-20 20:50:34-05:00,4134,5nauZoaxftcYR591YH4v52myeJLnXtY4okdttL9qSdkg,7x3G299D3bC7EwUQojhTXUv29BG4NGzrLbgS4mEyqG5r,True,171305294,42826323,267486,133743,133743,3zqXX6kzhkbW3d4TwD2CNjMRwxTbREXySekvq37kfCNk,10699475,50308211,-39608736,624
2022-01-20 20:50:38-05:00,4135,AGhvB6x3gmvAJSnr9UVtvhKqVg3Qgh1k4roHzrNHhAaa,HhhjXT6WJnz1HQfHcwKdBppuAhc8ncUcq1mkJ4EHqgpe,True,2340,585,3,1,2,3zqXX6kzhkbW3d4TwD2CNjMRwxTbREXySekvq37kfCNk,146,1214,-1068,623
2022-01-20 20:50:38-05:00,4136,D2L7ST8iGsRfZ4zj2pdfKTptbojQ4cDtHKQ8ngcFVQwA,7cNrHGWJ6FGGazfGaCePs8XyaK6bwVLrYFCUJQi9w2Wc,True,25051,6262,39,19,20,3zqXX6kzhkbW3d4TwD2CNjMRwxTbREXySekvq37kfCNk,1567,12501,-10934,625
2022-01-20 20:50:59-05:00,4137,3njiRuSRMXRzKmamyiR72Hc38PU8UDDmWdfPhgxmGxEW,5WoF3gkgygyNNbwxWgVfqGWkExcDixuzgJQQjXEZQ6J5,True,94439583,23609895,146998,73499,73499,3uL2NSR2ZdDqCiKfzA5SwwpddAnit22DBJo6uvvz1rRs,5879943,74936000,-69056057,622
2022-01-20 20:51:02-05:00,4138,ES1MDwRUa3hoToPKQiiZkzMYe9PDVnAQwMrEvZrzvnc1,C4wBG3xTDkmDQneB28xYnf1aBNEeq7UB8oR7NuEfLkFg,True,10192533,2548133,15863,7931,7932,3uL2NSR2ZdDqCiKfzA5SwwpddAnit22DBJo6uvvz1rRs,634532,4362772,-3728240,622
2022-01-20 20:51:02-05:00,4139,8NdcaYUC1X5CP7FMDip78uqtqmCt8GcZdCzLRTYTihmb,9Ei1K9bXWXSXcBfeX5exPSXGCAu62WSKzvnnd4wHvyVh,True,48647,12161,76,38,38,3uL2NSR2ZdDqCiKfzA5SwwpddAnit22DBJo6uvvz1rRs,3041,25656,-22615,625
2022-01-20 20:51:02-05:00,4140,7uHMFnppZKtV7nAySv8UGcoGTSQ98RVz1GP47dsFWpYr,FmS9WPYVTT8i4agyidApdLnoHAUMfdRFPnAVJQUwfWr5,True,635388955,158847238,989144,494572,494572,3uL2NSR2ZdDqCiKfzA5SwwpddAnit22DBJo6uvvz1rRs,39565766,141636811,-102071045,622
2022-01-20 20:51:04-05:00,4141,C2Dmfw4G8KKzFq38aRH2pLCRngnGZDvUUN3fHDMjFkoG,7kzJk3BTNvY3hGFNj7nDy9L5CAYus6eNiCAxWH8dSioX,True,137399,34349,214,107,107,3uL2NSR2ZdDqCiKfzA5SwwpddAnit22DBJo6uvvz1rRs,8584,96879,-88295,624
2022-01-20 20:51:04-05:00,4142,Gs3WP18hbzNpbBgiU39e6tfkggfCKRyNqPqJQcthuHFD,4XAY25YUma6gUdG2GdbXeivum3t21g93ZagfWGTZYkWZ,True,6909941,1727484,10799,5399,5400,3uL2NSR2ZdDqCiKfzA5SwwpddAnit22DBJo6uvvz1rRs,431985,3651088,-3219103,625
2022-01-20 20:51:06-05:00,4143,5RvNKzSeJ1fvqsKpcQu25evEZGmKjyEDgwsMZkykoT3P,BRqSGfE4XHXu4HrinwetWumfVTmr82iuF6Y5oSV6eMiK,True,54303,13575,84,42,42,3uL2NSR2ZdDqCiKfzA5SwwpddAnit22DBJo6uvvz1rRs,3385,23420,-20035,623
2022-01-20 20:51:12-05:00,4144,BAczoNDnbwj5AJX5LwzynzYab7ji7VbhRy9edA9Prax,34sbkUKnMetUNyMs6BhiWut85d5UZtBWnPtwx8jEpJNA,True,481141,120285,751,375,376,3uL2NSR2ZdDqCiKfzA5SwwpddAnit22DBJo6uvvz1rRs,30054,260759,-230705,624
2022-01-20 20:51:13-05:00,4145,3ogBPSRcKfmwzgumVDHBkXLi1eCsEFG2xzSJgD4LQDNy,7TXyqWgJqfe71MSWFA2n7ufZbUdzf7JJoWej8FNNtMXo,True,15068711,3767177,23094,11547,11547,3zqXX6kzhkbW3d4TwD2CNjMRwxTbREXySekvq37kfCNk,923778,6097434,-5173656,613
2022-01-20 20:51:13-05:00,4146,LNX7AwwiGpuaXA4J86d1xqqtF6kD7qbCusssSZqtpKd,45a5FGVssw2NoGipB7NRN4XDLPob4GHNxSM9fqgsTpqA,True,320043143,80010785,499929,249964,249965,3zqXX6kzhkbW3d4TwD2CNjMRwxTbREXySekvq37kfCNk,19997195,86209478,-66212283,624
2022-01-20 20:51:13-05:00,4147,6dr65yANjSMmfBeKAuSxG3i16S9vMgF1CQ3zDyzh55Pn,EhrE5QpnshD41S4zPEBy2A5q2Gs2mwUrbHGo6WnT9zDP,True,123818,30954,193,96,97,3uL2NSR2ZdDqCiKfzA5SwwpddAnit22DBJo6uvvz1rRs,7721,73966,-66245,623
2022-01-20 20:51:13-05:00,4148,GGGyesjbt7h2XHHp9u8vpiWGugFwEbrtYaKrNQSDhQd7,8tydo1ZjGHmPBSqU33tywB3f9szdsHk1ckGFe4Ay5pgs,True,18681784,4670446,29084,14542,14542,3uL2NSR2ZdDqCiKfzA5SwwpddAnit22DBJo6uvvz1rRs,1163361,16142858,-14979497,622
2022-01-20 20:51:13-05:00,4149,A1j2G5FZRyWSjFt6dK87WHhLkQrPUVqHaM3KhSzhAKDT,2fMiHLYm4pL3YCd8aveTR4mT9uVxztQeMwb5eRZb4wUW,True,500546,125136,774,387,387,3uL2NSR2ZdDqCiKfzA5SwwpddAnit22DBJo6uvvz1rRs,30961,242261,-211300,618
2022-01-20 20:51:13-05:00,4150,6xikA6d7sjCBnSfqkFwrL4nPrtQUNWdRhXB7i1AccnxC,G8t7u2R9qjRfdTdULs74v3nVrTM2WeKvc4dK4FFAvuG1,True,13862796,3465699,21624,10812,10812,3zqXX6kzhkbW3d4TwD2CNjMRwxTbREXySekvq37kfCNk,864964,4195705,-3330741,623
2022-01-20 20:51:17-05:00,4151,AM5fwZR9BUW8AFkhdGWXW4PHd2cy8ora63kDf2z2eknw,E7ru6hg4MchnRG5zcr5YazwX8Snt55r5Xq9zCHCGaYZT,True,353678,88419,551,275,276,3zqXX6kzhkbW3d4TwD2CNjMRwxTbREXySekvq37kfCNk,22045,202252,-180207,623
2022-01-20 20:51:17-05:00,4152,2FrqGFZjbiNykJyo9BZ5S9FguQJPJiTi681rJJsQ5dta,3QUncYP92NKrfpaTvuF9iQg11PXKgZAgEngwh6BbnCCj,True,305738,76434,476,238,238,3uL2NSR2ZdDqCiKfzA5SwwpddAnit22DBJo6uvvz1rRs,19042,153162,-134120,622
2022-01-20 20:51:17-05:00,4153,8xvLGVeDmhVYQhN2ZpWkVG9jCrukRsNQ4926a4TMiZqa,9ciBySSjvADwp47WkETiFWZKVTFL8Hf1XvK7aSxhcgQS,True,17822519,4455629,27669,13834,13835,3zqXX6kzhkbW3d4TwD2CNjMRwxTbREXySekvq37kfCNk,1106786,7862113,-6755327,621
2022-01-20 20:51:20-05:00,4154,2QStaRnbSnDhA891Lb1bxjVeMYpJUpNdqaVkw3rqU45V,DakRWPnttPoRcjY5V7WLwiwBx39BapCo9Atog8dL17Ku,True,838025,209506,1311,655,656,3zqXX6kzhkbW3d4TwD2CNjMRwxTbREXySekvq37kfCNk,52458,340706,-288248,625
2022-01-20 20:51:20-05:00,4155,Ayx8dFsVzUBb9b7QKxw7YHJuhptdSitBXFEczXTaxe85,EvU1VLChnowi6ccSPeJRSk65njrqZfYouAN7SHePxsxf,True,8659,2164,13,6,7,3zqXX6kzhkbW3d4TwD2CNjMRwxTbREXySekvq37kfCNk,542,5187,-4645,625
2022-01-20 20:51:20-05:00,4156,6u6bPgAmK8ufACrQV99A1Y5nhGkue3KEUHmQQkcNkxwP,7636yXT5w4DcVpc7LJdN46aiggzSq6U2GXHXL5kyy9F3,True,43898036,10974509,68558,34279,34279,3zqXX6kzhkbW3d4TwD2CNjMRwxTbREXySekvq37kfCNk,2742358,25565906,-22823548,624
2022-01-20 20:51:31-05:00,4157,3Lv2XpiD4KBUHq7Zx6u3zNhpXoySodXHH8o8f5yaaPxG,H6TN4rhpBXkEH3mZnymYNcKfmnxRH2uzfwzeLH2q6ahP,True,69115,17278,108,54,54,3zqXX6kzhkbW3d4TwD2CNjMRwxTbREXySekvq37kfCNk,4326,36093,-31767,625
2022-01-20 20:51:37-05:00,4158,8hpAXzimCw2bTwLXoRFAbqNW8qoj5VV3JDYCuJwqHpHm,DkfsL2M7oRBX6grAfy15C4urwL6ToMJ7TWJEFAGhWjYX,True,3420503,855125,5290,2645,2645,3zqXX6kzhkbW3d4TwD2CNjMRwxTbREXySekvq37kfCNk,211623,1005655,-794032,618
2022-01-20 20:51:38-05:00,4159,6CeKxTJvFqhyNEyzySiBBKEwYVMe7j3A6nkMes4BW6o2,DzDR9XvwY1z7ygQ8YrCXrwDGHSf67JZF8BzUnuFE2fxQ,True,1618162,404540,2497,1248,1249,3zqXX6kzhkbW3d4TwD2CNjMRwxTbREXySekvq37kfCNk,99902,733723,-633821,617
2022-01-20 20:51:38-05:00,4160,CbhrZUdan1axNDFUrX1ZuEohfNMEGrszKSkk6pppVQuw,DHEAjJNtuEePezYAv77thWabbVxxqQpfuiC6moRSrpG1,True,66156975,16539243,103418,51709,51709,3zqXX6kzhkbW3d4TwD2CNjMRwxTbREXySekvq37kfCNk,4136745,39221312,-35084567,625
2022-01-20 20:51:38-05:00,4161,5SskSWkRPP5BNaqvHkJCbTAgHPUkHEwFh5pFr4t8PoBr,EqdX8Sdm9LCfdrzVKzisKaFcP2YEdSRNZYmev5RWjGqb,True,1448791,362197,2261,1130,1131,3zqXX6kzhkbW3d4TwD2CNjMRwxTbREXySekvq37kfCNk,90470,434468,-343998,624
2022-01-20 20:51:38-05:00,4162,8VnGmfop6qcUezAJ2M15jz2Nn6mPQgehDcJPvypq4XJn,6F6sqXNhgkW9ev8QNMm4ydywUUmemhwgydRQYNeqyUmi,True,3915173,978793,6061,3030,3031,3zqXX6kzhkbW3d4TwD2CNjMRwxTbREXySekvq37kfCNk,242440,3835754,-3593314,619
2022-01-20 20:51:38-05:00,4163,GjQQ2fQ7mrGjWZwjVYFUKp9NM1LmfkhEo675ovU5SPa8,ECgVUMRY5nB4MALs5drDyipF7YohCPuJpj2UegCs7HMn,True,11364287,2841071,17754,8877,8877,DddJ7EWCmYEEZETCBNgAUSg81Ls6fZtiAaY5ekJ5sXx1,710163,5389478,-4679315,624
2022-01-20 20:51:40-05:00,4164,Fd2HrzBAr4JobRPARZwpQHHVoSCEoog32A6tKMWAC1sK,BYappsar5sQf8VLem4wrLuTtrDFH9y8pEx1aMxfuU4Pq,True,11135227,2783806,17334,8667,8667,3zqXX6kzhkbW3d4TwD2CNjMRwxTbREXySekvq37kfCNk,693377,6480462,-5787085,622
2022-01-20 20:51:40-05:00,4165,Ftuj53jKP3Z8mvuTE1CEypdw2eZrCn5x8ktMWRdJo2gU,9JNUFRLrPNAh3DgKvMdaNvLCAeUtiS9FGWmDcMvcSe7J,True,94385079,23596269,146125,73062,73063,3zqXX6kzhkbW3d4TwD2CNjMRwxTbREXySekvq37kfCNk,5845002,41897981,-36052979,619
2022-01-20 20:51:41-05:00,4166,AHm7zF4rpaxaayBLn5QDHgJSp8KAr647s4cNvQ9wLgd7,FDM33WngED24pukBvSDpPAzinW6afVAeGReum5nyLRiC,True,306251,76562,474,237,237,3zqXX6kzhkbW3d4TwD2CNjMRwxTbREXySekvq37kfCNk,18960,183732,-164772,619
2022-01-20 20:51:46-05:00,4167,F2v1YwVAwXLiUgsJ5uwn4qAAkTXitn1E75fJcPnGuAcy,5rdJ4H5GxPg4Juu77mGc7uya5LwEqLzDSRyG8mQ2mDbK,True,7129503,1782375,11010,5505,5505,3zqXX6kzhkbW3d4TwD2CNjMRwxTbREXySekvq37kfCNk,440431,4149907,-3709476,617
2022-01-20 20:51:46-05:00,4168,6yw4GPvkqUbakcEWtqSCfjVLukty11xqjDpGxtEN9Km2,5ppEx7wkpqbG5nApCWMdRja3oRSheFmAAsNHUX7h2w2Y,True,610603,152650,950,475,475,3zqXX6kzhkbW3d4TwD2CNjMRwxTbREXySekvq37kfCNk,38009,608474,-570465,622
2022-01-20 20:51:46-05:00,4169,6tFQaTqqffino9kwMZTL2xVNBG8k9VREFhXqVi2si3A3,3w3wGxBbS4bmXeqmvd595SAWFeXekVpnH4UdbeEs8Sx5,True,1620538,405134,2519,1259,1260,3zqXX6kzhkbW3d4TwD2CNjMRwxTbREXySekvq37kfCNk,100796,732242,-631446,621
2022-01-20 20:51:48-05:00,4170,7hTjPRQSYAoWHhtpsVz2oKK5SAuFJd8dPHShKgKJq8dy,6DcHcrtcXR88d8e2KahhAiWTeRznNfF8oXLHmh5wE7wz,True,682393026,170598256,1052061,526030,526031,3zqXX6kzhkbW3d4TwD2CNjMRwxTbREXySekvq37kfCNk,42082469,276636480,-234554011,616
2022-01-20 20:51:50-05:00,4171,EmGW2aAG69ssWqCtbfDocRaM2u3TJsczn2HHP9jdmRvD,aypkDKsp9uqAB4F6mwvm5LofpsrFBuZT2MMWtE2eHdB,True,238706,59676,372,186,186,3zqXX6kzhkbW3d4TwD2CNjMRwxTbREXySekvq37kfCNk,14907,132528,-117621,624
2022-01-20 20:51:50-05:00,4172,F9s8a7Cpiw5dw3a2aNFMofqwyDWNXvDLnSdJzoj1gRiV,GpKsQKJD79KBRWdCTkyi4zX7NaoCWsLUjrKxAwJB6o6s,True,15014688,3753672,23474,11737,11737,3zqXX6kzhkbW3d4TwD2CNjMRwxTbREXySekvq37kfCNk,938960,4030420,-3091460,625
2022-01-20 20:52:27-05:00,4173,JDeYjCLpfnzcfxDFgHf4aBcHsajwdR14GUaKAA9euzVf,EJbvKoyMZcoCx4vWa61uMbW2vr6mUhrgEuECdteVBuZZ,True,5554711,1388677,8676,4338,4338,3zqXX6kzhkbW3d4TwD2CNjMRwxTbREXySekvq37kfCNk,347052,3433347,-3086295,624
2022-01-20 20:52:49-05:00,4174,WMUVFELv3C3KdMKJ5ZL4rG7o1YrV1qTP6Mmp2S5Rp8S,7UNzS3zDqT1oeq9a7eJGU8cgf8eUzEAZubSBQvNmK6uJ,True,6708508,1677127,10491,5245,5246,3uL2NSR2ZdDqCiKfzA5SwwpddAnit22DBJo6uvvz1rRs,419640,1869044,-1449404,625
2022-01-20 20:53:08-05:00,4175,E8ifvhmyJGBGVQomo3AnZw2UcaLHcpGsTtuoCid8voU3,FMQUWTbTAfSLfrc6GTrz4DM2ZSgoxF3KtqGn8AyjVtsf,True,2629175,657293,4085,2042,2043,3uL2NSR2ZdDqCiKfzA5SwwpddAnit22DBJo6uvvz1rRs,163432,1174024,-1010592,621
2022-01-20 20:53:09-05:00,4176,AATMHH4e4B6SL9bThnXGktzWuqWkPdx3JbRXk8HwkbPW,6F3u2yLx7P9gtpAAXASx7uF8xNyVBgJiKosMKUrgpicA,True,92461050,23115262,143497,71748,71749,3zqXX6kzhkbW3d4TwD2CNjMRwxTbREXySekvq37kfCNk,5739881,47083954,-41344073,620
2022-01-20 20:53:09-05:00,4177,9zpPiboHF5HW7NfCx7hYdmJGwUomVMTiUFc4Um5KrDi3,8q3eBpuwV6dMNkib9N8XQAq2tBUcjSANRe5SXpd4dFhZ,True,3032969,758242,4721,2360,2361,3zqXX6kzhkbW3d4TwD2CNjMRwxTbREXySekvq37kfCNk,188877,1284824,-1095947,622
2022-01-20 20:53:10-05:00,4178,6Y1UoGwrKyKsScZQm9ng1rNrXXykKT82V7kUopc43kAy,8YtWQTTKymCESbPMWCP9TMehbMU25zJMtxt9grqrpbD4,True,14092352,3523088,22021,11010,11011,3zqXX6kzhkbW3d4TwD2CNjMRwxTbREXySekvq37kfCNk,880855,13785776,-12904921,625
2022-01-20 20:53:13-05:00,4179,3oCun4gm3k8sXxVxiYM8okGi8iCXH9LvDkHf9PBQWYXR,E1np1dZ7jUm811ddvy1jQerBwGSYb5BbZWnUHeotvrfH,True,157567116,39391779,246273,123136,123137,3zqXX6kzhkbW3d4TwD2CNjMRwxTbREXySekvq37kfCNk,9850957,39094203,-29243246,625
2022-01-20 20:53:13-05:00,4180,GxFxvEUdWofneMmVvhCSScH9V6Zia5WJ2J9q6CpPnaq3,ATLykiHDii3Lw53MoZXwqu1FbBNPJbVNVGe2SoQMjVmY,True,2282679,570669,3571,1785,1786,3zqXX6kzhkbW3d4TwD2CNjMRwxTbREXySekvq37kfCNk,142874,1238270,-1095396,625
2022-01-20 20:53:18-05:00,4181,AWvHDdb2ikqV8wc7qQ8azbvNTZdixMNxhQjhQdhayYtR,9EpgEPBb1nog6aQeFdMXfSRiLSnzGQFQ39mbLdCxgYTv,True,32971647,8242911,51545,25772,25773,3zqXX6kzhkbW3d4TwD2CNjMRwxTbREXySekvq37kfCNk,2061812,11042150,-8980338,625
2022-01-20 20:53:27-05:00,4182,5dM6X7DVy28oznuB7mhJjdDNte6mcTZ31HLF7DqFDGsR,9UwrfQNmyeymmtrJEabKd3yWVKGP6UbNCRqKe9cLT3N9,True,5448342721,1362085680,8504691,4252345,4252346,3zqXX6kzhkbW3d4TwD2CNjMRwxTbREXySekvq37kfCNk,340187669,1620744948,-1280557279,624
2022-01-20 20:53:28-05:00,4183,BZxJ6CtrVoiU86DMMieMeDFLNWtMpHGTvZfM7nyay6o4,6CRxRR8bisRLHFJBFWjyumYuy7j4C4PkjYH1K8gXhdWD,True,2673800,668449,4095,2047,2048,3zqXX6kzhkbW3d4TwD2CNjMRwxTbREXySekvq37kfCNk,163813,893871,-730058,612
2022-01-20 20:53:30-05:00,4184,9UyQC8vc6zJJaSdnjvTAzgmcsw4fC3xFBBiCC1w9Sbjx,3ppBfboe6FPmt7f6WrivspMUoAznZKWQMeh3rCgw7vjQ,True,3309158,827289,5156,2578,2578,3zqXX6kzhkbW3d4TwD2CNjMRwxTbREXySekvq37kfCNk,206264,1401747,-1195483,623
2022-01-20 20:53:30-05:00,4185,2F45BX9mRmtNCHPejKFknN5aNgGvR4vVLFjMaY1a7dR8,ALdSutsvEFRUEQGGBbi31QywTL1pdXSDWrNJzvNTaoXL,True,9257779,2314444,14442,7221,7221,3zqXX6kzhkbW3d4TwD2CNjMRwxTbREXySekvq37kfCNk,577717,5222864,-4645147,624
2022-01-20 20:53:47-05:00,4186,5eMLdQ4gYA5iqvTXSNdGvctHp7s5VpyFuwtJKqx6chBc,Ckxc5K39nkBNXBTmFTM8J48R7wGqNm3vHKZu4G5baumZ,True,233506607,58376651,364752,182376,182376,3zqXX6kzhkbW3d4TwD2CNjMRwxTbREXySekvq37kfCNk,14590102,86636535,-72046433,624
2022-01-20 20:54:02-05:00,4187,J4krKPBBTMVLZRgrSeYJAMyHQs2FkNm5TXk7nQWwDB43,ASmLbfNbhTD2HHeV7qzAqiHjUx5a8Traj8oPDwbkMdFg,True,10496602,2624150,16424,8212,8212,3zqXX6kzhkbW3d4TwD2CNjMRwxTbREXySekvq37kfCNk,656976,4840962,-4183986,625
2022-01-20 20:54:02-05:00,4188,H1LftKtj94Zs6PG2A7gJt9rPurBkXkTy2hbbArQwAehi,8bANmhgdnPYa3PqdPnk5BA2xhvqJmPyaMF77mrBePJ13,True,14141,3535,22,11,11,3zqXX6kzhkbW3d4TwD2CNjMRwxTbREXySekvq37kfCNk,884,12880,-11996,625
2022-01-20 20:54:15-05:00,4189,3Xbsek5MsEGoWr3G9yhuohREr26B2vSQcjqXdspTFHta,2rPxkUiMo9wGDq8EvAiwY3ngRpKmL223cBWWNTYoBmFp,True,138809689,34702422,216270,108135,108135,3zqXX6kzhkbW3d4TwD2CNjMRwxTbREXySekvq37kfCNk,8650831,34939230,-26288399,623
2022-01-20 20:54:22-05:00,4190,pgzvXpnUYiY7hLrfjmwScqLd8oj9vYcXpFvpm4y4JvG,GdqdQgoyBAFuXdbvoZyDhB3jyqJzVo4nkGh7EPFxkBF2,True,782440,195610,1222,611,611,3zqXX6kzhkbW3d4TwD2CNjMRwxTbREXySekvq37kfCNk,48892,785281,-736389,624
2022-01-20 20:54:44-05:00,4191,CvZssqscu2dm35mwcE3zg9zedavbRjVJjWD59Py5ExUK,7pXaoR6aHKYofCmg1eHipygNYDteEaf8rbbS8BDYGQK6,True,259723,64930,406,203,203,HfEnetJ7uBSmZWCjBNxdvv9HEC5nsW4wDV7wu6WnhWan,16256,117724,-101468,625
2022-01-20 20:55:19-05:00,4192,3EmGvYu72cR4Ta3wLA5HKZBEqgfChCyiRanwj5hGLJXc,6NEWPFaKi5uLsrj4n6RM1DBhQTcGFE9TwYeJ12pC7yyp,True,14713,3678,23,11,12,3zqXX6kzhkbW3d4TwD2CNjMRwxTbREXySekvq37kfCNk,920,7398,-6478,625
2022-01-20 20:55:20-05:00,4193,51yPLtXTgL9oLKs1cCf5TjL54Ld5vuVxat2NNtwZVsZG,7UjtM7Z1tiXEQMMiorQyncgi9SKu3v46DhVdgXbWqSiF,True,131613305,32903326,205931,102965,102966,3zqXX6kzhkbW3d4TwD2CNjMRwxTbREXySekvq37kfCNk,8237254,127330485,-119093231,625
2022-01-20 20:55:27-05:00,4194,67Z7ZGhNu5xxEh9BYKWcXp9m1T4tFiE1o1M16hCzUWQA,CT7YKWixz7BhTbvg5F6M5HCyPGnHoFLNFuDV9GhoLTo3,True,1205491,301372,1885,942,943,3zqXX6kzhkbW3d4TwD2CNjMRwxTbREXySekvq37kfCNk,75423,814772,-739349,625
2022-01-20 20:55:33-05:00,4195,brCL9pzP6q4b6rKgAH1AJbMoqffBWyXLX8oAnZDoi77,Dx4G5UP9jTb47JQypWJnv48mPTzhJvqPD1BtBtDT7TJF,True,2997667,749416,4686,2343,2343,3zqXX6kzhkbW3d4TwD2CNjMRwxTbREXySekvq37kfCNk,187462,689795,-502333,625
2022-01-20 20:56:05-05:00,4196,ApAgbKGyEYXRonGM33w56ZxHQNAGSd9ji4K3zAGN2yA8,FZAhAUDtEaNsFmh4fP8uXNjoHneNkpZ2wQCfEeU4RYRM,True,37476750,9369187,58603,29301,29302,3zqXX6kzhkbW3d4TwD2CNjMRwxTbREXySekvq37kfCNk,2344135,17174661,-14830526,625
2022-01-20 20:56:09-05:00,4197,HcGtTcpuxex2eQyz6GjJHrjDgThU2ZWSjjnzNEf7tNXy,XuFuE8RxTusW8BYDczgzvWrD5YbDseACo2edd2K4tVv,True,29419,7354,46,23,23,3zqXX6kzhkbW3d4TwD2CNjMRwxTbREXySekvq37kfCNk,1840,10645,-8805,625
2022-01-20 20:56:29-05:00,4198,72woixtGAuGazCMfsYfYBYLP7FuRj8Fwz9fynFo4MCE4,5237BmWkKf58PBeTUEiu3Ld5uKXEe8wcrJRmCnUoWWku,True,495496139,123874034,771274,385637,385637,3uL2NSR2ZdDqCiKfzA5SwwpddAnit22DBJo6uvvz1rRs,30850989,131066739,-100215750,622
2022-01-20 20:56:35-05:00,4199,Bsr6kx1B6BSEd5UnJ7Z61M49iUb3bFrDVhiEtMVtPDF2,3CFd1pUJAJPA9fobwn4Jj2mRju1CWmoop4Mh4znypNWT,True,20823852,5205963,32357,16178,16179,DddJ7EWCmYEEZETCBNgAUSg81Ls6fZtiAaY5ekJ5sXx1,1294299,8385592,-7091293,621
2022-01-20 20:56:37-05:00,4200,CyWBZ1xJ9LahUnPesbXLZ4Rr5UyWAHgVFYwfrnhyrkNL,2Lpk87Xth8ZL5J9BfzmMpEE3x76FDrrrmdKiCNkSVip2,True,130966482,32741618,204733,102366,102367,HfEnetJ7uBSmZWCjBNxdvv9HEC5nsW4wDV7wu6WnhWan,8189348,52398684,-44209336,625
2022-01-20 20:56:47-05:00,4201,6NJFN855M3Q3RLTDNo57gTgAmwPD6G2E3WvMb1m5eNCN,3YpqNnonsvXaRT4nCC3G5FZx1jjVtbDPc36LiR6WK5jR,True,54106676,13526669,84665,42332,42333,HfEnetJ7uBSmZWCjBNxdvv9HEC5nsW4wDV7wu6WnhWan,3386614,32942594,-29555980,625
2022-01-20 20:56:47-05:00,4202,DGAQzgZhS2yioeZmG3cbacM3hdz4F1aZn1PWRwgiFukc,48KUtJaNCPNxkLXJBtWAdDxY4b9vZzLgbGxTNdwMqmjz,True,193868838,48467209,303222,151611,151611,3zqXX6kzhkbW3d4TwD2CNjMRwxTbREXySekvq37kfCNk,12128913,107374915,-95246002,625
2022-01-20 20:56:47-05:00,4203,3VYtHvoT9wi4K1PBjg6JjCf6U9fVPDf6tX9jyRRvLxcg,Ba5fjpVyAxLbiP6hYJmrxzougi7JUEDfDLKBxSbbTL7q,True,166820811,41705202,260776,130388,130388,3zqXX6kzhkbW3d4TwD2CNjMRwxTbREXySekvq37kfCNk,10431040,45144365,-34713325,625
2022-01-20 20:56:50-05:00,4204,CRaKcudjkQiSw5YPVjTLVdXvJskeGiHSYtq5ZcMPJhgQ,AgqTg3b3bAcaBmRidhNC4Uf9ZwNbeH52RQEqumWyuUs7,True,321147,80286,501,250,251,3zqXX6kzhkbW3d4TwD2CNjMRwxTbREXySekvq37kfCNk,20059,227403,-207344,624
2022-01-20 20:56:54-05:00,4205,9vcKW1GfrDZ3KLPh2pEVFF8ZyKqD1pJW1hiE8H98Av7S,C6Ki27mo4sCHu6u8UnR1p7WSgsTjFQxGGR9Lk9n5Rhjq,True,1030459,257614,1611,805,806,3zqXX6kzhkbW3d4TwD2CNjMRwxTbREXySekvq37kfCNk,64465,593987,-529522,625
2022-01-20 20:56:55-05:00,4206,BJaaH1SK1pF2kZQzmYpLFfDtm52CR9a5rd39RAPtLe8q,HUsT5FVxaisdnCvG1BQxX6zffjfL2Rwx5mMo5y8SDV7e,True,37284291,9321072,58285,29142,29143,3zqXX6kzhkbW3d4TwD2CNjMRwxTbREXySekvq37kfCNk,2331428,11730835,-9399407,625
2022-01-20 20:56:55-05:00,4207,6nJyqvFKprwaVCE1gAa2P4RHKc6Pa6XFSJymx654zZ9K,4e7iJmdwzAPxp1Zi8Azo38YyPQdPKqqY4VLJyQ5rpdYP,True,924039,231009,1442,721,721,3zqXX6kzhkbW3d4TwD2CNjMRwxTbREXySekvq37kfCNk,57714,561002,-503288,624
2022-01-20 20:57:01-05:00,4208,4cKgCTttVp8pzJnp43PP7uLLUXNcU7YGPJ3cCGHaUFe7,BBQqjwTpVEgpDzMk4wDDH8rCjaSxCRPWVhtFxERSujTD,True,15003664,3750916,23479,11739,11740,3zqXX6kzhkbW3d4TwD2CNjMRwxTbREXySekvq37kfCNk,939188,7765379,-6826191,625
2022-01-20 20:57:39-05:00,4209,CBL2NbekJrXvBiAcoj4fzQ4PfLDwTntW7Zt4nruHFYEw,59EvfgYTdKkfjUJz5LddLUAqbEdLaihcMzjcrTZsyzyS,True,3467,866,5,2,3,3zqXX6kzhkbW3d4TwD2CNjMRwxTbREXySekvq37kfCNk,217,1779,-1562,625
2022-01-20 20:57:39-05:00,4210,o2aCmkxsxSiyUX8soTEjwUCbJeXmCZsEaf8CWwxDT5n,3pvS2bTsUuiQyqZp5rdnTpq4cqWGgtv4E5rN9HsBxpRt,True,8852,2213,13,6,7,3zqXX6kzhkbW3d4TwD2CNjMRwxTbREXySekvq37kfCNk,547,3285,-2738,617
2022-01-20 20:57:39-05:00,4211,DdYgcyV1T2CDYiQVr4VL9Ym8RdKm93a7SKy8HxuyaoMW,GPdAeqeXb1UJ56AttcwwY1CyFhRyfptDC4BAX2Tc8MpE,True,194755,48688,300,150,150,3zqXX6kzhkbW3d4TwD2CNjMRwxTbREXySekvq37kfCNk,12019,117576,-105557,617
2022-01-20 20:57:39-05:00,4212,M69XSefqeum2arinvHEqmA3L2XHWNFN17p4msRhRZXf,2vK15yYUANLSbAoiBfgJ9VLyqsmtEpd2iNytQjms8GaQ,True,100397036,25099259,155717,77858,77859,3zqXX6kzhkbW3d4TwD2CNjMRwxTbREXySekvq37kfCNk,6228686,74276440,-68047754,620
2022-01-20 20:57:40-05:00,4213,2s9VGesQYbKr3LwuraMEa9sXbXz7f8299HPPAHgSaUdp,8uMS2GDsbmygjbRnc2gjwNkXKogmJX1i8nchmqt8ixCe,True,16581841990,4145460497,25807202,12903601,12903601,72FwbpFGoLEazJEdpqNtPNefsadUrimUqma9wSoy4qiS,1032288109,8719376848,-7687088739,622
2022-01-20 20:57:40-05:00,4214,7jvKp6onXyWgwsFrFWj4hYTXJsYYD6ot5mn6rPFuJriy,J7N6HiozevJVTiY9hDEUs2ud5BwT5QSE7wnMBS1w5ie2,True,22387379,5596844,34749,17374,17375,3zqXX6kzhkbW3d4TwD2CNjMRwxTbREXySekvq37kfCNk,1389975,12834606,-11444631,620
2022-01-20 20:57:40-05:00,4215,DdAPWdHnb7ocaYtcwwwYnppsH39sZpmzMyANeoJbCV7s,3BVmC39L8dEypPN1BZhsf9bx9Ge2sXCZR8Y6RH4eBNMJ,True,389705130,97426282,599518,299759,299759,3zqXX6kzhkbW3d4TwD2CNjMRwxTbREXySekvq37kfCNk,23980733,325818571,-301837838,615
2022-01-20 20:57:40-05:00,4216,6oroGB3mvzK3tDfiB9X2NJuL3x476pxhgRnt7VxqhdLo,2SoK8tKkLn2ppKURpTVazKsCEis4uahkHMsac1m85J4r,True,663552,165888,1032,516,516,3zqXX6kzhkbW3d4TwD2CNjMRwxTbREXySekvq37kfCNk,41285,644665,-603380,622
2022-01-20 20:57:40-05:00,4217,8sneA6wAg6geVDJ1g7YWg4R1PfjuRVzeHp1nUBJinhZa,14i1uWtmcTjrdbg3DSr9vzd5NBnxqsn1A4QdgFBZqeYM,True,111612,27902,172,86,86,3zqXX6kzhkbW3d4TwD2CNjMRwxTbREXySekvq37kfCNk,6909,51375,-44466,619
2022-01-20 20:57:40-05:00,4218,Ckqos6cdncPKj13DnCmDVZsZTqp6eS7277CRrT9WhcEr,AtUV8m7VQJvZq7GLCAHMf3jV7iamKEPnWVZHWuuVZQp1,True,459875,114968,708,354,354,3zqXX6kzhkbW3d4TwD2CNjMRwxTbREXySekvq37kfCNk,28336,326025,-297689,616
2022-01-20 20:57:44-05:00,4219,5sN3cfz4hZjwy2HkAStKWeL8wHhdbkW8F7USzwCzmggh,Fme7U7QY92biAsV3RR2Fj7rJPnpdcov13mmFhVDFuyYG,True,264983504,66245876,414087,207043,207044,3zqXX6kzhkbW3d4TwD2CNjMRwxTbREXySekvq37kfCNk,16563495,129523650,-112960155,625
2022-01-20 20:57:48-05:00,4220,HVZkXeDR3mc8oB9qFFwCK4RXpPojdcHk9tRGep6xtKGK,Bh3py7awPejWqeTMxtAgF7mPotL2Asxf8YrYJykq9nBt,True,2442604,610651,3819,1909,1910,3zqXX6kzhkbW3d4TwD2CNjMRwxTbREXySekvq37kfCNk,152775,1274034,-1121259,625
2022-01-20 20:59:03-05:00,4221,2jPxG5FL6D6XEJsRszJ9cmQ54AWSpZyPFSbn3DpWBSuM,3toQou4UVNvyWYvMvkuv379RVEF2aN2TzCpKKBUqeQV6,True,71525979,17881494,111921,55960,55961,3zqXX6kzhkbW3d4TwD2CNjMRwxTbREXySekvq37kfCNk,4476846,36746742,-32269896,625
2022-01-20 20:59:21-05:00,4222,GufVttJatW8NLeztT1NRQSLZpQNRk45kaG41p3QcWhx7,GTJUsWoWRyeafYJVhx2aRo8NE94U5UrBjaehmJ4PRUhn,True,19943927,4985981,31123,15561,15562,3zqXX6kzhkbW3d4TwD2CNjMRwxTbREXySekvq37kfCNk,1244944,6607925,-5362981,624
2022-01-20 20:59:40-05:00,4223,D64rDiWT3YG28fCgXCmbNjYa2JakZbpKQ1D2XuLChUfV,8WmMWq8cTsGQym5pUbHm9dPCpJugBeWUMVERYFGLxWHj,True,25395864,6348966,39666,19833,19833,3zqXX6kzhkbW3d4TwD2CNjMRwxTbREXySekvq37kfCNk,1586654,9558853,-7972199,624
2022-01-20 20:59:59-05:00,4224,8MGEQ1KEMv9WSgVifjN7CQ7tDbJBJbWgGYu71dTDKEPQ,mQY2X9KYVXf9JmGY8XwMK4G8odM4HmWkgEmYYqKnkvF,True,63707291,15926822,99669,49834,49835,3zqXX6kzhkbW3d4TwD2CNjMRwxTbREXySekvq37kfCNk,3986775,38355837,-34369062,625
2022-01-20 20:59:59-05:00,4225,CagSUfZLwXuCdypC4KzU6FSNdmCj9dKDroPcNeaRtsyt,yxw5d1ztZuEUY2QjL7eLpr72QJAj5rJd6ERvg91cy1m,True,599081,149770,935,467,468,3uL2NSR2ZdDqCiKfzA5SwwpddAnit22DBJo6uvvz1rRs,37424,282624,-245200,624
2022-01-20 21:00:00-05:00,4226,GqAS41YJssg9aaEp3hs3sG98APCsXhiQBQszXaSjZ2bN,2wodJ3AhrXdE1T4oVL95KvoBND7PubG5Wd5GWiLCMZJU,True,70351045,17587761,110009,55004,55005,3zqXX6kzhkbW3d4TwD2CNjMRwxTbREXySekvq37kfCNk,4400385,65388892,-60988507,625
2022-01-20 21:00:00-05:00,4227,3qnPsgqW11AcDEmyjmJquPcPLyE3EdJQuVLJ5kinDrd3,86rZadBB7emKio76aFTahpbrFtxd9tqZ4Mxgzaavq2xU,True,58512,14628,91,45,46,3zqXX6kzhkbW3d4TwD2CNjMRwxTbREXySekvq37kfCNk,3658,30677,-27019,625
2022-01-20 21:00:25-05:00,4228,BrHRMouGRz3LBNzd9anfdYMhWfg8yUPHL4PqJ8WdEDFS,4uzoLa3mC2VYHAPBoHLX4gTjPTC28rPf2fvEGtJWPYc,True,22537568,5634392,35239,17619,17620,3zqXX6kzhkbW3d4TwD2CNjMRwxTbREXySekvq37kfCNk,1409594,20825360,-19415766,625
2022-01-20 21:00:28-05:00,4229,5rW9kqXB9feGSKSvSMNJF1FCsBYV3vGmTmc8MvzaZ3pi,7AjnjcfPJevW5521hXw4VtgRCfHSsAqyzyArukKfNcHo,True,4072882,1018220,6355,3177,3178,3zqXX6kzhkbW3d4TwD2CNjMRwxTbREXySekvq37kfCNk,254224,2487832,-2233608,624
2022-01-20 21:00:28-05:00,4230,8627qmFevGS1LSDyCgoJjbURcf8CjVFCcxE7U9mWVP5f,3sgQuNcZuGV59Q9apxSBQcV1XAa6og6xa8FLpumvN7iZ,True,14848,3712,23,11,12,3zqXX6kzhkbW3d4TwD2CNjMRwxTbREXySekvq37kfCNk,929,7583,-6654,625
2022-01-20 21:00:28-05:00,4231,3C2MZQKh9x4zNTCMbhhvoafGaFMwUooqfy9MCgPyXs6E,AHjgWKpYPWe6ketjDHDKFBFsKQiRJ41jnkuo39MVYxZo,True,78408741,19602185,122297,61148,61149,3zqXX6kzhkbW3d4TwD2CNjMRwxTbREXySekvq37kfCNk,4891913,52871329,-47979416,623
2022-01-20 21:00:28-05:00,4232,HGJoZvLakWfSDFwuvShNBc4kCf7nP7VqzyM3mELpbFEf,12Qn5jin7QvsBngXqYAv4UstyG3b6nRf1jsLp9Dp8G7k,True,6006567,1501641,9375,4687,4688,3zqXX6kzhkbW3d4TwD2CNjMRwxTbREXySekvq37kfCNk,375021,3276653,-2901632,624
2022-01-20 21:00:28-05:00,4233,FKQVm9RsteDe7dQmwx4NGYhz3Wrvwh7TCp9rFbTgAomx,Dbwox8eRCdmH5KXyi5sBaqWzhxtaVPo1teWXJ2kRFT1f,True,255549302,63887325,398436,199218,199218,HfEnetJ7uBSmZWCjBNxdvv9HEC5nsW4wDV7wu6WnhWan,15937462,229542156,-213604694,623
2022-01-20 21:00:31-05:00,4234,BLJgLzizx2yLgd12pVBAHTMqn9J5JA3JHCF8PnLnPyUk,HhDmwMysBFWhXnd3mrV31w75WBRKBS8wJSiEMZgqdUSp,True,378545318,94636329,591088,295544,295544,3zqXX6kzhkbW3d4TwD2CNjMRwxTbREXySekvq37kfCNk,23643538,207557958,-183914420,624
2022-01-20 21:00:35-05:00,4235,4ne6vC7qdxQYHJCsaeFAKZrKdFt2SwXGHQ3jrMHqt4DL,Cf1dLHY2WXH9rXbRKq5TT8THbdo9SdNUZq4rYhRCF9z,True,50615322,12653830,76467,38233,38234,3zqXX6kzhkbW3d4TwD2CNjMRwxTbREXySekvq37kfCNk,3058692,14307312,-11248620,604
2022-01-20 21:00:51-05:00,4236,D7XummfEc3NTK4qMvZegV3FrYuqc8mNgnQu3ujwemZtg,HHiRcecqzW7sGFTio7Ph6TYv3dGt64KWv4DEKgKm84fQ,True,3958713,989678,6019,3009,3010,3zqXX6kzhkbW3d4TwD2CNjMRwxTbREXySekvq37kfCNk,240796,2189794,-1948998,608
2022-01-20 21:00:57-05:00,4237,5hJereyPSCNUrGW7TdYXHKjhXMWTbGZzc2GF9MWksLJE,AUE3NpqaeamHGBKUVuKnUhnBb4Lzt7xWU1FHMu1Hq5dC,True,490153967,122538491,766575,383287,383288,3zqXX6kzhkbW3d4TwD2CNjMRwxTbREXySekvq37kfCNk,30663030,139389063,-108726033,625
2022-01-20 21:02:24-05:00,4238,DDsY5V3F9wnEGBoQFCEf1hvEYuKUaJdysbc7TxhNqe9G,5oBCGzvy8odB8MCxCUvPDqYCnTyteZ4Yy1JDroroygbi,True,52777161,13194290,82130,41065,41065,3zqXX6kzhkbW3d4TwD2CNjMRwxTbREXySekvq37kfCNk,3285222,13742313,-10457091,622
2022-01-20 21:02:50-05:00,4239,DvuRmJkfn6FQczUKgYeaSCqwy2NTMunuAKNrnmxMvnzS,7LpWTX9dgBtW75kfEoB5WuNsDwEdw5s8CYSHh3J4qagM,True,44759580,11189895,67637,33818,33819,3zqXX6kzhkbW3d4TwD2CNjMRwxTbREXySekvq37kfCNk,2705515,25109318,-22403803,604
2022-01-20 21:02:50-05:00,4240,FV3G5EsSmyiLAAoREhgDXwvzbxoyDeq4Mwfj4jK5fJ7U,5nhzbJmm5JAwGDpTZoenkM1u3XtMY4uN7Qsm3vFGtRJE,True,43555114,10888778,65807,32903,32904,3zqXX6kzhkbW3d4TwD2CNjMRwxTbREXySekvq37kfCNk,2632308,9777194,-7144886,604
2022-01-20 21:02:54-05:00,4241,DkvR2xUPMyXWGGkUSmDSfhp7RtvMkfbT1ThKCS3TwrXd,F7jYV6TtT1LZ5XCNn1zkbUfNMo4gGcQUczAQy1jLHpaW,True,431961543,107990385,653652,326826,326826,72FwbpFGoLEazJEdpqNtPNefsadUrimUqma9wSoy4qiS,26146102,199568873,-173422771,605
2022-01-20 21:02:54-05:00,4242,DY6k3Dkwe18iLneaT8Xo3VpJWB6V4jWwQQjoDvEzdg2j,3GGV7S9FpRQGbARBXkvGFVqLrmw8JvYAcpnR1aKVUY2f,True,8782424,2195606,13376,6688,6688,3zqXX6kzhkbW3d4TwD2CNjMRwxTbREXySekvq37kfCNk,535047,5396343,-4861296,609
2022-01-20 21:02:54-05:00,4243,BgnsCfJ54ReunUtwPJLzkW4PWnqpBDWGNYxsW5PvDrbK,KpMqEkQ9dKMgCevsEK895wHd3fCLRPSzDmJSv3tKU4u,True,10279578765,2569894691,15431298,7715649,7715649,3zqXX6kzhkbW3d4TwD2CNjMRwxTbREXySekvq37kfCNk,617251921,4186048647,-3568796726,600
2022-01-20 21:02:54-05:00,4244,9WJBnVi84E926j7xEd566WzrZJkPJWRgmEnYj9vyjuad,4dLaFS5F7TGyLdwuJLMGkz3bSL53aHzd9ZfpNmhHxXeF,True,10904693,2726173,16761,8380,8381,3zqXX6kzhkbW3d4TwD2CNjMRwxTbREXySekvq37kfCNk,670463,5960736,-5290273,614
2022-01-20 21:02:54-05:00,4245,8swGZMrPrLAxZd7MxTbkCL13k3DmAJUw41jCp6Xo6awW,3fKnX7yTNXAT4uMmXVdTy47ALJT8h8YSD3WiBb4BGuzH,True,164447554,41111888,246084,123042,123042,3zqXX6kzhkbW3d4TwD2CNjMRwxTbREXySekvq37kfCNk,9843390,77917093,-68073703,598
2022-01-20 21:03:00-05:00,4246,CxLFMBDFkoMvpK9YUf7WtCq6hn7k3QACAuetAnGjU6KA,2gE52a1GWQnS6ifV6eVtKQyr13LXP5Jdt3yG9SjGPJPF,True,862635459,215658864,1347347,673673,673674,3zqXX6kzhkbW3d4TwD2CNjMRwxTbREXySekvq37kfCNk,53893889,191148430,-137254541,624
2022-01-20 21:14:30-05:00,4247,B9WJfmrYEkVH3L1UWz4qqWpaexHydymbzvEfwNVtB9BV,6mQb4yzGq8jE1NbweKCKSbevnnYVhHYxyc6Gz2a5kJLn,True,240070070,60017517,368937,184468,184469,3zqXX6kzhkbW3d4TwD2CNjMRwxTbREXySekvq37kfCNk,14757493,57548305,-42790812,614
2022-01-20 21:14:35-05:00,4248,8trFFwvXKKMwMx952ugCZmqyw29e1HxEKBuQmFn8ZwTf,FsD7gCvHXM3QchQiDcd292ksy5afZMWApneNTat5ndeS,True,214076341,53519085,334401,167200,167201,3zqXX6kzhkbW3d4TwD2CNjMRwxTbREXySekvq37kfCNk,13376053,51111732,-37735679,624
2022-01-20 21:14:52-05:00,4249,2mfcg17QocKKvDcqDH88TwxHRiS8dAQiJAGoAh1brns9,8aQLELBgaA9eXsxSciMjxWv8B1hpbUPfLwqVjEnasZbe,True,117257018,29314254,183297,91648,91649,3zqXX6kzhkbW3d4TwD2CNjMRwxTbREXySekvq37kfCNk,7331911,32445726,-25113815,625
2022-01-20 21:21:37-05:00,4250,8abFwhhZyq3xkvjp4NWDBt7qAPXBbzBxksUk8SAUeVkN,A9u4dhWZbBwthC4WXQg1Dfp3wHYXr67SGs5na1EQ1k3r,True,41036806,10259201,63283,31641,31642,3zqXX6kzhkbW3d4TwD2CNjMRwxTbREXySekvq37kfCNk,2531334,9022225,-6490891,616
2022-01-20 21:22:33-05:00,4251,AvwHizRhHUSahmvSg4jmTUErc7vAFSmkRAEsiKhXfW1m,3UrWYx8y9N5o9GYneSe6zyyHRTZzxwvcipQfHHYh7tEs,True,1357376,339344,2081,1040,1041,4BnQKPLuE3DMTtxp8MjUBytgnhvxqq3ZTqZHTVZo4JJh,83248,602238,-518990,613
2022-01-20 21:22:33-05:00,4252,DC4UVUDFWL3gVtgkX9hPtFgtxaA8DH5p94i4k9U3wyWv,3HCWqVvQQfRgSKitsTjGTduJ82ointZUSNtj13uea4kD,True,922343452,230585863,1397497,698748,698749,HfEnetJ7uBSmZWCjBNxdvv9HEC5nsW4wDV7wu6WnhWan,55899890,395728862,-339828972,606
2022-01-20 21:24:39-05:00,4253,H3x9b27yHVdCxvtDf7mmJxkNeubcmQMwfAkLTYADPWNv,HGVCCz23rWx78vrTB2wvm2aesbLZuYFhhNuznGiSSAyA,True,2393369482,598342370,3744393,1872196,1872197,HfEnetJ7uBSmZWCjBNxdvv9HEC5nsW4wDV7wu6WnhWan,149775754,569944590,-420168836,625
2022-01-20 21:46:26-05:00,4254,3Xbsek5MsEGoWr3G9yhuohREr26B2vSQcjqXdspTFHta,2rPxkUiMo9wGDq8EvAiwY3ngRpKmL223cBWWNTYoBmFp,True,102092991,25523247,159308,79654,79654,HfEnetJ7uBSmZWCjBNxdvv9HEC5nsW4wDV7wu6WnhWan,6372346,28103249,-21730903,624
2022-01-20 21:59:29-05:00,4255,3XZLp6JyrQYnufa1obczXqmK6cNR29ZMW1FdCYbWNTCP,8kUTi1Prio14m9LjCj6Mari6pXwJTYkE1mp21LMn235p,True,138259,34563,215,107,108,4BnQKPLuE3DMTtxp8MjUBytgnhvxqq3ZTqZHTVZo4JJh,8625,47056,-38431,623
2022-01-20 22:07:10-05:00,4256,J3ggP7ZxL8HRh3CBp5iYG2WgjLyNSAWYT46uC9VYDLCz,2FqTRiRPiLvdAH2BS5vroVntpsSXvTJEn5UHWmtKHzh9,True,20867802,5216950,32483,16241,16242,3zqXX6kzhkbW3d4TwD2CNjMRwxTbREXySekvq37kfCNk,1299328,7360801,-6061473,622
2022-01-20 22:08:41-05:00,4257,D9VKhnfLLCrntDGFYSfoxFaY76VnHmYZ1ZbyFXdKdibz,2hRCRH2pMDyQGYcXHa8Y6BZo6FbcGZf5VJC1v8Bp6tGa,True,65273478,16318369,102020,51010,51010,HfEnetJ7uBSmZWCjBNxdvv9HEC5nsW4wDV7wu6WnhWan,4080806,27162898,-23082092,625
2022-01-20 22:08:41-05:00,4258,A4tDE948CPFPh1UwHb8sXryfKktbxZ8BCkqXgA5DJHA8,3zXeKMrsEpCe5fQumLNzCgpxcG1kLJFEAtJuqxLsC6ZG,True,61490325,15372581,95547,47773,47774,3zqXX6kzhkbW3d4TwD2CNjMRwxTbREXySekvq37kfCNk,3821907,29488653,-25666746,621
2022-01-20 22:08:41-05:00,4259,399591e8XgY52yCMorCQ2WL6dQZTC485ZooHtmGuirhZ,JCiXAooFmKmEPQ2S7C8iSk6CLcTyrPEe1SsPSLyUGySe,True,759674,189918,1177,588,589,3zqXX6kzhkbW3d4TwD2CNjMRwxTbREXySekvq37kfCNk,47105,469904,-422799,620
2022-01-20 22:08:41-05:00,4260,4uygLJDk9DFCifJ56YwMrEsvd3oQNq8tYSLnMCyWorS6,GimL4uKGvg3FFmFQSWzAcjstv3Vmk5NMgDGMKTuXYVpB,True,368129873,92032468,571400,285700,285700,3zqXX6kzhkbW3d4TwD2CNjMRwxTbREXySekvq37kfCNk,22856024,165745795,-142889771,620
2022-01-20 22:08:43-05:00,4261,8E3K7vCHJ2xjdFofPRGLbMxrkm8UYEi926QmXPAFwsqe,4qHUDA1c43Dg4qi1ZPKqmpGYiEMUZ6r4UuzB5ftHCEhW,True,1006111488,251527872,1553942,776971,776971,3zqXX6kzhkbW3d4TwD2CNjMRwxTbREXySekvq37kfCNk,62157684,557602131,-495444447,617
2022-01-20 22:09:03-05:00,4262,8kJu5aqVSmW8FSZR9h6F75ftn9V2U9uMLBEKeqRaC855,FhVHByujkvwwtjTVpZ4mqSUqoMoBgeLUc5H7rbz3FgAt,True,62708272,15677068,97929,48964,48965,72FwbpFGoLEazJEdpqNtPNefsadUrimUqma9wSoy4qiS,3917177,38834242,-34917065,624
2022-01-20 22:09:19-05:00,4263,FnAT8HKGgisYfeAbxKU2gSbCp8KbZHULRpaJX1NVijHy,2u637Crc2QzfSJmCnRNqeib3aZQVn4NGncpgM3Ph6jvm,True,24308070,6077017,37566,18783,18783,3zqXX6kzhkbW3d4TwD2CNjMRwxTbREXySekvq37kfCNk,1502643,8992770,-7490127,618
2022-01-20 22:09:19-05:00,4264,9KD2AifD5wFD4QkHYuawXbJgLWHrfj2QPF3fT8jhGVA5,Ga9gAqmkuHbqrr31sUFPqa1xa5WNxLWJWGPUaMxQqLdj,True,690166,172541,1074,537,537,3zqXX6kzhkbW3d4TwD2CNjMRwxTbREXySekvq37kfCNk,42981,433612,-390631,622
2022-01-20 22:10:16-05:00,4265,H3394S5wdbwXB4scjGAY8NsXxCdGy1Xebct18s42FM1K,Hz84L1EquzhCvBJP75ScKug46hYGdNMVNH16AdG4y5D8,True,33271718,8317929,51627,25813,25814,4BnQKPLuE3DMTtxp8MjUBytgnhvxqq3ZTqZHTVZo4JJh,2065085,14402775,-12337690,620
2022-01-20 22:10:16-05:00,4266,FsMiJiJZibohKoV5QRisWCjzuFd86xSxFb4m73AQmu93,7p3TSKBaG9SV2YNDnhutQKacPKpTTmgsEfzmK51t6sYb,True,147859636,36964909,228826,114413,114413,4BnQKPLuE3DMTtxp8MjUBytgnhvxqq3ZTqZHTVZo4JJh,9153072,54866001,-45712929,619
2022-01-20 22:10:16-05:00,4267,HwosLQgDY1xtHQRQ4hzroPQHFWssPzTj5vRkP37FcviB,HKTNEYNXrephNkH7apbobK4mcQXcNayQA4W1NgM6sLr8,True,32322609,8080652,49692,24846,24846,HfEnetJ7uBSmZWCjBNxdvv9HEC5nsW4wDV7wu6WnhWan,1987698,11133467,-9145769,614
2022-01-20 22:10:16-05:00,4268,A36aouot1oFLUtswuBUM4EVcis9chKaSJu53MRoPDjab,33U9gpq1RRFMGWDrWa3ezXXkwgBewdAS6QGgGVPtGvqb,True,190609383,47652345,293428,146714,146714,4BnQKPLuE3DMTtxp8MjUBytgnhvxqq3ZTqZHTVZo4JJh,11737134,70340949,-58603815,615
2022-01-20 22:10:20-05:00,4269,AUH6YGBV8tDVX1E1WTo92Mubfx1DGsqfGeyUBqxo4fSr,33QZgMwmW32WuvmxD8XNbmF9ea88bLe3YTtNwHV73Wwu,True,147814014,36953503,225197,112598,112599,4BnQKPLuE3DMTtxp8MjUBytgnhvxqq3ZTqZHTVZo4JJh,9007888,56097581,-47089693,609
2022-01-20 22:10:20-05:00,4270,3VdSA9CED9f5swRwHX2U15U7J6Muaq8VPnCNy9CaGDHe,2YYstfnfdYic5NWmEbcUEHpccNUVd1EhuCkExvMsoMk8,True,3547919,886979,5439,2719,2720,4BnQKPLuE3DMTtxp8MjUBytgnhvxqq3ZTqZHTVZo4JJh,217560,2209437,-1991877,613
2022-01-20 22:10:29-05:00,4271,36ByQojnxEckWdQTjqHfxKqCx9yjqWQsPsZyqaN72UWR,AZoirtS1fjX61agRM64tqThVinnJTh3BWgiHyNHPTgZP,True,421080,105269,656,328,328,3zqXX6kzhkbW3d4TwD2CNjMRwxTbREXySekvq37kfCNk,26251,258663,-232412,623
2022-01-20 22:10:51-05:00,4272,5kwvkEtRFFD84j4ntVgxkacadgJaFvQ9JLhJqzLR7Y3G,GpMMkTv9T7y8DTiizuoJUsWvnSk3GSxADjRMGyYpryxm,True,16628743,4157185,25828,12914,12914,HfEnetJ7uBSmZWCjBNxdvv9HEC5nsW4wDV7wu6WnhWan,1033129,5912724,-4879595,621
2022-01-20 22:11:19-05:00,4273,5Rxuqgs4CaSKbfDXqBMFXkLTQ9dxrUjThXzoy3ouYVtK,BgvbKru66ebrGUcFFymGTmsaQv6GgcGMybiWaXqzBtwX,True,109310,27327,166,83,83,4BnQKPLuE3DMTtxp8MjUBytgnhvxqq3ZTqZHTVZo4JJh,6664,71823,-65159,609
2022-01-20 22:11:23-05:00,4274,3ogBPSRcKfmwzgumVDHBkXLi1eCsEFG2xzSJgD4LQDNy,7TXyqWgJqfe71MSWFA2n7ufZbUdzf7JJoWej8FNNtMXo,True,11084501,2771125,17004,8502,8502,4BnQKPLuE3DMTtxp8MjUBytgnhvxqq3ZTqZHTVZo4JJh,680196,4777482,-4097286,613
2022-01-20 22:11:25-05:00,4275,8xvLGVeDmhVYQhN2ZpWkVG9jCrukRsNQ4926a4TMiZqa,9ciBySSjvADwp47WkETiFWZKVTFL8Hf1XvK7aSxhcgQS,True,13096348,3274087,20112,10056,10056,4BnQKPLuE3DMTtxp8MjUBytgnhvxqq3ZTqZHTVZo4JJh,804489,6141542,-5337053,614
2022-01-20 22:11:27-05:00,4276,8T4WK27RvWVGqPuNqY6whk1fmU4vd5qaUQPZG1GJ79bh,DvSz7knS8N3K7L6JhQf1s4mJSyxB8uJXNQXtyjJn8QRL,True,65176025,16294005,100333,50166,50167,4BnQKPLuE3DMTtxp8MjUBytgnhvxqq3ZTqZHTVZo4JJh,4013336,32110798,-28097462,615
2022-01-20 22:11:30-05:00,4277,A1j2G5FZRyWSjFt6dK87WHhLkQrPUVqHaM3KhSzhAKDT,2fMiHLYm4pL3YCd8aveTR4mT9uVxztQeMwb5eRZb4wUW,True,367809,91952,561,280,281,3uL2NSR2ZdDqCiKfzA5SwwpddAnit22DBJo6uvvz1rRs,22472,188549,-166077,610
2022-01-20 22:11:31-05:00,4278,7hTjPRQSYAoWHhtpsVz2oKK5SAuFJd8dPHShKgKJq8dy,6DcHcrtcXR88d8e2KahhAiWTeRznNfF8oXLHmh5wE7wz,True,502141158,125535289,780501,390250,390251,4BnQKPLuE3DMTtxp8MjUBytgnhvxqq3ZTqZHTVZo4JJh,31220079,216810501,-185590422,621
2022-01-20 22:11:31-05:00,4279,CbhrZUdan1axNDFUrX1ZuEohfNMEGrszKSkk6pppVQuw,DHEAjJNtuEePezYAv77thWabbVxxqQpfuiC6moRSrpG1,True,48632377,12158094,75819,37909,37910,4BnQKPLuE3DMTtxp8MjUBytgnhvxqq3ZTqZHTVZo4JJh,3032795,30331804,-27299009,623
2022-01-20 22:11:52-05:00,4280,7ptPfZnqDCvTWotn8wPGyzERTJYLBgk47j7qf8Ciq941,AfAGcFqFFPi6LCQXydgsPWidN35c7NbhBa7RLEaDQQCu,True,5400112,1350026,8439,4219,4220,4BnQKPLuE3DMTtxp8MjUBytgnhvxqq3ZTqZHTVZo4JJh,337582,1835586,-1498004,625
2022-01-20 22:12:29-05:00,4281,JDeYjCLpfnzcfxDFgHf4aBcHsajwdR14GUaKAA9euzVf,EJbvKoyMZcoCx4vWa61uMbW2vr6mUhrgEuECdteVBuZZ,True,4079841,1019960,6272,3136,3136,HfEnetJ7uBSmZWCjBNxdvv9HEC5nsW4wDV7wu6WnhWan,250907,2651824,-2400917,614
2022-01-20 22:12:38-05:00,4282,6VJcr3VAEcEZaHEpt48QL8QxHKABufVp8n2JSEVTLh9U,8naR6kiySKj3vai9dCetdgCnCHgf2oyLjGqKTJ3Lz64Y,True,909380752,227345187,1422379,711189,711190,3zqXX6kzhkbW3d4TwD2CNjMRwxTbREXySekvq37kfCNk,56895185,461073558,-404178373,625
2022-01-20 22:12:38-05:00,4283,AWvHDdb2ikqV8wc7qQ8azbvNTZdixMNxhQjhQdhayYtR,9EpgEPBb1nog6aQeFdMXfSRiLSnzGQFQ39mbLdCxgYTv,True,24242395,6060598,37908,18954,18954,3zqXX6kzhkbW3d4TwD2CNjMRwxTbREXySekvq37kfCNk,1516340,8737982,-7221642,625
2022-01-20 22:21:46-05:00,4284,4ne6vC7qdxQYHJCsaeFAKZrKdFt2SwXGHQ3jrMHqt4DL,Cf1dLHY2WXH9rXbRKq5TT8THbdo9SdNUZq4rYhRCF9z,True,37328022,9332005,58390,29195,29195,3zqXX6kzhkbW3d4TwD2CNjMRwxTbREXySekvq37kfCNk,2335610,11405591,-9069981,625
2022-01-20 22:22:43-05:00,4285,GjQQ2fQ7mrGjWZwjVYFUKp9NM1LmfkhEo675ovU5SPa8,ECgVUMRY5nB4MALs5drDyipF7YohCPuJpj2UegCs7HMn,True,8357988,2089497,13078,6539,6539,3zqXX6kzhkbW3d4TwD2CNjMRwxTbREXySekvq37kfCNk,523123,4197840,-3674717,625
2022-01-20 22:23:01-05:00,4286,5eMLdQ4gYA5iqvTXSNdGvctHp7s5VpyFuwtJKqx6chBc,Ckxc5K39nkBNXBTmFTM8J48R7wGqNm3vHKZu4G5baumZ,True,171683498,42920874,268128,134064,134064,3uL2NSR2ZdDqCiKfzA5SwwpddAnit22DBJo6uvvz1rRs,10725151,68208866,-57483715,624
2022-01-20 22:25:29-05:00,4287,F9s8a7Cpiw5dw3a2aNFMofqwyDWNXvDLnSdJzoj1gRiV,GpKsQKJD79KBRWdCTkyi4zX7NaoCWsLUjrKxAwJB6o6s,True,11042042,2760510,17278,8639,8639,3zqXX6kzhkbW3d4TwD2CNjMRwxTbREXySekvq37kfCNk,691149,3228721,-2537572,625
2022-01-20 22:26:22-05:00,4288,Bsr6kx1B6BSEd5UnJ7Z61M49iUb3bFrDVhiEtMVtPDF2,3CFd1pUJAJPA9fobwn4Jj2mRju1CWmoop4Mh4znypNWT,True,15275136,3818784,22859,11429,11430,3uL2NSR2ZdDqCiKfzA5SwwpddAnit22DBJo6uvvz1rRs,914388,6575631,-5661243,598
2022-01-20 22:26:22-05:00,4289,6NJFN855M3Q3RLTDNo57gTgAmwPD6G2E3WvMb1m5eNCN,3YpqNnonsvXaRT4nCC3G5FZx1jjVtbDPc36LiR6WK5jR,True,39696926,9924231,60159,30079,30080,3uL2NSR2ZdDqCiKfzA5SwwpddAnit22DBJo6uvvz1rRs,2406390,25456611,-23050221,606
2022-01-20 22:26:22-05:00,4290,DYCYiQFH9QHzCo3eAw1pFoDu7pzwFMo1E2WDZjVFRz5w,CPh4FWsGak1kd1WFEH9qBjNhnun3R2tHtZA57zW8ugn5,True,26145250,6536312,40460,20230,20230,3uL2NSR2ZdDqCiKfzA5SwwpddAnit22DBJo6uvvz1rRs,1618434,15215424,-13596990,619
2022-01-20 22:26:22-05:00,4291,DkvR2xUPMyXWGGkUSmDSfhp7RtvMkfbT1ThKCS3TwrXd,F7jYV6TtT1LZ5XCNn1zkbUfNMo4gGcQUczAQy1jLHpaW,True,318403551,79600887,496843,248421,248422,3uL2NSR2ZdDqCiKfzA5SwwpddAnit22DBJo6uvvz1rRs,19873725,155517353,-135643628,624
2022-01-20 22:26:25-05:00,4292,8swGZMrPrLAxZd7MxTbkCL13k3DmAJUw41jCp6Xo6awW,3fKnX7yTNXAT4uMmXVdTy47ALJT8h8YSD3WiBb4BGuzH,True,121298127,30324531,188507,94253,94254,3zqXX6kzhkbW3d4TwD2CNjMRwxTbREXySekvq37kfCNk,7540294,60634419,-53094125,621
2022-01-20 22:26:25-05:00,4293,7CSCMFa9W52tBDVUbXbc3woAy3GByeA1wPJdp3MgznPa,3447ptuVFu6G8B6N63RmS8mRv4n9PfHneypHLvbeaGLn,True,55557290,13889322,86547,43273,43274,3zqXX6kzhkbW3d4TwD2CNjMRwxTbREXySekvq37kfCNk,3461892,29249433,-25787541,623
2022-01-20 22:26:25-05:00,4294,D64rDiWT3YG28fCgXCmbNjYa2JakZbpKQ1D2XuLChUfV,8WmMWq8cTsGQym5pUbHm9dPCpJugBeWUMVERYFGLxWHj,True,18646559,4661639,28519,14259,14260,3zqXX6kzhkbW3d4TwD2CNjMRwxTbREXySekvq37kfCNk,1140788,7520306,-6379518,611
2022-01-20 22:26:25-05:00,4295,GufVttJatW8NLeztT1NRQSLZpQNRk45kaG41p3QcWhx7,GTJUsWoWRyeafYJVhx2aRo8NE94U5UrBjaehmJ4PRUhn,True,14640828,3660207,22302,11151,11151,3uL2NSR2ZdDqCiKfzA5SwwpddAnit22DBJo6uvvz1rRs,892101,5231473,-4339372,609
2022-01-20 22:27:22-05:00,4296,GxFxvEUdWofneMmVvhCSScH9V6Zia5WJ2J9q6CpPnaq3,ATLykiHDii3Lw53MoZXwqu1FbBNPJbVNVGe2SoQMjVmY,True,1677137,419284,2590,1295,1295,3zqXX6kzhkbW3d4TwD2CNjMRwxTbREXySekvq37kfCNk,103614,960035,-856421,617
2022-01-20 22:28:19-05:00,4297,J1sBDjpdBZcsSBS5eg95SSRjRqmQUR9cXJCsLJu8yCUt,F5wRpD2senMkGbL8Uquqo8W9x5NQDDa268dHuVFAZCww,True,2518351,629587,3885,1942,1943,3uL2NSR2ZdDqCiKfzA5SwwpddAnit22DBJo6uvvz1rRs,155420,1247003,-1091583,617
2022-01-20 22:28:23-05:00,4298,9E97vZ6evPgg1Ao8KwvjjZhBFW6dXZrrJENk1HvZ3SU,D7U38PB8BXLwUVKbRNv9po7VcFdnn7Y4tWY9xpRiNJsT,True,36258704,9064676,56727,28363,28364,3uL2NSR2ZdDqCiKfzA5SwwpddAnit22DBJo6uvvz1rRs,2269087,10689233,-8420146,625
2022-01-20 22:28:24-05:00,4299,3idUQDMPAN9f6F6BipHAYFZyhG5JADey1y7JcFYx5BRh,D6UMk8WsSRahs4nGyi9DLt2HyZQy4wAywDwL31sL8BVj,True,26849993,6712498,41598,20799,20799,HfEnetJ7uBSmZWCjBNxdvv9HEC5nsW4wDV7wu6WnhWan,1663941,6907518,-5243577,619
2022-01-20 22:28:27-05:00,4300,5hJereyPSCNUrGW7TdYXHKjhXMWTbGZzc2GF9MWksLJE,AUE3NpqaeamHGBKUVuKnUhnBb4Lzt7xWU1FHMu1Hq5dC,True,359974864,89993716,553213,276606,276607,3uL2NSR2ZdDqCiKfzA5SwwpddAnit22DBJo6uvvz1rRs,22128523,111317876,-89189353,614
2022-01-20 22:29:36-05:00,4301,C33hfnDHzVwKXxr6AwFAXhd1vJYrPKhtqc75Qpjm19Zt,2WYBMSyrHQEYZqxEtxBMe2xn7eioJEGsudqdCmGvssGh,True,34277460,8569365,53584,26792,26792,3zqXX6kzhkbW3d4TwD2CNjMRwxTbREXySekvq37kfCNk,2143367,7940113,-5796746,625
2022-01-20 22:29:50-05:00,4302,HmspGdpobjC5Vbmo3FcKdw4RLPN7wJKxv3uKqDjVhLee,3YEX8TzdyJyuHo76Kw76imVCJjzrC9m188YuRKvwwSwD,True,222771491,55692872,348214,174107,174107,3zqXX6kzhkbW3d4TwD2CNjMRwxTbREXySekvq37kfCNk,13928583,54756240,-40827657,625
2022-01-20 22:30:05-05:00,4303,BgnsCfJ54ReunUtwPJLzkW4PWnqpBDWGNYxsW5PvDrbK,KpMqEkQ9dKMgCevsEK895wHd3fCLRPSzDmJSv3tKU4u,True,7578336857,1894584214,11731353,5865676,5865677,3uL2NSR2ZdDqCiKfzA5SwwpddAnit22DBJo6uvvz1rRs,469254137,3282068941,-2812814804,619
2022-01-20 22:30:05-05:00,4304,DY6k3Dkwe18iLneaT8Xo3VpJWB6V4jWwQQjoDvEzdg2j,3GGV7S9FpRQGbARBXkvGFVqLrmw8JvYAcpnR1aKVUY2f,True,6463945,1615986,9943,4971,4972,3zqXX6kzhkbW3d4TwD2CNjMRwxTbREXySekvq37kfCNk,397759,4166609,-3768850,615
2022-01-20 22:30:06-05:00,4305,3MEiFqy4F9nBW8gHxvGjv7norSBHwxhbzzNKngPk1RHq,2tcsJ4NUJegcEfHNwWPh979yKjKmq568CpNm5iWGbuoR,True,17375175,4343793,26615,13307,13308,3uL2NSR2ZdDqCiKfzA5SwwpddAnit22DBJo6uvvz1rRs,1064627,6939460,-5874833,612
2022-01-20 22:30:47-05:00,4306,3Xbsek5MsEGoWr3G9yhuohREr26B2vSQcjqXdspTFHta,2rPxkUiMo9wGDq8EvAiwY3ngRpKmL223cBWWNTYoBmFp,True,75038735,18759683,116384,58192,58192,HfEnetJ7uBSmZWCjBNxdvv9HEC5nsW4wDV7wu6WnhWan,4655372,22484741,-17829369,620
2022-01-20 22:31:03-05:00,4307,GKCeRcHQYMhcTwEm5wu1SbkXAT19gjGUGji43HS36B5N,EYQKX5sWsmXoge5xbTcMYAjvRbSUTXXpHEzckPY2LV8W,True,1283093,320773,2005,1002,1003,3zqXX6kzhkbW3d4TwD2CNjMRwxTbREXySekvq37kfCNk,80239,379020,-298781,625
2022-01-20 22:31:33-05:00,4308,9WJBnVi84E926j7xEd566WzrZJkPJWRgmEnYj9vyjuad,4dLaFS5F7TGyLdwuJLMGkz3bSL53aHzd9ZfpNmhHxXeF,True,8022201,2005550,12402,6201,6201,4BnQKPLuE3DMTtxp8MjUBytgnhvxqq3ZTqZHTVZo4JJh,496092,4620123,-4124031,618
2022-01-20 22:31:46-05:00,4309,72woixtGAuGazCMfsYfYBYLP7FuRj8Fwz9fynFo4MCE4,5237BmWkKf58PBeTUEiu3Ld5uKXEe8wcrJRmCnUoWWku,True,364487768,91121942,569176,284588,284588,3zqXX6kzhkbW3d4TwD2CNjMRwxTbREXySekvq37kfCNk,22767041,105066308,-82299267,624
2022-01-20 22:32:12-05:00,4310,8trkirSQNdMmAcJdeswxs5cPjH8dD6U4eJtWiAdMsrDB,HaSzpQ45x2MipfN17U6jGBxX8tXboomVDhXNSrnEfLDr,True,1728281,432070,2701,1350,1351,3zqXX6kzhkbW3d4TwD2CNjMRwxTbREXySekvq37kfCNk,108059,838163,-730104,625
2022-01-20 22:32:48-05:00,4311,Br1j5Ftafei7ysu5SmqVZSoRe4uS4qCPeKSPHg55pyiE,G8fc7QvXjfkgBFvAVUgJFQS3VaF1biL9rktBExGa87Ks,True,3619126798,904781698,5647676,2823838,2823838,HfEnetJ7uBSmZWCjBNxdvv9HEC5nsW4wDV7wu6WnhWan,225907067,1460488843,-1234581776,624
2022-01-20 22:32:50-05:00,4312,DXEJNyHSCbGZezXHy2xQaSzd37dwJs4dMTgt5VF5UZAG,7fCYM9DWrAX7vgZ11CwQMNd5NU8FB1yrbctxHaPYshpB,True,24302566,6075641,37966,18983,18983,4BnQKPLuE3DMTtxp8MjUBytgnhvxqq3ZTqZHTVZo4JJh,1518677,7213081,-5694404,624
2022-01-20 22:32:59-05:00,4313,FnAT8HKGgisYfeAbxKU2gSbCp8KbZHULRpaJX1NVijHy,2u637Crc2QzfSJmCnRNqeib3aZQVn4NGncpgM3Ph6jvm,True,17847328,4461832,27033,13516,13517,3zqXX6kzhkbW3d4TwD2CNjMRwxTbREXySekvq37kfCNk,1081352,7082700,-6001348,605
2022-01-20 22:32:59-05:00,4314,A36aouot1oFLUtswuBUM4EVcis9chKaSJu53MRoPDjab,33U9gpq1RRFMGWDrWa3ezXXkwgBewdAS6QGgGVPtGvqb,True,140249897,35062474,218414,109207,109207,4BnQKPLuE3DMTtxp8MjUBytgnhvxqq3ZTqZHTVZo4JJh,8736565,55398197,-46661632,622
2022-01-20 22:32:59-05:00,4315,8kJu5aqVSmW8FSZR9h6F75ftn9V2U9uMLBEKeqRaC855,FhVHByujkvwwtjTVpZ4mqSUqoMoBgeLUc5H7rbz3FgAt,True,45991706,11497926,69493,34746,34747,3zqXX6kzhkbW3d4TwD2CNjMRwxTbREXySekvq37kfCNk,2779750,30007257,-27227507,604
2022-01-20 22:33:01-05:00,4316,H3394S5wdbwXB4scjGAY8NsXxCdGy1Xebct18s42FM1K,Hz84L1EquzhCvBJP75ScKug46hYGdNMVNH16AdG4y5D8,True,24454087,6113521,37843,18921,18922,3uL2NSR2ZdDqCiKfzA5SwwpddAnit22DBJo6uvvz1rRs,1513756,11266778,-9753022,619
2022-01-20 22:33:01-05:00,4317,4uygLJDk9DFCifJ56YwMrEsvd3oQNq8tYSLnMCyWorS6,GimL4uKGvg3FFmFQSWzAcjstv3Vmk5NMgDGMKTuXYVpB,True,269917762,67479440,402624,201312,201312,3zqXX6kzhkbW3d4TwD2CNjMRwxTbREXySekvq37kfCNk,16104981,129458393,-113353412,596
2022-01-20 22:33:01-05:00,4318,2jDRvE3pQNjWy1NRFa4tzB3KmU5UkbUCHw8sQRFujo66,C4zNi2szDrEEh4coTF3WRUghfP4ZwAVVSYTLWfkejQRu,True,249872488,62468121,379703,189851,189852,3zqXX6kzhkbW3d4TwD2CNjMRwxTbREXySekvq37kfCNk,15188154,106909096,-91720942,607
2022-01-20 22:33:01-05:00,4319,A4tDE948CPFPh1UwHb8sXryfKktbxZ8BCkqXgA5DJHA8,3zXeKMrsEpCe5fQumLNzCgpxcG1kLJFEAtJuqxLsC6ZG,True,45082234,11270558,67271,33635,33636,3zqXX6kzhkbW3d4TwD2CNjMRwxTbREXySekvq37kfCNk,2690850,22976604,-20285754,596
2022-01-20 22:33:01-05:00,4320,8E3K7vCHJ2xjdFofPRGLbMxrkm8UYEi926QmXPAFwsqe,4qHUDA1c43Dg4qi1ZPKqmpGYiEMUZ6r4UuzB5ftHCEhW,True,737731089,184432772,1093780,546890,546890,3zqXX6kzhkbW3d4TwD2CNjMRwxTbREXySekvq37kfCNk,43751215,432238794,-388487579,593
2022-01-20 22:33:01-05:00,4321,AUH6YGBV8tDVX1E1WTo92Mubfx1DGsqfGeyUBqxo4fSr,33QZgMwmW32WuvmxD8XNbmF9ea88bLe3YTtNwHV73Wwu,True,108748422,27187105,166765,83382,83383,3zqXX6kzhkbW3d4TwD2CNjMRwxTbREXySekvq37kfCNk,6670602,44100949,-37430347,613
2022-01-20 22:33:01-05:00,4322,J3ggP7ZxL8HRh3CBp5iYG2WgjLyNSAWYT46uC9VYDLCz,2FqTRiRPiLvdAH2BS5vroVntpsSXvTJEn5UHWmtKHzh9,True,15278938,3819734,22373,11186,11187,3zqXX6kzhkbW3d4TwD2CNjMRwxTbREXySekvq37kfCNk,894931,5812970,-4918039,585
2022-01-20 22:33:01-05:00,4323,CxLFMBDFkoMvpK9YUf7WtCq6hn7k3QACAuetAnGjU6KA,2gE52a1GWQnS6ifV6eVtKQyr13LXP5Jdt3yG9SjGPJPF,True,631351654,157837913,920486,460243,460243,3zqXX6kzhkbW3d4TwD2CNjMRwxTbREXySekvq37kfCNk,36819467,155414815,-118595348,583
2022-01-20 22:33:01-05:00,4324,FsMiJiJZibohKoV5QRisWCjzuFd86xSxFb4m73AQmu93,7p3TSKBaG9SV2YNDnhutQKacPKpTTmgsEfzmK51t6sYb,True,108655625,27163906,167128,83564,83564,3zqXX6kzhkbW3d4TwD2CNjMRwxTbREXySekvq37kfCNk,6685144,43209924,-36524780,615
2022-01-20 22:33:01-05:00,4325,399591e8XgY52yCMorCQ2WL6dQZTC485ZooHtmGuirhZ,JCiXAooFmKmEPQ2S7C8iSk6CLcTyrPEe1SsPSLyUGySe,True,556878,139219,826,413,413,3zqXX6kzhkbW3d4TwD2CNjMRwxTbREXySekvq37kfCNk,33050,363028,-329978,593
2022-01-20 22:33:01-05:00,4326,3VdSA9CED9f5swRwHX2U15U7J6Muaq8VPnCNy9CaGDHe,2YYstfnfdYic5NWmEbcUEHpccNUVd1EhuCkExvMsoMk8,True,2610630,652657,4045,2022,2023,3zqXX6kzhkbW3d4TwD2CNjMRwxTbREXySekvq37kfCNk,161811,1706030,-1544219,619
2022-01-20 22:33:02-05:00,4327,D9VKhnfLLCrntDGFYSfoxFaY76VnHmYZ1ZbyFXdKdibz,2hRCRH2pMDyQGYcXHa8Y6BZo6FbcGZf5VJC1v8Bp6tGa,True,47859219,11964804,72072,36036,36036,4BnQKPLuE3DMTtxp8MjUBytgnhvxqq3ZTqZHTVZo4JJh,2882896,21290553,-18407657,602
2022-01-20 22:33:03-05:00,4328,9KD2AifD5wFD4QkHYuawXbJgLWHrfj2QPF3fT8jhGVA5,Ga9gAqmkuHbqrr31sUFPqa1xa5WNxLWJWGPUaMxQqLdj,True,506735,126683,775,387,388,4BnQKPLuE3DMTtxp8MjUBytgnhvxqq3ZTqZHTVZo4JJh,31017,334881,-303864,612
2022-01-20 22:33:25-05:00,4329,yU8LyPdpD2gV6KBQDfm6Kc55BrUdM63R98Bo3im6okB,7ZmFdy9nbZMDScyzeMZF3ANqRyxrr5qmNYPmwTv1M14v,True,213919742,53479935,332656,166328,166328,HfEnetJ7uBSmZWCjBNxdvv9HEC5nsW4wDV7wu6WnhWan,13306271,48894029,-35587758,622
2022-01-20 22:33:44-05:00,4330,C1CsbgQFvEvSXzuVHTr39tQHr3drDhjxeYiotd8eNocF,4rAaTCAMj5VpgNVKiYizabH7cMLhEA12seu2QXQNTyV3,True,33222337,8305584,51934,25967,25967,72FwbpFGoLEazJEdpqNtPNefsadUrimUqma9wSoy4qiS,2077372,8549035,-6471663,625
2022-01-20 22:34:06-05:00,4331,DDsY5V3F9wnEGBoQFCEf1hvEYuKUaJdysbc7TxhNqe9G,5oBCGzvy8odB8MCxCUvPDqYCnTyteZ4Yy1JDroroygbi,True,38799613,9699903,60276,30138,30138,HfEnetJ7uBSmZWCjBNxdvv9HEC5nsW4wDV7wu6WnhWan,2411044,11037162,-8626118,621
2022-01-20 22:34:09-05:00,4332,D7XummfEc3NTK4qMvZegV3FrYuqc8mNgnQu3ujwemZtg,HHiRcecqzW7sGFTio7Ph6TYv3dGt64KWv4DEKgKm84fQ,True,2917304,729326,4560,2280,2280,4BnQKPLuE3DMTtxp8MjUBytgnhvxqq3ZTqZHTVZo4JJh,182424,1695904,-1513480,625
2022-01-20 22:34:27-05:00,4333,8trFFwvXKKMwMx952ugCZmqyw29e1HxEKBuQmFn8ZwTf,FsD7gCvHXM3QchQiDcd292ksy5afZMWApneNTat5ndeS,True,157265097,39316274,242843,121421,121422,3uL2NSR2ZdDqCiKfzA5SwwpddAnit22DBJo6uvvz1rRs,9713746,41308327,-31594581,617
2022-01-20 22:34:37-05:00,4334,2mfcg17QocKKvDcqDH88TwxHRiS8dAQiJAGoAh1brns9,8aQLELBgaA9eXsxSciMjxWv8B1hpbUPfLwqVjEnasZbe,True,86139006,21534751,133131,66565,66566,3zqXX6kzhkbW3d4TwD2CNjMRwxTbREXySekvq37kfCNk,5325268,25964593,-20639325,618
2022-01-20 22:34:40-05:00,4335,B9WJfmrYEkVH3L1UWz4qqWpaexHydymbzvEfwNVtB9BV,6mQb4yzGq8jE1NbweKCKSbevnnYVhHYxyc6Gz2a5kJLn,True,176277322,44069330,264330,132165,132165,3zqXX6kzhkbW3d4TwD2CNjMRwxTbREXySekvq37kfCNk,10573238,46442413,-35869175,599
2022-01-20 22:35:18-05:00,4336,GNkEoVMpNAgfyDBZ986MR9BEVc485xpLuZWwSCyZk5zJ,AT2eiaMyZNHZGqgTdie8QjLWCTrWSdkRmQxU2vZNgtDs,True,30936647,7734161,47714,23857,23857,3zqXX6kzhkbW3d4TwD2CNjMRwxTbREXySekvq37kfCNk,1908594,7508647,-5600053,616
2022-01-20 22:35:18-05:00,4337,8abFwhhZyq3xkvjp4NWDBt7qAPXBbzBxksUk8SAUeVkN,A9u4dhWZbBwthC4WXQg1Dfp3wHYXr67SGs5na1EQ1k3r,True,30192404,7548099,47061,23530,23531,3zqXX6kzhkbW3d4TwD2CNjMRwxTbREXySekvq37kfCNk,1882476,7330180,-5447704,623
2022-01-20 22:35:22-05:00,4338,H3x9b27yHVdCxvtDf7mmJxkNeubcmQMwfAkLTYADPWNv,HGVCCz23rWx78vrTB2wvm2aesbLZuYFhhNuznGiSSAyA,True,1759128599,439782149,2743293,1371646,1371647,HfEnetJ7uBSmZWCjBNxdvv9HEC5nsW4wDV7wu6WnhWan,109731731,460839751,-351108020,623
2022-01-20 22:35:22-05:00,4339,4xn9vTtLZyNtCbBLLpcXUMWU8AnnZCov9rJaY6rew16T,5UNWdFw2CP44qS8oc4uPt8zxw6zFg8oXz8SUCedZLLEC,True,12386483,3096620,19381,9690,9691,HfEnetJ7uBSmZWCjBNxdvv9HEC5nsW4wDV7wu6WnhWan,775249,3368868,-2593619,625
2022-01-20 22:35:34-05:00,4340,FS5xx53Bo65G21gJLta7LEEiS132VJM1kGpUzuqyfzoy,2kbTLjdBBA9K1coxKmwmYbjq2heSnuNg4Nh2EfVNYgwj,True,156062435,39015608,244099,122049,122050,3zqXX6kzhkbW3d4TwD2CNjMRwxTbREXySekvq37kfCNk,9763962,40924282,-31160320,625
2022-01-20 22:36:11-05:00,4341,DBqRWp8dv3VLQC2dNAriLMVVAqSEpeXGoFRbcPW9busY,EM9N5ybnQdbRcSLdm7jY5zNyogYNkPD3BykBNaT6cvco,False,214663,214663,10140,507,9633,3zqXX6kzhkbW3d4TwD2CNjMRwxTbREXySekvq37kfCNk,10140,72877,-62737,472
2022-01-20 22:36:15-05:00,4342,2MbNCikBC3fdwqJKfMK1FjPg7wT3xWMXmN88XuikJ8r9,5eG6U5x63YYMpE7iwwu1TPcZapvQMyKczvtnFfST1BH3,True,99244,24811,151,75,76,HfEnetJ7uBSmZWCjBNxdvv9HEC5nsW4wDV7wu6WnhWan,6068,34013,-27945,611
2022-01-20 22:36:46-05:00,4343,FV3G5EsSmyiLAAoREhgDXwvzbxoyDeq4Mwfj4jK5fJ7U,5nhzbJmm5JAwGDpTZoenkM1u3XtMY4uN7Qsm3vFGtRJE,True,32115570,8028892,50221,25110,25111,HfEnetJ7uBSmZWCjBNxdvv9HEC5nsW4wDV7wu6WnhWan,2008862,7918317,-5909455,625
2022-01-20 22:36:47-05:00,4344,DvuRmJkfn6FQczUKgYeaSCqwy2NTMunuAKNrnmxMvnzS,7LpWTX9dgBtW75kfEoB5WuNsDwEdw5s8CYSHh3J4qagM,True,33003617,8250904,51618,25809,25809,HfEnetJ7uBSmZWCjBNxdvv9HEC5nsW4wDV7wu6WnhWan,2064747,19433700,-17368953,625
2022-01-10 09:34:16-05:00,3321,CwTus4FyoXYqyTKAYDp69NLhA1joYZ3tarzY6FFTr6fn,6ivuvYWU6i25MzJSY8rG9rPDKiq38E6QtrV1jvRubLGr,True,13087,3271,20,10,10,3zqXX6kzhkbW3d4TwD2CNjMRwxTbREXySekvq37kfCNk,811,5722,-4911,619
2022-01-10 09:34:17-05:00,3322,FV9CBGGTbppLnBKh79f2LzD1diTiS5g6u89FcpZHZmnK,Fe7mtmCUziFqbbYTvrhAcAq1Ub7YLfTJRtQ1hG7GzJD1,True,6800065,1700016,10520,5260,5260,4BnQKPLuE3DMTtxp8MjUBytgnhvxqq3ZTqZHTVZo4JJh,420822,2633607,-2212785,618
2022-01-10 09:34:17-05:00,3323,6Bq55LtGCEeGqh4JrFLCmmGc2iJfTTBJixivqH78aGSE,DSNrCgWJeNe2P9tAQu5FvCueTzNKDKds7wzuwTQSMRG,True,8585484,2146371,13295,6647,6648,4BnQKPLuE3DMTtxp8MjUBytgnhvxqq3ZTqZHTVZo4JJh,531817,3268463,-2736646,619
2022-01-10 09:34:22-05:00,3324,AL8JFS4gjaQx89f9j8wtaNJgV76K8bw1ugvNtgvhgAnb,HJYvG2kGKe8kXgtZSWTWwTmSjxA3XUeCvyT7acoKtS1C,True,5899887840,1474971960,9095404,4547702,4547702,3zqXX6kzhkbW3d4TwD2CNjMRwxTbREXySekvq37kfCNk,363816192,1938642486,-1574826294,616
2022-01-10 09:34:22-05:00,3325,9ebpuMtXee3DSx4qWiEYEtTT1gK5FqCY2H5yQVWWtTts,9b71dTsTYD1bx6KsjFs5h6d3Jj4T9eX3nqmS7RQj3HS5,True,378229248,94557312,586592,293296,293296,3zqXX6kzhkbW3d4TwD2CNjMRwxTbREXySekvq37kfCNk,23463697,158093860,-134630163,620
2022-01-10 09:34:22-05:00,3326,CP2qcTSw1Y5J7jZiEgbtsvJoigRbJ4m9oHGQS8Fiai2x,7Zd1uX1thbuGkp9H4r1t8aLTu9W8MxvUBNjji2FNJa8E,True,50693757,12673439,78738,39369,39369,DddJ7EWCmYEEZETCBNgAUSg81Ls6fZtiAaY5ekJ5sXx1,3149544,21448818,-18299274,621
2022-01-10 09:34:23-05:00,3327,Cs2YxkuqBK1kjoYZbUZdUcxapPbv8oC75trwGgWoCPfG,2PgHQM1GhHykE4bQ1ggueAw2Zs1BFUW5hxvMvr8DojKM,True,71013303,17753325,110008,55004,55004,3zqXX6kzhkbW3d4TwD2CNjMRwxTbREXySekvq37kfCNk,4400321,40164634,-35764313,619
2022-01-10 09:34:23-05:00,3328,F1JT1p2VuwK4L7zj7NNnZtYiZiNUCcTGKDkgdoX3BZdZ,3BKe4yzTwnnBnvTWP3britpPJ4oAWL7JZJzNLCxjUufS,True,6556,1639,10,5,5,4BnQKPLuE3DMTtxp8MjUBytgnhvxqq3ZTqZHTVZo4JJh,409,1646,-1237,623
2022-01-10 09:34:25-05:00,3329,4j19AEcDwhtAZrnoDc4epNPmEL1jPpVUMeg7RmQ72Qkb,84WB42AAGbczVE9txZPwXrx4FD5jP87r8QdDzEABTm5G,True,66199261560,16549815390,103478668,51739334,51739334,72FwbpFGoLEazJEdpqNtPNefsadUrimUqma9wSoy4qiS,4139146742,37929785192,-33790638450,625
2022-01-10 09:34:32-05:00,3330,CK3ocyWzXQkJJZQmM6bBK4Nv6Rh3UEufjY6DvNU6gJZy,C924o4GY3p2BHLeAbFbe9SEysXqCUyD8sFu2d4NzkAV7,True,6566870,1641717,10184,5092,5092,4BnQKPLuE3DMTtxp8MjUBytgnhvxqq3ZTqZHTVZo4JJh,407366,2515632,-2108266,620
2022-01-10 09:34:32-05:00,3331,2PzBAkdXkrwH9VuoMALumQz86qkW7sSBQtCrHw14JUp3,D5vwWAMHVooobG2sCWv9EwtJrAFZG6cwKH4dfmA98tbt,True,2621020,655255,4040,2020,2020,4BnQKPLuE3DMTtxp8MjUBytgnhvxqq3ZTqZHTVZo4JJh,161616,1144305,-982689,616
2022-01-10 09:34:33-05:00,3332,X5SF9srgzDgBRBhv8xUWyszYYSQiqFF6cVnVLWzQgp1,7rTqnMkPuUUJFt5px1DxwsUK8U5fQUtnx9N4v6dA4vGb,True,33333,8333,51,25,26,3zqXX6kzhkbW3d4TwD2CNjMRwxTbREXySekvq37kfCNk,2059,14502,-12443,617
2022-01-10 09:34:34-05:00,3333,7D4rFmGMPKNAF75VRPxHAhSn2wTjiW8jmth1UD22Xqq9,GQ7BrT6vsXu8tHCMm75YdxFR2r9QTCrCUbdPEZBSAg9w,True,48303783,12075945,74777,37388,37389,4BnQKPLuE3DMTtxp8MjUBytgnhvxqq3ZTqZHTVZo4JJh,2991099,17692403,-14701304,619
2022-01-10 09:34:34-05:00,3334,7vKmhLV45Q5etXhJL5ng8rxWhYSiUCDmAbGnwBPr7zcx,cP6xPeuHLnjr858QK1F9qYn7rJpEbPy7wEJHoju6oV7,True,43615681,10903920,67425,33712,33713,DddJ7EWCmYEEZETCBNgAUSg81Ls6fZtiAaY5ekJ5sXx1,2697000,18856703,-16159703,618
2022-01-10 09:34:34-05:00,3335,FX5sizQGZcDCaETDyJ3HbLxFwhu4t9bX6YyQM7cVEo9Z,6EqnCsv1JPjz6JX1yLNcf74rmkuhAUx6Sf35QMYGuuF6,True,220843643,55210910,341263,170631,170632,3zqXX6kzhkbW3d4TwD2CNjMRwxTbREXySekvq37kfCNk,13650549,93376546,-79725997,618
2022-01-10 09:34:34-05:00,3336,EhANPABkSw9x9WnsDEi8pCg67iQTX2UGTTUpyjADTwdN,4FKLi98hyg9ZjM4MY6ctJsv7B6vPUnTYWdhrnNoYsztX,True,10109506,2527376,15642,7821,7821,4BnQKPLuE3DMTtxp8MjUBytgnhvxqq3ZTqZHTVZo4JJh,625692,5446939,-4821247,618
2022-01-10 09:34:34-05:00,3337,Cb4zhnvig11U4GcC4kqKrnDicGgPhUpfDQB1U7hP3nPa,DiRAMrKqaevGXeXg38KnhaYBERj8tNKU7oWFJvhS32kw,True,203253,50813,316,158,158,3zqXX6kzhkbW3d4TwD2CNjMRwxTbREXySekvq37kfCNk,12662,76380,-63718,622
2022-01-10 09:34:34-05:00,3338,8W9NJfM6cqCsvR1FC8Ab8YZPSQF7bz7inxJZxWnF7GsX,3exfPuVcTnPxs8GwCtS3ruKUGveYymwGV7RXQssPiizJ,True,396661270,99165317,617861,308930,308931,3zqXX6kzhkbW3d4TwD2CNjMRwxTbREXySekvq37kfCNk,24714452,319983290,-295268838,623
2022-01-10 09:34:34-05:00,3339,i7TcF4weYcqgrRdH3GpndbEYxCxfcSfr9JWYrAUg1CF,BkDfknUir7PnSEW8auoB87PytycEFwyX5kT2GY4SGJJL,True,5328026,1332006,8244,4122,4122,4BnQKPLuE3DMTtxp8MjUBytgnhvxqq3ZTqZHTVZo4JJh,329775,4386444,-4056669,618
2022-01-10 09:34:34-05:00,3340,2d1qyEJRyGvB2H83ACSqUjqYLwcLHcURHWAKLXs4w9vp,EFA6rDFpTQcY2vjZMq6Qrjv56nJPN2FhWXNwFzkWtE2M,True,11426901,2856725,17659,8829,8830,DddJ7EWCmYEEZETCBNgAUSg81Ls6fZtiAaY5ekJ5sXx1,706395,6363719,-5657324,618
2022-01-10 09:34:34-05:00,3341,GhV3DChNShu8mGwUUy7VLidabCV6Y2aKdp7cqPynd6Ci,8R8QkgruGRCeE1pjXmn3WjdVDiawNbXFid8gU8BfabZA,True,17968,4492,27,13,14,3zqXX6kzhkbW3d4TwD2CNjMRwxTbREXySekvq37kfCNk,1116,7488,-6372,621
2022-01-10 09:34:35-05:00,3342,5Z3ZFCA65WoWhm3okRuuziEMi7ajGAEHWUFchzBNba5S,FcomdrWidygkxMKzcsY5xELbmwC652uMci648LMTv7AB,True,12532,3133,19,9,10,3zqXX6kzhkbW3d4TwD2CNjMRwxTbREXySekvq37kfCNk,782,5304,-4522,624
2022-01-10 09:34:35-05:00,3343,DrzTARa7RK8RXoxHZPKCBqYtMC8TAUHRw8SznXRKTa5M,FYANet92VhyXkKZqqBJR4sFxuCftWb68sgQU9VHCdTJk,True,33278,8319,51,25,26,3zqXX6kzhkbW3d4TwD2CNjMRwxTbREXySekvq37kfCNk,2065,13847,-11782,620
2022-01-10 09:34:44-05:00,3344,E1wp3bmkcY3eiEYyGYwhTCsr7BZ7RfPa5DJTZFupcFwj,452hVdYkD5SDDrA6hv6DLPFvyS8PvR2P6DPNScGxWTsW,True,812583,203145,1261,630,631,4BnQKPLuE3DMTtxp8MjUBytgnhvxqq3ZTqZHTVZo4JJh,50451,364030,-313579,620
2022-01-10 09:34:59-05:00,3345,9RtNbEZ4ZR8T1HFF4cujPVy2kejVBKFo3CPQi8psSa1q,7zwaGb71jKc9y2HKCKy5q2XV2YUphkyU1hkDaab1GBas,True,118870744,29717685,184978,92489,92489,4BnQKPLuE3DMTtxp8MjUBytgnhvxqq3ZTqZHTVZo4JJh,7399156,31959728,-24560572,622
2022-01-10 09:35:02-05:00,3346,Bsr6kx1B6BSEd5UnJ7Z61M49iUb3bFrDVhiEtMVtPDF2,3CFd1pUJAJPA9fobwn4Jj2mRju1CWmoop4Mh4znypNWT,True,27989882,6997470,43174,21587,21587,3zqXX6kzhkbW3d4TwD2CNjMRwxTbREXySekvq37kfCNk,1726984,10957244,-9230260,617
2022-01-10 09:35:02-05:00,3347,GufVttJatW8NLeztT1NRQSLZpQNRk45kaG41p3QcWhx7,GTJUsWoWRyeafYJVhx2aRo8NE94U5UrBjaehmJ4PRUhn,True,26828880,6707220,41909,20954,20955,3zqXX6kzhkbW3d4TwD2CNjMRwxTbREXySekvq37kfCNk,1676372,8589992,-6913620,624
2022-01-10 09:35:03-05:00,3348,6NJFN855M3Q3RLTDNo57gTgAmwPD6G2E3WvMb1m5eNCN,3YpqNnonsvXaRT4nCC3G5FZx1jjVtbDPc36LiR6WK5jR,True,72732030,18183007,112901,56450,56451,3zqXX6kzhkbW3d4TwD2CNjMRwxTbREXySekvq37kfCNk,4516070,43333863,-38817793,620
2022-01-10 09:35:11-05:00,3349,75ycx5sUFBxDhY1uwuPCW22s2C6BydkJTje7q7zEQFGT,FpEgrVFRubjGK4DRjTqdVbxSECURpn16zfpoC31NbwnN,True,6422935,1605733,10014,5007,5007,4BnQKPLuE3DMTtxp8MjUBytgnhvxqq3ZTqZHTVZo4JJh,400571,3468873,-3068302,623
2022-01-10 09:35:12-05:00,3350,AKxRtcdpi7gWhAuL8ENj7zhgeQezzEXe9TSANE6bQoRA,2YH4vrU9deP8Cu6E8Hzf8GqKG1yVjv5pdz4FE7r5YKir,True,6896220,1724055,10760,5380,5380,4BnQKPLuE3DMTtxp8MjUBytgnhvxqq3ZTqZHTVZo4JJh,430426,2948999,-2518573,624
2022-01-10 09:35:12-05:00,3351,2NHv3c4ufYGo3xNr6KXymAZJdpfURrNiCKbXZ7s82Vwo,E4NYpYgHTvSG6LqH2bBV9Q1XJ6pAzCp9FLSKMzJmYRrQ,True,26057142,6514285,40469,20234,20235,3zqXX6kzhkbW3d4TwD2CNjMRwxTbREXySekvq37kfCNk,1618791,14334644,-12715853,621
2022-01-10 09:35:12-05:00,3352,9TL17gjvWFdhSJkpXgfnX7fKF9c2hfw59k3g8WUqm8Cb,7TyxFBKG4z5Xv3js3n1gbEWWj1M9KBF7dEmFxjCPGidC,True,186336114,46584028,290740,145370,145370,4BnQKPLuE3DMTtxp8MjUBytgnhvxqq3ZTqZHTVZo4JJh,11629627,65197513,-53567886,624
2022-01-10 09:35:19-05:00,3353,89CkXnSZnr52Zsoh48efv9MQacrkB6GMtrbEpNJSyA2H,HcvRBS4Z22CpYgDNgm4TVF4AVXFDuYzBUAFcdHAwdpg4,True,3019384,754846,4703,2351,2352,HfEnetJ7uBSmZWCjBNxdvv9HEC5nsW4wDV7wu6WnhWan,188138,1293530,-1105392,623
2022-01-10 09:35:28-05:00,3354,GaEpNGa8jnwSRvjzzEMYkZe1pKcr2eiZtePrqFxpABjB,5CFZHuyWbJv14zPdX5dSQDREgHrCb4vsFvB6hLiEe3Ji,True,153435,38358,240,120,120,DddJ7EWCmYEEZETCBNgAUSg81Ls6fZtiAaY5ekJ5sXx1,9605,66411,-56806,625
2022-01-10 09:35:28-05:00,3355,H1Z83zVoskNuBvYao1FjdLfETfhPpQFQUkniJfGxbaNz,EVqbBRV6Zy1tPLRevxpAykp8Mvv6tDZVTc4RmCKw4Gq1,True,774664076,193666018,1198081,599040,599041,4BnQKPLuE3DMTtxp8MjUBytgnhvxqq3ZTqZHTVZo4JJh,47923271,379382961,-331459690,618
2022-01-10 09:35:29-05:00,3356,BgnsCfJ54ReunUtwPJLzkW4PWnqpBDWGNYxsW5PvDrbK,KpMqEkQ9dKMgCevsEK895wHd3fCLRPSzDmJSv3tKU4u,True,13833459298,3458364824,21131613,10565806,10565807,4BnQKPLuE3DMTtxp8MjUBytgnhvxqq3ZTqZHTVZo4JJh,845264549,5464215275,-4618950726,611
2022-01-10 09:35:29-05:00,3357,DkvR2xUPMyXWGGkUSmDSfhp7RtvMkfbT1ThKCS3TwrXd,F7jYV6TtT1LZ5XCNn1zkbUfNMo4gGcQUczAQy1jLHpaW,True,581295727,145323931,893012,446506,446506,72FwbpFGoLEazJEdpqNtPNefsadUrimUqma9wSoy4qiS,35720492,261581624,-225861132,614
2022-01-10 09:35:29-05:00,3358,D64rDiWT3YG28fCgXCmbNjYa2JakZbpKQ1D2XuLChUfV,8WmMWq8cTsGQym5pUbHm9dPCpJugBeWUMVERYFGLxWHj,True,34044967,8511241,51134,25567,25567,3zqXX6kzhkbW3d4TwD2CNjMRwxTbREXySekvq37kfCNk,2045381,12491090,-10445709,600
2022-01-10 09:35:30-05:00,3359,8xQ3tsWVUe75EG1HmocULJ3kh52utveoFMEPotTGrKno,i3SKW3ywrwYucX9ySEx1C4zaUKGnzLerP3V38437NyV,True,56512376,14128093,87394,43697,43697,4BnQKPLuE3DMTtxp8MjUBytgnhvxqq3ZTqZHTVZo4JJh,3495792,27533030,-24037238,618
2022-01-10 09:35:31-05:00,3360,GJ3PbEfPK8jjrPgMmZtvN5fMSSy2dtiiAtZ8wcfgxVuc,FCUDVFb2TjDvehHE8fVBofqSykpb9W6Afc9QeHtj7te7,True,77323453,19330863,120176,60088,60088,4BnQKPLuE3DMTtxp8MjUBytgnhvxqq3ZTqZHTVZo4JJh,4807063,44177710,-39370647,621
2022-01-10 09:35:32-05:00,3361,Ar5QB4VBcUyzSCG23z2QNAbrWY55NbHCr1MNN6P2GAmh,BusFGTiDrJmxzwGUxWz9b3SFF3eseqtgh2DRHqyAwyVe,True,465738,116434,723,361,362,3zqXX6kzhkbW3d4TwD2CNjMRwxTbREXySekvq37kfCNk,28944,210242,-181298,621
2022-01-10 09:35:33-05:00,3362,8swGZMrPrLAxZd7MxTbkCL13k3DmAJUw41jCp6Xo6awW,3fKnX7yTNXAT4uMmXVdTy47ALJT8h8YSD3WiBb4BGuzH,True,221459418,55364854,340254,170127,170127,3zqXX6kzhkbW3d4TwD2CNjMRwxTbREXySekvq37kfCNk,13610162,102175833,-88565671,614
2022-01-10 09:35:34-05:00,3363,2BH44k4TYoQSqsSs5EASqJhxpH17Fr8Ahxbg2MAkWa72,HwvvVWpqfN7NDsVYdxbCSbqxSrLCThwnJiZQHh2w2zJb,True,18060,4515,28,14,14,3zqXX6kzhkbW3d4TwD2CNjMRwxTbREXySekvq37kfCNk,1124,7606,-6482,622
2022-01-10 09:35:36-05:00,3364,DY6k3Dkwe18iLneaT8Xo3VpJWB6V4jWwQQjoDvEzdg2j,3GGV7S9FpRQGbARBXkvGFVqLrmw8JvYAcpnR1aKVUY2f,True,11819008,2954752,18252,9126,9126,4BnQKPLuE3DMTtxp8MjUBytgnhvxqq3ZTqZHTVZo4JJh,730098,7102706,-6372608,617
2022-01-10 09:35:36-05:00,3365,2rCRdyfi65rpxRRmg7knaSb8t55FuPt3h8wF4Fzhy8MM,CLVY5nSG3jTdRo7tRSKgK9DJgW6aswfWKe4tLxzsENmb,True,634377,158594,989,494,495,3zqXX6kzhkbW3d4TwD2CNjMRwxTbREXySekvq37kfCNk,39585,243490,-203905,623
2022-01-10 09:35:37-05:00,3366,D3mXrJzhHf8qRaoCKLschUxAFoijFCFuT6bmNZH4W7Cj,9E3Xtqw7TncXWnbhAbFJMtuNmP6WS3ooGuptzyzw7UpA,True,58258,14564,91,45,46,72FwbpFGoLEazJEdpqNtPNefsadUrimUqma9wSoy4qiS,3643,33580,-29937,625
2022-01-10 09:35:38-05:00,3367,8vva9SmKpMGW8wjpkvydQczxVK6VtN79qzH2i4JQSwg4,F8a3GLicsSapt4aLURoU4qHxJaxCij4LS6JVxoMF3YHT,True,967006,241751,1512,756,756,4BnQKPLuE3DMTtxp8MjUBytgnhvxqq3ZTqZHTVZo4JJh,60498,286347,-225849,625
2022-01-10 09:35:48-05:00,3368,3JrhHRs4UkkuMoCrQAaAGKZQrWoU72zWArnDGxKFESzH,8yREVE3kMYB7UAwtUDnTDK3egXTuTsN4igtJ5yeHYkCP,True,386348791,96587197,601896,300948,300948,DddJ7EWCmYEEZETCBNgAUSg81Ls6fZtiAaY5ekJ5sXx1,24075870,113059834,-88983964,623
2022-01-10 09:36:12-05:00,3369,DDsY5V3F9wnEGBoQFCEf1hvEYuKUaJdysbc7TxhNqe9G,5oBCGzvy8odB8MCxCUvPDqYCnTyteZ4Yy1JDroroygbi,True,70400610,17600152,109817,54908,54909,3zqXX6kzhkbW3d4TwD2CNjMRwxTbREXySekvq37kfCNk,4392700,18304327,-13911627,623
2022-01-10 09:36:14-05:00,3370,8aKqLY7GXxNnGRK8Utke7o6EDGZATNDDF8Ph9Q27ppyi,7MQKkebLEzQgjWjByBMzzkn68yqtYivS4VDcraAScZR6,True,999848,249960,1553,776,777,4BnQKPLuE3DMTtxp8MjUBytgnhvxqq3ZTqZHTVZo4JJh,62145,313640,-251495,621
2022-01-10 09:36:17-05:00,3371,8Xt3qHjZG3zLxozgM5vPHMVxp8eYFMg89kaVW7vdHKoA,2i8riSsQpfADD9LUVpiBJBfX5qjVAgmZegzfKx6RG9dW,True,53526239,13381559,83492,41746,41746,3zqXX6kzhkbW3d4TwD2CNjMRwxTbREXySekvq37kfCNk,3339697,17748048,-14408351,623
2022-01-10 09:37:03-05:00,3372,56488NdcUy6Hi6X5SLs2GFtW5pG4u5wJpH7vHdxTCx4z,tGgXjJeVr3W2m3T2NXPCqpBEd6HJKE2cRsgCyiDZQy4,True,37123153,9280788,57787,28893,28894,4BnQKPLuE3DMTtxp8MjUBytgnhvxqq3ZTqZHTVZo4JJh,2311485,18582523,-16271038,622
2022-01-10 09:37:37-05:00,3373,2mfcg17QocKKvDcqDH88TwxHRiS8dAQiJAGoAh1brns9,8aQLELBgaA9eXsxSciMjxWv8B1hpbUPfLwqVjEnasZbe,True,156344532,39086133,243709,121854,121855,3zqXX6kzhkbW3d4TwD2CNjMRwxTbREXySekvq37kfCNk,9748367,43231125,-33482758,623
2022-01-10 09:37:38-05:00,3374,BZxJ6CtrVoiU86DMMieMeDFLNWtMpHGTvZfM7nyay6o4,6CRxRR8bisRLHFJBFWjyumYuy7j4C4PkjYH1K8gXhdWD,True,3590094,897522,5604,2802,2802,HfEnetJ7uBSmZWCjBNxdvv9HEC5nsW4wDV7wu6WnhWan,224179,1172557,-948378,624
2022-01-10 09:37:42-05:00,3375,B9WJfmrYEkVH3L1UWz4qqWpaexHydymbzvEfwNVtB9BV,6mQb4yzGq8jE1NbweKCKSbevnnYVhHYxyc6Gz2a5kJLn,True,319944145,79986036,489464,244732,244732,3zqXX6kzhkbW3d4TwD2CNjMRwxTbREXySekvq37kfCNk,19578571,76780290,-57201719,611
2022-01-10 09:37:42-05:00,3376,8trFFwvXKKMwMx952ugCZmqyw29e1HxEKBuQmFn8ZwTf,FsD7gCvHXM3QchQiDcd292ksy5afZMWApneNTat5ndeS,True,285301580,71325395,442009,221004,221005,3zqXX6kzhkbW3d4TwD2CNjMRwxTbREXySekvq37kfCNk,17680375,68126585,-50446210,619
2022-01-10 09:37:46-05:00,3377,aTkGURJptmKNNP6RSXSWsmVbfcriSAJaMuUiT2eZEfb,5qoGxL83PLhrguyk27X8xE6jGitRg5BaQpXzrcfEvCfJ,True,194856829,48714207,304652,152326,152326,4BnQKPLuE3DMTtxp8MjUBytgnhvxqq3ZTqZHTVZo4JJh,12186088,72342285,-60156197,625
2022-01-10 09:38:33-05:00,3378,243SAnGxchCVB1LQAUF4SsozR86yDwEdg2QQpbWGsMYe,5u8sNkb2oEQjUXJAB3yGStmv3Uwz16gBgExBo5myVK4b,True,10072560,2518140,15722,7861,7861,HfEnetJ7uBSmZWCjBNxdvv9HEC5nsW4wDV7wu6WnhWan,628887,3908496,-3279609,624
2022-01-12 07:32:05-05:00,3379,8G3MZPpXc9r39cFuEPoeVhG5jiJchAD6FfUZEu1Ua5q9,Cym1s8kog2DysSqRjccnDDtnnVbyQmGNnmv3Jk85wcGn,True,11330833558,2832708389,17425155,8712577,8712578,HfEnetJ7uBSmZWCjBNxdvv9HEC5nsW4wDV7wu6WnhWan,697006215,2027839774,-1330833559,615
2022-01-12 08:41:51-05:00,3380,2VTYgeeefRGR3R14ywsrn7h3Q9NcCVesVrbK11QKEzSu,FKJUBEkabSEXMmSanm85TDF9zy8Gf2MWEy9Ku2chMqcy,True,69754523,17438630,108061,54030,54031,DddJ7EWCmYEEZETCBNgAUSg81Ls6fZtiAaY5ekJ5sXx1,4322466,12366990,-8044524,619
2022-01-12 16:25:03-05:00,3381,8AhMgKNmKmYtDnc6YCvK6GRmbEM8RmbAkjSSCdJz4Mag,CVBS4BZMTrc7QemUujwAmS9fh7EgNxsUD14w9WNgyKNu,True,7478853953,1869713487,11667137,5833568,5833569,DddJ7EWCmYEEZETCBNgAUSg81Ls6fZtiAaY5ekJ5sXx1,466685486,1318870385,-852184899,624
2022-01-12 16:25:36-05:00,3382,2VTYgeeefRGR3R14ywsrn7h3Q9NcCVesVrbK11QKEzSu,FKJUBEkabSEXMmSanm85TDF9zy8Gf2MWEy9Ku2chMqcy,True,53211445,13302861,83168,41584,41584,3zqXX6kzhkbW3d4TwD2CNjMRwxTbREXySekvq37kfCNk,3326722,10255808,-6929086,625
2022-01-16 13:52:28-05:00,3383,JCBhqqPQxP1Xc41sSY6e1sQKRstHhe7D1v6rLz4hp3Qp,DWMUq2bMD1jqpxHtyXDFjcAwjA27yyMRe68hGcsK143m,False,1970,1970,0,0,0,DddJ7EWCmYEEZETCBNgAUSg81Ls6fZtiAaY5ekJ5sXx1,0,2948,-7592,0
2022-01-17 22:11:25-05:00,3384,3XZLp6JyrQYnufa1obczXqmK6cNR29ZMW1FdCYbWNTCP,8kUTi1Prio14m9LjCj6Mari6pXwJTYkE1mp21LMn235p,True,472623,118154,730,365,365,3zqXX6kzhkbW3d4TwD2CNjMRwxTbREXySekvq37kfCNk,29200,122042,-92842,617
2022-01-18 09:21:45-05:00,3385,EcjCYJWTXn3LfpgJ9EbdVYQyR35QfWdBjsMdX8V9gBn6,8oMpGUjxhnQ8HATVWJCeSzyodTyBHt3u8YSbJsKV4f3J,True,24278053960,6069513490,37696174,18848087,18848087,DddJ7EWCmYEEZETCBNgAUSg81Ls6fZtiAaY5ekJ5sXx1,1507846983,5541008740,-4033161757,621
2022-01-18 09:34:20-05:00,3386,4mB2DVbQVqVk535v98Cj8SPNg1tTc3DFyY2Q7VBbY645,HXo255k3RgsTGsc4hiP6ZTXUspBTqJ37duQa5eK7tqp3,True,513316801,128329199,796591,398295,398296,HfEnetJ7uBSmZWCjBNxdvv9HEC5nsW4wDV7wu6WnhWan,31863644,183772959,-151909315,620
2022-01-18 11:43:10-05:00,3387,3XZLp6JyrQYnufa1obczXqmK6cNR29ZMW1FdCYbWNTCP,8kUTi1Prio14m9LjCj6Mari6pXwJTYkE1mp21LMn235p,True,347191,86797,543,271,272,3zqXX6kzhkbW3d4TwD2CNjMRwxTbREXySekvq37kfCNk,21729,93207,-71478,625
2022-01-19 02:16:51-05:00,3388,EcjCYJWTXn3LfpgJ9EbdVYQyR35QfWdBjsMdX8V9gBn6,8oMpGUjxhnQ8HATVWJCeSzyodTyBHt3u8YSbJsKV4f3J,True,15907418550,3976854637,24884068,12442034,12442034,3zqXX6kzhkbW3d4TwD2CNjMRwxTbREXySekvq37kfCNk,995362756,4174982972,-3179620216,625
2022-01-19 02:44:49-05:00,3389,EYt1Pzqfwnd4iXSmcpw4T3Edmm1y3GnRhCjcQEEK4Atj,EHqporfvvfg7UQPsjv5tsgZE8u9yyRuEU2DdLpQeXy85,True,41004240008,10251060002,64106863,32053431,32053432,3zqXX6kzhkbW3d4TwD2CNjMRwxTbREXySekvq37kfCNk,2564274540,7940285310,-5376010770,625
2022-01-19 03:34:50-05:00,3390,FfpzVu4rcnwxNbx9EoNpZ4LmCYTjhYTkhwrUGCpnSJvh,5rRoUEuDVtaXQBH9xvq4vUvPWJDytFoEByNrcWfiq1E8,True,398327,99580,621,310,311,DddJ7EWCmYEEZETCBNgAUSg81Ls6fZtiAaY5ekJ5sXx1,24870,90219,-65349,624
2022-01-19 03:43:38-05:00,3391,3XZLp6JyrQYnufa1obczXqmK6cNR29ZMW1FdCYbWNTCP,8kUTi1Prio14m9LjCj6Mari6pXwJTYkE1mp21LMn235p,True,254678,63667,398,199,199,3zqXX6kzhkbW3d4TwD2CNjMRwxTbREXySekvq37kfCNk,15929,74602,-58673,625
2022-01-20 16:41:22-05:00,3392,4mB2DVbQVqVk535v98Cj8SPNg1tTc3DFyY2Q7VBbY645,HXo255k3RgsTGsc4hiP6ZTXUspBTqJ37duQa5eK7tqp3,True,389912368,97478091,606017,303008,303009,HfEnetJ7uBSmZWCjBNxdvv9HEC5nsW4wDV7wu6WnhWan,24240684,144028646,-119787962,621
2022-01-20 17:02:30-05:00,3393,96DzqyUxsB1FKWrhLdTdjDcokuus6rbx83gLsghqPPwt,74CWb7SVoSy3ADysEzFEeMiS2fxHJ9gdUF9pzM3E52Gj,True,19731,4932,30,15,15,HfEnetJ7uBSmZWCjBNxdvv9HEC5nsW4wDV7wu6WnhWan,1224,8046,-6822,620
2022-01-20 17:02:30-05:00,3394,4MmpDGUTyMcYEqJ1RoZ46AN2BhrBUseHaHqF8AmiTPyD,7HW2YZpYM349HMfW7u4h9ESZ1AXkwN8JcVDTNFzp9aTz,True,122375774,30593943,190623,95311,95312,HfEnetJ7uBSmZWCjBNxdvv9HEC5nsW4wDV7wu6WnhWan,7624928,63520565,-55895637,623
2022-01-20 17:02:32-05:00,3395,BzSJ77zKaqtBk2cEL1XqFL97zTXXMRHmxtkgtXwCc3C,2g4KXTwy2MPSRQ2khNp1o1rn7CradEr9H4ySYKDoSWN9,True,10297355,2574338,16091,8045,8046,3zqXX6kzhkbW3d4TwD2CNjMRwxTbREXySekvq37kfCNk,643655,9738628,-9094973,625
2022-01-20 17:02:32-05:00,3396,8BMDSWFtzq9fu1ubVGtSFw8fEaMg1uvJiECuJnN8e1pd,FwkETAXL296CirvQ2AJuSHHtdKsxkZkmXSwZVVHXVDhA,True,132696509,33174127,206889,103444,103445,4BnQKPLuE3DMTtxp8MjUBytgnhvxqq3ZTqZHTVZo4JJh,8275567,53560319,-45284752,623
2022-01-20 17:02:32-05:00,3397,9jdfc9GFTecsdRuTjWFGX13niKKmeBxRgtv5j86uhSnU,HLWMShobjSkaLyXrNjgwVaUGVtbtdUSnr1XjqpXn1bLR,True,298574,74643,463,231,232,4BnQKPLuE3DMTtxp8MjUBytgnhvxqq3ZTqZHTVZo4JJh,18558,137030,-118472,621
2022-01-20 17:02:32-05:00,3398,EV21gv8jEvXtmGDoGRNm5LJEvTBccLMZyVDCLsp54jP3,DGxxoU52aQNoUQcxdvQtv2H5q2PhK6TGkLgNSaFgnZrb,True,4547593,1136898,7093,3546,3547,DddJ7EWCmYEEZETCBNgAUSg81Ls6fZtiAaY5ekJ5sXx1,283731,1966533,-1682802,623
2022-01-20 17:02:32-05:00,3399,9YEzjb49Awvedv9yNc6LG54SkGBug2RYiJwiUV13mGsS,3H8w5WCD187NWWoZMNUCzUDdxTgqrRJLga8gDzUVXBgZ,True,1117870,279467,1742,871,871,3zqXX6kzhkbW3d4TwD2CNjMRwxTbREXySekvq37kfCNk,69701,669160,-599459,623
2022-01-20 17:02:32-05:00,3400,HutRztBianNUgm9sJDWKUQBmoVyy8y7CfnNk4hHjSkEW,EtVfvPyiy5bizbCZxR19TNUgETf3QcmziBvMtc6o5zjr,True,251170386,62792596,389288,194644,194644,3uL2NSR2ZdDqCiKfzA5SwwpddAnit22DBJo6uvvz1rRs,15571522,210120938,-194549416,619
2022-01-20 17:02:33-05:00,3401,KoCscQ9Q8TZHhmya5KaXBrwUEMTdCkEMRtrhvtgEmiZ,6aZ5AFMFoqf1X64RwAt1J4Yrx4WGGe2JMiEjqnQ2gEtk,True,480700,120175,751,375,376,3zqXX6kzhkbW3d4TwD2CNjMRwxTbREXySekvq37kfCNk,30059,111861,-81802,625
2022-01-20 17:18:00-05:00,3402,EeUACm9TkjHKES5U7Yj1oPhYmcp7R3tvesGBiP8txEzq,3qkmm4aS6EDirEDejmbm5PDw2jpYkC7zKqrMkmgeE5BA,True,235357,58839,364,182,182,3uL2NSR2ZdDqCiKfzA5SwwpddAnit22DBJo6uvvz1rRs,14578,83672,-69094,619
2022-01-20 17:18:00-05:00,3403,2NdwSLxsGok8PczpCZj9CVX2BymNU5MvHt7hWfGetg2M,8AQbDXeA6mD9QoZBFJcYbnHvZwKNxzA9CCHLAgdSfTA3,True,10853,2713,16,8,8,HfEnetJ7uBSmZWCjBNxdvv9HEC5nsW4wDV7wu6WnhWan,674,5661,-4987,621
2022-01-20 17:18:03-05:00,3404,8VT2nxz5ZYDJFd9uL2XZwEXxChd9pjuMJNMAcutZubL1,EhAkiRbouzUAWtqQFsN8HEEfi46UVN8H8tyBP7CbgeLe,True,9349,2337,14,7,7,3zqXX6kzhkbW3d4TwD2CNjMRwxTbREXySekvq37kfCNk,584,4397,-3813,624
2022-01-20 17:18:03-05:00,3405,AtKuDfcFXqWUMnRqQpjedUMTb5CQKLc2zoqEAcQpysKQ,9bPFLYp5TDZruLLDXDYYCiPYcD982iF8xt5rfTkqwNsL,True,11339,2834,17,8,9,DddJ7EWCmYEEZETCBNgAUSg81Ls6fZtiAaY5ekJ5sXx1,706,4538,-3832,622
2022-01-20 17:18:03-05:00,3406,6XHt7CrURSomkQrtVXV5JuKSZY4tQRpUyQKfCDaSTYaD,GCgcmPSDDBsn2smYbpiX3PJybDkQWtufPu4YRsbEEU8X,True,343718240,85929560,534450,267225,267225,3zqXX6kzhkbW3d4TwD2CNjMRwxTbREXySekvq37kfCNk,21378028,210024284,-188646256,621
2022-01-20 17:18:03-05:00,3407,Mcbzp1LhZwpfmXTv1pqe9D1jCKHw443j9QKp6tUpzgM,8uforSMAKEih5jHfHp3gCqCvaugtCmhzVfVHA63Akz7F,True,2032741,508185,3170,1585,1585,DddJ7EWCmYEEZETCBNgAUSg81Ls6fZtiAaY5ekJ5sXx1,126821,1063453,-936632,623
2022-01-20 17:18:05-05:00,3408,6WNPf4rFCX74PuyvdmzRFqbxWhguuxTQqBSdnaTVBd5D,9N7a9aiHGQsxFMgVbmWoCF9w95d12xyT7XFAwpHGkTLA,True,1534125,383531,2396,1198,1198,3zqXX6kzhkbW3d4TwD2CNjMRwxTbREXySekvq37kfCNk,95847,428521,-332674,624
2022-01-20 17:18:09-05:00,3409,99NHcwD1iaf5FXM3UNb91SjNiiT3HwyQFQMhkGd5ASts,8syAydy52vSQQLzsLXW24BFw4VPeK66Vp3BmAbnHfgod,True,50379815,12594953,78197,39098,39099,4BnQKPLuE3DMTtxp8MjUBytgnhvxqq3ZTqZHTVZo4JJh,3127911,22048778,-18920867,620
2022-01-20 17:18:09-05:00,3410,7LRBswSEDBjJzQ4YurfTxLydh7tFS2jVn5V95Z6wL7ci,fD41VYGmk66MW46KKb23vAqQvUSDScgXnVdsHhJBZzu,True,119952,29988,185,92,93,3zqXX6kzhkbW3d4TwD2CNjMRwxTbREXySekvq37kfCNk,7426,58531,-51105,619
2022-01-20 17:18:11-05:00,3411,CAkknoa9UFPMEZ1KWSfqtmnL7ArVNV3HRETLwecuuXP,4cHJYv3dxA6qjcuxUkGRuL7STWobGPKtoHFD4ACUbiWq,True,10659522,2664880,16517,8258,8259,3zqXX6kzhkbW3d4TwD2CNjMRwxTbREXySekvq37kfCNk,660687,4349274,-3688587,619
2022-01-20 17:18:11-05:00,3412,Grw2snBvSDMa7ev2nWZo81WoLfyavmXXxCV1ugHGk5Xe,AF1WVCQcBmXCnWbDx2s62vU99zW1AdhNoqbWvdrbiQVm,True,15781457,3945364,24556,12278,12278,3zqXX6kzhkbW3d4TwD2CNjMRwxTbREXySekvq37kfCNk,982256,6198678,-5216422,622
2022-01-20 17:18:14-05:00,3413,C7a8BtMjuLXkzxZBC4Wk2gjkGBmucLmDjokf9pyA1Mu6,GxwYNWwYTtFMUxuZvNC5qrEYuJzYiEURQVuBxssfCJzr,True,1560611,390152,2438,1219,1219,3zqXX6kzhkbW3d4TwD2CNjMRwxTbREXySekvq37kfCNk,97525,435355,-337830,624
2022-01-20 17:18:30-05:00,3414,2RZPBo8Z2BgZmsASo14ySTSwqqgqmfVEjPkiAwQ1VTgf,BRS5cYtEoPRoSvTAiQaT1svWRdLJWVfy8LUb4SCudCjS,True,4986105,1246526,7800,3900,3900,3zqXX6kzhkbW3d4TwD2CNjMRwxTbREXySekvq37kfCNk,312013,2062254,-1750241,625
2022-01-20 17:19:04-05:00,3415,CEbGTNX6WpaoKp4RBGSn9LzYM6yAYyeiMrgVYgJxA4zb,AiXUcGAFFm4tc7vKBscSNjZawV5YJqbv7D1KpxD3Zufg,True,18585951,4646487,29076,14538,14538,DddJ7EWCmYEEZETCBNgAUSg81Ls6fZtiAaY5ekJ5sXx1,1163066,10219206,-9056140,625
2022-01-20 17:19:04-05:00,3416,4hrm69kAKNcfBkiP2YgtW94Pbip6FLfQAwnDRAAack69,BjbZRdGMoC7Mfoa4H19UvE2eQafgKD5rqnK7BSGwqS1s,True,34497,8624,53,26,27,DddJ7EWCmYEEZETCBNgAUSg81Ls6fZtiAaY5ekJ5sXx1,2147,14477,-12330,622
2022-01-20 17:19:04-05:00,3417,ZoNjrSjYh4NJLW38LUPcf7jtEBxdaaM7T1zp795qjHE,FZx6v8cU25NwEosbKJ2n141o9uFAWURZB7NeCeX1trEn,True,1432336,358084,2238,1119,1119,DddJ7EWCmYEEZETCBNgAUSg81Ls6fZtiAaY5ekJ5sXx1,89526,397427,-307901,625
2022-01-20 17:19:09-05:00,3418,5hUZ9uQFcYnjAQVVaGLJWdKyg7y1XMpoo8osQ9DeY7Xd,BdYiKWsjuzJLcHh3814mJ4xQ9JxoQKKcr7AHZ7Vxoavq,True,41267,10316,64,32,32,3zqXX6kzhkbW3d4TwD2CNjMRwxTbREXySekvq37kfCNk,2575,17617,-15042,623
2022-01-20 17:19:11-05:00,3419,3axqGcX5yuJ2vGxRjtNguefXUvSQHDQmn2zskhyCuQkf,EYrZo9zZDaHqFdc1fam63W3jvqqmbU67wzp6yFcppwsL,True,27360841,6840210,42589,21294,21295,3zqXX6kzhkbW3d4TwD2CNjMRwxTbREXySekvq37kfCNk,1703589,22337917,-20634328,622
2022-01-20 17:19:28-05:00,3420,EgU9hX6VK7YXeCgCHVaJAMekCcyZa2MVWdKra5pN7Gwv,7y8Ad9XY34bqREvheXHT2tr8Jy11D6X3pu7yLVtjU4QV,True,9280453,2320113,14472,7236,7236,3zqXX6kzhkbW3d4TwD2CNjMRwxTbREXySekvq37kfCNk,578904,4573096,-3994192,623
2022-01-20 17:19:28-05:00,3421,EEcTbsFTUEifcdbPyjBLkS943daEx1RpR8F3uZxKRZbT,8V3JzDQ1VWYQLas8fxUsWJZZHe4gEmn74RehtUwLw3k5,True,5014648,1253662,7804,3902,3902,4BnQKPLuE3DMTtxp8MjUBytgnhvxqq3ZTqZHTVZo4JJh,312162,2451905,-2139743,622
2022-01-20 17:19:28-05:00,3422,FjDp4bWCtqehFD7FunCrjrcdxMezTJj5aqh2VnBvHDQU,HRYeZqcqhP1RPiAGXziR1qCWwk4sF6c5ZYbvSDhX7foN,True,7513952,1878488,11667,5833,5834,DddJ7EWCmYEEZETCBNgAUSg81Ls6fZtiAaY5ekJ5sXx1,466704,2963072,-2496368,621
2022-01-20 17:19:28-05:00,3423,Buioe5v3DyFwD9nquW5XdYeVYbSABCyg79eUHEvtvfaW,7T9gi7prCcZJkYJMSB5Ef6Bu4pAuBw4XLvumSFnqKDSi,True,662787,165696,1025,512,513,3zqXX6kzhkbW3d4TwD2CNjMRwxTbREXySekvq37kfCNk,41011,365785,-324774,618
2022-01-20 17:19:28-05:00,3424,8mbMH9EKd9kQDyFrYiDJCV9VaWxWCzpZBQZLyYN2yNVx,J9gT39dF1egMeQvweXYWeRAX3kpmBABijYZhfj6M2UqU,True,22851672,5712918,35403,17701,17702,4BnQKPLuE3DMTtxp8MjUBytgnhvxqq3ZTqZHTVZo4JJh,1416137,7927476,-6511339,619
2022-01-20 17:19:28-05:00,3425,DiB9SeCFXjioNGPJM3GuZ3FCG9KBZhHK27zCSN5b6gkq,GtK8UtKDQy9jgtTXvam4jja9N7c4EFuDQr4TKHgNyhXT,True,4115432,1028858,6372,3186,3186,DddJ7EWCmYEEZETCBNgAUSg81Ls6fZtiAaY5ekJ5sXx1,254896,1877980,-1623084,619
2022-01-20 17:19:28-05:00,3426,C4dbwF9mioaBkZnyBFvFs6Cqd362VuGPBGPbTY9CAnAk,CcUqBfu1hbWm5VVxbtF2Xm6HUz4CLFzuDsjUi6KtnZQg,True,1666070,416517,2579,1289,1290,72FwbpFGoLEazJEdpqNtPNefsadUrimUqma9wSoy4qiS,103196,462130,-358934,619
2022-01-20 17:24:44-05:00,3427,DiPSJvnnEwg1En7HJfEsKrUbBgtUf4KzGMyMCZDQSYgp,s8UVC6vPBofuXUS6RW1aQmZ8C35PrC5r4A6ugmvzLGB,True,1821502,455375,2832,1416,1416,HfEnetJ7uBSmZWCjBNxdvv9HEC5nsW4wDV7wu6WnhWan,113312,506658,-393346,622
2022-01-20 17:24:44-05:00,3428,2ce2v2TCbjNH635NgbwTG3sqiRWYrRRaBpxPxBZJ929q,9cnoebT43FkWDFhidndGCVNiFD4NErv8DuL1Va4Jv9S8,True,5634278,1408569,8802,4401,4401,DddJ7EWCmYEEZETCBNgAUSg81Ls6fZtiAaY5ekJ5sXx1,352091,4315950,-3963859,624
2022-01-20 17:24:45-05:00,3429,5BjBPqumCb9KC82ZNNch3dcRzbpGdRLJneru7o9a1D9R,FuZtBWKktxFu4yoiLVMzxq8fMhQyN8SGzGPz49xs3m6P,True,137971290,34492822,214910,107455,107455,3zqXX6kzhkbW3d4TwD2CNjMRwxTbREXySekvq37kfCNk,8596422,67976021,-59379599,623
2022-01-20 17:24:45-05:00,3430,3zH1b58jqbNU37y9kDTZZrotSeT8XzS1tuyAHPKWrbah,4trxDWV16x6sVcz7bxHehYHkjjyKebh3S9fyJf8txzK5,True,7089,1772,11,5,6,3zqXX6kzhkbW3d4TwD2CNjMRwxTbREXySekvq37kfCNk,442,2867,-2425,623
2022-01-20 17:46:10-05:00,3431,4FazDUgfQ3AKoFcnWHr8E9Ht8jLA3tkxf75yrGZVHdmF,HzRMH6mbgEKydRCnnMvSsKgTEVNQi6nuzoR1xutYFdzg,True,57344,14336,88,44,44,HfEnetJ7uBSmZWCjBNxdvv9HEC5nsW4wDV7wu6WnhWan,3549,41167,-37618,618
2022-01-20 17:46:11-05:00,3432,7MSzV5yy5FmrM4j1BcYSRiTGWfit1AJahheRUaXzz349,aPSTZLxBpVr3sucjbj95emRV2J1GrUWr7wbARYqJkQZ,True,4165571,1041392,6448,3224,3224,3zqXX6kzhkbW3d4TwD2CNjMRwxTbREXySekvq37kfCNk,257953,1438865,-1180912,619
2022-01-20 17:46:12-05:00,3433,ECuu1L4QGdemZ7FjAjVAAxYN6piinweY7Fuk5csVovfT,Amd8WGcpdtB8yoA83R1BUT5uryuqoKbcBexYacbrbGVX,True,2855324,713831,4454,2227,2227,4BnQKPLuE3DMTtxp8MjUBytgnhvxqq3ZTqZHTVZo4JJh,178169,1062825,-884656,623
2022-01-20 17:46:12-05:00,3434,87R8o8xLjHw2GpunYkm7pX7uJ8hjM4B1y4Qm7aQf6Yh4,48aSVPQoFYdncF5NtJ114urbdTzVjTgYLgPzMfpJbZB3,True,59789076,14947269,92612,46306,46306,3uL2NSR2ZdDqCiKfzA5SwwpddAnit22DBJo6uvvz1rRs,3704497,55290045,-51585548,619
2022-01-20 17:46:13-05:00,3435,93ho4cgnpAJiJsG6uu2udkLVNU7rkz4QjCYfsqvpbPA5,45ouQn9gGwXqnTGfaP5CvU8fCKadBRA5kPwtfvJzykRU,True,59356614,14839153,91941,45970,45971,3uL2NSR2ZdDqCiKfzA5SwwpddAnit22DBJo6uvvz1rRs,3677662,21172887,-17495225,619
2022-01-20 17:46:13-05:00,3436,3g1debT8Z2efQPuMNSDPUNZzDqarBG2acErsZ4HP7QGA,42wDHagxr5Nno3mUx6kyYGDjwR98aedRbh3ByB468agB,True,17696,4424,27,13,14,3zqXX6kzhkbW3d4TwD2CNjMRwxTbREXySekvq37kfCNk,1097,7334,-6237,619
2022-01-20 17:46:14-05:00,3437,E9FFPvygPSF22u7gqFq4w6yE5kV15zbeGDXFQc349RsG,yi1REPVUwKhr5ss5YJc56crYz8LVfkqNVMpKcdSfwfY,True,1562286,390571,2416,1208,1208,3uL2NSR2ZdDqCiKfzA5SwwpddAnit22DBJo6uvvz1rRs,96661,432816,-336155,618
2022-01-20 17:46:14-05:00,3438,9gYrMXAGmGSV4VFjXzYP5WwH2aFpB1TxA6CqpYsosKLv,Dh8aH6RK48wu4fkT9xKw5XL7itxnPDuw3SDwPwvL5sva,True,24767,6191,38,19,19,3zqXX6kzhkbW3d4TwD2CNjMRwxTbREXySekvq37kfCNk,1528,10210,-8682,616
2022-01-20 17:46:16-05:00,3439,9LZ3rShLfzErXsGkh4dYfAm58GNPWhK6ohDy5RrLJhc,41tLyuvuJ5M7YctkSASD2R7RGGetD7FmKaZUdkTdgXgt,True,1352821,338205,2105,1052,1053,3zqXX6kzhkbW3d4TwD2CNjMRwxTbREXySekvq37kfCNk,84215,376710,-292495,622
2022-01-20 17:46:23-05:00,3440,2bikYf33ZxxDmvkMNjWDGGqEpbYJPvWv5At3hzyeLEQK,5FtirUBjRAZ3k5arFFVwKz42ixWzhkEBLkaK9PraRZ78,True,136926,34231,213,106,107,DddJ7EWCmYEEZETCBNgAUSg81Ls6fZtiAaY5ekJ5sXx1,8559,47836,-39277,625
2022-01-20 17:46:23-05:00,3441,HhwiZPKZBGa16oVi739s4qtMDMTwzWXc7iwNfX63t2UP,5AnbMbAFKy85yHt5y2M5S38nNkA1vT4ejY5NjGbRNUqn,True,1293493,323373,2021,1010,1011,3zqXX6kzhkbW3d4TwD2CNjMRwxTbREXySekvq37kfCNk,80845,791691,-710846,625
2022-01-20 17:46:24-05:00,3442,2p2fGXdKrmxjomLSnyaNg84J82cBBBNympZ6qQc8UZgU,HKAM8bazuLMUY6yapZJqYsgaWkTBqKHyMs1hSfpYsZGi,True,758611521,189652880,1186630,593315,593315,3uL2NSR2ZdDqCiKfzA5SwwpddAnit22DBJo6uvvz1rRs,47465209,393114216,-345649007,625
2022-01-20 17:46:26-05:00,3443,6osqTNxgZv1Y1EjnVR7D1G4cywof1CrWswj87tAnktWV,Fah93R9W7SFuajFif4AbXDdxouWA5rrLz29vzVRGsMxv,True,11676888,2919222,18207,9103,9104,3uL2NSR2ZdDqCiKfzA5SwwpddAnit22DBJo6uvvz1rRs,728310,10051422,-9323112,623
2022-01-20 17:46:27-05:00,3444,7g4NJBHwDTRm58GqX7Tz1JzqwbAhF6EWJUQH3SoDxSf7,82Ypv7STZeSCBPf3HckWdyatELpvaDaWxFXhD5dNSML4,True,21748,5437,33,16,17,3zqXX6kzhkbW3d4TwD2CNjMRwxTbREXySekvq37kfCNk,1357,9047,-7690,623
2022-01-20 17:46:31-05:00,3445,6d6HN8LWikwW2HYdy3BABWuxKHt1sgv4DcneACR133sE,4eKvzmfFvX96XbujKBhUauAvWP4yQYwZH3pd7gXzbCvJ,True,1560561,390140,2434,1217,1217,3zqXX6kzhkbW3d4TwD2CNjMRwxTbREXySekvq37kfCNk,97375,435255,-337880,623
2022-01-20 17:46:47-05:00,3446,duKo8riX1qpX1K1qpgwZniMtUeWqu2eYgchTu5n7Rbu,9vAVwfVtdsaZMbeZvoymjHqwASeuM38gfEJkbTVwDqya,True,62575905,15643976,97508,48754,48754,DddJ7EWCmYEEZETCBNgAUSg81Ls6fZtiAaY5ekJ5sXx1,3900351,25315962,-21415611,623
2022-01-20 17:46:47-05:00,3447,CCHzYXr5zMXFu8MMZNkfUWGyUcF8xy7Vvhq7tNCtZg2L,AuEXkCJTTJ3HK8iP4qTWpQr4vp6HPRJZyZwfRjF8zjfp,True,136849,34212,212,106,106,4BnQKPLuE3DMTtxp8MjUBytgnhvxqq3ZTqZHTVZo4JJh,8516,47869,-39353,622
2022-01-20 17:46:47-05:00,3448,4kbcrzH6o2LvLUCNphyL52i8uGzVD8wcUNEqoQ14z3VG,5Q1atmEBs2AqaDZsiZFG5stHzj1fE6ZvypgfkEc9LYqE,True,166559589,41639897,260347,130173,130174,DddJ7EWCmYEEZETCBNgAUSg81Ls6fZtiAaY5ekJ5sXx1,10413909,92612572,-82198663,625
2022-01-20 17:46:47-05:00,3449,BPRoaqrDs8vhqv2T7d9qV2oPU33pi1K1LUaotM7yuD2i,6qo8uQGAEwBfYQR36v6nRiqA2xGV6SjJAsXsdzy5bqNH,True,967884891,241971222,1507111,753555,753556,DddJ7EWCmYEEZETCBNgAUSg81Ls6fZtiAaY5ekJ5sXx1,60284461,442435733,-382151272,622
2022-01-20 17:46:47-05:00,3450,DJiXXW7sjNsAAxWupDKBUsFhXSgPoerVYaAtJqqNgVbn,2MsqvNuJw1xQhJ3UnXt9i7oNHDuZpR9w7iE1WQcGqt5m,True,136846,34211,212,106,106,DddJ7EWCmYEEZETCBNgAUSg81Ls6fZtiAaY5ekJ5sXx1,8505,47860,-39355,621
2022-01-20 17:46:48-05:00,3451,921FBgLS3A1wA77uWitsnTvW737Q2jY7tzvgWtWLXNC7,E4eJ9H7cqP9zNpMH5xRBTAp9yaBCBihuJBNd6pqzteDG,True,136847,34211,212,106,106,DddJ7EWCmYEEZETCBNgAUSg81Ls6fZtiAaY5ekJ5sXx1,8510,47866,-39356,621
2022-01-20 17:46:53-05:00,3452,7W6ih2ZGXaE6tvuQFUPCvc7NvEJHy7UffgoVX3ZPdLXt,6uQCkeMjEXHBQxE2HD33RM1zyTsSko1fYZA1mWUggJ5B,True,24021,6005,37,18,19,3zqXX6kzhkbW3d4TwD2CNjMRwxTbREXySekvq37kfCNk,1496,10293,-8797,622
2022-01-20 17:46:53-05:00,3453,FLTW9fwjWqGPm5PiE3C9LFzwZxtDh8c2MnEoRq8W7MfQ,GKsfzKBP2QkmoEWvTaUN1h4nqrT3kAcwYRC9WxW9bB3h,True,11516633,2879158,17915,8957,8958,3zqXX6kzhkbW3d4TwD2CNjMRwxTbREXySekvq37kfCNk,716639,4029767,-3313128,622
2022-01-20 17:47:31-05:00,3454,HkRKcvAWLM5sCDL6a5DvYsH55bg5BnZnyP9WwX7wLUDF,GXtDJS8BCoZKnvviGaUb2QfKs2LQQZPMa9564tf5Jq8Y,True,1425291147,356322786,2228984,1114492,1114492,4BnQKPLuE3DMTtxp8MjUBytgnhvxqq3ZTqZHTVZo4JJh,89159368,317823180,-228663812,625
2022-01-20 17:48:07-05:00,3455,GH6Q9E1jZPTTp46aDd57UNZPNS2D6PBSwyLL3EHSjGn2,2XvwZXNsrPWx4EfPvhTP933bzCC3SJHDQ8xARfrXdVY9,True,18411404,4602851,28503,14251,14252,3zqXX6kzhkbW3d4TwD2CNjMRwxTbREXySekvq37kfCNk,1140138,15691195,-14551057,619
2022-01-20 17:48:10-05:00,3456,AA9zFZTXqBR8Mw1fwEH59edzBiswoGasRNWsi6aLeysB,4VeitxYqqtRxyfdSVpshdJ3EDcgksRVnaHvAqWxTeujH,True,1585849,396462,2471,1235,1236,3zqXX6kzhkbW3d4TwD2CNjMRwxTbREXySekvq37kfCNk,98860,443092,-344232,623
2022-01-20 17:48:10-05:00,3457,EeztHR1M4PPacJEZ6c5arCRVCuu8aN7eGdpY1u4bev79,9Twdc9Xrzv2oeJ9Fbd8mRvzjbFi7mkGopFS37SMabeAK,True,165591059,41397764,257834,128917,128917,DddJ7EWCmYEEZETCBNgAUSg81Ls6fZtiAaY5ekJ5sXx1,10313379,53329527,-43016148,622
2022-01-20 17:48:10-05:00,3458,4D7mDXe7SdmbAx7kaD1mBNuEa7DzMi6TAwXURxtLEazk,5pSnT91PHoLdN6uhPnUtoD7cboLmndn26y1XouPx8vwW,True,1382944,345736,2146,1073,1073,3zqXX6kzhkbW3d4TwD2CNjMRwxTbREXySekvq37kfCNk,85879,482369,-396490,620
2022-01-20 17:48:10-05:00,3459,AGhvB6x3gmvAJSnr9UVtvhKqVg3Qgh1k4roHzrNHhAaa,HhhjXT6WJnz1HQfHcwKdBppuAhc8ncUcq1mkJ4EHqgpe,True,5890,1472,9,4,5,3zqXX6kzhkbW3d4TwD2CNjMRwxTbREXySekvq37kfCNk,365,2546,-2181,619
2022-01-20 17:48:18-05:00,3460,6dr65yANjSMmfBeKAuSxG3i16S9vMgF1CQ3zDyzh55Pn,EhrE5QpnshD41S4zPEBy2A5q2Gs2mwUrbHGo6WnT9zDP,True,311710,77927,487,243,244,4BnQKPLuE3DMTtxp8MjUBytgnhvxqq3ZTqZHTVZo4JJh,19488,158291,-138803,625
2022-01-20 17:48:18-05:00,3461,AM5fwZR9BUW8AFkhdGWXW4PHd2cy8ora63kDf2z2eknw,E7ru6hg4MchnRG5zcr5YazwX8Snt55r5Xq9zCHCGaYZT,True,890384,222596,1388,694,694,3zqXX6kzhkbW3d4TwD2CNjMRwxTbREXySekvq37kfCNk,55552,430667,-375115,623
2022-01-20 17:48:18-05:00,3462,5nauZoaxftcYR591YH4v52myeJLnXtY4okdttL9qSdkg,7x3G299D3bC7EwUQojhTXUv29BG4NGzrLbgS4mEyqG5r,True,430960581,107740145,669027,334513,334514,4BnQKPLuE3DMTtxp8MjUBytgnhvxqq3ZTqZHTVZo4JJh,26761089,95740508,-68979419,620
2022-01-20 17:48:19-05:00,3463,5jin5wXjQQ25nGM2ECrCXcg1a95vquh6kM7rMRru6Ke7,EKM657EQ8HWWgf4cssByoYHoXGjFfTspTKXAGmygAPQG,True,35040780,8760195,54402,27201,27201,DddJ7EWCmYEEZETCBNgAUSg81Ls6fZtiAaY5ekJ5sXx1,2176099,17339333,-15163234,621
2022-01-20 17:48:19-05:00,3464,ES1MDwRUa3hoToPKQiiZkzMYe9PDVnAQwMrEvZrzvnc1,C4wBG3xTDkmDQneB28xYnf1aBNEeq7UB8oR7NuEfLkFg,True,25652237,6413059,39900,19950,19950,3zqXX6kzhkbW3d4TwD2CNjMRwxTbREXySekvq37kfCNk,1596020,8941145,-7345125,622
2022-01-20 17:48:19-05:00,3465,DAku12iueL13vRoTpKLyqdGaLQ2rWF6REe8Dr8soFvNs,H2vVH3LxkhGe6x6Mdwy67BYwTKNQM6XayKx7mhrwyfJM,True,415531,103882,644,322,322,4BnQKPLuE3DMTtxp8MjUBytgnhvxqq3ZTqZHTVZo4JJh,25787,210938,-185151,620
2022-01-20 17:48:19-05:00,3466,6xikA6d7sjCBnSfqkFwrL4nPrtQUNWdRhXB7i1AccnxC,G8t7u2R9qjRfdTdULs74v3nVrTM2WeKvc4dK4FFAvuG1,True,34899251,8724812,54530,27265,27265,3zqXX6kzhkbW3d4TwD2CNjMRwxTbREXySekvq37kfCNk,2181219,8036986,-5855767,625
2022-01-20 17:48:19-05:00,3467,5RvNKzSeJ1fvqsKpcQu25evEZGmKjyEDgwsMZkykoT3P,BRqSGfE4XHXu4HrinwetWumfVTmr82iuF6Y5oSV6eMiK,True,136677,34169,212,106,106,DddJ7EWCmYEEZETCBNgAUSg81Ls6fZtiAaY5ekJ5sXx1,8510,48035,-39525,622
2022-01-20 17:48:19-05:00,3468,FpqCxvTkSiwDwD5qEt6hXJxzFDLFLAQ8VevK8zwRqYun,A3p6YQisCJKpNkF7vkjZRbEfbnUt7vTZdR2zPBUSdTkk,True,382445933,95611483,591878,295939,295939,3zqXX6kzhkbW3d4TwD2CNjMRwxTbREXySekvq37kfCNk,23675152,141857569,-118182417,619
2022-01-20 17:48:19-05:00,3469,C2Dmfw4G8KKzFq38aRH2pLCRngnGZDvUUN3fHDMjFkoG,7kzJk3BTNvY3hGFNj7nDy9L5CAYus6eNiCAxWH8dSioX,True,345814,86453,538,269,269,4BnQKPLuE3DMTtxp8MjUBytgnhvxqq3ZTqZHTVZo4JJh,21556,210711,-189155,623
2022-01-20 17:48:20-05:00,3470,6u6bPgAmK8ufACrQV99A1Y5nhGkue3KEUHmQQkcNkxwP,7636yXT5w4DcVpc7LJdN46aiggzSq6U2GXHXL5kyy9F3,True,110511109,27627777,172855,86427,86428,4BnQKPLuE3DMTtxp8MjUBytgnhvxqq3ZTqZHTVZo4JJh,6914201,54557598,-47643397,625
2022-01-20 17:48:22-05:00,3471,GGGyesjbt7h2XHHp9u8vpiWGugFwEbrtYaKrNQSDhQd7,8tydo1ZjGHmPBSqU33tywB3f9szdsHk1ckGFe4Ay5pgs,True,47030458,11757614,73404,36702,36702,DddJ7EWCmYEEZETCBNgAUSg81Ls6fZtiAaY5ekJ5sXx1,2936189,35695350,-32759161,624
2022-01-20 17:48:38-05:00,3472,3Lv2XpiD4KBUHq7Zx6u3zNhpXoySodXHH8o8f5yaaPxG,H6TN4rhpBXkEH3mZnymYNcKfmnxRH2uzfwzeLH2q6ahP,True,173968,43492,271,135,136,4BnQKPLuE3DMTtxp8MjUBytgnhvxqq3ZTqZHTVZo4JJh,10875,76029,-65154,625
2022-01-20 17:48:38-05:00,3473,Ayx8dFsVzUBb9b7QKxw7YHJuhptdSitBXFEczXTaxe85,EvU1VLChnowi6ccSPeJRSk65njrqZfYouAN7SHePxsxf,True,21793,5448,34,17,17,4BnQKPLuE3DMTtxp8MjUBytgnhvxqq3ZTqZHTVZo4JJh,1361,11097,-9736,624
2022-01-20 17:48:38-05:00,3474,2QStaRnbSnDhA891Lb1bxjVeMYpJUpNdqaVkw3rqU45V,DakRWPnttPoRcjY5V7WLwiwBx39BapCo9Atog8dL17Ku,True,2109340,527335,3296,1648,1648,4BnQKPLuE3DMTtxp8MjUBytgnhvxqq3ZTqZHTVZo4JJh,131859,692200,-560341,625
2022-01-20 17:48:38-05:00,3475,6CeKxTJvFqhyNEyzySiBBKEwYVMe7j3A6nkMes4BW6o2,DzDR9XvwY1z7ygQ8YrCXrwDGHSf67JZF8BzUnuFE2fxQ,True,4077092,1019273,6375,3187,3188,3zqXX6kzhkbW3d4TwD2CNjMRwxTbREXySekvq37kfCNk,255024,1515962,-1260938,625
2022-01-20 18:08:50-05:00,3476,4ne6vC7qdxQYHJCsaeFAKZrKdFt2SwXGHQ3jrMHqt4DL,Cf1dLHY2WXH9rXbRKq5TT8THbdo9SdNUZq4rYhRCF9z,True,93790797,23447699,146085,73042,73043,3zqXX6kzhkbW3d4TwD2CNjMRwxTbREXySekvq37kfCNk,5843419,22032622,-16189203,623
2022-01-20 18:16:00-05:00,3477,2FrqGFZjbiNykJyo9BZ5S9FguQJPJiTi681rJJsQ5dta,3QUncYP92NKrfpaTvuF9iQg11PXKgZAgEngwh6BbnCCj,True,768683,192170,1190,595,595,4BnQKPLuE3DMTtxp8MjUBytgnhvxqq3ZTqZHTVZo4JJh,47616,321554,-273938,619
2022-01-20 18:16:00-05:00,3478,3njiRuSRMXRzKmamyiR72Hc38PU8UDDmWdfPhgxmGxEW,5WoF3gkgygyNNbwxWgVfqGWkExcDixuzgJQQjXEZQ6J5,True,237369504,59342376,366571,183285,183286,3zqXX6kzhkbW3d4TwD2CNjMRwxTbREXySekvq37kfCNk,14662871,164836722,-150173851,617
2022-01-20 18:16:00-05:00,3479,8NdcaYUC1X5CP7FMDip78uqtqmCt8GcZdCzLRTYTihmb,9Ei1K9bXWXSXcBfeX5exPSXGCAu62WSKzvnnd4wHvyVh,True,122272,30568,189,94,95,DddJ7EWCmYEEZETCBNgAUSg81Ls6fZtiAaY5ekJ5sXx1,7564,54205,-46641,618
2022-01-20 18:16:00-05:00,3480,8VnGmfop6qcUezAJ2M15jz2Nn6mPQgehDcJPvypq4XJn,6F6sqXNhgkW9ev8QNMm4ydywUUmemhwgydRQYNeqyUmi,True,9851124,2462781,15170,7585,7585,3uL2NSR2ZdDqCiKfzA5SwwpddAnit22DBJo6uvvz1rRs,606830,8553590,-7946760,616
2022-01-20 18:16:02-05:00,3481,8hpAXzimCw2bTwLXoRFAbqNW8qoj5VV3JDYCuJwqHpHm,DkfsL2M7oRBX6grAfy15C4urwL6ToMJ7TWJEFAGhWjYX,True,8605746,2151436,13233,6616,6617,3zqXX6kzhkbW3d4TwD2CNjMRwxTbREXySekvq37kfCNk,529358,1913612,-1384254,615
2022-01-20 18:16:02-05:00,3482,BAczoNDnbwj5AJX5LwzynzYab7ji7VbhRy9edA9Prax,34sbkUKnMetUNyMs6BhiWut85d5UZtBWnPtwx8jEpJNA,True,1209096,302274,1867,933,934,DddJ7EWCmYEEZETCBNgAUSg81Ls6fZtiAaY5ekJ5sXx1,74694,552929,-478235,617
2022-01-20 18:16:02-05:00,3483,AHm7zF4rpaxaayBLn5QDHgJSp8KAr647s4cNvQ9wLgd7,FDM33WngED24pukBvSDpPAzinW6afVAeGReum5nyLRiC,True,770563,192640,1195,597,598,DddJ7EWCmYEEZETCBNgAUSg81Ls6fZtiAaY5ekJ5sXx1,47816,393745,-345929,620
2022-01-20 18:16:02-05:00,3484,F2v1YwVAwXLiUgsJ5uwn4qAAkTXitn1E75fJcPnGuAcy,5rdJ4H5GxPg4Juu77mGc7uya5LwEqLzDSRyG8mQ2mDbK,True,17942492,4485623,27857,13928,13929,3zqXX6kzhkbW3d4TwD2CNjMRwxTbREXySekvq37kfCNk,1114303,8864189,-7749886,621
2022-01-20 18:16:06-05:00,3485,5SskSWkRPP5BNaqvHkJCbTAgHPUkHEwFh5pFr4t8PoBr,EqdX8Sdm9LCfdrzVKzisKaFcP2YEdSRNZYmev5RWjGqb,True,3643870,910967,5657,2828,2829,3zqXX6kzhkbW3d4TwD2CNjMRwxTbREXySekvq37kfCNk,226284,831984,-605700,620
2022-01-20 18:16:06-05:00,3486,6tFQaTqqffino9kwMZTL2xVNBG8k9VREFhXqVi2si3A3,3w3wGxBbS4bmXeqmvd595SAWFeXekVpnH4UdbeEs8Sx5,True,4076442,1019110,6333,3166,3167,3zqXX6kzhkbW3d4TwD2CNjMRwxTbREXySekvq37kfCNk,253340,1514928,-1261588,621
2022-01-20 18:16:10-05:00,3487,Fd2HrzBAr4JobRPARZwpQHHVoSCEoog32A6tKMWAC1sK,BYappsar5sQf8VLem4wrLuTtrDFH9y8pEx1aMxfuU4Pq,True,28004473,7001118,43363,21681,21682,4BnQKPLuE3DMTtxp8MjUBytgnhvxqq3ZTqZHTVZo4JJh,1734538,13842183,-12107645,619
2022-01-20 18:16:16-05:00,3488,EmGW2aAG69ssWqCtbfDocRaM2u3TJsczn2HHP9jdmRvD,aypkDKsp9uqAB4F6mwvm5LofpsrFBuZT2MMWtE2eHdB,True,600513,150128,935,467,468,3zqXX6kzhkbW3d4TwD2CNjMRwxTbREXySekvq37kfCNk,37408,281518,-244110,622
2022-01-20 18:16:17-05:00,3489,6yw4GPvkqUbakcEWtqSCfjVLukty11xqjDpGxtEN9Km2,5ppEx7wkpqbG5nApCWMdRja3oRSheFmAAsNHUX7h2w2Y,True,1534822,383705,2360,1180,1180,3zqXX6kzhkbW3d4TwD2CNjMRwxTbREXySekvq37kfCNk,94411,1359152,-1264741,615
2022-01-20 18:16:22-05:00,3490,3VYtHvoT9wi4K1PBjg6JjCf6U9fVPDf6tX9jyRRvLxcg,Ba5fjpVyAxLbiP6hYJmrxzougi7JUEDfDLKBxSbbTL7q,True,419748290,104937072,652635,326317,326318,4BnQKPLuE3DMTtxp8MjUBytgnhvxqq3ZTqZHTVZo4JJh,26105403,84064160,-57958757,621
2022-01-20 18:16:22-05:00,3491,WMUVFELv3C3KdMKJ5ZL4rG7o1YrV1qTP6Mmp2S5Rp8S,7UNzS3zDqT1oeq9a7eJGU8cgf8eUzEAZubSBQvNmK6uJ,True,16865780,4216445,26063,13031,13032,4BnQKPLuE3DMTtxp8MjUBytgnhvxqq3ZTqZHTVZo4JJh,1042520,3514002,-2471482,618
2022-01-20 18:16:22-05:00,3492,9zpPiboHF5HW7NfCx7hYdmJGwUomVMTiUFc4Um5KrDi3,8q3eBpuwV6dMNkib9N8XQAq2tBUcjSANRe5SXpd4dFhZ,True,7631857,1907964,11842,5921,5921,DddJ7EWCmYEEZETCBNgAUSg81Ls6fZtiAaY5ekJ5sXx1,473691,2628889,-2155198,620
2022-01-20 18:16:22-05:00,3493,E8ifvhmyJGBGVQomo3AnZw2UcaLHcpGsTtuoCid8voU3,FMQUWTbTAfSLfrc6GTrz4DM2ZSgoxF3KtqGn8AyjVtsf,True,6615536,1653884,10249,5124,5125,3zqXX6kzhkbW3d4TwD2CNjMRwxTbREXySekvq37kfCNk,409989,2422042,-2012053,619
2022-01-20 18:16:25-05:00,3494,9UyQC8vc6zJJaSdnjvTAzgmcsw4fC3xFBBiCC1w9Sbjx,3ppBfboe6FPmt7f6WrivspMUoAznZKWQMeh3rCgw7vjQ,True,8326296,2081574,12896,6448,6448,3zqXX6kzhkbW3d4TwD2CNjMRwxTbREXySekvq37kfCNk,515868,2867230,-2351362,619
2022-01-20 18:16:30-05:00,3495,J4krKPBBTMVLZRgrSeYJAMyHQs2FkNm5TXk7nQWwDB43,ASmLbfNbhTD2HHeV7qzAqiHjUx5a8Traj8oPDwbkMdFg,True,26422365,6605591,41338,20669,20669,3zqXX6kzhkbW3d4TwD2CNjMRwxTbREXySekvq37kfCNk,1653543,10029585,-8376042,625
2022-01-20 18:16:33-05:00,3496,H1LftKtj94Zs6PG2A7gJt9rPurBkXkTy2hbbArQwAehi,8bANmhgdnPYa3PqdPnk5BA2xhvqJmPyaMF77mrBePJ13,True,35594,8898,55,27,28,3zqXX6kzhkbW3d4TwD2CNjMRwxTbREXySekvq37kfCNk,2218,28572,-26354,623
2022-01-20 18:16:33-05:00,3497,2F45BX9mRmtNCHPejKFknN5aNgGvR4vVLFjMaY1a7dR8,ALdSutsvEFRUEQGGBbi31QywTL1pdXSDWrNJzvNTaoXL,True,23293823,5823455,36186,18093,18093,3zqXX6kzhkbW3d4TwD2CNjMRwxTbREXySekvq37kfCNk,1447446,11108683,-9661237,621
2022-01-20 18:16:48-05:00,3498,3EmGvYu72cR4Ta3wLA5HKZBEqgfChCyiRanwj5hGLJXc,6NEWPFaKi5uLsrj4n6RM1DBhQTcGFE9TwYeJ12pC7yyp,True,37048,9262,57,28,29,DddJ7EWCmYEEZETCBNgAUSg81Ls6fZtiAaY5ekJ5sXx1,2318,15497,-13179,625
2022-01-20 18:16:55-05:00,3499,pgzvXpnUYiY7hLrfjmwScqLd8oj9vYcXpFvpm4y4JvG,GdqdQgoyBAFuXdbvoZyDhB3jyqJzVo4nkGh7EPFxkBF2,True,1967567,491891,3038,1519,1519,3zqXX6kzhkbW3d4TwD2CNjMRwxTbREXySekvq37kfCNk,121536,1754145,-1632609,617
2022-01-20 18:17:00-05:00,3500,CvZssqscu2dm35mwcE3zg9zedavbRjVJjWD59Py5ExUK,7pXaoR6aHKYofCmg1eHipygNYDteEaf8rbbS8BDYGQK6,True,653161,163290,1009,504,505,DddJ7EWCmYEEZETCBNgAUSg81Ls6fZtiAaY5ekJ5sXx1,40387,243376,-202989,618
2022-01-20 18:17:02-05:00,3501,67Z7ZGhNu5xxEh9BYKWcXp9m1T4tFiE1o1M16hCzUWQA,CT7YKWixz7BhTbvg5F6M5HCyPGnHoFLNFuDV9GhoLTo3,True,3032385,758096,4699,2349,2350,3zqXX6kzhkbW3d4TwD2CNjMRwxTbREXySekvq37kfCNk,187974,1765573,-1577599,619
2022-01-20 18:17:04-05:00,3502,51yPLtXTgL9oLKs1cCf5TjL54Ld5vuVxat2NNtwZVsZG,7UjtM7Z1tiXEQMMiorQyncgi9SKu3v46DhVdgXbWqSiF,True,331025315,82756328,515278,257639,257639,3zqXX6kzhkbW3d4TwD2CNjMRwxTbREXySekvq37kfCNk,20611128,283849157,-263238029,622
2022-01-20 18:17:12-05:00,3503,CRaKcudjkQiSw5YPVjTLVdXvJskeGiHSYtq5ZcMPJhgQ,AgqTg3b3bAcaBmRidhNC4Uf9ZwNbeH52RQEqumWyuUs7,True,807872,201968,1255,627,628,3zqXX6kzhkbW3d4TwD2CNjMRwxTbREXySekvq37kfCNk,50216,495055,-444839,621
2022-01-20 18:17:12-05:00,3504,DdYgcyV1T2CDYiQVr4VL9Ym8RdKm93a7SKy8HxuyaoMW,GPdAeqeXb1UJ56AttcwwY1CyFhRyfptDC4BAX2Tc8MpE,True,490469,122617,764,382,382,3zqXX6kzhkbW3d4TwD2CNjMRwxTbREXySekvq37kfCNk,30578,251955,-221377,623
2022-01-20 18:17:13-05:00,3505,4cKgCTttVp8pzJnp43PP7uLLUXNcU7YGPJ3cCGHaUFe7,BBQqjwTpVEgpDzMk4wDDH8rCjaSxCRPWVhtFxERSujTD,True,37744393,9436098,58792,29396,29396,3zqXX6kzhkbW3d4TwD2CNjMRwxTbREXySekvq37kfCNk,2351688,16352093,-14000405,623
2022-01-20 18:17:19-05:00,3506,DGAQzgZhS2yioeZmG3cbacM3hdz4F1aZn1PWRwgiFukc,48KUtJaNCPNxkLXJBtWAdDxY4b9vZzLgbGxTNdwMqmjz,True,487627958,121906989,758226,379113,379113,3uL2NSR2ZdDqCiKfzA5SwwpddAnit22DBJo6uvvz1rRs,30329060,228003566,-197674506,621
2022-01-20 18:17:20-05:00,3507,6nJyqvFKprwaVCE1gAa2P4RHKc6Pa6XFSJymx654zZ9K,4e7iJmdwzAPxp1Zi8Azo38YyPQdPKqqY4VLJyQ5rpdYP,True,2324481,581120,3610,1805,1805,3uL2NSR2ZdDqCiKfzA5SwwpddAnit22DBJo6uvvz1rRs,144438,1203245,-1058807,621
2022-01-20 18:17:20-05:00,3508,o2aCmkxsxSiyUX8soTEjwUCbJeXmCZsEaf8CWwxDT5n,3pvS2bTsUuiQyqZp5rdnTpq4cqWGgtv4E5rN9HsBxpRt,True,22292,5573,34,17,17,3uL2NSR2ZdDqCiKfzA5SwwpddAnit22DBJo6uvvz1rRs,1389,6566,-5177,623
2022-01-20 18:17:29-05:00,3509,DdAPWdHnb7ocaYtcwwwYnppsH39sZpmzMyANeoJbCV7s,3BVmC39L8dEypPN1BZhsf9bx9Ge2sXCZR8Y6RH4eBNMJ,True,981595240,245398810,1534932,767466,767466,3zqXX6kzhkbW3d4TwD2CNjMRwxTbREXySekvq37kfCNk,61397287,718982359,-657585072,625
2022-01-20 18:17:32-05:00,3510,9vcKW1GfrDZ3KLPh2pEVFF8ZyKqD1pJW1hiE8H98Av7S,C6Ki27mo4sCHu6u8UnR1p7WSgsTjFQxGGR9Lk9n5Rhjq,True,2591048,647762,4028,2014,2014,3zqXX6kzhkbW3d4TwD2CNjMRwxTbREXySekvq37kfCNk,161147,1267825,-1106678,621
2022-01-20 18:17:37-05:00,3511,CBL2NbekJrXvBiAcoj4fzQ4PfLDwTntW7Zt4nruHFYEw,59EvfgYTdKkfjUJz5LddLUAqbEdLaihcMzjcrTZsyzyS,True,8722,2180,13,6,7,3zqXX6kzhkbW3d4TwD2CNjMRwxTbREXySekvq37kfCNk,542,3735,-3193,621
2022-01-20 18:17:37-05:00,3512,Ckqos6cdncPKj13DnCmDVZsZTqp6eS7277CRrT9WhcEr,AtUV8m7VQJvZq7GLCAHMf3jV7iamKEPnWVZHWuuVZQp1,True,1157225,289306,1791,895,896,3zqXX6kzhkbW3d4TwD2CNjMRwxTbREXySekvq37kfCNk,71651,710125,-638474,619
2022-01-20 18:17:38-05:00,3513,6oroGB3mvzK3tDfiB9X2NJuL3x476pxhgRnt7VxqhdLo,2SoK8tKkLn2ppKURpTVazKsCEis4uahkHMsac1m85J4r,True,1669750,417437,2593,1296,1297,HfEnetJ7uBSmZWCjBNxdvv9HEC5nsW4wDV7wu6WnhWan,103758,1437098,-1333340,621
2022-01-20 18:17:39-05:00,3514,M69XSefqeum2arinvHEqmA3L2XHWNFN17p4msRhRZXf,2vK15yYUANLSbAoiBfgJ9VLyqsmtEpd2iNytQjms8GaQ,True,252556129,63139032,391048,195524,195524,3zqXX6kzhkbW3d4TwD2CNjMRwxTbREXySekvq37kfCNk,15641947,162360302,-146718355,619
2022-01-20 18:17:40-05:00,3515,HVZkXeDR3mc8oB9qFFwCK4RXpPojdcHk9tRGep6xtKGK,Bh3py7awPejWqeTMxtAgF7mPotL2Asxf8YrYJykq9nBt,True,6146529,1536632,9562,4781,4781,4BnQKPLuE3DMTtxp8MjUBytgnhvxqq3ZTqZHTVZo4JJh,382508,2683647,-2301139,622
2022-01-20 18:17:42-05:00,3516,5rW9kqXB9feGSKSvSMNJF1FCsBYV3vGmTmc8MvzaZ3pi,7AjnjcfPJevW5521hXw4VtgRCfHSsAqyzyArukKfNcHo,True,10252138,2563034,16040,8020,8020,4BnQKPLuE3DMTtxp8MjUBytgnhvxqq3ZTqZHTVZo4JJh,641639,5338208,-4696569,625
2022-01-20 18:17:42-05:00,3517,2jPxG5FL6D6XEJsRszJ9cmQ54AWSpZyPFSbn3DpWBSuM,3toQou4UVNvyWYvMvkuv379RVEF2aN2TzCpKKBUqeQV6,True,180006934,45001733,281075,140537,140538,3zqXX6kzhkbW3d4TwD2CNjMRwxTbREXySekvq37kfCNk,11243010,77269835,-66026825,624
2022-01-20 18:17:43-05:00,3518,CagSUfZLwXuCdypC4KzU6FSNdmCj9dKDroPcNeaRtsyt,yxw5d1ztZuEUY2QjL7eLpr72QJAj5rJd6ERvg91cy1m,True,1507914,376978,2352,1176,1176,DddJ7EWCmYEEZETCBNgAUSg81Ls6fZtiAaY5ekJ5sXx1,94112,587451,-493339,624
2022-01-20 18:18:10-05:00,3519,BrHRMouGRz3LBNzd9anfdYMhWfg8yUPHL4PqJ8WdEDFS,4uzoLa3mC2VYHAPBoHLX4gTjPTC28rPf2fvEGtJWPYc,True,56725035,14181258,88735,44367,44368,3zqXX6kzhkbW3d4TwD2CNjMRwxTbREXySekvq37kfCNk,3549428,46269209,-42719781,625
2022-01-20 18:18:18-05:00,3520,3C2MZQKh9x4zNTCMbhhvoafGaFMwUooqfy9MCgPyXs6E,AHjgWKpYPWe6ketjDHDKFBFsKQiRJ41jnkuo39MVYxZo,True,197159267,49289816,304751,152375,152376,3zqXX6kzhkbW3d4TwD2CNjMRwxTbREXySekvq37kfCNk,12190044,114616307,-102426263,618
2022-01-20 18:18:18-05:00,3521,BPsM1um9ZJf7eNoVMsQCRSwgARMuLCGGSDxf9tZeNeEy,BpzDdXfxVygiSYSmsHV6uPxQMeTFtrURMCCqhswQjd5X,True,1122891,280722,1746,873,873,3zqXX6kzhkbW3d4TwD2CNjMRwxTbREXySekvq37kfCNk,69865,448520,-378655,622
2022-01-20 18:18:20-05:00,3522,DMgD2KCEhTGFLUZ5GnfNcwfiiwKYbyVpoWiN6knMkCAf,5KU2vgBkPTNVHsSULjgX7ZkZS56U3Dy3xqLTxL5sUZJ3,True,1328253403,332063350,2072868,1036434,1036434,3zqXX6kzhkbW3d4TwD2CNjMRwxTbREXySekvq37kfCNk,82914752,814271733,-731356981,624
2022-01-20 18:18:20-05:00,3523,HGJoZvLakWfSDFwuvShNBc4kCf7nP7VqzyM3mELpbFEf,12Qn5jin7QvsBngXqYAv4UstyG3b6nRf1jsLp9Dp8G7k,True,15103275,3775818,23340,11670,11670,DddJ7EWCmYEEZETCBNgAUSg81Ls6fZtiAaY5ekJ5sXx1,933618,6946058,-6012440,618
2022-01-20 18:18:20-05:00,3524,8MGEQ1KEMv9WSgVifjN7CQ7tDbJBJbWgGYu71dTDKEPQ,mQY2X9KYVXf9JmGY8XwMK4G8odM4HmWkgEmYYqKnkvF,True,160180772,40045193,247300,123650,123650,3zqXX6kzhkbW3d4TwD2CNjMRwxTbREXySekvq37kfCNk,9892021,82187766,-72295745,617
2022-01-20 18:18:20-05:00,3525,3qnPsgqW11AcDEmyjmJquPcPLyE3EdJQuVLJ5kinDrd3,86rZadBB7emKio76aFTahpbrFtxd9tqZ4Mxgzaavq2xU,True,147118,36779,226,113,113,3zqXX6kzhkbW3d4TwD2CNjMRwxTbREXySekvq37kfCNk,9079,64695,-55616,617
2022-01-20 18:18:20-05:00,3526,2FEbsetZMkRqLjSC8GBbgecKgX5T1T1fci2sLQux29p8,H722Fcd6DkTFRZxqQWbPDufBfXEgmFfhiEpQZWhxwYv1,True,4499148,1124787,6962,3481,3481,DddJ7EWCmYEEZETCBNgAUSg81Ls6fZtiAaY5ekJ5sXx1,278504,1785143,-1506639,619
2022-01-20 18:18:22-05:00,3527,GqAS41YJssg9aaEp3hs3sG98APCsXhiQBQszXaSjZ2bN,2wodJ3AhrXdE1T4oVL95KvoBND7PubG5Wd5GWiLCMZJU,True,176884892,44221223,273007,136503,136504,3zqXX6kzhkbW3d4TwD2CNjMRwxTbREXySekvq37kfCNk,10920300,145357663,-134437363,617
2022-01-20 18:18:22-05:00,3528,72woixtGAuGazCMfsYfYBYLP7FuRj8Fwz9fynFo4MCE4,5237BmWkKf58PBeTUEiu3Ld5uKXEe8wcrJRmCnUoWWku,True,917222586,229305646,1435215,717607,717608,DddJ7EWCmYEEZETCBNgAUSg81Ls6fZtiAaY5ekJ5sXx1,57408639,199206053,-141797414,625
2022-01-20 18:18:22-05:00,3529,ymyzGH4Qc7HH5PbKpVphCbsQgLLXyGkPcXamQJuNj5C,8oTLHaV2XzbKXNWRuUjCfHjUn61Pw93LYK14m9q2VDpZ,True,12811483,3202870,19941,9970,9971,3zqXX6kzhkbW3d4TwD2CNjMRwxTbREXySekvq37kfCNk,797671,5003458,-4205787,622
2022-01-20 18:18:22-05:00,3530,E1CShgy7M9998q9jyzpnHZxHJR6z5hvnshUJt37kVPtG,96f1nYW4S9APCJS3TXTGSb9UcJDdxJuoBR3pLYqcNz2b,True,164633923,41158480,257013,128506,128507,4BnQKPLuE3DMTtxp8MjUBytgnhvxqq3ZTqZHTVZo4JJh,10280555,70624347,-60343792,624
2022-01-20 18:18:24-05:00,3531,BYvjENe16Ta77PqGV7JKEWrsqCTfkMGYwTSG5gXneDvd,EvxAXgvhPC6QkNurbK7vWyTApGo8J2R4EgMAknkHVU3d,True,2879946,719986,4506,2253,2253,4BnQKPLuE3DMTtxp8MjUBytgnhvxqq3ZTqZHTVZo4JJh,180247,1804938,-1624691,625
2022-01-20 18:18:24-05:00,3532,BJV5jbowrbELXfDvfMovaQy4PiRf12pLYHimW9bgzW5X,6WXrWso5FvLx7RMCFBzrbzh5qevKkk2LJAihUfWXxXzB,True,20164359,5041089,31455,15727,15728,DddJ7EWCmYEEZETCBNgAUSg81Ls6fZtiAaY5ekJ5sXx1,1258222,16589832,-15331610,623
2022-01-20 18:18:24-05:00,3533,B4Uc39nKzz9wBRQsCkMR4A7RwTJ8rSuwpR6EQn2AesRb,H49bGZgatRZVpj6QufZRVgYrQtH7LpdbiqKBs23151m,True,24107015,6026753,37602,18801,18801,DddJ7EWCmYEEZETCBNgAUSg81Ls6fZtiAaY5ekJ5sXx1,1504098,21746313,-20242215,623
2022-01-20 18:18:24-05:00,3534,U3vvMQ4X4aKzVYfhMw1V1p58HRqaLnuXozqmmefYeD9,7JA94MArkNCFRhBq8f5a32DgMF6aPdFsoC5HvXDQ6NuR,True,292541761,73135440,454796,227398,227398,DddJ7EWCmYEEZETCBNgAUSg81Ls6fZtiAaY5ekJ5sXx1,18191876,154886603,-136694727,621
2022-01-20 18:18:52-05:00,3535,AL8JFS4gjaQx89f9j8wtaNJgV76K8bw1ugvNtgvhgAnb,HJYvG2kGKe8kXgtZSWTWwTmSjxA3XUeCvyT7acoKtS1C,True,4394887064,1098721766,6804621,3402310,3402311,DddJ7EWCmYEEZETCBNgAUSg81Ls6fZtiAaY5ekJ5sXx1,272184845,1483625695,-1211440850,619
2022-01-20 18:18:53-05:00,3536,FF8rqfM9PTEjYiVFy8jS81weDRwdaYooux2uSa2LexrJ,JBk1JghH1gged1YpDbkczFXP9ka5ivYSkaYoVbbXD4kg,True,174576354,43644088,269168,134584,134584,3zqXX6kzhkbW3d4TwD2CNjMRwxTbREXySekvq37kfCNk,10766737,86165133,-75398396,616
2022-01-20 18:18:53-05:00,3537,3WcJUt8jQ1ngL3ZCGo6dFrc3GmTMTYtzeDva7mri2Tqx,HeG1Pz2oMjqtkfsRMsbqP3VpatnVEQzcWmKDVoFp4Htr,True,15108937,3777234,23492,11746,11746,DddJ7EWCmYEEZETCBNgAUSg81Ls6fZtiAaY5ekJ5sXx1,939700,6946478,-6006778,621
2022-01-20 18:18:53-05:00,3538,Cs2YxkuqBK1kjoYZbUZdUcxapPbv8oC75trwGgWoCPfG,2PgHQM1GhHykE4bQ1ggueAw2Zs1BFUW5hxvMvr8DojKM,True,52893936,13223484,82309,41154,41155,3zqXX6kzhkbW3d4TwD2CNjMRwxTbREXySekvq37kfCNk,3292368,30481696,-27189328,622
2022-01-20 18:18:53-05:00,3539,AA6QgBaH9F8QfPT9xjztv9uELcADPxwUuXofkBV8dYg4,FCMXozSstTNA74FVCJ5hpYvNJamjutnoakHoBVnzwcWj,True,19984,4996,31,15,16,3zqXX6kzhkbW3d4TwD2CNjMRwxTbREXySekvq37kfCNk,1247,9465,-8218,623
2022-01-20 18:18:53-05:00,3540,6rb3fRVWJ5cSzFcmuC1YwdrNxiNctvboDF7HwsfyGoCA,H6JaYfFZkRk6iSJrA4nVeuFpMVQtVwQZHVgK1TyaupTE,True,40389,10097,62,31,31,HfEnetJ7uBSmZWCjBNxdvv9HEC5nsW4wDV7wu6WnhWan,2494,31823,-29329,617
2022-01-20 18:18:53-05:00,3541,CP2qcTSw1Y5J7jZiEgbtsvJoigRbJ4m9oHGQS8Fiai2x,7Zd1uX1thbuGkp9H4r1t8aLTu9W8MxvUBNjji2FNJa8E,True,37758932,9439733,58958,29479,29479,4BnQKPLuE3DMTtxp8MjUBytgnhvxqq3ZTqZHTVZo4JJh,2358329,16344195,-13985866,624
2022-01-20 18:18:53-05:00,3542,7jvKp6onXyWgwsFrFWj4hYTXJsYYD6ot5mn6rPFuJriy,J7N6HiozevJVTiY9hDEUs2ud5BwT5QSE7wnMBS1w5ie2,True,41443372,10360842,64761,32380,32381,DddJ7EWCmYEEZETCBNgAUSg81Ls6fZtiAaY5ekJ5sXx1,2590469,21292859,-18702390,625
2022-01-20 18:18:53-05:00,3543,CwTus4FyoXYqyTKAYDp69NLhA1joYZ3tarzY6FFTr6fn,6ivuvYWU6i25MzJSY8rG9rPDKiq38E6QtrV1jvRubLGr,True,9745,2436,15,7,8,3zqXX6kzhkbW3d4TwD2CNjMRwxTbREXySekvq37kfCNk,604,4359,-3755,619
2022-01-20 18:18:54-05:00,3544,FV9CBGGTbppLnBKh79f2LzD1diTiS5g6u89FcpZHZmnK,Fe7mtmCUziFqbbYTvrhAcAq1Ub7YLfTJRtQ1hG7GzJD1,True,5063474,1265868,7830,3915,3915,DddJ7EWCmYEEZETCBNgAUSg81Ls6fZtiAaY5ekJ5sXx1,313236,2009401,-1696165,618
2022-01-20 18:18:54-05:00,3545,9ebpuMtXee3DSx4qWiEYEtTT1gK5FqCY2H5yQVWWtTts,9b71dTsTYD1bx6KsjFs5h6d3Jj4T9eX3nqmS7RQj3HS5,True,281721142,70430285,439016,219508,219508,4BnQKPLuE3DMTtxp8MjUBytgnhvxqq3ZTqZHTVZo4JJh,17560662,120485365,-102924703,623
2022-01-20 18:18:55-05:00,3546,6Bq55LtGCEeGqh4JrFLCmmGc2iJfTTBJixivqH78aGSE,DSNrCgWJeNe2P9tAQu5FvCueTzNKDKds7wzuwTQSMRG,True,6392904,1598226,9898,4949,4949,3zqXX6kzhkbW3d4TwD2CNjMRwxTbREXySekvq37kfCNk,395939,2494634,-2098695,619
2022-01-20 18:18:55-05:00,3547,96StvqZyFUPtyMr4o9s7K4V29RSNyRpVi76vNwxG5rUf,GZKXFSFq4aGiTaqovtxqNCCVGkAFNXPh4Hep1ZMwdZ8g,True,21489605,5372401,33255,16627,16628,DddJ7EWCmYEEZETCBNgAUSg81Ls6fZtiAaY5ekJ5sXx1,1330211,18731418,-17401207,619
2022-01-20 18:21:47-05:00,3548,3Xbsek5MsEGoWr3G9yhuohREr26B2vSQcjqXdspTFHta,2rPxkUiMo9wGDq8EvAiwY3ngRpKmL223cBWWNTYoBmFp,True,188824350,47206087,295152,147576,147576,HfEnetJ7uBSmZWCjBNxdvv9HEC5nsW4wDV7wu6WnhWan,11806114,43111764,-31305650,625
2022-01-20 18:23:45-05:00,3549,2PzBAkdXkrwH9VuoMALumQz86qkW7sSBQtCrHw14JUp3,D5vwWAMHVooobG2sCWv9EwtJrAFZG6cwKH4dfmA98tbt,True,1953306,488326,3044,1522,1522,3zqXX6kzhkbW3d4TwD2CNjMRwxTbREXySekvq37kfCNk,121770,871246,-749476,623
2022-01-20 18:23:45-05:00,3550,F1JT1p2VuwK4L7zj7NNnZtYiZiNUCcTGKDkgdoX3BZdZ,3BKe4yzTwnnBnvTWP3britpPJ4oAWL7JZJzNLCxjUufS,True,4881,1220,7,3,4,3zqXX6kzhkbW3d4TwD2CNjMRwxTbREXySekvq37kfCNk,305,1269,-964,624
2022-01-20 18:23:45-05:00,3551,3REbHhGGpn5b2GH67yQy2Dn7ZLNGLfM6hkBNU8UE1BRm,FBeCamJw884cPNpzbzhjSF7CFXyyhjnj3qWWCdBCK1NP,True,4457995,1114498,6971,3485,3486,3zqXX6kzhkbW3d4TwD2CNjMRwxTbREXySekvq37kfCNk,278876,920881,-642005,625
2022-01-20 18:23:45-05:00,3552,7vKmhLV45Q5etXhJL5ng8rxWhYSiUCDmAbGnwBPr7zcx,cP6xPeuHLnjr858QK1F9qYn7rJpEbPy7wEJHoju6oV7,True,32496986,8124246,50657,25328,25329,3zqXX6kzhkbW3d4TwD2CNjMRwxTbREXySekvq37kfCNk,2026285,14360855,-12334570,623
2022-01-20 18:23:46-05:00,3553,FX5sizQGZcDCaETDyJ3HbLxFwhu4t9bX6YyQM7cVEo9Z,6EqnCsv1JPjz6JX1yLNcf74rmkuhAUx6Sf35QMYGuuF6,True,164545798,41136449,256378,128189,128189,3zqXX6kzhkbW3d4TwD2CNjMRwxTbREXySekvq37kfCNk,10255126,71137000,-60881874,623
2022-01-20 18:23:46-05:00,3554,X5SF9srgzDgBRBhv8xUWyszYYSQiqFF6cVnVLWzQgp1,7rTqnMkPuUUJFt5px1DxwsUK8U5fQUtnx9N4v6dA4vGb,True,24836,6209,38,19,19,4BnQKPLuE3DMTtxp8MjUBytgnhvxqq3ZTqZHTVZo4JJh,1548,11045,-9497,623
2022-01-20 18:23:46-05:00,3555,i7TcF4weYcqgrRdH3GpndbEYxCxfcSfr9JWYrAUg1CF,BkDfknUir7PnSEW8auoB87PytycEFwyX5kT2GY4SGJJL,True,3969814,992453,6196,3098,3098,4BnQKPLuE3DMTtxp8MjUBytgnhvxqq3ZTqZHTVZo4JJh,247865,3316574,-3068709,624
2022-01-20 18:23:51-05:00,3556,EhANPABkSw9x9WnsDEi8pCg67iQTX2UGTTUpyjADTwdN,4FKLi98hyg9ZjM4MY6ctJsv7B6vPUnTYWdhrnNoYsztX,True,7532283,1883070,11753,5876,5877,3zqXX6kzhkbW3d4TwD2CNjMRwxTbREXySekvq37kfCNk,470151,4135935,-3665784,624
2022-01-20 18:23:51-05:00,3557,7D4rFmGMPKNAF75VRPxHAhSn2wTjiW8jmth1UD22Xqq9,GQ7BrT6vsXu8tHCMm75YdxFR2r9QTCrCUbdPEZBSAg9w,True,35989486,8997371,56192,28096,28096,3zqXX6kzhkbW3d4TwD2CNjMRwxTbREXySekvq37kfCNk,2247695,13512046,-11264351,624
2022-01-20 18:23:57-05:00,3558,CK3ocyWzXQkJJZQmM6bBK4Nv6Rh3UEufjY6DvNU6gJZy,C924o4GY3p2BHLeAbFbe9SEysXqCUyD8sFu2d4NzkAV7,True,4891337,1222834,7621,3810,3811,DddJ7EWCmYEEZETCBNgAUSg81Ls6fZtiAaY5ekJ5sXx1,304871,1919888,-1615017,623
2022-01-20 18:23:57-05:00,3559,E1wp3bmkcY3eiEYyGYwhTCsr7BZ7RfPa5DJTZFupcFwj,452hVdYkD5SDDrA6hv6DLPFvyS8PvR2P6DPNScGxWTsW,True,605233,151308,943,471,472,DddJ7EWCmYEEZETCBNgAUSg81Ls6fZtiAaY5ekJ5sXx1,37748,277138,-239390,623
2022-01-20 18:23:57-05:00,3560,DrzTARa7RK8RXoxHZPKCBqYtMC8TAUHRw8SznXRKTa5M,FYANet92VhyXkKZqqBJR4sFxuCftWb68sgQU9VHCdTJk,True,24772,6193,38,19,19,3zqXX6kzhkbW3d4TwD2CNjMRwxTbREXySekvq37kfCNk,1531,10555,-9024,618
2022-01-20 18:24:01-05:00,3561,GhV3DChNShu8mGwUUy7VLidabCV6Y2aKdp7cqPynd6Ci,8R8QkgruGRCeE1pjXmn3WjdVDiawNbXFid8gU8BfabZA,True,13373,3343,20,10,10,3zqXX6kzhkbW3d4TwD2CNjMRwxTbREXySekvq37kfCNk,826,5709,-4883,617
2022-01-20 18:24:01-05:00,3562,5Z3ZFCA65WoWhm3okRuuziEMi7ajGAEHWUFchzBNba5S,FcomdrWidygkxMKzcsY5xELbmwC652uMci648LMTv7AB,True,9327,2331,14,7,7,3zqXX6kzhkbW3d4TwD2CNjMRwxTbREXySekvq37kfCNk,580,4044,-3464,621
2022-01-20 18:24:01-05:00,3563,4j19AEcDwhtAZrnoDc4epNPmEL1jPpVUMeg7RmQ72Qkb,84WB42AAGbczVE9txZPwXrx4FD5jP87r8QdDzEABTm5G,True,49270684538,12317671134,76654691,38327345,38327346,3zqXX6kzhkbW3d4TwD2CNjMRwxTbREXySekvq37kfCNk,3066187659,28831826410,-25765638751,622
2022-01-20 18:24:01-05:00,3564,2NHv3c4ufYGo3xNr6KXymAZJdpfURrNiCKbXZ7s82Vwo,E4NYpYgHTvSG6LqH2bBV9Q1XJ6pAzCp9FLSKMzJmYRrQ,True,19378255,4844563,29536,14768,14768,4BnQKPLuE3DMTtxp8MjUBytgnhvxqq3ZTqZHTVZo4JJh,1181443,10882942,-9701499,609
2022-01-20 18:24:01-05:00,3565,Cb4zhnvig11U4GcC4kqKrnDicGgPhUpfDQB1U7hP3nPa,DiRAMrKqaevGXeXg38KnhaYBERj8tNKU7oWFJvhS32kw,True,151032,37758,228,114,114,3zqXX6kzhkbW3d4TwD2CNjMRwxTbREXySekvq37kfCNk,9128,58325,-49197,604
2022-01-20 18:24:02-05:00,3566,8W9NJfM6cqCsvR1FC8Ab8YZPSQF7bz7inxJZxWnF7GsX,3exfPuVcTnPxs8GwCtS3ruKUGveYymwGV7RXQssPiizJ,True,294749005,73687251,445405,222702,222703,3zqXX6kzhkbW3d4TwD2CNjMRwxTbREXySekvq37kfCNk,17816232,242016630,-224200398,604
2022-01-20 18:24:09-05:00,3567,2rCRdyfi65rpxRRmg7knaSb8t55FuPt3h8wF4Fzhy8MM,CLVY5nSG3jTdRo7tRSKgK9DJgW6aswfWKe4tLxzsENmb,True,472012,118003,729,364,365,DddJ7EWCmYEEZETCBNgAUSg81Ls6fZtiAaY5ekJ5sXx1,29166,185867,-156701,617
2022-01-20 18:24:09-05:00,3568,75ycx5sUFBxDhY1uwuPCW22s2C6BydkJTje7q7zEQFGT,FpEgrVFRubjGK4DRjTqdVbxSECURpn16zfpoC31NbwnN,True,4775583,1193895,7292,3646,3646,4BnQKPLuE3DMTtxp8MjUBytgnhvxqq3ZTqZHTVZo4JJh,291683,2634530,-2342847,610
2022-01-20 18:24:09-05:00,3569,AKxRtcdpi7gWhAuL8ENj7zhgeQezzEXe9TSANE6bQoRA,2YH4vrU9deP8Cu6E8Hzf8GqKG1yVjv5pdz4FE7r5YKir,True,5127479,1281869,7837,3918,3919,3zqXX6kzhkbW3d4TwD2CNjMRwxTbREXySekvq37kfCNk,313506,2247123,-1933617,611
2022-01-20 18:24:10-05:00,3570,2BH44k4TYoQSqsSs5EASqJhxpH17Fr8Ahxbg2MAkWa72,HwvvVWpqfN7NDsVYdxbCSbqxSrLCThwnJiZQHh2w2zJb,True,13437,3359,20,10,10,4BnQKPLuE3DMTtxp8MjUBytgnhvxqq3ZTqZHTVZo4JJh,827,5797,-4970,615
2022-01-20 18:24:10-05:00,3571,96DzqyUxsB1FKWrhLdTdjDcokuus6rbx83gLsghqPPwt,74CWb7SVoSy3ADysEzFEeMiS2fxHJ9gdUF9pzM3E52Gj,True,14509,3627,22,11,11,DddJ7EWCmYEEZETCBNgAUSg81Ls6fZtiAaY5ekJ5sXx1,902,6309,-5407,621
2022-01-20 18:24:10-05:00,3572,9TL17gjvWFdhSJkpXgfnX7fKF9c2hfw59k3g8WUqm8Cb,7TyxFBKG4z5Xv3js3n1gbEWWj1M9KBF7dEmFxjCPGidC,True,138538756,34634689,211612,105806,105806,3zqXX6kzhkbW3d4TwD2CNjMRwxTbREXySekvq37kfCNk,8464512,49854054,-41389542,610
2022-01-20 18:24:10-05:00,3573,89CkXnSZnr52Zsoh48efv9MQacrkB6GMtrbEpNJSyA2H,HcvRBS4Z22CpYgDNgm4TVF4AVXFDuYzBUAFcdHAwdpg4,True,2245600,561400,3439,1719,1720,4BnQKPLuE3DMTtxp8MjUBytgnhvxqq3ZTqZHTVZo4JJh,137573,985556,-847983,612
2022-01-20 18:24:10-05:00,3574,HutRztBianNUgm9sJDWKUQBmoVyy8y7CfnNk4hHjSkEW,EtVfvPyiy5bizbCZxR19TNUgETf3QcmziBvMtc6o5zjr,True,184689434,46172358,286693,143346,143347,4BnQKPLuE3DMTtxp8MjUBytgnhvxqq3ZTqZHTVZo4JJh,11467730,161068887,-149601157,620
2022-01-20 18:24:10-05:00,3575,GaEpNGa8jnwSRvjzzEMYkZe1pKcr2eiZtePrqFxpABjB,5CFZHuyWbJv14zPdX5dSQDREgHrCb4vsFvB6hLiEe3Ji,True,114114,28528,175,87,88,3zqXX6kzhkbW3d4TwD2CNjMRwxTbREXySekvq37kfCNk,7034,50602,-43568,616
2022-01-20 18:24:11-05:00,3576,D3mXrJzhHf8qRaoCKLschUxAFoijFCFuT6bmNZH4W7Cj,9E3Xtqw7TncXWnbhAbFJMtuNmP6WS3ooGuptzyzw7UpA,True,43345,10836,67,33,34,3zqXX6kzhkbW3d4TwD2CNjMRwxTbREXySekvq37kfCNk,2684,25487,-22803,619
2022-01-20 18:24:13-05:00,3577,9rfebymEFqy2SoBoDKKUppZVRPr1zNh6gkFYkmVsqbqz,6pQ3MsewzM8jzKEQG5zJDry8iEMUjGA1UDJPEQjFWTgR,True,6196396,1549099,9445,4722,4723,DddJ7EWCmYEEZETCBNgAUSg81Ls6fZtiAaY5ekJ5sXx1,377818,1281422,-903604,609
2022-01-20 18:24:13-05:00,3578,6h43GsVT3TjtLa5nRpsXp15GDpAY4smWCYHgcq58dSPM,CTgbWridYWnfE5Emwr7qiCEb3LcXHupqeB9zwmddoEqB,True,118827081,29706770,183498,91749,91749,3zqXX6kzhkbW3d4TwD2CNjMRwxTbREXySekvq37kfCNk,7339940,94022331,-86682391,617
2022-01-20 18:24:14-05:00,3579,4MmpDGUTyMcYEqJ1RoZ46AN2BhrBUseHaHqF8AmiTPyD,7HW2YZpYM349HMfW7u4h9ESZ1AXkwN8JcVDTNFzp9aTz,True,89981103,22495275,140520,70260,70260,4BnQKPLuE3DMTtxp8MjUBytgnhvxqq3ZTqZHTVZo4JJh,5620838,49343438,-43722600,624
2022-01-20 18:24:14-05:00,3580,EHJXCJ4ZxPY7F1CeDQkXxVCLyTBXAY2ouWMJfKic9EcK,3yxXBa3sJhUhK9auop8niypnuWiasge5waVTM1zzuhU7,True,827304438,206826109,1262412,631206,631206,3zqXX6kzhkbW3d4TwD2CNjMRwxTbREXySekvq37kfCNk,50496516,183782078,-133285562,610
2022-01-20 18:24:15-05:00,3581,9jdfc9GFTecsdRuTjWFGX13niKKmeBxRgtv5j86uhSnU,HLWMShobjSkaLyXrNjgwVaUGVtbtdUSnr1XjqpXn1bLR,True,219541,54885,341,170,171,3zqXX6kzhkbW3d4TwD2CNjMRwxTbREXySekvq37kfCNk,13674,106919,-93245,622
2022-01-20 18:24:15-05:00,3582,8BMDSWFtzq9fu1ubVGtSFw8fEaMg1uvJiECuJnN8e1pd,FwkETAXL296CirvQ2AJuSHHtdKsxkZkmXSwZVVHXVDhA,True,97571207,24392801,152592,76296,76296,4BnQKPLuE3DMTtxp8MjUBytgnhvxqq3ZTqZHTVZo4JJh,6103689,42018585,-35914896,625
2022-01-20 18:24:15-05:00,3583,4mB2DVbQVqVk535v98Cj8SPNg1tTc3DFyY2Q7VBbY645,HXo255k3RgsTGsc4hiP6ZTXUspBTqJ37duQa5eK7tqp3,True,280070859,70017714,429925,214962,214963,HfEnetJ7uBSmZWCjBNxdvv9HEC5nsW4wDV7wu6WnhWan,17197016,113415007,-96217991,614
2022-01-20 18:24:32-05:00,3584,Ar5QB4VBcUyzSCG23z2QNAbrWY55NbHCr1MNN6P2GAmh,BusFGTiDrJmxzwGUxWz9b3SFF3eseqtgh2DRHqyAwyVe,True,346582,86645,533,266,267,3uL2NSR2ZdDqCiKfzA5SwwpddAnit22DBJo6uvvz1rRs,21345,160041,-138696,615
2022-01-20 18:24:45-05:00,3585,9YEzjb49Awvedv9yNc6LG54SkGBug2RYiJwiUV13mGsS,3H8w5WCD187NWWoZMNUCzUDdxTgqrRJLga8gDzUVXBgZ,True,822006,205501,1286,643,643,3zqXX6kzhkbW3d4TwD2CNjMRwxTbREXySekvq37kfCNk,51446,517438,-465992,625
2022-01-20 18:34:59-05:00,3586,C3k34T2x8fW171coEG9YvoUePvxtHmrQMjVsX1Cb5ZbU,4mh5Tp4Jjh5X3GDERpSMAFgsfYJvysRdd1Nu5oJQ1Dhw,True,17088,4272,26,13,13,DddJ7EWCmYEEZETCBNgAUSg81Ls6fZtiAaY5ekJ5sXx1,1061,7303,-6242,620
2022-01-20 18:34:59-05:00,3587,EV21gv8jEvXtmGDoGRNm5LJEvTBccLMZyVDCLsp54jP3,DGxxoU52aQNoUQcxdvQtv2H5q2PhK6TGkLgNSaFgnZrb,True,3341415,835353,5172,2586,2586,DddJ7EWCmYEEZETCBNgAUSg81Ls6fZtiAaY5ekJ5sXx1,206885,1538267,-1331382,619
2022-01-20 18:34:59-05:00,3588,EeUACm9TkjHKES5U7Yj1oPhYmcp7R3tvesGBiP8txEzq,3qkmm4aS6EDirEDejmbm5PDw2jpYkC7zKqrMkmgeE5BA,True,173050,43262,268,134,134,4BnQKPLuE3DMTtxp8MjUBytgnhvxqq3ZTqZHTVZo4JJh,10722,66011,-55289,619
2022-01-20 18:34:59-05:00,3589,KoCscQ9Q8TZHhmya5KaXBrwUEMTdCkEMRtrhvtgEmiZ,6aZ5AFMFoqf1X64RwAt1J4Yrx4WGGe2JMiEjqnQ2gEtk,True,353203,88300,548,274,274,3zqXX6kzhkbW3d4TwD2CNjMRwxTbREXySekvq37kfCNk,21936,90610,-68674,621
2022-01-20 18:35:02-05:00,3590,BzSJ77zKaqtBk2cEL1XqFL97zTXXMRHmxtkgtXwCc3C,2g4KXTwy2MPSRQ2khNp1o1rn7CradEr9H4ySYKDoSWN9,True,7566079,1891519,11738,5869,5869,3zqXX6kzhkbW3d4TwD2CNjMRwxTbREXySekvq37kfCNk,469555,7447726,-6978171,620
2022-01-20 18:35:02-05:00,3591,Mcbzp1LhZwpfmXTv1pqe9D1jCKHw443j9QKp6tUpzgM,8uforSMAKEih5jHfHp3gCqCvaugtCmhzVfVHA63Akz7F,True,1494657,373664,2338,1169,1169,4BnQKPLuE3DMTtxp8MjUBytgnhvxqq3ZTqZHTVZo4JJh,93541,825915,-732374,625
2022-01-20 18:35:02-05:00,3592,6XHt7CrURSomkQrtVXV5JuKSZY4tQRpUyQKfCDaSTYaD,GCgcmPSDDBsn2smYbpiX3PJybDkQWtufPu4YRsbEEU8X,True,252724112,63181028,393580,196790,196790,3zqXX6kzhkbW3d4TwD2CNjMRwxTbREXySekvq37kfCNk,15743203,162293670,-146550467,622
2022-01-20 18:35:02-05:00,3593,2NdwSLxsGok8PczpCZj9CVX2BymNU5MvHt7hWfGetg2M,8AQbDXeA6mD9QoZBFJcYbnHvZwKNxzA9CCHLAgdSfTA3,True,7980,1995,12,6,6,3zqXX6kzhkbW3d4TwD2CNjMRwxTbREXySekvq37kfCNk,497,4398,-3901,622
2022-01-20 18:35:42-05:00,3594,AtKuDfcFXqWUMnRqQpjedUMTb5CQKLc2zoqEAcQpysKQ,9bPFLYp5TDZruLLDXDYYCiPYcD982iF8xt5rfTkqwNsL,True,8338,2084,13,6,7,HfEnetJ7uBSmZWCjBNxdvv9HEC5nsW4wDV7wu6WnhWan,521,3563,-3042,624
2022-01-20 18:35:43-05:00,3595,7LRBswSEDBjJzQ4YurfTxLydh7tFS2jVn5V95Z6wL7ci,fD41VYGmk66MW46KKb23vAqQvUSDScgXnVdsHhJBZzu,True,88158,22039,135,67,68,3zqXX6kzhkbW3d4TwD2CNjMRwxTbREXySekvq37kfCNk,5423,45558,-40135,615
2022-01-20 18:35:43-05:00,3596,6WNPf4rFCX74PuyvdmzRFqbxWhguuxTQqBSdnaTVBd5D,9N7a9aiHGQsxFMgVbmWoCF9w95d12xyT7XFAwpHGkTLA,True,1126524,281631,1730,865,865,3zqXX6kzhkbW3d4TwD2CNjMRwxTbREXySekvq37kfCNk,69222,342798,-273576,614
2022-01-20 18:35:47-05:00,3597,CAkknoa9UFPMEZ1KWSfqtmnL7ArVNV3HRETLwecuuXP,4cHJYv3dxA6qjcuxUkGRuL7STWobGPKtoHFD4ACUbiWq,True,7834175,1958543,12064,6032,6032,3zqXX6kzhkbW3d4TwD2CNjMRwxTbREXySekvq37kfCNk,482592,3409501,-2926909,616
2022-01-20 18:35:47-05:00,3598,Grw2snBvSDMa7ev2nWZo81WoLfyavmXXxCV1ugHGk5Xe,AF1WVCQcBmXCnWbDx2s62vU99zW1AdhNoqbWvdrbiQVm,True,11598522,2899630,17962,8981,8981,3zqXX6kzhkbW3d4TwD2CNjMRwxTbREXySekvq37kfCNk,718484,4868374,-4149890,619
2022-01-20 18:35:48-05:00,3599,8VT2nxz5ZYDJFd9uL2XZwEXxChd9pjuMJNMAcutZubL1,EhAkiRbouzUAWtqQFsN8HEEfi46UVN8H8tyBP7CbgeLe,True,6865,1716,10,5,5,3zqXX6kzhkbW3d4TwD2CNjMRwxTbREXySekvq37kfCNk,423,3431,-3008,616
2022-01-20 18:35:48-05:00,3600,99NHcwD1iaf5FXM3UNb91SjNiiT3HwyQFQMhkGd5ASts,8syAydy52vSQQLzsLXW24BFw4VPeK66Vp3BmAbnHfgod,True,37026432,9256608,57150,28575,28575,3zqXX6kzhkbW3d4TwD2CNjMRwxTbREXySekvq37kfCNk,2286031,17235135,-14949104,617
2022-01-20 18:35:49-05:00,3601,C7a8BtMjuLXkzxZBC4Wk2gjkGBmucLmDjokf9pyA1Mu6,GxwYNWwYTtFMUxuZvNC5qrEYuJzYiEURQVuBxssfCJzr,True,1146965,286741,1785,892,893,4BnQKPLuE3DMTtxp8MjUBytgnhvxqq3ZTqZHTVZo4JJh,71431,348298,-276867,622
2022-01-20 18:35:49-05:00,3602,2RZPBo8Z2BgZmsASo14ySTSwqqgqmfVEjPkiAwQ1VTgf,BRS5cYtEoPRoSvTAiQaT1svWRdLJWVfy8LUb4SCudCjS,True,3664645,916161,5719,2859,2860,3zqXX6kzhkbW3d4TwD2CNjMRwxTbREXySekvq37kfCNk,228760,1616376,-1387616,624
2022-01-20 18:36:00-05:00,3603,4hrm69kAKNcfBkiP2YgtW94Pbip6FLfQAwnDRAAack69,BjbZRdGMoC7Mfoa4H19UvE2eQafgKD5rqnK7BSGwqS1s,True,25366,6341,39,19,20,3zqXX6kzhkbW3d4TwD2CNjMRwxTbREXySekvq37kfCNk,1584,11339,-9755,624
2022-01-20 18:36:03-05:00,3604,3axqGcX5yuJ2vGxRjtNguefXUvSQHDQmn2zskhyCuQkf,EYrZo9zZDaHqFdc1fam63W3jvqqmbU67wzp6yFcppwsL,True,20118504,5029626,31400,15700,15700,DddJ7EWCmYEEZETCBNgAUSg81Ls6fZtiAaY5ekJ5sXx1,1256019,17133902,-15877883,624
2022-01-20 18:41:45-05:00,3605,D7XummfEc3NTK4qMvZegV3FrYuqc8mNgnQu3ujwemZtg,HHiRcecqzW7sGFTio7Ph6TYv3dGt64KWv4DEKgKm84fQ,True,7334102,1833525,11422,5711,5711,4BnQKPLuE3DMTtxp8MjUBytgnhvxqq3ZTqZHTVZo4JJh,456908,3625397,-3168489,622
2022-01-20 18:42:09-05:00,3606,Buioe5v3DyFwD9nquW5XdYeVYbSABCyg79eUHEvtvfaW,7T9gi7prCcZJkYJMSB5Ef6Bu4pAuBw4XLvumSFnqKDSi,True,487355,121838,754,377,377,3zqXX6kzhkbW3d4TwD2CNjMRwxTbREXySekvq37kfCNk,30181,283499,-253318,619
2022-01-20 18:42:09-05:00,3607,C4dbwF9mioaBkZnyBFvFs6Cqd362VuGPBGPbTY9CAnAk,CcUqBfu1hbWm5VVxbtF2Xm6HUz4CLFzuDsjUi6KtnZQg,True,1225080,306270,1899,949,950,DddJ7EWCmYEEZETCBNgAUSg81Ls6fZtiAaY5ekJ5sXx1,75971,369645,-293674,620
2022-01-20 18:42:09-05:00,3608,ZoNjrSjYh4NJLW38LUPcf7jtEBxdaaM7T1zp795qjHE,FZx6v8cU25NwEosbKJ2n141o9uFAWURZB7NeCeX1trEn,True,1052278,263069,1629,814,815,DddJ7EWCmYEEZETCBNgAUSg81Ls6fZtiAaY5ekJ5sXx1,65165,318065,-252900,619
2022-01-20 18:42:09-05:00,3609,CEbGTNX6WpaoKp4RBGSn9LzYM6yAYyeiMrgVYgJxA4zb,AiXUcGAFFm4tc7vKBscSNjZawV5YJqbv7D1KpxD3Zufg,True,13654333,3413583,21173,10586,10587,3zqXX6kzhkbW3d4TwD2CNjMRwxTbREXySekvq37kfCNk,846920,7924160,-7077240,620
2022-01-20 18:42:09-05:00,3610,DiB9SeCFXjioNGPJM3GuZ3FCG9KBZhHK27zCSN5b6gkq,GtK8UtKDQy9jgtTXvam4jja9N7c4EFuDQr4TKHgNyhXT,True,3026121,756530,4691,2345,2346,3uL2NSR2ZdDqCiKfzA5SwwpddAnit22DBJo6uvvz1rRs,187642,1465409,-1277767,620
2022-01-20 18:42:09-05:00,3611,EEcTbsFTUEifcdbPyjBLkS943daEx1RpR8F3uZxKRZbT,8V3JzDQ1VWYQLas8fxUsWJZZHe4gEmn74RehtUwLw3k5,True,3687321,921830,5754,2877,2877,3zqXX6kzhkbW3d4TwD2CNjMRwxTbREXySekvq37kfCNk,230170,1908643,-1678473,624
2022-01-20 18:42:10-05:00,3612,5hUZ9uQFcYnjAQVVaGLJWdKyg7y1XMpoo8osQ9DeY7Xd,BdYiKWsjuzJLcHh3814mJ4xQ9JxoQKKcr7AHZ7Vxoavq,True,30318,7579,46,23,23,4BnQKPLuE3DMTtxp8MjUBytgnhvxqq3ZTqZHTVZo4JJh,1874,13789,-11915,618
2022-01-20 18:42:10-05:00,3613,FjDp4bWCtqehFD7FunCrjrcdxMezTJj5aqh2VnBvHDQU,HRYeZqcqhP1RPiAGXziR1qCWwk4sF6c5ZYbvSDhX7foN,True,5525086,1381271,8596,4298,4298,3uL2NSR2ZdDqCiKfzA5SwwpddAnit22DBJo6uvvz1rRs,343875,2326530,-1982655,622
2022-01-20 18:42:11-05:00,3614,8mbMH9EKd9kQDyFrYiDJCV9VaWxWCzpZBQZLyYN2yNVx,J9gT39dF1egMeQvweXYWeRAX3kpmBABijYZhfj6M2UqU,True,16803073,4200768,26066,13033,13033,DddJ7EWCmYEEZETCBNgAUSg81Ls6fZtiAaY5ekJ5sXx1,1042667,6261857,-5219190,620
2022-01-20 18:42:11-05:00,3615,EgU9hX6VK7YXeCgCHVaJAMekCcyZa2MVWdKra5pN7Gwv,7y8Ad9XY34bqREvheXHT2tr8Jy11D6X3pu7yLVtjU4QV,True,6824007,1706001,10678,5339,5339,HfEnetJ7uBSmZWCjBNxdvv9HEC5nsW4wDV7wu6WnhWan,427130,3559108,-3131978,625
2022-01-20 18:49:46-05:00,3616,DiPSJvnnEwg1En7HJfEsKrUbBgtUf4KzGMyMCZDQSYgp,s8UVC6vPBofuXUS6RW1aQmZ8C35PrC5r4A6ugmvzLGB,True,1339514,334878,2091,1045,1046,DddJ7EWCmYEEZETCBNgAUSg81Ls6fZtiAaY5ekJ5sXx1,83677,405300,-321623,624
2022-01-20 18:49:48-05:00,3617,5BjBPqumCb9KC82ZNNch3dcRzbpGdRLJneru7o9a1D9R,FuZtBWKktxFu4yoiLVMzxq8fMhQyN8SGzGPz49xs3m6P,True,101385884,25346471,156862,78431,78431,3zqXX6kzhkbW3d4TwD2CNjMRwxTbREXySekvq37kfCNk,6274512,52901976,-46627464,618
2022-01-20 18:49:48-05:00,3618,FfpzVu4rcnwxNbx9EoNpZ4LmCYTjhYTkhwrUGCpnSJvh,5rRoUEuDVtaXQBH9xvq4vUvPWJDytFoEByNrcWfiq1E8,True,293796,73447,459,229,230,3zqXX6kzhkbW3d4TwD2CNjMRwxTbREXySekvq37kfCNk,18389,72817,-54428,625
2022-01-20 18:49:49-05:00,3619,2ce2v2TCbjNH635NgbwTG3sqiRWYrRRaBpxPxBZJ929q,9cnoebT43FkWDFhidndGCVNiFD4NErv8DuL1Va4Jv9S8,True,4140117,1035029,6427,3213,3214,DddJ7EWCmYEEZETCBNgAUSg81Ls6fZtiAaY5ekJ5sXx1,257109,3315597,-3058488,621
2022-01-20 18:49:49-05:00,3620,4FazDUgfQ3AKoFcnWHr8E9Ht8jLA3tkxf75yrGZVHdmF,HzRMH6mbgEKydRCnnMvSsKgTEVNQi6nuzoR1xutYFdzg,True,42180,10545,65,32,33,3zqXX6kzhkbW3d4TwD2CNjMRwxTbREXySekvq37kfCNk,2628,31670,-29042,623
2022-01-20 18:49:49-05:00,3621,7MSzV5yy5FmrM4j1BcYSRiTGWfit1AJahheRUaXzz349,aPSTZLxBpVr3sucjbj95emRV2J1GrUWr7wbARYqJkQZ,True,3063986,765996,4771,2385,2386,3zqXX6kzhkbW3d4TwD2CNjMRwxTbREXySekvq37kfCNk,190877,1136755,-945878,622
2022-01-20 18:49:49-05:00,3622,9gYrMXAGmGSV4VFjXzYP5WwH2aFpB1TxA6CqpYsosKLv,Dh8aH6RK48wu4fkT9xKw5XL7itxnPDuw3SDwPwvL5sva,True,18222,4555,28,14,14,3zqXX6kzhkbW3d4TwD2CNjMRwxTbREXySekvq37kfCNk,1134,8000,-6866,622
2022-01-20 18:49:51-05:00,3623,3zH1b58jqbNU37y9kDTZZrotSeT8XzS1tuyAHPKWrbah,4trxDWV16x6sVcz7bxHehYHkjjyKebh3S9fyJf8txzK5,True,5209,1302,8,4,4,4BnQKPLuE3DMTtxp8MjUBytgnhvxqq3ZTqZHTVZo4JJh,323,2250,-1927,620
2022-01-20 18:49:54-05:00,3624,E9FFPvygPSF22u7gqFq4w6yE5kV15zbeGDXFQc349RsG,yi1REPVUwKhr5ss5YJc56crYz8LVfkqNVMpKcdSfwfY,True,1149375,287343,1793,896,897,3zqXX6kzhkbW3d4TwD2CNjMRwxTbREXySekvq37kfCNk,71742,346199,-274457,624
2022-01-20 18:49:54-05:00,3625,87R8o8xLjHw2GpunYkm7pX7uJ8hjM4B1y4Qm7aQf6Yh4,48aSVPQoFYdncF5NtJ114urbdTzVjTgYLgPzMfpJbZB3,True,43976552,10994138,68509,34254,34255,4BnQKPLuE3DMTtxp8MjUBytgnhvxqq3ZTqZHTVZo4JJh,2740377,42294837,-39554460,623
2022-01-20 18:49:55-05:00,3626,3g1debT8Z2efQPuMNSDPUNZzDqarBG2acErsZ4HP7QGA,42wDHagxr5Nno3mUx6kyYGDjwR98aedRbh3ByB468agB,True,13016,3254,20,10,10,3uL2NSR2ZdDqCiKfzA5SwwpddAnit22DBJo6uvvz1rRs,813,5747,-4934,624
2022-01-20 18:49:55-05:00,3627,93ho4cgnpAJiJsG6uu2udkLVNU7rkz4QjCYfsqvpbPA5,45ouQn9gGwXqnTGfaP5CvU8fCKadBRA5kPwtfvJzykRU,True,43658477,10914619,68013,34006,34007,3zqXX6kzhkbW3d4TwD2CNjMRwxTbREXySekvq37kfCNk,2720529,16700963,-13980434,623
2022-01-20 18:49:55-05:00,3628,2kqN3TbCDgM4x8XfZvKgqJvDAHqvZxtT89NcfmQSQa5b,8fEx56PjuPAP61CBnrsnnnQnZmt8cw6KVjhYDK1mWJzP,True,392475248,98118812,613647,306823,306824,3zqXX6kzhkbW3d4TwD2CNjMRwxTbREXySekvq37kfCNk,24545916,80850668,-56304752,625
2022-01-20 18:49:58-05:00,3629,EuvK7bsc3hbxqeJjJkLELCvS7kruCMAGDctn5u7Q7BnP,Dv4XTdwnp6Sv5zxkSwRwsdSzxApDtBr4A13x4vvzTVjm,True,35829425,8957356,55295,27647,27648,3zqXX6kzhkbW3d4TwD2CNjMRwxTbREXySekvq37kfCNk,2211810,16382385,-14170575,617
2022-01-20 18:49:58-05:00,3630,AQr9mVmcXCNQhBVCfx63MwR6c4WqDSC9K2BZqr7N8LCx,CB7TWUaL381ounsLw6neAUaKRxJL9P1HC9uGX5e1Uxod,True,395827532,98956883,616498,308249,308249,3zqXX6kzhkbW3d4TwD2CNjMRwxTbREXySekvq37kfCNk,24659929,274336221,-249676292,622
2022-01-20 18:50:07-05:00,3631,ioPHEVyheRnHYomVS7PmP6Coyhjk6LCs7hMD5Mq9Ngv,DYTpFmZ4yXVghKwkaovgCdpv3jfWkjtXRzxsZjKJfXNN,True,16524,4131,25,12,13,3zqXX6kzhkbW3d4TwD2CNjMRwxTbREXySekvq37kfCNk,1022,7323,-6301,618
2022-01-20 18:50:07-05:00,3632,ECuu1L4QGdemZ7FjAjVAAxYN6piinweY7Fuk5csVovfT,Amd8WGcpdtB8yoA83R1BUT5uryuqoKbcBexYacbrbGVX,True,2098462,524615,3259,1629,1630,4BnQKPLuE3DMTtxp8MjUBytgnhvxqq3ZTqZHTVZo4JJh,130386,836910,-706524,621
2022-01-20 18:50:08-05:00,3633,6d6HN8LWikwW2HYdy3BABWuxKHt1sgv4DcneACR133sE,4eKvzmfFvX96XbujKBhUauAvWP4yQYwZH3pd7gXzbCvJ,True,1147179,286794,1788,894,894,3zqXX6kzhkbW3d4TwD2CNjMRwxTbREXySekvq37kfCNk,71536,348189,-276653,623
2022-01-20 18:50:08-05:00,3634,7g4NJBHwDTRm58GqX7Tz1JzqwbAhF6EWJUQH3SoDxSf7,82Ypv7STZeSCBPf3HckWdyatELpvaDaWxFXhD5dNSML4,True,15987,3996,24,12,12,3uL2NSR2ZdDqCiKfzA5SwwpddAnit22DBJo6uvvz1rRs,998,7090,-6092,624
2022-01-20 18:50:08-05:00,3635,9LZ3rShLfzErXsGkh4dYfAm58GNPWhK6ohDy5RrLJhc,41tLyuvuJ5M7YctkSASD2R7RGGetD7FmKaZUdkTdgXgt,True,994399,248599,1543,771,772,DddJ7EWCmYEEZETCBNgAUSg81Ls6fZtiAaY5ekJ5sXx1,61752,301341,-239589,620
2022-01-20 18:50:08-05:00,3636,6osqTNxgZv1Y1EjnVR7D1G4cywof1CrWswj87tAnktWV,Fah93R9W7SFuajFif4AbXDdxouWA5rrLz29vzVRGsMxv,True,8583325,2145831,13363,6681,6682,4BnQKPLuE3DMTtxp8MjUBytgnhvxqq3ZTqZHTVZo4JJh,534541,7701218,-7166677,622
2022-01-20 18:50:10-05:00,3637,2bikYf33ZxxDmvkMNjWDGGqEpbYJPvWv5At3hzyeLEQK,5FtirUBjRAZ3k5arFFVwKz42ixWzhkEBLkaK9PraRZ78,True,100646,25161,157,78,79,DddJ7EWCmYEEZETCBNgAUSg81Ls6fZtiAaY5ekJ5sXx1,6283,37791,-31508,624
2022-01-20 18:50:13-05:00,3638,HhwiZPKZBGa16oVi739s4qtMDMTwzWXc7iwNfX63t2UP,5AnbMbAFKy85yHt5y2M5S38nNkA1vT4ejY5NjGbRNUqn,True,950761,237690,1483,741,742,3zqXX6kzhkbW3d4TwD2CNjMRwxTbREXySekvq37kfCNk,59330,611825,-552495,624
2022-01-20 18:50:18-05:00,3639,FLTW9fwjWqGPm5PiE3C9LFzwZxtDh8c2MnEoRq8W7MfQ,GKsfzKBP2QkmoEWvTaUN1h4nqrT3kAcwYRC9WxW9bB3h,True,8468725,2117181,13219,6609,6610,DddJ7EWCmYEEZETCBNgAUSg81Ls6fZtiAaY5ekJ5sXx1,528769,3182367,-2653598,624
2022-01-20 18:50:19-05:00,3640,DJiXXW7sjNsAAxWupDKBUsFhXSgPoerVYaAtJqqNgVbn,2MsqvNuJw1xQhJ3UnXt9i7oNHDuZpR9w7iE1WQcGqt5m,True,100629,25157,156,78,78,DddJ7EWCmYEEZETCBNgAUSg81Ls6fZtiAaY5ekJ5sXx1,6273,37796,-31523,623
2022-01-20 18:50:21-05:00,3641,2p2fGXdKrmxjomLSnyaNg84J82cBBBNympZ6qQc8UZgU,HKAM8bazuLMUY6yapZJqYsgaWkTBqKHyMs1hSfpYsZGi,True,557520591,139380147,869028,434514,434514,3uL2NSR2ZdDqCiKfzA5SwwpddAnit22DBJo6uvvz1rRs,34761159,305441500,-270680341,623
2022-01-20 18:50:21-05:00,3642,921FBgLS3A1wA77uWitsnTvW737Q2jY7tzvgWtWLXNC7,E4eJ9H7cqP9zNpMH5xRBTAp9yaBCBihuJBNd6pqzteDG,True,100629,25157,156,78,78,4BnQKPLuE3DMTtxp8MjUBytgnhvxqq3ZTqZHTVZo4JJh,6277,37802,-31525,623
2022-01-20 18:50:24-05:00,3643,BPRoaqrDs8vhqv2T7d9qV2oPU33pi1K1LUaotM7yuD2i,6qo8uQGAEwBfYQR36v6nRiqA2xGV6SjJAsXsdzy5bqNH,True,711718675,177929668,1112025,556012,556013,4BnQKPLuE3DMTtxp8MjUBytgnhvxqq3ZTqZHTVZo4JJh,44481033,345298118,-300817085,624
2022-01-20 18:50:24-05:00,3644,CCHzYXr5zMXFu8MMZNkfUWGyUcF8xy7Vvhq7tNCtZg2L,AuEXkCJTTJ3HK8iP4qTWpQr4vp6HPRJZyZwfRjF8zjfp,True,100627,25156,157,78,79,3zqXX6kzhkbW3d4TwD2CNjMRwxTbREXySekvq37kfCNk,6280,37806,-31526,624
2022-01-20 18:50:27-05:00,3645,duKo8riX1qpX1K1qpgwZniMtUeWqu2eYgchTu5n7Rbu,9vAVwfVtdsaZMbeZvoymjHqwASeuM38gfEJkbTVwDqya,True,46011039,11502759,71885,35942,35943,3zqXX6kzhkbW3d4TwD2CNjMRwxTbREXySekvq37kfCNk,2875403,19858037,-16982634,624
2022-01-20 18:50:32-05:00,3646,7W6ih2ZGXaE6tvuQFUPCvc7NvEJHy7UffgoVX3ZPdLXt,6uQCkeMjEXHBQxE2HD33RM1zyTsSko1fYZA1mWUggJ5B,True,17662,4415,27,13,14,3uL2NSR2ZdDqCiKfzA5SwwpddAnit22DBJo6uvvz1rRs,1103,8055,-6952,624
2022-01-20 18:50:35-05:00,3647,DYCYiQFH9QHzCo3eAw1pFoDu7pzwFMo1E2WDZjVFRz5w,CPh4FWsGak1kd1WFEH9qBjNhnun3R2tHtZA57zW8ugn5,True,48403418,12100853,75735,37867,37868,3zqXX6kzhkbW3d4TwD2CNjMRwxTbREXySekvq37kfCNk,3029412,25278767,-22249355,625
2022-01-20 18:50:50-05:00,3648,DvuRmJkfn6FQczUKgYeaSCqwy2NTMunuAKNrnmxMvnzS,7LpWTX9dgBtW75kfEoB5WuNsDwEdw5s8CYSHh3J4qagM,True,82955360,20738840,129237,64618,64619,4BnQKPLuE3DMTtxp8MjUBytgnhvxqq3ZTqZHTVZo4JJh,5169508,41615476,-36445968,623
2022-01-20 18:50:50-05:00,3649,4kbcrzH6o2LvLUCNphyL52i8uGzVD8wcUNEqoQ14z3VG,5Q1atmEBs2AqaDZsiZFG5stHzj1fE6ZvypgfkEc9LYqE,True,122432800,30608200,191230,95615,95615,4BnQKPLuE3DMTtxp8MjUBytgnhvxqq3ZTqZHTVZo4JJh,7649235,71785399,-64136164,624
2022-01-20 18:50:58-05:00,3650,HkRKcvAWLM5sCDL6a5DvYsH55bg5BnZnyP9WwX7wLUDF,GXtDJS8BCoZKnvviGaUb2QfKs2LQQZPMa9564tf5Jq8Y,True,1047388201,261847050,1630024,815012,815012,3zqXX6kzhkbW3d4TwD2CNjMRwxTbREXySekvq37kfCNk,65200971,258294574,-193093603,622
2022-01-20 18:51:00-05:00,3651,GWkVXmZNQdcdWNNu8dvRqct4aMhLoDNqijrTvxbfEdKN,6LKRNbJv2XkyjJQKCFAqFRPzvANrRBSTmu8doRWqTicU,True,74447037,18611759,116212,58106,58106,4BnQKPLuE3DMTtxp8MjUBytgnhvxqq3ZTqZHTVZo4JJh,4648482,16491445,-11842963,624
2022-01-20 18:51:02-05:00,3652,GH6Q9E1jZPTTp46aDd57UNZPNS2D6PBSwyLL3EHSjGn2,2XvwZXNsrPWx4EfPvhTP933bzCC3SJHDQ8xARfrXdVY9,True,13545095,3386273,21156,10578,10578,4BnQKPLuE3DMTtxp8MjUBytgnhvxqq3ZTqZHTVZo4JJh,846247,12023003,-11176756,624
2022-01-20 18:51:13-05:00,3653,AGhvB6x3gmvAJSnr9UVtvhKqVg3Qgh1k4roHzrNHhAaa,HhhjXT6WJnz1HQfHcwKdBppuAhc8ncUcq1mkJ4EHqgpe,True,4333,1083,6,3,3,4BnQKPLuE3DMTtxp8MjUBytgnhvxqq3ZTqZHTVZo4JJh,271,1993,-1722,625
2022-01-20 18:51:25-05:00,3654,FpqCxvTkSiwDwD5qEt6hXJxzFDLFLAQ8VevK8zwRqYun,A3p6YQisCJKpNkF7vkjZRbEfbnUt7vTZdR2zPBUSdTkk,True,281351619,70337904,439007,219503,219504,4BnQKPLuE3DMTtxp8MjUBytgnhvxqq3ZTqZHTVZo4JJh,17560318,111681229,-94120911,624
2022-01-20 18:51:25-05:00,3655,AA9zFZTXqBR8Mw1fwEH59edzBiswoGasRNWsi6aLeysB,4VeitxYqqtRxyfdSVpshdJ3EDcgksRVnaHvAqWxTeujH,True,1165758,291439,1814,907,907,3zqXX6kzhkbW3d4TwD2CNjMRwxTbREXySekvq37kfCNk,72594,354398,-281804,622
2022-01-20 18:51:25-05:00,3656,4D7mDXe7SdmbAx7kaD1mBNuEa7DzMi6TAwXURxtLEazk,5pSnT91PHoLdN6uhPnUtoD7cboLmndn26y1XouPx8vwW,True,1016606,254151,1574,787,787,3zqXX6kzhkbW3d4TwD2CNjMRwxTbREXySekvq37kfCNk,62987,380957,-317970,619
2022-01-20 18:51:25-05:00,3657,EeztHR1M4PPacJEZ6c5arCRVCuu8aN7eGdpY1u4bev79,9Twdc9Xrzv2oeJ9Fbd8mRvzjbFi7mkGopFS37SMabeAK,True,121726422,30431605,189282,94641,94641,3zqXX6kzhkbW3d4TwD2CNjMRwxTbREXySekvq37kfCNk,7571312,42300525,-34729213,621
2022-01-20 18:51:27-05:00,3658,2VyFcgZDH1HTEvD1XaWhwqBCMmZ1k6TmZ3fEpPcBZR9E,G1wFJETTpdoc7CfypGCzkq1jssXPfUkiuLjK2cwVZ9dJ,False,73845,73845,3672,183,3489,3zqXX6kzhkbW3d4TwD2CNjMRwxTbREXySekvq37kfCNk,3672,38302,-34630,497
2022-01-20 18:51:32-05:00,3659,5nauZoaxftcYR591YH4v52myeJLnXtY4okdttL9qSdkg,7x3G299D3bC7EwUQojhTXUv29BG4NGzrLbgS4mEyqG5r,True,316965010,79241252,494785,247392,247393,DddJ7EWCmYEEZETCBNgAUSg81Ls6fZtiAaY5ekJ5sXx1,19791421,77782837,-57991416,624
2022-01-20 18:51:33-05:00,3660,DAku12iueL13vRoTpKLyqdGaLQ2rWF6REe8Dr8soFvNs,H2vVH3LxkhGe6x6Mdwy67BYwTKNQM6XayKx7mhrwyfJM,True,305616,76404,476,238,238,3zqXX6kzhkbW3d4TwD2CNjMRwxTbREXySekvq37kfCNk,19067,163964,-144897,623
2022-01-20 18:51:34-05:00,3661,5jin5wXjQQ25nGM2ECrCXcg1a95vquh6kM7rMRru6Ke7,EKM657EQ8HWWgf4cssByoYHoXGjFfTspTKXAGmygAPQG,True,25767242,6441810,40116,20058,20058,3zqXX6kzhkbW3d4TwD2CNjMRwxTbREXySekvq37kfCNk,1604678,13490459,-11885781,622
2022-01-20 18:51:39-05:00,3662,5RvNKzSeJ1fvqsKpcQu25evEZGmKjyEDgwsMZkykoT3P,BRqSGfE4XHXu4HrinwetWumfVTmr82iuF6Y5oSV6eMiK,True,100503,25125,156,78,78,DddJ7EWCmYEEZETCBNgAUSg81Ls6fZtiAaY5ekJ5sXx1,6279,37929,-31650,624
2022-01-20 18:51:39-05:00,3663,ES1MDwRUa3hoToPKQiiZkzMYe9PDVnAQwMrEvZrzvnc1,C4wBG3xTDkmDQneB28xYnf1aBNEeq7UB8oR7NuEfLkFg,True,18862031,4715507,29407,14703,14704,3zqXX6kzhkbW3d4TwD2CNjMRwxTbREXySekvq37kfCNk,1176282,7062279,-5885997,623
2022-01-20 18:51:39-05:00,3664,C2Dmfw4G8KKzFq38aRH2pLCRngnGZDvUUN3fHDMjFkoG,7kzJk3BTNvY3hGFNj7nDy9L5CAYus6eNiCAxWH8dSioX,True,254278,63569,397,198,199,3zqXX6kzhkbW3d4TwD2CNjMRwxTbREXySekvq37kfCNk,15899,162849,-146950,625
2022-01-20 18:51:45-05:00,3665,AM5fwZR9BUW8AFkhdGWXW4PHd2cy8ora63kDf2z2eknw,E7ru6hg4MchnRG5zcr5YazwX8Snt55r5Xq9zCHCGaYZT,True,654644,163661,1023,511,512,3zqXX6kzhkbW3d4TwD2CNjMRwxTbREXySekvq37kfCNk,40927,335408,-294481,625
2022-01-20 18:51:50-05:00,3666,GGGyesjbt7h2XHHp9u8vpiWGugFwEbrtYaKrNQSDhQd7,8tydo1ZjGHmPBSqU33tywB3f9szdsHk1ckGFe4Ay5pgs,True,34578029,8644507,54075,27037,27038,3zqXX6kzhkbW3d4TwD2CNjMRwxTbREXySekvq37kfCNk,2163036,27427248,-25264212,625
2022-01-20 18:51:57-05:00,3667,6xikA6d7sjCBnSfqkFwrL4nPrtQUNWdRhXB7i1AccnxC,G8t7u2R9qjRfdTdULs74v3nVrTM2WeKvc4dK4FFAvuG1,True,25656492,6414123,40127,20063,20064,DddJ7EWCmYEEZETCBNgAUSg81Ls6fZtiAaY5ekJ5sXx1,1605081,6514863,-4909782,625
2022-01-20 18:52:03-05:00,3668,6dr65yANjSMmfBeKAuSxG3i16S9vMgF1CQ3zDyzh55Pn,EhrE5QpnshD41S4zPEBy2A5q2Gs2mwUrbHGo6WnT9zDP,True,229112,57278,357,178,179,4BnQKPLuE3DMTtxp8MjUBytgnhvxqq3ZTqZHTVZo4JJh,14298,123072,-108774,624
2022-01-20 18:52:05-05:00,3669,6u6bPgAmK8ufACrQV99A1Y5nhGkue3KEUHmQQkcNkxwP,7636yXT5w4DcVpc7LJdN46aiggzSq6U2GXHXL5kyy9F3,True,81225584,20306396,126800,63400,63400,3zqXX6kzhkbW3d4TwD2CNjMRwxTbREXySekvq37kfCNk,5072004,42462416,-37390412,624
2022-01-20 18:52:05-05:00,3670,Ayx8dFsVzUBb9b7QKxw7YHJuhptdSitBXFEczXTaxe85,EvU1VLChnowi6ccSPeJRSk65njrqZfYouAN7SHePxsxf,True,16021,4005,25,12,13,3zqXX6kzhkbW3d4TwD2CNjMRwxTbREXySekvq37kfCNk,1001,8628,-7627,624
2022-01-20 18:52:05-05:00,3671,7CSCMFa9W52tBDVUbXbc3woAy3GByeA1wPJdp3MgznPa,3447ptuVFu6G8B6N63RmS8mRv4n9PfHneypHLvbeaGLn,True,102802022,25700505,160750,80375,80375,3uL2NSR2ZdDqCiKfzA5SwwpddAnit22DBJo6uvvz1rRs,6430030,48240767,-41810737,625
2022-01-20 18:52:05-05:00,3672,DC4UVUDFWL3gVtgkX9hPtFgtxaA8DH5p94i4k9U3wyWv,3HCWqVvQQfRgSKitsTjGTduJ82ointZUSNtj13uea4kD,True,1708744461,427186115,2665993,1332996,1332997,DddJ7EWCmYEEZETCBNgAUSg81Ls6fZtiAaY5ekJ5sXx1,106639748,641664729,-535024981,624
2022-01-20 18:52:10-05:00,3673,2QStaRnbSnDhA891Lb1bxjVeMYpJUpNdqaVkw3rqU45V,DakRWPnttPoRcjY5V7WLwiwBx39BapCo9Atog8dL17Ku,True,1550618,387654,2423,1211,1212,3zqXX6kzhkbW3d4TwD2CNjMRwxTbREXySekvq37kfCNk,96955,548598,-451643,625
2022-01-20 18:52:11-05:00,3674,6CeKxTJvFqhyNEyzySiBBKEwYVMe7j3A6nkMes4BW6o2,DzDR9XvwY1z7ygQ8YrCXrwDGHSf67JZF8BzUnuFE2fxQ,True,2997153,749288,4688,2344,2344,DddJ7EWCmYEEZETCBNgAUSg81Ls6fZtiAaY5ekJ5sXx1,187556,1193926,-1006370,625
2022-01-20 18:52:11-05:00,3675,3Lv2XpiD4KBUHq7Zx6u3zNhpXoySodXHH8o8f5yaaPxG,H6TN4rhpBXkEH3mZnymYNcKfmnxRH2uzfwzeLH2q6ahP,True,127883,31970,199,99,100,4BnQKPLuE3DMTtxp8MjUBytgnhvxqq3ZTqZHTVZo4JJh,7993,59452,-51459,625
2022-01-20 18:52:32-05:00,3676,8hpAXzimCw2bTwLXoRFAbqNW8qoj5VV3JDYCuJwqHpHm,DkfsL2M7oRBX6grAfy15C4urwL6ToMJ7TWJEFAGhWjYX,True,6334214,1583553,9900,4950,4950,HfEnetJ7uBSmZWCjBNxdvv9HEC5nsW4wDV7wu6WnhWan,396029,1554317,-1158288,625
2022-01-20 18:52:36-05:00,3677,AvwHizRhHUSahmvSg4jmTUErc7vAFSmkRAEsiKhXfW1m,3UrWYx8y9N5o9GYneSe6zyyHRTZzxwvcipQfHHYh7tEs,True,2513665,628416,3926,1963,1963,DddJ7EWCmYEEZETCBNgAUSg81Ls6fZtiAaY5ekJ5sXx1,157066,979161,-822095,624
2022-01-20 18:52:38-05:00,3678,8VnGmfop6qcUezAJ2M15jz2Nn6mPQgehDcJPvypq4XJn,6F6sqXNhgkW9ev8QNMm4ydywUUmemhwgydRQYNeqyUmi,True,7250522,1812630,11345,5672,5673,3zqXX6kzhkbW3d4TwD2CNjMRwxTbREXySekvq37kfCNk,453839,6551732,-6097893,625
2022-01-20 18:52:43-05:00,3679,E8ifvhmyJGBGVQomo3AnZw2UcaLHcpGsTtuoCid8voU3,FMQUWTbTAfSLfrc6GTrz4DM2ZSgoxF3KtqGn8AyjVtsf,True,4862210,1215552,7507,3753,3754,4BnQKPLuE3DMTtxp8MjUBytgnhvxqq3ZTqZHTVZo4JJh,300298,1908781,-1608483,617
2022-01-20 18:52:43-05:00,3680,9UyQC8vc6zJJaSdnjvTAzgmcsw4fC3xFBBiCC1w9Sbjx,3ppBfboe6FPmt7f6WrivspMUoAznZKWQMeh3rCgw7vjQ,True,6123088,1530772,9533,4766,4767,DddJ7EWCmYEEZETCBNgAUSg81Ls6fZtiAaY5ekJ5sXx1,381338,2266495,-1885157,622
2022-01-20 18:52:43-05:00,3681,3njiRuSRMXRzKmamyiR72Hc38PU8UDDmWdfPhgxmGxEW,5WoF3gkgygyNNbwxWgVfqGWkExcDixuzgJQQjXEZQ6J5,True,174179228,43544807,261210,130605,130605,3zqXX6kzhkbW3d4TwD2CNjMRwxTbREXySekvq37kfCNk,10448400,126927298,-116478898,599
2022-01-20 18:52:43-05:00,3682,8NdcaYUC1X5CP7FMDip78uqtqmCt8GcZdCzLRTYTihmb,9Ei1K9bXWXSXcBfeX5exPSXGCAu62WSKzvnnd4wHvyVh,True,89721,22430,134,67,67,DddJ7EWCmYEEZETCBNgAUSg81Ls6fZtiAaY5ekJ5sXx1,5392,42356,-36964,600
2022-01-20 18:52:43-05:00,3683,BAczoNDnbwj5AJX5LwzynzYab7ji7VbhRy9edA9Prax,34sbkUKnMetUNyMs6BhiWut85d5UZtBWnPtwx8jEpJNA,True,887434,221858,1335,667,668,3zqXX6kzhkbW3d4TwD2CNjMRwxTbREXySekvq37kfCNk,53439,431504,-378065,602
2022-01-20 18:52:43-05:00,3684,2FrqGFZjbiNykJyo9BZ5S9FguQJPJiTi681rJJsQ5dta,3QUncYP92NKrfpaTvuF9iQg11PXKgZAgEngwh6BbnCCj,True,564028,141007,848,424,424,3zqXX6kzhkbW3d4TwD2CNjMRwxTbREXySekvq37kfCNk,33941,251880,-217939,601
2022-01-20 18:52:45-05:00,3685,LNX7AwwiGpuaXA4J86d1xqqtF6kD7qbCusssSZqtpKd,45a5FGVssw2NoGipB7NRN4XDLPob4GHNxSM9fqgsTpqA,True,590290391,147572597,887349,443674,443675,DddJ7EWCmYEEZETCBNgAUSg81Ls6fZtiAaY5ekJ5sXx1,35493980,131873589,-96379609,601
2022-01-20 18:52:46-05:00,3686,6tFQaTqqffino9kwMZTL2xVNBG8k9VREFhXqVi2si3A3,3w3wGxBbS4bmXeqmvd595SAWFeXekVpnH4UdbeEs8Sx5,True,2993325,748331,4575,2287,2288,3zqXX6kzhkbW3d4TwD2CNjMRwxTbREXySekvq37kfCNk,183000,1193199,-1010199,611
2022-01-20 18:52:46-05:00,3687,Fd2HrzBAr4JobRPARZwpQHHVoSCEoog32A6tKMWAC1sK,BYappsar5sQf8VLem4wrLuTtrDFH9y8pEx1aMxfuU4Pq,True,20563651,5140912,31286,15643,15643,3zqXX6kzhkbW3d4TwD2CNjMRwxTbREXySekvq37kfCNk,1251471,10771917,-9520446,608
2022-01-20 18:52:46-05:00,3688,WMUVFELv3C3KdMKJ5ZL4rG7o1YrV1qTP6Mmp2S5Rp8S,7UNzS3zDqT1oeq9a7eJGU8cgf8eUzEAZubSBQvNmK6uJ,True,12395195,3098798,19057,9528,9529,3zqXX6kzhkbW3d4TwD2CNjMRwxTbREXySekvq37kfCNk,762317,2870071,-2107754,615
2022-01-20 18:52:46-05:00,3689,5SskSWkRPP5BNaqvHkJCbTAgHPUkHEwFh5pFr4t8PoBr,EqdX8Sdm9LCfdrzVKzisKaFcP2YEdSRNZYmev5RWjGqb,True,2675413,668853,4078,2039,2039,DddJ7EWCmYEEZETCBNgAUSg81Ls6fZtiAaY5ekJ5sXx1,163137,674903,-511766,609
2022-01-20 18:52:46-05:00,3690,AHm7zF4rpaxaayBLn5QDHgJSp8KAr647s4cNvQ9wLgd7,FDM33WngED24pukBvSDpPAzinW6afVAeGReum5nyLRiC,True,565561,141390,856,428,428,DddJ7EWCmYEEZETCBNgAUSg81Ls6fZtiAaY5ekJ5sXx1,34259,306069,-271810,605
2022-01-20 18:52:46-05:00,3691,EmGW2aAG69ssWqCtbfDocRaM2u3TJsczn2HHP9jdmRvD,aypkDKsp9uqAB4F6mwvm5LofpsrFBuZT2MMWtE2eHdB,True,440956,110239,676,338,338,4BnQKPLuE3DMTtxp8MjUBytgnhvxqq3ZTqZHTVZo4JJh,27044,219556,-192512,613
2022-01-20 18:52:46-05:00,3692,6yw4GPvkqUbakcEWtqSCfjVLukty11xqjDpGxtEN9Km2,5ppEx7wkpqbG5nApCWMdRja3oRSheFmAAsNHUX7h2w2Y,True,1127856,281964,1719,859,860,4BnQKPLuE3DMTtxp8MjUBytgnhvxqq3ZTqZHTVZo4JJh,68790,1040608,-971818,609
2022-01-20 18:52:47-05:00,3693,2F45BX9mRmtNCHPejKFknN5aNgGvR4vVLFjMaY1a7dR8,ALdSutsvEFRUEQGGBbi31QywTL1pdXSDWrNJzvNTaoXL,True,17129237,4282309,26753,13376,13377,DddJ7EWCmYEEZETCBNgAUSg81Ls6fZtiAaY5ekJ5sXx1,1070129,8657194,-7587065,624
2022-01-20 18:52:47-05:00,3694,Ftuj53jKP3Z8mvuTE1CEypdw2eZrCn5x8ktMWRdJo2gU,9JNUFRLrPNAh3DgKvMdaNvLCAeUtiS9FGWmDcMvcSe7J,True,174301876,43575469,264109,132054,132055,3zqXX6kzhkbW3d4TwD2CNjMRwxTbREXySekvq37kfCNk,10564367,68151739,-57587372,606
2022-01-20 18:52:47-05:00,3695,9zpPiboHF5HW7NfCx7hYdmJGwUomVMTiUFc4Um5KrDi3,8q3eBpuwV6dMNkib9N8XQAq2tBUcjSANRe5SXpd4dFhZ,True,5608873,1402218,8670,4335,4335,3zqXX6kzhkbW3d4TwD2CNjMRwxTbREXySekvq37kfCNk,346829,2078249,-1731420,618
2022-01-20 18:52:49-05:00,3696,F2v1YwVAwXLiUgsJ5uwn4qAAkTXitn1E75fJcPnGuAcy,5rdJ4H5GxPg4Juu77mGc7uya5LwEqLzDSRyG8mQ2mDbK,True,13168974,3292243,19963,9981,9982,3zqXX6kzhkbW3d4TwD2CNjMRwxTbREXySekvq37kfCNk,798551,6898864,-6100313,606
2022-01-20 18:53:01-05:00,3697,H1LftKtj94Zs6PG2A7gJt9rPurBkXkTy2hbbArQwAehi,8bANmhgdnPYa3PqdPnk5BA2xhvqJmPyaMF77mrBePJ13,True,26171,6542,40,20,20,4BnQKPLuE3DMTtxp8MjUBytgnhvxqq3ZTqZHTVZo4JJh,1638,21929,-20291,625
2022-01-20 18:53:11-05:00,3698,CvZssqscu2dm35mwcE3zg9zedavbRjVJjWD59Py5ExUK,7pXaoR6aHKYofCmg1eHipygNYDteEaf8rbbS8BDYGQK6,True,480368,120092,746,373,373,HfEnetJ7uBSmZWCjBNxdvv9HEC5nsW4wDV7wu6WnhWan,29875,191621,-161746,621
2022-01-20 18:53:11-05:00,3699,3VYtHvoT9wi4K1PBjg6JjCf6U9fVPDf6tX9jyRRvLxcg,Ba5fjpVyAxLbiP6hYJmrxzougi7JUEDfDLKBxSbbTL7q,True,308513161,77128290,478867,239433,239434,HfEnetJ7uBSmZWCjBNxdvv9HEC5nsW4wDV7wu6WnhWan,19154711,68922978,-49768267,620
2022-01-20 18:53:12-05:00,3700,67Z7ZGhNu5xxEh9BYKWcXp9m1T4tFiE1o1M16hCzUWQA,CT7YKWixz7BhTbvg5F6M5HCyPGnHoFLNFuDV9GhoLTo3,True,2230157,557539,3478,1739,1739,3zqXX6kzhkbW3d4TwD2CNjMRwxTbREXySekvq37kfCNk,139143,1366475,-1227332,623
2022-01-20 18:53:12-05:00,3701,3EmGvYu72cR4Ta3wLA5HKZBEqgfChCyiRanwj5hGLJXc,6NEWPFaKi5uLsrj4n6RM1DBhQTcGFE9TwYeJ12pC7yyp,True,27220,6805,42,21,21,3zqXX6kzhkbW3d4TwD2CNjMRwxTbREXySekvq37kfCNk,1695,12146,-10451,622
2022-01-20 18:53:12-05:00,3702,ApAgbKGyEYXRonGM33w56ZxHQNAGSd9ji4K3zAGN2yA8,FZAhAUDtEaNsFmh4fP8uXNjoHneNkpZ2wQCfEeU4RYRM,True,69354539,17338634,108452,54226,54226,3zqXX6kzhkbW3d4TwD2CNjMRwxTbREXySekvq37kfCNk,4338113,27974181,-23636068,625
2022-01-20 18:53:12-05:00,3703,pgzvXpnUYiY7hLrfjmwScqLd8oj9vYcXpFvpm4y4JvG,GdqdQgoyBAFuXdbvoZyDhB3jyqJzVo4nkGh7EPFxkBF2,True,1446987,361746,2245,1122,1123,3zqXX6kzhkbW3d4TwD2CNjMRwxTbREXySekvq37kfCNk,89809,1342956,-1253147,620
2022-01-20 18:53:12-05:00,3704,J4krKPBBTMVLZRgrSeYJAMyHQs2FkNm5TXk7nQWwDB43,ASmLbfNbhTD2HHeV7qzAqiHjUx5a8Traj8oPDwbkMdFg,True,19408852,4852213,30107,15053,15054,3zqXX6kzhkbW3d4TwD2CNjMRwxTbREXySekvq37kfCNk,1204283,7894243,-6689960,620
2022-01-20 18:53:43-05:00,3705,51yPLtXTgL9oLKs1cCf5TjL54Ld5vuVxat2NNtwZVsZG,7UjtM7Z1tiXEQMMiorQyncgi9SKu3v46DhVdgXbWqSiF,True,242978122,60744530,370124,185062,185062,DddJ7EWCmYEEZETCBNgAUSg81Ls6fZtiAaY5ekJ5sXx1,14804985,217525678,-202720693,609
2022-01-20 18:53:46-05:00,3706,M69XSefqeum2arinvHEqmA3L2XHWNFN17p4msRhRZXf,2vK15yYUANLSbAoiBfgJ9VLyqsmtEpd2iNytQjms8GaQ,True,185698279,46424569,288302,144151,144151,3uL2NSR2ZdDqCiKfzA5SwwpddAnit22DBJo6uvvz1rRs,11532081,125290335,-113758254,621
2022-01-20 18:53:46-05:00,3707,DGAQzgZhS2yioeZmG3cbacM3hdz4F1aZn1PWRwgiFukc,48KUtJaNCPNxkLXJBtWAdDxY4b9vZzLgbGxTNdwMqmjz,True,358143057,89535764,549823,274911,274912,3uL2NSR2ZdDqCiKfzA5SwwpddAnit22DBJo6uvvz1rRs,21992922,177828931,-155836009,614
2022-01-20 18:53:46-05:00,3708,HcGtTcpuxex2eQyz6GjJHrjDgThU2ZWSjjnzNEf7tNXy,XuFuE8RxTusW8BYDczgzvWrD5YbDseACo2edd2K4tVv,True,54332,13583,82,41,41,3uL2NSR2ZdDqCiKfzA5SwwpddAnit22DBJo6uvvz1rRs,3318,16936,-13618,610
2022-01-20 18:53:46-05:00,3709,6nJyqvFKprwaVCE1gAa2P4RHKc6Pa6XFSJymx654zZ9K,4e7iJmdwzAPxp1Zi8Azo38YyPQdPKqqY4VLJyQ5rpdYP,True,1707227,426806,2617,1308,1309,3zqXX6kzhkbW3d4TwD2CNjMRwxTbREXySekvq37kfCNk,104694,934934,-830240,613
2022-01-20 18:53:46-05:00,3710,DdAPWdHnb7ocaYtcwwwYnppsH39sZpmzMyANeoJbCV7s,3BVmC39L8dEypPN1BZhsf9bx9Ge2sXCZR8Y6RH4eBNMJ,True,721014100,180253525,1117000,558500,558500,DddJ7EWCmYEEZETCBNgAUSg81Ls6fZtiAaY5ekJ5sXx1,44680025,553061836,-508381811,619
2022-01-20 18:53:46-05:00,3711,DdYgcyV1T2CDYiQVr4VL9Ym8RdKm93a7SKy8HxuyaoMW,GPdAeqeXb1UJ56AttcwwY1CyFhRyfptDC4BAX2Tc8MpE,True,360220,90055,554,277,277,4BnQKPLuE3DMTtxp8MjUBytgnhvxqq3ZTqZHTVZo4JJh,22182,195848,-173666,615
2022-01-20 18:53:46-05:00,3712,CBL2NbekJrXvBiAcoj4fzQ4PfLDwTntW7Zt4nruHFYEw,59EvfgYTdKkfjUJz5LddLUAqbEdLaihcMzjcrTZsyzyS,True,6413,1603,10,5,5,3uL2NSR2ZdDqCiKfzA5SwwpddAnit22DBJo6uvvz1rRs,400,2924,-2524,623
2022-01-20 18:53:46-05:00,3713,6oroGB3mvzK3tDfiB9X2NJuL3x476pxhgRnt7VxqhdLo,2SoK8tKkLn2ppKURpTVazKsCEis4uahkHMsac1m85J4r,True,1227693,306923,1913,956,957,4BnQKPLuE3DMTtxp8MjUBytgnhvxqq3ZTqZHTVZo4JJh,76545,1101171,-1024626,623
2022-01-20 18:53:48-05:00,3714,HVZkXeDR3mc8oB9qFFwCK4RXpPojdcHk9tRGep6xtKGK,Bh3py7awPejWqeTMxtAgF7mPotL2Asxf8YrYJykq9nBt,True,4519127,1129781,7054,3527,3527,DddJ7EWCmYEEZETCBNgAUSg81Ls6fZtiAaY5ekJ5sXx1,282176,2098801,-1816625,624
2022-01-20 18:53:48-05:00,3715,4cKgCTttVp8pzJnp43PP7uLLUXNcU7YGPJ3cCGHaUFe7,BBQqjwTpVEgpDzMk4wDDH8rCjaSxCRPWVhtFxERSujTD,True,27718970,6929742,42589,21294,21295,3zqXX6kzhkbW3d4TwD2CNjMRwxTbREXySekvq37kfCNk,1703571,12793213,-11089642,614
2022-01-20 18:53:48-05:00,3716,Ckqos6cdncPKj13DnCmDVZsZTqp6eS7277CRrT9WhcEr,AtUV8m7VQJvZq7GLCAHMf3jV7iamKEPnWVZHWuuVZQp1,True,850790,212697,1318,659,659,DddJ7EWCmYEEZETCBNgAUSg81Ls6fZtiAaY5ekJ5sXx1,52731,548716,-495985,619
2022-01-20 18:53:48-05:00,3717,CRaKcudjkQiSw5YPVjTLVdXvJskeGiHSYtq5ZcMPJhgQ,AgqTg3b3bAcaBmRidhNC4Uf9ZwNbeH52RQEqumWyuUs7,True,593290,148322,908,454,454,3zqXX6kzhkbW3d4TwD2CNjMRwxTbREXySekvq37kfCNk,36347,382591,-346244,612
2022-01-20 18:53:48-05:00,3718,o2aCmkxsxSiyUX8soTEjwUCbJeXmCZsEaf8CWwxDT5n,3pvS2bTsUuiQyqZp5rdnTpq4cqWGgtv4E5rN9HsBxpRt,True,16371,4092,25,12,13,3zqXX6kzhkbW3d4TwD2CNjMRwxTbREXySekvq37kfCNk,1007,5238,-4231,615
2022-01-20 18:53:48-05:00,3719,9vcKW1GfrDZ3KLPh2pEVFF8ZyKqD1pJW1hiE8H98Av7S,C6Ki27mo4sCHu6u8UnR1p7WSgsTjFQxGGR9Lk9n5Rhjq,True,1903682,475920,2937,1468,1469,3zqXX6kzhkbW3d4TwD2CNjMRwxTbREXySekvq37kfCNk,117515,987128,-869613,617
2022-01-20 18:54:00-05:00,3720,4ne6vC7qdxQYHJCsaeFAKZrKdFt2SwXGHQ3jrMHqt4DL,Cf1dLHY2WXH9rXbRKq5TT8THbdo9SdNUZq4rYhRCF9z,True,68958662,17239665,107822,53911,53911,3zqXX6kzhkbW3d4TwD2CNjMRwxTbREXySekvq37kfCNk,4312898,17839382,-13526484,625
2022-01-20 18:54:04-05:00,3721,FKQVm9RsteDe7dQmwx4NGYhz3Wrvwh7TCp9rFbTgAomx,Dbwox8eRCdmH5KXyi5sBaqWzhxtaVPo1teWXJ2kRFT1f,True,472645086,118161271,735699,367849,367850,3zqXX6kzhkbW3d4TwD2CNjMRwxTbREXySekvq37kfCNk,29427982,390828296,-361400314,622
2022-01-20 18:54:04-05:00,3722,CagSUfZLwXuCdypC4KzU6FSNdmCj9dKDroPcNeaRtsyt,yxw5d1ztZuEUY2QjL7eLpr72QJAj5rJd6ERvg91cy1m,True,1107970,276992,1719,859,860,3zqXX6kzhkbW3d4TwD2CNjMRwxTbREXySekvq37kfCNk,68794,461765,-392971,620
2022-01-20 18:54:04-05:00,3723,2jPxG5FL6D6XEJsRszJ9cmQ54AWSpZyPFSbn3DpWBSuM,3toQou4UVNvyWYvMvkuv379RVEF2aN2TzCpKKBUqeQV6,True,132263608,33065902,205508,102754,102754,3zqXX6kzhkbW3d4TwD2CNjMRwxTbREXySekvq37kfCNk,8220342,60482349,-52262007,621
2022-01-20 18:54:04-05:00,3724,3qnPsgqW11AcDEmyjmJquPcPLyE3EdJQuVLJ5kinDrd3,86rZadBB7emKio76aFTahpbrFtxd9tqZ4Mxgzaavq2xU,True,108215,27053,168,84,84,3zqXX6kzhkbW3d4TwD2CNjMRwxTbREXySekvq37kfCNk,6729,50566,-43837,621
2022-01-20 18:54:05-05:00,3725,5rW9kqXB9feGSKSvSMNJF1FCsBYV3vGmTmc8MvzaZ3pi,7AjnjcfPJevW5521hXw4VtgRCfHSsAqyzyArukKfNcHo,True,7532917,1883229,11735,5867,5868,3zqXX6kzhkbW3d4TwD2CNjMRwxTbREXySekvq37kfCNk,469412,4148028,-3678616,623
2022-01-20 18:54:06-05:00,3726,2FEbsetZMkRqLjSC8GBbgecKgX5T1T1fci2sLQux29p8,H722Fcd6DkTFRZxqQWbPDufBfXEgmFfhiEpQZWhxwYv1,True,3309396,827349,5164,2582,2582,3zqXX6kzhkbW3d4TwD2CNjMRwxTbREXySekvq37kfCNk,206577,1401522,-1194945,624
2022-01-20 18:54:06-05:00,3727,HGJoZvLakWfSDFwuvShNBc4kCf7nP7VqzyM3mELpbFEf,12Qn5jin7QvsBngXqYAv4UstyG3b6nRf1jsLp9Dp8G7k,True,11109339,2777334,17304,8652,8652,3zqXX6kzhkbW3d4TwD2CNjMRwxTbREXySekvq37kfCNk,692160,5419611,-4727451,623
2022-01-20 18:54:06-05:00,3728,GqAS41YJssg9aaEp3hs3sG98APCsXhiQBQszXaSjZ2bN,2wodJ3AhrXdE1T4oVL95KvoBND7PubG5Wd5GWiLCMZJU,True,130109913,32527478,202338,101169,101169,3zqXX6kzhkbW3d4TwD2CNjMRwxTbREXySekvq37kfCNk,8093537,111475682,-103382145,622
2022-01-20 18:54:09-05:00,3729,8627qmFevGS1LSDyCgoJjbURcf8CjVFCcxE7U9mWVP5f,3sgQuNcZuGV59Q9apxSBQcV1XAa6og6xa8FLpumvN7iZ,True,27459,6864,42,21,21,DddJ7EWCmYEEZETCBNgAUSg81Ls6fZtiAaY5ekJ5sXx1,1711,12473,-10762,623
2022-01-20 18:54:10-05:00,3730,9Hz4p7gcfDbXBJp8KzhaBBPh9i7xe9kun7zLfDtqPe6c,2bJ43Lep6kp6WY7Ct56oiscKnAbdtC265G5yRvRPFThU,True,650629213,162657303,1017261,508630,508631,3uL2NSR2ZdDqCiKfzA5SwwpddAnit22DBJo6uvvz1rRs,40690447,144181234,-103490787,625
2022-01-20 18:54:10-05:00,3731,3C2MZQKh9x4zNTCMbhhvoafGaFMwUooqfy9MCgPyXs6E,AHjgWKpYPWe6ketjDHDKFBFsKQiRJ41jnkuo39MVYxZo,True,145016631,36254157,225811,112905,112906,DddJ7EWCmYEEZETCBNgAUSg81Ls6fZtiAaY5ekJ5sXx1,9032473,88705384,-79672911,622
2022-01-20 18:54:12-05:00,3732,U3vvMQ4X4aKzVYfhMw1V1p58HRqaLnuXozqmmefYeD9,7JA94MArkNCFRhBq8f5a32DgMF6aPdFsoC5HvXDQ6NuR,True,215131490,53782872,336556,168278,168278,3zqXX6kzhkbW3d4TwD2CNjMRwxTbREXySekvq37kfCNk,13462249,120258960,-106796711,625
2022-01-20 18:54:12-05:00,3733,BrHRMouGRz3LBNzd9anfdYMhWfg8yUPHL4PqJ8WdEDFS,4uzoLa3mC2VYHAPBoHLX4gTjPTC28rPf2fvEGtJWPYc,True,41682981,10420745,64997,32498,32499,4BnQKPLuE3DMTtxp8MjUBytgnhvxqq3ZTqZHTVZo4JJh,2599897,35500567,-32900670,623
2022-01-20 18:54:12-05:00,3734,8MGEQ1KEMv9WSgVifjN7CQ7tDbJBJbWgGYu71dTDKEPQ,mQY2X9KYVXf9JmGY8XwMK4G8odM4HmWkgEmYYqKnkvF,True,117820115,29455028,183231,91615,91616,4BnQKPLuE3DMTtxp8MjUBytgnhvxqq3ZTqZHTVZo4JJh,7329257,63866778,-56537521,622
2022-01-20 18:54:14-05:00,3735,6BQVtmNsxihi4PcA7MurtguTwa6SmbmKyP14RHyjVZkf,7ZFv5ms4HzVKiw7KgE8RUoKxW9rB6JUD7ujZxMx4DwnM,True,2270746,567686,3549,1774,1775,3uL2NSR2ZdDqCiKfzA5SwwpddAnit22DBJo6uvvz1rRs,141965,870916,-728951,625
2022-01-20 18:54:25-05:00,3736,Gs3WP18hbzNpbBgiU39e6tfkggfCKRyNqPqJQcthuHFD,4XAY25YUma6gUdG2GdbXeivum3t21g93ZagfWGTZYkWZ,True,9399877,2349968,14708,7354,7354,4BnQKPLuE3DMTtxp8MjUBytgnhvxqq3ZTqZHTVZo4JJh,588355,4693864,-4105509,625
2022-01-20 18:54:35-05:00,3737,ymyzGH4Qc7HH5PbKpVphCbsQgLLXyGkPcXamQJuNj5C,8oTLHaV2XzbKXNWRuUjCfHjUn61Pw93LYK14m9q2VDpZ,True,9420328,2355082,14736,7368,7368,4BnQKPLuE3DMTtxp8MjUBytgnhvxqq3ZTqZHTVZo4JJh,589445,3932072,-3342627,625
2022-01-20 18:54:58-05:00,3738,BPsM1um9ZJf7eNoVMsQCRSwgARMuLCGGSDxf9tZeNeEy,BpzDdXfxVygiSYSmsHV6uPxQMeTFtrURMCCqhswQjd5X,True,825707,206426,1291,645,646,3zqXX6kzhkbW3d4TwD2CNjMRwxTbREXySekvq37kfCNk,51657,352111,-300454,625
2022-01-20 18:55:11-05:00,3739,B4Uc39nKzz9wBRQsCkMR4A7RwTJ8rSuwpR6EQn2AesRb,H49bGZgatRZVpj6QufZRVgYrQtH7LpdbiqKBs23151m,True,17720553,4430138,27669,13834,13835,3zqXX6kzhkbW3d4TwD2CNjMRwxTbREXySekvq37kfCNk,1106787,16648166,-15541379,624
2022-01-20 18:55:13-05:00,3740,BJV5jbowrbELXfDvfMovaQy4PiRf12pLYHimW9bgzW5X,6WXrWso5FvLx7RMCFBzrbzh5qevKkk2LJAihUfWXxXzB,True,14822380,3705595,23146,11573,11573,3zqXX6kzhkbW3d4TwD2CNjMRwxTbREXySekvq37kfCNk,925877,12725481,-11799604,624
2022-01-20 18:55:13-05:00,3741,FF8rqfM9PTEjYiVFy8jS81weDRwdaYooux2uSa2LexrJ,JBk1JghH1gged1YpDbkczFXP9ka5ivYSkaYoVbbXD4kg,True,128453875,32113468,200479,100239,100240,3zqXX6kzhkbW3d4TwD2CNjMRwxTbREXySekvq37kfCNk,8019178,67046657,-59027479,624
2022-01-20 18:55:14-05:00,3742,6rb3fRVWJ5cSzFcmuC1YwdrNxiNctvboDF7HwsfyGoCA,H6JaYfFZkRk6iSJrA4nVeuFpMVQtVwQZHVgK1TyaupTE,True,29719,7429,46,23,23,4BnQKPLuE3DMTtxp8MjUBytgnhvxqq3ZTqZHTVZo4JJh,1859,24430,-22571,625
2022-01-20 18:55:16-05:00,3743,E1CShgy7M9998q9jyzpnHZxHJR6z5hvnshUJt37kVPtG,96f1nYW4S9APCJS3TXTGSb9UcJDdxJuoBR3pLYqcNz2b,True,121014980,30253745,189076,94538,94538,4BnQKPLuE3DMTtxp8MjUBytgnhvxqq3ZTqZHTVZo4JJh,7563079,55281633,-47718554,624
2022-01-20 18:55:18-05:00,3744,8trkirSQNdMmAcJdeswxs5cPjH8dD6U4eJtWiAdMsrDB,HaSzpQ45x2MipfN17U6jGBxX8tXboomVDhXNSrnEfLDr,True,3195005,798750,4957,2478,2479,4BnQKPLuE3DMTtxp8MjUBytgnhvxqq3ZTqZHTVZo4JJh,198313,1373763,-1175450,620
2022-01-20 18:55:21-05:00,3745,BYvjENe16Ta77PqGV7JKEWrsqCTfkMGYwTSG5gXneDvd,EvxAXgvhPC6QkNurbK7vWyTApGo8J2R4EgMAknkHVU3d,True,2116643,529160,3310,1655,1655,3zqXX6kzhkbW3d4TwD2CNjMRwxTbREXySekvq37kfCNk,132424,1394260,-1261836,625
2022-01-20 18:55:21-05:00,3746,FV9CBGGTbppLnBKh79f2LzD1diTiS5g6u89FcpZHZmnK,Fe7mtmCUziFqbbYTvrhAcAq1Ub7YLfTJRtQ1hG7GzJD1,True,3725289,931322,5827,2913,2914,3zqXX6kzhkbW3d4TwD2CNjMRwxTbREXySekvq37kfCNk,233089,1577531,-1344442,625
2022-01-20 18:55:22-05:00,3747,DMgD2KCEhTGFLUZ5GnfNcwfiiwKYbyVpoWiN6knMkCAf,5KU2vgBkPTNVHsSULjgX7ZkZS56U3Dy3xqLTxL5sUZJ3,True,976428628,244107157,1527011,763505,763506,3zqXX6kzhkbW3d4TwD2CNjMRwxTbREXySekvq37kfCNk,61080459,629377791,-568297332,625
2022-01-20 18:55:29-05:00,3748,AL8JFS4gjaQx89f9j8wtaNJgV76K8bw1ugvNtgvhgAnb,HJYvG2kGKe8kXgtZSWTWwTmSjxA3XUeCvyT7acoKtS1C,True,3233133183,808283295,5058702,2529351,2529351,3zqXX6kzhkbW3d4TwD2CNjMRwxTbREXySekvq37kfCNk,202348109,1174124581,-971776472,625
2022-01-20 18:55:29-05:00,3749,96StvqZyFUPtyMr4o9s7K4V29RSNyRpVi76vNwxG5rUf,GZKXFSFq4aGiTaqovtxqNCCVGkAFNXPh4Hep1ZMwdZ8g,True,15808459,3952114,24705,12352,12353,DddJ7EWCmYEEZETCBNgAUSg81Ls6fZtiAaY5ekJ5sXx1,988211,14347868,-13359657,625
2022-01-20 18:55:33-05:00,3750,6Bq55LtGCEeGqh4JrFLCmmGc2iJfTTBJixivqH78aGSE,DSNrCgWJeNe2P9tAQu5FvCueTzNKDKds7wzuwTQSMRG,True,4702826,1175706,7354,3677,3677,3zqXX6kzhkbW3d4TwD2CNjMRwxTbREXySekvq37kfCNk,294189,1960063,-1665874,625
2022-01-20 18:55:50-05:00,3751,3WcJUt8jQ1ngL3ZCGo6dFrc3GmTMTYtzeDva7mri2Tqx,HeG1Pz2oMjqtkfsRMsbqP3VpatnVEQzcWmKDVoFp4Htr,True,11101881,2775470,17159,8579,8580,3zqXX6kzhkbW3d4TwD2CNjMRwxTbREXySekvq37kfCNk,686386,5421294,-4734908,618
2022-01-20 18:55:50-05:00,3752,CwTus4FyoXYqyTKAYDp69NLhA1joYZ3tarzY6FFTr6fn,6ivuvYWU6i25MzJSY8rG9rPDKiq38E6QtrV1jvRubLGr,True,7161,1790,11,5,6,3zqXX6kzhkbW3d4TwD2CNjMRwxTbREXySekvq37kfCNk,441,3406,-2965,615
2022-01-20 18:55:51-05:00,3753,54grbLQHZsNK4qTyXb8kXAU12Af9QUNFMujuzLLHHHef,3Ua1LDmZfPxvpaCp45RJ5xn3ovNuMxyWGrxnLcsK2ko3,True,1094108954,273527238,1692155,846077,846078,3zqXX6kzhkbW3d4TwD2CNjMRwxTbREXySekvq37kfCNk,67686238,473577284,-405891046,618
2022-01-20 18:55:51-05:00,3754,9ebpuMtXee3DSx4qWiEYEtTT1gK5FqCY2H5yQVWWtTts,9b71dTsTYD1bx6KsjFs5h6d3Jj4T9eX3nqmS7RQj3HS5,True,207002989,51750747,320844,160422,160422,3zqXX6kzhkbW3d4TwD2CNjMRwxTbREXySekvq37kfCNk,12833778,94315894,-81482116,619
2022-01-20 18:55:51-05:00,3755,CP2qcTSw1Y5J7jZiEgbtsvJoigRbJ4m9oHGQS8Fiai2x,7Zd1uX1thbuGkp9H4r1t8aLTu9W8MxvUBNjji2FNJa8E,True,27744241,6936060,43110,21555,21555,4BnQKPLuE3DMTtxp8MjUBytgnhvxqq3ZTqZHTVZo4JJh,1724413,12788784,-11064371,621
2022-01-20 18:55:51-05:00,3756,8nXbrdjjaHB73CRPRenGEQj73wbtEFGDwXsehRGMhsap,43pvdcJ6f27wz94D6ZboKwRJYbyvYCrjsJhYsvk7LJCM,True,44092306,11023076,67880,33940,33940,4BnQKPLuE3DMTtxp8MjUBytgnhvxqq3ZTqZHTVZo4JJh,2715231,9333614,-6618383,615
2022-01-20 18:55:54-05:00,3757,2PzBAkdXkrwH9VuoMALumQz86qkW7sSBQtCrHw14JUp3,D5vwWAMHVooobG2sCWv9EwtJrAFZG6cwKH4dfmA98tbt,True,1435909,358977,2241,1120,1121,3zqXX6kzhkbW3d4TwD2CNjMRwxTbREXySekvq37kfCNk,89655,680834,-591179,624
2022-01-20 18:55:56-05:00,3758,AA6QgBaH9F8QfPT9xjztv9uELcADPxwUuXofkBV8dYg4,FCMXozSstTNA74FVCJ5hpYvNJamjutnoakHoBVnzwcWj,True,14683,3670,22,11,11,3zqXX6kzhkbW3d4TwD2CNjMRwxTbREXySekvq37kfCNk,911,7380,-6469,620
2022-01-20 18:56:02-05:00,3759,Cs2YxkuqBK1kjoYZbUZdUcxapPbv8oC75trwGgWoCPfG,2PgHQM1GhHykE4bQ1ggueAw2Zs1BFUW5hxvMvr8DojKM,True,38863564,9715891,60079,30039,30040,HfEnetJ7uBSmZWCjBNxdvv9HEC5nsW4wDV7wu6WnhWan,2403171,23602084,-21198913,618
2022-01-20 18:56:13-05:00,3760,GjQQ2fQ7mrGjWZwjVYFUKp9NM1LmfkhEo675ovU5SPa8,ECgVUMRY5nB4MALs5drDyipF7YohCPuJpj2UegCs7HMn,True,15457714,3864428,24167,12083,12084,4BnQKPLuE3DMTtxp8MjUBytgnhvxqq3ZTqZHTVZo4JJh,966699,6900448,-5933749,625
2022-01-20 18:56:30-05:00,3761,FX5sizQGZcDCaETDyJ3HbLxFwhu4t9bX6YyQM7cVEo9Z,6EqnCsv1JPjz6JX1yLNcf74rmkuhAUx6Sf35QMYGuuF6,True,120969856,30242464,188981,94490,94491,3zqXX6kzhkbW3d4TwD2CNjMRwxTbREXySekvq37kfCNk,7559255,55660401,-48101146,624
2022-01-20 18:56:30-05:00,3762,F1JT1p2VuwK4L7zj7NNnZtYiZiNUCcTGKDkgdoX3BZdZ,3BKe4yzTwnnBnvTWP3britpPJ4oAWL7JZJzNLCxjUufS,True,3587,896,5,2,3,4BnQKPLuE3DMTtxp8MjUBytgnhvxqq3ZTqZHTVZo4JJh,224,1022,-798,624
2022-01-20 18:56:30-05:00,3763,3REbHhGGpn5b2GH67yQy2Dn7ZLNGLfM6hkBNU8UE1BRm,FBeCamJw884cPNpzbzhjSF7CFXyyhjnj3qWWCdBCK1NP,True,3276630,819157,5125,2562,2563,4BnQKPLuE3DMTtxp8MjUBytgnhvxqq3ZTqZHTVZo4JJh,205038,753410,-548372,625
2022-01-20 18:56:30-05:00,3764,X5SF9srgzDgBRBhv8xUWyszYYSQiqFF6cVnVLWzQgp1,7rTqnMkPuUUJFt5px1DxwsUK8U5fQUtnx9N4v6dA4vGb,True,18258,4564,28,14,14,4BnQKPLuE3DMTtxp8MjUBytgnhvxqq3ZTqZHTVZo4JJh,1141,8633,-7492,624
2022-01-20 18:56:30-05:00,3765,Cb4zhnvig11U4GcC4kqKrnDicGgPhUpfDQB1U7hP3nPa,DiRAMrKqaevGXeXg38KnhaYBERj8tNKU7oWFJvhS32kw,True,111334,27833,174,87,87,3zqXX6kzhkbW3d4TwD2CNjMRwxTbREXySekvq37kfCNk,6960,45798,-38838,625
2022-01-20 18:56:30-05:00,3766,8W9NJfM6cqCsvR1FC8Ab8YZPSQF7bz7inxJZxWnF7GsX,3exfPuVcTnPxs8GwCtS3ruKUGveYymwGV7RXQssPiizJ,True,217277746,54319436,339670,169835,169835,4BnQKPLuE3DMTtxp8MjUBytgnhvxqq3ZTqZHTVZo4JJh,13586819,185522144,-171935325,625
2022-01-20 18:56:31-05:00,3767,7vKmhLV45Q5etXhJL5ng8rxWhYSiUCDmAbGnwBPr7zcx,cP6xPeuHLnjr858QK1F9qYn7rJpEbPy7wEJHoju6oV7,True,23890736,5972684,37340,18670,18670,3zqXX6kzhkbW3d4TwD2CNjMRwxTbREXySekvq37kfCNk,1493624,11226566,-9732942,625
2022-01-20 18:56:37-05:00,3768,7D4rFmGMPKNAF75VRPxHAhSn2wTjiW8jmth1UD22Xqq9,GQ7BrT6vsXu8tHCMm75YdxFR2r9QTCrCUbdPEZBSAg9w,True,26455260,6613815,41366,20683,20683,4BnQKPLuE3DMTtxp8MjUBytgnhvxqq3ZTqZHTVZo4JJh,1654648,10639778,-8985130,625
2022-01-20 18:56:37-05:00,3769,DrzTARa7RK8RXoxHZPKCBqYtMC8TAUHRw8SznXRKTa5M,FYANet92VhyXkKZqqBJR4sFxuCftWb68sgQU9VHCdTJk,True,18226,4556,28,14,14,3zqXX6kzhkbW3d4TwD2CNjMRwxTbREXySekvq37kfCNk,1140,8262,-7122,625
2022-01-20 18:56:38-05:00,3770,i7TcF4weYcqgrRdH3GpndbEYxCxfcSfr9JWYrAUg1CF,BkDfknUir7PnSEW8auoB87PytycEFwyX5kT2GY4SGJJL,True,2917979,729494,4557,2278,2279,3zqXX6kzhkbW3d4TwD2CNjMRwxTbREXySekvq37kfCNk,182287,2543202,-2360915,624
2022-01-20 18:56:39-05:00,3771,EhANPABkSw9x9WnsDEi8pCg67iQTX2UGTTUpyjADTwdN,4FKLi98hyg9ZjM4MY6ctJsv7B6vPUnTYWdhrnNoYsztX,True,5536594,1384148,8644,4322,4322,3zqXX6kzhkbW3d4TwD2CNjMRwxTbREXySekvq37kfCNk,345779,3207738,-2861959,624
2022-01-20 18:56:45-05:00,3772,CK3ocyWzXQkJJZQmM6bBK4Nv6Rh3UEufjY6DvNU6gJZy,C924o4GY3p2BHLeAbFbe9SEysXqCUyD8sFu2d4NzkAV7,True,3595523,898880,5606,2803,2803,3zqXX6kzhkbW3d4TwD2CNjMRwxTbREXySekvq37kfCNk,224270,1508514,-1284244,623
2022-01-20 18:56:48-05:00,3773,3y34hmyz6rsVnpp7d6a9s2Xw9GdezLU1H44HfieG6SGG,9DCz2eyYsrk1Hd5zsSVBhKTV9QD6beym5zB5fH3aA4hE,True,570134273,142533568,891658,445829,445829,4BnQKPLuE3DMTtxp8MjUBytgnhvxqq3ZTqZHTVZo4JJh,35666331,468495446,-432829115,625
2022-01-20 18:56:48-05:00,3774,GhV3DChNShu8mGwUUy7VLidabCV6Y2aKdp7cqPynd6Ci,8R8QkgruGRCeE1pjXmn3WjdVDiawNbXFid8gU8BfabZA,True,9838,2459,15,7,8,DddJ7EWCmYEEZETCBNgAUSg81Ls6fZtiAaY5ekJ5sXx1,614,4469,-3855,624
2022-01-20 18:56:48-05:00,3775,E1wp3bmkcY3eiEYyGYwhTCsr7BZ7RfPa5DJTZFupcFwj,452hVdYkD5SDDrA6hv6DLPFvyS8PvR2P6DPNScGxWTsW,True,444874,111218,693,346,347,3zqXX6kzhkbW3d4TwD2CNjMRwxTbREXySekvq37kfCNk,27754,216348,-188594,623
2022-01-20 18:57:36-05:00,3776,2NHv3c4ufYGo3xNr6KXymAZJdpfURrNiCKbXZ7s82Vwo,E4NYpYgHTvSG6LqH2bBV9Q1XJ6pAzCp9FLSKMzJmYRrQ,True,14275179,3568794,22334,11167,11167,3zqXX6kzhkbW3d4TwD2CNjMRwxTbREXySekvq37kfCNk,893394,8428036,-7534642,625
2022-01-20 18:57:56-05:00,3777,F9s8a7Cpiw5dw3a2aNFMofqwyDWNXvDLnSdJzoj1gRiV,GpKsQKJD79KBRWdCTkyi4zX7NaoCWsLUjrKxAwJB6o6s,True,20418582,5104645,31863,15931,15932,3uL2NSR2ZdDqCiKfzA5SwwpddAnit22DBJo6uvvz1rRs,1274525,4997465,-3722940,624
2022-01-20 19:03:31-05:00,3778,2jDRvE3pQNjWy1NRFa4tzB3KmU5UkbUCHw8sQRFujo66,C4zNi2szDrEEh4coTF3WRUghfP4ZwAVVSYTLWfkejQRu,True,462283966,115570991,706525,353262,353263,HfEnetJ7uBSmZWCjBNxdvv9HEC5nsW4wDV7wu6WnhWan,28261037,173245454,-144984417,611
2022-01-20 19:03:41-05:00,3779,GxFxvEUdWofneMmVvhCSScH9V6Zia5WJ2J9q6CpPnaq3,ATLykiHDii3Lw53MoZXwqu1FbBNPJbVNVGe2SoQMjVmY,True,3101628,775407,4786,2393,2393,HfEnetJ7uBSmZWCjBNxdvv9HEC5nsW4wDV7wu6WnhWan,191461,1593932,-1402471,617
2022-01-20 19:04:00-05:00,3780,H3x9b27yHVdCxvtDf7mmJxkNeubcmQMwfAkLTYADPWNv,HGVCCz23rWx78vrTB2wvm2aesbLZuYFhhNuznGiSSAyA,True,3253837918,813459479,5063189,2531594,2531595,HfEnetJ7uBSmZWCjBNxdvv9HEC5nsW4wDV7wu6WnhWan,202527576,699875725,-497348149,622
2022-01-20 19:11:45-05:00,3781,9TL17gjvWFdhSJkpXgfnX7fKF9c2hfw59k3g8WUqm8Cb,7TyxFBKG4z5Xv3js3n1gbEWWj1M9KBF7dEmFxjCPGidC,True,102022962,25505740,158960,79480,79480,HfEnetJ7uBSmZWCjBNxdvv9HEC5nsW4wDV7wu6WnhWan,6358438,39281866,-32923428,623
2022-01-20 19:11:50-05:00,3782,89CkXnSZnr52Zsoh48efv9MQacrkB6GMtrbEpNJSyA2H,HcvRBS4Z22CpYgDNgm4TVF4AVXFDuYzBUAFcdHAwdpg4,True,1653706,413426,2585,1292,1293,3zqXX6kzhkbW3d4TwD2CNjMRwxTbREXySekvq37kfCNk,103424,769906,-666482,625
2022-01-20 19:11:50-05:00,3783,75ycx5sUFBxDhY1uwuPCW22s2C6BydkJTje7q7zEQFGT,FpEgrVFRubjGK4DRjTqdVbxSECURpn16zfpoC31NbwnN,True,3516583,879145,5470,2735,2735,3zqXX6kzhkbW3d4TwD2CNjMRwxTbREXySekvq37kfCNk,218826,2041067,-1822241,622
2022-01-20 19:11:50-05:00,3784,9rfebymEFqy2SoBoDKKUppZVRPr1zNh6gkFYkmVsqbqz,6pQ3MsewzM8jzKEQG5zJDry8iEMUjGA1UDJPEQjFWTgR,True,4563061,1140765,7088,3544,3544,HfEnetJ7uBSmZWCjBNxdvv9HEC5nsW4wDV7wu6WnhWan,283540,1045480,-761940,621
2022-01-20 19:11:50-05:00,3785,AKxRtcdpi7gWhAuL8ENj7zhgeQezzEXe9TSANE6bQoRA,2YH4vrU9deP8Cu6E8Hzf8GqKG1yVjv5pdz4FE7r5YKir,True,3775708,943927,5881,2940,2941,HfEnetJ7uBSmZWCjBNxdvv9HEC5nsW4wDV7wu6WnhWan,235273,1755389,-1520116,623
2022-01-20 19:11:52-05:00,3786,EHJXCJ4ZxPY7F1CeDQkXxVCLyTBXAY2ouWMJfKic9EcK,3yxXBa3sJhUhK9auop8niypnuWiasge5waVTM1zzuhU7,True,609242878,152310719,947972,473986,473986,3uL2NSR2ZdDqCiKfzA5SwwpddAnit22DBJo6uvvz1rRs,37918886,149123799,-111204913,622
2022-01-20 19:11:53-05:00,3787,5Z3ZFCA65WoWhm3okRuuziEMi7ajGAEHWUFchzBNba5S,FcomdrWidygkxMKzcsY5xELbmwC652uMci648LMTv7AB,True,6857,1714,10,5,5,3zqXX6kzhkbW3d4TwD2CNjMRwxTbREXySekvq37kfCNk,427,3165,-2738,622
2022-01-20 19:12:07-05:00,3788,Ar5QB4VBcUyzSCG23z2QNAbrWY55NbHCr1MNN6P2GAmh,BusFGTiDrJmxzwGUxWz9b3SFF3eseqtgh2DRHqyAwyVe,True,255092,63773,398,199,199,3zqXX6kzhkbW3d4TwD2CNjMRwxTbREXySekvq37kfCNk,15934,124802,-108868,624
2022-01-20 19:12:17-05:00,3789,4j19AEcDwhtAZrnoDc4epNPmEL1jPpVUMeg7RmQ72Qkb,84WB42AAGbczVE9txZPwXrx4FD5jP87r8QdDzEABTm5G,True,36234385622,9058596405,56653821,28326910,28326911,HfEnetJ7uBSmZWCjBNxdvv9HEC5nsW4wDV7wu6WnhWan,2266152875,22333608799,-20067455924,625
2022-01-20 19:12:18-05:00,3790,2BH44k4TYoQSqsSs5EASqJhxpH17Fr8Ahxbg2MAkWa72,HwvvVWpqfN7NDsVYdxbCSbqxSrLCThwnJiZQHh2w2zJb,True,9884,2471,15,7,8,DddJ7EWCmYEEZETCBNgAUSg81Ls6fZtiAaY5ekJ5sXx1,612,4534,-3922,619
2022-01-20 19:12:19-05:00,3791,9ydHRjDWvWV2XqbXKKpeLDh2RV7WnQZWDTi4ahgDjGNh,AiJQBv4a1Z4w2rsRog5WTaKb4dTjAXfAvXcWoW4DztSW,True,34491107,8622776,53943,26971,26972,4BnQKPLuE3DMTtxp8MjUBytgnhvxqq3ZTqZHTVZo4JJh,2157720,7666613,-5508893,625
2022-01-20 19:12:20-05:00,3792,D3mXrJzhHf8qRaoCKLschUxAFoijFCFuT6bmNZH4W7Cj,9E3Xtqw7TncXWnbhAbFJMtuNmP6WS3ooGuptzyzw7UpA,True,31885,7971,49,24,25,DddJ7EWCmYEEZETCBNgAUSg81Ls6fZtiAaY5ekJ5sXx1,1989,19716,-17727,623
2022-01-20 19:12:20-05:00,3793,2rCRdyfi65rpxRRmg7knaSb8t55FuPt3h8wF4Fzhy8MM,CLVY5nSG3jTdRo7tRSKgK9DJgW6aswfWKe4tLxzsENmb,True,347195,86798,539,269,270,3zqXX6kzhkbW3d4TwD2CNjMRwxTbREXySekvq37kfCNk,21578,145918,-124340,621
2022-01-20 19:12:20-05:00,3794,HutRztBianNUgm9sJDWKUQBmoVyy8y7CfnNk4hHjSkEW,EtVfvPyiy5bizbCZxR19TNUgETf3QcmziBvMtc6o5zjr,True,135857928,33964482,212602,106301,106301,3zqXX6kzhkbW3d4TwD2CNjMRwxTbREXySekvq37kfCNk,8504083,123364511,-114860428,625
2022-01-20 19:12:20-05:00,3795,6h43GsVT3TjtLa5nRpsXp15GDpAY4smWCYHgcq58dSPM,CTgbWridYWnfE5Emwr7qiCEb3LcXHupqeB9zwmddoEqB,True,87409425,21852356,135852,67926,67926,3zqXX6kzhkbW3d4TwD2CNjMRwxTbREXySekvq37kfCNk,5434100,72156943,-66722843,621
2022-01-20 19:12:20-05:00,3796,GaEpNGa8jnwSRvjzzEMYkZe1pKcr2eiZtePrqFxpABjB,5CFZHuyWbJv14zPdX5dSQDREgHrCb4vsFvB6hLiEe3Ji,True,83943,20985,130,65,65,3zqXX6kzhkbW3d4TwD2CNjMRwxTbREXySekvq37kfCNk,5205,39525,-34320,620
2022-01-20 19:12:32-05:00,3797,3XZLp6JyrQYnufa1obczXqmK6cNR29ZMW1FdCYbWNTCP,8kUTi1Prio14m9LjCj6Mari6pXwJTYkE1mp21LMn235p,True,187284,46819,292,146,146,3zqXX6kzhkbW3d4TwD2CNjMRwxTbREXySekvq37kfCNk,11696,59263,-47567,624
2022-01-20 19:34:18-05:00,3798,4mB2DVbQVqVk535v98Cj8SPNg1tTc3DFyY2Q7VBbY645,HXo255k3RgsTGsc4hiP6ZTXUspBTqJ37duQa5eK7tqp3,True,209819750,52454937,322819,161409,161410,HfEnetJ7uBSmZWCjBNxdvv9HEC5nsW4wDV7wu6WnhWan,12912787,88912735,-75999948,615
2022-01-20 20:01:25-05:00,3799,96DzqyUxsB1FKWrhLdTdjDcokuus6rbx83gLsghqPPwt,74CWb7SVoSy3ADysEzFEeMiS2fxHJ9gdUF9pzM3E52Gj,True,10672,2668,16,8,8,DddJ7EWCmYEEZETCBNgAUSg81Ls6fZtiAaY5ekJ5sXx1,668,4934,-4266,625
2022-01-20 20:01:27-05:00,3800,9jdfc9GFTecsdRuTjWFGX13niKKmeBxRgtv5j86uhSnU,HLWMShobjSkaLyXrNjgwVaUGVtbtdUSnr1XjqpXn1bLR,True,161453,40363,252,126,126,3zqXX6kzhkbW3d4TwD2CNjMRwxTbREXySekvq37kfCNk,10087,83224,-73137,624
2022-01-20 20:01:39-05:00,3801,4MmpDGUTyMcYEqJ1RoZ46AN2BhrBUseHaHqF8AmiTPyD,7HW2YZpYM349HMfW7u4h9ESZ1AXkwN8JcVDTNFzp9aTz,True,66160578,16540144,103432,51716,51716,3zqXX6kzhkbW3d4TwD2CNjMRwxTbREXySekvq37kfCNk,4137286,38254567,-34117281,625
2022-01-20 20:01:39-05:00,3802,EeUACm9TkjHKES5U7Yj1oPhYmcp7R3tvesGBiP8txEzq,3qkmm4aS6EDirEDejmbm5PDw2jpYkC7zKqrMkmgeE5BA,True,127333,31833,199,99,100,HfEnetJ7uBSmZWCjBNxdvv9HEC5nsW4wDV7wu6WnhWan,7965,51888,-43923,625
2022-01-20 20:01:39-05:00,3803,EV21gv8jEvXtmGDoGRNm5LJEvTBccLMZyVDCLsp54jP3,DGxxoU52aQNoUQcxdvQtv2H5q2PhK6TGkLgNSaFgnZrb,True,2458656,614664,3841,1920,1921,3zqXX6kzhkbW3d4TwD2CNjMRwxTbREXySekvq37kfCNk,153647,1199590,-1045943,624
2022-01-20 20:02:01-05:00,3804,9YEzjb49Awvedv9yNc6LG54SkGBug2RYiJwiUV13mGsS,3H8w5WCD187NWWoZMNUCzUDdxTgqrRJLga8gDzUVXBgZ,True,604322,151080,945,472,473,3zqXX6kzhkbW3d4TwD2CNjMRwxTbREXySekvq37kfCNk,37815,399493,-361678,625
2022-01-20 20:02:01-05:00,3805,8BMDSWFtzq9fu1ubVGtSFw8fEaMg1uvJiECuJnN8e1pd,FwkETAXL296CirvQ2AJuSHHtdKsxkZkmXSwZVVHXVDhA,True,71735906,17933976,112232,56116,56116,3zqXX6kzhkbW3d4TwD2CNjMRwxTbREXySekvq37kfCNk,4489314,32868074,-28378760,625
2022-01-20 20:02:23-05:00,3806,BzSJ77zKaqtBk2cEL1XqFL97zTXXMRHmxtkgtXwCc3C,2g4KXTwy2MPSRQ2khNp1o1rn7CradEr9H4ySYKDoSWN9,True,5566713,1391678,8711,4355,4356,4BnQKPLuE3DMTtxp8MjUBytgnhvxqq3ZTqZHTVZo4JJh,348474,5689951,-5341477,625
2022-01-20 20:03:52-05:00,3807,KoCscQ9Q8TZHhmya5KaXBrwUEMTdCkEMRtrhvtgEmiZ,6aZ5AFMFoqf1X64RwAt1J4Yrx4WGGe2JMiEjqnQ2gEtk,True,259842,64960,406,203,203,3zqXX6kzhkbW3d4TwD2CNjMRwxTbREXySekvq37kfCNk,16258,72825,-56567,625
2022-01-20 20:04:01-05:00,3808,C3k34T2x8fW171coEG9YvoUePvxtHmrQMjVsX1Cb5ZbU,4mh5Tp4Jjh5X3GDERpSMAFgsfYJvysRdd1Nu5oJQ1Dhw,True,12570,3142,19,9,10,DddJ7EWCmYEEZETCBNgAUSg81Ls6fZtiAaY5ekJ5sXx1,786,5714,-4928,625
2022-01-20 20:04:28-05:00,3809,6XHt7CrURSomkQrtVXV5JuKSZY4tQRpUyQKfCDaSTYaD,GCgcmPSDDBsn2smYbpiX3PJybDkQWtufPu4YRsbEEU8X,True,185871202,46467800,290693,145346,145347,DddJ7EWCmYEEZETCBNgAUSg81Ls6fZtiAaY5ekJ5sXx1,11627758,125213163,-113585405,625
2022-01-20 20:06:21-05:00,3810,2NdwSLxsGok8PczpCZj9CVX2BymNU5MvHt7hWfGetg2M,8AQbDXeA6mD9QoZBFJcYbnHvZwKNxzA9CCHLAgdSfTA3,True,5865,1466,9,4,5,3zqXX6kzhkbW3d4TwD2CNjMRwxTbREXySekvq37kfCNk,364,3410,-3046,620
2022-01-20 20:06:21-05:00,3811,7nByfyoLmMrzzVHsjxL2FRF72tfW3KiRT27BRGUp4PhP,36SF6NBnUc5wK41yfGCnujpCaCwExR3iRXJQx1WNakyM,True,21905028,5476257,33966,16983,16983,HfEnetJ7uBSmZWCjBNxdvv9HEC5nsW4wDV7wu6WnhWan,1358670,4853642,-3494972,620
2022-01-20 20:06:21-05:00,3812,6WNPf4rFCX74PuyvdmzRFqbxWhguuxTQqBSdnaTVBd5D,9N7a9aiHGQsxFMgVbmWoCF9w95d12xyT7XFAwpHGkTLA,True,829084,207271,1286,643,643,3zqXX6kzhkbW3d4TwD2CNjMRwxTbREXySekvq37kfCNk,51460,272452,-220992,620
2022-01-20 20:06:21-05:00,3813,99NHcwD1iaf5FXM3UNb91SjNiiT3HwyQFQMhkGd5ASts,8syAydy52vSQQLzsLXW24BFw4VPeK66Vp3BmAbnHfgod,True,27250244,6812561,42549,21274,21275,HfEnetJ7uBSmZWCjBNxdvv9HEC5nsW4wDV7wu6WnhWan,1701969,13433390,-11731421,624
2022-01-20 20:06:22-05:00,3814,8VT2nxz5ZYDJFd9uL2XZwEXxChd9pjuMJNMAcutZubL1,EhAkiRbouzUAWtqQFsN8HEEfi46UVN8H8tyBP7CbgeLe,True,5053,1263,7,3,4,4BnQKPLuE3DMTtxp8MjUBytgnhvxqq3ZTqZHTVZo4JJh,316,2669,-2353,625
2022-01-20 20:06:22-05:00,3815,CAkknoa9UFPMEZ1KWSfqtmnL7ArVNV3HRETLwecuuXP,4cHJYv3dxA6qjcuxUkGRuL7STWobGPKtoHFD4ACUbiWq,True,5765690,1441422,8975,4487,4488,DddJ7EWCmYEEZETCBNgAUSg81Ls6fZtiAaY5ekJ5sXx1,359035,2664160,-2305125,622
2022-01-20 20:06:22-05:00,3816,Mcbzp1LhZwpfmXTv1pqe9D1jCKHw443j9QKp6tUpzgM,8uforSMAKEih5jHfHp3gCqCvaugtCmhzVfVHA63Akz7F,True,1098549,274637,1711,855,856,DddJ7EWCmYEEZETCBNgAUSg81Ls6fZtiAaY5ekJ5sXx1,68464,640189,-571725,623
2022-01-20 20:06:26-05:00,3817,AtKuDfcFXqWUMnRqQpjedUMTb5CQKLc2zoqEAcQpysKQ,9bPFLYp5TDZruLLDXDYYCiPYcD982iF8xt5rfTkqwNsL,True,6129,1532,9,4,5,3zqXX6kzhkbW3d4TwD2CNjMRwxTbREXySekvq37kfCNk,382,2789,-2407,623
2022-01-20 20:06:26-05:00,3818,7LRBswSEDBjJzQ4YurfTxLydh7tFS2jVn5V95Z6wL7ci,fD41VYGmk66MW46KKb23vAqQvUSDScgXnVdsHhJBZzu,True,64882,16220,100,50,50,DddJ7EWCmYEEZETCBNgAUSg81Ls6fZtiAaY5ekJ5sXx1,4034,35373,-31339,621
2022-01-20 20:06:35-05:00,3819,Grw2snBvSDMa7ev2nWZo81WoLfyavmXXxCV1ugHGk5Xe,AF1WVCQcBmXCnWbDx2s62vU99zW1AdhNoqbWvdrbiQVm,True,8532589,2133147,13298,6649,6649,4BnQKPLuE3DMTtxp8MjUBytgnhvxqq3ZTqZHTVZo4JJh,531923,3810646,-3278723,623
2022-01-20 20:06:42-05:00,3820,C7a8BtMjuLXkzxZBC4Wk2gjkGBmucLmDjokf9pyA1Mu6,GxwYNWwYTtFMUxuZvNC5qrEYuJzYiEURQVuBxssfCJzr,True,843594,210898,1319,659,660,4BnQKPLuE3DMTtxp8MjUBytgnhvxqq3ZTqZHTVZo4JJh,52789,277070,-224281,625
2022-01-20 20:06:51-05:00,3821,2RZPBo8Z2BgZmsASo14ySTSwqqgqmfVEjPkiAwQ1VTgf,BRS5cYtEoPRoSvTAiQaT1svWRdLJWVfy8LUb4SCudCjS,True,2693066,673266,4172,2086,2086,3zqXX6kzhkbW3d4TwD2CNjMRwxTbREXySekvq37kfCNk,166898,1263029,-1096131,619
2022-01-20 20:06:58-05:00,3822,ZoNjrSjYh4NJLW38LUPcf7jtEBxdaaM7T1zp795qjHE,FZx6v8cU25NwEosbKJ2n141o9uFAWURZB7NeCeX1trEn,True,774150,193537,1206,603,603,HfEnetJ7uBSmZWCjBNxdvv9HEC5nsW4wDV7wu6WnhWan,48269,253004,-204735,623
2022-01-20 20:06:58-05:00,3823,5hUZ9uQFcYnjAQVVaGLJWdKyg7y1XMpoo8osQ9DeY7Xd,BdYiKWsjuzJLcHh3814mJ4xQ9JxoQKKcr7AHZ7Vxoavq,True,22305,5576,34,17,17,3zqXX6kzhkbW3d4TwD2CNjMRwxTbREXySekvq37kfCNk,1388,10759,-9371,622
2022-01-20 20:06:58-05:00,3824,CEbGTNX6WpaoKp4RBGSn9LzYM6yAYyeiMrgVYgJxA4zb,AiXUcGAFFm4tc7vKBscSNjZawV5YJqbv7D1KpxD3Zufg,True,10045345,2511336,15690,7845,7845,DddJ7EWCmYEEZETCBNgAUSg81Ls6fZtiAaY5ekJ5sXx1,627635,6130973,-5503338,624
2022-01-20 20:06:59-05:00,3825,3axqGcX5yuJ2vGxRjtNguefXUvSQHDQmn2zskhyCuQkf,EYrZo9zZDaHqFdc1fam63W3jvqqmbU67wzp6yFcppwsL,True,14788112,3697028,22996,11498,11498,DddJ7EWCmYEEZETCBNgAUSg81Ls6fZtiAaY5ekJ5sXx1,919868,13129052,-12209184,622
2022-01-20 20:06:59-05:00,3826,91tPxdvLhrVtytKuNkf33XocRnpEqA1x3jDb1Je6xeui,2ByoMpaZg1uzkA48vMufvcx8BLYxWLXUK3tXAJcupanF,True,15990,3997,24,12,12,DddJ7EWCmYEEZETCBNgAUSg81Ls6fZtiAaY5ekJ5sXx1,999,7329,-6330,624
2022-01-20 20:06:59-05:00,3827,4hrm69kAKNcfBkiP2YgtW94Pbip6FLfQAwnDRAAack69,BjbZRdGMoC7Mfoa4H19UvE2eQafgKD5rqnK7BSGwqS1s,True,18645,4661,29,14,15,4BnQKPLuE3DMTtxp8MjUBytgnhvxqq3ZTqZHTVZo4JJh,1160,8857,-7697,622
2022-01-20 20:06:59-05:00,3828,8mbMH9EKd9kQDyFrYiDJCV9VaWxWCzpZBQZLyYN2yNVx,J9gT39dF1egMeQvweXYWeRAX3kpmBABijYZhfj6M2UqU,True,12361839,3090459,19320,9660,9660,3zqXX6kzhkbW3d4TwD2CNjMRwxTbREXySekvq37kfCNk,772804,4927666,-4154862,625
2022-01-20 20:07:00-05:00,3829,DiB9SeCFXjioNGPJM3GuZ3FCG9KBZhHK27zCSN5b6gkq,GtK8UtKDQy9jgtTXvam4jja9N7c4EFuDQr4TKHgNyhXT,True,2226283,556570,3476,1738,1738,DddJ7EWCmYEEZETCBNgAUSg81Ls6fZtiAaY5ekJ5sXx1,139044,1140678,-1001634,624
2022-01-20 20:07:00-05:00,3830,Buioe5v3DyFwD9nquW5XdYeVYbSABCyg79eUHEvtvfaW,7T9gi7prCcZJkYJMSB5Ef6Bu4pAuBw4XLvumSFnqKDSi,True,358543,89635,558,279,279,DddJ7EWCmYEEZETCBNgAUSg81Ls6fZtiAaY5ekJ5sXx1,22357,219321,-196964,623
2022-01-20 20:07:00-05:00,3831,6BPPDj3BVgBPD3agd8b4B12d9Gvp4bFPXRWjzbtsmtRF,8VZnAwXPyKK2AHoMTZxKXthAiFMrL6b5EXAGqsAMTdhm,True,15992,3998,25,12,13,DddJ7EWCmYEEZETCBNgAUSg81Ls6fZtiAaY5ekJ5sXx1,1001,7329,-6328,625
2022-01-20 20:07:01-05:00,3832,C4dbwF9mioaBkZnyBFvFs6Cqd362VuGPBGPbTY9CAnAk,CcUqBfu1hbWm5VVxbtF2Xm6HUz4CLFzuDsjUi6KtnZQg,True,901179,225294,1404,702,702,3zqXX6kzhkbW3d4TwD2CNjMRwxTbREXySekvq37kfCNk,56199,294086,-237887,623
2022-01-20 20:07:20-05:00,3833,FjDp4bWCtqehFD7FunCrjrcdxMezTJj5aqh2VnBvHDQU,HRYeZqcqhP1RPiAGXziR1qCWwk4sF6c5ZYbvSDhX7foN,True,4062746,1015686,6327,3163,3164,3zqXX6kzhkbW3d4TwD2CNjMRwxTbREXySekvq37kfCNk,253115,1821176,-1568061,623
2022-01-20 20:07:21-05:00,3834,HPDN6Ro6gPgYbNgnv7yhFCpyY3uYzT18epFxRFNZ985w,3Jop74A52E7gYLXJRUAoPBzSZ6mmP2gmaCg7eG6eQHu5,True,316382196,79095548,493115,246557,246558,3zqXX6kzhkbW3d4TwD2CNjMRwxTbREXySekvq37kfCNk,19724616,83041346,-63316730,623
2022-01-20 20:07:24-05:00,3835,EEcTbsFTUEifcdbPyjBLkS943daEx1RpR8F3uZxKRZbT,8V3JzDQ1VWYQLas8fxUsWJZZHe4gEmn74RehtUwLw3k5,True,2711275,677818,4236,2118,2118,3zqXX6kzhkbW3d4TwD2CNjMRwxTbREXySekvq37kfCNk,169469,1482541,-1313072,625
2022-01-20 20:07:55-05:00,3836,EgU9hX6VK7YXeCgCHVaJAMekCcyZa2MVWdKra5pN7Gwv,7y8Ad9XY34bqREvheXHT2tr8Jy11D6X3pu7yLVtjU4QV,True,5016771,1254192,7846,3923,3923,HfEnetJ7uBSmZWCjBNxdvv9HEC5nsW4wDV7wu6WnhWan,313865,2764085,-2450220,625
2022-01-20 20:08:09-05:00,3837,5BjBPqumCb9KC82ZNNch3dcRzbpGdRLJneru7o9a1D9R,FuZtBWKktxFu4yoiLVMzxq8fMhQyN8SGzGPz49xs3m6P,True,74598254,18649563,116409,58204,58205,DddJ7EWCmYEEZETCBNgAUSg81Ls6fZtiAaY5ekJ5sXx1,4656367,41068225,-36411858,624
2022-01-20 20:08:09-05:00,3838,DiPSJvnnEwg1En7HJfEsKrUbBgtUf4KzGMyMCZDQSYgp,s8UVC6vPBofuXUS6RW1aQmZ8C35PrC5r4A6ugmvzLGB,True,984770,246192,1536,768,768,3zqXX6kzhkbW3d4TwD2CNjMRwxTbREXySekvq37kfCNk,61455,322539,-261084,624
2022-01-20 20:08:15-05:00,3839,3zH1b58jqbNU37y9kDTZZrotSeT8XzS1tuyAHPKWrbah,4trxDWV16x6sVcz7bxHehYHkjjyKebh3S9fyJf8txzK5,True,3828,957,5,2,3,3zqXX6kzhkbW3d4TwD2CNjMRwxTbREXySekvq37kfCNk,235,1760,-1525,613
2022-01-20 20:08:15-05:00,3840,3g1debT8Z2efQPuMNSDPUNZzDqarBG2acErsZ4HP7QGA,42wDHagxr5Nno3mUx6kyYGDjwR98aedRbh3ByB468agB,True,9565,2391,14,7,7,3zqXX6kzhkbW3d4TwD2CNjMRwxTbREXySekvq37kfCNk,594,4492,-3898,621
2022-01-20 20:08:15-05:00,3841,EuvK7bsc3hbxqeJjJkLELCvS7kruCMAGDctn5u7Q7BnP,Dv4XTdwnp6Sv5zxkSwRwsdSzxApDtBr4A13x4vvzTVjm,True,26339737,6584934,40426,20213,20213,DddJ7EWCmYEEZETCBNgAUSg81Ls6fZtiAaY5ekJ5sXx1,1617069,12777345,-11160276,613
2022-01-20 20:08:16-05:00,3842,2ce2v2TCbjNH635NgbwTG3sqiRWYrRRaBpxPxBZJ929q,9cnoebT43FkWDFhidndGCVNiFD4NErv8DuL1Va4Jv9S8,True,3042558,760639,4683,2341,2342,DddJ7EWCmYEEZETCBNgAUSg81Ls6fZtiAaY5ekJ5sXx1,187331,2543728,-2356397,615
2022-01-20 20:08:16-05:00,3843,93ho4cgnpAJiJsG6uu2udkLVNU7rkz4QjCYfsqvpbPA5,45ouQn9gGwXqnTGfaP5CvU8fCKadBRA5kPwtfvJzykRU,True,32085495,8021373,49637,24818,24819,DddJ7EWCmYEEZETCBNgAUSg81Ls6fZtiAaY5ekJ5sXx1,1985487,13129193,-11143706,618
2022-01-20 20:08:16-05:00,3844,87R8o8xLjHw2GpunYkm7pX7uJ8hjM4B1y4Qm7aQf6Yh4,48aSVPQoFYdncF5NtJ114urbdTzVjTgYLgPzMfpJbZB3,True,32319211,8079802,49998,24999,24999,3zqXX6kzhkbW3d4TwD2CNjMRwxTbREXySekvq37kfCNk,1999936,32329009,-30329073,618
2022-01-20 20:08:16-05:00,3845,AQr9mVmcXCNQhBVCfx63MwR6c4WqDSC9K2BZqr7N8LCx,CB7TWUaL381ounsLw6neAUaKRxJL9P1HC9uGX5e1Uxod,True,290991268,72747817,452136,226068,226068,3zqXX6kzhkbW3d4TwD2CNjMRwxTbREXySekvq37kfCNk,18085452,211223758,-193138306,621
2022-01-20 20:08:16-05:00,3846,9gYrMXAGmGSV4VFjXzYP5WwH2aFpB1TxA6CqpYsosKLv,Dh8aH6RK48wu4fkT9xKw5XL7itxnPDuw3SDwPwvL5sva,True,13392,3348,20,10,10,4BnQKPLuE3DMTtxp8MjUBytgnhvxqq3ZTqZHTVZo4JJh,828,6253,-5425,618
2022-01-20 20:08:16-05:00,3847,2kqN3TbCDgM4x8XfZvKgqJvDAHqvZxtT89NcfmQSQa5b,8fEx56PjuPAP61CBnrsnnnQnZmt8cw6KVjhYDK1mWJzP,True,288438169,72109542,448402,224201,224201,3zqXX6kzhkbW3d4TwD2CNjMRwxTbREXySekvq37kfCNk,17936093,66084100,-48148007,621
2022-01-20 20:08:17-05:00,3848,4FazDUgfQ3AKoFcnWHr8E9Ht8jLA3tkxf75yrGZVHdmF,HzRMH6mbgEKydRCnnMvSsKgTEVNQi6nuzoR1xutYFdzg,True,30997,7749,47,23,24,DddJ7EWCmYEEZETCBNgAUSg81Ls6fZtiAaY5ekJ5sXx1,1917,24337,-22420,618
2022-01-20 20:08:17-05:00,3849,7MSzV5yy5FmrM4j1BcYSRiTGWfit1AJahheRUaXzz349,aPSTZLxBpVr3sucjbj95emRV2J1GrUWr7wbARYqJkQZ,True,2251687,562921,3479,1739,1740,4BnQKPLuE3DMTtxp8MjUBytgnhvxqq3ZTqZHTVZo4JJh,139195,894907,-755712,618
2022-01-20 20:08:17-05:00,3850,E9FFPvygPSF22u7gqFq4w6yE5kV15zbeGDXFQc349RsG,yi1REPVUwKhr5ss5YJc56crYz8LVfkqNVMpKcdSfwfY,True,844658,211164,1308,654,654,DddJ7EWCmYEEZETCBNgAUSg81Ls6fZtiAaY5ekJ5sXx1,52347,275565,-223218,619
2022-01-20 20:08:17-05:00,3851,ioPHEVyheRnHYomVS7PmP6Coyhjk6LCs7hMD5Mq9Ngv,DYTpFmZ4yXVghKwkaovgCdpv3jfWkjtXRzxsZjKJfXNN,True,12154,3038,18,9,9,DddJ7EWCmYEEZETCBNgAUSg81Ls6fZtiAaY5ekJ5sXx1,755,5721,-4966,621
2022-01-20 20:08:18-05:00,3852,9LZ3rShLfzErXsGkh4dYfAm58GNPWhK6ohDy5RrLJhc,41tLyuvuJ5M7YctkSASD2R7RGGetD7FmKaZUdkTdgXgt,True,731415,182853,1140,570,570,4BnQKPLuE3DMTtxp8MjUBytgnhvxqq3ZTqZHTVZo4JJh,45627,239705,-194078,623
2022-01-20 20:08:18-05:00,3853,ECuu1L4QGdemZ7FjAjVAAxYN6piinweY7Fuk5csVovfT,Amd8WGcpdtB8yoA83R1BUT5uryuqoKbcBexYacbrbGVX,True,1543382,385845,2406,1203,1203,DddJ7EWCmYEEZETCBNgAUSg81Ls6fZtiAaY5ekJ5sXx1,96246,656605,-560359,623
2022-01-20 20:08:28-05:00,3854,6osqTNxgZv1Y1EjnVR7D1G4cywof1CrWswj87tAnktWV,Fah93R9W7SFuajFif4AbXDdxouWA5rrLz29vzVRGsMxv,True,6312651,1578162,9865,4932,4933,3zqXX6kzhkbW3d4TwD2CNjMRwxTbREXySekvq37kfCNk,394630,5894482,-5499852,625
2022-01-20 20:08:37-05:00,3855,6d6HN8LWikwW2HYdy3BABWuxKHt1sgv4DcneACR133sE,4eKvzmfFvX96XbujKBhUauAvWP4yQYwZH3pd7gXzbCvJ,True,843609,210902,1318,659,659,DddJ7EWCmYEEZETCBNgAUSg81Ls6fZtiAaY5ekJ5sXx1,52745,277012,-224267,625
2022-01-20 20:08:50-05:00,3856,2bikYf33ZxxDmvkMNjWDGGqEpbYJPvWv5At3hzyeLEQK,5FtirUBjRAZ3k5arFFVwKz42ixWzhkEBLkaK9PraRZ78,True,74007,18501,115,57,58,3zqXX6kzhkbW3d4TwD2CNjMRwxTbREXySekvq37kfCNk,4629,29739,-25110,625
2022-01-20 20:08:51-05:00,3857,7g4NJBHwDTRm58GqX7Tz1JzqwbAhF6EWJUQH3SoDxSf7,82Ypv7STZeSCBPf3HckWdyatELpvaDaWxFXhD5dNSML4,True,11755,2938,18,9,9,DddJ7EWCmYEEZETCBNgAUSg81Ls6fZtiAaY5ekJ5sXx1,735,5541,-4806,625
2022-01-20 20:08:51-05:00,3858,HhwiZPKZBGa16oVi739s4qtMDMTwzWXc7iwNfX63t2UP,5AnbMbAFKy85yHt5y2M5S38nNkA1vT4ejY5NjGbRNUqn,True,699116,174779,1092,546,546,HfEnetJ7uBSmZWCjBNxdvv9HEC5nsW4wDV7wu6WnhWan,43704,472031,-428327,625
2022-01-20 20:08:54-05:00,3859,921FBgLS3A1wA77uWitsnTvW737Q2jY7tzvgWtWLXNC7,E4eJ9H7cqP9zNpMH5xRBTAp9yaBCBihuJBNd6pqzteDG,True,73981,18495,115,57,58,3zqXX6kzhkbW3d4TwD2CNjMRwxTbREXySekvq37kfCNk,4611,29746,-25135,623
2022-01-20 20:08:57-05:00,3860,DJiXXW7sjNsAAxWupDKBUsFhXSgPoerVYaAtJqqNgVbn,2MsqvNuJw1xQhJ3UnXt9i7oNHDuZpR9w7iE1WQcGqt5m,True,73971,18492,114,57,57,3zqXX6kzhkbW3d4TwD2CNjMRwxTbREXySekvq37kfCNk,4597,29741,-25144,621
2022-01-20 20:08:57-05:00,3861,2p2fGXdKrmxjomLSnyaNg84J82cBBBNympZ6qQc8UZgU,HKAM8bazuLMUY6yapZJqYsgaWkTBqKHyMs1hSfpYsZGi,True,409817314,102454328,636455,318227,318228,3zqXX6kzhkbW3d4TwD2CNjMRwxTbREXySekvq37kfCNk,25458208,236794677,-211336469,621
2022-01-20 20:08:59-05:00,3862,7W6ih2ZGXaE6tvuQFUPCvc7NvEJHy7UffgoVX3ZPdLXt,6uQCkeMjEXHBQxE2HD33RM1zyTsSko1fYZA1mWUggJ5B,True,12984,3246,20,10,10,3uL2NSR2ZdDqCiKfzA5SwwpddAnit22DBJo6uvvz1rRs,810,6288,-5478,623
2022-01-20 20:08:59-05:00,3863,FLTW9fwjWqGPm5PiE3C9LFzwZxtDh8c2MnEoRq8W7MfQ,GKsfzKBP2QkmoEWvTaUN1h4nqrT3kAcwYRC9WxW9bB3h,True,6224560,1556140,9672,4836,4836,DddJ7EWCmYEEZETCBNgAUSg81Ls6fZtiAaY5ekJ5sXx1,386884,2504068,-2117184,621
2022-01-20 20:09:00-05:00,3864,6gFbxvPafnpqZjWW94MMmL8mGp2FHZGqoJC5fWqgwNxS,C6WcDycp3Ff3xYmb81i8JbD39Xv1o5G2AdtPs1FdXtr4,True,1162050735,290512683,1804352,902176,902176,DddJ7EWCmYEEZETCBNgAUSg81Ls6fZtiAaY5ekJ5sXx1,72174097,259983262,-187809165,621
2022-01-20 20:09:01-05:00,3865,duKo8riX1qpX1K1qpgwZniMtUeWqu2eYgchTu5n7Rbu,9vAVwfVtdsaZMbeZvoymjHqwASeuM38gfEJkbTVwDqya,True,33819652,8454913,52643,26321,26322,4BnQKPLuE3DMTtxp8MjUBytgnhvxqq3ZTqZHTVZo4JJh,2105747,15531371,-13425624,622
2022-01-20 20:09:02-05:00,3866,4kbcrzH6o2LvLUCNphyL52i8uGzVD8wcUNEqoQ14z3VG,5Q1atmEBs2AqaDZsiZFG5stHzj1fE6ZvypgfkEc9LYqE,True,90018808,22504702,140696,70348,70348,DddJ7EWCmYEEZETCBNgAUSg81Ls6fZtiAaY5ekJ5sXx1,5627875,55535943,-49908068,625
2022-01-20 20:09:02-05:00,3867,CCHzYXr5zMXFu8MMZNkfUWGyUcF8xy7Vvhq7tNCtZg2L,AuEXkCJTTJ3HK8iP4qTWpQr4vp6HPRJZyZwfRjF8zjfp,True,73959,18489,114,57,57,3uL2NSR2ZdDqCiKfzA5SwwpddAnit22DBJo6uvvz1rRs,4592,29749,-25157,620
2022-01-20 20:09:03-05:00,3868,BPRoaqrDs8vhqv2T7d9qV2oPU33pi1K1LUaotM7yuD2i,6qo8uQGAEwBfYQR36v6nRiqA2xGV6SjJAsXsdzy5bqNH,True,522932402,130733100,809274,404637,404637,3uL2NSR2ZdDqCiKfzA5SwwpddAnit22DBJo6uvvz1rRs,32370965,268845195,-236474230,619
2022-01-20 20:09:10-05:00,3869,HkRKcvAWLM5sCDL6a5DvYsH55bg5BnZnyP9WwX7wLUDF,GXtDJS8BCoZKnvviGaUb2QfKs2LQQZPMa9564tf5Jq8Y,True,770256660,192564165,1201952,600976,600976,3zqXX6kzhkbW3d4TwD2CNjMRwxTbREXySekvq37kfCNk,48078112,208191483,-160113371,624
2022-01-20 20:09:30-05:00,3870,GH6Q9E1jZPTTp46aDd57UNZPNS2D6PBSwyLL3EHSjGn2,2XvwZXNsrPWx4EfPvhTP933bzCC3SJHDQ8xARfrXdVY9,True,9958704,2489676,15556,7778,7778,3zqXX6kzhkbW3d4TwD2CNjMRwxTbREXySekvq37kfCNk,622279,9204967,-8582688,624
2022-01-20 20:09:31-05:00,3871,GWkVXmZNQdcdWNNu8dvRqct4aMhLoDNqijrTvxbfEdKN,6LKRNbJv2XkyjJQKCFAqFRPzvANrRBSTmu8doRWqTicU,True,54725535,13681383,85192,42596,42596,3zqXX6kzhkbW3d4TwD2CNjMRwxTbREXySekvq37kfCNk,3407719,13399728,-9992009,622
2022-01-20 20:09:34-05:00,3872,4D7mDXe7SdmbAx7kaD1mBNuEa7DzMi6TAwXURxtLEazk,5pSnT91PHoLdN6uhPnUtoD7cboLmndn26y1XouPx8vwW,True,747900,186975,1166,583,583,3zqXX6kzhkbW3d4TwD2CNjMRwxTbREXySekvq37kfCNk,46656,299689,-253033,623
2022-01-20 20:09:41-05:00,3873,AA9zFZTXqBR8Mw1fwEH59edzBiswoGasRNWsi6aLeysB,4VeitxYqqtRxyfdSVpshdJ3EDcgksRVnaHvAqWxTeujH,True,857277,214319,1337,668,669,3zqXX6kzhkbW3d4TwD2CNjMRwxTbREXySekvq37kfCNk,53506,281902,-228396,624
2022-01-20 20:09:44-05:00,3874,EeztHR1M4PPacJEZ6c5arCRVCuu8aN7eGdpY1u4bev79,9Twdc9Xrzv2oeJ9Fbd8mRvzjbFi7mkGopFS37SMabeAK,True,89515485,22378871,139461,69730,69731,DddJ7EWCmYEEZETCBNgAUSg81Ls6fZtiAaY5ekJ5sXx1,5578465,33404835,-27826370,623
2022-01-20 20:09:50-05:00,3875,FpqCxvTkSiwDwD5qEt6hXJxzFDLFLAQ8VevK8zwRqYun,A3p6YQisCJKpNkF7vkjZRbEfbnUt7vTZdR2zPBUSdTkk,True,206870506,51717626,323052,161526,161526,3zqXX6kzhkbW3d4TwD2CNjMRwxTbREXySekvq37kfCNk,12922091,87656690,-74734599,624
2022-01-20 20:09:57-05:00,3876,AGhvB6x3gmvAJSnr9UVtvhKqVg3Qgh1k4roHzrNHhAaa,HhhjXT6WJnz1HQfHcwKdBppuAhc8ncUcq1mkJ4EHqgpe,True,3182,795,4,2,2,3uL2NSR2ZdDqCiKfzA5SwwpddAnit22DBJo6uvvz1rRs,197,1557,-1360,619
2022-01-20 20:09:58-05:00,3877,DAku12iueL13vRoTpKLyqdGaLQ2rWF6REe8Dr8soFvNs,H2vVH3LxkhGe6x6Mdwy67BYwTKNQM6XayKx7mhrwyfJM,True,224645,56161,349,174,175,DddJ7EWCmYEEZETCBNgAUSg81Ls6fZtiAaY5ekJ5sXx1,13964,127204,-113240,621
2022-01-20 20:09:58-05:00,3878,5nauZoaxftcYR591YH4v52myeJLnXtY4okdttL9qSdkg,7x3G299D3bC7EwUQojhTXUv29BG4NGzrLbgS4mEyqG5r,True,232987390,58246847,362428,181214,181214,DddJ7EWCmYEEZETCBNgAUSg81Ls6fZtiAaY5ekJ5sXx1,14497152,62727877,-48230725,622
2022-01-20 20:09:58-05:00,3879,ES1MDwRUa3hoToPKQiiZkzMYe9PDVnAQwMrEvZrzvnc1,C4wBG3xTDkmDQneB28xYnf1aBNEeq7UB8oR7NuEfLkFg,True,13868082,3467020,21616,10808,10808,4BnQKPLuE3DMTtxp8MjUBytgnhvxqq3ZTqZHTVZo4JJh,864677,5557621,-4692944,623
2022-01-20 20:09:58-05:00,3880,5jin5wXjQQ25nGM2ECrCXcg1a95vquh6kM7rMRru6Ke7,EKM657EQ8HWWgf4cssByoYHoXGjFfTspTKXAGmygAPQG,True,18943693,4735923,29442,14721,14721,3uL2NSR2ZdDqCiKfzA5SwwpddAnit22DBJo6uvvz1rRs,1177692,10473774,-9296082,621
2022-01-20 20:09:58-05:00,3881,8NdcaYUC1X5CP7FMDip78uqtqmCt8GcZdCzLRTYTihmb,9Ei1K9bXWXSXcBfeX5exPSXGCAu62WSKzvnnd4wHvyVh,True,66189,16547,103,51,52,4BnQKPLuE3DMTtxp8MjUBytgnhvxqq3ZTqZHTVZo4JJh,4139,32965,-28826,625
2022-01-20 20:09:59-05:00,3882,5RvNKzSeJ1fvqsKpcQu25evEZGmKjyEDgwsMZkykoT3P,BRqSGfE4XHXu4HrinwetWumfVTmr82iuF6Y5oSV6eMiK,True,73889,18472,115,57,58,3zqXX6kzhkbW3d4TwD2CNjMRwxTbREXySekvq37kfCNk,4614,29841,-25227,624
2022-01-20 20:09:59-05:00,3883,3njiRuSRMXRzKmamyiR72Hc38PU8UDDmWdfPhgxmGxEW,5WoF3gkgygyNNbwxWgVfqGWkExcDixuzgJQQjXEZQ6J5,True,128490440,32122610,200210,100105,100105,3zqXX6kzhkbW3d4TwD2CNjMRwxTbREXySekvq37kfCNk,8008400,97511894,-89503494,623
2022-01-20 20:10:06-05:00,3884,LNX7AwwiGpuaXA4J86d1xqqtF6kD7qbCusssSZqtpKd,45a5FGVssw2NoGipB7NRN4XDLPob4GHNxSM9fqgsTpqA,True,435455385,108863846,680656,340328,340328,3zqXX6kzhkbW3d4TwD2CNjMRwxTbREXySekvq37kfCNk,27226247,106776077,-79549830,625
2022-01-20 20:10:07-05:00,3885,AM5fwZR9BUW8AFkhdGWXW4PHd2cy8ora63kDf2z2eknw,E7ru6hg4MchnRG5zcr5YazwX8Snt55r5Xq9zCHCGaYZT,True,481314,120328,752,376,376,3zqXX6kzhkbW3d4TwD2CNjMRwxTbREXySekvq37kfCNk,30105,260636,-230531,625
2022-01-20 20:10:07-05:00,3886,C2Dmfw4G8KKzFq38aRH2pLCRngnGZDvUUN3fHDMjFkoG,7kzJk3BTNvY3hGFNj7nDy9L5CAYus6eNiCAxWH8dSioX,True,186933,46733,291,145,146,4BnQKPLuE3DMTtxp8MjUBytgnhvxqq3ZTqZHTVZo4JJh,11676,125666,-113990,624
2022-01-20 20:10:09-05:00,3887,2FrqGFZjbiNykJyo9BZ5S9FguQJPJiTi681rJJsQ5dta,3QUncYP92NKrfpaTvuF9iQg11PXKgZAgEngwh6BbnCCj,True,415969,103992,648,324,324,3zqXX6kzhkbW3d4TwD2CNjMRwxTbREXySekvq37kfCNk,25929,196436,-170507,623
2022-01-20 20:10:28-05:00,3888,6xikA6d7sjCBnSfqkFwrL4nPrtQUNWdRhXB7i1AccnxC,G8t7u2R9qjRfdTdULs74v3nVrTM2WeKvc4dK4FFAvuG1,True,18856137,4714034,29340,14670,14670,3zqXX6kzhkbW3d4TwD2CNjMRwxTbREXySekvq37kfCNk,1173611,5242185,-4068574,622
2022-01-20 20:10:28-05:00,3889,6u6bPgAmK8ufACrQV99A1Y5nhGkue3KEUHmQQkcNkxwP,7636yXT5w4DcVpc7LJdN46aiggzSq6U2GXHXL5kyy9F3,True,59709938,14927484,92994,46497,46497,HfEnetJ7uBSmZWCjBNxdvv9HEC5nsW4wDV7wu6WnhWan,3719770,32971894,-29252124,622
2022-01-20 20:10:28-05:00,3890,BAczoNDnbwj5AJX5LwzynzYab7ji7VbhRy9edA9Prax,34sbkUKnMetUNyMs6BhiWut85d5UZtBWnPtwx8jEpJNA,True,654315,163578,1016,508,508,3zqXX6kzhkbW3d4TwD2CNjMRwxTbREXySekvq37kfCNk,40666,335477,-294811,621
2022-01-20 20:10:28-05:00,3891,6dr65yANjSMmfBeKAuSxG3i16S9vMgF1CQ3zDyzh55Pn,EhrE5QpnshD41S4zPEBy2A5q2Gs2mwUrbHGo6WnT9zDP,True,168410,42102,261,130,131,3zqXX6kzhkbW3d4TwD2CNjMRwxTbREXySekvq37kfCNk,10472,95477,-85005,621
2022-01-20 20:10:28-05:00,3892,GGGyesjbt7h2XHHp9u8vpiWGugFwEbrtYaKrNQSDhQd7,8tydo1ZjGHmPBSqU33tywB3f9szdsHk1ckGFe4Ay5pgs,True,25409948,6352487,39462,19731,19731,3zqXX6kzhkbW3d4TwD2CNjMRwxTbREXySekvq37kfCNk,1578500,21050248,-19471748,621
2022-01-20 20:10:29-05:00,3893,Ayx8dFsVzUBb9b7QKxw7YHJuhptdSitBXFEczXTaxe85,EvU1VLChnowi6ccSPeJRSk65njrqZfYouAN7SHePxsxf,True,11777,2944,18,9,9,4BnQKPLuE3DMTtxp8MjUBytgnhvxqq3ZTqZHTVZo4JJh,734,6694,-5960,623
2022-01-20 20:10:32-05:00,3894,3Lv2XpiD4KBUHq7Zx6u3zNhpXoySodXHH8o8f5yaaPxG,H6TN4rhpBXkEH3mZnymYNcKfmnxRH2uzfwzeLH2q6ahP,True,94006,23501,146,73,73,3uL2NSR2ZdDqCiKfzA5SwwpddAnit22DBJo6uvvz1rRs,5862,46364,-40502,623
2022-01-20 20:10:32-05:00,3895,2QStaRnbSnDhA891Lb1bxjVeMYpJUpNdqaVkw3rqU45V,DakRWPnttPoRcjY5V7WLwiwBx39BapCo9Atog8dL17Ku,True,1139796,284949,1776,888,888,3uL2NSR2ZdDqCiKfzA5SwwpddAnit22DBJo6uvvz1rRs,71056,432957,-361901,623
2022-01-20 20:10:33-05:00,3896,8hpAXzimCw2bTwLXoRFAbqNW8qoj5VV3JDYCuJwqHpHm,DkfsL2M7oRBX6grAfy15C4urwL6ToMJ7TWJEFAGhWjYX,True,4656751,1164187,7273,3636,3637,3zqXX6kzhkbW3d4TwD2CNjMRwxTbREXySekvq37kfCNk,290957,1253584,-962627,624
2022-01-20 20:10:33-05:00,3897,AHm7zF4rpaxaayBLn5QDHgJSp8KAr647s4cNvQ9wLgd7,FDM33WngED24pukBvSDpPAzinW6afVAeGReum5nyLRiC,True,416969,104242,652,326,326,3zqXX6kzhkbW3d4TwD2CNjMRwxTbREXySekvq37kfCNk,26088,237148,-211060,625
2022-01-20 20:10:33-05:00,3898,6CeKxTJvFqhyNEyzySiBBKEwYVMe7j3A6nkMes4BW6o2,DzDR9XvwY1z7ygQ8YrCXrwDGHSf67JZF8BzUnuFE2fxQ,True,2203084,550771,3437,1718,1719,3zqXX6kzhkbW3d4TwD2CNjMRwxTbREXySekvq37kfCNk,137490,937049,-799559,624
2022-01-20 20:10:34-05:00,3899,8VnGmfop6qcUezAJ2M15jz2Nn6mPQgehDcJPvypq4XJn,6F6sqXNhgkW9ev8QNMm4ydywUUmemhwgydRQYNeqyUmi,True,5329724,1332431,8322,4161,4161,3zqXX6kzhkbW3d4TwD2CNjMRwxTbREXySekvq37kfCNk,332882,5014472,-4681590,624
2022-01-20 20:10:36-05:00,3900,F2v1YwVAwXLiUgsJ5uwn4qAAkTXitn1E75fJcPnGuAcy,5rdJ4H5GxPg4Juu77mGc7uya5LwEqLzDSRyG8mQ2mDbK,True,9707478,2426869,15167,7583,7584,3zqXX6kzhkbW3d4TwD2CNjMRwxTbREXySekvq37kfCNk,606704,5351195,-4744491,624
2022-01-20 20:10:36-05:00,3901,Ftuj53jKP3Z8mvuTE1CEypdw2eZrCn5x8ktMWRdJo2gU,9JNUFRLrPNAh3DgKvMdaNvLCAeUtiS9FGWmDcMvcSe7J,True,128486146,32121536,200629,100314,100315,3zqXX6kzhkbW3d4TwD2CNjMRwxTbREXySekvq37kfCNk,8025162,53456223,-45431061,624
2022-01-20 20:11:08-05:00,3902,Fd2HrzBAr4JobRPARZwpQHHVoSCEoog32A6tKMWAC1sK,BYappsar5sQf8VLem4wrLuTtrDFH9y8pEx1aMxfuU4Pq,True,15153980,3788495,23682,11841,11841,4BnQKPLuE3DMTtxp8MjUBytgnhvxqq3ZTqZHTVZo4JJh,947317,8356416,-7409099,625
2022-01-20 20:11:19-05:00,3903,6yw4GPvkqUbakcEWtqSCfjVLukty11xqjDpGxtEN9Km2,5ppEx7wkpqbG5nApCWMdRja3oRSheFmAAsNHUX7h2w2Y,True,831001,207750,1298,649,649,3zqXX6kzhkbW3d4TwD2CNjMRwxTbREXySekvq37kfCNk,51955,795710,-743755,625
2022-01-20 20:11:24-05:00,3904,5SskSWkRPP5BNaqvHkJCbTAgHPUkHEwFh5pFr4t8PoBr,EqdX8Sdm9LCfdrzVKzisKaFcP2YEdSRNZYmev5RWjGqb,True,1971168,492792,3078,1539,1539,3uL2NSR2ZdDqCiKfzA5SwwpddAnit22DBJo6uvvz1rRs,123133,542350,-419217,624
2022-01-20 20:11:39-05:00,3905,WMUVFELv3C3KdMKJ5ZL4rG7o1YrV1qTP6Mmp2S5Rp8S,7UNzS3zDqT1oeq9a7eJGU8cgf8eUzEAZubSBQvNmK6uJ,True,9123800,2280950,14204,7102,7102,DddJ7EWCmYEEZETCBNgAUSg81Ls6fZtiAaY5ekJ5sXx1,568186,2321600,-1753414,622
2022-01-20 20:11:39-05:00,3906,6tFQaTqqffino9kwMZTL2xVNBG8k9VREFhXqVi2si3A3,3w3wGxBbS4bmXeqmvd595SAWFeXekVpnH4UdbeEs8Sx5,True,2203312,550828,3403,1701,1702,3zqXX6kzhkbW3d4TwD2CNjMRwxTbREXySekvq37kfCNk,136145,935477,-799332,617
2022-01-20 20:11:39-05:00,3907,E8ifvhmyJGBGVQomo3AnZw2UcaLHcpGsTtuoCid8voU3,FMQUWTbTAfSLfrc6GTrz4DM2ZSgoxF3KtqGn8AyjVtsf,True,3578775,894693,5598,2799,2799,DddJ7EWCmYEEZETCBNgAUSg81Ls6fZtiAaY5ekJ5sXx1,223937,1498183,-1274246,625
2022-01-20 20:11:40-05:00,3908,7jvKp6onXyWgwsFrFWj4hYTXJsYYD6ot5mn6rPFuJriy,J7N6HiozevJVTiY9hDEUs2ud5BwT5QSE7wnMBS1w5ie2,True,30457397,7614348,47324,23662,23662,DddJ7EWCmYEEZETCBNgAUSg81Ls6fZtiAaY5ekJ5sXx1,1892969,16544906,-14651937,621
2022-01-20 20:11:42-05:00,3909,AATMHH4e4B6SL9bThnXGktzWuqWkPdx3JbRXk8HwkbPW,6F3u2yLx7P9gtpAAXASx7uF8xNyVBgJiKosMKUrgpicA,True,125851108,31462777,196593,98296,98297,3zqXX6kzhkbW3d4TwD2CNjMRwxTbREXySekvq37kfCNk,7863755,60419275,-52555520,624
2022-01-20 20:11:42-05:00,3910,EmGW2aAG69ssWqCtbfDocRaM2u3TJsczn2HHP9jdmRvD,aypkDKsp9uqAB4F6mwvm5LofpsrFBuZT2MMWtE2eHdB,True,324564,81141,503,251,252,3zqXX6kzhkbW3d4TwD2CNjMRwxTbREXySekvq37kfCNk,20127,170665,-150538,620
2022-01-20 20:12:02-05:00,3911,9zpPiboHF5HW7NfCx7hYdmJGwUomVMTiUFc4Um5KrDi3,8q3eBpuwV6dMNkib9N8XQAq2tBUcjSANRe5SXpd4dFhZ,True,4127924,1031981,6457,3228,3229,3zqXX6kzhkbW3d4TwD2CNjMRwxTbREXySekvq37kfCNk,258308,1635605,-1377297,625
2022-01-20 20:12:17-05:00,3912,3oCun4gm3k8sXxVxiYM8okGi8iCXH9LvDkHf9PBQWYXR,E1np1dZ7jUm811ddvy1jQerBwGSYb5BbZWnUHeotvrfH,True,214361899,53590474,334750,167375,167375,3uL2NSR2ZdDqCiKfzA5SwwpddAnit22DBJo6uvvz1rRs,13390016,48108117,-34718101,624
2022-01-20 20:12:24-05:00,3913,9UyQC8vc6zJJaSdnjvTAzgmcsw4fC3xFBBiCC1w9Sbjx,3ppBfboe6FPmt7f6WrivspMUoAznZKWQMeh3rCgw7vjQ,True,4503543,1125885,7045,3522,3523,DddJ7EWCmYEEZETCBNgAUSg81Ls6fZtiAaY5ekJ5sXx1,281809,1784451,-1502642,625
2022-01-20 20:26:36-05:00,3914,H1LftKtj94Zs6PG2A7gJt9rPurBkXkTy2hbbArQwAehi,8bANmhgdnPYa3PqdPnk5BA2xhvqJmPyaMF77mrBePJ13,True,19232,4808,29,14,15,HfEnetJ7uBSmZWCjBNxdvv9HEC5nsW4wDV7wu6WnhWan,1196,16813,-15617,621
2022-01-20 20:26:36-05:00,3915,2F45BX9mRmtNCHPejKFknN5aNgGvR4vVLFjMaY1a7dR8,ALdSutsvEFRUEQGGBbi31QywTL1pdXSDWrNJzvNTaoXL,True,12585507,3146376,19463,9731,9732,3zqXX6kzhkbW3d4TwD2CNjMRwxTbREXySekvq37kfCNk,778532,6730255,-5951723,618
2022-01-20 20:26:38-05:00,3916,pgzvXpnUYiY7hLrfjmwScqLd8oj9vYcXpFvpm4y4JvG,GdqdQgoyBAFuXdbvoZyDhB3jyqJzVo4nkGh7EPFxkBF2,True,1064306,266076,1658,829,829,DddJ7EWCmYEEZETCBNgAUSg81Ls6fZtiAaY5ekJ5sXx1,66340,1027137,-960797,623
2022-01-20 20:26:38-05:00,3917,3EmGvYu72cR4Ta3wLA5HKZBEqgfChCyiRanwj5hGLJXc,6NEWPFaKi5uLsrj4n6RM1DBhQTcGFE9TwYeJ12pC7yyp,True,20020,5005,31,15,16,HfEnetJ7uBSmZWCjBNxdvv9HEC5nsW4wDV7wu6WnhWan,1253,9487,-8234,625
2022-01-20 20:26:39-05:00,3918,J4krKPBBTMVLZRgrSeYJAMyHQs2FkNm5TXk7nQWwDB43,ASmLbfNbhTD2HHeV7qzAqiHjUx5a8Traj8oPDwbkMdFg,True,14275830,3568957,22237,11118,11119,3zqXX6kzhkbW3d4TwD2CNjMRwxTbREXySekvq37kfCNk,889484,6187767,-5298283,623
2022-01-20 20:26:39-05:00,3919,CvZssqscu2dm35mwcE3zg9zedavbRjVJjWD59Py5ExUK,7pXaoR6aHKYofCmg1eHipygNYDteEaf8rbbS8BDYGQK6,True,353311,88327,551,275,276,3zqXX6kzhkbW3d4TwD2CNjMRwxTbREXySekvq37kfCNk,22068,150343,-128275,624
2022-01-20 20:36:48-05:00,3920,67Z7ZGhNu5xxEh9BYKWcXp9m1T4tFiE1o1M16hCzUWQA,CT7YKWixz7BhTbvg5F6M5HCyPGnHoFLNFuDV9GhoLTo3,True,1639539,409884,2553,1276,1277,DddJ7EWCmYEEZETCBNgAUSg81Ls6fZtiAaY5ekJ5sXx1,102140,1055719,-953579,622
2022-01-20 20:36:48-05:00,3921,51yPLtXTgL9oLKs1cCf5TjL54Ld5vuVxat2NNtwZVsZG,7UjtM7Z1tiXEQMMiorQyncgi9SKu3v46DhVdgXbWqSiF,True,179000919,44750229,278836,139418,139418,DddJ7EWCmYEEZETCBNgAUSg81Ls6fZtiAaY5ekJ5sXx1,11153475,166427395,-155273920,623
2022-01-20 20:36:49-05:00,3922,ApAgbKGyEYXRonGM33w56ZxHQNAGSd9ji4K3zAGN2yA8,FZAhAUDtEaNsFmh4fP8uXNjoHneNkpZ2wQCfEeU4RYRM,True,50988899,12747224,79719,39859,39860,3zqXX6kzhkbW3d4TwD2CNjMRwxTbREXySekvq37kfCNk,3188779,21942880,-18754101,625
2022-01-20 20:36:58-05:00,3923,HcGtTcpuxex2eQyz6GjJHrjDgThU2ZWSjjnzNEf7tNXy,XuFuE8RxTusW8BYDczgzvWrD5YbDseACo2edd2K4tVv,True,40026,10006,62,31,31,3zqXX6kzhkbW3d4TwD2CNjMRwxTbREXySekvq37kfCNk,2503,13440,-10937,625
2022-01-20 20:37:24-05:00,3924,6nJyqvFKprwaVCE1gAa2P4RHKc6Pa6XFSJymx654zZ9K,4e7iJmdwzAPxp1Zi8Azo38YyPQdPKqqY4VLJyQ5rpdYP,True,1257304,314326,1965,982,983,4BnQKPLuE3DMTtxp8MjUBytgnhvxqq3ZTqZHTVZo4JJh,78618,724416,-645798,625
2022-01-20 20:37:34-05:00,3925,CRaKcudjkQiSw5YPVjTLVdXvJskeGiHSYtq5ZcMPJhgQ,AgqTg3b3bAcaBmRidhNC4Uf9ZwNbeH52RQEqumWyuUs7,True,436971,109242,683,341,342,3zqXX6kzhkbW3d4TwD2CNjMRwxTbREXySekvq37kfCNk,27324,295005,-267681,625
2022-01-20 20:37:56-05:00,3926,3VYtHvoT9wi4K1PBjg6JjCf6U9fVPDf6tX9jyRRvLxcg,Ba5fjpVyAxLbiP6hYJmrxzougi7JUEDfDLKBxSbbTL7q,True,226930385,56732596,354051,177025,177026,4BnQKPLuE3DMTtxp8MjUBytgnhvxqq3ZTqZHTVZo4JJh,14162069,55943391,-41781322,624
2022-01-20 20:38:03-05:00,3927,72woixtGAuGazCMfsYfYBYLP7FuRj8Fwz9fynFo4MCE4,5237BmWkKf58PBeTUEiu3Ld5uKXEe8wcrJRmCnUoWWku,True,674187985,168546996,1051175,525587,525588,3zqXX6kzhkbW3d4TwD2CNjMRwxTbREXySekvq37kfCNk,42047014,162134082,-120087068,623
2022-01-20 20:38:06-05:00,3928,DGAQzgZhS2yioeZmG3cbacM3hdz4F1aZn1PWRwgiFukc,48KUtJaNCPNxkLXJBtWAdDxY4b9vZzLgbGxTNdwMqmjz,True,263622982,65905745,409674,204837,204837,3zqXX6kzhkbW3d4TwD2CNjMRwxTbREXySekvq37kfCNk,16386986,138249539,-121862553,621
2022-01-20 20:38:13-05:00,3929,DdYgcyV1T2CDYiQVr4VL9Ym8RdKm93a7SKy8HxuyaoMW,GPdAeqeXb1UJ56AttcwwY1CyFhRyfptDC4BAX2Tc8MpE,True,265144,66286,413,206,207,3zqXX6kzhkbW3d4TwD2CNjMRwxTbREXySekvq37kfCNk,16535,151806,-135271,623
2022-01-20 20:38:15-05:00,3930,4cKgCTttVp8pzJnp43PP7uLLUXNcU7YGPJ3cCGHaUFe7,BBQqjwTpVEgpDzMk4wDDH8rCjaSxCRPWVhtFxERSujTD,True,20404360,5101090,31763,15881,15882,3zqXX6kzhkbW3d4TwD2CNjMRwxTbREXySekvq37kfCNk,1270557,9972664,-8702107,622
2022-01-20 20:38:19-05:00,3931,o2aCmkxsxSiyUX8soTEjwUCbJeXmCZsEaf8CWwxDT5n,3pvS2bTsUuiQyqZp5rdnTpq4cqWGgtv4E5rN9HsBxpRt,True,12052,3013,18,9,9,3uL2NSR2ZdDqCiKfzA5SwwpddAnit22DBJo6uvvz1rRs,752,4153,-3401,623
2022-01-20 20:38:40-05:00,3932,9WJBnVi84E926j7xEd566WzrZJkPJWRgmEnYj9vyjuad,4dLaFS5F7TGyLdwuJLMGkz3bSL53aHzd9ZfpNmhHxXeF,True,14835167,3708791,22917,11458,11459,3zqXX6kzhkbW3d4TwD2CNjMRwxTbREXySekvq37kfCNk,916712,7674816,-6758104,617
2022-01-20 20:38:58-05:00,3933,J3ggP7ZxL8HRh3CBp5iYG2WgjLyNSAWYT46uC9VYDLCz,2FqTRiRPiLvdAH2BS5vroVntpsSXvTJEn5UHWmtKHzh9,True,28373814,7093453,44059,22029,22030,3zqXX6kzhkbW3d4TwD2CNjMRwxTbREXySekvq37kfCNk,1762398,9294236,-7531838,621
2022-01-20 20:39:14-05:00,3934,8E3K7vCHJ2xjdFofPRGLbMxrkm8UYEi926QmXPAFwsqe,4qHUDA1c43Dg4qi1ZPKqmpGYiEMUZ6r4UuzB5ftHCEhW,True,1369439434,342359858,2139418,1069709,1069709,3zqXX6kzhkbW3d4TwD2CNjMRwxTbREXySekvq37kfCNk,85576733,718088034,-632511301,624
2022-01-20 20:39:43-05:00,3935,HVZkXeDR3mc8oB9qFFwCK4RXpPojdcHk9tRGep6xtKGK,Bh3py7awPejWqeTMxtAgF7mPotL2Asxf8YrYJykq9nBt,True,3321877,830469,5168,2584,2584,HfEnetJ7uBSmZWCjBNxdvv9HEC5nsW4wDV7wu6WnhWan,206747,1636686,-1429939,622
2022-01-20 20:39:45-05:00,3936,CagSUfZLwXuCdypC4KzU6FSNdmCj9dKDroPcNeaRtsyt,yxw5d1ztZuEUY2QjL7eLpr72QJAj5rJd6ERvg91cy1m,True,814952,203738,1270,635,635,3zqXX6kzhkbW3d4TwD2CNjMRwxTbREXySekvq37kfCNk,50827,361582,-310755,623
2022-01-20 20:39:45-05:00,3937,2s9VGesQYbKr3LwuraMEa9sXbXz7f8299HPPAHgSaUdp,8uMS2GDsbmygjbRnc2gjwNkXKogmJX1i8nchmqt8ixCe,True,22534464326,5633616081,34648573,17324286,17324287,3zqXX6kzhkbW3d4TwD2CNjMRwxTbREXySekvq37kfCNk,1385942937,11203468381,-9817525444,615
2022-01-20 20:39:45-05:00,3938,5sN3cfz4hZjwy2HkAStKWeL8wHhdbkW8F7USzwCzmggh,Fme7U7QY92biAsV3RR2Fj7rJPnpdcov13mmFhVDFuyYG,True,360219722,90054930,557558,278779,278779,3zqXX6kzhkbW3d4TwD2CNjMRwxTbREXySekvq37kfCNk,22302341,166005857,-143703516,619
2022-01-20 20:39:45-05:00,3939,CBL2NbekJrXvBiAcoj4fzQ4PfLDwTntW7Zt4nruHFYEw,59EvfgYTdKkfjUJz5LddLUAqbEdLaihcMzjcrTZsyzyS,True,4712,1178,7,3,4,3zqXX6kzhkbW3d4TwD2CNjMRwxTbREXySekvq37kfCNk,291,2283,-1992,617
2022-01-20 20:39:45-05:00,3940,6oroGB3mvzK3tDfiB9X2NJuL3x476pxhgRnt7VxqhdLo,2SoK8tKkLn2ppKURpTVazKsCEis4uahkHMsac1m85J4r,True,902035,225508,1391,695,696,3zqXX6kzhkbW3d4TwD2CNjMRwxTbREXySekvq37kfCNk,55651,842856,-787205,616
2022-01-20 20:39:45-05:00,3941,2jPxG5FL6D6XEJsRszJ9cmQ54AWSpZyPFSbn3DpWBSuM,3toQou4UVNvyWYvMvkuv379RVEF2aN2TzCpKKBUqeQV6,True,97244615,24311153,150880,75440,75440,DddJ7EWCmYEEZETCBNgAUSg81Ls6fZtiAaY5ekJ5sXx1,6035209,47184970,-41149761,620
2022-01-20 20:39:45-05:00,3942,9vcKW1GfrDZ3KLPh2pEVFF8ZyKqD1pJW1hiE8H98Av7S,C6Ki27mo4sCHu6u8UnR1p7WSgsTjFQxGGR9Lk9n5Rhjq,True,1398810,349702,2131,1065,1066,3zqXX6kzhkbW3d4TwD2CNjMRwxTbREXySekvq37kfCNk,85245,766408,-681163,609
2022-01-20 20:39:45-05:00,3943,8MGEQ1KEMv9WSgVifjN7CQ7tDbJBJbWgGYu71dTDKEPQ,mQY2X9KYVXf9JmGY8XwMK4G8odM4HmWkgEmYYqKnkvF,True,86627173,21656793,134611,67305,67306,3zqXX6kzhkbW3d4TwD2CNjMRwxTbREXySekvq37kfCNk,5384475,49525669,-44141194,621
2022-01-20 20:39:46-05:00,3944,3qnPsgqW11AcDEmyjmJquPcPLyE3EdJQuVLJ5kinDrd3,86rZadBB7emKio76aFTahpbrFtxd9tqZ4Mxgzaavq2xU,True,79564,19891,123,61,62,3zqXX6kzhkbW3d4TwD2CNjMRwxTbREXySekvq37kfCNk,4942,39419,-34477,621
2022-01-20 20:39:46-05:00,3945,GqAS41YJssg9aaEp3hs3sG98APCsXhiQBQszXaSjZ2bN,2wodJ3AhrXdE1T4oVL95KvoBND7PubG5Wd5GWiLCMZJU,True,95661087,23915271,148593,74296,74297,3uL2NSR2ZdDqCiKfzA5SwwpddAnit22DBJo6uvvz1rRs,5943749,85401910,-79458161,621
2022-01-20 20:39:46-05:00,3946,M69XSefqeum2arinvHEqmA3L2XHWNFN17p4msRhRZXf,2vK15yYUANLSbAoiBfgJ9VLyqsmtEpd2iNytQjms8GaQ,True,136431692,34107923,209113,104556,104557,3uL2NSR2ZdDqCiKfzA5SwwpddAnit22DBJo6uvvz1rRs,8364532,96525615,-88161083,613
2022-01-20 20:39:47-05:00,3947,BLJgLzizx2yLgd12pVBAHTMqn9J5JA3JHCF8PnLnPyUk,HhDmwMysBFWhXnd3mrV31w75WBRKBS8wJSiEMZgqdUSp,True,514717065,128679266,800410,400205,400205,DddJ7EWCmYEEZETCBNgAUSg81Ls6fZtiAaY5ekJ5sXx1,32016415,267242180,-235225765,622
2022-01-20 20:39:47-05:00,3948,FKQVm9RsteDe7dQmwx4NGYhz3Wrvwh7TCp9rFbTgAomx,Dbwox8eRCdmH5KXyi5sBaqWzhxtaVPo1teWXJ2kRFT1f,True,347472673,86868168,539657,269828,269829,DddJ7EWCmYEEZETCBNgAUSg81Ls6fZtiAaY5ekJ5sXx1,21586318,299650341,-278064023,621
2022-01-20 20:39:47-05:00,3949,HGJoZvLakWfSDFwuvShNBc4kCf7nP7VqzyM3mELpbFEf,12Qn5jin7QvsBngXqYAv4UstyG3b6nRf1jsLp9Dp8G7k,True,8167182,2041795,12695,6347,6348,3zqXX6kzhkbW3d4TwD2CNjMRwxTbREXySekvq37kfCNk,507805,4218219,-3710414,621
2022-01-20 20:39:47-05:00,3950,DdAPWdHnb7ocaYtcwwwYnppsH39sZpmzMyANeoJbCV7s,3BVmC39L8dEypPN1BZhsf9bx9Ge2sXCZR8Y6RH4eBNMJ,True,529707362,132426840,809131,404565,404566,3zqXX6kzhkbW3d4TwD2CNjMRwxTbREXySekvq37kfCNk,32365256,424710771,-392345515,611
2022-01-20 20:39:48-05:00,3951,2FEbsetZMkRqLjSC8GBbgecKgX5T1T1fci2sLQux29p8,H722Fcd6DkTFRZxqQWbPDufBfXEgmFfhiEpQZWhxwYv1,True,2432923,608230,3790,1895,1895,3zqXX6kzhkbW3d4TwD2CNjMRwxTbREXySekvq37kfCNk,151626,1096959,-945333,623
2022-01-20 20:39:50-05:00,3952,Ckqos6cdncPKj13DnCmDVZsZTqp6eS7277CRrT9WhcEr,AtUV8m7VQJvZq7GLCAHMf3jV7iamKEPnWVZHWuuVZQp1,True,625067,156266,955,477,478,3zqXX6kzhkbW3d4TwD2CNjMRwxTbREXySekvq37kfCNk,38217,423233,-385016,611
2022-01-20 20:39:51-05:00,3953,5rW9kqXB9feGSKSvSMNJF1FCsBYV3vGmTmc8MvzaZ3pi,7AjnjcfPJevW5521hXw4VtgRCfHSsAqyzyArukKfNcHo,True,5537270,1384317,8593,4296,4297,3zqXX6kzhkbW3d4TwD2CNjMRwxTbREXySekvq37kfCNk,343748,3215129,-2871381,620
2022-01-20 20:39:53-05:00,3954,3C2MZQKh9x4zNTCMbhhvoafGaFMwUooqfy9MCgPyXs6E,AHjgWKpYPWe6ketjDHDKFBFsKQiRJ41jnkuo39MVYxZo,True,106600095,26650023,165379,82689,82690,3zqXX6kzhkbW3d4TwD2CNjMRwxTbREXySekvq37kfCNk,6615190,68532472,-61917282,620
2022-01-20 20:39:56-05:00,3955,8627qmFevGS1LSDyCgoJjbURcf8CjVFCcxE7U9mWVP5f,3sgQuNcZuGV59Q9apxSBQcV1XAa6og6xa8FLpumvN7iZ,True,20186,5046,31,15,16,3zqXX6kzhkbW3d4TwD2CNjMRwxTbREXySekvq37kfCNk,1255,9737,-8482,621
2022-01-20 20:39:56-05:00,3956,6BQVtmNsxihi4PcA7MurtguTwa6SmbmKyP14RHyjVZkf,7ZFv5ms4HzVKiw7KgE8RUoKxW9rB6JUD7ujZxMx4DwnM,True,1669209,417302,2602,1301,1301,3zqXX6kzhkbW3d4TwD2CNjMRwxTbREXySekvq37kfCNk,104110,684675,-580565,623
2022-01-20 20:39:59-05:00,3957,U3vvMQ4X4aKzVYfhMw1V1p58HRqaLnuXozqmmefYeD9,7JA94MArkNCFRhBq8f5a32DgMF6aPdFsoC5HvXDQ6NuR,True,158141042,39535260,246873,123436,123437,3zqXX6kzhkbW3d4TwD2CNjMRwxTbREXySekvq37kfCNk,9874956,93180531,-83305575,624
2022-01-20 20:39:59-05:00,3958,9Hz4p7gcfDbXBJp8KzhaBBPh9i7xe9kun7zLfDtqPe6c,2bJ43Lep6kp6WY7Ct56oiscKnAbdtC265G5yRvRPFThU,True,478266743,119566685,745937,372968,372969,3zqXX6kzhkbW3d4TwD2CNjMRwxTbREXySekvq37kfCNk,29837485,117164034,-87326549,623
2022-01-20 20:39:59-05:00,3959,ymyzGH4Qc7HH5PbKpVphCbsQgLLXyGkPcXamQJuNj5C,8oTLHaV2XzbKXNWRuUjCfHjUn61Pw93LYK14m9q2VDpZ,True,6925412,1731353,10824,5412,5412,4BnQKPLuE3DMTtxp8MjUBytgnhvxqq3ZTqZHTVZo4JJh,432985,3079791,-2646806,625
2022-01-20 20:40:00-05:00,3960,BrHRMouGRz3LBNzd9anfdYMhWfg8yUPHL4PqJ8WdEDFS,4uzoLa3mC2VYHAPBoHLX4gTjPTC28rPf2fvEGtJWPYc,True,30640415,7660103,47617,23808,23809,4BnQKPLuE3DMTtxp8MjUBytgnhvxqq3ZTqZHTVZo4JJh,1904717,27202062,-25297345,621
2022-01-20 20:40:49-05:00,3961,FF8rqfM9PTEjYiVFy8jS81weDRwdaYooux2uSa2LexrJ,JBk1JghH1gged1YpDbkczFXP9ka5ivYSkaYoVbbXD4kg,True,94458958,23614739,147786,73893,73893,3uL2NSR2ZdDqCiKfzA5SwwpddAnit22DBJo6uvvz1rRs,5911468,52063689,-46152221,625
2022-01-20 20:40:52-05:00,3962,B4Uc39nKzz9wBRQsCkMR4A7RwTJ8rSuwpR6EQn2AesRb,H49bGZgatRZVpj6QufZRVgYrQtH7LpdbiqKBs23151m,True,13030436,3257609,20389,10194,10195,3uL2NSR2ZdDqCiKfzA5SwwpddAnit22DBJo6uvvz1rRs,815583,12731601,-11916018,625
2022-01-20 20:40:59-05:00,3963,J1sBDjpdBZcsSBS5eg95SSRjRqmQUR9cXJCsLJu8yCUt,F5wRpD2senMkGbL8Uquqo8W9x5NQDDa268dHuVFAZCww,True,3426771,856692,5338,2669,2669,3uL2NSR2ZdDqCiKfzA5SwwpddAnit22DBJo6uvvz1rRs,213557,1600029,-1386472,623
2022-01-20 20:41:05-05:00,3964,BJV5jbowrbELXfDvfMovaQy4PiRf12pLYHimW9bgzW5X,6WXrWso5FvLx7RMCFBzrbzh5qevKkk2LJAihUfWXxXzB,True,10898931,2724732,17047,8523,8524,3uL2NSR2ZdDqCiKfzA5SwwpddAnit22DBJo6uvvz1rRs,681903,9749463,-9067560,625
2022-01-20 20:41:42-05:00,3965,BPsM1um9ZJf7eNoVMsQCRSwgARMuLCGGSDxf9tZeNeEy,BpzDdXfxVygiSYSmsHV6uPxQMeTFtrURMCCqhswQjd5X,True,607049,151762,949,474,475,3uL2NSR2ZdDqCiKfzA5SwwpddAnit22DBJo6uvvz1rRs,37969,275542,-237573,625
2022-01-20 20:42:01-05:00,3966,9E97vZ6evPgg1Ao8KwvjjZhBFW6dXZrrJENk1HvZ3SU,D7U38PB8BXLwUVKbRNv9po7VcFdnn7Y4tWY9xpRiNJsT,True,49311408,12327852,77163,38581,38582,3uL2NSR2ZdDqCiKfzA5SwwpddAnit22DBJo6uvvz1rRs,3086527,13346869,-10260342,625
2022-01-20 20:44:27-05:00,3967,CwTus4FyoXYqyTKAYDp69NLhA1joYZ3tarzY6FFTr6fn,6ivuvYWU6i25MzJSY8rG9rPDKiq38E6QtrV1jvRubLGr,True,5268,1317,8,4,4,3zqXX6kzhkbW3d4TwD2CNjMRwxTbREXySekvq37kfCNk,326,2654,-2328,618
2022-01-20 20:44:32-05:00,3968,Cs2YxkuqBK1kjoYZbUZdUcxapPbv8oC75trwGgWoCPfG,2PgHQM1GhHykE4bQ1ggueAw2Zs1BFUW5hxvMvr8DojKM,True,28593007,7148251,44515,22257,22258,3uL2NSR2ZdDqCiKfzA5SwwpddAnit22DBJo6uvvz1rRs,1780615,18234482,-16453867,622
2022-01-20 20:44:33-05:00,3969,54grbLQHZsNK4qTyXb8kXAU12Af9QUNFMujuzLLHHHef,3Ua1LDmZfPxvpaCp45RJ5xn3ovNuMxyWGrxnLcsK2ko3,True,804932840,201233210,1253132,626566,626566,3uL2NSR2ZdDqCiKfzA5SwwpddAnit22DBJo6uvvz1rRs,50125288,370203467,-320078179,622
2022-01-20 20:44:34-05:00,3970,6rb3fRVWJ5cSzFcmuC1YwdrNxiNctvboDF7HwsfyGoCA,H6JaYfFZkRk6iSJrA4nVeuFpMVQtVwQZHVgK1TyaupTE,True,21834,5458,33,16,17,4BnQKPLuE3DMTtxp8MjUBytgnhvxqq3ZTqZHTVZo4JJh,1352,18738,-17386,619
2022-01-20 20:44:35-05:00,3971,FS5xx53Bo65G21gJLta7LEEiS132VJM1kGpUzuqyfzoy,2kbTLjdBBA9K1coxKmwmYbjq2heSnuNg4Nh2EfVNYgwj,True,212207764,53051941,331206,165603,165603,72FwbpFGoLEazJEdpqNtPNefsadUrimUqma9wSoy4qiS,13248246,50670482,-37422236,624
2022-01-20 20:44:35-05:00,3972,AL8JFS4gjaQx89f9j8wtaNJgV76K8bw1ugvNtgvhgAnb,HJYvG2kGKe8kXgtZSWTWwTmSjxA3XUeCvyT7acoKtS1C,True,2375811987,593952996,3690058,1845029,1845029,3zqXX6kzhkbW3d4TwD2CNjMRwxTbREXySekvq37kfCNk,147602352,925563821,-777961469,621
2022-01-20 20:44:35-05:00,3973,6Bq55LtGCEeGqh4JrFLCmmGc2iJfTTBJixivqH78aGSE,DSNrCgWJeNe2P9tAQu5FvCueTzNKDKds7wzuwTQSMRG,True,3455641,863910,5360,2680,2680,72FwbpFGoLEazJEdpqNtPNefsadUrimUqma9wSoy4qiS,214412,1535298,-1320886,620
2022-01-20 20:44:35-05:00,3974,96StvqZyFUPtyMr4o9s7K4V29RSNyRpVi76vNwxG5rUf,GZKXFSFq4aGiTaqovtxqNCCVGkAFNXPh4Hep1ZMwdZ8g,True,11616067,2904016,18001,9000,9001,72FwbpFGoLEazJEdpqNtPNefsadUrimUqma9wSoy4qiS,720055,10980080,-10260025,619
2022-01-20 20:44:35-05:00,3975,DMgD2KCEhTGFLUZ5GnfNcwfiiwKYbyVpoWiN6knMkCAf,5KU2vgBkPTNVHsSULjgX7ZkZS56U3Dy3xqLTxL5sUZJ3,True,717405930,179351482,1111047,555523,555524,3zqXX6kzhkbW3d4TwD2CNjMRwxTbREXySekvq37kfCNk,44441891,485590551,-441148660,619
2022-01-20 20:44:35-05:00,3976,E1CShgy7M9998q9jyzpnHZxHJR6z5hvnshUJt37kVPtG,96f1nYW4S9APCJS3TXTGSb9UcJDdxJuoBR3pLYqcNz2b,True,88898538,22224634,137175,68587,68588,3zqXX6kzhkbW3d4TwD2CNjMRwxTbREXySekvq37kfCNk,5487017,43138767,-37651750,617
2022-01-20 20:44:36-05:00,3977,8nXbrdjjaHB73CRPRenGEQj73wbtEFGDwXsehRGMhsap,43pvdcJ6f27wz94D6ZboKwRJYbyvYCrjsJhYsvk7LJCM,True,32436330,8109082,50139,25069,25070,4BnQKPLuE3DMTtxp8MjUBytgnhvxqq3ZTqZHTVZo4JJh,2005589,7602292,-5596703,618
2022-01-20 20:44:39-05:00,3978,9ebpuMtXee3DSx4qWiEYEtTT1gK5FqCY2H5yQVWWtTts,9b71dTsTYD1bx6KsjFs5h6d3Jj4T9eX3nqmS7RQj3HS5,True,152280649,38070162,237493,118746,118747,3zqXX6kzhkbW3d4TwD2CNjMRwxTbREXySekvq37kfCNk,9499734,73583316,-64083582,623
2022-01-20 20:44:40-05:00,3979,BYvjENe16Ta77PqGV7JKEWrsqCTfkMGYwTSG5gXneDvd,EvxAXgvhPC6QkNurbK7vWyTApGo8J2R4EgMAknkHVU3d,True,1555095,388773,2407,1203,1204,3zqXX6kzhkbW3d4TwD2CNjMRwxTbREXySekvq37kfCNk,96302,1075068,-978766,619
2022-01-20 20:44:40-05:00,3980,3WcJUt8jQ1ngL3ZCGo6dFrc3GmTMTYtzeDva7mri2Tqx,HeG1Pz2oMjqtkfsRMsbqP3VpatnVEQzcWmKDVoFp4Htr,True,8166827,2041706,12685,6342,6343,3zqXX6kzhkbW3d4TwD2CNjMRwxTbREXySekvq37kfCNk,507412,4218179,-3710767,621
2022-01-20 20:44:42-05:00,3981,FV9CBGGTbppLnBKh79f2LzD1diTiS5g6u89FcpZHZmnK,Fe7mtmCUziFqbbYTvrhAcAq1Ub7YLfTJRtQ1hG7GzJD1,True,2736963,684240,4237,2118,2119,72FwbpFGoLEazJEdpqNtPNefsadUrimUqma9wSoy4qiS,169511,1234847,-1065336,619
2022-01-20 20:44:45-05:00,3982,3MEiFqy4F9nBW8gHxvGjv7norSBHwxhbzzNKngPk1RHq,2tcsJ4NUJegcEfHNwWPh979yKjKmq568CpNm5iWGbuoR,True,23657195,5914297,36887,18443,18444,3zqXX6kzhkbW3d4TwD2CNjMRwxTbREXySekvq37kfCNk,1475480,8818285,-7342805,623
2022-01-20 20:44:58-05:00,3983,AA6QgBaH9F8QfPT9xjztv9uELcADPxwUuXofkBV8dYg4,FCMXozSstTNA74FVCJ5hpYvNJamjutnoakHoBVnzwcWj,True,10802,2700,16,8,8,3uL2NSR2ZdDqCiKfzA5SwwpddAnit22DBJo6uvvz1rRs,676,5740,-5064,625
2022-01-20 20:45:00-05:00,3984,CP2qcTSw1Y5J7jZiEgbtsvJoigRbJ4m9oHGQS8Fiai2x,7Zd1uX1thbuGkp9H4r1t8aLTu9W8MxvUBNjji2FNJa8E,True,20409849,5102462,31934,15967,15967,3uL2NSR2ZdDqCiKfzA5SwwpddAnit22DBJo6uvvz1rRs,1277395,9974013,-8696618,625
2022-01-20 20:46:09-05:00,3985,D7XummfEc3NTK4qMvZegV3FrYuqc8mNgnQu3ujwemZtg,HHiRcecqzW7sGFTio7Ph6TYv3dGt64KWv4DEKgKm84fQ,True,5392977,1348244,8407,4203,4204,3zqXX6kzhkbW3d4TwD2CNjMRwxTbREXySekvq37kfCNk,336301,2820270,-2483969,623
2022-01-20 20:46:15-05:00,3986,2PzBAkdXkrwH9VuoMALumQz86qkW7sSBQtCrHw14JUp3,D5vwWAMHVooobG2sCWv9EwtJrAFZG6cwKH4dfmA98tbt,True,1055816,263954,1650,825,825,3uL2NSR2ZdDqCiKfzA5SwwpddAnit22DBJo6uvvz1rRs,66010,530511,-464501,625
2022-01-20 20:46:19-05:00,3987,2iG781tfP9H77hcFimqp5X9KB9QsbVkQVS9q7emJAJXX,5XDdJMfPSs8WwZZgEtv22RQXEbg748ia4gGfZCy1n4jy,True,6061847,1515461,9477,4738,4739,3zqXX6kzhkbW3d4TwD2CNjMRwxTbREXySekvq37kfCNk,379092,1312643,-933551,625
2022-01-20 20:46:36-05:00,3988,FX5sizQGZcDCaETDyJ3HbLxFwhu4t9bX6YyQM7cVEo9Z,6EqnCsv1JPjz6JX1yLNcf74rmkuhAUx6Sf35QMYGuuF6,True,88946507,22236626,139126,69563,69563,3zqXX6kzhkbW3d4TwD2CNjMRwxTbREXySekvq37kfCNk,5565070,43421953,-37856883,625
2022-01-20 20:46:56-05:00,3989,3idUQDMPAN9f6F6BipHAYFZyhG5JADey1y7JcFYx5BRh,D6UMk8WsSRahs4nGyi9DLt2HyZQy4wAywDwL31sL8BVj,True,36402629,9100657,54547,27273,27274,3zqXX6kzhkbW3d4TwD2CNjMRwxTbREXySekvq37kfCNk,2181887,8570658,-6388771,599
2022-01-20 20:47:03-05:00,3990,Cb4zhnvig11U4GcC4kqKrnDicGgPhUpfDQB1U7hP3nPa,DiRAMrKqaevGXeXg38KnhaYBERj8tNKU7oWFJvhS32kw,True,81785,20446,126,63,63,3zqXX6kzhkbW3d4TwD2CNjMRwxTbREXySekvq37kfCNk,5048,35893,-30845,617
2022-01-20 20:47:05-05:00,3991,7vKmhLV45Q5etXhJL5ng8rxWhYSiUCDmAbGnwBPr7zcx,cP6xPeuHLnjr858QK1F9qYn7rJpEbPy7wEJHoju6oV7,True,17549241,4387310,27066,13533,13533,DddJ7EWCmYEEZETCBNgAUSg81Ls6fZtiAaY5ekJ5sXx1,1082671,8751195,-7668524,616
2022-01-20 20:47:05-05:00,3992,8W9NJfM6cqCsvR1FC8Ab8YZPSQF7bz7inxJZxWnF7GsX,3exfPuVcTnPxs8GwCtS3ruKUGveYymwGV7RXQssPiizJ,True,159603996,39900999,246228,123114,123114,3zqXX6kzhkbW3d4TwD2CNjMRwxTbREXySekvq37kfCNk,9849154,142155530,-132306376,617
2022-01-20 20:47:05-05:00,3993,i7TcF4weYcqgrRdH3GpndbEYxCxfcSfr9JWYrAUg1CF,BkDfknUir7PnSEW8auoB87PytycEFwyX5kT2GY4SGJJL,True,2143805,535951,3311,1655,1656,3zqXX6kzhkbW3d4TwD2CNjMRwxTbREXySekvq37kfCNk,132464,1947832,-1815368,617
2022-01-20 20:47:05-05:00,3994,3REbHhGGpn5b2GH67yQy2Dn7ZLNGLfM6hkBNU8UE1BRm,FBeCamJw884cPNpzbzhjSF7CFXyyhjnj3qWWCdBCK1NP,True,2406872,601718,3716,1858,1858,DddJ7EWCmYEEZETCBNgAUSg81Ls6fZtiAaY5ekJ5sXx1,148654,610535,-461881,617
2022-01-20 20:47:05-05:00,3995,EhANPABkSw9x9WnsDEi8pCg67iQTX2UGTTUpyjADTwdN,4FKLi98hyg9ZjM4MY6ctJsv7B6vPUnTYWdhrnNoYsztX,True,4067670,1016917,6281,3140,3141,3zqXX6kzhkbW3d4TwD2CNjMRwxTbREXySekvq37kfCNk,251246,2482493,-2231247,617
2022-01-20 20:47:06-05:00,3996,DH6W3oB22rPJj7PPrey3Rgtn8Tz8kFKQjftajzUFBeKK,5gNsQSAUq8yFVt3FtU854NfuvFQaaCDC6oAqKA6hoZ3F,True,20723369,5180842,31990,15995,15995,3zqXX6kzhkbW3d4TwD2CNjMRwxTbREXySekvq37kfCNk,1279631,9053383,-7773752,617
2022-01-20 20:47:06-05:00,3997,DrzTARa7RK8RXoxHZPKCBqYtMC8TAUHRw8SznXRKTa5M,FYANet92VhyXkKZqqBJR4sFxuCftWb68sgQU9VHCdTJk,True,13390,3347,20,10,10,HfEnetJ7uBSmZWCjBNxdvv9HEC5nsW4wDV7wu6WnhWan,829,6451,-5622,619
2022-01-20 20:47:08-05:00,3998,7D4rFmGMPKNAF75VRPxHAhSn2wTjiW8jmth1UD22Xqq9,GQ7BrT6vsXu8tHCMm75YdxFR2r9QTCrCUbdPEZBSAg9w,True,19435465,4858866,30049,15024,15025,3zqXX6kzhkbW3d4TwD2CNjMRwxTbREXySekvq37kfCNk,1201983,8346818,-7144835,618
2022-01-20 20:47:10-05:00,3999,75ycx5sUFBxDhY1uwuPCW22s2C6BydkJTje7q7zEQFGT,FpEgrVFRubjGK4DRjTqdVbxSECURpn16zfpoC31NbwnN,True,2586205,646551,4044,2022,2022,3uL2NSR2ZdDqCiKfzA5SwwpddAnit22DBJo6uvvz1rRs,161761,1579676,-1417915,625
2022-01-20 20:47:10-05:00,4000,7CSCMFa9W52tBDVUbXbc3woAy3GByeA1wPJdp3MgznPa,3447ptuVFu6G8B6N63RmS8mRv4n9PfHneypHLvbeaGLn,True,75567358,18891838,117942,58971,58971,3zqXX6kzhkbW3d4TwD2CNjMRwxTbREXySekvq37kfCNk,4717684,37610011,-32892327,624
2022-01-20 20:47:10-05:00,4001,E1wp3bmkcY3eiEYyGYwhTCsr7BZ7RfPa5DJTZFupcFwj,452hVdYkD5SDDrA6hv6DLPFvyS8PvR2P6DPNScGxWTsW,True,326939,81734,506,253,253,3zqXX6kzhkbW3d4TwD2CNjMRwxTbREXySekvq37kfCNk,20255,168418,-148163,619
2022-01-20 20:47:10-05:00,4002,F1JT1p2VuwK4L7zj7NNnZtYiZiNUCcTGKDkgdoX3BZdZ,3BKe4yzTwnnBnvTWP3britpPJ4oAWL7JZJzNLCxjUufS,True,2636,659,4,2,2,3uL2NSR2ZdDqCiKfzA5SwwpddAnit22DBJo6uvvz1rRs,164,818,-654,622
2022-01-20 20:47:11-05:00,4003,3y34hmyz6rsVnpp7d6a9s2Xw9GdezLU1H44HfieG6SGG,9DCz2eyYsrk1Hd5zsSVBhKTV9QD6beym5zB5fH3aA4hE,True,418992510,104748127,651295,325647,325648,3uL2NSR2ZdDqCiKfzA5SwwpddAnit22DBJo6uvvz1rRs,26051805,359285677,-333233872,621
2022-01-20 20:47:11-05:00,4004,DYCYiQFH9QHzCo3eAw1pFoDu7pzwFMo1E2WDZjVFRz5w,CPh4FWsGak1kd1WFEH9qBjNhnun3R2tHtZA57zW8ugn5,True,35575101,8893773,55468,27734,27734,3zqXX6kzhkbW3d4TwD2CNjMRwxTbREXySekvq37kfCNk,2218750,19633268,-17414518,623
2022-01-20 20:47:12-05:00,4005,GhV3DChNShu8mGwUUy7VLidabCV6Y2aKdp7cqPynd6Ci,8R8QkgruGRCeE1pjXmn3WjdVDiawNbXFid8gU8BfabZA,True,7230,1807,11,5,6,3zqXX6kzhkbW3d4TwD2CNjMRwxTbREXySekvq37kfCNk,449,3490,-3041,621
2022-01-20 20:47:12-05:00,4006,X5SF9srgzDgBRBhv8xUWyszYYSQiqFF6cVnVLWzQgp1,7rTqnMkPuUUJFt5px1DxwsUK8U5fQUtnx9N4v6dA4vGb,True,13412,3353,20,10,10,3zqXX6kzhkbW3d4TwD2CNjMRwxTbREXySekvq37kfCNk,828,6730,-5902,617
2022-01-20 20:47:12-05:00,4007,CK3ocyWzXQkJJZQmM6bBK4Nv6Rh3UEufjY6DvNU6gJZy,C924o4GY3p2BHLeAbFbe9SEysXqCUyD8sFu2d4NzkAV7,True,2642213,660553,4087,2043,2044,DddJ7EWCmYEEZETCBNgAUSg81Ls6fZtiAaY5ekJ5sXx1,163511,1181125,-1017614,618
2022-01-20 20:47:12-05:00,4008,2NHv3c4ufYGo3xNr6KXymAZJdpfURrNiCKbXZ7s82Vwo,E4NYpYgHTvSG6LqH2bBV9Q1XJ6pAzCp9FLSKMzJmYRrQ,True,10491486,2622871,16332,8166,8166,3zqXX6kzhkbW3d4TwD2CNjMRwxTbREXySekvq37kfCNk,653290,6519174,-5865884,622
2022-01-20 20:47:12-05:00,4009,EHJXCJ4ZxPY7F1CeDQkXxVCLyTBXAY2ouWMJfKic9EcK,3yxXBa3sJhUhK9auop8niypnuWiasge5waVTM1zzuhU7,True,448041045,112010261,700424,350212,350212,3zqXX6kzhkbW3d4TwD2CNjMRwxTbREXySekvq37kfCNk,28016997,120314745,-92297748,625
2022-01-20 20:47:12-05:00,4010,9rfebymEFqy2SoBoDKKUppZVRPr1zNh6gkFYkmVsqbqz,6pQ3MsewzM8jzKEQG5zJDry8iEMUjGA1UDJPEQjFWTgR,True,3355640,838910,5233,2616,2617,3zqXX6kzhkbW3d4TwD2CNjMRwxTbREXySekvq37kfCNk,209326,847438,-638112,623
2022-01-20 20:47:18-05:00,4011,C33hfnDHzVwKXxr6AwFAXhd1vJYrPKhtqc75Qpjm19Zt,2WYBMSyrHQEYZqxEtxBMe2xn7eioJEGsudqdCmGvssGh,True,46599998,11649999,72577,36288,36289,3zqXX6kzhkbW3d4TwD2CNjMRwxTbREXySekvq37kfCNk,2903109,9735343,-6832234,622
2022-01-20 20:47:19-05:00,4012,HmspGdpobjC5Vbmo3FcKdw4RLPN7wJKxv3uKqDjVhLee,3YEX8TzdyJyuHo76Kw76imVCJjzrC9m188YuRKvwwSwD,True,302933626,75733406,473138,236569,236569,DddJ7EWCmYEEZETCBNgAUSg81Ls6fZtiAaY5ekJ5sXx1,18925538,67455704,-48530166,624
2022-01-20 20:47:26-05:00,4013,9TL17gjvWFdhSJkpXgfnX7fKF9c2hfw59k3g8WUqm8Cb,7TyxFBKG4z5Xv3js3n1gbEWWj1M9KBF7dEmFxjCPGidC,True,75022394,18755598,117353,58676,58677,3zqXX6kzhkbW3d4TwD2CNjMRwxTbREXySekvq37kfCNk,4694134,30881626,-26187492,625
2022-01-20 20:47:26-05:00,4014,AKxRtcdpi7gWhAuL8ENj7zhgeQezzEXe9TSANE6bQoRA,2YH4vrU9deP8Cu6E8Hzf8GqKG1yVjv5pdz4FE7r5YKir,True,2776521,694130,4343,2171,2172,3zqXX6kzhkbW3d4TwD2CNjMRwxTbREXySekvq37kfCNk,173743,1369091,-1195348,625
2022-01-20 20:47:45-05:00,4015,4MmpDGUTyMcYEqJ1RoZ46AN2BhrBUseHaHqF8AmiTPyD,7HW2YZpYM349HMfW7u4h9ESZ1AXkwN8JcVDTNFzp9aTz,True,48458625,12114656,71801,35900,35901,3zqXX6kzhkbW3d4TwD2CNjMRwxTbREXySekvq37kfCNk,2872045,29621860,-26749815,592
2022-01-20 20:47:47-05:00,4016,8BMDSWFtzq9fu1ubVGtSFw8fEaMg1uvJiECuJnN8e1pd,FwkETAXL296CirvQ2AJuSHHtdKsxkZkmXSwZVVHXVDhA,True,52547039,13136759,78054,39027,39027,DddJ7EWCmYEEZETCBNgAUSg81Ls6fZtiAaY5ekJ5sXx1,3122191,25661201,-22539010,594
2022-01-20 20:47:47-05:00,4017,9jdfc9GFTecsdRuTjWFGX13niKKmeBxRgtv5j86uhSnU,HLWMShobjSkaLyXrNjgwVaUGVtbtdUSnr1XjqpXn1bLR,True,118234,29558,174,87,87,DddJ7EWCmYEEZETCBNgAUSg81Ls6fZtiAaY5ekJ5sXx1,6979,64688,-57709,590
2022-01-20 20:47:47-05:00,4018,Grw2snBvSDMa7ev2nWZo81WoLfyavmXXxCV1ugHGk5Xe,AF1WVCQcBmXCnWbDx2s62vU99zW1AdhNoqbWvdrbiQVm,True,6259041,1564760,9455,4727,4728,3zqXX6kzhkbW3d4TwD2CNjMRwxTbREXySekvq37kfCNk,378224,2977669,-2599445,604
2022-01-20 20:47:48-05:00,4019,2NdwSLxsGok8PczpCZj9CVX2BymNU5MvHt7hWfGetg2M,8AQbDXeA6mD9QoZBFJcYbnHvZwKNxzA9CCHLAgdSfTA3,True,4301,1075,6,3,3,3zqXX6kzhkbW3d4TwD2CNjMRwxTbREXySekvq37kfCNk,257,2640,-2383,597
2022-01-20 20:47:48-05:00,4020,C3k34T2x8fW171coEG9YvoUePvxtHmrQMjVsX1Cb5ZbU,4mh5Tp4Jjh5X3GDERpSMAFgsfYJvysRdd1Nu5oJQ1Dhw,True,9209,2302,13,6,7,DddJ7EWCmYEEZETCBNgAUSg81Ls6fZtiAaY5ekJ5sXx1,548,4464,-3916,595
2022-01-20 20:47:52-05:00,4021,5Z3ZFCA65WoWhm3okRuuziEMi7ajGAEHWUFchzBNba5S,FcomdrWidygkxMKzcsY5xELbmwC652uMci648LMTv7AB,True,5015,1253,7,3,4,3zqXX6kzhkbW3d4TwD2CNjMRwxTbREXySekvq37kfCNk,289,2471,-2182,576
2022-01-20 20:47:52-05:00,4022,5hUZ9uQFcYnjAQVVaGLJWdKyg7y1XMpoo8osQ9DeY7Xd,BdYiKWsjuzJLcHh3814mJ4xQ9JxoQKKcr7AHZ7Vxoavq,True,16379,4094,25,12,13,3zqXX6kzhkbW3d4TwD2CNjMRwxTbREXySekvq37kfCNk,1004,8383,-7379,612
2022-01-20 20:47:52-05:00,4023,89CkXnSZnr52Zsoh48efv9MQacrkB6GMtrbEpNJSyA2H,HcvRBS4Z22CpYgDNgm4TVF4AVXFDuYzBUAFcdHAwdpg4,True,1209294,302323,1742,871,871,3zqXX6kzhkbW3d4TwD2CNjMRwxTbREXySekvq37kfCNk,69683,600531,-530848,576
2022-01-20 20:47:52-05:00,4024,7tJwRNiNqDcbKrejrHCKXBtUTpmTq2SxeYbcfiut1Bet,7BDLXMT32bq5VQy3KcVjfSCkVY84Wy6WfEHr6GMHEHQm,True,13027858035,3256964508,19705243,9852621,9852622,3zqXX6kzhkbW3d4TwD2CNjMRwxTbREXySekvq37kfCNk,788209750,5690058383,-4901848633,605
2022-01-20 20:47:52-05:00,4025,6WNPf4rFCX74PuyvdmzRFqbxWhguuxTQqBSdnaTVBd5D,9N7a9aiHGQsxFMgVbmWoCF9w95d12xyT7XFAwpHGkTLA,True,607775,151943,903,451,452,3zqXX6kzhkbW3d4TwD2CNjMRwxTbREXySekvq37kfCNk,36136,215919,-179783,594
2022-01-20 20:47:52-05:00,4026,EEcTbsFTUEifcdbPyjBLkS943daEx1RpR8F3uZxKRZbT,8V3JzDQ1VWYQLas8fxUsWJZZHe4gEmn74RehtUwLw3k5,True,1991559,497889,3083,1541,1542,3zqXX6kzhkbW3d4TwD2CNjMRwxTbREXySekvq37kfCNk,123335,1150038,-1026703,619
2022-01-20 20:47:52-05:00,4027,3JzquEXUqphLYNmaVQLUTyrD6mJKXDcSSu9m39YCYvHf,Dk8mswH5HnCUmTEFvX4xHhUPk2m8VmgZW344BiNqg819,True,1920154305,480038576,2935313,1467656,1467657,3zqXX6kzhkbW3d4TwD2CNjMRwxTbREXySekvq37kfCNk,117412523,815962818,-698550295,611
2022-01-20 20:47:52-05:00,4028,ZoNjrSjYh4NJLW38LUPcf7jtEBxdaaM7T1zp795qjHE,FZx6v8cU25NwEosbKJ2n141o9uFAWURZB7NeCeX1trEn,True,568326,142081,869,434,435,3zqXX6kzhkbW3d4TwD2CNjMRwxTbREXySekvq37kfCNk,34776,200615,-165839,611
2022-01-20 20:47:52-05:00,4029,D3mXrJzhHf8qRaoCKLschUxAFoijFCFuT6bmNZH4W7Cj,9E3Xtqw7TncXWnbhAbFJMtuNmP6WS3ooGuptzyzw7UpA,True,23337,5834,34,17,17,3zqXX6kzhkbW3d4TwD2CNjMRwxTbREXySekvq37kfCNk,1360,15233,-13873,582
2022-01-20 20:47:53-05:00,4030,2rCRdyfi65rpxRRmg7knaSb8t55FuPt3h8wF4Fzhy8MM,CLVY5nSG3jTdRo7tRSKgK9DJgW6aswfWKe4tLxzsENmb,True,254106,63526,367,183,184,72FwbpFGoLEazJEdpqNtPNefsadUrimUqma9wSoy4qiS,14713,114260,-99547,579
2022-01-20 20:47:53-05:00,4031,5BjBPqumCb9KC82ZNNch3dcRzbpGdRLJneru7o9a1D9R,FuZtBWKktxFu4yoiLVMzxq8fMhQyN8SGzGPz49xs3m6P,True,54822223,13705555,85337,42668,42669,72FwbpFGoLEazJEdpqNtPNefsadUrimUqma9wSoy4qiS,3413490,31848908,-28435418,622
2022-01-20 20:47:53-05:00,4032,7nByfyoLmMrzzVHsjxL2FRF72tfW3KiRT27BRGUp4PhP,36SF6NBnUc5wK41yfGCnujpCaCwExR3iRXJQx1WNakyM,True,16057292,4014323,23830,11915,11915,72FwbpFGoLEazJEdpqNtPNefsadUrimUqma9wSoy4qiS,953225,3945937,-2992712,593
2022-01-20 20:47:53-05:00,4033,EgU9hX6VK7YXeCgCHVaJAMekCcyZa2MVWdKra5pN7Gwv,7y8Ad9XY34bqREvheXHT2tr8Jy11D6X3pu7yLVtjU4QV,True,3685583,921395,5725,2862,2863,72FwbpFGoLEazJEdpqNtPNefsadUrimUqma9wSoy4qiS,229023,2143685,-1914662,621
2022-01-20 20:47:54-05:00,4034,FjDp4bWCtqehFD7FunCrjrcdxMezTJj5aqh2VnBvHDQU,HRYeZqcqhP1RPiAGXziR1qCWwk4sF6c5ZYbvSDhX7foN,True,2984045,746011,4594,2297,2297,3zqXX6kzhkbW3d4TwD2CNjMRwxTbREXySekvq37kfCNk,183773,1422835,-1239062,615
2022-01-20 20:47:54-05:00,4035,91tPxdvLhrVtytKuNkf33XocRnpEqA1x3jDb1Je6xeui,2ByoMpaZg1uzkA48vMufvcx8BLYxWLXUK3tXAJcupanF,True,11739,2934,18,9,9,3zqXX6kzhkbW3d4TwD2CNjMRwxTbREXySekvq37kfCNk,721,5723,-5002,614
2022-01-20 20:47:54-05:00,4036,8mbMH9EKd9kQDyFrYiDJCV9VaWxWCzpZBQZLyYN2yNVx,J9gT39dF1egMeQvweXYWeRAX3kpmBABijYZhfj6M2UqU,True,9075180,2268795,13932,6966,6966,3zqXX6kzhkbW3d4TwD2CNjMRwxTbREXySekvq37kfCNk,557284,3869633,-3312349,614
2022-01-20 20:47:54-05:00,4037,8trkirSQNdMmAcJdeswxs5cPjH8dD6U4eJtWiAdMsrDB,HaSzpQ45x2MipfN17U6jGBxX8tXboomVDhXNSrnEfLDr,True,2349534,587383,3653,1826,1827,72FwbpFGoLEazJEdpqNtPNefsadUrimUqma9wSoy4qiS,146137,1074447,-928310,621
2022-01-20 20:47:54-05:00,4038,Buioe5v3DyFwD9nquW5XdYeVYbSABCyg79eUHEvtvfaW,7T9gi7prCcZJkYJMSB5Ef6Bu4pAuBw4XLvumSFnqKDSi,True,263217,65804,402,201,201,3zqXX6kzhkbW3d4TwD2CNjMRwxTbREXySekvq37kfCNk,16108,169523,-153415,611
2022-01-20 20:47:54-05:00,4039,CEbGTNX6WpaoKp4RBGSn9LzYM6yAYyeiMrgVYgJxA4zb,AiXUcGAFFm4tc7vKBscSNjZawV5YJqbv7D1KpxD3Zufg,True,7374569,1843642,11312,5656,5656,3zqXX6kzhkbW3d4TwD2CNjMRwxTbREXySekvq37kfCNk,452505,4739450,-4286945,613
2022-01-20 20:47:54-05:00,4040,6h43GsVT3TjtLa5nRpsXp15GDpAY4smWCYHgcq58dSPM,CTgbWridYWnfE5Emwr7qiCEb3LcXHupqeB9zwmddoEqB,True,63973410,15993352,92639,46319,46320,3zqXX6kzhkbW3d4TwD2CNjMRwxTbREXySekvq37kfCNk,3705569,55331452,-51625883,579
2022-01-20 20:47:54-05:00,4041,6BPPDj3BVgBPD3agd8b4B12d9Gvp4bFPXRWjzbtsmtRF,8VZnAwXPyKK2AHoMTZxKXthAiFMrL6b5EXAGqsAMTdhm,True,11740,2935,18,9,9,3zqXX6kzhkbW3d4TwD2CNjMRwxTbREXySekvq37kfCNk,722,5723,-5001,614
2022-01-20 20:47:54-05:00,4042,2BH44k4TYoQSqsSs5EASqJhxpH17Fr8Ahxbg2MAkWa72,HwvvVWpqfN7NDsVYdxbCSbqxSrLCThwnJiZQHh2w2zJb,True,7234,1808,10,5,5,72FwbpFGoLEazJEdpqNtPNefsadUrimUqma9wSoy4qiS,417,3538,-3121,576
2022-01-20 20:47:54-05:00,4043,Mcbzp1LhZwpfmXTv1pqe9D1jCKHw443j9QKp6tUpzgM,8uforSMAKEih5jHfHp3gCqCvaugtCmhzVfVHA63Akz7F,True,805282,201320,1203,601,602,72FwbpFGoLEazJEdpqNtPNefsadUrimUqma9wSoy4qiS,48123,495548,-447425,597
2022-01-20 20:47:54-05:00,4044,GaEpNGa8jnwSRvjzzEMYkZe1pKcr2eiZtePrqFxpABjB,5CFZHuyWbJv14zPdX5dSQDREgHrCb4vsFvB6hLiEe3Ji,True,61437,15359,88,44,44,3zqXX6kzhkbW3d4TwD2CNjMRwxTbREXySekvq37kfCNk,3546,30808,-27262,577
2022-01-20 20:47:54-05:00,4045,8VT2nxz5ZYDJFd9uL2XZwEXxChd9pjuMJNMAcutZubL1,EhAkiRbouzUAWtqQFsN8HEEfi46UVN8H8tyBP7CbgeLe,True,3704,926,5,2,3,72FwbpFGoLEazJEdpqNtPNefsadUrimUqma9wSoy4qiS,223,2074,-1851,602
2022-01-20 20:47:54-05:00,4046,4j19AEcDwhtAZrnoDc4epNPmEL1jPpVUMeg7RmQ72Qkb,84WB42AAGbczVE9txZPwXrx4FD5jP87r8QdDzEABTm5G,True,26519464294,6629866073,38735782,19367891,19367891,72FwbpFGoLEazJEdpqNtPNefsadUrimUqma9wSoy4qiS,1549431301,17270060473,-15720629172,584
2022-01-20 20:47:55-05:00,4047,FfpzVu4rcnwxNbx9EoNpZ4LmCYTjhYTkhwrUGCpnSJvh,5rRoUEuDVtaXQBH9xvq4vUvPWJDytFoEByNrcWfiq1E8,True,216803,54198,337,168,169,3zqXX6kzhkbW3d4TwD2CNjMRwxTbREXySekvq37kfCNk,13492,58714,-45222,622
2022-01-20 20:47:55-05:00,4048,7LRBswSEDBjJzQ4YurfTxLydh7tFS2jVn5V95Z6wL7ci,fD41VYGmk66MW46KKb23vAqQvUSDScgXnVdsHhJBZzu,True,47538,11884,70,35,35,3zqXX6kzhkbW3d4TwD2CNjMRwxTbREXySekvq37kfCNk,2810,27439,-24629,591
2022-01-20 20:47:55-05:00,4049,C4dbwF9mioaBkZnyBFvFs6Cqd362VuGPBGPbTY9CAnAk,CcUqBfu1hbWm5VVxbtF2Xm6HUz4CLFzuDsjUi6KtnZQg,True,661335,165333,1006,503,503,3zqXX6kzhkbW3d4TwD2CNjMRwxTbREXySekvq37kfCNk,40245,233211,-192966,608
2022-01-20 20:47:55-05:00,4050,9YEzjb49Awvedv9yNc6LG54SkGBug2RYiJwiUV13mGsS,3H8w5WCD187NWWoZMNUCzUDdxTgqrRJLga8gDzUVXBgZ,True,442319,110579,648,324,324,72FwbpFGoLEazJEdpqNtPNefsadUrimUqma9wSoy4qiS,25947,308130,-282183,586
2022-01-20 20:47:55-05:00,4051,3axqGcX5yuJ2vGxRjtNguefXUvSQHDQmn2zskhyCuQkf,EYrZo9zZDaHqFdc1fam63W3jvqqmbU67wzp6yFcppwsL,True,10850739,2712684,16413,8206,8207,3zqXX6kzhkbW3d4TwD2CNjMRwxTbREXySekvq37kfCNk,656527,10053763,-9397236,605
2022-01-20 20:47:55-05:00,4052,EuvK7bsc3hbxqeJjJkLELCvS7kruCMAGDctn5u7Q7BnP,Dv4XTdwnp6Sv5zxkSwRwsdSzxApDtBr4A13x4vvzTVjm,True,19370924,4842731,29819,14909,14910,3zqXX6kzhkbW3d4TwD2CNjMRwxTbREXySekvq37kfCNk,1192764,9946858,-8754094,615
2022-01-20 20:47:55-05:00,4053,AtKuDfcFXqWUMnRqQpjedUMTb5CQKLc2zoqEAcQpysKQ,9bPFLYp5TDZruLLDXDYYCiPYcD982iF8xt5rfTkqwNsL,True,4491,1122,6,3,3,3zqXX6kzhkbW3d4TwD2CNjMRwxTbREXySekvq37kfCNk,267,2179,-1912,594
2022-01-20 20:47:55-05:00,4054,DiB9SeCFXjioNGPJM3GuZ3FCG9KBZhHK27zCSN5b6gkq,GtK8UtKDQy9jgtTXvam4jja9N7c4EFuDQr4TKHgNyhXT,True,1633530,408382,2484,1242,1242,3zqXX6kzhkbW3d4TwD2CNjMRwxTbREXySekvq37kfCNk,99385,886795,-787410,608
2022-01-20 20:47:55-05:00,4055,96DzqyUxsB1FKWrhLdTdjDcokuus6rbx83gLsghqPPwt,74CWb7SVoSy3ADysEzFEeMiS2fxHJ9gdUF9pzM3E52Gj,True,7807,1951,11,5,6,3zqXX6kzhkbW3d4TwD2CNjMRwxTbREXySekvq37kfCNk,455,3852,-3397,582
2022-01-20 20:47:56-05:00,4056,KoCscQ9Q8TZHhmya5KaXBrwUEMTdCkEMRtrhvtgEmiZ,6aZ5AFMFoqf1X64RwAt1J4Yrx4WGGe2JMiEjqnQ2gEtk,True,190198,47549,279,139,140,3zqXX6kzhkbW3d4TwD2CNjMRwxTbREXySekvq37kfCNk,11168,58278,-47110,587
2022-01-20 20:47:56-05:00,4057,9ydHRjDWvWV2XqbXKKpeLDh2RV7WnQZWDTi4ahgDjGNh,AiJQBv4a1Z4w2rsRog5WTaKb4dTjAXfAvXcWoW4DztSW,True,25230223,6307555,36552,18276,18276,3zqXX6kzhkbW3d4TwD2CNjMRwxTbREXySekvq37kfCNk,1462110,6231898,-4769788,579
2022-01-20 20:47:56-05:00,4058,2RZPBo8Z2BgZmsASo14ySTSwqqgqmfVEjPkiAwQ1VTgf,BRS5cYtEoPRoSvTAiQaT1svWRdLJWVfy8LUb4SCudCjS,True,1975956,493989,2972,1486,1486,3zqXX6kzhkbW3d4TwD2CNjMRwxTbREXySekvq37kfCNk,118882,984825,-865943,601
2022-01-20 20:47:56-05:00,4059,4hrm69kAKNcfBkiP2YgtW94Pbip6FLfQAwnDRAAack69,BjbZRdGMoC7Mfoa4H19UvE2eQafgKD5rqnK7BSGwqS1s,True,13681,3420,20,10,10,3zqXX6kzhkbW3d4TwD2CNjMRwxTbREXySekvq37kfCNk,828,6905,-6077,605
2022-01-20 20:47:56-05:00,4060,BzSJ77zKaqtBk2cEL1XqFL97zTXXMRHmxtkgtXwCc3C,2g4KXTwy2MPSRQ2khNp1o1rn7CradEr9H4ySYKDoSWN9,True,4074140,1018535,5971,2985,2986,3zqXX6kzhkbW3d4TwD2CNjMRwxTbREXySekvq37kfCNk,238868,4345872,-4107004,586
2022-01-20 20:47:56-05:00,4061,EV21gv8jEvXtmGDoGRNm5LJEvTBccLMZyVDCLsp54jP3,DGxxoU52aQNoUQcxdvQtv2H5q2PhK6TGkLgNSaFgnZrb,True,1799255,449813,2626,1313,1313,3zqXX6kzhkbW3d4TwD2CNjMRwxTbREXySekvq37kfCNk,105069,934264,-829195,583
2022-01-20 20:47:56-05:00,4062,EeUACm9TkjHKES5U7Yj1oPhYmcp7R3tvesGBiP8txEzq,3qkmm4aS6EDirEDejmbm5PDw2jpYkC7zKqrMkmgeE5BA,True,93183,23295,136,68,68,3zqXX6kzhkbW3d4TwD2CNjMRwxTbREXySekvq37kfCNk,5449,40709,-35260,584
2022-01-20 20:47:56-05:00,4063,GABCjRvhnVZwwR9aZLhkTfaH9xdp2hJK7J6h4kD5VzkC,JabV7oy3dp6jshtccn89ybinAuaf9dHVmKuiEjXDPT9,True,23334653,5833663,33802,16901,16901,3zqXX6kzhkbW3d4TwD2CNjMRwxTbREXySekvq37kfCNk,1352110,11944030,-10591920,579
2022-01-20 20:47:57-05:00,4064,HutRztBianNUgm9sJDWKUQBmoVyy8y7CfnNk4hHjSkEW,EtVfvPyiy5bizbCZxR19TNUgETf3QcmziBvMtc6o5zjr,True,99355757,24838939,143494,71747,71747,3zqXX6kzhkbW3d4TwD2CNjMRwxTbREXySekvq37kfCNk,5739773,94423013,-88683240,577
2022-01-20 20:47:58-05:00,4065,6XHt7CrURSomkQrtVXV5JuKSZY4tQRpUyQKfCDaSTYaD,GCgcmPSDDBsn2smYbpiX3PJybDkQWtufPu4YRsbEEU8X,True,136057777,34014444,199786,99893,99893,3zqXX6kzhkbW3d4TwD2CNjMRwxTbREXySekvq37kfCNk,7991440,96526494,-88535054,587
2022-01-20 20:47:58-05:00,4066,A7HnmwpMzu9yYuvURa1Zct5JUoFujFybc6Ympjciuz99,E41s3xNbU4haxQQjR8nXZwTpJCoLiJ2BJSncHDfc6HzS,True,224156597,56039149,336732,168366,168366,3zqXX6kzhkbW3d4TwD2CNjMRwxTbREXySekvq37kfCNk,13469291,89282394,-75813103,600
2022-01-20 20:47:58-05:00,4067,Ar5QB4VBcUyzSCG23z2QNAbrWY55NbHCr1MNN6P2GAmh,BusFGTiDrJmxzwGUxWz9b3SFF3eseqtgh2DRHqyAwyVe,True,186411,46602,265,132,133,3zqXX6kzhkbW3d4TwD2CNjMRwxTbREXySekvq37kfCNk,10602,97162,-86560,568
2022-01-20 20:47:58-05:00,4068,99NHcwD1iaf5FXM3UNb91SjNiiT3HwyQFQMhkGd5ASts,8syAydy52vSQQLzsLXW24BFw4VPeK66Vp3BmAbnHfgod,True,19960098,4990024,29545,14772,14773,3zqXX6kzhkbW3d4TwD2CNjMRwxTbREXySekvq37kfCNk,1181835,10457994,-9276159,592
2022-01-20 20:48:02-05:00,4069,36ByQojnxEckWdQTjqHfxKqCx9yjqWQsPsZyqaN72UWR,AZoirtS1fjX61agRM64tqThVinnJTh3BWgiHyNHPTgZP,True,571874,142968,877,438,439,HfEnetJ7uBSmZWCjBNxdvv9HEC5nsW4wDV7wu6WnhWan,35086,334531,-299445,613
2022-01-20 20:48:03-05:00,4070,2ce2v2TCbjNH635NgbwTG3sqiRWYrRRaBpxPxBZJ929q,9cnoebT43FkWDFhidndGCVNiFD4NErv8DuL1Va4Jv9S8,True,2236843,559210,3439,1719,1720,3zqXX6kzhkbW3d4TwD2CNjMRwxTbREXySekvq37kfCNk,137572,1949947,-1812375,615
2022-01-20 20:48:06-05:00,4071,C7a8BtMjuLXkzxZBC4Wk2gjkGBmucLmDjokf9pyA1Mu6,GxwYNWwYTtFMUxuZvNC5qrEYuJzYiEURQVuBxssfCJzr,True,618258,154564,925,462,463,3zqXX6kzhkbW3d4TwD2CNjMRwxTbREXySekvq37kfCNk,37032,219682,-182650,598
2022-01-20 20:48:07-05:00,4072,87R8o8xLjHw2GpunYkm7pX7uJ8hjM4B1y4Qm7aQf6Yh4,48aSVPQoFYdncF5NtJ114urbdTzVjTgYLgPzMfpJbZB3,True,23760616,5940154,36778,18389,18389,72FwbpFGoLEazJEdpqNtPNefsadUrimUqma9wSoy4qiS,1471145,24696758,-23225613,619
2022-01-20 20:48:07-05:00,4073,DiPSJvnnEwg1En7HJfEsKrUbBgtUf4KzGMyMCZDQSYgp,s8UVC6vPBofuXUS6RW1aQmZ8C35PrC5r4A6ugmvzLGB,True,723145,180786,1112,556,556,3zqXX6kzhkbW3d4TwD2CNjMRwxTbREXySekvq37kfCNk,44486,255733,-211247,615
2022-01-20 20:48:07-05:00,4074,AQr9mVmcXCNQhBVCfx63MwR6c4WqDSC9K2BZqr7N8LCx,CB7TWUaL381ounsLw6neAUaKRxJL9P1HC9uGX5e1Uxod,True,213933604,53483401,333086,166543,166543,72FwbpFGoLEazJEdpqNtPNefsadUrimUqma9wSoy4qiS,13323469,162487996,-149164527,622
2022-01-20 20:48:16-05:00,4075,CAkknoa9UFPMEZ1KWSfqtmnL7ArVNV3HRETLwecuuXP,4cHJYv3dxA6qjcuxUkGRuL7STWobGPKtoHFD4ACUbiWq,True,4222831,1055707,6215,3107,3108,3zqXX6kzhkbW3d4TwD2CNjMRwxTbREXySekvq37kfCNk,248623,2078905,-1830282,588
2022-01-20 20:48:19-05:00,4076,4FazDUgfQ3AKoFcnWHr8E9Ht8jLA3tkxf75yrGZVHdmF,HzRMH6mbgEKydRCnnMvSsKgTEVNQi6nuzoR1xutYFdzg,True,22780,5695,35,17,18,3zqXX6kzhkbW3d4TwD2CNjMRwxTbREXySekvq37kfCNk,1402,18686,-17284,615
2022-01-20 20:48:19-05:00,4077,GKCeRcHQYMhcTwEm5wu1SbkXAT19gjGUGji43HS36B5N,EYQKX5sWsmXoge5xbTcMYAjvRbSUTXXpHEzckPY2LV8W,True,1745036,436259,2729,1364,1365,3zqXX6kzhkbW3d4TwD2CNjMRwxTbREXySekvq37kfCNk,109199,473327,-364128,625
2022-01-20 20:48:19-05:00,4078,E9FFPvygPSF22u7gqFq4w6yE5kV15zbeGDXFQc349RsG,yi1REPVUwKhr5ss5YJc56crYz8LVfkqNVMpKcdSfwfY,True,620747,155186,957,478,479,3zqXX6kzhkbW3d4TwD2CNjMRwxTbREXySekvq37kfCNk,38292,218453,-180161,616
2022-01-20 20:48:19-05:00,4079,7MSzV5yy5FmrM4j1BcYSRiTGWfit1AJahheRUaXzz349,aPSTZLxBpVr3sucjbj95emRV2J1GrUWr7wbARYqJkQZ,True,1654666,413666,2540,1270,1270,HfEnetJ7uBSmZWCjBNxdvv9HEC5nsW4wDV7wu6WnhWan,101616,702501,-600885,614
2022-01-20 20:48:21-05:00,4080,9LZ3rShLfzErXsGkh4dYfAm58GNPWhK6ohDy5RrLJhc,41tLyuvuJ5M7YctkSASD2R7RGGetD7FmKaZUdkTdgXgt,True,537505,134376,835,417,418,3zqXX6kzhkbW3d4TwD2CNjMRwxTbREXySekvq37kfCNk,33430,190046,-156616,621
2022-01-20 20:48:21-05:00,4081,9gYrMXAGmGSV4VFjXzYP5WwH2aFpB1TxA6CqpYsosKLv,Dh8aH6RK48wu4fkT9xKw5XL7itxnPDuw3SDwPwvL5sva,True,9841,2460,15,7,8,3zqXX6kzhkbW3d4TwD2CNjMRwxTbREXySekvq37kfCNk,605,4877,-4272,614
2022-01-20 20:48:21-05:00,4082,ioPHEVyheRnHYomVS7PmP6Coyhjk6LCs7hMD5Mq9Ngv,DYTpFmZ4yXVghKwkaovgCdpv3jfWkjtXRzxsZjKJfXNN,True,8932,2233,13,6,7,3zqXX6kzhkbW3d4TwD2CNjMRwxTbREXySekvq37kfCNk,553,4462,-3909,619
2022-01-20 20:48:22-05:00,4083,ECuu1L4QGdemZ7FjAjVAAxYN6piinweY7Fuk5csVovfT,Amd8WGcpdtB8yoA83R1BUT5uryuqoKbcBexYacbrbGVX,True,1134163,283540,1761,880,881,3zqXX6kzhkbW3d4TwD2CNjMRwxTbREXySekvq37kfCNk,70466,514110,-443644,621
2022-01-20 20:48:23-05:00,4084,2kqN3TbCDgM4x8XfZvKgqJvDAHqvZxtT89NcfmQSQa5b,8fEx56PjuPAP61CBnrsnnnQnZmt8cw6KVjhYDK1mWJzP,True,211952771,52988192,327795,163897,163898,3zqXX6kzhkbW3d4TwD2CNjMRwxTbREXySekvq37kfCNk,13111835,53599351,-40487516,618
2022-01-20 20:48:29-05:00,4085,6d6HN8LWikwW2HYdy3BABWuxKHt1sgv4DcneACR133sE,4eKvzmfFvX96XbujKBhUauAvWP4yQYwZH3pd7gXzbCvJ,True,620040,155010,969,484,485,3zqXX6kzhkbW3d4TwD2CNjMRwxTbREXySekvq37kfCNk,38760,219628,-180868,625
2022-01-20 20:48:29-05:00,4086,3g1debT8Z2efQPuMNSDPUNZzDqarBG2acErsZ4HP7QGA,42wDHagxr5Nno3mUx6kyYGDjwR98aedRbh3ByB468agB,True,7029,1757,10,5,5,3zqXX6kzhkbW3d4TwD2CNjMRwxTbREXySekvq37kfCNk,435,3504,-3069,618
2022-01-20 20:48:29-05:00,4087,93ho4cgnpAJiJsG6uu2udkLVNU7rkz4QjCYfsqvpbPA5,45ouQn9gGwXqnTGfaP5CvU8fCKadBRA5kPwtfvJzykRU,True,23577005,5894251,36218,18109,18109,HfEnetJ7uBSmZWCjBNxdvv9HEC5nsW4wDV7wu6WnhWan,1448733,10293640,-8844907,614
2022-01-20 20:48:29-05:00,4088,4uygLJDk9DFCifJ56YwMrEsvd3oQNq8tYSLnMCyWorS6,GimL4uKGvg3FFmFQSWzAcjstv3Vmk5NMgDGMKTuXYVpB,True,500710697,125177674,778798,389399,389399,3zqXX6kzhkbW3d4TwD2CNjMRwxTbREXySekvq37kfCNk,31151946,211785356,-180633410,622
2022-01-20 20:48:30-05:00,4089,3zH1b58jqbNU37y9kDTZZrotSeT8XzS1tuyAHPKWrbah,4trxDWV16x6sVcz7bxHehYHkjjyKebh3S9fyJf8txzK5,True,2813,703,4,2,2,3zqXX6kzhkbW3d4TwD2CNjMRwxTbREXySekvq37kfCNk,172,1375,-1203,611
2022-01-20 20:48:32-05:00,4090,9k5YHTFCHczFg6KAZXf2ostkFLH7WdVAxiA9zCGRprg3,2b52r1TA8dkJsnuMuM9cNfGxKEynd42WjQUuzcQTRcD9,True,23656,5914,37,18,19,3uL2NSR2ZdDqCiKfzA5SwwpddAnit22DBJo6uvvz1rRs,1480,11853,-10373,625
2022-01-20 20:48:34-05:00,4091,6osqTNxgZv1Y1EjnVR7D1G4cywof1CrWswj87tAnktWV,Fah93R9W7SFuajFif4AbXDdxouWA5rrLz29vzVRGsMxv,True,4638323,1159580,7214,3607,3607,3zqXX6kzhkbW3d4TwD2CNjMRwxTbREXySekvq37kfCNk,288599,4509656,-4221057,622
2022-01-20 20:48:34-05:00,4092,A4tDE948CPFPh1UwHb8sXryfKktbxZ8BCkqXgA5DJHA8,3zXeKMrsEpCe5fQumLNzCgpxcG1kLJFEAtJuqxLsC6ZG,True,83634811,20908702,130172,65086,65086,3uL2NSR2ZdDqCiKfzA5SwwpddAnit22DBJo6uvvz1rRs,5206899,37781074,-32574175,622
2022-01-20 20:48:34-05:00,4093,HhwiZPKZBGa16oVi739s4qtMDMTwzWXc7iwNfX63t2UP,5AnbMbAFKy85yHt5y2M5S38nNkA1vT4ejY5NjGbRNUqn,True,513798,128449,801,400,401,3zqXX6kzhkbW3d4TwD2CNjMRwxTbREXySekvq37kfCNk,32073,363858,-331785,624
2022-01-20 20:48:35-05:00,4094,FLTW9fwjWqGPm5PiE3C9LFzwZxtDh8c2MnEoRq8W7MfQ,GKsfzKBP2QkmoEWvTaUN1h4nqrT3kAcwYRC9WxW9bB3h,True,4577144,1144286,7148,3574,3574,3zqXX6kzhkbW3d4TwD2CNjMRwxTbREXySekvq37kfCNk,285936,1965101,-1679165,624
2022-01-20 20:48:36-05:00,4095,4mB2DVbQVqVk535v98Cj8SPNg1tTc3DFyY2Q7VBbY645,HXo255k3RgsTGsc4hiP6ZTXUspBTqJ37duQa5eK7tqp3,True,152155817,38038954,237805,118902,118903,3zqXX6kzhkbW3d4TwD2CNjMRwxTbREXySekvq37kfCNk,9512207,69573856,-60061649,625
2022-01-20 20:48:36-05:00,4096,BPRoaqrDs8vhqv2T7d9qV2oPU33pi1K1LUaotM7yuD2i,6qo8uQGAEwBfYQR36v6nRiqA2xGV6SjJAsXsdzy5bqNH,True,384664466,96166116,600671,300335,300336,3zqXX6kzhkbW3d4TwD2CNjMRwxTbREXySekvq37kfCNk,24026855,208920043,-184893188,624
