ts,record_id,user_authority,user,partial,base_asset_value,base_asset_value_closed,liquidation_fee,fee_to_liquidator,fee_to_insurance_fund,liquidator,total_collateral,collateral,unrealized_pnl,margin_ratio
2022-05-09 19:53:07-04:00,21505,EXddheG5i73fJpvS4svYd16qxUhnvv3jNYhx3gn35jeE,HjYTR2AtVve381a2Rrp1JvoC3pbuFKbSViDJayJ8SXTh,False,23005785,23005785,942930,47146,895784,5HnvdJnCCcmRsm4GkXnYWd4q9RpwuvYDGEUMPkYR3Ts9,942933,16765373,-15822440,409
2022-05-09 19:53:07-04:00,21506,9cE3sPydeiFpAZajTK8ewa8pQLT5MvQPemwrHJUyzH1C,2XB63S8WX5FWQYTKuDrq75aMFVHZ3KCuZDiP5Cy95VPe,True,310325718,77581429,476939,238469,238470,F31bVJvHB2XkhGdgjyTim48hY2cLFEx661AiPS3SzYJ2,19077584,121304517,-102226933,614
2022-05-09 19:53:12-04:00,21507,DKHnugPqCk62V5SC2BLqYJ6CrUFkZe3X45DM3PncjfrV,5Wk61GCcKBBfx2EtcBvKUaMtQKFSJUBBDsWbonTvcun1,True,38751008,2299616,10191,5095,5096,5HnvdJnCCcmRsm4GkXnYWd4q9RpwuvYDGEUMPkYR3Ts9,1717428,27966545,-26249117,443
2022-05-09 19:53:13-04:00,21508,CpSUMCkXamfGm1FyxYQgmAKh1jaJ1DdmrRHxHANJpc3Q,2rVXtfeMhRgmU6eNBvg6RvQ4jRCAmgKVgLS8bPppCb8Q,True,38745816,2311070,10309,5154,5155,6L1WYrPiCMyi7XemPww4B4hvpKD1LQKD4RpiSKmrmgSC,1728392,27980488,-26252096,446
2022-05-09 19:53:31-04:00,21509,Y3bqEwy46XfvKCYHYnEdBqsUAVMBRfq5qLtmvEA6Kb1,GCDPpvCjwjBJp8VZ4hTmnmeG3uVny1PcAmKQKCXHw3nV,True,30524671,1727405,7540,3770,3770,3zqXX6kzhkbW3d4TwD2CNjMRwxTbREXySekvq37kfCNk,1332407,22057839,-20725432,436
2022-05-09 19:53:38-04:00,21510,2A7ZobmSAddaDW7xJUbXKCKnPmnCd9hMV5UtzSbdgBMg,9aXtTVwGPwJoPL5V16y5T4SnAg8cAoF5YT5VsKcfS5GD,True,18064472,4516118,27763,13881,13882,3zqXX6kzhkbW3d4TwD2CNjMRwxTbREXySekvq37kfCNk,1110541,25928301,-24817760,614
2022-05-09 19:53:39-04:00,21511,DuNLzKUCCxrZY6JyBGwKJEJRygBd2vm1CesXgMDhfhn6,4PGnrVg4NTCuW5sZmkpg6g5ria57Jvhoaktsi9J8Ay13,True,70502527,17625631,101612,50806,50806,5HnvdJnCCcmRsm4GkXnYWd4q9RpwuvYDGEUMPkYR3Ts9,4064497,31268606,-27204109,576
2022-05-09 19:53:40-04:00,21512,CZsnNXD5oC348mWZeawVj4K2bGxpTiXZzkpm8QtXLbBW,FmBXczLq7hkauf7C4JoxH5TY8HHJ83U5xqGXK3j6t5Fw,False,13524550,13524550,800890,40044,760846,68sueyVfmy5ToEGtLFGDkwebX47xAmzyXE29z8JrmcWv,800890,24358812,-23557922,592
2022-05-09 19:53:47-04:00,21513,6fqbSyhh3PPdgRcLraHb7Jahj9s1oHHeX3SsjNSsGa6t,GpRUow48TYgttdYfsygbgjYQcmHyYjWETUDjDVphEgwq,True,650315864,162578966,961817,480908,480909,3zqXX6kzhkbW3d4TwD2CNjMRwxTbREXySekvq37kfCNk,38472696,255984034,-217511338,591
2022-05-09 19:56:19-04:00,21514,8ZsXyXgAV71qRor7YWFC8zMntN73XWm7GhTkE7XgV7Rq,D4QLFpaaetu9TcVxQH9j9WAXK7ZVKKLnW6KtHK6W9MZ9,True,30498543,1728789,7531,3765,3766,Hu94aiQWvce6THeGyCFqGRPM1pQrK3ihzkcXo1EpJcJL,1328610,22080178,-20751568,435
2022-05-09 19:56:20-04:00,21515,26wo1RqwKXrNnfgMdZEmkGhnDbURpZcp2hasB5EA5QtD,34gwTVGRrdoaBzLUG6SBwRwBovkjBjCebqVUBan6GDnB,True,114241016,28560254,203885,101942,101943,6L1WYrPiCMyi7XemPww4B4hvpKD1LQKD4RpiSKmrmgSC,8155407,112864708,-104709301,713
2022-05-09 19:56:25-04:00,21516,7bTEcer5k6PypbgPJEFqpTJgiwhU4oJARe4ioWYPy4na,Gu3g7ghunEhPxMPaFQ5r9BC4ZYLAXXmLkSUCuUTn1g7o,True,30483072,1728484,7518,3759,3759,5HnvdJnCCcmRsm4GkXnYWd4q9RpwuvYDGEUMPkYR3Ts9,1325932,22092993,-20767061,434
2022-05-09 19:56:28-04:00,21517,75fFExuVbQ6dKrSdQK13NMMN1ZoGbaEXUpR8Yfr6ruTG,55Qjxz3zoBnt3sfFEHsyoC4HJVqEHZxcnRCAggVTiAcx,True,36322282,1972108,8532,4266,4266,6L1WYrPiCMyi7XemPww4B4hvpKD1LQKD4RpiSKmrmgSC,1571492,26508326,-24936834,432
2022-05-09 19:56:37-04:00,21518,6vWL8gpQtX2s3C9eqrUTnrK8iEUSMpAPh4C2Jsch7VF3,dgGLcKRBKvEWdXULyFLpxxcAEdMwiBVyXJB775RoDcJ,True,30492480,1729085,7549,3774,3775,6L1WYrPiCMyi7XemPww4B4hvpKD1LQKD4RpiSKmrmgSC,1331428,22089055,-20757627,436
2022-05-09 19:56:37-04:00,21519,9eWpSyu71Z6dmx7yTh7WrbVScdrrZN14d5tfmqEGFgXt,2r89PFKSD9zmSp2Wyx4CQ75HAtmUgwhAS2oG5MuYuiV6,True,55918757,10108613,39288,19644,19644,6L1WYrPiCMyi7XemPww4B4hvpKD1LQKD4RpiSKmrmgSC,2173399,29149103,-26975704,388
2022-05-09 19:56:39-04:00,21520,CZhzJ91hP1pFbNNz7YnUKXznvs6ZFVSRNLbe1SaTw29o,X3B4LpHFfeJPmCnEmRQ8V6MNMi7KpTE4MLD7LHYXUwy,True,105401072,12013590,43596,21798,21798,6L1WYrPiCMyi7XemPww4B4hvpKD1LQKD4RpiSKmrmgSC,3824952,34567529,-30742577,362
2022-05-09 19:56:39-04:00,21521,Bk5cwVTwW7qznfwZAuRgwLG8pe5RM5PfsstsRSWfDyWd,5jDkvsWVT7ymBbnnTYqoQYg2K2pJMRN7kGw1Bja55R7o,False,1668983,1668983,49584,2479,47105,3zqXX6kzhkbW3d4TwD2CNjMRwxTbREXySekvq37kfCNk,49584,875601,-826017,297
2022-05-09 19:56:42-04:00,21522,E6naKBMrPoQXUx76w4t88u2DYhqyPSqp7u8h2xF5p7xm,Eg7ZTk4aG8BzNTNQxX2ae5c1HLeW5AHe8aTY97nA3gJv,True,36337450,1970644,8460,4230,4230,5HnvdJnCCcmRsm4GkXnYWd4q9RpwuvYDGEUMPkYR3Ts9,1560028,26472676,-24912648,429
2022-05-09 19:56:43-04:00,21523,Eo5LYLiUCspbrK13ker5skq9kMjnpUJEJPSbRDWjH6V4,GefeNAw5BdDkibatZknZVGsLhkfc8wfxriEfjHNpvMPm,True,171653449,42913362,123858,61929,61929,3zqXX6kzhkbW3d4TwD2CNjMRwxTbREXySekvq37kfCNk,4954339,73859590,-68905251,288
2022-05-09 19:56:44-04:00,21524,CS7E1f7LjgmwFUs85CMG45Q6qDy9NqmuGfJywfjjrf1U,Bem68iukByPcPpgzi63FufEhjTigKkPeeW2gY4o8zK2Z,True,125002152,31250538,189547,94773,94774,6L1WYrPiCMyi7XemPww4B4hvpKD1LQKD4RpiSKmrmgSC,7581915,79897170,-72315255,606
2022-05-09 19:56:46-04:00,21525,DRVtEzZs9u9ysrcANZLEjrvbuuGqYn77v2h4cDFKuNUx,Fv9qiMZhuSBL2cs9AWUYbDLQjB46W2ZwrhxaNXtPLDpC,True,241557285,60389321,182479,91239,91240,5HnvdJnCCcmRsm4GkXnYWd4q9RpwuvYDGEUMPkYR3Ts9,7299160,50841402,-43542242,302
2022-05-09 19:56:48-04:00,21526,4LKfqVYzFVztXomWdyfkNyDfPyNMxAiHU7rwmJrZkHx7,6Ysdyg5TJ6YsjMX1YuuLTrp3Q1vyQU7jEuBsrqGW7kSH,False,18568737,18568737,542417,27120,515297,6L1WYrPiCMyi7XemPww4B4hvpKD1LQKD4RpiSKmrmgSC,542417,8881575,-8339158,292
2022-05-09 19:56:49-04:00,21527,8Whh4Vq7cjwwWagFE37NeXajMPokQQEJy4Mpv4FrV4ZG,43xrKAPrrjRZbdTc8ZQ1QkeUPhf6MZ8UuqFZPJ2AYhAH,True,35069944,8767486,25345,12672,12673,5HnvdJnCCcmRsm4GkXnYWd4q9RpwuvYDGEUMPkYR3Ts9,1013837,16776322,-15762485,289
2022-05-09 19:57:04-04:00,21528,D7dQmfuiK31BHRG4Y9wpkRu7sChiZhTYes47YPNGvnpF,AN5jjtJp7d9DG3xJo3DnDRmGmzj5pKKy1owwVuREpReQ,True,72932334,18233083,113059,56529,56530,F31bVJvHB2XkhGdgjyTim48hY2cLFEx661AiPS3SzYJ2,4522396,14931197,-10408801,620
2022-05-09 19:57:24-04:00,21529,92cQnCMBkPL8DmE4xYQXJVAQ8EXk3moXXVHaM2zQT4uj,A5MAQitMT3yojsCtjyq9pypZQP9Df6m95X5srsEXaxr6,True,282979749,70744937,213614,106807,106807,6L1WYrPiCMyi7XemPww4B4hvpKD1LQKD4RpiSKmrmgSC,8544596,355670780,-347126184,301
2022-05-09 19:57:24-04:00,21530,AzBK36Qny8VFVN6jFg8CBGsRU2FbdZYDMsgbJeRfZjRs,GSZ8veMKWDmYpAkZxtDL6DLreo9R6d7YhyGix4a6TgBJ,True,34246695,3625922,15107,7553,7554,2a35JJeTUW1pm6M3e8DHCjp8qr4vbc2cRPhuzZWyFzYd,1426901,23430301,-22003400,416
2022-05-09 19:57:31-04:00,21531,EVMrznfJS54BZiywDD2WhUtxzicDtbEpm2a5yLrtCgRF,CpzsMYVYvKg8ihrX1cKRw7TDEYwD3kAyiX92hsf2KiTz,True,26544166,1779577,8315,4157,4158,5HnvdJnCCcmRsm4GkXnYWd4q9RpwuvYDGEUMPkYR3Ts9,1240280,24007102,-22766822,467
2022-05-09 19:57:32-04:00,21532,EHi1UBG8wMUFZECktsFUZkGjJPaBNEedswS62hyYn6jC,Drx9ErQhAjnPuJ83LPYFnY5ZV5XDzGuXDuSf16VqWayp,True,27767209,1470730,5458,2729,2729,68sueyVfmy5ToEGtLFGDkwebX47xAmzyXE29z8JrmcWv,1030522,23386909,-22356387,371
2022-05-09 19:57:40-04:00,21533,Y3bqEwy46XfvKCYHYnEdBqsUAVMBRfq5qLtmvEA6Kb1,GCDPpvCjwjBJp8VZ4hTmnmeG3uVny1PcAmKQKCXHw3nV,True,28688150,1467116,6217,3108,3109,68sueyVfmy5ToEGtLFGDkwebX47xAmzyXE29z8JrmcWv,1215751,20965202,-19749451,423
2022-05-09 19:57:40-04:00,21534,DuNLzKUCCxrZY6JyBGwKJEJRygBd2vm1CesXgMDhfhn6,4PGnrVg4NTCuW5sZmkpg6g5ria57Jvhoaktsi9J8Ay13,True,52104886,13026221,79771,39885,39886,2a35JJeTUW1pm6M3e8DHCjp8qr4vbc2cRPhuzZWyFzYd,3190875,24366040,-21175165,612
2022-05-09 19:57:42-04:00,21535,BQYbbwd1MLtj6fBuBiTncAaXdAqKWa1JbcbGkZbLA728,2Wsyr6KoMbSVSvFy3YzutuEQ6skGUZyVHGM42SN4eU98,True,1822566019,142981117,485243,242621,242622,4yhyLx1phodwcvvwVU2bramHcdbJYvfadd7pANsRzX8M,61853530,2478361196,-2416507666,339
2022-05-09 19:57:46-04:00,21536,J8FKUM9x5gNzz4wEpBEu5jCiy9Z115xzVtxy6tjDh5xK,BGUQKXLhZdjkPDJEREXyyTPwQFZAFuGMdxBzFhPqfVkr,True,36584999,4173663,14867,7433,7434,3zqXX6kzhkbW3d4TwD2CNjMRwxTbREXySekvq37kfCNk,1303303,17219083,-15915780,356
2022-05-09 19:57:46-04:00,21537,4xmumckS9d4DrdVoJbxvrpZjFCmobujksAq7eisULMfC,Fr9YnDVQ3Z8VExMRvsZyCZV6B13wBgqnc5zHPFM3xVYf,True,102412777,25603194,75118,37559,37559,F31bVJvHB2XkhGdgjyTim48hY2cLFEx661AiPS3SzYJ2,3004731,58088416,-55083685,293
2022-05-09 19:57:48-04:00,21538,9cE3sPydeiFpAZajTK8ewa8pQLT5MvQPemwrHJUyzH1C,2XB63S8WX5FWQYTKuDrq75aMFVHZ3KCuZDiP5Cy95VPe,True,228067345,57016836,348092,174046,174046,3zqXX6kzhkbW3d4TwD2CNjMRwxTbREXySekvq37kfCNk,13923701,95272185,-81348484,610
2022-05-09 19:57:50-04:00,21539,DKHnugPqCk62V5SC2BLqYJ6CrUFkZe3X45DM3PncjfrV,5Wk61GCcKBBfx2EtcBvKUaMtQKFSJUBBDsWbonTvcun1,True,36282869,1979106,8392,4196,4196,3zqXX6kzhkbW3d4TwD2CNjMRwxTbREXySekvq37kfCNk,1538714,26505963,-24967249,424
2022-05-09 19:57:54-04:00,21540,4uNUqcnkVMJH9XZWzukBy8smUa9KUNs8kLMDpyfbWQMz,4kqp3UGFJ7pSUU17zw31nNqLH4SMhU4qpyG8T9ynY3d3,True,262093196,65523299,182996,91498,91498,F31bVJvHB2XkhGdgjyTim48hY2cLFEx661AiPS3SzYJ2,7319844,59668871,-52349027,279
2022-05-09 19:57:54-04:00,21541,8ZsXyXgAV71qRor7YWFC8zMntN73XWm7GhTkE7XgV7Rq,D4QLFpaaetu9TcVxQH9j9WAXK7ZVKKLnW6KtHK6W9MZ9,True,28646789,1467106,6135,3067,3068,5HnvdJnCCcmRsm4GkXnYWd4q9RpwuvYDGEUMPkYR3Ts9,1198114,20988933,-19790819,418
2022-05-09 19:57:56-04:00,21542,7bTEcer5k6PypbgPJEFqpTJgiwhU4oJARe4ioWYPy4na,Gu3g7ghunEhPxMPaFQ5r9BC4ZYLAXXmLkSUCuUTn1g7o,True,28631693,1465139,6117,3058,3059,8sEswn3kzEhnYjAZVvCQnHEUvYd7pFVvc2Xc2Kd1BpbC,1195519,21001454,-19805935,417
2022-05-09 19:57:56-04:00,21543,AzBK36Qny8VFVN6jFg8CBGsRU2FbdZYDMsgbJeRfZjRs,GSZ8veMKWDmYpAkZxtDL6DLreo9R6d7YhyGix4a6TgBJ,True,30530589,1721832,7453,3726,3727,68sueyVfmy5ToEGtLFGDkwebX47xAmzyXE29z8JrmcWv,1321610,22041117,-20719507,432
2022-05-09 19:57:58-04:00,21544,75fFExuVbQ6dKrSdQK13NMMN1ZoGbaEXUpR8Yfr6ruTG,55Qjxz3zoBnt3sfFEHsyoC4HJVqEHZxcnRCAggVTiAcx,True,34200982,3620578,14966,7483,7483,3zqXX6kzhkbW3d4TwD2CNjMRwxTbREXySekvq37kfCNk,1413768,23471904,-22058136,413
2022-05-09 19:57:58-04:00,21545,CpSUMCkXamfGm1FyxYQgmAKh1jaJ1DdmrRHxHANJpc3Q,2rVXtfeMhRgmU6eNBvg6RvQ4jRCAmgKVgLS8bPppCb8Q,True,36214710,1963863,8123,4061,4062,3zqXX6kzhkbW3d4TwD2CNjMRwxTbREXySekvq37kfCNk,1498047,26531250,-25033203,413
2022-05-09 19:58:00-04:00,21546,3VYtHvoT9wi4K1PBjg6JjCf6U9fVPDf6tX9jyRRvLxcg,Ba5fjpVyAxLbiP6hYJmrxzougi7JUEDfDLKBxSbbTL7q,True,246304766,61576191,176144,88072,88072,F31bVJvHB2XkhGdgjyTim48hY2cLFEx661AiPS3SzYJ2,7045776,27391391,-20345615,286
2022-05-09 19:58:00-04:00,21547,7H7up1CfeLA8r7P4yGjTWt3PQnA5TEUrhWadj8hoioGf,HoaZyS9FsnTurhqYGoUj9m6akA8dahexXavt8aXTQctS,True,128208653,32052161,95382,47691,47691,F31bVJvHB2XkhGdgjyTim48hY2cLFEx661AiPS3SzYJ2,3815325,22995899,-19180574,297
2022-05-09 19:58:00-04:00,21548,6vWL8gpQtX2s3C9eqrUTnrK8iEUSMpAPh4C2Jsch7VF3,dgGLcKRBKvEWdXULyFLpxxcAEdMwiBVyXJB775RoDcJ,True,28657052,1468091,6237,3118,3119,Hu94aiQWvce6THeGyCFqGRPM1pQrK3ihzkcXo1EpJcJL,1217536,20998090,-19780554,424
2022-05-09 19:58:07-04:00,21549,DKHnugPqCk62V5SC2BLqYJ6CrUFkZe3X45DM3PncjfrV,5Wk61GCcKBBfx2EtcBvKUaMtQKFSJUBBDsWbonTvcun1,True,34185932,3621366,14962,7481,7481,5HnvdJnCCcmRsm4GkXnYWd4q9RpwuvYDGEUMPkYR3Ts9,1412491,23476680,-22064189,413
2022-05-09 19:58:08-04:00,21550,6xeNr9LhAfC6FRV62dALYdgx3bsoUpUpmEBiUPYCV5fz,8GP5cEpfNTEjvqm9usBUXs7jPCK5RciqjVJqtvX9fuGs,True,108305863,27076465,80019,40009,40010,5HnvdJnCCcmRsm4GkXnYWd4q9RpwuvYDGEUMPkYR3Ts9,3200770,30986081,-27785311,295
2022-05-09 19:58:08-04:00,21551,BQYbbwd1MLtj6fBuBiTncAaXdAqKWa1JbcbGkZbLA728,2Wsyr6KoMbSVSvFy3YzutuEQ6skGUZyVHGM42SN4eU98,True,1675827039,133477345,458859,229429,229430,4yhyLx1phodwcvvwVU2bramHcdbJYvfadd7pANsRzX8M,57610424,2175858832,-2118248408,343
2022-05-09 19:58:09-04:00,21552,6fqbSyhh3PPdgRcLraHb7Jahj9s1oHHeX3SsjNSsGa6t,GpRUow48TYgttdYfsygbgjYQcmHyYjWETUDjDVphEgwq,True,477884225,119471056,691455,345727,345728,C4UnXuShCvjSMgBAgVNMy1oakxCNk1et27A82fywU112,27658206,200650307,-172992101,578
2022-05-09 19:58:09-04:00,21553,Y3bqEwy46XfvKCYHYnEdBqsUAVMBRfq5qLtmvEA6Kb1,GCDPpvCjwjBJp8VZ4hTmnmeG3uVny1PcAmKQKCXHw3nV,True,27132862,2677236,11064,5532,5532,68sueyVfmy5ToEGtLFGDkwebX47xAmzyXE29z8JrmcWv,1121362,18676102,-17554740,413
2022-05-09 19:58:09-04:00,21554,2A7ZobmSAddaDW7xJUbXKCKnPmnCd9hMV5UtzSbdgBMg,9aXtTVwGPwJoPL5V16y5T4SnAg8cAoF5YT5VsKcfS5GD,False,13256327,13256327,790751,39537,751214,3zqXX6kzhkbW3d4TwD2CNjMRwxTbREXySekvq37kfCNk,790751,19696107,-18905356,596
2022-05-09 19:58:12-04:00,21555,A5NXadGWnFZRoHEn1dKTRjcXgWmfMLMyJdpF4rQPZyRR,ALs3Zfotc4c4A6TFDMbd5GM5whK1dTYSnGrHiMBWmApH,True,81302785,20325696,60526,30263,30263,F31bVJvHB2XkhGdgjyTim48hY2cLFEx661AiPS3SzYJ2,2421053,7993434,-5572381,297
2022-05-09 19:58:12-04:00,21556,2iHmrYwG4wYoUqX1uZhx1TMAWn3JdUx3idqQ7T5e1eAx,EvtnpMHszPxf8rgvmdfmnpwwcCDz135CN9SXZwRvTorG,True,55285807,13821451,39750,19875,19875,5HnvdJnCCcmRsm4GkXnYWd4q9RpwuvYDGEUMPkYR3Ts9,1590037,158098255,-156508218,287
2022-05-09 19:58:12-04:00,21557,Guz4ofgn6nw3yfBYbPKx3828HGB9uGURTpAPrcNiJprv,5fkvyvCF2YTXw1rGKy5YjHH175sD9vnF1QGW7gEb7sFa,True,73139631,8789589,45757,22878,22879,5HnvdJnCCcmRsm4GkXnYWd4q9RpwuvYDGEUMPkYR3Ts9,3807524,39673129,-35865605,520
2022-05-09 19:58:12-04:00,21558,E6naKBMrPoQXUx76w4t88u2DYhqyPSqp7u8h2xF5p7xm,Eg7ZTk4aG8BzNTNQxX2ae5c1HLeW5AHe8aTY97nA3gJv,True,34173995,3621897,14400,7200,7200,6L1WYrPiCMyi7XemPww4B4hvpKD1LQKD4RpiSKmrmgSC,1358757,23434860,-22076103,397
2022-05-09 19:58:13-04:00,21559,CpSUMCkXamfGm1FyxYQgmAKh1jaJ1DdmrRHxHANJpc3Q,2rVXtfeMhRgmU6eNBvg6RvQ4jRCAmgKVgLS8bPppCb8Q,True,34191799,3622603,15159,7579,7580,3zqXX6kzhkbW3d4TwD2CNjMRwxTbREXySekvq37kfCNk,1430876,23487536,-22056660,418
2022-05-09 19:58:14-04:00,21560,CZhzJ91hP1pFbNNz7YnUKXznvs6ZFVSRNLbe1SaTw29o,X3B4LpHFfeJPmCnEmRQ8V6MNMi7KpTE4MLD7LHYXUwy,True,92955061,5092339,18346,9173,9173,C4UnXuShCvjSMgBAgVNMy1oakxCNk1et27A82fywU112,3348935,32459657,-29110722,360
2022-05-09 19:58:14-04:00,21561,GCNi25P1Ywvfx5JpyxFVV68sRkio7LEhFgY85ZqveKR3,34mxz8fCss7KNAbEi2Wj9z5dTgXCGxuq2vyqzBPChtmq,True,106804668,26701167,79476,39738,39738,F31bVJvHB2XkhGdgjyTim48hY2cLFEx661AiPS3SzYJ2,3179078,54324611,-51145533,297
2022-05-09 19:58:14-04:00,21562,Eo5LYLiUCspbrK13ker5skq9kMjnpUJEJPSbRDWjH6V4,GefeNAw5BdDkibatZknZVGsLhkfc8wfxriEfjHNpvMPm,True,127747673,31936918,95951,47975,47976,3zqXX6kzhkbW3d4TwD2CNjMRwxTbREXySekvq37kfCNk,3838067,56509814,-52671747,300
2022-05-09 19:58:16-04:00,21563,F2AU2PjaSmHxWWhkz8XxMggkCMWbMVgawt89tSnYS6RL,ET9febRJiW197DYMaJbgk3kWsAeFv5f4peQ4vFCVppK6,True,198344276,49586069,308084,154042,154042,F31bVJvHB2XkhGdgjyTim48hY2cLFEx661AiPS3SzYJ2,12323391,46351997,-34028606,621
2022-05-09 19:58:20-04:00,21564,8Whh4Vq7cjwwWagFE37NeXajMPokQQEJy4Mpv4FrV4ZG,43xrKAPrrjRZbdTc8ZQ1QkeUPhf6MZ8UuqFZPJ2AYhAH,False,26100521,26100521,786555,39327,747228,6L1WYrPiCMyi7XemPww4B4hvpKD1LQKD4RpiSKmrmgSC,786555,12810373,-12023818,301
2022-05-09 19:58:24-04:00,21565,FRbeFwhUYCiHW5oP26mad8KND7CCYDbfnoNxX7GuXVp8,GrzXKxPX2WDka8i2D8sunMUsrsThKasQi8NYLwuCGygV,True,25730428,2415880,10112,5056,5056,5HnvdJnCCcmRsm4GkXnYWd4q9RpwuvYDGEUMPkYR3Ts9,1077039,14711804,-13634765,418
2022-05-09 19:58:30-04:00,21566,ENVy41YA1Rk88LwzTpofmECuU8EXXrKa3vFCPQnV75tB,5rQPvvuGRVKup9sXTyqpjt1MKziDPmhzNWRaDTndyQXU,True,387145808,96786452,289628,144814,144814,C4UnXuShCvjSMgBAgVNMy1oakxCNk1et27A82fywU112,11585158,62349156,-50763998,299
2022-05-09 19:58:34-04:00,21567,EVMrznfJS54BZiywDD2WhUtxzicDtbEpm2a5yLrtCgRF,CpzsMYVYvKg8ihrX1cKRw7TDEYwD3kAyiX92hsf2KiTz,True,24643382,1649934,7436,3718,3718,C4UnXuShCvjSMgBAgVNMy1oakxCNk1et27A82fywU112,1110758,21852157,-20741399,450
2022-05-09 19:58:37-04:00,21568,E6naKBMrPoQXUx76w4t88u2DYhqyPSqp7u8h2xF5p7xm,Eg7ZTk4aG8BzNTNQxX2ae5c1HLeW5AHe8aTY97nA3gJv,True,30522724,1719705,7408,3704,3704,6L1WYrPiCMyi7XemPww4B4hvpKD1LQKD4RpiSKmrmgSC,1314983,22042355,-20727372,430
2022-05-09 19:58:37-04:00,21569,7bTEcer5k6PypbgPJEFqpTJgiwhU4oJARe4ioWYPy4na,Gu3g7ghunEhPxMPaFQ5r9BC4ZYLAXXmLkSUCuUTn1g7o,True,27097135,2673773,11051,5525,5526,3zqXX6kzhkbW3d4TwD2CNjMRwxTbREXySekvq37kfCNk,1119983,18710474,-17590491,413
2022-05-09 19:58:43-04:00,21570,AZq9LHFskHUujKDJZTpWhpP9LRaDjQKcrf2Bz2eY6TtN,EtStidHXHYYQJ6E1h7LHmgewtiK7AjMAsDBw4XBCrdQs,True,63049025,15762256,97410,48705,48705,C4UnXuShCvjSMgBAgVNMy1oakxCNk1et27A82fywU112,3896439,48422222,-44525783,618
2022-05-09 19:58:43-04:00,21571,75fFExuVbQ6dKrSdQK13NMMN1ZoGbaEXUpR8Yfr6ruTG,55Qjxz3zoBnt3sfFEHsyoC4HJVqEHZxcnRCAggVTiAcx,True,30488867,1717795,7365,3682,3683,3zqXX6kzhkbW3d4TwD2CNjMRwxTbREXySekvq37kfCNk,1307265,22075730,-20768465,428
2022-05-09 19:58:44-04:00,21572,J8FKUM9x5gNzz4wEpBEu5jCiy9Z115xzVtxy6tjDh5xK,BGUQKXLhZdjkPDJEREXyyTPwQFZAFuGMdxBzFhPqfVkr,True,32294845,3439239,12480,6240,6240,6L1WYrPiCMyi7XemPww4B4hvpKD1LQKD4RpiSKmrmgSC,1171945,16127884,-14955939,362
2022-05-09 19:58:44-04:00,21573,695LQDJuM8zR7b2Dan3RxzmqcZfd7fgfyikX7qA6bncD,Cw4ywkJVVAi8ebJp7Hb4cznTX2quU8HRdjUVJtD3AbXH,True,40289398,10072349,29849,14924,14925,5HnvdJnCCcmRsm4GkXnYWd4q9RpwuvYDGEUMPkYR3Ts9,1193970,23394572,-22200602,296
2022-05-09 19:58:44-04:00,21574,8ZsXyXgAV71qRor7YWFC8zMntN73XWm7GhTkE7XgV7Rq,D4QLFpaaetu9TcVxQH9j9WAXK7ZVKKLnW6KtHK6W9MZ9,True,27107345,2673801,11043,5521,5522,68sueyVfmy5ToEGtLFGDkwebX47xAmzyXE29z8JrmcWv,1119641,18699904,-17580263,413
2022-05-09 19:58:46-04:00,21575,AzBK36Qny8VFVN6jFg8CBGsRU2FbdZYDMsgbJeRfZjRs,GSZ8veMKWDmYpAkZxtDL6DLreo9R6d7YhyGix4a6TgBJ,True,28687006,1453357,6041,3020,3021,5HnvdJnCCcmRsm4GkXnYWd4q9RpwuvYDGEUMPkYR3Ts9,1192406,20942992,-19750586,415
2022-05-09 19:58:59-04:00,21576,GMpoV2jRyLdf2V3Gb5TQZ5gEs5ftMjD3JhFUzkA6fWVz,5bi814d5gdToTLVWCmbdB6J15kMdsTQk74cZTRd62p81,True,39060498,9765124,69581,34790,34791,72FwbpFGoLEazJEdpqNtPNefsadUrimUqma9wSoy4qiS,2783270,20282971,-17499701,712
2022-05-09 19:59:01-04:00,21577,Y3bqEwy46XfvKCYHYnEdBqsUAVMBRfq5qLtmvEA6Kb1,GCDPpvCjwjBJp8VZ4hTmnmeG3uVny1PcAmKQKCXHw3nV,True,24377812,1282810,5433,2716,2717,8sEswn3kzEhnYjAZVvCQnHEUvYd7pFVvc2Xc2Kd1BpbC,1032484,17592262,-16559778,423
2022-05-09 19:59:04-04:00,21578,CS7E1f7LjgmwFUs85CMG45Q6qDy9NqmuGfJywfjjrf1U,Bem68iukByPcPpgzi63FufEhjTigKkPeeW2gY4o8zK2Z,True,92104276,23026069,143625,71812,71813,C4UnXuShCvjSMgBAgVNMy1oakxCNk1et27A82fywU112,5745030,61629070,-55884040,623
2022-05-09 19:59:05-04:00,21579,Bzp3ZUxzRWqW4QoLq9PtKN1HQeSaKXFQrX1G3a4ocrre,H12B3p4v1ZtZ9gaSgpxCJsKXmmEjiqaRZQzexjzAhevo,True,544341412,75418748,334584,167292,167292,5HnvdJnCCcmRsm4GkXnYWd4q9RpwuvYDGEUMPkYR3Ts9,24148988,341028169,-316879181,443
2022-05-09 19:59:05-04:00,21580,85gxgPczGaY9xtDwEvNrWLPhsJFqHPCG1DbbedtFwsVK,AhZjmArZneA5QoTrL8TxzLni6aUxQYZbTYym1YcY4Qhz,True,51414957,12853739,78672,39336,39336,C4UnXuShCvjSMgBAgVNMy1oakxCNk1et27A82fywU112,3146890,19498086,-16351196,612
2022-05-09 19:59:06-04:00,21581,G8Bnx7PhHFxsqY2KTVPpwwDWUend8DmzLNQfSaevrEDz,JCvjtN3aZsaSwQPaZcMFnQBm8NtgopQqdPa6FKrH4Bcm,True,1329579376,134968133,686283,343141,343142,2xTUy2RS74GJMMDnmFaegMzFLn19RVfYG4CibhBmjP1i,67606269,556442071,-488835802,508
2022-05-09 19:59:09-04:00,21582,CpSUMCkXamfGm1FyxYQgmAKh1jaJ1DdmrRHxHANJpc3Q,2rVXtfeMhRgmU6eNBvg6RvQ4jRCAmgKVgLS8bPppCb8Q,True,30463613,1716112,7380,3690,3690,C4UnXuShCvjSMgBAgVNMy1oakxCNk1et27A82fywU112,1310134,22094979,-20784845,430
2022-05-09 19:59:15-04:00,21583,4X3JtctRhYihcyDkxk1B4QNWt15JkiSWCtLu9sWh9T88,BqxESjHzsRi9RBQA8v6uBCACDPTshEpaWPd4c8JBDqa8,True,1082932005,270733001,1690647,845323,845324,gjBMZYVujDjD1ECG4i97M8Q3gV9ESnwwTSUGropkusj,67625910,502308322,-434682412,624
2022-05-09 19:59:15-04:00,21584,6vWL8gpQtX2s3C9eqrUTnrK8iEUSMpAPh4C2Jsch7VF3,dgGLcKRBKvEWdXULyFLpxxcAEdMwiBVyXJB775RoDcJ,True,27052334,2667304,10595,5297,5298,3zqXX6kzhkbW3d4TwD2CNjMRwxTbREXySekvq37kfCNk,1074672,18709944,-17635272,397
2022-05-09 19:59:18-04:00,21585,DKHnugPqCk62V5SC2BLqYJ6CrUFkZe3X45DM3PncjfrV,5Wk61GCcKBBfx2EtcBvKUaMtQKFSJUBBDsWbonTvcun1,True,30453978,1707728,7216,3608,3608,3zqXX6kzhkbW3d4TwD2CNjMRwxTbREXySekvq37kfCNk,1286941,22083080,-20796139,422
2022-05-09 19:59:37-04:00,21586,BQYbbwd1MLtj6fBuBiTncAaXdAqKWa1JbcbGkZbLA728,2Wsyr6KoMbSVSvFy3YzutuEQ6skGUZyVHGM42SN4eU98,True,1538660014,124342749,432038,216019,216019,3zqXX6kzhkbW3d4TwD2CNjMRwxTbREXySekvq37kfCNk,53461885,2050142151,-1996680266,347
2022-05-09 19:59:38-04:00,21587,E6naKBMrPoQXUx76w4t88u2DYhqyPSqp7u8h2xF5p7xm,Eg7ZTk4aG8BzNTNQxX2ae5c1HLeW5AHe8aTY97nA3gJv,True,28702288,1448936,6092,3046,3046,2a35JJeTUW1pm6M3e8DHCjp8qr4vbc2cRPhuzZWyFzYd,1206844,20942151,-19735307,420
2022-05-09 19:59:38-04:00,21588,8ZsXyXgAV71qRor7YWFC8zMntN73XWm7GhTkE7XgV7Rq,D4QLFpaaetu9TcVxQH9j9WAXK7ZVKKLnW6KtHK6W9MZ9,True,24357540,1281524,5432,2716,2716,68sueyVfmy5ToEGtLFGDkwebX47xAmzyXE29z8JrmcWv,1032594,17612651,-16580057,423
2022-05-09 19:59:41-04:00,21589,DGgBcketqLbZLyfCJfbiyio4Aw9mty1v7EpzSFEgVppz,7AxvGswkMr48qahGNGDfq6wAmfS1qfHh5rrvUmTFUYVJ,True,57607433018,8399229502,25207279,12603639,12603640,GXyFXZMNk2NFyEzw6JetVqsujqcz2yCixH7n8EpDJYWD,1728880834,7496976168,-5768095334,300
2022-05-09 19:59:42-04:00,21590,7bTEcer5k6PypbgPJEFqpTJgiwhU4oJARe4ioWYPy4na,Gu3g7ghunEhPxMPaFQ5r9BC4ZYLAXXmLkSUCuUTn1g7o,False,24301394,24301394,986961,49348,937613,3zqXX6kzhkbW3d4TwD2CNjMRwxTbREXySekvq37kfCNk,986964,17623183,-16636219,406
2022-05-09 19:59:44-04:00,21591,AzBK36Qny8VFVN6jFg8CBGsRU2FbdZYDMsgbJeRfZjRs,GSZ8veMKWDmYpAkZxtDL6DLreo9R6d7YhyGix4a6TgBJ,True,27130933,2685280,10725,5362,5363,3zqXX6kzhkbW3d4TwD2CNjMRwxTbREXySekvq37kfCNk,1083649,18640306,-17556657,399
2022-05-09 19:59:45-04:00,21592,CZhzJ91hP1pFbNNz7YnUKXznvs6ZFVSRNLbe1SaTw29o,X3B4LpHFfeJPmCnEmRQ8V6MNMi7KpTE4MLD7LHYXUwy,True,87374136,18067216,58766,29383,29383,5HnvdJnCCcmRsm4GkXnYWd4q9RpwuvYDGEUMPkYR3Ts9,2842003,28148189,-25306186,325
2022-05-09 19:59:45-04:00,21593,75fFExuVbQ6dKrSdQK13NMMN1ZoGbaEXUpR8Yfr6ruTG,55Qjxz3zoBnt3sfFEHsyoC4HJVqEHZxcnRCAggVTiAcx,True,28615901,1440385,5761,2880,2881,5HnvdJnCCcmRsm4GkXnYWd4q9RpwuvYDGEUMPkYR3Ts9,1144729,20973186,-19828457,400
2022-05-09 19:59:45-04:00,21594,DvXQbVWbiNv5kaHLGcvKewB6wSiUewpArSS3iyBK5nHG,7zt5Pxcbmwt3h7tALUhKnuTF5R59U763e2h8AQf398zy,True,47214160,11803540,35175,17587,17588,3zqXX6kzhkbW3d4TwD2CNjMRwxTbREXySekvq37kfCNk,1407013,103163518,-101756505,298
2022-05-09 19:59:48-04:00,21595,DKHnugPqCk62V5SC2BLqYJ6CrUFkZe3X45DM3PncjfrV,5Wk61GCcKBBfx2EtcBvKUaMtQKFSJUBBDsWbonTvcun1,True,28663444,1457295,6085,3042,3043,3zqXX6kzhkbW3d4TwD2CNjMRwxTbREXySekvq37kfCNk,1196919,20971085,-19774166,417
2022-05-09 19:59:48-04:00,21596,9cE3sPydeiFpAZajTK8ewa8pQLT5MvQPemwrHJUyzH1C,2XB63S8WX5FWQYTKuDrq75aMFVHZ3KCuZDiP5Cy95VPe,True,167935002,41983750,261502,130751,130751,3zqXX6kzhkbW3d4TwD2CNjMRwxTbREXySekvq37kfCNk,10460102,74587718,-64127616,622
2022-05-09 19:59:50-04:00,21597,CpSUMCkXamfGm1FyxYQgmAKh1jaJ1DdmrRHxHANJpc3Q,2rVXtfeMhRgmU6eNBvg6RvQ4jRCAmgKVgLS8bPppCb8Q,True,28661008,1446064,6136,3068,3068,3zqXX6kzhkbW3d4TwD2CNjMRwxTbREXySekvq37kfCNk,1216261,20991210,-19774949,424
2022-05-09 19:59:50-04:00,21598,Guz4ofgn6nw3yfBYbPKx3828HGB9uGURTpAPrcNiJprv,5fkvyvCF2YTXw1rGKy5YjHH175sD9vnF1QGW7gEb7sFa,True,63794701,6518042,32760,16380,16380,72FwbpFGoLEazJEdpqNtPNefsadUrimUqma9wSoy4qiS,3206426,35461923,-32255497,502
2022-05-09 19:59:51-04:00,21599,H9pFRayNBHTAhsbtGyfs1XXUWGxAbw7SgpT1xdrSRWEY,9LNreyXuhgyLCDYViNyA1jUw6h1nv4GmDtTYMoUQBqCG,True,437862001,62335181,179568,89784,89784,F31bVJvHB2XkhGdgjyTim48hY2cLFEx661AiPS3SzYJ2,12613451,221980163,-209366712,288
2022-05-09 19:59:51-04:00,21600,6vWL8gpQtX2s3C9eqrUTnrK8iEUSMpAPh4C2Jsch7VF3,dgGLcKRBKvEWdXULyFLpxxcAEdMwiBVyXJB775RoDcJ,True,24322238,1281834,5276,2638,2638,3zqXX6kzhkbW3d4TwD2CNjMRwxTbREXySekvq37kfCNk,1001285,17616641,-16615356,411
2022-05-09 19:59:56-04:00,21601,DRVtEzZs9u9ysrcANZLEjrvbuuGqYn77v2h4cDFKuNUx,Fv9qiMZhuSBL2cs9AWUYbDLQjB46W2ZwrhxaNXtPLDpC,True,179234311,44808577,129575,64787,64788,3zqXX6kzhkbW3d4TwD2CNjMRwxTbREXySekvq37kfCNk,5183028,39774020,-34590992,289
2022-05-09 20:00:04-04:00,21602,EHi1UBG8wMUFZECktsFUZkGjJPaBNEedswS62hyYn6jC,Drx9ErQhAjnPuJ83LPYFnY5ZV5XDzGuXDuSf16VqWayp,False,26191993,26191993,916237,45811,870426,3zqXX6kzhkbW3d4TwD2CNjMRwxTbREXySekvq37kfCNk,916238,21506758,-20590520,349
2022-05-09 20:00:04-04:00,21603,9NJtZKn573HJciV3v61nZVtjaasutgardSwQ8DfQMraZ,GqUFcQEEELDaQEgYv5aEg3e5NYtUs9hy5rU3cK7tAqXq,True,73227070,18306767,52078,26039,26039,F31bVJvHB2XkhGdgjyTim48hY2cLFEx661AiPS3SzYJ2,2083139,45988304,-43905165,284
2022-05-09 20:00:10-04:00,21604,92cQnCMBkPL8DmE4xYQXJVAQ8EXk3moXXVHaM2zQT4uj,A5MAQitMT3yojsCtjyq9pypZQP9Df6m95X5srsEXaxr6,True,210135515,52533878,155353,77676,77677,F31bVJvHB2XkhGdgjyTim48hY2cLFEx661AiPS3SzYJ2,6214158,268659797,-262445639,295
2022-05-09 20:00:12-04:00,21605,8J4BZXZzkK4SmWxc2YoaJRg9ivuuXbdVe5XpEhVds1ZM,3pirVwiye9NftvMpX5F7WpfcGZy5uV3c11xCdkkZbL9D,True,44114270,11028567,31035,15517,15518,72FwbpFGoLEazJEdpqNtPNefsadUrimUqma9wSoy4qiS,1241408,11430953,-10189545,281
2022-05-09 20:00:15-04:00,21606,DuNLzKUCCxrZY6JyBGwKJEJRygBd2vm1CesXgMDhfhn6,4PGnrVg4NTCuW5sZmkpg6g5ria57Jvhoaktsi9J8Ay13,True,38363800,9590950,59905,29952,29953,2a35JJeTUW1pm6M3e8DHCjp8qr4vbc2cRPhuzZWyFzYd,2396239,18992519,-16596280,624
2022-05-09 20:00:19-04:00,21607,m7gf1jAYXBZjRZEY9w4MjPfhzLwgDKaXyaCVhRD6C5E,Aa2aTZnpPux1i5K2MT4i1TsVM8vR7qR7rZGijQW4zpwd,True,68695244,11795626,45785,22892,22893,72FwbpFGoLEazJEdpqNtPNefsadUrimUqma9wSoy4qiS,2666479,44250117,-41583638,388
2022-05-09 20:00:20-04:00,21608,J8FKUM9x5gNzz4wEpBEu5jCiy9Z115xzVtxy6tjDh5xK,BGUQKXLhZdjkPDJEREXyyTPwQFZAFuGMdxBzFhPqfVkr,True,28730991,3129626,11221,5610,5611,3zqXX6kzhkbW3d4TwD2CNjMRwxTbREXySekvq37kfCNk,1030168,15612453,-14582285,358
2022-05-09 20:00:20-04:00,21609,FRbeFwhUYCiHW5oP26mad8KND7CCYDbfnoNxX7GuXVp8,GrzXKxPX2WDka8i2D8sunMUsrsThKasQi8NYLwuCGygV,False,23167299,23167299,918744,45937,872807,72FwbpFGoLEazJEdpqNtPNefsadUrimUqma9wSoy4qiS,918745,13215375,-12296630,396
2022-05-09 20:00:23-04:00,21610,D5VZNThkv6XD6bimPshD2J3PvbPXgCbivZuPfkVxgdjc,8C77LmMk4C3KvyEb1N3scdbAgwN7J45nAcv9tkL5namB,True,48702446,12175611,75891,37945,37946,5HnvdJnCCcmRsm4GkXnYWd4q9RpwuvYDGEUMPkYR3Ts9,3035653,29929225,-26893572,623
2022-05-09 20:00:24-04:00,21611,4xmumckS9d4DrdVoJbxvrpZjFCmobujksAq7eisULMfC,Fr9YnDVQ3Z8VExMRvsZyCZV6B13wBgqnc5zHPFM3xVYf,True,76173357,19043339,57175,28587,28588,68sueyVfmy5ToEGtLFGDkwebX47xAmzyXE29z8JrmcWv,2287033,44236178,-41949145,300
2022-05-09 20:00:56-04:00,21612,6fqbSyhh3PPdgRcLraHb7Jahj9s1oHHeX3SsjNSsGa6t,GpRUow48TYgttdYfsygbgjYQcmHyYjWETUDjDVphEgwq,True,352223988,88055997,519439,259719,259720,C4UnXuShCvjSMgBAgVNMy1oakxCNk1et27A82fywU112,20777570,156714126,-135936556,589
2022-05-09 20:00:57-04:00,21613,Y3bqEwy46XfvKCYHYnEdBqsUAVMBRfq5qLtmvEA6Kb1,GCDPpvCjwjBJp8VZ4hTmnmeG3uVny1PcAmKQKCXHw3nV,False,23026011,23026011,954160,47708,906452,2a35JJeTUW1pm6M3e8DHCjp8qr4vbc2cRPhuzZWyFzYd,954161,16756362,-15802201,414
2022-05-09 20:01:28-04:00,21614,8KzrbHiup39X7Zw9grvh7gS9ZcA1zuhLGqgYguSjwnD6,A2EPmTs73YiS15ZKcjom55huNYaJY3WeP7NBDar1VE3R,False,340905226,340905226,13001231,650061,12351170,DA18qE9qesbBqpwNv1M4befYcNQkbSBSeLPTmQzrmbJw,13001231,526120008,-513118777,381
2022-05-09 20:01:31-04:00,21615,AZq9LHFskHUujKDJZTpWhpP9LRaDjQKcrf2Bz2eY6TtN,EtStidHXHYYQJ6E1h7LHmgewtiK7AjMAsDBw4XBCrdQs,True,45924323,11481080,59837,29918,29919,C4UnXuShCvjSMgBAgVNMy1oakxCNk1et27A82fywU112,2393485,37150422,-34756937,521
2022-05-09 20:01:36-04:00,21616,EVMrznfJS54BZiywDD2WhUtxzicDtbEpm2a5yLrtCgRF,CpzsMYVYvKg8ihrX1cKRw7TDEYwD3kAyiX92hsf2KiTz,False,22875197,22875197,977550,48877,928673,C4UnXuShCvjSMgBAgVNMy1oakxCNk1et27A82fywU112,977551,20097168,-19119617,427
2022-05-09 20:01:36-04:00,21617,4nqsW3XCJxzSsDdQzvE3zeM9nqBv8xVdUG8GxFWn6Edf,6eVvNs2rckFeTGkXZgPEGLYg4rmz3MFtoVNPRNmktcrY,True,97552251,24388062,171976,85988,85988,F31bVJvHB2XkhGdgjyTim48hY2cLFEx661AiPS3SzYJ2,6879065,30009717,-23130652,705
2022-05-09 20:01:50-04:00,21618,8qq2gfbca7JXvq4gViBBVT2QAbM4MvBMEQLXgn8UUTvt,3o5jpBVYdFFEYrGRdCUkLrUC85wsuTKgy8iYwnpZyC1B,True,35842156,4870879,20794,10397,10397,68sueyVfmy5ToEGtLFGDkwebX47xAmzyXE29z8JrmcWv,1530163,25448500,-23918337,426
2022-05-09 20:01:59-04:00,21619,6K2m4zFPFjecwWFiNFYXKzwuEXV8GKxYHsq6Kcq4S4xW,GxaHi77G2tXJzhL77GiH7pgiW76H7AeBhziu6YYtU6xc,True,442412357,110603089,785570,392785,392785,4yhyLx1phodwcvvwVU2bramHcdbJYvfadd7pANsRzX8M,31422804,200210861,-168788057,710
2022-05-09 20:02:02-04:00,21620,Bzp3ZUxzRWqW4QoLq9PtKN1HQeSaKXFQrX1G3a4ocrre,H12B3p4v1ZtZ9gaSgpxCJsKXmmEjiqaRZQzexjzAhevo,True,465193025,30200239,134535,67267,67268,72FwbpFGoLEazJEdpqNtPNefsadUrimUqma9wSoy4qiS,20723304,304747280,-284023976,445
2022-05-09 20:02:02-04:00,21621,9eWpSyu71Z6dmx7yTh7WrbVScdrrZN14d5tfmqEGFgXt,2r89PFKSD9zmSp2Wyx4CQ75HAtmUgwhAS2oG5MuYuiV6,True,45268164,11317040,39168,19584,19584,72FwbpFGoLEazJEdpqNtPNefsadUrimUqma9wSoy4qiS,1566770,27274248,-25707478,346
2022-05-09 20:02:02-04:00,21622,4X3JtctRhYihcyDkxk1B4QNWt15JkiSWCtLu9sWh9T88,BqxESjHzsRi9RBQA8v6uBCACDPTshEpaWPd4c8JBDqa8,True,795919682,198979920,1241398,620699,620699,3zqXX6kzhkbW3d4TwD2CNjMRwxTbREXySekvq37kfCNk,49655941,391964557,-342308616,623
2022-05-09 20:02:02-04:00,21623,8ZsXyXgAV71qRor7YWFC8zMntN73XWm7GhTkE7XgV7Rq,D4QLFpaaetu9TcVxQH9j9WAXK7ZVKKLnW6KtHK6W9MZ9,False,23002675,23002675,949919,47495,902424,6L1WYrPiCMyi7XemPww4B4hvpKD1LQKD4RpiSKmrmgSC,949921,16775464,-15825543,412
2022-05-09 20:02:02-04:00,21624,J8FKUM9x5gNzz4wEpBEu5jCiy9Z115xzVtxy6tjDh5xK,BGUQKXLhZdjkPDJEREXyyTPwQFZAFuGMdxBzFhPqfVkr,False,25544347,25544347,960873,48043,912830,6L1WYrPiCMyi7XemPww4B4hvpKD1LQKD4RpiSKmrmgSC,960874,14792304,-13831430,376
2022-05-09 20:02:19-04:00,21625,Guz4ofgn6nw3yfBYbPKx3828HGB9uGURTpAPrcNiJprv,5fkvyvCF2YTXw1rGKy5YjHH175sD9vnF1QGW7gEb7sFa,True,57026346,5336512,27272,13636,13636,68sueyVfmy5ToEGtLFGDkwebX47xAmzyXE29z8JrmcWv,2914354,32221918,-29307564,511
2022-05-09 20:02:19-04:00,21626,CS7E1f7LjgmwFUs85CMG45Q6qDy9NqmuGfJywfjjrf1U,Bem68iukByPcPpgzi63FufEhjTigKkPeeW2gY4o8zK2Z,True,67380827,16845206,97600,48800,48800,72FwbpFGoLEazJEdpqNtPNefsadUrimUqma9wSoy4qiS,3904025,47514580,-43610555,579
2022-05-09 20:02:58-04:00,21627,9cE3sPydeiFpAZajTK8ewa8pQLT5MvQPemwrHJUyzH1C,2XB63S8WX5FWQYTKuDrq75aMFVHZ3KCuZDiP5Cy95VPe,True,123528905,30882226,189969,94984,94985,3zqXX6kzhkbW3d4TwD2CNjMRwxTbREXySekvq37kfCNk,7598784,58117260,-50518476,615
2022-05-09 20:03:26-04:00,21628,6fqbSyhh3PPdgRcLraHb7Jahj9s1oHHeX3SsjNSsGa6t,GpRUow48TYgttdYfsygbgjYQcmHyYjWETUDjDVphEgwq,True,259742817,64935704,386461,193230,193231,5HnvdJnCCcmRsm4GkXnYWd4q9RpwuvYDGEUMPkYR3Ts9,15458449,121837880,-106379431,595
2022-05-09 20:03:41-04:00,21629,DuNLzKUCCxrZY6JyBGwKJEJRygBd2vm1CesXgMDhfhn6,4PGnrVg4NTCuW5sZmkpg6g5ria57Jvhoaktsi9J8Ay13,True,28119810,7029952,41068,20534,20534,6L1WYrPiCMyi7XemPww4B4hvpKD1LQKD4RpiSKmrmgSC,1642750,14743023,-13100273,584
2022-05-09 20:04:39-04:00,21630,6vWL8gpQtX2s3C9eqrUTnrK8iEUSMpAPh4C2Jsch7VF3,dgGLcKRBKvEWdXULyFLpxxcAEdMwiBVyXJB775RoDcJ,False,23004749,23004749,950358,47517,902841,68sueyVfmy5ToEGtLFGDkwebX47xAmzyXE29z8JrmcWv,950360,16773828,-15823468,413
2022-05-09 20:04:39-04:00,21631,AzBK36Qny8VFVN6jFg8CBGsRU2FbdZYDMsgbJeRfZjRs,GSZ8veMKWDmYpAkZxtDL6DLreo9R6d7YhyGix4a6TgBJ,True,24415485,1286925,5442,2721,2721,3zqXX6kzhkbW3d4TwD2CNjMRwxTbREXySekvq37kfCNk,1032584,17554685,-16522101,422
2022-05-09 20:04:40-04:00,21632,75fFExuVbQ6dKrSdQK13NMMN1ZoGbaEXUpR8Yfr6ruTG,55Qjxz3zoBnt3sfFEHsyoC4HJVqEHZxcnRCAggVTiAcx,True,27168058,2714280,11199,5599,5600,3zqXX6kzhkbW3d4TwD2CNjMRwxTbREXySekvq37kfCNk,1121048,18647348,-17526300,412
2022-05-09 20:04:55-04:00,21633,CZhzJ91hP1pFbNNz7YnUKXznvs6ZFVSRNLbe1SaTw29o,X3B4LpHFfeJPmCnEmRQ8V6MNMi7KpTE4MLD7LHYXUwy,True,69066036,3661338,13295,6647,6648,68sueyVfmy5ToEGtLFGDkwebX47xAmzyXE29z8JrmcWv,2508020,24991408,-22483388,363
2022-05-09 20:04:59-04:00,21634,E6naKBMrPoQXUx76w4t88u2DYhqyPSqp7u8h2xF5p7xm,Eg7ZTk4aG8BzNTNQxX2ae5c1HLeW5AHe8aTY97nA3gJv,True,27175832,2714535,11114,5557,5557,3zqXX6kzhkbW3d4TwD2CNjMRwxTbREXySekvq37kfCNk,1112754,18624515,-17511761,409
2022-05-09 20:05:13-04:00,21635,CS7E1f7LjgmwFUs85CMG45Q6qDy9NqmuGfJywfjjrf1U,Bem68iukByPcPpgzi63FufEhjTigKkPeeW2gY4o8zK2Z,True,49919561,12479890,77945,38972,38973,3zqXX6kzhkbW3d4TwD2CNjMRwxTbREXySekvq37kfCNk,3117809,36441867,-33324058,624
2022-05-09 20:05:26-04:00,21636,64Diz8zzEv1jDWnBQPTHPpXwaWf7vjM19RyJmkPy1viQ,G8wkGHRHMtT3mvXBkH3zgsKNs8wbpdiPUS17y4cozhkZ,True,32133202,8033300,50157,25078,25079,6L1WYrPiCMyi7XemPww4B4hvpKD1LQKD4RpiSKmrmgSC,2006315,8744042,-6737727,624
2022-05-09 20:05:36-04:00,21637,4X3JtctRhYihcyDkxk1B4QNWt15JkiSWCtLu9sWh9T88,BqxESjHzsRi9RBQA8v6uBCACDPTshEpaWPd4c8JBDqa8,True,584701714,146175428,883060,441530,441530,3zqXX6kzhkbW3d4TwD2CNjMRwxTbREXySekvq37kfCNk,35322407,304301654,-268979247,604
2022-05-09 20:05:58-04:00,21638,DKHnugPqCk62V5SC2BLqYJ6CrUFkZe3X45DM3PncjfrV,5Wk61GCcKBBfx2EtcBvKUaMtQKFSJUBBDsWbonTvcun1,True,27140825,2711542,11139,5569,5570,6L1WYrPiCMyi7XemPww4B4hvpKD1LQKD4RpiSKmrmgSC,1114980,18661765,-17546785,410
2022-05-09 20:06:11-04:00,21639,CpSUMCkXamfGm1FyxYQgmAKh1jaJ1DdmrRHxHANJpc3Q,2rVXtfeMhRgmU6eNBvg6RvQ4jRCAmgKVgLS8bPppCb8Q,True,27130587,2708852,11135,5567,5568,3zqXX6kzhkbW3d4TwD2CNjMRwxTbREXySekvq37kfCNk,1115277,18671056,-17555779,411
2022-05-09 20:06:13-04:00,21640,CZhzJ91hP1pFbNNz7YnUKXznvs6ZFVSRNLbe1SaTw29o,X3B4LpHFfeJPmCnEmRQ8V6MNMi7KpTE4MLD7LHYXUwy,True,65213099,6883076,24308,12154,12154,6L1WYrPiCMyi7XemPww4B4hvpKD1LQKD4RpiSKmrmgSC,2303126,21600351,-19297225,353
2022-05-09 20:06:18-04:00,21641,75fFExuVbQ6dKrSdQK13NMMN1ZoGbaEXUpR8Yfr6ruTG,55Qjxz3zoBnt3sfFEHsyoC4HJVqEHZxcnRCAggVTiAcx,True,24355670,1285894,5341,2670,2671,3zqXX6kzhkbW3d4TwD2CNjMRwxTbREXySekvq37kfCNk,1011741,17599084,-16587343,415
2022-05-09 20:06:25-04:00,21642,AzBK36Qny8VFVN6jFg8CBGsRU2FbdZYDMsgbJeRfZjRs,GSZ8veMKWDmYpAkZxtDL6DLreo9R6d7YhyGix4a6TgBJ,False,23033957,23033957,932537,46626,885911,3zqXX6kzhkbW3d4TwD2CNjMRwxTbREXySekvq37kfCNk,932539,16726789,-15794250,404
2022-05-09 20:06:26-04:00,21643,E6naKBMrPoQXUx76w4t88u2DYhqyPSqp7u8h2xF5p7xm,Eg7ZTk4aG8BzNTNQxX2ae5c1HLeW5AHe8aTY97nA3gJv,True,24379692,1287278,5385,2692,2693,6L1WYrPiCMyi7XemPww4B4hvpKD1LQKD4RpiSKmrmgSC,1020035,17577930,-16557895,418
2022-05-09 20:06:27-04:00,21644,DuNLzKUCCxrZY6JyBGwKJEJRygBd2vm1CesXgMDhfhn6,4PGnrVg4NTCuW5sZmkpg6g5ria57Jvhoaktsi9J8Ay13,True,20700385,5175096,30305,15152,15153,6L1WYrPiCMyi7XemPww4B4hvpKD1LQKD4RpiSKmrmgSC,1212209,11426900,-10214691,585
2022-05-09 20:06:38-04:00,21645,26wo1RqwKXrNnfgMdZEmkGhnDbURpZcp2hasB5EA5QtD,34gwTVGRrdoaBzLUG6SBwRwBovkjBjCebqVUBan6GDnB,True,83494832,20873708,143420,71710,71710,68sueyVfmy5ToEGtLFGDkwebX47xAmzyXE29z8JrmcWv,5736830,86456660,-80719830,687
2022-05-09 20:06:38-04:00,21646,9cE3sPydeiFpAZajTK8ewa8pQLT5MvQPemwrHJUyzH1C,2XB63S8WX5FWQYTKuDrq75aMFVHZ3KCuZDiP5Cy95VPe,True,90498925,22624731,131526,65763,65763,6L1WYrPiCMyi7XemPww4B4hvpKD1LQKD4RpiSKmrmgSC,5261061,45297904,-40036843,581
2022-05-09 20:06:39-04:00,21647,Guz4ofgn6nw3yfBYbPKx3828HGB9uGURTpAPrcNiJprv,5fkvyvCF2YTXw1rGKy5YjHH175sD9vnF1QGW7gEb7sFa,True,51411882,4683340,23516,11758,11758,68sueyVfmy5ToEGtLFGDkwebX47xAmzyXE29z8JrmcWv,2581578,29200502,-26618924,502
2022-05-09 20:06:43-04:00,21648,6fqbSyhh3PPdgRcLraHb7Jahj9s1oHHeX3SsjNSsGa6t,GpRUow48TYgttdYfsygbgjYQcmHyYjWETUDjDVphEgwq,True,190956834,47739208,280542,140271,140271,6L1WYrPiCMyi7XemPww4B4hvpKD1LQKD4RpiSKmrmgSC,11221709,94857588,-83635879,587
2022-05-09 20:07:03-04:00,21649,DKHnugPqCk62V5SC2BLqYJ6CrUFkZe3X45DM3PncjfrV,5Wk61GCcKBBfx2EtcBvKUaMtQKFSJUBBDsWbonTvcun1,True,24358826,1280760,5433,2716,2717,68sueyVfmy5ToEGtLFGDkwebX47xAmzyXE29z8JrmcWv,1033384,17612160,-16578776,424
2022-05-09 20:07:23-04:00,21650,75fFExuVbQ6dKrSdQK13NMMN1ZoGbaEXUpR8Yfr6ruTG,55Qjxz3zoBnt3sfFEHsyoC4HJVqEHZxcnRCAggVTiAcx,False,23016764,23016764,953385,47669,905716,6L1WYrPiCMyi7XemPww4B4hvpKD1LQKD4RpiSKmrmgSC,953388,16769907,-15816519,414
2022-05-09 20:07:28-04:00,21651,E6naKBMrPoQXUx76w4t88u2DYhqyPSqp7u8h2xF5p7xm,Eg7ZTk4aG8BzNTNQxX2ae5c1HLeW5AHe8aTY97nA3gJv,False,23026584,23026584,948818,47440,901378,Hu94aiQWvce6THeGyCFqGRPM1pQrK3ihzkcXo1EpJcJL,948820,16750445,-15801625,412
2022-05-09 20:07:33-04:00,21652,CpSUMCkXamfGm1FyxYQgmAKh1jaJ1DdmrRHxHANJpc3Q,2rVXtfeMhRgmU6eNBvg6RvQ4jRCAmgKVgLS8bPppCb8Q,True,24325782,1286559,5332,2666,2666,6L1WYrPiCMyi7XemPww4B4hvpKD1LQKD4RpiSKmrmgSC,1008189,17618767,-16610578,414
2022-05-09 20:07:40-04:00,21653,CS7E1f7LjgmwFUs85CMG45Q6qDy9NqmuGfJywfjjrf1U,Bem68iukByPcPpgzi63FufEhjTigKkPeeW2gY4o8zK2Z,True,36622856,9155714,55576,27788,27788,3zqXX6kzhkbW3d4TwD2CNjMRwxTbREXySekvq37kfCNk,2223049,28032953,-25809904,607
2022-05-09 20:07:41-04:00,21654,4X3JtctRhYihcyDkxk1B4QNWt15JkiSWCtLu9sWh9T88,BqxESjHzsRi9RBQA8v6uBCACDPTshEpaWPd4c8JBDqa8,True,430959813,107739953,671821,335910,335911,3zqXX6kzhkbW3d4TwD2CNjMRwxTbREXySekvq37kfCNk,26872874,236179203,-209306329,623
2022-05-09 20:08:05-04:00,21655,CZhzJ91hP1pFbNNz7YnUKXznvs6ZFVSRNLbe1SaTw29o,X3B4LpHFfeJPmCnEmRQ8V6MNMi7KpTE4MLD7LHYXUwy,True,58066710,6680205,23186,11593,11593,72FwbpFGoLEazJEdpqNtPNefsadUrimUqma9wSoy4qiS,2015505,20529768,-18514263,347
2022-05-09 20:08:20-04:00,21656,DKHnugPqCk62V5SC2BLqYJ6CrUFkZe3X45DM3PncjfrV,5Wk61GCcKBBfx2EtcBvKUaMtQKFSJUBBDsWbonTvcun1,False,22998308,22998308,948191,47409,900782,3zqXX6kzhkbW3d4TwD2CNjMRwxTbREXySekvq37kfCNk,948193,16778107,-15829914,412
2022-05-09 20:08:22-04:00,21657,9cE3sPydeiFpAZajTK8ewa8pQLT5MvQPemwrHJUyzH1C,2XB63S8WX5FWQYTKuDrq75aMFVHZ3KCuZDiP5Cy95VPe,True,66689305,16672326,98616,49308,49308,3zqXX6kzhkbW3d4TwD2CNjMRwxTbREXySekvq37kfCNk,3944646,35157297,-31212651,591
2022-05-09 20:08:29-04:00,21658,Guz4ofgn6nw3yfBYbPKx3828HGB9uGURTpAPrcNiJprv,5fkvyvCF2YTXw1rGKy5YjHH175sD9vnF1QGW7gEb7sFa,True,46442829,4022848,19682,9841,9841,6L1WYrPiCMyi7XemPww4B4hvpKD1LQKD4RpiSKmrmgSC,2272349,26573106,-24300757,489
2022-05-09 20:08:42-04:00,21659,CpSUMCkXamfGm1FyxYQgmAKh1jaJ1DdmrRHxHANJpc3Q,2rVXtfeMhRgmU6eNBvg6RvQ4jRCAmgKVgLS8bPppCb8Q,False,22966338,22966338,929970,46498,883472,68sueyVfmy5ToEGtLFGDkwebX47xAmzyXE29z8JrmcWv,929972,16790617,-15860645,404
2022-05-09 20:08:43-04:00,21660,2wAW5AhrGDpMXnZPwHFFcUvovjWSDftRB2uynhCvy1Ss,7V8py72Rbtgk7iGcEEiiodsR8MmJnmFVgf9A8jiQcVrF,False,42075,42075,1837,91,1746,6L1WYrPiCMyi7XemPww4B4hvpKD1LQKD4RpiSKmrmgSC,1839,36264,-34425,437
2022-05-09 20:08:45-04:00,21661,6fqbSyhh3PPdgRcLraHb7Jahj9s1oHHeX3SsjNSsGa6t,GpRUow48TYgttdYfsygbgjYQcmHyYjWETUDjDVphEgwq,True,139733703,34933425,186431,93215,93216,47z82br5WdW2DZajdnPDPSSRRKsyAggqXqK6oPUwTaLf,7457244,73668649,-66211405,533
2022-05-09 20:08:51-04:00,21662,CZhzJ91hP1pFbNNz7YnUKXznvs6ZFVSRNLbe1SaTw29o,X3B4LpHFfeJPmCnEmRQ8V6MNMi7KpTE4MLD7LHYXUwy,True,51254823,2643953,9597,4798,4799,6L1WYrPiCMyi7XemPww4B4hvpKD1LQKD4RpiSKmrmgSC,1860637,19267932,-17407295,363
2022-05-09 20:09:00-04:00,21663,DuNLzKUCCxrZY6JyBGwKJEJRygBd2vm1CesXgMDhfhn6,4PGnrVg4NTCuW5sZmkpg6g5ria57Jvhoaktsi9J8Ay13,False,15109932,15109932,766547,38327,728220,47z82br5WdW2DZajdnPDPSSRRKsyAggqXqK6oPUwTaLf,766547,8842930,-8076383,507
2022-05-09 20:09:19-04:00,21664,Guz4ofgn6nw3yfBYbPKx3828HGB9uGURTpAPrcNiJprv,5fkvyvCF2YTXw1rGKy5YjHH175sD9vnF1QGW7gEb7sFa,True,42248941,3419579,16848,8424,8424,72FwbpFGoLEazJEdpqNtPNefsadUrimUqma9wSoy4qiS,2081627,24348935,-22267308,492
2022-05-09 20:09:45-04:00,21665,CS7E1f7LjgmwFUs85CMG45Q6qDy9NqmuGfJywfjjrf1U,Bem68iukByPcPpgzi63FufEhjTigKkPeeW2gY4o8zK2Z,True,26971536,6742884,41796,20898,20898,3zqXX6kzhkbW3d4TwD2CNjMRwxTbREXySekvq37kfCNk,1671867,21524927,-19853060,619
2022-05-09 20:10:25-04:00,21666,EgpRPHPAC2cPBiar3SUD5PGZnzbCXBzUpa4KVTF5q9XY,2zf7NkfWagBWWts9RgacdRgkSzgJaChpFW5mMZczXa18,True,43551563,10887890,30151,15075,15076,47z82br5WdW2DZajdnPDPSSRRKsyAggqXqK6oPUwTaLf,1206055,46008381,-44802326,276
2022-05-09 20:10:34-04:00,21667,4X3JtctRhYihcyDkxk1B4QNWt15JkiSWCtLu9sWh9T88,BqxESjHzsRi9RBQA8v6uBCACDPTshEpaWPd4c8JBDqa8,True,316619470,79154867,490016,245008,245008,3zqXX6kzhkbW3d4TwD2CNjMRwxTbREXySekvq37kfCNk,19600663,183183823,-163583160,619
2022-05-09 20:10:38-04:00,21668,CZhzJ91hP1pFbNNz7YnUKXznvs6ZFVSRNLbe1SaTw29o,X3B4LpHFfeJPmCnEmRQ8V6MNMi7KpTE4MLD7LHYXUwy,True,48475783,5161384,18269,9134,9135,2a35JJeTUW1pm6M3e8DHCjp8qr4vbc2cRPhuzZWyFzYd,1715953,16622961,-14907008,353
2022-05-09 20:10:43-04:00,21669,Bzp3ZUxzRWqW4QoLq9PtKN1HQeSaKXFQrX1G3a4ocrre,H12B3p4v1ZtZ9gaSgpxCJsKXmmEjiqaRZQzexjzAhevo,True,432117621,29457191,132486,66243,66243,C4UnXuShCvjSMgBAgVNMy1oakxCNk1et27A82fywU112,19434900,317238305,-297803405,449
2022-05-09 20:11:02-04:00,21670,6fqbSyhh3PPdgRcLraHb7Jahj9s1oHHeX3SsjNSsGa6t,GpRUow48TYgttdYfsygbgjYQcmHyYjWETUDjDVphEgwq,True,103809514,25952378,157001,78500,78501,72FwbpFGoLEazJEdpqNtPNefsadUrimUqma9wSoy4qiS,6280049,56929685,-50649636,604
2022-05-09 20:11:04-04:00,21671,8sQzUoiFfBUsfVKdUjUh3xUjwnaCP1Qmw9BGwtH768ZR,8wZxijgcyRwqxiRKMMZhoREAb6iHhRGCgjgZRd5Yp6RP,False,11221658,11221658,661878,33093,628785,72FwbpFGoLEazJEdpqNtPNefsadUrimUqma9wSoy4qiS,661878,8976995,-8315117,589
2022-05-09 20:11:06-04:00,21672,4umpTXkiSYPTLH7B5MXC7VgJzwUpTKCZ5amqykZewDzG,J8gcRTQNYZP9NeZk8GejAh54GgwiF3MW2RZ7cZp25zt3,False,7154552,7154552,212767,10638,202129,3zqXX6kzhkbW3d4TwD2CNjMRwxTbREXySekvq37kfCNk,212767,5796928,-5584161,297
2022-05-09 20:11:14-04:00,21673,9cE3sPydeiFpAZajTK8ewa8pQLT5MvQPemwrHJUyzH1C,2XB63S8WX5FWQYTKuDrq75aMFVHZ3KCuZDiP5Cy95VPe,True,48902298,12225574,68283,34141,34142,C4UnXuShCvjSMgBAgVNMy1oakxCNk1et27A82fywU112,2731349,27255591,-24524242,558
2022-05-09 20:11:18-04:00,21674,GYgxUfZ19oSyHuovGRA6gBJT32goSxCrKR8hQQdBsrRG,2r8c6SU74hRq7xEmYBJ92WoSB6v6XCAXR3JcDznfCxkN,True,49671051,12417762,36572,18286,18286,C4UnXuShCvjSMgBAgVNMy1oakxCNk1et27A82fywU112,1462889,41896000,-40433111,294
2022-05-09 20:11:47-04:00,21675,Guz4ofgn6nw3yfBYbPKx3828HGB9uGURTpAPrcNiJprv,5fkvyvCF2YTXw1rGKy5YjHH175sD9vnF1QGW7gEb7sFa,True,38600166,2987705,14207,7103,7104,72FwbpFGoLEazJEdpqNtPNefsadUrimUqma9wSoy4qiS,1835583,22286249,-20450666,475
2022-05-09 20:12:35-04:00,21676,64Diz8zzEv1jDWnBQPTHPpXwaWf7vjM19RyJmkPy1viQ,G8wkGHRHMtT3mvXBkH3zgsKNs8wbpdiPUS17y4cozhkZ,True,23595207,5898801,36286,18143,18143,47z82br5WdW2DZajdnPDPSSRRKsyAggqXqK6oPUwTaLf,1451463,7009501,-5558038,615
2022-05-09 20:13:00-04:00,21677,CS7E1f7LjgmwFUs85CMG45Q6qDy9NqmuGfJywfjjrf1U,Bem68iukByPcPpgzi63FufEhjTigKkPeeW2gY4o8zK2Z,True,19785849,4946462,29681,14840,14841,3zqXX6kzhkbW3d4TwD2CNjMRwxTbREXySekvq37kfCNk,1187268,16519881,-15332613,600
2022-05-09 20:13:01-04:00,21678,4X3JtctRhYihcyDkxk1B4QNWt15JkiSWCtLu9sWh9T88,BqxESjHzsRi9RBQA8v6uBCACDPTshEpaWPd4c8JBDqa8,True,232906755,58226688,363819,181909,181910,3zqXX6kzhkbW3d4TwD2CNjMRwxTbREXySekvq37kfCNk,14552799,141799701,-127246902,624
2022-05-09 20:13:39-04:00,21679,9cE3sPydeiFpAZajTK8ewa8pQLT5MvQPemwrHJUyzH1C,2XB63S8WX5FWQYTKuDrq75aMFVHZ3KCuZDiP5Cy95VPe,True,36230921,9057730,55431,27715,27716,3zqXX6kzhkbW3d4TwD2CNjMRwxTbREXySekvq37kfCNk,2217263,21056288,-18839025,611
2022-05-09 20:13:41-04:00,21680,6fqbSyhh3PPdgRcLraHb7Jahj9s1oHHeX3SsjNSsGa6t,GpRUow48TYgttdYfsygbgjYQcmHyYjWETUDjDVphEgwq,True,76026352,19006588,107306,53653,53653,47z82br5WdW2DZajdnPDPSSRRKsyAggqXqK6oPUwTaLf,4292264,44110454,-39818190,564
2022-05-09 20:13:57-04:00,21681,Guz4ofgn6nw3yfBYbPKx3828HGB9uGURTpAPrcNiJprv,5fkvyvCF2YTXw1rGKy5YjHH175sD9vnF1QGW7gEb7sFa,True,35413417,2486923,11392,5696,5696,47z82br5WdW2DZajdnPDPSSRRKsyAggqXqK6oPUwTaLf,1622332,20589239,-18966907,458
2022-05-09 20:14:59-04:00,21682,9DWREMQtcKKcZRzqBi4kWKp61TW9MhASCVE9biCX7tvD,J4kGq2xVmSku73SfzjExKgpdJgjfZ6HBFvgKBsxsmPvr,False,76090568261,76090568261,3641199113,182059955,3459139158,F31bVJvHB2XkhGdgjyTim48hY2cLFEx661AiPS3SzYJ2,3641199113,1374961600,2266237513,478
2022-05-09 20:15:02-04:00,21683,6L9NE2QwAcbRwn9aga1g36ouHCaZ7HFuvoNqFR4zK3fJ,8nRvtSHRnZusLhZEJRYtrTGoenCzdcu2w4RzsshjFsPV,False,296904762825,173628516271,7384496630,369224831,7015271799,6L1WYrPiCMyi7XemPww4B4hvpKD1LQKD4RpiSKmrmgSC,12627489239,19849617976,-7222128737,425
2022-05-09 20:15:02-04:00,21684,6L9NE2QwAcbRwn9aga1g36ouHCaZ7HFuvoNqFR4zK3fJ,8nRvtSHRnZusLhZEJRYtrTGoenCzdcu2w4RzsshjFsPV,False,123276246554,123276246554,5242992609,262149630,4980842979,6L1WYrPiCMyi7XemPww4B4hvpKD1LQKD4RpiSKmrmgSC,5242992609,9437572483,-4194579874,425
2022-05-09 20:15:13-04:00,21685,F9s8a7Cpiw5dw3a2aNFMofqwyDWNXvDLnSdJzoj1gRiV,GpKsQKJD79KBRWdCTkyi4zX7NaoCWsLUjrKxAwJB6o6s,False,1105129081,1105129081,0,0,0,5HnvdJnCCcmRsm4GkXnYWd4q9RpwuvYDGEUMPkYR3Ts9,0,99358186,-102025348,0
2022-05-09 20:15:16-04:00,21686,43Wk9mS6z1XFiYptRNTkGsJhuFZEuEMWsW8xJzJ2EGf9,9HzrjVGu1hSdcoLnayPA15wTkiJjWqB4ZipwTE9DGP99,False,6372305846,6372305846,284532159,14226607,270305552,AmTrMPzuTp2BjnjqGNKqz9FTTCdpoKcPAJLwFc8ozcbh,284532159,259150944,25381215,446
2022-05-09 20:17:45-04:00,21687,8qq2gfbca7JXvq4gViBBVT2QAbM4MvBMEQLXgn8UUTvt,3o5jpBVYdFFEYrGRdCUkLrUC85wsuTKgy8iYwnpZyC1B,True,30941924,2177858,10264,5132,5132,C4UnXuShCvjSMgBAgVNMy1oakxCNk1et27A82fywU112,1458368,27237741,-25779373,471
2022-05-09 20:23:19-04:00,21688,GMpoV2jRyLdf2V3Gb5TQZ5gEs5ftMjD3JhFUzkA6fWVz,5bi814d5gdToTLVWCmbdB6J15kMdsTQk74cZTRd62p81,True,28621766,7155441,50838,25419,25419,8sEswn3kzEhnYjAZVvCQnHEUvYd7pFVvc2Xc2Kd1BpbC,2033542,15832171,-13798629,710
2022-05-09 20:28:07-04:00,21689,m7gf1jAYXBZjRZEY9w4MjPfhzLwgDKaXyaCVhRD6C5E,Aa2aTZnpPux1i5K2MT4i1TsVM8vR7qR7rZGijQW4zpwd,True,56622740,5375732,22150,11075,11075,C4UnXuShCvjSMgBAgVNMy1oakxCNk1et27A82fywU112,2333087,39747857,-37414770,412
2022-05-09 20:28:10-04:00,21690,8J4BZXZzkK4SmWxc2YoaJRg9ivuuXbdVe5XpEhVds1ZM,3pirVwiye9NftvMpX5F7WpfcGZy5uV3c11xCdkkZbL9D,False,32835854,32835854,957118,47855,909263,47z82br5WdW2DZajdnPDPSSRRKsyAggqXqK6oPUwTaLf,957118,8849212,-7892094,291
2022-05-09 20:28:22-04:00,21691,H9pFRayNBHTAhsbtGyfs1XXUWGxAbw7SgpT1xdrSRWEY,9LNreyXuhgyLCDYViNyA1jUw6h1nv4GmDtTYMoUQBqCG,True,374467846,46843767,141174,70587,70587,C4UnXuShCvjSMgBAgVNMy1oakxCNk1et27A82fywU112,11285518,196122301,-184836783,301
2022-05-09 20:30:03-04:00,21692,BQYbbwd1MLtj6fBuBiTncAaXdAqKWa1JbcbGkZbLA728,2Wsyr6KoMbSVSvFy3YzutuEQ6skGUZyVHGM42SN4eU98,True,1411211767,54218623,190704,95352,95352,A2p75MbAbeUdHkPLkAjgGeiwuu9WPrkMHzjCkDXF1Xr3,49636935,1951261634,-1901624699,351
2022-05-09 20:33:37-04:00,21693,CcHRe7yjr3pDZqHfqzWw7g8q59y2ayiFLUvVeywC5J39,HCDkE5M7hHrZxJZxF9nkEXp86VYcFqejohxmLGZkC9SG,True,56268676,14067169,86784,43392,43392,68sueyVfmy5ToEGtLFGDkwebX47xAmzyXE29z8JrmcWv,3471372,48702894,-45231522,616
2022-05-09 20:34:20-04:00,21694,64Diz8zzEv1jDWnBQPTHPpXwaWf7vjM19RyJmkPy1viQ,G8wkGHRHMtT3mvXBkH3zgsKNs8wbpdiPUS17y4cozhkZ,True,17361038,4340259,26995,13497,13498,5HnvdJnCCcmRsm4GkXnYWd4q9RpwuvYDGEUMPkYR3Ts9,1079809,5583732,-4503923,621
2022-05-09 20:35:30-04:00,21695,D7dQmfuiK31BHRG4Y9wpkRu7sChiZhTYes47YPNGvnpF,AN5jjtJp7d9DG3xJo3DnDRmGmzj5pKKy1owwVuREpReQ,True,53648392,13412098,83787,41893,41894,5HnvdJnCCcmRsm4GkXnYWd4q9RpwuvYDGEUMPkYR3Ts9,3351482,12209102,-8857620,624
2022-05-09 20:36:17-04:00,21696,9jMAUgoiHZXsoGomc6NFTvarZojxpNJPtz816zq2gQM6,HsxPbuECvAmkcjbsDGgqmN5JLnW6NnFsHNhP1UKmyqr7,True,1477750398,369437599,2268688,1134344,1134344,F31bVJvHB2XkhGdgjyTim48hY2cLFEx661AiPS3SzYJ2,90747555,149976331,-59228776,614
2022-05-09 20:36:17-04:00,21697,3Dc89y1Z6ViLFDoY3vwcJewSjMQam2mSTqPtpxsPZVz5,4NfXm5CTgNUTQd6NPj2hKwjMYDr7a8d5yVC9rV2uTcjA,True,26296720020,6574180005,37700527,18850263,18850264,72XWPCtRYEDZbddP7d6dHtUBRRDLSJsB2xZTAfefoEVZ,1508021102,3249769382,-1741748280,573
2022-05-09 20:39:17-04:00,21698,3Dc89y1Z6ViLFDoY3vwcJewSjMQam2mSTqPtpxsPZVz5,4NfXm5CTgNUTQd6NPj2hKwjMYDr7a8d5yVC9rV2uTcjA,True,19961904461,4990476115,30773903,15386951,15386952,F31bVJvHB2XkhGdgjyTim48hY2cLFEx661AiPS3SzYJ2,1230956129,2783646269,-1552690140,616
2022-05-09 20:42:46-04:00,21699,9jMAUgoiHZXsoGomc6NFTvarZojxpNJPtz816zq2gQM6,HsxPbuECvAmkcjbsDGgqmN5JLnW6NnFsHNhP1UKmyqr7,True,1127615184,281903796,1729412,864706,864706,5HnvdJnCCcmRsm4GkXnYWd4q9RpwuvYDGEUMPkYR3Ts9,69176482,132923229,-63746747,613
2022-05-09 20:43:28-04:00,21700,9jMAUgoiHZXsoGomc6NFTvarZojxpNJPtz816zq2gQM6,HsxPbuECvAmkcjbsDGgqmN5JLnW6NnFsHNhP1UKmyqr7,True,863389624,215847406,1244220,622110,622110,DA18qE9qesbBqpwNv1M4befYcNQkbSBSeLPTmQzrmbJw,49768834,115270054,-65501220,576
2022-05-09 20:43:56-04:00,21701,HcnP3UoGhbPx1hj5vrGueBzeWM5eWdpGmcU9HZmEGvoy,C8TvCYGcySV4MQ4y97vLnYUAqxKqSDahbyyKpfJreM3k,True,673379080,168344770,1012254,506127,506127,F31bVJvHB2XkhGdgjyTim48hY2cLFEx661AiPS3SzYJ2,40490190,102495080,-62004890,601
2022-05-09 20:43:57-04:00,21702,9jMAUgoiHZXsoGomc6NFTvarZojxpNJPtz816zq2gQM6,HsxPbuECvAmkcjbsDGgqmN5JLnW6NnFsHNhP1UKmyqr7,True,655322137,163830534,1018617,509308,509309,F31bVJvHB2XkhGdgjyTim48hY2cLFEx661AiPS3SzYJ2,40744695,97657874,-56913179,621
2022-05-09 20:44:12-04:00,21703,8ayr4AZAcNN17UCJUXe5VJtaj6ziTmGpER4fpHGpdbiT,uRK1KLx2bX5xGSAkviLApXew2aT9ar4ATb24yu7ELRR,True,53008147,13252036,80535,40267,40268,6L1WYrPiCMyi7XemPww4B4hvpKD1LQKD4RpiSKmrmgSC,3221411,9350627,-6129216,607
2022-05-09 20:44:35-04:00,21704,CrisPtzi6bzU8z654QkRbr6S3wiUG1rY6MShpdKhKoHv,BybwpNKf7SzVswTnsmoheSEhbYuVUR1j9jMK7mNn4TYq,True,3349934021,837483505,5184503,2592251,2592252,6L1WYrPiCMyi7XemPww4B4hvpKD1LQKD4RpiSKmrmgSC,207380156,526325729,-318945573,619
2022-05-09 20:44:48-04:00,21705,9jMAUgoiHZXsoGomc6NFTvarZojxpNJPtz816zq2gQM6,HsxPbuECvAmkcjbsDGgqmN5JLnW6NnFsHNhP1UKmyqr7,False,509681302,509681302,21536379,1076818,20459561,2xTUy2RS74GJMMDnmFaegMzFLn19RVfYG4CibhBmjP1i,21536379,82415118,-60878739,422
2022-05-09 20:44:51-04:00,21706,6cyefDEH1EqWn2RYGMtLj9CPhjXg5eECHsrm3C8fxurr,4o3XrjY3LA63KkjPtNGbwEuq59qXh8WmuEDsD5mfbtMD,True,262462579,65615644,244167,122083,122084,5HnvdJnCCcmRsm4GkXnYWd4q9RpwuvYDGEUMPkYR3Ts9,9766736,28809796,-19043060,372
2022-05-09 20:44:51-04:00,21707,CrisPtzi6bzU8z654QkRbr6S3wiUG1rY6MShpdKhKoHv,BybwpNKf7SzVswTnsmoheSEhbYuVUR1j9jMK7mNn4TYq,True,2567510300,641877575,3678396,1839198,1839198,6L1WYrPiCMyi7XemPww4B4hvpKD1LQKD4RpiSKmrmgSC,147135869,441511649,-294375780,573
2022-05-09 20:45:02-04:00,21708,6cyefDEH1EqWn2RYGMtLj9CPhjXg5eECHsrm3C8fxurr,4o3XrjY3LA63KkjPtNGbwEuq59qXh8WmuEDsD5mfbtMD,True,197065309,25967029,122599,61299,61300,6L1WYrPiCMyi7XemPww4B4hvpKD1LQKD4RpiSKmrmgSC,9304195,23805238,-14501043,472
2022-05-09 20:45:47-04:00,21709,8ayr4AZAcNN17UCJUXe5VJtaj6ziTmGpER4fpHGpdbiT,uRK1KLx2bX5xGSAkviLApXew2aT9ar4ATb24yu7ELRR,False,41084497,41084497,1812490,90624,1721866,6L1WYrPiCMyi7XemPww4B4hvpKD1LQKD4RpiSKmrmgSC,1812490,7737814,-5925324,441
2022-05-09 20:46:09-04:00,21710,6ucX5Cd3jULYupyPziU3srkPb98jwmFr5sB1RkzDprzf,EnbsNX9tL2aManeCwPh2dAZqKJZPBF1T3dkx7miA9xNA,True,1135991692,283997923,1677567,838783,838784,72XWPCtRYEDZbddP7d6dHtUBRRDLSJsB2xZTAfefoEVZ,67102697,198995902,-131893205,590
2022-05-09 20:46:32-04:00,21711,CrisPtzi6bzU8z654QkRbr6S3wiUG1rY6MShpdKhKoHv,BybwpNKf7SzVswTnsmoheSEhbYuVUR1j9jMK7mNn4TYq,True,1962888123,490722030,2655051,1327525,1327526,72XWPCtRYEDZbddP7d6dHtUBRRDLSJsB2xZTAfefoEVZ,106202075,364300042,-258097967,541
2022-05-09 20:46:41-04:00,21712,C5YJApJ5drW91Ma3GM9WM1kPxnZ8SY38r2zDCULVszSg,FKE5C1ZjH6W97cdcpznPNAvZJVE6GCJGdQuUFFTbKkKn,True,993573925,248393481,681657,340828,340829,2py1FiYeL2f7J3HU36qiJz6TD6HCmiTN36RyxYtapQCZ,27266295,47771206,-20504911,274
2022-05-09 20:46:41-04:00,21713,6ucX5Cd3jULYupyPziU3srkPb98jwmFr5sB1RkzDprzf,EnbsNX9tL2aManeCwPh2dAZqKJZPBF1T3dkx7miA9xNA,True,863853742,215963435,1339128,669564,669564,72XWPCtRYEDZbddP7d6dHtUBRRDLSJsB2xZTAfefoEVZ,53565157,164356863,-110791706,620
2022-05-09 20:46:48-04:00,21714,6cyefDEH1EqWn2RYGMtLj9CPhjXg5eECHsrm3C8fxurr,4o3XrjY3LA63KkjPtNGbwEuq59qXh8WmuEDsD5mfbtMD,True,173444972,20047805,80309,40154,40155,6L1WYrPiCMyi7XemPww4B4hvpKD1LQKD4RpiSKmrmgSC,6948018,19972569,-13024551,400
2022-05-09 20:46:51-04:00,21715,CrisPtzi6bzU8z654QkRbr6S3wiUG1rY6MShpdKhKoHv,BybwpNKf7SzVswTnsmoheSEhbYuVUR1j9jMK7mNn4TYq,True,1489802264,372450566,2147771,1073885,1073886,DA18qE9qesbBqpwNv1M4befYcNQkbSBSeLPTmQzrmbJw,85910853,297154989,-211244136,576
2022-05-09 20:58:22-04:00,21716,6cyefDEH1EqWn2RYGMtLj9CPhjXg5eECHsrm3C8fxurr,4o3XrjY3LA63KkjPtNGbwEuq59qXh8WmuEDsD5mfbtMD,True,87365588,21841397,132971,66485,66486,5HnvdJnCCcmRsm4GkXnYWd4q9RpwuvYDGEUMPkYR3Ts9,5318852,16823915,-11505063,608
2022-05-09 21:03:39-04:00,21717,29hcg7nN7unogHZTe72dL9C6SSG2hGbMtmK9egS7guub,B2y9KwPJe964UBYqfpMP3q6sRLBpvsT3xR5RwGGL7L2f,True,41226845263,10306711315,30436891,15218445,15218446,AmTrMPzuTp2BjnjqGNKqz9FTTCdpoKcPAJLwFc8ozcbh,1217475673,2000666335,-783190662,295
2022-05-09 21:03:55-04:00,21718,6RicHPpU172jK5bUAkydRb5DsKWpDPtwLPrR7UgXfUX1,H46aoDpDpW35BHq4sZrxReKLHkFEAHdjeF5VsUerCMbp,True,813786062700,90078586369,539546191,269773095,269773096,A2p75MbAbeUdHkPLkAjgGeiwuu9WPrkMHzjCkDXF1Xr3,48743568129,60710101005,-11966532876,598
2022-05-09 21:05:10-04:00,21719,C5YJApJ5drW91Ma3GM9WM1kPxnZ8SY38r2zDCULVszSg,FKE5C1ZjH6W97cdcpznPNAvZJVE6GCJGdQuUFFTbKkKn,True,751742780,187935695,508383,254191,254192,A9TwRM1BMxqb8DCC7YNAMV6zPenEJm3HTZBy7wJKK58U,20335341,42285463,-21950122,270
2022-05-09 21:05:26-04:00,21720,C5YJApJ5drW91Ma3GM9WM1kPxnZ8SY38r2zDCULVszSg,FKE5C1ZjH6W97cdcpznPNAvZJVE6GCJGdQuUFFTbKkKn,True,566513848,141628462,428004,214002,214002,DQCvC9mR68hJ3tJsUiddh6JwcBJAmntqGJR2nUsEq7yj,17120195,36294692,-19174497,302
2022-05-09 21:05:37-04:00,21721,EixYycpq2qVBMY4zNAj8bWU5KFvH9mCN4ETnEd7PgqmR,9SLJ4kHG7oGfxGG929V57TXSKbQGtkqBJHh3Qag9asay,True,342475699929,25925274298,159103139,79551569,79551570,2xTUy2RS74GJMMDnmFaegMzFLn19RVfYG4CibhBmjP1i,21017698164,15027368869,5990329295,613
2022-05-09 21:06:20-04:00,21722,6RicHPpU172jK5bUAkydRb5DsKWpDPtwLPrR7UgXfUX1,H46aoDpDpW35BHq4sZrxReKLHkFEAHdjeF5VsUerCMbp,True,726665357916,68698753624,427755831,213877915,213877916,F31bVJvHB2XkhGdgjyTim48hY2cLFEx661AiPS3SzYJ2,45246140353,46309649083,-1063508730,622
2022-05-09 21:06:21-04:00,21723,EixYycpq2qVBMY4zNAj8bWU5KFvH9mCN4ETnEd7PgqmR,9SLJ4kHG7oGfxGG929V57TXSKbQGtkqBJHh3Qag9asay,True,317261025026,24850060938,147827811,73913905,73913906,GXyFXZMNk2NFyEzw6JetVqsujqcz2yCixH7n8EpDJYWD,18873194334,15965594538,2907599796,594
2022-05-09 21:13:21-04:00,21724,F5vnN191nY9kUJBtFcm6fUhPDJvUSrSHLvfstesb68rH,9DtiZh3FsVmZA9MRqZhonAN2Pk4rQdcWw8As76DnQ6ee,True,678661565,169665391,1047956,523978,523978,6L1WYrPiCMyi7XemPww4B4hvpKD1LQKD4RpiSKmrmgSC,41918247,71144138,-29225891,617
2022-05-09 21:17:31-04:00,21725,F5vnN191nY9kUJBtFcm6fUhPDJvUSrSHLvfstesb68rH,9DtiZh3FsVmZA9MRqZhonAN2Pk4rQdcWw8As76DnQ6ee,True,499153620,124788405,775693,387846,387847,F31bVJvHB2XkhGdgjyTim48hY2cLFEx661AiPS3SzYJ2,31027737,62794641,-31766904,621
2022-05-09 21:20:16-04:00,21726,AZq9LHFskHUujKDJZTpWhpP9LRaDjQKcrf2Bz2eY6TtN,EtStidHXHYYQJ6E1h7LHmgewtiK7AjMAsDBw4XBCrdQs,True,34276905,8569226,53105,26552,26553,6L1WYrPiCMyi7XemPww4B4hvpKD1LQKD4RpiSKmrmgSC,2124221,28358348,-26234127,619
2022-05-09 21:20:24-04:00,21727,F5vnN191nY9kUJBtFcm6fUhPDJvUSrSHLvfstesb68rH,9DtiZh3FsVmZA9MRqZhonAN2Pk4rQdcWw8As76DnQ6ee,True,366883667,91720916,569262,284631,284631,F31bVJvHB2XkhGdgjyTim48hY2cLFEx661AiPS3SzYJ2,22770496,54079969,-31309473,620
2022-05-09 21:37:50-04:00,21728,6cyefDEH1EqWn2RYGMtLj9CPhjXg5eECHsrm3C8fxurr,4o3XrjY3LA63KkjPtNGbwEuq59qXh8WmuEDsD5mfbtMD,True,99227854,24806963,72880,36440,36440,6L1WYrPiCMyi7XemPww4B4hvpKD1LQKD4RpiSKmrmgSC,2915214,4988942,-2073728,293
2022-05-09 21:41:56-04:00,21729,F5vnN191nY9kUJBtFcm6fUhPDJvUSrSHLvfstesb68rH,9DtiZh3FsVmZA9MRqZhonAN2Pk4rQdcWw8As76DnQ6ee,True,269713415,67428353,418797,209398,209399,5HnvdJnCCcmRsm4GkXnYWd4q9RpwuvYDGEUMPkYR3Ts9,16751898,45684869,-28932971,621
2022-05-09 21:44:26-04:00,21730,7qxGLMg6ZAxkVjhuj2PY6a5F36k4Efo3aCa99kvTpSKw,wgWcmEebBLbcm9a2jyCiw8nzqbGbfj6zRou4ZZhfWp7,True,47986110,9036041,31859,15929,15930,68sueyVfmy5ToEGtLFGDkwebX47xAmzyXE29z8JrmcWv,1691959,2669579,-977620,352
2022-05-09 22:03:40-04:00,21731,6cyefDEH1EqWn2RYGMtLj9CPhjXg5eECHsrm3C8fxurr,4o3XrjY3LA63KkjPtNGbwEuq59qXh8WmuEDsD5mfbtMD,True,73731864,18432966,53229,26614,26615,6L1WYrPiCMyi7XemPww4B4hvpKD1LQKD4RpiSKmrmgSC,2129180,4373599,-2244419,288
2022-05-09 22:08:25-04:00,21732,HooxSzasW3HMoFJ6sAvRQ75Char1J5aBdJtsqfDV6myp,BCmsWwpGeV4NNfeKZKKydty2uueLGHYTJDk1WErpXsVT,False,15255192,15255192,950610,47530,903080,6L1WYrPiCMyi7XemPww4B4hvpKD1LQKD4RpiSKmrmgSC,950610,7749582,-6798972,623
2022-05-09 22:12:28-04:00,21733,5FewDaMC9U7n5EHcto98GaAmDVxDh5SYimuTP6AtfakM,7DAULUoqV7f9hsBzKEhjQPnWaHSqiMWcBqWcdcadaQv4,True,31927209,7981802,49845,24922,24923,68sueyVfmy5ToEGtLFGDkwebX47xAmzyXE29z8JrmcWv,1993825,11161493,-9167668,624
2022-05-09 22:13:32-04:00,21734,8uoS53t92hUWWx6mZHGhpKs3dkYJYyiRufnp4H1anBJH,E1Nc6fTaZ7EFFJqVDnEfV3odtasBRhEzbtg4JDFDzJ3k,False,14769753,14769753,922810,46140,876670,68sueyVfmy5ToEGtLFGDkwebX47xAmzyXE29z8JrmcWv,922810,15516733,-14593923,624
2022-05-09 22:15:08-04:00,21735,F5vnN191nY9kUJBtFcm6fUhPDJvUSrSHLvfstesb68rH,9DtiZh3FsVmZA9MRqZhonAN2Pk4rQdcWw8As76DnQ6ee,True,198500993,49625248,309684,154842,154842,F31bVJvHB2XkhGdgjyTim48hY2cLFEx661AiPS3SzYJ2,12387395,37872045,-25484650,624
2022-05-09 22:27:31-04:00,21736,2BtRzBie97hsFBLgu4X4dTGCtv8We7npaXM9MmcqdWvf,C2hEQdUE3nFGJB3e6pHx8JZguZfdW9FYDHi9PGXkakm,True,332963351,83240837,207364,103682,103682,5HnvdJnCCcmRsm4GkXnYWd4q9RpwuvYDGEUMPkYR3Ts9,8294600,1624542,6670058,249
2022-05-09 22:37:18-04:00,21737,F5vnN191nY9kUJBtFcm6fUhPDJvUSrSHLvfstesb68rH,9DtiZh3FsVmZA9MRqZhonAN2Pk4rQdcWw8As76DnQ6ee,True,145917269,36479317,227980,113990,113990,68sueyVfmy5ToEGtLFGDkwebX47xAmzyXE29z8JrmcWv,9119235,31191674,-22072439,624
2022-05-09 22:40:01-04:00,21738,29hcg7nN7unogHZTe72dL9C6SSG2hGbMtmK9egS7guub,B2y9KwPJe964UBYqfpMP3q6sRLBpvsT3xR5RwGGL7L2f,True,24908368906,6227092226,18684838,9342419,9342419,DA18qE9qesbBqpwNv1M4befYcNQkbSBSeLPTmQzrmbJw,747393533,1198615326,-451221793,300
2022-05-09 22:56:57-04:00,21739,F5vnN191nY9kUJBtFcm6fUhPDJvUSrSHLvfstesb68rH,9DtiZh3FsVmZA9MRqZhonAN2Pk4rQdcWw8As76DnQ6ee,True,106665440,26666360,152968,76484,76484,6L1WYrPiCMyi7XemPww4B4hvpKD1LQKD4RpiSKmrmgSC,6118743,25445849,-19327106,573
2022-05-09 22:57:14-04:00,21740,HcnP3UoGhbPx1hj5vrGueBzeWM5eWdpGmcU9HZmEGvoy,C8TvCYGcySV4MQ4y97vLnYUAqxKqSDahbyyKpfJreM3k,True,186095696,46523924,272690,136345,136345,6L1WYrPiCMyi7XemPww4B4hvpKD1LQKD4RpiSKmrmgSC,10907633,32964144,-22056511,586
2022-05-09 22:59:03-04:00,21741,HcnP3UoGhbPx1hj5vrGueBzeWM5eWdpGmcU9HZmEGvoy,C8TvCYGcySV4MQ4y97vLnYUAqxKqSDahbyyKpfJreM3k,True,137309174,34327293,209308,104654,104654,C4UnXuShCvjSMgBAgVNMy1oakxCNk1et27A82fywU112,8372345,27177750,-18805405,609
2022-05-09 22:59:04-04:00,21742,6HufrrRWdkPo2umgxtgvqnDSBMZrU7hbDvrX8qpnbMBQ,HJwfz9kANDRKNwRwbwzrWaqAZ57pzVoiiedC5uarDLjv,True,99483195,13449672,70884,35442,35442,C4UnXuShCvjSMgBAgVNMy1oakxCNk1et27A82fywU112,5243121,85576259,-80333138,527
2022-05-09 22:59:04-04:00,21743,F5vnN191nY9kUJBtFcm6fUhPDJvUSrSHLvfstesb68rH,9DtiZh3FsVmZA9MRqZhonAN2Pk4rQdcWw8As76DnQ6ee,True,78700129,19675032,116670,58335,58335,6L1WYrPiCMyi7XemPww4B4hvpKD1LQKD4RpiSKmrmgSC,4666824,20461252,-15794428,592
2022-05-09 23:11:17-04:00,21744,F5vnN191nY9kUJBtFcm6fUhPDJvUSrSHLvfstesb68rH,9DtiZh3FsVmZA9MRqZhonAN2Pk4rQdcWw8As76DnQ6ee,True,58145709,14536427,90260,45130,45130,5HnvdJnCCcmRsm4GkXnYWd4q9RpwuvYDGEUMPkYR3Ts9,3610419,16335711,-12725292,620
2022-05-09 23:11:48-04:00,21745,CAqcooQi8ZyYUehyWXcz83i8p7CNyBNRTY1jbjv4ZZdD,5PzRa1oukLxXfAoJaRMUn5D4uRjF8qN57nADD4hK4qAg,True,1396618221,349154555,2133561,1066780,1066781,2xTUy2RS74GJMMDnmFaegMzFLn19RVfYG4CibhBmjP1i,85342472,337017178,-251674706,611
2022-05-09 23:11:48-04:00,21746,HcnP3UoGhbPx1hj5vrGueBzeWM5eWdpGmcU9HZmEGvoy,C8TvCYGcySV4MQ4y97vLnYUAqxKqSDahbyyKpfJreM3k,True,100758520,25189630,145859,72929,72930,68sueyVfmy5ToEGtLFGDkwebX47xAmzyXE29z8JrmcWv,5834388,22162040,-16327652,579
2022-05-09 23:12:00-04:00,21747,6HufrrRWdkPo2umgxtgvqnDSBMZrU7hbDvrX8qpnbMBQ,HJwfz9kANDRKNwRwbwzrWaqAZ57pzVoiiedC5uarDLjv,True,84985475,9861581,51034,25517,25517,6L1WYrPiCMyi7XemPww4B4hvpKD1LQKD4RpiSKmrmgSC,4398103,61939950,-57541847,517
2022-05-09 23:15:06-04:00,21748,HcnP3UoGhbPx1hj5vrGueBzeWM5eWdpGmcU9HZmEGvoy,C8TvCYGcySV4MQ4y97vLnYUAqxKqSDahbyyKpfJreM3k,True,74351265,18587816,111772,55886,55886,68sueyVfmy5ToEGtLFGDkwebX47xAmzyXE29z8JrmcWv,4470904,17934400,-13463496,601
2022-05-09 23:15:09-04:00,21749,F5vnN191nY9kUJBtFcm6fUhPDJvUSrSHLvfstesb68rH,9DtiZh3FsVmZA9MRqZhonAN2Pk4rQdcWw8As76DnQ6ee,True,42615187,10653796,63151,31575,31576,6L1WYrPiCMyi7XemPww4B4hvpKD1LQKD4RpiSKmrmgSC,2526064,13064174,-10538110,592
2022-05-09 23:15:52-04:00,21750,CAqcooQi8ZyYUehyWXcz83i8p7CNyBNRTY1jbjv4ZZdD,5PzRa1oukLxXfAoJaRMUn5D4uRjF8qN57nADD4hK4qAg,True,1028468074,257117018,1605332,802666,802666,3zqXX6kzhkbW3d4TwD2CNjMRwxTbREXySekvq37kfCNk,64213319,271990570,-207777251,624
2022-05-09 23:16:28-04:00,21751,CS7E1f7LjgmwFUs85CMG45Q6qDy9NqmuGfJywfjjrf1U,Bem68iukByPcPpgzi63FufEhjTigKkPeeW2gY4o8zK2Z,False,14621736,14621736,890260,44513,845747,6L1WYrPiCMyi7XemPww4B4hvpKD1LQKD4RpiSKmrmgSC,890260,12607379,-11717119,608
2022-05-09 23:16:34-04:00,21752,6fqbSyhh3PPdgRcLraHb7Jahj9s1oHHeX3SsjNSsGa6t,GpRUow48TYgttdYfsygbgjYQcmHyYjWETUDjDVphEgwq,True,56547019,14136754,87997,43998,43999,6L1WYrPiCMyi7XemPww4B4hvpKD1LQKD4RpiSKmrmgSC,3519903,33856390,-30336487,622
2022-05-09 23:16:56-04:00,21753,4X3JtctRhYihcyDkxk1B4QNWt15JkiSWCtLu9sWh9T88,BqxESjHzsRi9RBQA8v6uBCACDPTshEpaWPd4c8JBDqa8,True,171736597,42934149,266518,133259,133259,6L1WYrPiCMyi7XemPww4B4hvpKD1LQKD4RpiSKmrmgSC,10660737,109040322,-98379585,620
2022-05-09 23:17:08-04:00,21754,9cE3sPydeiFpAZajTK8ewa8pQLT5MvQPemwrHJUyzH1C,2XB63S8WX5FWQYTKuDrq75aMFVHZ3KCuZDiP5Cy95VPe,True,26730167,6682541,40691,20345,20346,5HnvdJnCCcmRsm4GkXnYWd4q9RpwuvYDGEUMPkYR3Ts9,1627678,16199994,-14572316,608
2022-05-09 23:17:18-04:00,21755,H69q3Q8E74xm7swmMQpsJLVp2Q9JuBwBbxraAMX5Drzm,5RiCCwr1YLn1136t6pprm9FAvcrJNG8VA394CYHpYbtA,True,10161999441,2540499860,15868043,7934021,7934022,AmTrMPzuTp2BjnjqGNKqz9FTTCdpoKcPAJLwFc8ozcbh,634721746,1064346744,-429624998,624
2022-05-09 23:17:29-04:00,21756,6HufrrRWdkPo2umgxtgvqnDSBMZrU7hbDvrX8qpnbMBQ,HJwfz9kANDRKNwRwbwzrWaqAZ57pzVoiiedC5uarDLjv,True,74164603,7198475,36110,18055,18055,5HnvdJnCCcmRsm4GkXnYWd4q9RpwuvYDGEUMPkYR3Ts9,3720370,44005508,-40285138,501
2022-05-09 23:17:55-04:00,21757,9MS5y8Y5UNDJLXwSjPtXpfsJUZFSEkULfk7zouuxxEhU,F7jXVeLxKwjypj5kChnN3uJDGE46eVTgHAhN7EncKGBE,False,5990425,5990425,365817,18290,347527,5HnvdJnCCcmRsm4GkXnYWd4q9RpwuvYDGEUMPkYR3Ts9,365817,11173695,-10807878,610
2022-05-09 23:18:19-04:00,21758,F5vnN191nY9kUJBtFcm6fUhPDJvUSrSHLvfstesb68rH,9DtiZh3FsVmZA9MRqZhonAN2Pk4rQdcWw8As76DnQ6ee,True,31443847,7860961,48634,24317,24317,5HnvdJnCCcmRsm4GkXnYWd4q9RpwuvYDGEUMPkYR3Ts9,1945369,10366522,-8421153,618
2022-05-09 23:21:00-04:00,21759,HcnP3UoGhbPx1hj5vrGueBzeWM5eWdpGmcU9HZmEGvoy,C8TvCYGcySV4MQ4y97vLnYUAqxKqSDahbyyKpfJreM3k,True,54752999,13688249,83717,41858,41859,5HnvdJnCCcmRsm4GkXnYWd4q9RpwuvYDGEUMPkYR3Ts9,3348682,14456828,-11108146,611
2022-05-09 23:22:46-04:00,21760,CAqcooQi8ZyYUehyWXcz83i8p7CNyBNRTY1jbjv4ZZdD,5PzRa1oukLxXfAoJaRMUn5D4uRjF8qN57nADD4hK4qAg,True,753427014,188356753,1117098,558549,558549,A2p75MbAbeUdHkPLkAjgGeiwuu9WPrkMHzjCkDXF1Xr3,44683945,218455211,-173771266,593
2022-05-09 23:23:27-04:00,21761,9cE3sPydeiFpAZajTK8ewa8pQLT5MvQPemwrHJUyzH1C,2XB63S8WX5FWQYTKuDrq75aMFVHZ3KCuZDiP5Cy95VPe,True,19684756,4921189,30602,15301,15301,5HnvdJnCCcmRsm4GkXnYWd4q9RpwuvYDGEUMPkYR3Ts9,1224117,12516238,-11292121,621
2022-05-09 23:23:31-04:00,21762,6fqbSyhh3PPdgRcLraHb7Jahj9s1oHHeX3SsjNSsGa6t,GpRUow48TYgttdYfsygbgjYQcmHyYjWETUDjDVphEgwq,True,41540222,10385055,64046,32023,32023,6L1WYrPiCMyi7XemPww4B4hvpKD1LQKD4RpiSKmrmgSC,2561863,26184328,-23622465,616
2022-05-09 23:24:32-04:00,21763,4X3JtctRhYihcyDkxk1B4QNWt15JkiSWCtLu9sWh9T88,BqxESjHzsRi9RBQA8v6uBCACDPTshEpaWPd4c8JBDqa8,True,126289991,31572497,197044,98522,98522,F31bVJvHB2XkhGdgjyTim48hY2cLFEx661AiPS3SzYJ2,7881762,84179432,-76297670,624
2022-05-09 23:24:56-04:00,21764,H69q3Q8E74xm7swmMQpsJLVp2Q9JuBwBbxraAMX5Drzm,5RiCCwr1YLn1136t6pprm9FAvcrJNG8VA394CYHpYbtA,True,7461199744,1865299936,11463846,5731923,5731923,2xTUy2RS74GJMMDnmFaegMzFLn19RVfYG4CibhBmjP1i,458553866,942286901,-483733035,614
2022-05-09 23:31:08-04:00,21765,6HufrrRWdkPo2umgxtgvqnDSBMZrU7hbDvrX8qpnbMBQ,HJwfz9kANDRKNwRwbwzrWaqAZ57pzVoiiedC5uarDLjv,True,66408159,5274197,25730,12865,12865,C4UnXuShCvjSMgBAgVNMy1oakxCNk1et27A82fywU112,3239817,30359110,-27119293,487
2022-05-09 23:31:16-04:00,21766,F5vnN191nY9kUJBtFcm6fUhPDJvUSrSHLvfstesb68rH,9DtiZh3FsVmZA9MRqZhonAN2Pk4rQdcWw8As76DnQ6ee,True,23127534,5781883,36034,18017,18017,5HnvdJnCCcmRsm4GkXnYWd4q9RpwuvYDGEUMPkYR3Ts9,1441383,8212615,-6771232,623
2022-05-09 23:32:31-04:00,21767,HcnP3UoGhbPx1hj5vrGueBzeWM5eWdpGmcU9HZmEGvoy,C8TvCYGcySV4MQ4y97vLnYUAqxKqSDahbyyKpfJreM3k,True,40269569,10067392,61744,30872,30872,6L1WYrPiCMyi7XemPww4B4hvpKD1LQKD4RpiSKmrmgSC,2469784,11596116,-9126332,613
2022-05-09 23:35:06-04:00,21768,5zSrKR5jwRqcCCFh2CcqH4DPE5ka56dmBqjndjuTLzLb,DjoKm6riRduDv4jUuQ2vPRZgJo7oyrhKqBBu9ypxvZhh,True,76824222,19199533,117880,58940,58940,6L1WYrPiCMyi7XemPww4B4hvpKD1LQKD4RpiSKmrmgSC,4716858,148844290,-144127432,613
2022-05-09 23:35:12-04:00,21769,CAqcooQi8ZyYUehyWXcz83i8p7CNyBNRTY1jbjv4ZZdD,5PzRa1oukLxXfAoJaRMUn5D4uRjF8qN57nADD4hK4qAg,True,554358003,138589500,821364,410682,410682,3zqXX6kzhkbW3d4TwD2CNjMRwxTbREXySekvq37kfCNk,32854589,173903239,-141048650,592
2022-05-09 23:35:38-04:00,21770,6fqbSyhh3PPdgRcLraHb7Jahj9s1oHHeX3SsjNSsGa6t,GpRUow48TYgttdYfsygbgjYQcmHyYjWETUDjDVphEgwq,True,30520964,7630241,46590,23295,23295,5HnvdJnCCcmRsm4GkXnYWd4q9RpwuvYDGEUMPkYR3Ts9,1863614,20214698,-18351084,610
2022-05-09 23:35:38-04:00,21771,4X3JtctRhYihcyDkxk1B4QNWt15JkiSWCtLu9sWh9T88,BqxESjHzsRi9RBQA8v6uBCACDPTshEpaWPd4c8JBDqa8,True,92807485,23201871,144367,72183,72184,3zqXX6kzhkbW3d4TwD2CNjMRwxTbREXySekvq37kfCNk,5774709,64908263,-59133554,622
2022-05-09 23:35:39-04:00,21772,9cE3sPydeiFpAZajTK8ewa8pQLT5MvQPemwrHJUyzH1C,2XB63S8WX5FWQYTKuDrq75aMFVHZ3KCuZDiP5Cy95VPe,False,14462962,14462962,892910,44645,848265,3zqXX6kzhkbW3d4TwD2CNjMRwxTbREXySekvq37kfCNk,892910,9662613,-8769703,617
2022-05-09 23:40:07-04:00,21773,H69q3Q8E74xm7swmMQpsJLVp2Q9JuBwBbxraAMX5Drzm,5RiCCwr1YLn1136t6pprm9FAvcrJNG8VA394CYHpYbtA,True,5487452202,1371863050,8466060,4233030,4233030,2py1FiYeL2f7J3HU36qiJz6TD6HCmiTN36RyxYtapQCZ,338642414,810565884,-471923470,617
2022-05-09 23:44:48-04:00,21774,F5vnN191nY9kUJBtFcm6fUhPDJvUSrSHLvfstesb68rH,9DtiZh3FsVmZA9MRqZhonAN2Pk4rQdcWw8As76DnQ6ee,True,16991403,4247850,26277,13138,13139,6L1WYrPiCMyi7XemPww4B4hvpKD1LQKD4RpiSKmrmgSC,1051101,6483782,-5432681,618
2022-05-09 23:44:51-04:00,21775,HcnP3UoGhbPx1hj5vrGueBzeWM5eWdpGmcU9HZmEGvoy,C8TvCYGcySV4MQ4y97vLnYUAqxKqSDahbyyKpfJreM3k,True,29644497,7411124,46259,23129,23130,C4UnXuShCvjSMgBAgVNMy1oakxCNk1et27A82fywU112,1850360,9252812,-7402452,624
2022-05-09 23:45:14-04:00,21776,5zSrKR5jwRqcCCFh2CcqH4DPE5ka56dmBqjndjuTLzLb,DjoKm6riRduDv4jUuQ2vPRZgJo7oyrhKqBBu9ypxvZhh,True,56551588,14131383,88105,44052,44053,3zqXX6kzhkbW3d4TwD2CNjMRwxTbREXySekvq37kfCNk,3525877,112697375,-109171498,623
2022-05-09 23:45:45-04:00,21777,CAqcooQi8ZyYUehyWXcz83i8p7CNyBNRTY1jbjv4ZZdD,5PzRa1oukLxXfAoJaRMUn5D4uRjF8qN57nADD4hK4qAg,True,408717717,102179429,624560,312280,312280,6UQfSsLooL4pQKQfLtXCutQS2BnF7A7F7ewJopDLmUpc,24982439,137824138,-112841699,611
2022-05-09 23:47:10-04:00,21778,6fqbSyhh3PPdgRcLraHb7Jahj9s1oHHeX3SsjNSsGa6t,GpRUow48TYgttdYfsygbgjYQcmHyYjWETUDjDVphEgwq,True,22462056,5615514,34708,17354,17354,6L1WYrPiCMyi7XemPww4B4hvpKD1LQKD4RpiSKmrmgSC,1388357,15580355,-14191998,618
2022-05-09 23:47:26-04:00,21779,4X3JtctRhYihcyDkxk1B4QNWt15JkiSWCtLu9sWh9T88,BqxESjHzsRi9RBQA8v6uBCACDPTshEpaWPd4c8JBDqa8,True,68173290,17043322,104950,52475,52475,5HnvdJnCCcmRsm4GkXnYWd4q9RpwuvYDGEUMPkYR3Ts9,4198018,49980670,-45782652,615
2022-05-09 23:47:28-04:00,21780,6HufrrRWdkPo2umgxtgvqnDSBMZrU7hbDvrX8qpnbMBQ,HJwfz9kANDRKNwRwbwzrWaqAZ57pzVoiiedC5uarDLjv,True,60420457,3822746,18134,9067,9067,5HnvdJnCCcmRsm4GkXnYWd4q9RpwuvYDGEUMPkYR3Ts9,2866340,20000991,-17134651,474
2022-05-09 23:47:56-04:00,21781,H69q3Q8E74xm7swmMQpsJLVp2Q9JuBwBbxraAMX5Drzm,5RiCCwr1YLn1136t6pprm9FAvcrJNG8VA394CYHpYbtA,True,4031369516,1007842379,6148917,3074458,3074459,8HQmsTbxhLhy25fvfCb16HudTGQ9wkHoEBRz5WYeqiZw,245956718,684495628,-438538910,610
2022-05-09 23:48:37-04:00,21782,F5vnN191nY9kUJBtFcm6fUhPDJvUSrSHLvfstesb68rH,9DtiZh3FsVmZA9MRqZhonAN2Pk4rQdcWw8As76DnQ6ee,False,12488074,12488074,769345,38467,730878,68sueyVfmy5ToEGtLFGDkwebX47xAmzyXE29z8JrmcWv,769345,5099340,-4329995,616
2022-05-09 23:48:37-04:00,21783,HcnP3UoGhbPx1hj5vrGueBzeWM5eWdpGmcU9HZmEGvoy,C8TvCYGcySV4MQ4y97vLnYUAqxKqSDahbyyKpfJreM3k,True,21787802,5446950,33963,16981,16982,5HnvdJnCCcmRsm4GkXnYWd4q9RpwuvYDGEUMPkYR3Ts9,1358530,7355953,-5997423,623
2022-05-09 23:48:45-04:00,21784,8B2hVK6ZKj9NVVtS7JjausbeWFCFPikxw4vejtyfDAVC,9fAoYzgFWFGERcizHbLXjF1scTYD61TWeKhFwsmgUmCv,False,2245777,2245777,90024,4501,85523,6L1WYrPiCMyi7XemPww4B4hvpKD1LQKD4RpiSKmrmgSC,90025,2995701,-2905676,400
2022-05-09 23:48:51-04:00,21785,CAqcooQi8ZyYUehyWXcz83i8p7CNyBNRTY1jbjv4ZZdD,5PzRa1oukLxXfAoJaRMUn5D4uRjF8qN57nADD4hK4qAg,True,300919861,75229965,468486,234243,234243,5HnvdJnCCcmRsm4GkXnYWd4q9RpwuvYDGEUMPkYR3Ts9,18739452,108991622,-90252170,622
2022-05-09 23:48:51-04:00,21786,5zSrKR5jwRqcCCFh2CcqH4DPE5ka56dmBqjndjuTLzLb,DjoKm6riRduDv4jUuQ2vPRZgJo7oyrhKqBBu9ypxvZhh,True,41538196,10378020,63853,31926,31927,6L1WYrPiCMyi7XemPww4B4hvpKD1LQKD4RpiSKmrmgSC,2555763,85319142,-82763379,615
2022-05-09 23:49:49-04:00,21787,6fqbSyhh3PPdgRcLraHb7Jahj9s1oHHeX3SsjNSsGa6t,GpRUow48TYgttdYfsygbgjYQcmHyYjWETUDjDVphEgwq,True,16508036,4127009,25378,12689,12689,68sueyVfmy5ToEGtLFGDkwebX47xAmzyXE29z8JrmcWv,1015143,11997658,-10982515,614
2022-05-09 23:49:50-04:00,21788,DDmGzGuVK67aG3U7s85xJwt3gTiKK9S9tP43u6SSfuTM,ERwURauRuJAgpvQu6moTwDPYHNkuMHVvcF353RHJCaGg,True,29287289437,3130558426,13718613,6859306,6859307,AmTrMPzuTp2BjnjqGNKqz9FTTCdpoKcPAJLwFc8ozcbh,1283416390,2006937181,-723520791,438
2022-05-09 23:49:53-04:00,21789,6HufrrRWdkPo2umgxtgvqnDSBMZrU7hbDvrX8qpnbMBQ,HJwfz9kANDRKNwRwbwzrWaqAZ57pzVoiiedC5uarDLjv,True,56322515,3620372,16675,8337,8338,5HnvdJnCCcmRsm4GkXnYWd4q9RpwuvYDGEUMPkYR3Ts9,2594260,12100659,-9506399,460
2022-05-09 23:49:53-04:00,21790,4X3JtctRhYihcyDkxk1B4QNWt15JkiSWCtLu9sWh9T88,BqxESjHzsRi9RBQA8v6uBCACDPTshEpaWPd4c8JBDqa8,True,49946939,12486734,72750,36375,36375,3zqXX6kzhkbW3d4TwD2CNjMRwxTbREXySekvq37kfCNk,2910039,38430148,-35520109,582
2022-05-09 23:49:53-04:00,21791,H69q3Q8E74xm7swmMQpsJLVp2Q9JuBwBbxraAMX5Drzm,5RiCCwr1YLn1136t6pprm9FAvcrJNG8VA394CYHpYbtA,True,2963734984,740933746,4500391,2250195,2250196,DQCvC9mR68hJ3tJsUiddh6JwcBJAmntqGJR2nUsEq7yj,180015648,568921714,-388906066,607
2022-05-09 23:50:58-04:00,21792,HcnP3UoGhbPx1hj5vrGueBzeWM5eWdpGmcU9HZmEGvoy,C8TvCYGcySV4MQ4y97vLnYUAqxKqSDahbyyKpfJreM3k,False,15993852,15993852,977567,48878,928689,6L1WYrPiCMyi7XemPww4B4hvpKD1LQKD4RpiSKmrmgSC,977567,5822642,-4845075,611
2022-05-09 23:51:03-04:00,21793,5zSrKR5jwRqcCCFh2CcqH4DPE5ka56dmBqjndjuTLzLb,DjoKm6riRduDv4jUuQ2vPRZgJo7oyrhKqBBu9ypxvZhh,True,30574143,7637014,47605,23802,23803,68sueyVfmy5ToEGtLFGDkwebX47xAmzyXE29z8JrmcWv,1905877,64567128,-62661251,623
2022-05-09 23:51:09-04:00,21794,CAqcooQi8ZyYUehyWXcz83i8p7CNyBNRTY1jbjv4ZZdD,5PzRa1oukLxXfAoJaRMUn5D4uRjF8qN57nADD4hK4qAg,True,221227853,55306963,345223,172611,172612,68sueyVfmy5ToEGtLFGDkwebX47xAmzyXE29z8JrmcWv,13808923,85961470,-72152547,624
2022-05-09 23:51:27-04:00,21795,4X3JtctRhYihcyDkxk1B4QNWt15JkiSWCtLu9sWh9T88,BqxESjHzsRi9RBQA8v6uBCACDPTshEpaWPd4c8JBDqa8,True,36801231,9200307,54457,27228,27229,3zqXX6kzhkbW3d4TwD2CNjMRwxTbREXySekvq37kfCNk,2178315,29477422,-27299107,591
2022-05-09 23:51:29-04:00,21796,H69q3Q8E74xm7swmMQpsJLVp2Q9JuBwBbxraAMX5Drzm,5RiCCwr1YLn1136t6pprm9FAvcrJNG8VA394CYHpYbtA,True,2180024771,545006192,3318469,1659234,1659235,4yhyLx1phodwcvvwVU2bramHcdbJYvfadd7pANsRzX8M,132738790,467311620,-334572830,608
2022-05-09 23:51:30-04:00,21797,Guz4ofgn6nw3yfBYbPKx3828HGB9uGURTpAPrcNiJprv,5fkvyvCF2YTXw1rGKy5YjHH175sD9vnF1QGW7gEb7sFa,True,32869954,2302663,10533,5266,5267,6L1WYrPiCMyi7XemPww4B4hvpKD1LQKD4RpiSKmrmgSC,1503645,18914950,-17411305,457
2022-05-09 23:51:35-04:00,21798,6fqbSyhh3PPdgRcLraHb7Jahj9s1oHHeX3SsjNSsGa6t,GpRUow48TYgttdYfsygbgjYQcmHyYjWETUDjDVphEgwq,False,12079033,12079033,687771,34388,653383,C4UnXuShCvjSMgBAgVNMy1oakxCNk1et27A82fywU112,687771,9226657,-8538886,569
2022-05-09 23:51:54-04:00,21799,6HufrrRWdkPo2umgxtgvqnDSBMZrU7hbDvrX8qpnbMBQ,HJwfz9kANDRKNwRwbwzrWaqAZ57pzVoiiedC5uarDLjv,True,52452900,7009106,31693,15846,15847,6L1WYrPiCMyi7XemPww4B4hvpKD1LQKD4RpiSKmrmgSC,2371814,13412123,-11040309,452
2022-05-09 23:54:30-04:00,21800,5zSrKR5jwRqcCCFh2CcqH4DPE5ka56dmBqjndjuTLzLb,DjoKm6riRduDv4jUuQ2vPRZgJo7oyrhKqBBu9ypxvZhh,True,22476449,5612592,34898,17449,17449,C4UnXuShCvjSMgBAgVNMy1oakxCNk1et27A82fywU112,1397592,48856872,-47459280,621
2022-05-09 23:54:46-04:00,21801,CAqcooQi8ZyYUehyWXcz83i8p7CNyBNRTY1jbjv4ZZdD,5PzRa1oukLxXfAoJaRMUn5D4uRjF8qN57nADD4hK4qAg,True,162619362,40654840,254054,127027,127027,6L1WYrPiCMyi7XemPww4B4hvpKD1LQKD4RpiSKmrmgSC,10162172,67578877,-57416705,624
2022-05-09 23:55:14-04:00,21802,4X3JtctRhYihcyDkxk1B4QNWt15JkiSWCtLu9sWh9T88,BqxESjHzsRi9RBQA8v6uBCACDPTshEpaWPd4c8JBDqa8,True,27147702,6786925,41765,20882,20883,C4UnXuShCvjSMgBAgVNMy1oakxCNk1et27A82fywU112,1670636,22598218,-20927582,615
2022-05-09 23:55:29-04:00,21803,H69q3Q8E74xm7swmMQpsJLVp2Q9JuBwBbxraAMX5Drzm,5RiCCwr1YLn1136t6pprm9FAvcrJNG8VA394CYHpYbtA,True,1603911172,400977793,2457822,1228911,1228911,A9TwRM1BMxqb8DCC7YNAMV6zPenEJm3HTZBy7wJKK58U,98312914,380415022,-282102108,612
2022-05-09 23:55:32-04:00,21804,6HufrrRWdkPo2umgxtgvqnDSBMZrU7hbDvrX8qpnbMBQ,HJwfz9kANDRKNwRwbwzrWaqAZ57pzVoiiedC5uarDLjv,True,45242795,2712719,12724,6362,6362,6L1WYrPiCMyi7XemPww4B4hvpKD1LQKD4RpiSKmrmgSC,2122182,15509463,-13387281,469
2022-05-09 23:56:48-04:00,21805,5zSrKR5jwRqcCCFh2CcqH4DPE5ka56dmBqjndjuTLzLb,DjoKm6riRduDv4jUuQ2vPRZgJo7oyrhKqBBu9ypxvZhh,True,16528869,4125673,25651,12825,12826,68sueyVfmy5ToEGtLFGDkwebX47xAmzyXE29z8JrmcWv,1027706,36959802,-35932096,621
2022-05-09 23:57:15-04:00,21806,Guz4ofgn6nw3yfBYbPKx3828HGB9uGURTpAPrcNiJprv,5fkvyvCF2YTXw1rGKy5YjHH175sD9vnF1QGW7gEb7sFa,True,30424550,4258538,18901,9450,9451,6L1WYrPiCMyi7XemPww4B4hvpKD1LQKD4RpiSKmrmgSC,1350371,17704197,-16353826,443
2022-05-09 23:57:23-04:00,21807,CAqcooQi8ZyYUehyWXcz83i8p7CNyBNRTY1jbjv4ZZdD,5PzRa1oukLxXfAoJaRMUn5D4uRjF8qN57nADD4hK4qAg,True,119454125,29863531,184943,92471,92472,C4UnXuShCvjSMgBAgVNMy1oakxCNk1et27A82fywU112,7397721,52971074,-45573353,619
2022-05-09 23:57:35-04:00,21808,6HufrrRWdkPo2umgxtgvqnDSBMZrU7hbDvrX8qpnbMBQ,HJwfz9kANDRKNwRwbwzrWaqAZ57pzVoiiedC5uarDLjv,True,42393566,2657815,12339,6169,6170,6L1WYrPiCMyi7XemPww4B4hvpKD1LQKD4RpiSKmrmgSC,1968244,16495399,-14527155,464
2022-05-09 23:57:49-04:00,21809,4X3JtctRhYihcyDkxk1B4QNWt15JkiSWCtLu9sWh9T88,BqxESjHzsRi9RBQA8v6uBCACDPTshEpaWPd4c8JBDqa8,True,19967635,4991908,30893,15446,15447,68sueyVfmy5ToEGtLFGDkwebX47xAmzyXE29z8JrmcWv,1235729,17324574,-16088845,618
2022-05-09 23:58:41-04:00,21810,H69q3Q8E74xm7swmMQpsJLVp2Q9JuBwBbxraAMX5Drzm,5RiCCwr1YLn1136t6pprm9FAvcrJNG8VA394CYHpYbtA,True,1180491435,295122858,1835328,917664,917664,3zqXX6kzhkbW3d4TwD2CNjMRwxTbREXySekvq37kfCNk,73413148,307467932,-234054784,621
2022-05-09 23:59:28-04:00,21811,Guz4ofgn6nw3yfBYbPKx3828HGB9uGURTpAPrcNiJprv,5fkvyvCF2YTXw1rGKy5YjHH175sD9vnF1QGW7gEb7sFa,True,26043401,1723958,8001,4000,4001,6L1WYrPiCMyi7XemPww4B4hvpKD1LQKD4RpiSKmrmgSC,1208859,15950714,-14741855,464
2022-05-09 23:59:56-04:00,21812,4X3JtctRhYihcyDkxk1B4QNWt15JkiSWCtLu9sWh9T88,BqxESjHzsRi9RBQA8v6uBCACDPTshEpaWPd4c8JBDqa8,False,14683001,14683001,912110,45605,866505,3zqXX6kzhkbW3d4TwD2CNjMRwxTbREXySekvq37kfCNk,912110,13271480,-12359370,621
2022-05-09 23:59:59-04:00,21813,CAqcooQi8ZyYUehyWXcz83i8p7CNyBNRTY1jbjv4ZZdD,5PzRa1oukLxXfAoJaRMUn5D4uRjF8qN57nADD4hK4qAg,True,87388193,21847048,125259,62629,62630,6L1WYrPiCMyi7XemPww4B4hvpKD1LQKD4RpiSKmrmgSC,5010377,41393031,-36382654,573
2022-05-10 00:00:01-04:00,21814,5zSrKR5jwRqcCCFh2CcqH4DPE5ka56dmBqjndjuTLzLb,DjoKm6riRduDv4jUuQ2vPRZgJo7oyrhKqBBu9ypxvZhh,False,12081164,12081164,680022,34001,646021,3zqXX6kzhkbW3d4TwD2CNjMRwxTbREXySekvq37kfCNk,680023,27953744,-27273721,562
2022-05-10 00:00:15-04:00,21815,Guz4ofgn6nw3yfBYbPKx3828HGB9uGURTpAPrcNiJprv,5fkvyvCF2YTXw1rGKy5YjHH175sD9vnF1QGW7gEb7sFa,True,24196816,1573373,6930,3465,3465,68sueyVfmy5ToEGtLFGDkwebX47xAmzyXE29z8JrmcWv,1065822,15027098,-13961276,440
2022-05-10 00:00:29-04:00,21816,H69q3Q8E74xm7swmMQpsJLVp2Q9JuBwBbxraAMX5Drzm,5RiCCwr1YLn1136t6pprm9FAvcrJNG8VA394CYHpYbtA,True,869389871,217347467,1358419,679209,679210,A9TwRM1BMxqb8DCC7YNAMV6zPenEJm3HTZBy7wJKK58U,54336792,245876792,-191540000,624
2022-05-10 00:01:11-04:00,21817,Guz4ofgn6nw3yfBYbPKx3828HGB9uGURTpAPrcNiJprv,5fkvyvCF2YTXw1rGKy5YjHH175sD9vnF1QGW7gEb7sFa,False,22550425,22550425,985872,49293,936579,68sueyVfmy5ToEGtLFGDkwebX47xAmzyXE29z8JrmcWv,985874,13519241,-12533367,437
2022-05-10 00:02:19-04:00,21818,6HufrrRWdkPo2umgxtgvqnDSBMZrU7hbDvrX8qpnbMBQ,HJwfz9kANDRKNwRwbwzrWaqAZ57pzVoiiedC5uarDLjv,True,39352417,5250815,23470,11735,11735,6L1WYrPiCMyi7XemPww4B4hvpKD1LQKD4RpiSKmrmgSC,1759018,10365580,-8606562,446
2022-05-10 00:02:23-04:00,21819,CAqcooQi8ZyYUehyWXcz83i8p7CNyBNRTY1jbjv4ZZdD,5PzRa1oukLxXfAoJaRMUn5D4uRjF8qN57nADD4hK4qAg,True,64516395,16129098,94135,47067,47068,6L1WYrPiCMyi7XemPww4B4hvpKD1LQKD4RpiSKmrmgSC,3765435,32077308,-28311873,583
2022-05-10 00:05:31-04:00,21820,H69q3Q8E74xm7swmMQpsJLVp2Q9JuBwBbxraAMX5Drzm,5RiCCwr1YLn1136t6pprm9FAvcrJNG8VA394CYHpYbtA,True,636676777,159169194,940318,470159,470159,DA18qE9qesbBqpwNv1M4befYcNQkbSBSeLPTmQzrmbJw,37612746,196644636,-159031890,590
2022-05-10 00:05:31-04:00,21821,6HufrrRWdkPo2umgxtgvqnDSBMZrU7hbDvrX8qpnbMBQ,HJwfz9kANDRKNwRwbwzrWaqAZ57pzVoiiedC5uarDLjv,True,34079884,2032127,9519,4759,4760,5HnvdJnCCcmRsm4GkXnYWd4q9RpwuvYDGEUMPkYR3Ts9,1596436,11944894,-10348458,468
2022-05-10 00:06:06-04:00,21822,CAqcooQi8ZyYUehyWXcz83i8p7CNyBNRTY1jbjv4ZZdD,5PzRa1oukLxXfAoJaRMUn5D4uRjF8qN57nADD4hK4qAg,True,47378274,11844568,66556,33278,33278,6L1WYrPiCMyi7XemPww4B4hvpKD1LQKD4RpiSKmrmgSC,2662277,24905279,-22243002,561
2022-05-10 00:06:49-04:00,21823,6HufrrRWdkPo2umgxtgvqnDSBMZrU7hbDvrX8qpnbMBQ,HJwfz9kANDRKNwRwbwzrWaqAZ57pzVoiiedC5uarDLjv,True,31945140,3938034,18293,9146,9147,5HnvdJnCCcmRsm4GkXnYWd4q9RpwuvYDGEUMPkYR3Ts9,1484000,12686781,-11202781,464
2022-05-10 00:07:36-04:00,21824,H69q3Q8E74xm7swmMQpsJLVp2Q9JuBwBbxraAMX5Drzm,5RiCCwr1YLn1136t6pprm9FAvcrJNG8VA394CYHpYbtA,True,467393645,116848411,663962,331981,331981,5HnvdJnCCcmRsm4GkXnYWd4q9RpwuvYDGEUMPkYR3Ts9,26558490,155952607,-129394117,568
2022-05-10 00:07:42-04:00,21825,CAqcooQi8ZyYUehyWXcz83i8p7CNyBNRTY1jbjv4ZZdD,5PzRa1oukLxXfAoJaRMUn5D4uRjF8qN57nADD4hK4qAg,True,35131200,8782800,54830,27415,27415,6L1WYrPiCMyi7XemPww4B4hvpKD1LQKD4RpiSKmrmgSC,2193215,19278015,-17084800,624
2022-05-10 00:08:50-04:00,21826,6HufrrRWdkPo2umgxtgvqnDSBMZrU7hbDvrX8qpnbMBQ,HJwfz9kANDRKNwRwbwzrWaqAZ57pzVoiiedC5uarDLjv,True,27911496,1848965,8948,4474,4474,5HnvdJnCCcmRsm4GkXnYWd4q9RpwuvYDGEUMPkYR3Ts9,1350809,13870650,-12519841,483
2022-05-10 00:20:05-04:00,21827,29hcg7nN7unogHZTe72dL9C6SSG2hGbMtmK9egS7guub,B2y9KwPJe964UBYqfpMP3q6sRLBpvsT3xR5RwGGL7L2f,True,18852490123,4713122530,14112534,7056267,7056267,F31bVJvHB2XkhGdgjyTim48hY2cLFEx661AiPS3SzYJ2,564501369,1079850094,-515348725,299
2022-05-10 00:21:25-04:00,21828,CVjkHr29t8pzeXU1U1CdMpT6qwf9Jw4XGxvxU7RURPYj,D66Zpxp7q4Tn4KiLa2pHTrADhgtP8tGqNXVPyCo9mcxc,True,402973872,100743468,576078,288039,288039,6L1WYrPiCMyi7XemPww4B4hvpKD1LQKD4RpiSKmrmgSC,23043146,46844144,-23800998,571
2022-05-10 00:33:51-04:00,21829,C5YJApJ5drW91Ma3GM9WM1kPxnZ8SY38r2zDCULVszSg,FKE5C1ZjH6W97cdcpznPNAvZJVE6GCJGdQuUFFTbKkKn,True,428950477,107237619,323011,161505,161506,A2p75MbAbeUdHkPLkAjgGeiwuu9WPrkMHzjCkDXF1Xr3,12920445,31369308,-18448863,301
2022-05-10 00:33:52-04:00,21830,29hcg7nN7unogHZTe72dL9C6SSG2hGbMtmK9egS7guub,B2y9KwPJe964UBYqfpMP3q6sRLBpvsT3xR5RwGGL7L2f,True,14266593307,3566648326,10579078,5289539,5289539,A2p75MbAbeUdHkPLkAjgGeiwuu9WPrkMHzjCkDXF1Xr3,423163121,940130229,-516967108,296
2022-05-10 00:34:17-04:00,21831,CVjkHr29t8pzeXU1U1CdMpT6qwf9Jw4XGxvxU7RURPYj,D66Zpxp7q4Tn4KiLa2pHTrADhgtP8tGqNXVPyCo9mcxc,True,276901019,69225254,432638,216319,216319,C4UnXuShCvjSMgBAgVNMy1oakxCNk1et27A82fywU112,17305532,38266520,-20960988,624
2022-05-10 00:34:30-04:00,21832,61tFQBtkHmkJ1Fzh1emPUvpL3RwaUSuh6RFjq59Uz28r,36U3HDhVU6hcqeyNNBsZoZ8c7Xf5Yb3c1aX1beyAbLAz,True,3584822560,896205640,4860810,2430405,2430405,AmTrMPzuTp2BjnjqGNKqz9FTTCdpoKcPAJLwFc8ozcbh,194432412,343111342,-148678930,542
2022-05-10 00:34:37-04:00,21833,29hcg7nN7unogHZTe72dL9C6SSG2hGbMtmK9egS7guub,B2y9KwPJe964UBYqfpMP3q6sRLBpvsT3xR5RwGGL7L2f,True,10794868499,2698717124,7941513,3970756,3970757,GXyFXZMNk2NFyEzw6JetVqsujqcz2yCixH7n8EpDJYWD,317660525,802133572,-484473047,294
2022-05-10 00:34:41-04:00,21834,C5YJApJ5drW91Ma3GM9WM1kPxnZ8SY38r2zDCULVszSg,FKE5C1ZjH6W97cdcpznPNAvZJVE6GCJGdQuUFFTbKkKn,True,325161410,81290352,228722,114361,114361,AmTrMPzuTp2BjnjqGNKqz9FTTCdpoKcPAJLwFc8ozcbh,9148882,26435720,-17286838,281
2022-05-10 00:34:57-04:00,21835,61tFQBtkHmkJ1Fzh1emPUvpL3RwaUSuh6RFjq59Uz28r,36U3HDhVU6hcqeyNNBsZoZ8c7Xf5Yb3c1aX1beyAbLAz,True,2710630805,677657701,4188942,2094471,2094471,AmTrMPzuTp2BjnjqGNKqz9FTTCdpoKcPAJLwFc8ozcbh,167557717,301227376,-133669659,618
2022-05-10 00:35:02-04:00,21836,CVjkHr29t8pzeXU1U1CdMpT6qwf9Jw4XGxvxU7RURPYj,D66Zpxp7q4Tn4KiLa2pHTrADhgtP8tGqNXVPyCo9mcxc,True,211515879,52878969,325819,162909,162910,C4UnXuShCvjSMgBAgVNMy1oakxCNk1et27A82fywU112,13032780,32594482,-19561702,616
2022-05-10 00:39:00-04:00,21837,98EU6xz94j8Hn2xDNB9LdUtZBSxEmKu6pxhRpC9E4v5v,Hn62HqTJg42gHoEcBRE6raaijqCEk2TNToMNubKAsxpV,True,7043002697,1760750674,5283281,2641640,2641641,A2p75MbAbeUdHkPLkAjgGeiwuu9WPrkMHzjCkDXF1Xr3,211331278,458336695,-247005417,300
2022-05-10 00:39:01-04:00,21838,61tFQBtkHmkJ1Fzh1emPUvpL3RwaUSuh6RFjq59Uz28r,36U3HDhVU6hcqeyNNBsZoZ8c7Xf5Yb3c1aX1beyAbLAz,True,2068013875,517003468,3208200,1604100,1604100,gjBMZYVujDjD1ECG4i97M8Q3gV9ESnwwTSUGropkusj,128328004,263703797,-135375793,620
2022-05-10 00:41:49-04:00,21839,C5YJApJ5drW91Ma3GM9WM1kPxnZ8SY38r2zDCULVszSg,FKE5C1ZjH6W97cdcpznPNAvZJVE6GCJGdQuUFFTbKkKn,True,245435695,61358923,183888,91944,91944,5HnvdJnCCcmRsm4GkXnYWd4q9RpwuvYDGEUMPkYR3Ts9,7355523,21886215,-14530692,299
2022-05-10 00:42:05-04:00,21840,61tFQBtkHmkJ1Fzh1emPUvpL3RwaUSuh6RFjq59Uz28r,36U3HDhVU6hcqeyNNBsZoZ8c7Xf5Yb3c1aX1beyAbLAz,True,1578332192,394583048,2444950,1222475,1222475,AmTrMPzuTp2BjnjqGNKqz9FTTCdpoKcPAJLwFc8ozcbh,97798019,226698607,-128900588,619
2022-05-10 00:43:48-04:00,21841,CVjkHr29t8pzeXU1U1CdMpT6qwf9Jw4XGxvxU7RURPYj,D66Zpxp7q4Tn4KiLa2pHTrADhgtP8tGqNXVPyCo9mcxc,True,158911706,39727926,229291,114645,114646,6L1WYrPiCMyi7XemPww4B4hvpKD1LQKD4RpiSKmrmgSC,9171646,10519392,-1347746,577
2022-05-10 00:46:58-04:00,21842,CVjkHr29t8pzeXU1U1CdMpT6qwf9Jw4XGxvxU7RURPYj,D66Zpxp7q4Tn4KiLa2pHTrADhgtP8tGqNXVPyCo9mcxc,True,118555559,29638889,180854,90427,90427,6L1WYrPiCMyi7XemPww4B4hvpKD1LQKD4RpiSKmrmgSC,7234190,7783152,-548962,610
2022-05-10 00:52:18-04:00,21843,CVjkHr29t8pzeXU1U1CdMpT6qwf9Jw4XGxvxU7RURPYj,D66Zpxp7q4Tn4KiLa2pHTrADhgtP8tGqNXVPyCo9mcxc,True,90425148,22606287,138621,69310,69311,72FwbpFGoLEazJEdpqNtPNefsadUrimUqma9wSoy4qiS,5544858,7465223,-1920365,613
2022-05-10 00:52:28-04:00,21844,29hcg7nN7unogHZTe72dL9C6SSG2hGbMtmK9egS7guub,B2y9KwPJe964UBYqfpMP3q6sRLBpvsT3xR5RwGGL7L2f,True,8164456279,2041114069,6035352,3017676,3017676,3zqXX6kzhkbW3d4TwD2CNjMRwxTbREXySekvq37kfCNk,241414108,674104131,-432690023,295
2022-05-10 00:53:02-04:00,21845,CVjkHr29t8pzeXU1U1CdMpT6qwf9Jw4XGxvxU7RURPYj,D66Zpxp7q4Tn4KiLa2pHTrADhgtP8tGqNXVPyCo9mcxc,True,69535346,17383836,92243,46121,46122,72FwbpFGoLEazJEdpqNtPNefsadUrimUqma9wSoy4qiS,3689752,6846604,-3156852,530
2022-05-10 00:56:13-04:00,21846,CVjkHr29t8pzeXU1U1CdMpT6qwf9Jw4XGxvxU7RURPYj,D66Zpxp7q4Tn4KiLa2pHTrADhgtP8tGqNXVPyCo9mcxc,True,52503869,13125967,81128,40564,40564,6L1WYrPiCMyi7XemPww4B4hvpKD1LQKD4RpiSKmrmgSC,3245150,5965201,-2720051,618
2022-05-10 00:56:41-04:00,21847,61tFQBtkHmkJ1Fzh1emPUvpL3RwaUSuh6RFjq59Uz28r,36U3HDhVU6hcqeyNNBsZoZ8c7Xf5Yb3c1aX1beyAbLAz,True,1204767202,301191800,1858375,929187,929188,AmTrMPzuTp2BjnjqGNKqz9FTTCdpoKcPAJLwFc8ozcbh,74335011,192055154,-117720143,617
2022-05-10 00:57:32-04:00,21848,61tFQBtkHmkJ1Fzh1emPUvpL3RwaUSuh6RFjq59Uz28r,36U3HDhVU6hcqeyNNBsZoZ8c7Xf5Yb3c1aX1beyAbLAz,True,919054708,229763677,1424933,712466,712467,4yhyLx1phodwcvvwVU2bramHcdbJYvfadd7pANsRzX8M,56997330,160781862,-103784532,620
2022-05-10 00:57:32-04:00,21849,CVjkHr29t8pzeXU1U1CdMpT6qwf9Jw4XGxvxU7RURPYj,D66Zpxp7q4Tn4KiLa2pHTrADhgtP8tGqNXVPyCo9mcxc,True,40191088,10047772,58770,29385,29385,5HnvdJnCCcmRsm4GkXnYWd4q9RpwuvYDGEUMPkYR3Ts9,2350836,5204090,-2853254,584
2022-05-10 00:57:34-04:00,21850,4iCuPKeTUGU5NX1svHMm7z7kt4YdEeJmUTnwN95acfkP,3UQYJzipqQvXYNGhHrT8KJtU9QZZe7u7gW8xaaAnPGJx,True,352802615,88200653,229533,114766,114767,5HnvdJnCCcmRsm4GkXnYWd4q9RpwuvYDGEUMPkYR3Ts9,9181392,0,9181392,260
2022-05-10 01:05:41-04:00,21851,C5YJApJ5drW91Ma3GM9WM1kPxnZ8SY38r2zDCULVszSg,FKE5C1ZjH6W97cdcpznPNAvZJVE6GCJGdQuUFFTbKkKn,True,185688449,46422112,139556,69778,69778,6L1WYrPiCMyi7XemPww4B4hvpKD1LQKD4RpiSKmrmgSC,5582277,18092496,-12510219,300
2022-05-10 01:06:35-04:00,21852,3C3KRcbd53ApLvLcwEhKmzVDuUYtrD9umuYKxk84b7Tv,34ucgaZhYG1PCzsowuBezPp5qUdj28CQxtmTSCtQBQXC,True,814256776,203564194,610993,305496,305497,DQCvC9mR68hJ3tJsUiddh6JwcBJAmntqGJR2nUsEq7yj,24439755,54255817,-29816062,300
2022-05-10 01:06:50-04:00,21853,7qxGLMg6ZAxkVjhuj2PY6a5F36k4Efo3aCa99kvTpSKw,wgWcmEebBLbcm9a2jyCiw8nzqbGbfj6zRou4ZZhfWp7,True,40277213,6933049,25432,12716,12716,5HnvdJnCCcmRsm4GkXnYWd4q9RpwuvYDGEUMPkYR3Ts9,1477531,776783,700748,366
2022-05-10 01:08:09-04:00,21854,3C3KRcbd53ApLvLcwEhKmzVDuUYtrD9umuYKxk84b7Tv,34ucgaZhYG1PCzsowuBezPp5qUdj28CQxtmTSCtQBQXC,True,616239330,154059832,457050,228525,228525,DQCvC9mR68hJ3tJsUiddh6JwcBJAmntqGJR2nUsEq7yj,18282014,46196674,-27914660,296
2022-05-10 01:08:15-04:00,21855,C5YJApJ5drW91Ma3GM9WM1kPxnZ8SY38r2zDCULVszSg,FKE5C1ZjH6W97cdcpznPNAvZJVE6GCJGdQuUFFTbKkKn,True,140750135,35187533,98973,49486,49487,F31bVJvHB2XkhGdgjyTim48hY2cLFEx661AiPS3SzYJ2,3958923,14825680,-10866757,281
2022-05-10 01:09:49-04:00,21856,H69q3Q8E74xm7swmMQpsJLVp2Q9JuBwBbxraAMX5Drzm,5RiCCwr1YLn1136t6pprm9FAvcrJNG8VA394CYHpYbtA,True,1471599479,367899869,2118470,1059235,1059235,A2p75MbAbeUdHkPLkAjgGeiwuu9WPrkMHzjCkDXF1Xr3,84738803,121046617,-36307814,575
2022-05-10 01:11:20-04:00,21857,H69q3Q8E74xm7swmMQpsJLVp2Q9JuBwBbxraAMX5Drzm,5RiCCwr1YLn1136t6pprm9FAvcrJNG8VA394CYHpYbtA,True,1088402802,272100700,1683088,841544,841544,DA18qE9qesbBqpwNv1M4befYcNQkbSBSeLPTmQzrmbJw,67323525,109877114,-42553589,618
2022-05-10 01:13:48-04:00,21858,H69q3Q8E74xm7swmMQpsJLVp2Q9JuBwBbxraAMX5Drzm,5RiCCwr1YLn1136t6pprm9FAvcrJNG8VA394CYHpYbtA,True,800538407,200134601,1246918,623459,623459,A2p75MbAbeUdHkPLkAjgGeiwuu9WPrkMHzjCkDXF1Xr3,49876742,97570108,-47693366,623
2022-05-10 01:35:11-04:00,21859,CVjkHr29t8pzeXU1U1CdMpT6qwf9Jw4XGxvxU7RURPYj,D66Zpxp7q4Tn4KiLa2pHTrADhgtP8tGqNXVPyCo9mcxc,True,30590956,7647739,46524,23262,23262,5HnvdJnCCcmRsm4GkXnYWd4q9RpwuvYDGEUMPkYR3Ts9,1860965,4448562,-2587597,608
2022-05-10 01:35:18-04:00,21860,61tFQBtkHmkJ1Fzh1emPUvpL3RwaUSuh6RFjq59Uz28r,36U3HDhVU6hcqeyNNBsZoZ8c7Xf5Yb3c1aX1beyAbLAz,True,701525233,175381308,1092909,546454,546455,3zqXX6kzhkbW3d4TwD2CNjMRwxTbREXySekvq37kfCNk,43716397,133797574,-90081177,623
2022-05-10 01:38:32-04:00,21861,29hcg7nN7unogHZTe72dL9C6SSG2hGbMtmK9egS7guub,B2y9KwPJe964UBYqfpMP3q6sRLBpvsT3xR5RwGGL7L2f,True,6814998063,1703749515,5072833,2536416,2536417,6UQfSsLooL4pQKQfLtXCutQS2BnF7A7F7ewJopDLmUpc,202913330,685684764,-482771434,297
2022-05-10 01:38:33-04:00,21862,C5YJApJ5drW91Ma3GM9WM1kPxnZ8SY38r2zDCULVszSg,FKE5C1ZjH6W97cdcpznPNAvZJVE6GCJGdQuUFFTbKkKn,True,106267543,26566885,78875,39437,39438,C4UnXuShCvjSMgBAgVNMy1oakxCNk1et27A82fywU112,3155009,12010184,-8855175,296
2022-05-10 01:38:33-04:00,21863,CVjkHr29t8pzeXU1U1CdMpT6qwf9Jw4XGxvxU7RURPYj,D66Zpxp7q4Tn4KiLa2pHTrADhgtP8tGqNXVPyCo9mcxc,True,23321720,5830430,35898,17949,17949,C4UnXuShCvjSMgBAgVNMy1oakxCNk1et27A82fywU112,1435938,3755148,-2319210,615
2022-05-10 01:39:26-04:00,21864,3C3KRcbd53ApLvLcwEhKmzVDuUYtrD9umuYKxk84b7Tv,34ucgaZhYG1PCzsowuBezPp5qUdj28CQxtmTSCtQBQXC,True,465974625,116493656,350745,175372,175373,6L1WYrPiCMyi7XemPww4B4hvpKD1LQKD4RpiSKmrmgSC,14029837,38764273,-24734436,301
2022-05-10 01:39:50-04:00,21865,61tFQBtkHmkJ1Fzh1emPUvpL3RwaUSuh6RFjq59Uz28r,36U3HDhVU6hcqeyNNBsZoZ8c7Xf5Yb3c1aX1beyAbLAz,True,535378770,133844692,834716,417358,417358,5HnvdJnCCcmRsm4GkXnYWd4q9RpwuvYDGEUMPkYR3Ts9,33388643,110189237,-76800594,623
2022-05-10 01:44:38-04:00,21866,E6JSJUMvo2qhzHLvYbzFefGHNeKbNbCdKM4f1UnNyfXn,E1oYD3YFn3bXoRULYvSXbtKYFYRYxgE2kyLkbtvXTVFD,True,793778062,198444515,600885,300442,300443,F31bVJvHB2XkhGdgjyTim48hY2cLFEx661AiPS3SzYJ2,24035401,90186581,-66151180,302
2022-05-10 01:44:47-04:00,21867,29hcg7nN7unogHZTe72dL9C6SSG2hGbMtmK9egS7guub,B2y9KwPJe964UBYqfpMP3q6sRLBpvsT3xR5RwGGL7L2f,True,5157140350,1289285087,3798717,1899358,1899359,AmTrMPzuTp2BjnjqGNKqz9FTTCdpoKcPAJLwFc8ozcbh,151948695,560312147,-408363452,294
2022-05-10 01:44:53-04:00,21868,Cb6MEn1MN9XQcVVd3o9J8QdK3cFWxSNETsFzhVJ8jmdh,A6yTKbggUftjbjAVu5YR1M7rg7h78ghbfofmTSnmKNGz,True,4970473154,1242618288,3705565,1852782,1852783,gjBMZYVujDjD1ECG4i97M8Q3gV9ESnwwTSUGropkusj,148222612,239120425,-90897813,298
2022-05-10 01:44:56-04:00,21869,3C3KRcbd53ApLvLcwEhKmzVDuUYtrD9umuYKxk84b7Tv,34ucgaZhYG1PCzsowuBezPp5qUdj28CQxtmTSCtQBQXC,True,352696354,88174088,261592,130796,130796,DQCvC9mR68hJ3tJsUiddh6JwcBJAmntqGJR2nUsEq7yj,10463707,32231790,-21768083,296
2022-05-10 01:44:56-04:00,21870,C5YJApJ5drW91Ma3GM9WM1kPxnZ8SY38r2zDCULVszSg,FKE5C1ZjH6W97cdcpznPNAvZJVE6GCJGdQuUFFTbKkKn,True,80517097,20129274,56492,28246,28246,68sueyVfmy5ToEGtLFGDkwebX47xAmzyXE29z8JrmcWv,2259695,9717609,-7457914,280
2022-05-10 01:45:11-04:00,21871,Hq7GCu2oQqD4QPgPdhHUEA57WYPdxWoHC5U35igedo1c,77B5irtBfDmvFTNmnsbt9VVMVYiyy6vVxeEp1eDCFn4h,True,6582336690,1645584172,10006703,5003351,5003352,6UQfSsLooL4pQKQfLtXCutQS2BnF7A7F7ewJopDLmUpc,400268152,933419693,-533151541,608
2022-05-10 01:45:17-04:00,21872,CVjkHr29t8pzeXU1U1CdMpT6qwf9Jw4XGxvxU7RURPYj,D66Zpxp7q4Tn4KiLa2pHTrADhgtP8tGqNXVPyCo9mcxc,True,17788697,4447174,27565,13782,13783,6L1WYrPiCMyi7XemPww4B4hvpKD1LQKD4RpiSKmrmgSC,1102633,3139453,-2036820,619
2022-05-10 01:45:46-04:00,21873,98CjCSKJVupUJ5G4kRDpWyLrP1qdXvcKtv9BbcGituAe,Gwp6Vo2j65exaVgWDG9eQQNwGc4fgJwt31mUVoJG1UyT,True,53189596368,13297399092,40225775,20112887,20112888,A9TwRM1BMxqb8DCC7YNAMV6zPenEJm3HTZBy7wJKK58U,1609031001,5029621843,-3420590842,302
2022-05-10 01:46:07-04:00,21874,iEXYXt9JNg6tud7wsHcTe349MNWHBgAoRptNpasAGwb,DNCFSLLWNWEVfsqht6EuiQ7PwCdzhHjDk9i4UpgnDTxB,True,183882876,42370215,125496,62748,62748,6L1WYrPiCMyi7XemPww4B4hvpKD1LQKD4RpiSKmrmgSC,5446468,905373,4541095,296
2022-05-10 01:46:35-04:00,21875,29hcg7nN7unogHZTe72dL9C6SSG2hGbMtmK9egS7guub,B2y9KwPJe964UBYqfpMP3q6sRLBpvsT3xR5RwGGL7L2f,True,3902860805,975715201,2828610,1414305,1414305,3zqXX6kzhkbW3d4TwD2CNjMRwxTbREXySekvq37kfCNk,113144436,454644629,-341500193,289
2022-05-10 01:46:35-04:00,21876,Cb6MEn1MN9XQcVVd3o9J8QdK3cFWxSNETsFzhVJ8jmdh,A6yTKbggUftjbjAVu5YR1M7rg7h78ghbfofmTSnmKNGz,True,3761138250,940284562,2780841,1390420,1390421,CGtKBgcWZ6HKE3tFNLPUM9khDv2Rc7d6BrPtxz7J1aY,111233663,212910303,-101676640,295
2022-05-10 01:46:35-04:00,21877,E6JSJUMvo2qhzHLvYbzFefGHNeKbNbCdKM4f1UnNyfXn,E1oYD3YFn3bXoRULYvSXbtKYFYRYxgE2kyLkbtvXTVFD,True,601925961,150481490,421052,210526,210526,3zqXX6kzhkbW3d4TwD2CNjMRwxTbREXySekvq37kfCNk,16842102,73053143,-56211041,279
2022-05-10 01:46:38-04:00,21878,3C3KRcbd53ApLvLcwEhKmzVDuUYtrD9umuYKxk84b7Tv,34ucgaZhYG1PCzsowuBezPp5qUdj28CQxtmTSCtQBQXC,True,266667112,66666778,201431,100715,100716,4yhyLx1phodwcvvwVU2bramHcdbJYvfadd7pANsRzX8M,8057269,26529235,-18471966,302
2022-05-10 01:46:39-04:00,21879,C5YJApJ5drW91Ma3GM9WM1kPxnZ8SY38r2zDCULVszSg,FKE5C1ZjH6W97cdcpznPNAvZJVE6GCJGdQuUFFTbKkKn,True,60881907,15220476,42727,21363,21364,5HnvdJnCCcmRsm4GkXnYWd4q9RpwuvYDGEUMPkYR3Ts9,1709119,7796691,-6087572,280
2022-05-10 01:47:07-04:00,21880,98CjCSKJVupUJ5G4kRDpWyLrP1qdXvcKtv9BbcGituAe,Gwp6Vo2j65exaVgWDG9eQQNwGc4fgJwt31mUVoJG1UyT,True,40253316873,10063329218,30192140,15096070,15096070,AmTrMPzuTp2BjnjqGNKqz9FTTCdpoKcPAJLwFc8ozcbh,1207685629,4158191203,-2950505574,300
2022-05-10 01:47:09-04:00,21881,61tFQBtkHmkJ1Fzh1emPUvpL3RwaUSuh6RFjq59Uz28r,36U3HDhVU6hcqeyNNBsZoZ8c7Xf5Yb3c1aX1beyAbLAz,True,410073896,102518474,600352,300176,300176,C4UnXuShCvjSMgBAgVNMy1oakxCNk1et27A82fywU112,24014109,90157134,-66143025,585
2022-05-10 01:47:11-04:00,21882,C5YJApJ5drW91Ma3GM9WM1kPxnZ8SY38r2zDCULVszSg,FKE5C1ZjH6W97cdcpznPNAvZJVE6GCJGdQuUFFTbKkKn,True,45947011,11486752,34520,17260,17260,C4UnXuShCvjSMgBAgVNMy1oakxCNk1et27A82fywU112,1380812,6232101,-4851289,300
2022-05-10 01:47:11-04:00,21883,E6JSJUMvo2qhzHLvYbzFefGHNeKbNbCdKM4f1UnNyfXn,E1oYD3YFn3bXoRULYvSXbtKYFYRYxgE2kyLkbtvXTVFD,True,454303142,113575785,339059,169529,169530,3zqXX6kzhkbW3d4TwD2CNjMRwxTbREXySekvq37kfCNk,13562379,58582295,-45019916,298
2022-05-10 01:47:24-04:00,21884,EixYycpq2qVBMY4zNAj8bWU5KFvH9mCN4ETnEd7PgqmR,9SLJ4kHG7oGfxGG929V57TXSKbQGtkqBJHh3Qag9asay,True,213524939276,18103775969,112785135,56392567,56392568,8HQmsTbxhLhy25fvfCb16HudTGQ9wkHoEBRz5WYeqiZw,13302439922,21344146544,-8041706622,622
2022-05-10 01:47:44-04:00,21885,CVjkHr29t8pzeXU1U1CdMpT6qwf9Jw4XGxvxU7RURPYj,D66Zpxp7q4Tn4KiLa2pHTrADhgtP8tGqNXVPyCo9mcxc,False,13588182,13588182,828409,41420,786989,6L1WYrPiCMyi7XemPww4B4hvpKD1LQKD4RpiSKmrmgSC,828409,2602686,-1774277,609
2022-05-10 01:47:47-04:00,21886,Hq7GCu2oQqD4QPgPdhHUEA57WYPdxWoHC5U35igedo1c,77B5irtBfDmvFTNmnsbt9VVMVYiyy6vVxeEp1eDCFn4h,True,5035068758,1258767189,7298630,3649315,3649315,AmTrMPzuTp2BjnjqGNKqz9FTTCdpoKcPAJLwFc8ozcbh,291945209,790570403,-498625194,579
2022-05-10 01:48:00-04:00,21887,61tFQBtkHmkJ1Fzh1emPUvpL3RwaUSuh6RFjq59Uz28r,36U3HDhVU6hcqeyNNBsZoZ8c7Xf5Yb3c1aX1beyAbLAz,True,313464164,78366041,437625,218812,218813,6L1WYrPiCMyi7XemPww4B4hvpKD1LQKD4RpiSKmrmgSC,17505015,73022595,-55517580,558
2022-05-10 01:48:29-04:00,21888,Hq7GCu2oQqD4QPgPdhHUEA57WYPdxWoHC5U35igedo1c,77B5irtBfDmvFTNmnsbt9VVMVYiyy6vVxeEp1eDCFn4h,True,3832440845,958110211,5712682,2856341,2856341,72XWPCtRYEDZbddP7d6dHtUBRRDLSJsB2xZTAfefoEVZ,228507303,658868393,-430361090,596
2022-05-10 01:48:56-04:00,21889,61tFQBtkHmkJ1Fzh1emPUvpL3RwaUSuh6RFjq59Uz28r,36U3HDhVU6hcqeyNNBsZoZ8c7Xf5Yb3c1aX1beyAbLAz,True,237800278,59450069,359130,179565,179565,A2p75MbAbeUdHkPLkAjgGeiwuu9WPrkMHzjCkDXF1Xr3,14365235,58706466,-44341231,604
2022-05-10 01:49:14-04:00,21890,29hcg7nN7unogHZTe72dL9C6SSG2hGbMtmK9egS7guub,B2y9KwPJe964UBYqfpMP3q6sRLBpvsT3xR5RwGGL7L2f,True,2951326747,737831686,2153367,1076683,1076684,3zqXX6kzhkbW3d4TwD2CNjMRwxTbREXySekvq37kfCNk,86134683,366566431,-280431748,291
2022-05-10 01:49:14-04:00,21891,Cb6MEn1MN9XQcVVd3o9J8QdK3cFWxSNETsFzhVJ8jmdh,A6yTKbggUftjbjAVu5YR1M7rg7h78ghbfofmTSnmKNGz,True,2844139537,711034884,2129174,1064587,1064587,DA18qE9qesbBqpwNv1M4befYcNQkbSBSeLPTmQzrmbJw,85166973,184834531,-99667558,299
2022-05-10 01:49:53-04:00,21892,3C3KRcbd53ApLvLcwEhKmzVDuUYtrD9umuYKxk84b7Tv,34ucgaZhYG1PCzsowuBezPp5qUdj28CQxtmTSCtQBQXC,True,201871300,50467825,149621,74810,74811,6L1WYrPiCMyi7XemPww4B4hvpKD1LQKD4RpiSKmrmgSC,5984872,21710410,-15725538,296
2022-05-10 02:05:41-04:00,21893,61tFQBtkHmkJ1Fzh1emPUvpL3RwaUSuh6RFjq59Uz28r,36U3HDhVU6hcqeyNNBsZoZ8c7Xf5Yb3c1aX1beyAbLAz,True,181631694,45407923,268853,134426,134427,6L1WYrPiCMyi7XemPww4B4hvpKD1LQKD4RpiSKmrmgSC,10754128,47292040,-36537912,592
2022-05-10 02:09:06-04:00,21894,61tFQBtkHmkJ1Fzh1emPUvpL3RwaUSuh6RFjq59Uz28r,36U3HDhVU6hcqeyNNBsZoZ8c7Xf5Yb3c1aX1beyAbLAz,True,138084910,34521227,215603,107801,107802,6L1WYrPiCMyi7XemPww4B4hvpKD1LQKD4RpiSKmrmgSC,8624136,37888995,-29264859,624
2022-05-10 02:11:30-04:00,21895,61tFQBtkHmkJ1Fzh1emPUvpL3RwaUSuh6RFjq59Uz28r,36U3HDhVU6hcqeyNNBsZoZ8c7Xf5Yb3c1aX1beyAbLAz,True,105490182,26372545,162050,81025,81025,6L1WYrPiCMyi7XemPww4B4hvpKD1LQKD4RpiSKmrmgSC,6482034,30357339,-23875305,614
2022-05-10 02:11:55-04:00,21896,61tFQBtkHmkJ1Fzh1emPUvpL3RwaUSuh6RFjq59Uz28r,36U3HDhVU6hcqeyNNBsZoZ8c7Xf5Yb3c1aX1beyAbLAz,True,80868577,20217144,114226,57113,57113,6L1WYrPiCMyi7XemPww4B4hvpKD1LQKD4RpiSKmrmgSC,4569044,24226555,-19657511,564
2022-05-10 02:12:46-04:00,21897,61tFQBtkHmkJ1Fzh1emPUvpL3RwaUSuh6RFjq59Uz28r,36U3HDhVU6hcqeyNNBsZoZ8c7Xf5Yb3c1aX1beyAbLAz,True,61327782,15331945,94461,47230,47231,C4UnXuShCvjSMgBAgVNMy1oakxCNk1et27A82fywU112,3778469,19198003,-15419534,616
2022-05-10 02:14:32-04:00,21898,2gavXbp1LSmnMCDYwtgU2TsbkGnUVMLDs9Ly8dFrv727,CEMdi4ApMU7sfiHKKB1WgBThjxRaHC8DyX6HAozm18gK,True,640421705,68662046,455162,227581,227581,3zqXX6kzhkbW3d4TwD2CNjMRwxTbREXySekvq37kfCNk,42453708,40225321,2228387,662
2022-05-10 02:16:27-04:00,21899,DgsQgzkRGC81h6UCKAkLA5j7A8bzYYXre57Z8g5aJnwh,8QTAu7aDZT7i5o1NrhEossKq96yZ8snnpNxtgMKZoXwo,True,15349416119,2636184697,17169170,8584585,8584585,A2p75MbAbeUdHkPLkAjgGeiwuu9WPrkMHzjCkDXF1Xr3,999690021,2603846352,-1604156331,651
2022-05-10 02:17:04-04:00,21900,2gavXbp1LSmnMCDYwtgU2TsbkGnUVMLDs9Ly8dFrv727,CEMdi4ApMU7sfiHKKB1WgBThjxRaHC8DyX6HAozm18gK,True,576291425,51779352,336636,168318,168318,5HnvdJnCCcmRsm4GkXnYWd4q9RpwuvYDGEUMPkYR3Ts9,37466780,36275715,1191065,650
2022-05-10 02:24:06-04:00,21901,F4hN7ecndZ8Gr5KQNSFaSrMGawMasz7jfWTLTMpk7gaB,AJ23FpXSGjipcqywk88WGsKfqfiiUjPzZLsvLtBAhB12,True,1145691230,224576852,1372964,686482,686482,gjBMZYVujDjD1ECG4i97M8Q3gV9ESnwwTSUGropkusj,70042566,129860127,-59817561,611
2022-05-10 02:35:44-04:00,21902,DgsQgzkRGC81h6UCKAkLA5j7A8bzYYXre57Z8g5aJnwh,8QTAu7aDZT7i5o1NrhEossKq96yZ8snnpNxtgMKZoXwo,True,12852014931,2015976487,13234925,6617462,6617463,CGtKBgcWZ6HKE3tFNLPUM9khDv2Rc7d6BrPtxz7J1aY,843737342,2373483724,-1529746382,656
2022-05-10 02:35:46-04:00,21903,2gavXbp1LSmnMCDYwtgU2TsbkGnUVMLDs9Ly8dFrv727,CEMdi4ApMU7sfiHKKB1WgBThjxRaHC8DyX6HAozm18gK,True,527315373,55550523,361619,180809,180810,6L1WYrPiCMyi7XemPww4B4hvpKD1LQKD4RpiSKmrmgSC,34326844,33032134,1294710,650
2022-05-10 02:35:56-04:00,21904,BLhFkXqiCSj18qNk77dEbyRJGVW6T94fqY24P8yTun3f,7KaD3MzMMKtuYW7STnmEr17LgUjpcwSaZs22UerHkSRj,True,4839660478,312469126,1992723,996361,996362,5HnvdJnCCcmRsm4GkXnYWd4q9RpwuvYDGEUMPkYR3Ts9,308641822,685396404,-376754582,637
2022-05-10 02:35:57-04:00,21905,8uZhgcgTGB3fDBZdiNkp7oMGys2bBoiTzWyYwrmKKC3U,5cVp8ogiZsS7x8TWCAqihMQiNNxLqi3xVYQ4TkhHPsjS,True,538119040,39816815,188084,94042,94042,5HnvdJnCCcmRsm4GkXnYWd4q9RpwuvYDGEUMPkYR3Ts9,25419363,55204638,-29785275,472
2022-05-10 02:37:13-04:00,21906,C5YJApJ5drW91Ma3GM9WM1kPxnZ8SY38r2zDCULVszSg,FKE5C1ZjH6W97cdcpznPNAvZJVE6GCJGdQuUFFTbKkKn,True,34756411,8689102,26291,13145,13146,5HnvdJnCCcmRsm4GkXnYWd4q9RpwuvYDGEUMPkYR3Ts9,1051663,4986298,-3934635,302
2022-05-10 02:37:15-04:00,21907,29hcg7nN7unogHZTe72dL9C6SSG2hGbMtmK9egS7guub,B2y9KwPJe964UBYqfpMP3q6sRLBpvsT3xR5RwGGL7L2f,True,2230240388,557560097,1683340,841670,841670,3zqXX6kzhkbW3d4TwD2CNjMRwxTbREXySekvq37kfCNk,67333624,294473618,-227139994,301
2022-05-10 02:37:30-04:00,21908,Cb6MEn1MN9XQcVVd3o9J8QdK3cFWxSNETsFzhVJ8jmdh,A6yTKbggUftjbjAVu5YR1M7rg7h78ghbfofmTSnmKNGz,True,2151757808,537939452,1611968,805984,805984,6L1WYrPiCMyi7XemPww4B4hvpKD1LQKD4RpiSKmrmgSC,64478726,157952710,-93473984,299
2022-05-10 02:37:33-04:00,21909,8uZhgcgTGB3fDBZdiNkp7oMGys2bBoiTzWyYwrmKKC3U,5cVp8ogiZsS7x8TWCAqihMQiNNxLqi3xVYQ4TkhHPsjS,True,500443633,30054128,138665,69332,69333,3zqXX6kzhkbW3d4TwD2CNjMRwxTbREXySekvq37kfCNk,23089871,52485729,-29395858,461
2022-05-10 02:37:44-04:00,21910,3C3KRcbd53ApLvLcwEhKmzVDuUYtrD9umuYKxk84b7Tv,34ucgaZhYG1PCzsowuBezPp5qUdj28CQxtmTSCtQBQXC,True,152722515,38180628,113072,56536,56536,6L1WYrPiCMyi7XemPww4B4hvpKD1LQKD4RpiSKmrmgSC,4522882,17636413,-13113531,296
2022-05-10 02:38:26-04:00,21911,8uZhgcgTGB3fDBZdiNkp7oMGys2bBoiTzWyYwrmKKC3U,5cVp8ogiZsS7x8TWCAqihMQiNNxLqi3xVYQ4TkhHPsjS,True,472011406,56758922,256482,128241,128241,68sueyVfmy5ToEGtLFGDkwebX47xAmzyXE29z8JrmcWv,21329305,50257316,-28928011,451
2022-05-10 02:39:43-04:00,21912,F4hN7ecndZ8Gr5KQNSFaSrMGawMasz7jfWTLTMpk7gaB,AJ23FpXSGjipcqywk88WGsKfqfiiUjPzZLsvLtBAhB12,True,939693210,172009019,1073345,536672,536673,A2p75MbAbeUdHkPLkAjgGeiwuu9WPrkMHzjCkDXF1Xr3,58637394,109333699,-50696305,624
2022-05-10 02:39:47-04:00,21913,DgsQgzkRGC81h6UCKAkLA5j7A8bzYYXre57Z8g5aJnwh,8QTAu7aDZT7i5o1NrhEossKq96yZ8snnpNxtgMKZoXwo,True,10941252785,1527945957,10128647,5064323,5064324,6L1WYrPiCMyi7XemPww4B4hvpKD1LQKD4RpiSKmrmgSC,725288076,2159929900,-1434641824,662
2022-05-10 02:44:20-04:00,21914,61tFQBtkHmkJ1Fzh1emPUvpL3RwaUSuh6RFjq59Uz28r,36U3HDhVU6hcqeyNNBsZoZ8c7Xf5Yb3c1aX1beyAbLAz,True,47269456,11817364,60259,30129,30130,68sueyVfmy5ToEGtLFGDkwebX47xAmzyXE29z8JrmcWv,2410389,15248688,-12838299,509
2022-05-10 02:44:33-04:00,21915,2gavXbp1LSmnMCDYwtgU2TsbkGnUVMLDs9Ly8dFrv727,CEMdi4ApMU7sfiHKKB1WgBThjxRaHC8DyX6HAozm18gK,True,474743938,38926395,254069,127034,127035,6L1WYrPiCMyi7XemPww4B4hvpKD1LQKD4RpiSKmrmgSC,30986137,37535833,-6549696,652
2022-05-10 03:18:22-04:00,21916,DyMysFYo5aXZD3oH8NnRW1syYPnNdjHPoyvU2Vv2cCzv,KrerC6i7z79cFza1ZXkadwNDqGMzzWbVnvpDCvuGyPz,True,16163999457,4040999864,22633646,11316823,11316823,DQCvC9mR68hJ3tJsUiddh6JwcBJAmntqGJR2nUsEq7yj,905345853,2113900856,-1208555003,560
2022-05-10 03:35:03-04:00,21917,H69q3Q8E74xm7swmMQpsJLVp2Q9JuBwBbxraAMX5Drzm,5RiCCwr1YLn1136t6pprm9FAvcrJNG8VA394CYHpYbtA,True,1930864916,482716229,3013962,1506981,1506981,8HQmsTbxhLhy25fvfCb16HudTGQ9wkHoEBRz5WYeqiZw,120558487,82722264,37836223,624
2022-05-10 04:01:03-04:00,21918,H69q3Q8E74xm7swmMQpsJLVp2Q9JuBwBbxraAMX5Drzm,5RiCCwr1YLn1136t6pprm9FAvcrJNG8VA394CYHpYbtA,True,1626928650,406732162,2520902,1260451,1260451,DA18qE9qesbBqpwNv1M4befYcNQkbSBSeLPTmQzrmbJw,100836096,88968885,11867211,619
2022-05-10 05:22:27-04:00,21919,H69q3Q8E74xm7swmMQpsJLVp2Q9JuBwBbxraAMX5Drzm,5RiCCwr1YLn1136t6pprm9FAvcrJNG8VA394CYHpYbtA,True,1532074242,383018560,2187732,1093866,1093866,2a35JJeTUW1pm6M3e8DHCjp8qr4vbc2cRPhuzZWyFzYd,87509309,89115259,-1605950,571
2022-05-10 05:23:03-04:00,21920,H69q3Q8E74xm7swmMQpsJLVp2Q9JuBwBbxraAMX5Drzm,5RiCCwr1YLn1136t6pprm9FAvcrJNG8VA394CYHpYbtA,True,1134052984,283513246,1757971,878985,878986,8HQmsTbxhLhy25fvfCb16HudTGQ9wkHoEBRz5WYeqiZw,70318879,86552625,-16233746,620
2022-05-10 05:25:30-04:00,21921,4T2MDxf43fxhNe8A2aF7G8hFFpPnkeWkMGPRiYVcBo9h,4cjUvZRpju4xAdS8b5CjxhVEk3o52KBGwjkH9hq23u8A,True,26255479,6563869,41016,20508,20508,8sEswn3kzEhnYjAZVvCQnHEUvYd7pFVvc2Xc2Kd1BpbC,1640654,6114248,-4473594,624
2022-05-10 05:25:33-04:00,21922,H69q3Q8E74xm7swmMQpsJLVp2Q9JuBwBbxraAMX5Drzm,5RiCCwr1YLn1136t6pprm9FAvcrJNG8VA394CYHpYbtA,True,833967523,208491880,1299717,649858,649859,3zqXX6kzhkbW3d4TwD2CNjMRwxTbREXySekvq37kfCNk,51988693,80751075,-28762382,623
2022-05-10 05:27:29-04:00,21923,H69q3Q8E74xm7swmMQpsJLVp2Q9JuBwBbxraAMX5Drzm,5RiCCwr1YLn1136t6pprm9FAvcrJNG8VA394CYHpYbtA,False,604509959,604509959,29723292,1486164,28237128,4yhyLx1phodwcvvwVU2bramHcdbJYvfadd7pANsRzX8M,29723292,72269039,-42545747,491
2022-05-10 05:27:31-04:00,21924,2ft5U63ftgQNAii4VqdquGxKgQF19vq1DGQSyRG4HeN6,Dkk8bAk4R4L2J1ywAcfrDbwcp6W1nTgcLATpGoGEUVN7,True,1846594027,150759190,600733,300366,300367,8sEswn3kzEhnYjAZVvCQnHEUvYd7pFVvc2Xc2Kd1BpbC,73581698,540505238,-466923540,398
2022-05-10 05:27:32-04:00,21925,4T2MDxf43fxhNe8A2aF7G8hFFpPnkeWkMGPRiYVcBo9h,4cjUvZRpju4xAdS8b5CjxhVEk3o52KBGwjkH9hq23u8A,False,19017618,19017618,925646,46282,879364,2a35JJeTUW1pm6M3e8DHCjp8qr4vbc2cRPhuzZWyFzYd,925646,4954843,-4029197,486
2022-05-10 05:33:53-04:00,21926,CmMkpR7Yewedgu4GvLCZAFKdGj19ex69w4EhCQ58i25o,5QWRVRgDMHoincpRD981hPaPsYhGGZnkRVYxtDDYYGLc,True,395326740,60838227,182547,91273,91274,68sueyVfmy5ToEGtLFGDkwebX47xAmzyXE29z8JrmcWv,11861929,37071161,-25209232,300
2022-05-10 05:34:25-04:00,21927,7agvoo7kQa27Gx8Vn4fr3PMZBeXSW3tSrg8DFCnLZAh3,5nFTJaKiqFRNxicLeyxywDgmasU97xtnZSRz8Dy8HpAd,True,290404542,45992415,139227,69613,69614,8sEswn3kzEhnYjAZVvCQnHEUvYd7pFVvc2Xc2Kd1BpbC,8791081,30185753,-21394672,302
2022-05-10 05:36:49-04:00,21928,HbJxpWkhz7Vn2iKtjtgWAuN6f2vQC38JJnTQGEFNDvxQ,HgchxTa4ji58Tw3XB5MH2WtnqcnrhocgLpPsfCQemfDf,True,238390008,59597501,157016,78508,78508,6L1WYrPiCMyi7XemPww4B4hvpKD1LQKD4RpiSKmrmgSC,6280713,633551,5647162,263
2022-05-10 06:00:57-04:00,21929,DyMysFYo5aXZD3oH8NnRW1syYPnNdjHPoyvU2Vv2cCzv,KrerC6i7z79cFza1ZXkadwNDqGMzzWbVnvpDCvuGyPz,True,9645194418,2411298604,14881411,7440705,7440706,AmTrMPzuTp2BjnjqGNKqz9FTTCdpoKcPAJLwFc8ozcbh,595256447,1007089790,-411833343,617
2022-05-10 06:01:42-04:00,21930,2ft5U63ftgQNAii4VqdquGxKgQF19vq1DGQSyRG4HeN6,Dkk8bAk4R4L2J1ywAcfrDbwcp6W1nTgcLATpGoGEUVN7,True,1687683901,310300588,1189408,594704,594704,4yhyLx1phodwcvvwVU2bramHcdbJYvfadd7pANsRzX8M,64690373,501625328,-436934955,383
2022-05-10 07:19:05-04:00,21931,29JVska5UEG3axs63EmtHpPvkswNEqYpZ3PKMSfupiAG,DCftNBUsuogxyaJe9G9m3eWipH6o3qo4Rn4TuQXdVaBF,True,335993509,83998377,253560,126780,126780,6L1WYrPiCMyi7XemPww4B4hvpKD1LQKD4RpiSKmrmgSC,10142428,16324156,-6181728,301
2022-05-10 07:19:48-04:00,21932,8MKNsuGVaoYpdQy6NNyxDvRzh2DAquBUtri4nDsixUxs,D7M1SDmpZAs8vdPCCCa96UbDF15YQDxHmoGWB57tHiir,True,9225650282,2306412570,6933966,3466983,3466983,2xTUy2RS74GJMMDnmFaegMzFLn19RVfYG4CibhBmjP1i,277358660,444697520,-167338860,300
2022-05-10 07:24:05-04:00,21933,29JVska5UEG3axs63EmtHpPvkswNEqYpZ3PKMSfupiAG,DCftNBUsuogxyaJe9G9m3eWipH6o3qo4Rn4TuQXdVaBF,True,254465870,63616467,185453,92726,92727,F31bVJvHB2XkhGdgjyTim48hY2cLFEx661AiPS3SzYJ2,7418130,14526172,-7108042,291
2022-05-10 07:33:27-04:00,21934,8MKNsuGVaoYpdQy6NNyxDvRzh2DAquBUtri4nDsixUxs,D7M1SDmpZAs8vdPCCCa96UbDF15YQDxHmoGWB57tHiir,True,6982562357,1745640589,5177501,2588750,2588751,8HQmsTbxhLhy25fvfCb16HudTGQ9wkHoEBRz5WYeqiZw,207100049,396688470,-189588421,296
2022-05-10 07:34:24-04:00,21935,Cb6MEn1MN9XQcVVd3o9J8QdK3cFWxSNETsFzhVJ8jmdh,A6yTKbggUftjbjAVu5YR1M7rg7h78ghbfofmTSnmKNGz,True,1318947894,329736973,972273,486136,486137,C4UnXuShCvjSMgBAgVNMy1oakxCNk1et27A82fywU112,38890953,63484996,-24594043,294
2022-05-10 07:34:24-04:00,21936,8MKNsuGVaoYpdQy6NNyxDvRzh2DAquBUtri4nDsixUxs,D7M1SDmpZAs8vdPCCCa96UbDF15YQDxHmoGWB57tHiir,True,5281430014,1320357503,3935357,1967678,1967679,4yhyLx1phodwcvvwVU2bramHcdbJYvfadd7pANsRzX8M,157414302,344543023,-187128721,298
2022-05-10 07:34:28-04:00,21937,29JVska5UEG3axs63EmtHpPvkswNEqYpZ3PKMSfupiAG,DCftNBUsuogxyaJe9G9m3eWipH6o3qo4Rn4TuQXdVaBF,True,192750509,48187627,133289,66644,66645,Hu94aiQWvce6THeGyCFqGRPM1pQrK3ihzkcXo1EpJcJL,5331571,12564278,-7232707,276
2022-05-10 07:37:31-04:00,21938,Cb6MEn1MN9XQcVVd3o9J8QdK3cFWxSNETsFzhVJ8jmdh,A6yTKbggUftjbjAVu5YR1M7rg7h78ghbfofmTSnmKNGz,True,999606146,249901536,688086,344043,344043,DQCvC9mR68hJ3tJsUiddh6JwcBJAmntqGJR2nUsEq7yj,27523455,56379613,-28856158,275
2022-05-10 07:37:32-04:00,21939,29JVska5UEG3axs63EmtHpPvkswNEqYpZ3PKMSfupiAG,DCftNBUsuogxyaJe9G9m3eWipH6o3qo4Rn4TuQXdVaBF,True,145621483,36405370,103492,51746,51746,68sueyVfmy5ToEGtLFGDkwebX47xAmzyXE29z8JrmcWv,4139681,10623134,-6483453,284
2022-05-10 08:02:42-04:00,21940,8MKNsuGVaoYpdQy6NNyxDvRzh2DAquBUtri4nDsixUxs,D7M1SDmpZAs8vdPCCCa96UbDF15YQDxHmoGWB57tHiir,True,3996238989,999059747,2957279,1478639,1478640,6L1WYrPiCMyi7XemPww4B4hvpKD1LQKD4RpiSKmrmgSC,118291189,294046598,-175755409,296
2022-05-10 08:26:04-04:00,21941,Cb6MEn1MN9XQcVVd3o9J8QdK3cFWxSNETsFzhVJ8jmdh,A6yTKbggUftjbjAVu5YR1M7rg7h78ghbfofmTSnmKNGz,True,753908718,188477179,565681,282840,282841,8sEswn3kzEhnYjAZVvCQnHEUvYd7pFVvc2Xc2Kd1BpbC,22627264,48482199,-25854935,300
2022-05-10 08:27:50-04:00,21942,29JVska5UEG3axs63EmtHpPvkswNEqYpZ3PKMSfupiAG,DCftNBUsuogxyaJe9G9m3eWipH6o3qo4Rn4TuQXdVaBF,True,109938521,27484630,82829,41414,41415,F31bVJvHB2XkhGdgjyTim48hY2cLFEx661AiPS3SzYJ2,3313199,8898378,-5585179,301
2022-05-10 08:31:37-04:00,21943,8MKNsuGVaoYpdQy6NNyxDvRzh2DAquBUtri4nDsixUxs,D7M1SDmpZAs8vdPCCCa96UbDF15YQDxHmoGWB57tHiir,True,3022094533,755523633,2260465,1130232,1130233,A9TwRM1BMxqb8DCC7YNAMV6zPenEJm3HTZBy7wJKK58U,90418619,247287400,-156868781,299
2022-05-10 08:39:45-04:00,21944,29hcg7nN7unogHZTe72dL9C6SSG2hGbMtmK9egS7guub,B2y9KwPJe964UBYqfpMP3q6sRLBpvsT3xR5RwGGL7L2f,True,1687360959,421840239,1275642,637821,637821,2a35JJeTUW1pm6M3e8DHCjp8qr4vbc2cRPhuzZWyFzYd,51025708,236101376,-185075668,302
2022-05-10 08:39:57-04:00,21945,Cb6MEn1MN9XQcVVd3o9J8QdK3cFWxSNETsFzhVJ8jmdh,A6yTKbggUftjbjAVu5YR1M7rg7h78ghbfofmTSnmKNGz,True,571432862,142858215,401506,200753,200753,Hu94aiQWvce6THeGyCFqGRPM1pQrK3ihzkcXo1EpJcJL,16060260,41457696,-25397436,281
2022-05-10 08:39:57-04:00,21946,DgsQgzkRGC81h6UCKAkLA5j7A8bzYYXre57Z8g5aJnwh,8QTAu7aDZT7i5o1NrhEossKq96yZ8snnpNxtgMKZoXwo,True,9495687170,1249360306,8354738,4177369,4177369,F31bVJvHB2XkhGdgjyTim48hY2cLFEx661AiPS3SzYJ2,634996808,1984911225,-1349914417,668
2022-05-10 08:39:58-04:00,21947,3C3KRcbd53ApLvLcwEhKmzVDuUYtrD9umuYKxk84b7Tv,34ucgaZhYG1PCzsowuBezPp5qUdj28CQxtmTSCtQBQXC,True,115647916,28911979,82690,41345,41345,6L1WYrPiCMyi7XemPww4B4hvpKD1LQKD4RpiSKmrmgSC,3307613,14248981,-10941368,286
2022-05-10 08:40:00-04:00,21948,29JVska5UEG3axs63EmtHpPvkswNEqYpZ3PKMSfupiAG,DCftNBUsuogxyaJe9G9m3eWipH6o3qo4Rn4TuQXdVaBF,True,83248011,20812002,60906,30453,30453,2a35JJeTUW1pm6M3e8DHCjp8qr4vbc2cRPhuzZWyFzYd,2436250,7419357,-4983107,292
2022-05-10 08:43:16-04:00,21949,8uZhgcgTGB3fDBZdiNkp7oMGys2bBoiTzWyYwrmKKC3U,5cVp8ogiZsS7x8TWCAqihMQiNNxLqi3xVYQ4TkhHPsjS,True,416652715,22867490,108223,54111,54112,F31bVJvHB2XkhGdgjyTim48hY2cLFEx661AiPS3SzYJ2,19718690,46578482,-26859792,473
2022-05-10 08:44:48-04:00,21950,8MKNsuGVaoYpdQy6NNyxDvRzh2DAquBUtri4nDsixUxs,D7M1SDmpZAs8vdPCCCa96UbDF15YQDxHmoGWB57tHiir,True,2287090361,571772590,1690967,845483,845484,3zqXX6kzhkbW3d4TwD2CNjMRwxTbREXySekvq37kfCNk,67638693,205887077,-138248384,295
2022-05-10 08:54:27-04:00,21951,8uZhgcgTGB3fDBZdiNkp7oMGys2bBoiTzWyYwrmKKC3U,5cVp8ogiZsS7x8TWCAqihMQiNNxLqi3xVYQ4TkhHPsjS,True,395087969,43134568,199878,99939,99939,3zqXX6kzhkbW3d4TwD2CNjMRwxTbREXySekvq37kfCNk,18307723,44575990,-26268267,463
2022-05-10 08:54:33-04:00,21952,29hcg7nN7unogHZTe72dL9C6SSG2hGbMtmK9egS7guub,B2y9KwPJe964UBYqfpMP3q6sRLBpvsT3xR5RwGGL7L2f,True,1276720080,319180020,963767,481883,481884,6L1WYrPiCMyi7XemPww4B4hvpKD1LQKD4RpiSKmrmgSC,38550706,188579417,-150028711,301
2022-05-10 08:54:39-04:00,21953,Cb6MEn1MN9XQcVVd3o9J8QdK3cFWxSNETsFzhVJ8jmdh,A6yTKbggUftjbjAVu5YR1M7rg7h78ghbfofmTSnmKNGz,True,431287703,107821925,323642,161821,161821,F31bVJvHB2XkhGdgjyTim48hY2cLFEx661AiPS3SzYJ2,12945698,34709608,-21763910,300
2022-05-10 08:54:58-04:00,21954,3C3KRcbd53ApLvLcwEhKmzVDuUYtrD9umuYKxk84b7Tv,34ucgaZhYG1PCzsowuBezPp5qUdj28CQxtmTSCtQBQXC,True,87352435,21838108,65210,32605,32605,8sEswn3kzEhnYjAZVvCQnHEUvYd7pFVvc2Xc2Kd1BpbC,2608425,11431056,-8822631,298
2022-05-10 09:02:55-04:00,21955,8uZhgcgTGB3fDBZdiNkp7oMGys2bBoiTzWyYwrmKKC3U,5cVp8ogiZsS7x8TWCAqihMQiNNxLqi3xVYQ4TkhHPsjS,True,352990233,20949846,101311,50655,50656,8sEswn3kzEhnYjAZVvCQnHEUvYd7pFVvc2Xc2Kd1BpbC,17070371,41208568,-24138197,483
2022-05-10 09:02:58-04:00,21956,29JVska5UEG3axs63EmtHpPvkswNEqYpZ3PKMSfupiAG,DCftNBUsuogxyaJe9G9m3eWipH6o3qo4Rn4TuQXdVaBF,True,62913848,15728462,47420,23710,23710,Hu94aiQWvce6THeGyCFqGRPM1pQrK3ihzkcXo1EpJcJL,1896809,6112036,-4215227,301
2022-05-10 09:03:26-04:00,21957,DgsQgzkRGC81h6UCKAkLA5j7A8bzYYXre57Z8g5aJnwh,8QTAu7aDZT7i5o1NrhEossKq96yZ8snnpNxtgMKZoXwo,True,8319765155,1123269322,7472429,3736214,3736215,6L1WYrPiCMyi7XemPww4B4hvpKD1LQKD4RpiSKmrmgSC,553463502,1746524470,-1193060968,665
2022-05-10 09:34:45-04:00,21958,H7rsFRRhZPe2jLex2NkbYYzVtLobvFiqnCd4BUyJVPBB,8bedwDRfSKLP9vUxoXcpHNJzWQemMaf4QGT2mtHFVJFb,True,352422197,88105549,265403,132701,132702,6L1WYrPiCMyi7XemPww4B4hvpKD1LQKD4RpiSKmrmgSC,10616126,17640554,-7024428,301
2022-05-10 09:35:23-04:00,21959,DHfy6B2AYsqMCxPLBCXMDfQn3Gr2VwJaLFHUZKqpCjsb,EPZpYaY1gCAb8pMtri5veRowBmCrCpTHBMa3Rmgt6S29,True,11508505467,2835492240,8157437,4078718,4078719,8HQmsTbxhLhy25fvfCb16HudTGQ9wkHoEBRz5WYeqiZw,331088600,195644575,135444025,287
2022-05-10 09:35:34-04:00,21960,5BGPpyb8KHRgebUyoV1h6DwXCszgzQCL9N8osisfSpRt,Ci1u2V8Zfx7AsbnkuoftH7A4iAj3EMczVqvPTeRXwP9R,True,155948317,38987079,239030,119515,119515,Hu94aiQWvce6THeGyCFqGRPM1pQrK3ihzkcXo1EpJcJL,9561238,17484935,-7923697,613
2022-05-10 09:35:38-04:00,21961,6MPPCbGXrGRptonhc7bEVumovWkvqsxdzkDwr34QAYaz,4PstuqLgNoWtNVAyHihvmgDAQ4hjzfjSDyY5F8HQYJFT,True,282676559,70669139,212760,106380,106380,2a35JJeTUW1pm6M3e8DHCjp8qr4vbc2cRPhuzZWyFzYd,8510420,81657384,-73146964,301
2022-05-10 09:35:59-04:00,21962,H7rsFRRhZPe2jLex2NkbYYzVtLobvFiqnCd4BUyJVPBB,8bedwDRfSKLP9vUxoXcpHNJzWQemMaf4QGT2mtHFVJFb,True,261901146,65475286,198380,99190,99190,2a35JJeTUW1pm6M3e8DHCjp8qr4vbc2cRPhuzZWyFzYd,7935221,15620179,-7684958,302
2022-05-10 09:41:21-04:00,21963,5BGPpyb8KHRgebUyoV1h6DwXCszgzQCL9N8osisfSpRt,Ci1u2V8Zfx7AsbnkuoftH7A4iAj3EMczVqvPTeRXwP9R,True,114784102,28696025,178626,89313,89313,8sEswn3kzEhnYjAZVvCQnHEUvYd7pFVvc2Xc2Kd1BpbC,7145072,15265264,-8120192,622
2022-05-10 09:44:24-04:00,21964,E6JSJUMvo2qhzHLvYbzFefGHNeKbNbCdKM4f1UnNyfXn,E1oYD3YFn3bXoRULYvSXbtKYFYRYxgE2kyLkbtvXTVFD,True,253946822,63486705,191510,95755,95755,6L1WYrPiCMyi7XemPww4B4hvpKD1LQKD4RpiSKmrmgSC,7660417,14996425,-7336008,301
2022-05-10 09:46:00-04:00,21965,5BGPpyb8KHRgebUyoV1h6DwXCszgzQCL9N8osisfSpRt,Ci1u2V8Zfx7AsbnkuoftH7A4iAj3EMczVqvPTeRXwP9R,True,84372750,21093187,131277,65638,65639,2a35JJeTUW1pm6M3e8DHCjp8qr4vbc2cRPhuzZWyFzYd,5251119,13056748,-7805629,622
2022-05-10 10:27:17-04:00,21966,5BGPpyb8KHRgebUyoV1h6DwXCszgzQCL9N8osisfSpRt,Ci1u2V8Zfx7AsbnkuoftH7A4iAj3EMczVqvPTeRXwP9R,True,62009186,15502296,96249,48124,48125,Hu94aiQWvce6THeGyCFqGRPM1pQrK3ihzkcXo1EpJcJL,3849998,10974685,-7124687,620
2022-05-10 10:28:12-04:00,21967,6MPPCbGXrGRptonhc7bEVumovWkvqsxdzkDwr34QAYaz,4PstuqLgNoWtNVAyHihvmgDAQ4hjzfjSDyY5F8HQYJFT,True,209990018,52497504,157061,78530,78531,5HnvdJnCCcmRsm4GkXnYWd4q9RpwuvYDGEUMPkYR3Ts9,6282443,63160972,-56878529,299
2022-05-10 10:28:55-04:00,21968,DHfy6B2AYsqMCxPLBCXMDfQn3Gr2VwJaLFHUZKqpCjsb,EPZpYaY1gCAb8pMtri5veRowBmCrCpTHBMa3Rmgt6S29,True,5661549171,1415387292,4287309,2143654,2143655,2a35JJeTUW1pm6M3e8DHCjp8qr4vbc2cRPhuzZWyFzYd,171492366,290380756,-118888390,302
2022-05-10 10:35:12-04:00,21969,H7rsFRRhZPe2jLex2NkbYYzVtLobvFiqnCd4BUyJVPBB,8bedwDRfSKLP9vUxoXcpHNJzWQemMaf4QGT2mtHFVJFb,True,194558265,48639566,146781,73390,73391,F31bVJvHB2XkhGdgjyTim48hY2cLFEx661AiPS3SzYJ2,5871275,13503224,-7631949,301
2022-05-10 10:38:51-04:00,21970,5BGPpyb8KHRgebUyoV1h6DwXCszgzQCL9N8osisfSpRt,Ci1u2V8Zfx7AsbnkuoftH7A4iAj3EMczVqvPTeRXwP9R,True,45572042,11393010,70472,35236,35236,8sEswn3kzEhnYjAZVvCQnHEUvYd7pFVvc2Xc2Kd1BpbC,2818901,9097314,-6278413,618
2022-05-10 10:38:51-04:00,21971,8fVwuVA2CL5sZoHh6Dg4MBpcX3cvoUm7mnitnpQSdPBD,4F4ccaNm1KQu29XvsKvdjFkmpsbWqNvXkV41851EYQyu,True,76332156,19083039,116801,58400,58401,6L1WYrPiCMyi7XemPww4B4hvpKD1LQKD4RpiSKmrmgSC,4672063,13915602,-9243539,612
2022-05-10 10:39:47-04:00,21972,6MPPCbGXrGRptonhc7bEVumovWkvqsxdzkDwr34QAYaz,4PstuqLgNoWtNVAyHihvmgDAQ4hjzfjSDyY5F8HQYJFT,True,156086454,39021613,117983,58991,58992,Hu94aiQWvce6THeGyCFqGRPM1pQrK3ihzkcXo1EpJcJL,4719322,48784785,-44065463,302
2022-05-10 10:40:40-04:00,21973,DHfy6B2AYsqMCxPLBCXMDfQn3Gr2VwJaLFHUZKqpCjsb,EPZpYaY1gCAb8pMtri5veRowBmCrCpTHBMa3Rmgt6S29,True,4205701343,1051425335,3168613,1584306,1584307,A9TwRM1BMxqb8DCC7YNAMV6zPenEJm3HTZBy7wJKK58U,126744521,256666881,-129922360,301
2022-05-10 10:43:33-04:00,21974,7giGmfkXWV49jM3a3LiHcKxdfGfy1qsszBSXAFmcFcAf,92LzLQ8NLqi3svjhRsxTGmfTxNdRVHmSzazYCn7ozACN,True,400341413,100085352,259854,129927,129927,8sEswn3kzEhnYjAZVvCQnHEUvYd7pFVvc2Xc2Kd1BpbC,10394213,35631603,-25237390,259
2022-05-10 10:43:37-04:00,21975,H7rsFRRhZPe2jLex2NkbYYzVtLobvFiqnCd4BUyJVPBB,8bedwDRfSKLP9vUxoXcpHNJzWQemMaf4QGT2mtHFVJFb,True,144567677,36141919,109336,54668,54668,F31bVJvHB2XkhGdgjyTim48hY2cLFEx661AiPS3SzYJ2,4373472,11448812,-7075340,302
2022-05-10 10:47:53-04:00,21976,DwoQXrbwHmfnkWvYaHbPjir3WLmq3oSpSrAjnPdDqgtL,Hv6r5uYpyyn8B4PTzrki6mj5hdF64yaa564Zi277tANU,True,24915488361,6228872090,18547736,9273868,9273868,GXyFXZMNk2NFyEzw6JetVqsujqcz2yCixH7n8EpDJYWD,741909469,1180678889,-438769420,297
2022-05-10 10:48:30-04:00,21977,8fVwuVA2CL5sZoHh6Dg4MBpcX3cvoUm7mnitnpQSdPBD,4F4ccaNm1KQu29XvsKvdjFkmpsbWqNvXkV41851EYQyu,True,56168758,14042189,86872,43436,43436,C4UnXuShCvjSMgBAgVNMy1oakxCNk1et27A82fywU112,3474903,11487992,-8013089,618
2022-05-10 10:48:30-04:00,21978,6MPPCbGXrGRptonhc7bEVumovWkvqsxdzkDwr34QAYaz,4PstuqLgNoWtNVAyHihvmgDAQ4hjzfjSDyY5F8HQYJFT,True,115972219,28993054,87717,43858,43859,6L1WYrPiCMyi7XemPww4B4hvpKD1LQKD4RpiSKmrmgSC,3508717,37650720,-34142003,302
2022-05-10 10:48:31-04:00,21979,5BGPpyb8KHRgebUyoV1h6DwXCszgzQCL9N8osisfSpRt,Ci1u2V8Zfx7AsbnkuoftH7A4iAj3EMczVqvPTeRXwP9R,True,33490093,8372523,51487,25743,25744,C4UnXuShCvjSMgBAgVNMy1oakxCNk1et27A82fywU112,2059490,7457267,-5397777,614
2022-05-10 10:48:52-04:00,21980,DHfy6B2AYsqMCxPLBCXMDfQn3Gr2VwJaLFHUZKqpCjsb,EPZpYaY1gCAb8pMtri5veRowBmCrCpTHBMa3Rmgt6S29,True,3125221245,781305311,2363028,1181514,1181514,6L1WYrPiCMyi7XemPww4B4hvpKD1LQKD4RpiSKmrmgSC,94521145,221183141,-126661996,302
2022-05-10 10:49:05-04:00,21981,H7rsFRRhZPe2jLex2NkbYYzVtLobvFiqnCd4BUyJVPBB,8bedwDRfSKLP9vUxoXcpHNJzWQemMaf4QGT2mtHFVJFb,True,107398222,26849555,80915,40457,40458,F31bVJvHB2XkhGdgjyTim48hY2cLFEx661AiPS3SzYJ2,3236600,9570841,-6334241,301
2022-05-10 10:49:53-04:00,21982,E6JSJUMvo2qhzHLvYbzFefGHNeKbNbCdKM4f1UnNyfXn,E1oYD3YFn3bXoRULYvSXbtKYFYRYxgE2kyLkbtvXTVFD,True,123362710,30840677,93276,46638,46638,6L1WYrPiCMyi7XemPww4B4hvpKD1LQKD4RpiSKmrmgSC,3731075,11010379,-7279304,302
2022-05-10 11:04:22-04:00,21983,6MPPCbGXrGRptonhc7bEVumovWkvqsxdzkDwr34QAYaz,4PstuqLgNoWtNVAyHihvmgDAQ4hjzfjSDyY5F8HQYJFT,True,86033854,21508463,61890,30945,30945,5HnvdJnCCcmRsm4GkXnYWd4q9RpwuvYDGEUMPkYR3Ts9,2475606,29027579,-26551973,287
2022-05-10 11:04:57-04:00,21984,H7rsFRRhZPe2jLex2NkbYYzVtLobvFiqnCd4BUyJVPBB,8bedwDRfSKLP9vUxoXcpHNJzWQemMaf4QGT2mtHFVJFb,True,79792493,19948123,59985,29992,29993,F31bVJvHB2XkhGdgjyTim48hY2cLFEx661AiPS3SzYJ2,2399434,7906401,-5506967,300
2022-05-10 11:05:45-04:00,21985,5BGPpyb8KHRgebUyoV1h6DwXCszgzQCL9N8osisfSpRt,Ci1u2V8Zfx7AsbnkuoftH7A4iAj3EMczVqvPTeRXwP9R,True,24551898,6137974,36030,18015,18015,8sEswn3kzEhnYjAZVvCQnHEUvYd7pFVvc2Xc2Kd1BpbC,1441223,6055244,-4614021,587
2022-05-10 11:05:45-04:00,21986,8fVwuVA2CL5sZoHh6Dg4MBpcX3cvoUm7mnitnpQSdPBD,4F4ccaNm1KQu29XvsKvdjFkmpsbWqNvXkV41851EYQyu,True,41177764,10294441,60934,30467,30467,Hu94aiQWvce6THeGyCFqGRPM1pQrK3ihzkcXo1EpJcJL,2437367,9396031,-6958664,591
2022-05-10 11:05:51-04:00,21987,E6JSJUMvo2qhzHLvYbzFefGHNeKbNbCdKM4f1UnNyfXn,E1oYD3YFn3bXoRULYvSXbtKYFYRYxgE2kyLkbtvXTVFD,True,91616478,22904119,68303,34151,34152,8sEswn3kzEhnYjAZVvCQnHEUvYd7pFVvc2Xc2Kd1BpbC,2732155,9097336,-6365181,298
2022-05-10 11:05:54-04:00,21988,2ft5U63ftgQNAii4VqdquGxKgQF19vq1DGQSyRG4HeN6,Dkk8bAk4R4L2J1ywAcfrDbwcp6W1nTgcLATpGoGEUVN7,True,1369874874,112303763,455601,227800,227801,6UQfSsLooL4pQKQfLtXCutQS2BnF7A7F7ewJopDLmUpc,55573990,420909634,-365335644,405
2022-05-10 11:06:38-04:00,21989,6MPPCbGXrGRptonhc7bEVumovWkvqsxdzkDwr34QAYaz,4PstuqLgNoWtNVAyHihvmgDAQ4hjzfjSDyY5F8HQYJFT,True,63929012,15982253,45433,22716,22717,6L1WYrPiCMyi7XemPww4B4hvpKD1LQKD4RpiSKmrmgSC,1817337,22327785,-20510448,284
2022-05-10 11:09:46-04:00,21990,H7rsFRRhZPe2jLex2NkbYYzVtLobvFiqnCd4BUyJVPBB,8bedwDRfSKLP9vUxoXcpHNJzWQemMaf4QGT2mtHFVJFb,True,59272494,14818123,44189,22094,22095,8sEswn3kzEhnYjAZVvCQnHEUvYd7pFVvc2Xc2Kd1BpbC,1767573,6469737,-4702164,298
2022-05-10 11:10:09-04:00,21991,E6JSJUMvo2qhzHLvYbzFefGHNeKbNbCdKM4f1UnNyfXn,E1oYD3YFn3bXoRULYvSXbtKYFYRYxgE2kyLkbtvXTVFD,True,68090674,17022668,51054,25527,25527,Hu94aiQWvce6THeGyCFqGRPM1pQrK3ihzkcXo1EpJcJL,2042167,7437821,-5395654,299
2022-05-10 11:10:24-04:00,21992,6MPPCbGXrGRptonhc7bEVumovWkvqsxdzkDwr34QAYaz,4PstuqLgNoWtNVAyHihvmgDAQ4hjzfjSDyY5F8HQYJFT,True,47614775,11903693,35998,17999,17999,8sEswn3kzEhnYjAZVvCQnHEUvYd7pFVvc2Xc2Kd1BpbC,1439920,17154790,-15714870,302
2022-05-10 11:10:43-04:00,21993,2ft5U63ftgQNAii4VqdquGxKgQF19vq1DGQSyRG4HeN6,Dkk8bAk4R4L2J1ywAcfrDbwcp6W1nTgcLATpGoGEUVN7,True,1250968328,228977803,888031,444015,444016,AmTrMPzuTp2BjnjqGNKqz9FTTCdpoKcPAJLwFc8ozcbh,48515606,391081421,-342565815,387
2022-05-10 11:10:49-04:00,21994,H7rsFRRhZPe2jLex2NkbYYzVtLobvFiqnCd4BUyJVPBB,8bedwDRfSKLP9vUxoXcpHNJzWQemMaf4QGT2mtHFVJFb,True,44065481,11016370,33362,16681,16681,6L1WYrPiCMyi7XemPww4B4hvpKD1LQKD4RpiSKmrmgSC,1334494,5250042,-3915548,302
2022-05-10 11:17:05-04:00,21995,DyMysFYo5aXZD3oH8NnRW1syYPnNdjHPoyvU2Vv2cCzv,KrerC6i7z79cFza1ZXkadwNDqGMzzWbVnvpDCvuGyPz,True,7195555266,1798888816,11222129,5611064,5611065,4yhyLx1phodwcvvwVU2bramHcdbJYvfadd7pANsRzX8M,448885170,889882974,-440997804,623
2022-05-10 11:29:23-04:00,21996,8fVwuVA2CL5sZoHh6Dg4MBpcX3cvoUm7mnitnpQSdPBD,4F4ccaNm1KQu29XvsKvdjFkmpsbWqNvXkV41851EYQyu,True,30182568,7545642,41891,20945,20946,C4UnXuShCvjSMgBAgVNMy1oakxCNk1et27A82fywU112,1675678,7595455,-5919777,555
2022-05-10 11:29:23-04:00,21997,2ft5U63ftgQNAii4VqdquGxKgQF19vq1DGQSyRG4HeN6,Dkk8bAk4R4L2J1ywAcfrDbwcp6W1nTgcLATpGoGEUVN7,True,1015734331,171614052,698992,349496,349496,A9TwRM1BMxqb8DCC7YNAMV6zPenEJm3HTZBy7wJKK58U,41371381,327085322,-285713941,407
2022-05-10 11:29:25-04:00,21998,5BGPpyb8KHRgebUyoV1h6DwXCszgzQCL9N8osisfSpRt,Ci1u2V8Zfx7AsbnkuoftH7A4iAj3EMczVqvPTeRXwP9R,False,17996064,17996064,987333,49366,937967,6L1WYrPiCMyi7XemPww4B4hvpKD1LQKD4RpiSKmrmgSC,987333,4865718,-3878385,548
2022-05-10 13:30:40-04:00,21999,6cyefDEH1EqWn2RYGMtLj9CPhjXg5eECHsrm3C8fxurr,4o3XrjY3LA63KkjPtNGbwEuq59qXh8WmuEDsD5mfbtMD,True,128916592,32229148,196665,98332,98333,6L1WYrPiCMyi7XemPww4B4hvpKD1LQKD4RpiSKmrmgSC,7866607,12360654,-4494047,610
2022-05-10 15:06:21-04:00,22000,6HufrrRWdkPo2umgxtgvqnDSBMZrU7hbDvrX8qpnbMBQ,HJwfz9kANDRKNwRwbwzrWaqAZ57pzVoiiedC5uarDLjv,True,27382008,1613113,7796,3898,3898,6L1WYrPiCMyi7XemPww4B4hvpKD1LQKD4RpiSKmrmgSC,1323411,9150494,-7827083,483
2022-05-10 15:06:39-04:00,22001,8fVwuVA2CL5sZoHh6Dg4MBpcX3cvoUm7mnitnpQSdPBD,4F4ccaNm1KQu29XvsKvdjFkmpsbWqNvXkV41851EYQyu,True,22388678,5597169,34267,17133,17134,6L1WYrPiCMyi7XemPww4B4hvpKD1LQKD4RpiSKmrmgSC,1370704,6058798,-4688094,612
2022-05-10 15:07:09-04:00,22002,DyMysFYo5aXZD3oH8NnRW1syYPnNdjHPoyvU2Vv2cCzv,KrerC6i7z79cFza1ZXkadwNDqGMzzWbVnvpDCvuGyPz,True,5289802238,1322450559,8182157,4091078,4091079,2a35JJeTUW1pm6M3e8DHCjp8qr4vbc2cRPhuzZWyFzYd,327286280,765549079,-438262799,618
2022-05-10 15:08:02-04:00,22003,6HufrrRWdkPo2umgxtgvqnDSBMZrU7hbDvrX8qpnbMBQ,HJwfz9kANDRKNwRwbwzrWaqAZ57pzVoiiedC5uarDLjv,True,25695417,1513205,7146,3573,3573,8sEswn3kzEhnYjAZVvCQnHEUvYd7pFVvc2Xc2Kd1BpbC,1213511,9617234,-8403723,472
2022-05-10 15:08:03-04:00,22004,F4hN7ecndZ8Gr5KQNSFaSrMGawMasz7jfWTLTMpk7gaB,AJ23FpXSGjipcqywk88WGsKfqfiiUjPzZLsvLtBAhB12,True,579304637,84016667,524708,262354,262354,8sEswn3kzEhnYjAZVvCQnHEUvYd7pFVvc2Xc2Kd1BpbC,36179291,64600927,-28421636,624
2022-05-10 15:09:10-04:00,22005,8fVwuVA2CL5sZoHh6Dg4MBpcX3cvoUm7mnitnpQSdPBD,4F4ccaNm1KQu29XvsKvdjFkmpsbWqNvXkV41851EYQyu,True,16479339,4119834,25606,12803,12803,2a35JJeTUW1pm6M3e8DHCjp8qr4vbc2cRPhuzZWyFzYd,1024267,4852516,-3828249,621
2022-05-10 15:09:26-04:00,22006,B2nFCBzpcf1ptxYz1qJhsvMi66FxVC9MRbmyE651zyvc,Hrkw5SLuHTpmqamJBBTiDQHoF6Cmj5tSf4BFvgbNqUVx,True,285307901,71326975,445438,222719,222719,8sEswn3kzEhnYjAZVvCQnHEUvYd7pFVvc2Xc2Kd1BpbC,17817553,29394487,-11576934,624
2022-05-10 15:09:46-04:00,22007,DyMysFYo5aXZD3oH8NnRW1syYPnNdjHPoyvU2Vv2cCzv,KrerC6i7z79cFza1ZXkadwNDqGMzzWbVnvpDCvuGyPz,True,3887524472,971881118,5981922,2990961,2990961,DA18qE9qesbBqpwNv1M4befYcNQkbSBSeLPTmQzrmbJw,239276916,648163412,-408886496,615
2022-05-10 15:10:01-04:00,22008,F4hN7ecndZ8Gr5KQNSFaSrMGawMasz7jfWTLTMpk7gaB,AJ23FpXSGjipcqywk88WGsKfqfiiUjPzZLsvLtBAhB12,True,490207086,62045473,386970,193485,193485,6L1WYrPiCMyi7XemPww4B4hvpKD1LQKD4RpiSKmrmgSC,30573699,53783330,-23209631,623
2022-05-10 15:10:02-04:00,22009,8uZhgcgTGB3fDBZdiNkp7oMGys2bBoiTzWyYwrmKKC3U,5cVp8ogiZsS7x8TWCAqihMQiNNxLqi3xVYQ4TkhHPsjS,True,153826995,38456748,239847,119923,119924,2a35JJeTUW1pm6M3e8DHCjp8qr4vbc2cRPhuzZWyFzYd,9593908,28228282,-18634374,623
2022-05-10 15:10:55-04:00,22010,2ft5U63ftgQNAii4VqdquGxKgQF19vq1DGQSyRG4HeN6,Dkk8bAk4R4L2J1ywAcfrDbwcp6W1nTgcLATpGoGEUVN7,True,838499791,79199852,328095,164047,164048,68sueyVfmy5ToEGtLFGDkwebX47xAmzyXE29z8JrmcWv,34735918,278603631,-243867713,414
2022-05-10 15:11:41-04:00,22011,59GbuFudpbJZ4htaYFSabGsQVjRraHEqcroSb2CudvrW,HMs38RfLysAXyt6kD7uviCuqZy1LfFM7rDVgaYkF1mYX,True,607038591,151759647,948090,474045,474045,6L1WYrPiCMyi7XemPww4B4hvpKD1LQKD4RpiSKmrmgSC,37923624,141016549,-103092925,624
2022-05-10 15:12:12-04:00,22012,8fVwuVA2CL5sZoHh6Dg4MBpcX3cvoUm7mnitnpQSdPBD,4F4ccaNm1KQu29XvsKvdjFkmpsbWqNvXkV41851EYQyu,False,12095645,12095645,734801,36740,698061,C4UnXuShCvjSMgBAgVNMy1oakxCNk1et27A82fywU112,734801,3869853,-3135052,607
2022-05-10 15:12:12-04:00,22013,B2nFCBzpcf1ptxYz1qJhsvMi66FxVC9MRbmyE651zyvc,Hrkw5SLuHTpmqamJBBTiDQHoF6Cmj5tSf4BFvgbNqUVx,True,209633132,52408283,325608,162804,162804,C4UnXuShCvjSMgBAgVNMy1oakxCNk1et27A82fywU112,13024321,26055838,-13031517,621
2022-05-10 15:12:31-04:00,22014,DyMysFYo5aXZD3oH8NnRW1syYPnNdjHPoyvU2Vv2cCzv,KrerC6i7z79cFza1ZXkadwNDqGMzzWbVnvpDCvuGyPz,True,2860819659,715204914,4461782,2230891,2230891,6L1WYrPiCMyi7XemPww4B4hvpKD1LQKD4RpiSKmrmgSC,178471299,540161568,-361690269,623
2022-05-10 15:12:36-04:00,22015,F4hN7ecndZ8Gr5KQNSFaSrMGawMasz7jfWTLTMpk7gaB,AJ23FpXSGjipcqywk88WGsKfqfiiUjPzZLsvLtBAhB12,True,424490791,60384745,377194,188597,188597,8sEswn3kzEhnYjAZVvCQnHEUvYd7pFVvc2Xc2Kd1BpbC,26515907,44708994,-18193087,624
2022-05-10 15:13:08-04:00,22016,2ft5U63ftgQNAii4VqdquGxKgQF19vq1DGQSyRG4HeN6,Dkk8bAk4R4L2J1ywAcfrDbwcp6W1nTgcLATpGoGEUVN7,True,755290767,130420046,524909,262454,262455,2xTUy2RS74GJMMDnmFaegMzFLn19RVfYG4CibhBmjP1i,30398651,251216749,-220818098,402
2022-05-10 15:13:15-04:00,22017,8uZhgcgTGB3fDBZdiNkp7oMGys2bBoiTzWyYwrmKKC3U,5cVp8ogiZsS7x8TWCAqihMQiNNxLqi3xVYQ4TkhHPsjS,True,113080598,28270149,176610,88305,88305,2a35JJeTUW1pm6M3e8DHCjp8qr4vbc2cRPhuzZWyFzYd,7064412,23330163,-16265751,624
2022-05-10 15:22:19-04:00,22018,FMdKLXhQEnNJtvM17ZX8jhaeMaSD9UgDuN3Kw7kMrd7K,5pURHYWB5LUGwJmWVBGH8p6oyR9NJvXnZk7uDVoiassv,True,31049111975,7762277993,23480680,11740340,11740340,GXyFXZMNk2NFyEzw6JetVqsujqcz2yCixH7n8EpDJYWD,939227221,1556692865,-617465644,302
2022-05-10 15:22:32-04:00,22019,59GbuFudpbJZ4htaYFSabGsQVjRraHEqcroSb2CudvrW,HMs38RfLysAXyt6kD7uviCuqZy1LfFM7rDVgaYkF1mYX,True,444095307,111023826,644797,322398,322399,6L1WYrPiCMyi7XemPww4B4hvpKD1LQKD4RpiSKmrmgSC,25791897,114300460,-88508563,580
2022-05-10 15:22:32-04:00,22020,2ft5U63ftgQNAii4VqdquGxKgQF19vq1DGQSyRG4HeN6,Dkk8bAk4R4L2J1ywAcfrDbwcp6W1nTgcLATpGoGEUVN7,True,620543560,57680991,237461,118730,118731,6L1WYrPiCMyi7XemPww4B4hvpKD1LQKD4RpiSKmrmgSC,25546581,216792189,-191245608,411
2022-05-10 15:22:46-04:00,22021,F4hN7ecndZ8Gr5KQNSFaSrMGawMasz7jfWTLTMpk7gaB,AJ23FpXSGjipcqywk88WGsKfqfiiUjPzZLsvLtBAhB12,True,360408232,45088630,280745,140372,140373,2a35JJeTUW1pm6M3e8DHCjp8qr4vbc2cRPhuzZWyFzYd,22440899,47096676,-24655777,622
2022-05-10 15:22:50-04:00,22022,Edd15Xn899KpjQH2vgH5Jy3zNE1Du8DxHsCENSwUgJBS,BxJ18uKAsXjDpjBL2BtzETC5Xh6pkUDSBMwe6HkYaLyG,True,5685331139,1421332784,8862683,4431341,4431342,68sueyVfmy5ToEGtLFGDkwebX47xAmzyXE29z8JrmcWv,354507353,1330565894,-976058541,623
2022-05-10 15:24:09-04:00,22023,B2nFCBzpcf1ptxYz1qJhsvMi66FxVC9MRbmyE651zyvc,Hrkw5SLuHTpmqamJBBTiDQHoF6Cmj5tSf4BFvgbNqUVx,True,154160384,38540096,240856,120428,120428,Hu94aiQWvce6THeGyCFqGRPM1pQrK3ihzkcXo1EpJcJL,9634248,22472920,-12838672,624
2022-05-10 15:26:06-04:00,22024,DyMysFYo5aXZD3oH8NnRW1syYPnNdjHPoyvU2Vv2cCzv,KrerC6i7z79cFza1ZXkadwNDqGMzzWbVnvpDCvuGyPz,True,2102907742,525726935,3282562,1641281,1641281,CGtKBgcWZ6HKE3tFNLPUM9khDv2Rc7d6BrPtxz7J1aY,131302514,445389617,-314087103,624
2022-05-10 15:33:53-04:00,22025,2ft5U63ftgQNAii4VqdquGxKgQF19vq1DGQSyRG4HeN6,Dkk8bAk4R4L2J1ywAcfrDbwcp6W1nTgcLATpGoGEUVN7,True,560038959,97164777,390115,195057,195058,3zqXX6kzhkbW3d4TwD2CNjMRwxTbREXySekvq37kfCNk,22485510,194541013,-172055503,401
2022-05-10 15:34:15-04:00,22026,F4hN7ecndZ8Gr5KQNSFaSrMGawMasz7jfWTLTMpk7gaB,AJ23FpXSGjipcqywk88WGsKfqfiiUjPzZLsvLtBAhB12,True,312673859,44502503,277746,138873,138873,Hu94aiQWvce6THeGyCFqGRPM1pQrK3ihzkcXo1EpJcJL,19514411,48689388,-29174977,624
2022-05-10 15:34:52-04:00,22027,59GbuFudpbJZ4htaYFSabGsQVjRraHEqcroSb2CudvrW,HMs38RfLysAXyt6kD7uviCuqZy1LfFM7rDVgaYkF1mYX,True,328152058,82038014,505691,252845,252846,F31bVJvHB2XkhGdgjyTim48hY2cLFEx661AiPS3SzYJ2,20227677,91531429,-71303752,616
2022-05-10 15:35:45-04:00,22028,6HufrrRWdkPo2umgxtgvqnDSBMZrU7hbDvrX8qpnbMBQ,HJwfz9kANDRKNwRwbwzrWaqAZ57pzVoiiedC5uarDLjv,True,23673614,2984214,13793,6896,6897,Hu94aiQWvce6THeGyCFqGRPM1pQrK3ihzkcXo1EpJcJL,1094221,6185264,-5091043,462
2022-05-10 15:36:37-04:00,22029,Edd15Xn899KpjQH2vgH5Jy3zNE1Du8DxHsCENSwUgJBS,BxJ18uKAsXjDpjBL2BtzETC5Xh6pkUDSBMwe6HkYaLyG,True,4179557345,1044889336,6530091,3265045,3265046,8sEswn3kzEhnYjAZVvCQnHEUvYd7pFVvc2Xc2Kd1BpbC,261203660,1078154209,-816950549,624
2022-05-10 15:37:57-04:00,22030,2ft5U63ftgQNAii4VqdquGxKgQF19vq1DGQSyRG4HeN6,Dkk8bAk4R4L2J1ywAcfrDbwcp6W1nTgcLATpGoGEUVN7,True,460149305,42283151,177995,88997,88998,Hu94aiQWvce6THeGyCFqGRPM1pQrK3ihzkcXo1EpJcJL,19370518,168070671,-148700153,420
2022-05-10 15:38:03-04:00,22031,FMdKLXhQEnNJtvM17ZX8jhaeMaSD9UgDuN3Kw7kMrd7K,5pURHYWB5LUGwJmWVBGH8p6oyR9NJvXnZk7uDVoiassv,True,23059156329,5764789082,17201722,8600861,8600861,6L1WYrPiCMyi7XemPww4B4hvpKD1LQKD4RpiSKmrmgSC,688068888,1387873457,-699804569,298
2022-05-10 15:38:12-04:00,22032,B2nFCBzpcf1ptxYz1qJhsvMi66FxVC9MRbmyE651zyvc,Hrkw5SLuHTpmqamJBBTiDQHoF6Cmj5tSf4BFvgbNqUVx,True,113273676,28318419,176169,88084,88085,Hu94aiQWvce6THeGyCFqGRPM1pQrK3ihzkcXo1EpJcJL,7046780,19022713,-11975933,622
2022-05-10 15:38:30-04:00,22033,DyMysFYo5aXZD3oH8NnRW1syYPnNdjHPoyvU2Vv2cCzv,KrerC6i7z79cFza1ZXkadwNDqGMzzWbVnvpDCvuGyPz,True,1544767439,386191859,2390164,1195082,1195082,CGtKBgcWZ6HKE3tFNLPUM9khDv2Rc7d6BrPtxz7J1aY,95606584,363647876,-268041292,618
2022-05-10 15:39:46-04:00,22034,E6JSJUMvo2qhzHLvYbzFefGHNeKbNbCdKM4f1UnNyfXn,E1oYD3YFn3bXoRULYvSXbtKYFYRYxgE2kyLkbtvXTVFD,True,50597789,12649447,38022,19011,19011,6L1WYrPiCMyi7XemPww4B4hvpKD1LQKD4RpiSKmrmgSC,1520897,6037901,-4517004,300
2022-05-10 15:40:57-04:00,22035,59GbuFudpbJZ4htaYFSabGsQVjRraHEqcroSb2CudvrW,HMs38RfLysAXyt6kD7uviCuqZy1LfFM7rDVgaYkF1mYX,True,240444290,60111072,351305,175652,175653,8sEswn3kzEhnYjAZVvCQnHEUvYd7pFVvc2Xc2Kd1BpbC,14052232,73201423,-59149191,584
2022-05-10 15:40:57-04:00,22036,Hjfm6iGa54sbaqjwvJhC9HZ22S48iqt5gdUneRjv8qbR,94DWK2YsxQdw1sFoJstu3GeoUCWnBdcCZZyw4nkVg5ua,True,425799601,106449900,639513,319756,319757,4yhyLx1phodwcvvwVU2bramHcdbJYvfadd7pANsRzX8M,25580551,99024329,-73443778,600
2022-05-10 15:41:28-04:00,22037,2ft5U63ftgQNAii4VqdquGxKgQF19vq1DGQSyRG4HeN6,Dkk8bAk4R4L2J1ywAcfrDbwcp6W1nTgcLATpGoGEUVN7,True,414957605,72616510,284965,142482,142483,F31bVJvHB2XkhGdgjyTim48hY2cLFEx661AiPS3SzYJ2,16283974,150404396,-134120422,392
2022-05-10 15:41:33-04:00,22038,Edd15Xn899KpjQH2vgH5Jy3zNE1Du8DxHsCENSwUgJBS,BxJ18uKAsXjDpjBL2BtzETC5Xh6pkUDSBMwe6HkYaLyG,True,3071969992,767992498,4799388,2399694,2399694,F31bVJvHB2XkhGdgjyTim48hY2cLFEx661AiPS3SzYJ2,191975552,867645836,-675670284,624
2022-05-10 15:45:25-04:00,22039,B2nFCBzpcf1ptxYz1qJhsvMi66FxVC9MRbmyE651zyvc,Hrkw5SLuHTpmqamJBBTiDQHoF6Cmj5tSf4BFvgbNqUVx,True,83275877,20818969,129780,64890,64890,68sueyVfmy5ToEGtLFGDkwebX47xAmzyXE29z8JrmcWv,5191231,15852738,-10661507,623
2022-05-10 15:51:21-04:00,22040,6HufrrRWdkPo2umgxtgvqnDSBMZrU7hbDvrX8qpnbMBQ,HJwfz9kANDRKNwRwbwzrWaqAZ57pzVoiiedC5uarDLjv,False,20546986,20546986,979770,48988,930782,68sueyVfmy5ToEGtLFGDkwebX47xAmzyXE29z8JrmcWv,979772,7042402,-6062630,476
2022-05-10 15:51:24-04:00,22041,DyMysFYo5aXZD3oH8NnRW1syYPnNdjHPoyvU2Vv2cCzv,KrerC6i7z79cFza1ZXkadwNDqGMzzWbVnvpDCvuGyPz,True,1131770432,282942608,1660281,830140,830141,72XWPCtRYEDZbddP7d6dHtUBRRDLSJsB2xZTAfefoEVZ,66411272,294282239,-227870967,586
2022-05-10 15:51:24-04:00,22042,6cyefDEH1EqWn2RYGMtLj9CPhjXg5eECHsrm3C8fxurr,4o3XrjY3LA63KkjPtNGbwEuq59qXh8WmuEDsD5mfbtMD,True,62658935,15664733,94227,47113,47114,8sEswn3kzEhnYjAZVvCQnHEUvYd7pFVvc2Xc2Kd1BpbC,3769116,6546789,-2777673,601
2022-05-10 15:52:34-04:00,22043,CAqcooQi8ZyYUehyWXcz83i8p7CNyBNRTY1jbjv4ZZdD,5PzRa1oukLxXfAoJaRMUn5D4uRjF8qN57nADD4hK4qAg,True,25867016,6466754,40260,20130,20130,Hu94aiQWvce6THeGyCFqGRPM1pQrK3ihzkcXo1EpJcJL,1610413,14905421,-13295008,622
2022-05-10 16:01:29-04:00,22044,FMdKLXhQEnNJtvM17ZX8jhaeMaSD9UgDuN3Kw7kMrd7K,5pURHYWB5LUGwJmWVBGH8p6oyR9NJvXnZk7uDVoiassv,True,17134521804,4283630451,12769200,6384600,6384600,A9TwRM1BMxqb8DCC7YNAMV6zPenEJm3HTZBy7wJKK58U,510768025,1200523451,-689755426,298
2022-05-10 16:01:46-04:00,22045,6MPPCbGXrGRptonhc7bEVumovWkvqsxdzkDwr34QAYaz,4PstuqLgNoWtNVAyHihvmgDAQ4hjzfjSDyY5F8HQYJFT,True,35375746,8843936,26701,13350,13351,6L1WYrPiCMyi7XemPww4B4hvpKD1LQKD4RpiSKmrmgSC,1068064,13189581,-12121517,301
2022-05-10 16:03:51-04:00,22046,59GbuFudpbJZ4htaYFSabGsQVjRraHEqcroSb2CudvrW,HMs38RfLysAXyt6kD7uviCuqZy1LfFM7rDVgaYkF1mYX,True,177795040,44448760,276168,138084,138084,C4UnXuShCvjSMgBAgVNMy1oakxCNk1et27A82fywU112,11046731,57947705,-46900974,621
2022-05-10 16:04:09-04:00,22047,Hjfm6iGa54sbaqjwvJhC9HZ22S48iqt5gdUneRjv8qbR,94DWK2YsxQdw1sFoJstu3GeoUCWnBdcCZZyw4nkVg5ua,True,312459602,78114900,446136,223068,223068,2a35JJeTUW1pm6M3e8DHCjp8qr4vbc2cRPhuzZWyFzYd,17845478,79821074,-61975596,571
2022-05-10 16:04:22-04:00,22048,H7rsFRRhZPe2jLex2NkbYYzVtLobvFiqnCd4BUyJVPBB,8bedwDRfSKLP9vUxoXcpHNJzWQemMaf4QGT2mtHFVJFb,False,32730189,32730189,981725,49086,932639,Hu94aiQWvce6THeGyCFqGRPM1pQrK3ihzkcXo1EpJcJL,981725,4237328,-3255603,299
2022-05-10 16:13:37-04:00,22049,DyMysFYo5aXZD3oH8NnRW1syYPnNdjHPoyvU2Vv2cCzv,KrerC6i7z79cFza1ZXkadwNDqGMzzWbVnvpDCvuGyPz,True,829699156,207424789,1126757,563378,563379,gjBMZYVujDjD1ECG4i97M8Q3gV9ESnwwTSUGropkusj,45070303,235121572,-190051269,543
2022-05-10 16:13:37-04:00,22050,CAqcooQi8ZyYUehyWXcz83i8p7CNyBNRTY1jbjv4ZZdD,5PzRa1oukLxXfAoJaRMUn5D4uRjF8qN57nADD4hK4qAg,True,19018022,4754505,29381,14690,14691,C4UnXuShCvjSMgBAgVNMy1oakxCNk1et27A82fywU112,1175261,11528771,-10353510,617
2022-05-10 16:13:38-04:00,22051,B2nFCBzpcf1ptxYz1qJhsvMi66FxVC9MRbmyE651zyvc,Hrkw5SLuHTpmqamJBBTiDQHoF6Cmj5tSf4BFvgbNqUVx,True,60718655,15179663,82070,41035,41035,C4UnXuShCvjSMgBAgVNMy1oakxCNk1et27A82fywU112,3282802,13017284,-9734482,540
2022-05-10 16:13:39-04:00,22052,B3E2V6u8DnNzmtq34AAtnY1kkSuZoaZduDyP4srBTKDp,HYfqErjQ1yJLYq6tpFhDUNz1ByoCsE4T6RYSPZx9dWER,False,4282097,4282097,237304,11865,225439,Hu94aiQWvce6THeGyCFqGRPM1pQrK3ihzkcXo1EpJcJL,237304,10953692,-10716388,554
2022-05-10 16:13:40-04:00,22053,6cyefDEH1EqWn2RYGMtLj9CPhjXg5eECHsrm3C8fxurr,4o3XrjY3LA63KkjPtNGbwEuq59qXh8WmuEDsD5mfbtMD,True,45841221,11460305,62285,31142,31143,2a35JJeTUW1pm6M3e8DHCjp8qr4vbc2cRPhuzZWyFzYd,2491401,5727689,-3236288,543
2022-05-10 16:13:42-04:00,22054,59GbuFudpbJZ4htaYFSabGsQVjRraHEqcroSb2CudvrW,HMs38RfLysAXyt6kD7uviCuqZy1LfFM7rDVgaYkF1mYX,True,130646462,32661615,201768,100884,100884,Hu94aiQWvce6THeGyCFqGRPM1pQrK3ihzkcXo1EpJcJL,8070745,45946798,-37876053,617
2022-05-10 16:13:42-04:00,22055,Hjfm6iGa54sbaqjwvJhC9HZ22S48iqt5gdUneRjv8qbR,94DWK2YsxQdw1sFoJstu3GeoUCWnBdcCZZyw4nkVg5ua,True,231363442,57840860,360452,180226,180226,F31bVJvHB2XkhGdgjyTim48hY2cLFEx661AiPS3SzYJ2,14418082,63882521,-49464439,623
2022-05-10 16:15:32-04:00,22056,E6JSJUMvo2qhzHLvYbzFefGHNeKbNbCdKM4f1UnNyfXn,E1oYD3YFn3bXoRULYvSXbtKYFYRYxgE2kyLkbtvXTVFD,True,37599235,9399808,28330,14165,14165,8sEswn3kzEhnYjAZVvCQnHEUvYd7pFVvc2Xc2Kd1BpbC,1133208,4870094,-3736886,301
2022-05-10 16:31:10-04:00,22057,AL8JFS4gjaQx89f9j8wtaNJgV76K8bw1ugvNtgvhgAnb,HJYvG2kGKe8kXgtZSWTWwTmSjxA3XUeCvyT7acoKtS1C,True,2033817542,508454385,1509375,754687,754688,DQCvC9mR68hJ3tJsUiddh6JwcBJAmntqGJR2nUsEq7yj,60375038,706838430,-646463392,296
2022-05-10 16:31:10-04:00,22058,7zuFEyLQFHkAjm3mAuxN42VenwF6fZcqM81mmR8sBnmY,CSnQxjc4Jn8iP4JSxj5wsrvxGsLoAYQn1bKC8naY7YZP,True,755616677,188904169,570680,285340,285340,DA18qE9qesbBqpwNv1M4befYcNQkbSBSeLPTmQzrmbJw,22827203,113286012,-90458809,302
2022-05-10 16:31:10-04:00,22059,DwoQXrbwHmfnkWvYaHbPjir3WLmq3oSpSrAjnPdDqgtL,Hv6r5uYpyyn8B4PTzrki6mj5hdF64yaa564Zi277tANU,True,18426286816,4606571704,11219317,5609658,5609659,3zqXX6kzhkbW3d4TwD2CNjMRwxTbREXySekvq37kfCNk,448772684,1046512287,-597739603,243
2022-05-10 16:31:10-04:00,22060,9Uk3M4phqTJFXmkVvbNXTFxgKMdVahNy6q8CX4Jf71P9,J3Ypriz1JYFpt4M6Ffj67SaJAguH7CooR29cKh5gfDdZ,False,12109771,12109771,328024,16401,311623,C4UnXuShCvjSMgBAgVNMy1oakxCNk1et27A82fywU112,328024,6664053,-6336029,270
2022-05-10 16:31:10-04:00,22061,6Wb1dHysQGfnkNEXYGXUfZPcXXNnyPynvcZxvQyxkjbP,EqkpRqz6Liipov96UuGjVbAhCbogb43EUyfWa4hyxZhH,False,1186575,1186575,32240,1612,30628,3zqXX6kzhkbW3d4TwD2CNjMRwxTbREXySekvq37kfCNk,32240,745473,-713233,271
2022-05-10 16:31:10-04:00,22062,Cn9MVrxQJRdzK2McohX8BDQv98mt5psYmDu6Qvxa79d1,6aRB9jyRWHAp1v4GcLeuTZA346jF9h3Lj52RGgjd8msn,False,1717895,1717895,47176,2358,44818,3zqXX6kzhkbW3d4TwD2CNjMRwxTbREXySekvq37kfCNk,47176,714481,-667305,274
2022-05-10 16:31:10-04:00,22063,EFE8G2YrShWzzY6xocskvQZsELthMfg3UUkb8YqeAkdW,WcgQbekfTSEVtQfmDzPD1Pby9rNeVAMhREgqD3VMmmV,False,1186523,1186523,32410,1620,30790,3zqXX6kzhkbW3d4TwD2CNjMRwxTbREXySekvq37kfCNk,32410,745695,-713285,273
2022-05-10 16:31:11-04:00,22064,Aytv88ubD8wsFgjvAVCxNfqRK9ZR816bHbBnepBZzq4g,4GoDLnzt4f2XCjRepTiw1wuURufX8EvDHKt7BaY4JeHo,False,1186221,1186221,32172,1608,30564,Hu94aiQWvce6THeGyCFqGRPM1pQrK3ihzkcXo1EpJcJL,32172,745759,-713587,271
2022-05-10 16:31:11-04:00,22065,2S5EAU58ER5aRfdxyjMWnJrj6kBLoghxGSfHipZ6qoM5,8P5SyJaUFDLJvHrUT7nv5w8exWNuz41xijeQmLMErbG2,False,1187250,1187250,32982,1649,31333,2a35JJeTUW1pm6M3e8DHCjp8qr4vbc2cRPhuzZWyFzYd,32982,745540,-712558,277
2022-05-10 16:31:11-04:00,22066,EWRWde9hXUZQpLxXoE8ejHqNni3157ijxop6agQ66LYF,DLSLu1yv42y2rjsYYdp5JuJPWdBwc81ZWNrZcy8AkzjX,False,1187431,1187431,33125,1656,31469,8sEswn3kzEhnYjAZVvCQnHEUvYd7pFVvc2Xc2Kd1BpbC,33125,745502,-712377,278
2022-05-10 16:31:11-04:00,22067,DQtrjc38Yg52hjtFM9RAxCJcrb3zYi7EvzTRTRPjPhaR,4TwxvwgyQ4tUQitUiNuQQTZdbzHMcWshBHvMfHhtBPUh,False,1186522,1186522,32409,1620,30789,2a35JJeTUW1pm6M3e8DHCjp8qr4vbc2cRPhuzZWyFzYd,32409,745695,-713286,273
2022-05-10 16:31:11-04:00,22068,CvCA41pKSoaNEVLJC8R5V6isqkWDwiqF1mkiyri5W3X7,GBWzqNagD5ukMaAn9ARtFFsqZLp6r7jUvKeKFPJwEZKv,False,1187416,1187416,33113,1655,31458,6L1WYrPiCMyi7XemPww4B4hvpKD1LQKD4RpiSKmrmgSC,33113,745505,-712392,278
2022-05-10 16:31:11-04:00,22069,HFJdjfe5FUeiBvT9HBvbmqeiWVZX5Qaj89FsddZwEm59,J9GWPE3PupsoFEHB6WxwfAHJyfvxGWA76Nd655uUaSE4,False,1186521,1186521,32408,1620,30788,Hu94aiQWvce6THeGyCFqGRPM1pQrK3ihzkcXo1EpJcJL,32408,745695,-713287,273
2022-05-10 16:31:11-04:00,22070,6PTggD2ofgu7bVVqQ5SpHGa1Cyxozitktc6W3Dxy8MoW,AKUGXLeRYfh4w4xFiEWaSeVa9w7AnipaFi6Q68ZLjbNd,False,1186926,1186926,32516,1625,30891,3zqXX6kzhkbW3d4TwD2CNjMRwxTbREXySekvq37kfCNk,32516,745398,-712882,273
2022-05-10 16:31:11-04:00,22071,Hv2WyuxhsgqByFK84vre1otS4Xuyzs5WrX3QKuFCGzuL,HWVbbrMkMpuz2kiNTgRB39Btc1qfDreHZjyoddWdcjoW,False,1186369,1186369,32288,1614,30674,3zqXX6kzhkbW3d4TwD2CNjMRwxTbREXySekvq37kfCNk,32288,745727,-713439,272
2022-05-10 16:31:11-04:00,22072,HRayaZCtZXt5AWyh8FZwQTbTn8pqhGG6tKrcsBNPhgkh,jmTy62anVWt5Bx714RizPMMM1isaZha3y3H2MEAV8AZ,False,1186453,1186453,32143,1607,30536,6L1WYrPiCMyi7XemPww4B4hvpKD1LQKD4RpiSKmrmgSC,32143,745498,-713355,270
2022-05-10 16:31:12-04:00,22073,4g2jRR2fQFWHNssZ75UUNf5w2KypDZoBdWcWLQLVfroC,H8M8mdXDVkJKaSPtHq2xRacVo6GQTF6TgsJW12pWxb9R,False,1188631,1188631,34310,1715,32595,3zqXX6kzhkbW3d4TwD2CNjMRwxTbREXySekvq37kfCNk,34310,745487,-711177,288
2022-05-10 16:31:23-04:00,22074,FMdKLXhQEnNJtvM17ZX8jhaeMaSD9UgDuN3Kw7kMrd7K,5pURHYWB5LUGwJmWVBGH8p6oyR9NJvXnZk7uDVoiassv,True,12736366871,3184091717,9586858,4793429,4793429,A9TwRM1BMxqb8DCC7YNAMV6zPenEJm3HTZBy7wJKK58U,383474343,1018147942,-634673599,301
2022-05-10 16:32:00-04:00,22075,6MPPCbGXrGRptonhc7bEVumovWkvqsxdzkDwr34QAYaz,4PstuqLgNoWtNVAyHihvmgDAQ4hjzfjSDyY5F8HQYJFT,False,26286020,26286020,795573,39778,755795,Hu94aiQWvce6THeGyCFqGRPM1pQrK3ihzkcXo1EpJcJL,795573,10132517,-9336944,302
2022-05-10 16:35:45-04:00,22076,E6JSJUMvo2qhzHLvYbzFefGHNeKbNbCdKM4f1UnNyfXn,E1oYD3YFn3bXoRULYvSXbtKYFYRYxgE2kyLkbtvXTVFD,False,27887508,27887508,792959,39647,753312,8sEswn3kzEhnYjAZVvCQnHEUvYd7pFVvc2Xc2Kd1BpbC,792959,3907558,-3114599,284
2022-05-10 16:49:59-04:00,22077,8DSiP9CwJm3AEcH6uuAYFpArRRDLYpDQgjHEvjkUgfg2,ERJ8kuhPRRmUAhSM4oxUheh39YUVVYNgaTt6AdMXcCvL,True,1082011782,270502945,816328,408164,408164,2xTUy2RS74GJMMDnmFaegMzFLn19RVfYG4CibhBmjP1i,32653154,123672448,-91019294,301
2022-05-10 16:50:14-04:00,22078,FMdKLXhQEnNJtvM17ZX8jhaeMaSD9UgDuN3Kw7kMrd7K,5pURHYWB5LUGwJmWVBGH8p6oyR9NJvXnZk7uDVoiassv,True,9464201096,2366050274,7145335,3572667,3572668,72XWPCtRYEDZbddP7d6dHtUBRRDLSJsB2xZTAfefoEVZ,285813427,851479466,-565666039,301
2022-05-10 16:50:16-04:00,22079,B2nFCBzpcf1ptxYz1qJhsvMi66FxVC9MRbmyE651zyvc,Hrkw5SLuHTpmqamJBBTiDQHoF6Cmj5tSf4BFvgbNqUVx,True,45111542,11277885,69332,34666,34666,C4UnXuShCvjSMgBAgVNMy1oakxCNk1et27A82fywU112,2773282,10501649,-7728367,614
2022-05-10 16:50:18-04:00,22080,6cyefDEH1EqWn2RYGMtLj9CPhjXg5eECHsrm3C8fxurr,4o3XrjY3LA63KkjPtNGbwEuq59qXh8WmuEDsD5mfbtMD,True,34067506,8516876,52892,26446,26446,C4UnXuShCvjSMgBAgVNMy1oakxCNk1et27A82fywU112,2115706,4856361,-2740655,621
2022-05-10 16:50:19-04:00,22081,DyMysFYo5aXZD3oH8NnRW1syYPnNdjHPoyvU2Vv2cCzv,KrerC6i7z79cFza1ZXkadwNDqGMzzWbVnvpDCvuGyPz,True,609014113,152253528,767082,383541,383541,DA18qE9qesbBqpwNv1M4befYcNQkbSBSeLPTmQzrmbJw,30683292,186492774,-155809482,503
2022-05-10 16:50:21-04:00,22082,Hjfm6iGa54sbaqjwvJhC9HZ22S48iqt5gdUneRjv8qbR,94DWK2YsxQdw1sFoJstu3GeoUCWnBdcCZZyw4nkVg5ua,True,170006458,42501614,263537,131768,131769,C4UnXuShCvjSMgBAgVNMy1oakxCNk1et27A82fywU112,10541506,51156788,-40615282,620
2022-05-10 16:50:22-04:00,22083,F4hN7ecndZ8Gr5KQNSFaSrMGawMasz7jfWTLTMpk7gaB,AJ23FpXSGjipcqywk88WGsKfqfiiUjPzZLsvLtBAhB12,True,167572320,32333848,199724,99862,99862,F31bVJvHB2XkhGdgjyTim48hY2cLFEx661AiPS3SzYJ2,10350910,13402368,-3051458,617
2022-05-10 16:50:26-04:00,22084,59GbuFudpbJZ4htaYFSabGsQVjRraHEqcroSb2CudvrW,HMs38RfLysAXyt6kD7uviCuqZy1LfFM7rDVgaYkF1mYX,True,95982317,23995579,146661,73330,73331,6L1WYrPiCMyi7XemPww4B4hvpKD1LQKD4RpiSKmrmgSC,5866447,36276298,-30409851,611
2022-05-10 16:50:28-04:00,22085,CAqcooQi8ZyYUehyWXcz83i8p7CNyBNRTY1jbjv4ZZdD,5PzRa1oukLxXfAoJaRMUn5D4uRjF8qN57nADD4hK4qAg,False,13953193,13953193,835556,41777,793779,C4UnXuShCvjSMgBAgVNMy1oakxCNk1et27A82fywU112,835556,8911021,-8075465,598
2022-05-10 16:50:41-04:00,22086,DyMysFYo5aXZD3oH8NnRW1syYPnNdjHPoyvU2Vv2cCzv,KrerC6i7z79cFza1ZXkadwNDqGMzzWbVnvpDCvuGyPz,True,455244413,113811103,710000,355000,355000,8HQmsTbxhLhy25fvfCb16HudTGQ9wkHoEBRz5WYeqiZw,28400038,146779319,-118379281,623
2022-05-10 16:51:34-04:00,22087,6cyefDEH1EqWn2RYGMtLj9CPhjXg5eECHsrm3C8fxurr,4o3XrjY3LA63KkjPtNGbwEuq59qXh8WmuEDsD5mfbtMD,True,25016287,6254071,38211,19105,19106,6L1WYrPiCMyi7XemPww4B4hvpKD1LQKD4RpiSKmrmgSC,1528471,4118322,-2589851,610
2022-05-10 16:51:36-04:00,22088,B2nFCBzpcf1ptxYz1qJhsvMi66FxVC9MRbmyE651zyvc,Hrkw5SLuHTpmqamJBBTiDQHoF6Cmj5tSf4BFvgbNqUVx,True,33095305,8273826,49139,24569,24570,C4UnXuShCvjSMgBAgVNMy1oakxCNk1et27A82fywU112,1965598,8500256,-6534658,593
2022-05-10 16:52:39-04:00,22089,26wo1RqwKXrNnfgMdZEmkGhnDbURpZcp2hasB5EA5QtD,34gwTVGRrdoaBzLUG6SBwRwBovkjBjCebqVUBan6GDnB,True,53013571432,13253392858,93791731,46895865,46895866,F31bVJvHB2XkhGdgjyTim48hY2cLFEx661AiPS3SzYJ2,3751669261,10303688328,-6552019067,707
2022-05-10 16:52:51-04:00,22090,59GbuFudpbJZ4htaYFSabGsQVjRraHEqcroSb2CudvrW,HMs38RfLysAXyt6kD7uviCuqZy1LfFM7rDVgaYkF1mYX,True,70673833,17668458,110172,55086,55086,6L1WYrPiCMyi7XemPww4B4hvpKD1LQKD4RpiSKmrmgSC,4406881,28527331,-24120450,623
2022-05-10 16:52:56-04:00,22091,Hjfm6iGa54sbaqjwvJhC9HZ22S48iqt5gdUneRjv8qbR,94DWK2YsxQdw1sFoJstu3GeoUCWnBdcCZZyw4nkVg5ua,True,124752926,31188231,188151,94075,94076,8sEswn3kzEhnYjAZVvCQnHEUvYd7pFVvc2Xc2Kd1BpbC,7526051,40739892,-33213841,603
2022-05-10 16:53:15-04:00,22092,DyMysFYo5aXZD3oH8NnRW1syYPnNdjHPoyvU2Vv2cCzv,KrerC6i7z79cFza1ZXkadwNDqGMzzWbVnvpDCvuGyPz,True,334486508,83621627,518580,259290,259290,A9TwRM1BMxqb8DCC7YNAMV6zPenEJm3HTZBy7wJKK58U,20743236,116477867,-95734631,620
2022-05-10 16:53:21-04:00,22093,B2nFCBzpcf1ptxYz1qJhsvMi66FxVC9MRbmyE651zyvc,Hrkw5SLuHTpmqamJBBTiDQHoF6Cmj5tSf4BFvgbNqUVx,True,24396404,6099101,37284,18642,18642,2a35JJeTUW1pm6M3e8DHCjp8qr4vbc2cRPhuzZWyFzYd,1491384,6817470,-5326086,611
2022-05-10 16:53:22-04:00,22094,A5NXadGWnFZRoHEn1dKTRjcXgWmfMLMyJdpF4rQPZyRR,ALs3Zfotc4c4A6TFDMbd5GM5whK1dTYSnGrHiMBWmApH,True,1329790382,332447595,2011321,1005660,1005661,A9TwRM1BMxqb8DCC7YNAMV6zPenEJm3HTZBy7wJKK58U,80452871,247276179,-166823308,605
2022-05-10 16:53:25-04:00,22095,6cyefDEH1EqWn2RYGMtLj9CPhjXg5eECHsrm3C8fxurr,4o3XrjY3LA63KkjPtNGbwEuq59qXh8WmuEDsD5mfbtMD,True,18422918,4605729,28774,14387,14387,C4UnXuShCvjSMgBAgVNMy1oakxCNk1et27A82fywU112,1150962,3432658,-2281696,624
2022-05-10 17:05:15-04:00,22096,Hjfm6iGa54sbaqjwvJhC9HZ22S48iqt5gdUneRjv8qbR,94DWK2YsxQdw1sFoJstu3GeoUCWnBdcCZZyw4nkVg5ua,True,92038764,23009691,143559,71779,71780,2a35JJeTUW1pm6M3e8DHCjp8qr4vbc2cRPhuzZWyFzYd,5742387,32178956,-26436569,623
2022-05-10 17:05:20-04:00,22097,59GbuFudpbJZ4htaYFSabGsQVjRraHEqcroSb2CudvrW,HMs38RfLysAXyt6kD7uviCuqZy1LfFM7rDVgaYkF1mYX,True,51972423,12993105,80611,40305,40306,6L1WYrPiCMyi7XemPww4B4hvpKD1LQKD4RpiSKmrmgSC,3224466,22347843,-19123377,620
2022-05-10 17:09:08-04:00,22098,F4hN7ecndZ8Gr5KQNSFaSrMGawMasz7jfWTLTMpk7gaB,AJ23FpXSGjipcqywk88WGsKfqfiiUjPzZLsvLtBAhB12,True,133462207,24173999,150929,75464,75465,2a35JJeTUW1pm6M3e8DHCjp8qr4vbc2cRPhuzZWyFzYd,8332666,13082700,-4750034,624
2022-05-10 17:09:37-04:00,22099,DyMysFYo5aXZD3oH8NnRW1syYPnNdjHPoyvU2Vv2cCzv,KrerC6i7z79cFza1ZXkadwNDqGMzzWbVnvpDCvuGyPz,True,246094649,61523662,381686,190843,190843,6L1WYrPiCMyi7XemPww4B4hvpKD1LQKD4RpiSKmrmgSC,15267470,91840551,-76573081,620
2022-05-10 17:10:00-04:00,22100,B2nFCBzpcf1ptxYz1qJhsvMi66FxVC9MRbmyE651zyvc,Hrkw5SLuHTpmqamJBBTiDQHoF6Cmj5tSf4BFvgbNqUVx,True,17967462,4491865,27764,13882,13882,6L1WYrPiCMyi7XemPww4B4hvpKD1LQKD4RpiSKmrmgSC,1110579,5434994,-4324415,618
2022-05-10 17:10:16-04:00,22101,6cyefDEH1EqWn2RYGMtLj9CPhjXg5eECHsrm3C8fxurr,4o3XrjY3LA63KkjPtNGbwEuq59qXh8WmuEDsD5mfbtMD,False,13539673,13539673,834341,41717,792624,2a35JJeTUW1pm6M3e8DHCjp8qr4vbc2cRPhuzZWyFzYd,834341,2823135,-1988794,616
2022-05-10 17:11:51-04:00,22102,59GbuFudpbJZ4htaYFSabGsQVjRraHEqcroSb2CudvrW,HMs38RfLysAXyt6kD7uviCuqZy1LfFM7rDVgaYkF1mYX,True,38197388,9549347,59048,29524,29524,8sEswn3kzEhnYjAZVvCQnHEUvYd7pFVvc2Xc2Kd1BpbC,2361925,17486437,-15124512,618
2022-05-10 17:11:56-04:00,22103,Hjfm6iGa54sbaqjwvJhC9HZ22S48iqt5gdUneRjv8qbR,94DWK2YsxQdw1sFoJstu3GeoUCWnBdcCZZyw4nkVg5ua,True,67640106,16910026,105246,52623,52623,8sEswn3kzEhnYjAZVvCQnHEUvYd7pFVvc2Xc2Kd1BpbC,4209861,25426398,-21216537,622
2022-05-10 17:12:28-04:00,22104,DyMysFYo5aXZD3oH8NnRW1syYPnNdjHPoyvU2Vv2cCzv,KrerC6i7z79cFza1ZXkadwNDqGMzzWbVnvpDCvuGyPz,True,180981426,45245356,282405,141202,141203,8sEswn3kzEhnYjAZVvCQnHEUvYd7pFVvc2Xc2Kd1BpbC,11296223,72316640,-61020417,624
2022-05-10 17:12:32-04:00,22105,B2nFCBzpcf1ptxYz1qJhsvMi66FxVC9MRbmyE651zyvc,Hrkw5SLuHTpmqamJBBTiDQHoF6Cmj5tSf4BFvgbNqUVx,False,13201792,13201792,809010,40450,768560,Hu94aiQWvce6THeGyCFqGRPM1pQrK3ihzkcXo1EpJcJL,809010,4326132,-3517122,612
2022-05-10 17:14:33-04:00,22106,F4hN7ecndZ8Gr5KQNSFaSrMGawMasz7jfWTLTMpk7gaB,AJ23FpXSGjipcqywk88WGsKfqfiiUjPzZLsvLtBAhB12,True,107776292,18053791,111726,55863,55863,8sEswn3kzEhnYjAZVvCQnHEUvYd7pFVvc2Xc2Kd1BpbC,6669821,12797034,-6127213,618
2022-05-10 17:15:17-04:00,22107,CPsnF5SkVCnFkFXhLwzpp6H7rBrTumCuYJCyVSeT8cFZ,BMV1AyAxyTuXTfwddphdRc3nwbySVbhqUZau8oatdTEJ,True,210932505,17998046,73137,36568,36569,6L1WYrPiCMyi7XemPww4B4hvpKD1LQKD4RpiSKmrmgSC,8571525,89006315,-80434790,406
2022-05-10 17:15:17-04:00,22108,Hjfm6iGa54sbaqjwvJhC9HZ22S48iqt5gdUneRjv8qbR,94DWK2YsxQdw1sFoJstu3GeoUCWnBdcCZZyw4nkVg5ua,True,49645002,12411250,75488,37744,37744,8sEswn3kzEhnYjAZVvCQnHEUvYd7pFVvc2Xc2Kd1BpbC,3019537,20017098,-16997561,608
2022-05-10 17:15:17-04:00,22109,59GbuFudpbJZ4htaYFSabGsQVjRraHEqcroSb2CudvrW,HMs38RfLysAXyt6kD7uviCuqZy1LfFM7rDVgaYkF1mYX,True,28033106,7008276,42198,21099,21099,2a35JJeTUW1pm6M3e8DHCjp8qr4vbc2cRPhuzZWyFzYd,1687942,13646289,-11958347,602
2022-05-10 17:17:12-04:00,22110,DyMysFYo5aXZD3oH8NnRW1syYPnNdjHPoyvU2Vv2cCzv,KrerC6i7z79cFza1ZXkadwNDqGMzzWbVnvpDCvuGyPz,True,133020952,33255238,207467,103733,103734,8sEswn3kzEhnYjAZVvCQnHEUvYd7pFVvc2Xc2Kd1BpbC,8298700,56779713,-48481013,623
2022-05-10 17:21:48-04:00,22111,CPsnF5SkVCnFkFXhLwzpp6H7rBrTumCuYJCyVSeT8cFZ,BMV1AyAxyTuXTfwddphdRc3nwbySVbhqUZau8oatdTEJ,True,192660474,34820502,136292,68146,68146,2a35JJeTUW1pm6M3e8DHCjp8qr4vbc2cRPhuzZWyFzYd,7541019,47310303,-39769284,391
2022-05-10 17:22:16-04:00,22112,59GbuFudpbJZ4htaYFSabGsQVjRraHEqcroSb2CudvrW,HMs38RfLysAXyt6kD7uviCuqZy1LfFM7rDVgaYkF1mYX,True,20439026,5109756,26498,13249,13249,C4UnXuShCvjSMgBAgVNMy1oakxCNk1et27A82fywU112,1059940,10614520,-9554580,518
2022-05-10 17:22:16-04:00,22113,F4hN7ecndZ8Gr5KQNSFaSrMGawMasz7jfWTLTMpk7gaB,AJ23FpXSGjipcqywk88WGsKfqfiiUjPzZLsvLtBAhB12,True,88521197,13552399,82010,41005,41005,C4UnXuShCvjSMgBAgVNMy1oakxCNk1et27A82fywU112,5356791,12507499,-7150708,605
2022-05-10 17:22:16-04:00,22114,9AG4AeuNpn5VeA3dgijG4qpQ5DSSMwtnPhwk7jxeKUnQ,C37f7GHALWQbrxfn72Fjyq58FoW3MF98mBrwGEQbWbK4,True,85618143,21404535,116078,58039,58039,C4UnXuShCvjSMgBAgVNMy1oakxCNk1et27A82fywU112,4643156,47410802,-42767646,542
2022-05-10 17:22:21-04:00,22115,Hjfm6iGa54sbaqjwvJhC9HZ22S48iqt5gdUneRjv8qbR,94DWK2YsxQdw1sFoJstu3GeoUCWnBdcCZZyw4nkVg5ua,True,36194393,9048598,47617,23808,23809,C4UnXuShCvjSMgBAgVNMy1oakxCNk1et27A82fywU112,1904690,15692265,-13787575,526
2022-05-10 17:22:25-04:00,22116,DyMysFYo5aXZD3oH8NnRW1syYPnNdjHPoyvU2Vv2cCzv,KrerC6i7z79cFza1ZXkadwNDqGMzzWbVnvpDCvuGyPz,True,97247167,24311791,139317,69658,69659,C4UnXuShCvjSMgBAgVNMy1oakxCNk1et27A82fywU112,5572686,44452318,-38879632,573
2022-05-10 17:22:28-04:00,22117,CPsnF5SkVCnFkFXhLwzpp6H7rBrTumCuYJCyVSeT8cFZ,BMV1AyAxyTuXTfwddphdRc3nwbySVbhqUZau8oatdTEJ,True,156866748,13101310,53714,26857,26857,2a35JJeTUW1pm6M3e8DHCjp8qr4vbc2cRPhuzZWyFzYd,6431503,68603411,-62171908,409
2022-05-10 17:23:04-04:00,22118,59GbuFudpbJZ4htaYFSabGsQVjRraHEqcroSb2CudvrW,HMs38RfLysAXyt6kD7uviCuqZy1LfFM7rDVgaYkF1mYX,False,15234252,15234252,938424,46921,891503,Hu94aiQWvce6THeGyCFqGRPM1pQrK3ihzkcXo1EpJcJL,938424,8199386,-7260962,615
2022-05-10 17:23:08-04:00,22119,Hjfm6iGa54sbaqjwvJhC9HZ22S48iqt5gdUneRjv8qbR,94DWK2YsxQdw1sFoJstu3GeoUCWnBdcCZZyw4nkVg5ua,True,26929812,6732453,41027,20513,20514,2a35JJeTUW1pm6M3e8DHCjp8qr4vbc2cRPhuzZWyFzYd,1641090,12197780,-10556690,609
2022-05-10 17:23:19-04:00,22120,9AG4AeuNpn5VeA3dgijG4qpQ5DSSMwtnPhwk7jxeKUnQ,C37f7GHALWQbrxfn72Fjyq58FoW3MF98mBrwGEQbWbK4,True,63659406,15914851,99321,49660,49661,2a35JJeTUW1pm6M3e8DHCjp8qr4vbc2cRPhuzZWyFzYd,3972876,36602963,-32630087,624
2022-05-10 17:24:01-04:00,22121,DyMysFYo5aXZD3oH8NnRW1syYPnNdjHPoyvU2Vv2cCzv,KrerC6i7z79cFza1ZXkadwNDqGMzzWbVnvpDCvuGyPz,True,71915379,17978844,110334,55167,55167,68sueyVfmy5ToEGtLFGDkwebX47xAmzyXE29z8JrmcWv,4413372,34593274,-30179902,613
2022-05-10 17:24:02-04:00,22122,F4hN7ecndZ8Gr5KQNSFaSrMGawMasz7jfWTLTMpk7gaB,AJ23FpXSGjipcqywk88WGsKfqfiiUjPzZLsvLtBAhB12,True,74339222,10128412,63288,31644,31644,2a35JJeTUW1pm6M3e8DHCjp8qr4vbc2cRPhuzZWyFzYd,4645205,12304162,-7658957,624
2022-05-10 17:25:11-04:00,22123,Hjfm6iGa54sbaqjwvJhC9HZ22S48iqt5gdUneRjv8qbR,94DWK2YsxQdw1sFoJstu3GeoUCWnBdcCZZyw4nkVg5ua,True,19834466,4958616,30929,15464,15465,Hu94aiQWvce6THeGyCFqGRPM1pQrK3ihzkcXo1EpJcJL,1237170,9517595,-8280425,623
2022-05-10 17:25:17-04:00,22124,5L4rwphiDXABvFWjdFRCUjRjkvJoAdAhztB9nPn1vbTP,6KWPKfStxQ1HJ6mxAFG19EGmrccjZqdGvniPoEyy9Fij,True,369522369,92380592,659031,329515,329516,4yhyLx1phodwcvvwVU2bramHcdbJYvfadd7pANsRzX8M,26361241,196821802,-170460561,713
2022-05-10 17:26:17-04:00,22125,9AG4AeuNpn5VeA3dgijG4qpQ5DSSMwtnPhwk7jxeKUnQ,C37f7GHALWQbrxfn72Fjyq58FoW3MF98mBrwGEQbWbK4,True,46666534,11666633,69888,34944,34944,Hu94aiQWvce6THeGyCFqGRPM1pQrK3ihzkcXo1EpJcJL,2795534,28346205,-25550671,599
2022-05-10 17:26:18-04:00,22126,F4hN7ecndZ8Gr5KQNSFaSrMGawMasz7jfWTLTMpk7gaB,AJ23FpXSGjipcqywk88WGsKfqfiiUjPzZLsvLtBAhB12,True,63546898,8310485,51238,25619,25619,C4UnXuShCvjSMgBAgVNMy1oakxCNk1et27A82fywU112,3918005,12113977,-8195972,616
2022-05-10 17:26:30-04:00,22127,DyMysFYo5aXZD3oH8NnRW1syYPnNdjHPoyvU2Vv2cCzv,KrerC6i7z79cFza1ZXkadwNDqGMzzWbVnvpDCvuGyPz,True,52900401,13225100,81672,40836,40836,C4UnXuShCvjSMgBAgVNMy1oakxCNk1et27A82fywU112,3266904,26938066,-23671162,617
2022-05-10 17:26:50-04:00,22128,CPsnF5SkVCnFkFXhLwzpp6H7rBrTumCuYJCyVSeT8cFZ,BMV1AyAxyTuXTfwddphdRc3nwbySVbhqUZau8oatdTEJ,True,142084905,26015624,100617,50308,50309,2a35JJeTUW1pm6M3e8DHCjp8qr4vbc2cRPhuzZWyFzYd,5495274,36935212,-31439938,386
2022-05-10 17:27:40-04:00,22129,8DSiP9CwJm3AEcH6uuAYFpArRRDLYpDQgjHEvjkUgfg2,ERJ8kuhPRRmUAhSM4oxUheh39YUVVYNgaTt6AdMXcCvL,True,803889726,200972431,604569,302284,302285,DA18qE9qesbBqpwNv1M4befYcNQkbSBSeLPTmQzrmbJw,24182761,100078224,-75895463,300
2022-05-10 17:27:42-04:00,22130,3y4nxPTL7BWD5QrqkNKfQ2iCLPKzsWttc5Aofi3fsvPh,8Bk9cC7kTXjWkEwYFCg1GrKZaAMDPhzNdBXbd55hdkJ8,True,160177670,40044417,246997,123498,123499,8sEswn3kzEhnYjAZVvCQnHEUvYd7pFVvc2Xc2Kd1BpbC,9879890,99258670,-89378780,616
2022-05-10 17:28:09-04:00,22131,FMdKLXhQEnNJtvM17ZX8jhaeMaSD9UgDuN3Kw7kMrd7K,5pURHYWB5LUGwJmWVBGH8p6oyR9NJvXnZk7uDVoiassv,True,7024617469,1756154367,5120719,2560359,2560360,8HQmsTbxhLhy25fvfCb16HudTGQ9wkHoEBRz5WYeqiZw,204828793,703500363,-498671570,291
2022-05-10 17:28:17-04:00,22132,51JkLLdP6fXRjHpfayZGUK5juQ33A5n87jncRdcJRV7r,4pww8ryf4tVJhYR8dDA48oe5dj4uWqRhzHhh25m7Dy72,False,1188906,1188906,34701,1735,32966,Hu94aiQWvce6THeGyCFqGRPM1pQrK3ihzkcXo1EpJcJL,34701,745603,-710902,291
2022-05-10 17:28:17-04:00,22133,F4hN7ecndZ8Gr5KQNSFaSrMGawMasz7jfWTLTMpk7gaB,AJ23FpXSGjipcqywk88WGsKfqfiiUjPzZLsvLtBAhB12,True,54738514,7546211,46442,23221,23221,Hu94aiQWvce6THeGyCFqGRPM1pQrK3ihzkcXo1EpJcJL,3368868,10129028,-6760160,615
2022-05-10 17:28:19-04:00,22134,Hjfm6iGa54sbaqjwvJhC9HZ22S48iqt5gdUneRjv8qbR,94DWK2YsxQdw1sFoJstu3GeoUCWnBdcCZZyw4nkVg5ua,False,14570101,14570101,900492,45024,855468,C4UnXuShCvjSMgBAgVNMy1oakxCNk1et27A82fywU112,900492,7416568,-6516076,618
2022-05-10 17:28:54-04:00,22135,9AG4AeuNpn5VeA3dgijG4qpQ5DSSMwtnPhwk7jxeKUnQ,C37f7GHALWQbrxfn72Fjyq58FoW3MF98mBrwGEQbWbK4,True,34379431,8594857,52629,26314,26315,6L1WYrPiCMyi7XemPww4B4hvpKD1LQKD4RpiSKmrmgSC,2105176,21888697,-19783521,612
2022-05-10 17:29:49-04:00,22136,26wo1RqwKXrNnfgMdZEmkGhnDbURpZcp2hasB5EA5QtD,34gwTVGRrdoaBzLUG6SBwRwBovkjBjCebqVUBan6GDnB,True,38850532379,9712633094,68556777,34278388,34278389,CGtKBgcWZ6HKE3tFNLPUM9khDv2Rc7d6BrPtxz7J1aY,2742271102,8823343711,-6081072609,705
2022-05-10 17:32:54-04:00,22137,EyNCsqWu8zLyuRnXSbzJWnWZg7ZLjb4oJSZFdDSkbXmT,6rMMMkZibUHXYs8hXY3FmG4rgBx6gWDRGJwR2bP2t6ZD,True,4573079206,798228250,3182884,1591442,1591442,3zqXX6kzhkbW3d4TwD2CNjMRwxTbREXySekvq37kfCNk,182348672,1414169059,-1231820387,398
2022-05-10 17:36:08-04:00,22138,DyMysFYo5aXZD3oH8NnRW1syYPnNdjHPoyvU2Vv2cCzv,KrerC6i7z79cFza1ZXkadwNDqGMzzWbVnvpDCvuGyPz,True,38921138,9730284,60776,30388,30388,6L1WYrPiCMyi7XemPww4B4hvpKD1LQKD4RpiSKmrmgSC,2431069,20938660,-18507591,624
2022-05-10 17:36:20-04:00,22139,5L4rwphiDXABvFWjdFRCUjRjkvJoAdAhztB9nPn1vbTP,6KWPKfStxQ1HJ6mxAFG19EGmrccjZqdGvniPoEyy9Fij,True,269813779,67453444,459355,229677,229678,Hu94aiQWvce6THeGyCFqGRPM1pQrK3ihzkcXo1EpJcJL,18374212,153564035,-135189823,680
2022-05-10 17:37:12-04:00,22140,3y4nxPTL7BWD5QrqkNKfQ2iCLPKzsWttc5Aofi3fsvPh,8Bk9cC7kTXjWkEwYFCg1GrKZaAMDPhzNdBXbd55hdkJ8,True,117435200,29358800,173371,86685,86686,8sEswn3kzEhnYjAZVvCQnHEUvYd7pFVvc2Xc2Kd1BpbC,6934840,76667533,-69732693,590
2022-05-10 17:38:11-04:00,22141,CPsnF5SkVCnFkFXhLwzpp6H7rBrTumCuYJCyVSeT8cFZ,BMV1AyAxyTuXTfwddphdRc3nwbySVbhqUZau8oatdTEJ,True,114643994,19425353,78964,39482,39482,Hu94aiQWvce6THeGyCFqGRPM1pQrK3ihzkcXo1EpJcJL,4660292,53006216,-48345924,406
2022-05-10 17:39:02-04:00,22142,26wo1RqwKXrNnfgMdZEmkGhnDbURpZcp2hasB5EA5QtD,34gwTVGRrdoaBzLUG6SBwRwBovkjBjCebqVUBan6GDnB,True,28492705224,7123176306,50713006,25356503,25356503,A2p75MbAbeUdHkPLkAjgGeiwuu9WPrkMHzjCkDXF1Xr3,2028520264,7379104029,-5350583765,711
2022-05-10 17:39:08-04:00,22143,BePQMfbkFe8vQ54rFkkf2dzXunPq2Xwpibrm1JVzSHLz,8R6rnjVUnMGUxx5sRjnuuyEnfyBGeet7y2jSJwVswyT3,True,8525516591,2131379147,5939360,2969680,2969680,DQCvC9mR68hJ3tJsUiddh6JwcBJAmntqGJR2nUsEq7yj,237574405,2734205520,-2496631115,278
2022-05-10 17:39:11-04:00,22144,2Tqo1ULXPkdond4xNwF2UdMvAfWWgK2Ad8QFx74WqiUF,D6Nktb35GnLs7KAdtqtr8QhkMhDL6AgsdtvzCuA7rRVp,False,15828810,15828810,443084,22154,420930,3zqXX6kzhkbW3d4TwD2CNjMRwxTbREXySekvq37kfCNk,443084,7009774,-6566690,279
2022-05-10 17:39:14-04:00,22145,DwoQXrbwHmfnkWvYaHbPjir3WLmq3oSpSrAjnPdDqgtL,Hv6r5uYpyyn8B4PTzrki6mj5hdF64yaa564Zi277tANU,True,13781895579,3445473894,9957130,4978565,4978565,CGtKBgcWZ6HKE3tFNLPUM9khDv2Rc7d6BrPtxz7J1aY,398285213,889067624,-490782411,288
2022-05-10 17:39:16-04:00,22146,2u1f1ctzKMobykT68tN7jcURBTKqh9FJrnyCW311Hcx9,62WDNhS4PB3DWXhsUJQvUF5tJXLyFMD5CjyC5EMvnGeq,False,6452909,6452909,188960,9448,179512,Hu94aiQWvce6THeGyCFqGRPM1pQrK3ihzkcXo1EpJcJL,188960,3732051,-3543091,292
2022-05-10 17:39:17-04:00,22147,6VuKLtKKHmB5y7FUwYuVSVYUnDih5FJMPn3p6LFEmEB8,64MqsNgRTFR5QfmjZMmgf6ocf5ArnNt5oz9stBapDGfB,True,3670109812,917527453,2779928,1389964,1389964,Hu94aiQWvce6THeGyCFqGRPM1pQrK3ihzkcXo1EpJcJL,111197149,805726016,-694528867,302
2022-05-10 17:39:21-04:00,22148,5hfwMBNetuL1wYHVXrGkKWNAjKyN8WhmqjZd8EjXYN8d,DT9rQfjr27ULJ5PiQ3pShDFvT4LyV6ogcSXnp4mUdwhY,True,114492506,28623126,80212,40106,40106,F31bVJvHB2XkhGdgjyTim48hY2cLFEx661AiPS3SzYJ2,3208484,35288942,-32080458,280
2022-05-10 17:39:23-04:00,22149,EEQmHFk3WFNmPfe7ujtP1PK6P5yqV5mmWumNSoTu45P8,FG9DScQDQPrgcmBbRugZ5NfhSTRMnKSWLxcUeTF9MgJZ,False,26016456,26016456,622697,31134,591563,Hu94aiQWvce6THeGyCFqGRPM1pQrK3ihzkcXo1EpJcJL,622697,6392814,-5770117,239
2022-05-10 17:39:24-04:00,22150,EyNCsqWu8zLyuRnXSbzJWnWZg7ZLjb4oJSZFdDSkbXmT,6rMMMkZibUHXYs8hXY3FmG4rgBx6gWDRGJwR2bP2t6ZD,True,3744389536,343480129,1364093,682046,682047,2a35JJeTUW1pm6M3e8DHCjp8qr4vbc2cRPhuzZWyFzYd,148704368,1237379767,-1088675399,397
2022-05-10 17:39:26-04:00,22151,8e3Du79eCAvuNc6ZX44quJRCuCxmjVDNhRHr1eTB3wqr,3Lb3b9ikztneijmjUzNgHKzCBBfFNKbpjAyc7DQ8pE2M,True,54980028,13745007,38618,19309,19309,C4UnXuShCvjSMgBAgVNMy1oakxCNk1et27A82fywU112,1544721,35546599,-34001878,280
2022-05-10 17:39:32-04:00,22152,FnAT8HKGgisYfeAbxKU2gSbCp8KbZHULRpaJX1NVijHy,2u637Crc2QzfSJmCnRNqeib3aZQVn4NGncpgM3Ph6jvm,False,30801559,30801559,848996,42449,806547,C4UnXuShCvjSMgBAgVNMy1oakxCNk1et27A82fywU112,848996,7884937,-7035941,275
2022-05-10 17:39:34-04:00,22153,EcA4r9niwWqDHL4qnm2Px8nTGZcF1Mi5YWXZT9toTNXy,GE4of9HT9AAdqUfmZ5SUyJLxWqgxS6gGrbtABephXH8H,False,1302350,1302350,35238,1761,33477,3zqXX6kzhkbW3d4TwD2CNjMRwxTbREXySekvq37kfCNk,35238,732686,-697448,270
2022-05-10 17:39:36-04:00,22154,5bF9tSdmHqni2jdMMbLfiE5jxHtX8WoJXNXxMuykuojW,FrRNyeq1GrnBbAdBeEMPKX6yv54KJLhTpoPBB3irxDei,True,467866896,116966724,324841,162420,162421,C4UnXuShCvjSMgBAgVNMy1oakxCNk1et27A82fywU112,12993661,25245819,-12252158,277
2022-05-10 17:39:53-04:00,22155,9AG4AeuNpn5VeA3dgijG4qpQ5DSSMwtnPhwk7jxeKUnQ,C37f7GHALWQbrxfn72Fjyq58FoW3MF98mBrwGEQbWbK4,True,25194764,6298691,36568,18284,18284,2a35JJeTUW1pm6M3e8DHCjp8qr4vbc2cRPhuzZWyFzYd,1462737,16890215,-15427478,580
2022-05-10 17:40:09-04:00,22156,5L4rwphiDXABvFWjdFRCUjRjkvJoAdAhztB9nPn1vbTP,6KWPKfStxQ1HJ6mxAFG19EGmrccjZqdGvniPoEyy9Fij,True,197999098,49499774,338840,169420,169420,6L1WYrPiCMyi7XemPww4B4hvpKD1LQKD4RpiSKmrmgSC,13553620,119316330,-105762710,684
2022-05-10 17:40:23-04:00,22157,DyMysFYo5aXZD3oH8NnRW1syYPnNdjHPoyvU2Vv2cCzv,KrerC6i7z79cFza1ZXkadwNDqGMzzWbVnvpDCvuGyPz,True,28456318,7114079,40893,20446,20447,2a35JJeTUW1pm6M3e8DHCjp8qr4vbc2cRPhuzZWyFzYd,1635757,16251018,-14615261,574
2022-05-10 17:40:26-04:00,22158,3y4nxPTL7BWD5QrqkNKfQ2iCLPKzsWttc5Aofi3fsvPh,8Bk9cC7kTXjWkEwYFCg1GrKZaAMDPhzNdBXbd55hdkJ8,True,86668693,21667173,133844,66922,66922,F31bVJvHB2XkhGdgjyTim48hY2cLFEx661AiPS3SzYJ2,5353762,59061298,-53707536,617
2022-05-10 17:40:33-04:00,22159,FMdKLXhQEnNJtvM17ZX8jhaeMaSD9UgDuN3Kw7kMrd7K,5pURHYWB5LUGwJmWVBGH8p6oyR9NJvXnZk7uDVoiassv,True,5217347654,1304336913,3714815,1857407,1857408,8HQmsTbxhLhy25fvfCb16HudTGQ9wkHoEBRz5WYeqiZw,148592626,574209145,-425616519,284
2022-05-10 17:40:37-04:00,22160,8DSiP9CwJm3AEcH6uuAYFpArRRDLYpDQgjHEvjkUgfg2,ERJ8kuhPRRmUAhSM4oxUheh39YUVVYNgaTt6AdMXcCvL,True,596093903,149023475,418870,209435,209435,DA18qE9qesbBqpwNv1M4befYcNQkbSBSeLPTmQzrmbJw,16754800,80506441,-63751641,281
2022-05-10 17:41:57-04:00,22161,9AG4AeuNpn5VeA3dgijG4qpQ5DSSMwtnPhwk7jxeKUnQ,C37f7GHALWQbrxfn72Fjyq58FoW3MF98mBrwGEQbWbK4,True,18588132,4647033,27955,13977,13978,8sEswn3kzEhnYjAZVvCQnHEUvYd7pFVvc2Xc2Kd1BpbC,1118228,12996793,-11878565,601
2022-05-10 17:42:29-04:00,22162,DyMysFYo5aXZD3oH8NnRW1syYPnNdjHPoyvU2Vv2cCzv,KrerC6i7z79cFza1ZXkadwNDqGMzzWbVnvpDCvuGyPz,True,21048692,5262173,32532,16266,16266,6L1WYrPiCMyi7XemPww4B4hvpKD1LQKD4RpiSKmrmgSC,1301317,12556328,-11255011,618
2022-05-10 17:42:32-04:00,22163,CPsnF5SkVCnFkFXhLwzpp6H7rBrTumCuYJCyVSeT8cFZ,BMV1AyAxyTuXTfwddphdRc3nwbySVbhqUZau8oatdTEJ,True,93626084,8959383,37930,18965,18965,C4UnXuShCvjSMgBAgVNMy1oakxCNk1et27A82fywU112,3963795,65142231,-61178436,423
2022-05-10 17:42:53-04:00,22164,3y4nxPTL7BWD5QrqkNKfQ2iCLPKzsWttc5Aofi3fsvPh,8Bk9cC7kTXjWkEwYFCg1GrKZaAMDPhzNdBXbd55hdkJ8,True,63652810,15913202,96780,48390,48390,2a35JJeTUW1pm6M3e8DHCjp8qr4vbc2cRPhuzZWyFzYd,3871208,45500743,-41629535,608
2022-05-10 17:43:34-04:00,22165,AL8JFS4gjaQx89f9j8wtaNJgV76K8bw1ugvNtgvhgAnb,HJYvG2kGKe8kXgtZSWTWwTmSjxA3XUeCvyT7acoKtS1C,True,1509466389,377366597,1070229,535114,535115,A2p75MbAbeUdHkPLkAjgGeiwuu9WPrkMHzjCkDXF1Xr3,42809183,543625925,-500816742,283
2022-05-10 17:43:35-04:00,22166,BePQMfbkFe8vQ54rFkkf2dzXunPq2Xwpibrm1JVzSHLz,8R6rnjVUnMGUxx5sRjnuuyEnfyBGeet7y2jSJwVswyT3,True,6353746404,1588436601,4781100,2390550,2390550,AmTrMPzuTp2BjnjqGNKqz9FTTCdpoKcPAJLwFc8ozcbh,191244005,2105358806,-1914114801,300
2022-05-10 17:43:35-04:00,22167,7zuFEyLQFHkAjm3mAuxN42VenwF6fZcqM81mmR8sBnmY,CSnQxjc4Jn8iP4JSxj5wsrvxGsLoAYQn1bKC8naY7YZP,True,561336523,140334130,420530,210265,210265,AmTrMPzuTp2BjnjqGNKqz9FTTCdpoKcPAJLwFc8ozcbh,16821203,90049790,-73228587,299
2022-05-10 17:43:40-04:00,22168,4ffdaV4HxcgmHEbybBjEgrcT9nziJcNUnaSjWDm7odbM,UnYSFaXjRKn5bP8z6qQMQgkajnBejCEs43DoAUduz35,True,31874999,2382198,10020,5010,5010,2a35JJeTUW1pm6M3e8DHCjp8qr4vbc2cRPhuzZWyFzYd,1340801,29465746,-28124945,420
2022-05-10 17:44:24-04:00,22169,9AG4AeuNpn5VeA3dgijG4qpQ5DSSMwtnPhwk7jxeKUnQ,C37f7GHALWQbrxfn72Fjyq58FoW3MF98mBrwGEQbWbK4,False,13697820,13697820,846994,42349,804645,2a35JJeTUW1pm6M3e8DHCjp8qr4vbc2cRPhuzZWyFzYd,846994,9999205,-9152211,618
2022-05-10 17:45:20-04:00,22170,CPsnF5SkVCnFkFXhLwzpp6H7rBrTumCuYJCyVSeT8cFZ,BMV1AyAxyTuXTfwddphdRc3nwbySVbhqUZau8oatdTEJ,True,84301809,14484123,56098,28049,28049,Hu94aiQWvce6THeGyCFqGRPM1pQrK3ihzkcXo1EpJcJL,3265083,40526781,-37261698,387
2022-05-10 17:45:23-04:00,22171,DyMysFYo5aXZD3oH8NnRW1syYPnNdjHPoyvU2Vv2cCzv,KrerC6i7z79cFza1ZXkadwNDqGMzzWbVnvpDCvuGyPz,False,15456414,15456414,938680,46934,891746,C4UnXuShCvjSMgBAgVNMy1oakxCNk1et27A82fywU112,938680,9710054,-8771374,607
2022-05-10 17:46:57-04:00,22172,3y4nxPTL7BWD5QrqkNKfQ2iCLPKzsWttc5Aofi3fsvPh,8Bk9cC7kTXjWkEwYFCg1GrKZaAMDPhzNdBXbd55hdkJ8,True,46893278,11723319,73202,36601,36601,6L1WYrPiCMyi7XemPww4B4hvpKD1LQKD4RpiSKmrmgSC,2928098,34996676,-32068578,624
2022-05-10 17:47:24-04:00,22173,CPsnF5SkVCnFkFXhLwzpp6H7rBrTumCuYJCyVSeT8cFZ,BMV1AyAxyTuXTfwddphdRc3nwbySVbhqUZau8oatdTEJ,True,69524876,6517881,27320,13660,13660,Hu94aiQWvce6THeGyCFqGRPM1pQrK3ihzkcXo1EpJcJL,2914213,49716751,-46802538,419
2022-05-10 17:54:21-04:00,22174,4ffdaV4HxcgmHEbybBjEgrcT9nziJcNUnaSjWDm7odbM,UnYSFaXjRKn5bP8z6qQMQgkajnBejCEs43DoAUduz35,True,29363732,1782320,7293,3646,3647,Hu94aiQWvce6THeGyCFqGRPM1pQrK3ihzkcXo1EpJcJL,1201712,28087927,-26886215,409
2022-05-10 17:54:44-04:00,22175,8YuVG1zMmMSPmiM62AphS86zuHattfr4QdPYUaSiWx95,9qeLiZqeLWASGUJaUWyKD7WLMXPtc5APAdAsmBLPTUr8,True,31582211,3258652,15466,7733,7733,2a35JJeTUW1pm6M3e8DHCjp8qr4vbc2cRPhuzZWyFzYd,1499035,29916983,-28417948,474
2022-05-10 17:55:28-04:00,22176,CPsnF5SkVCnFkFXhLwzpp6H7rBrTumCuYJCyVSeT8cFZ,BMV1AyAxyTuXTfwddphdRc3nwbySVbhqUZau8oatdTEJ,True,62306649,10826804,43073,21536,21537,2a35JJeTUW1pm6M3e8DHCjp8qr4vbc2cRPhuzZWyFzYd,2478815,31054602,-28575787,397
2022-05-10 17:56:10-04:00,22177,6Y9imBXmExXnnPYEKtnQcEFQrv2zVCehMSDG5jDtz7Le,AxrpYyiKLPEa6jYAh55VDrScyjGwUbF6EGETsigvcRY7,True,803485832,200871458,1216640,608320,608320,CGtKBgcWZ6HKE3tFNLPUM9khDv2Rc7d6BrPtxz7J1aY,48665636,746023772,-697358136,605
2022-05-10 17:56:58-04:00,22178,FMdKLXhQEnNJtvM17ZX8jhaeMaSD9UgDuN3Kw7kMrd7K,5pURHYWB5LUGwJmWVBGH8p6oyR9NJvXnZk7uDVoiassv,True,3885562489,971390622,2935738,1467869,1467869,4yhyLx1phodwcvvwVU2bramHcdbJYvfadd7pANsRzX8M,117429559,464368667,-346939108,302
2022-05-10 17:57:02-04:00,22179,8DSiP9CwJm3AEcH6uuAYFpArRRDLYpDQgjHEvjkUgfg2,ERJ8kuhPRRmUAhSM4oxUheh39YUVVYNgaTt6AdMXcCvL,True,443897145,110974286,329066,164533,164533,F31bVJvHB2XkhGdgjyTim48hY2cLFEx661AiPS3SzYJ2,13162647,64153382,-50990735,296
2022-05-10 17:58:23-04:00,22180,CPsnF5SkVCnFkFXhLwzpp6H7rBrTumCuYJCyVSeT8cFZ,BMV1AyAxyTuXTfwddphdRc3nwbySVbhqUZau8oatdTEJ,True,51077261,4650115,18575,9287,9288,C4UnXuShCvjSMgBAgVNMy1oakxCNk1et27A82fywU112,2040388,37982337,-35941949,399
2022-05-10 17:58:42-04:00,22181,6Y9imBXmExXnnPYEKtnQcEFQrv2zVCehMSDG5jDtz7Le,AxrpYyiKLPEa6jYAh55VDrScyjGwUbF6EGETsigvcRY7,True,588670917,147167729,837638,418819,418819,8sEswn3kzEhnYjAZVvCQnHEUvYd7pFVvc2Xc2Kd1BpbC,33505539,570485327,-536979788,569
2022-05-10 17:58:44-04:00,22182,4ffdaV4HxcgmHEbybBjEgrcT9nziJcNUnaSjWDm7odbM,UnYSFaXjRKn5bP8z6qQMQgkajnBejCEs43DoAUduz35,True,27460335,1331208,5203,2601,2602,8sEswn3kzEhnYjAZVvCQnHEUvYd7pFVvc2Xc2Kd1BpbC,1073342,27050454,-25977112,390
2022-05-10 17:59:11-04:00,22183,8YuVG1zMmMSPmiM62AphS86zuHattfr4QdPYUaSiWx95,9qeLiZqeLWASGUJaUWyKD7WLMXPtc5APAdAsmBLPTUr8,True,28127053,2433878,11136,5568,5568,Hu94aiQWvce6THeGyCFqGRPM1pQrK3ihzkcXo1EpJcJL,1287063,28160163,-26873100,457
2022-05-10 17:59:49-04:00,22184,CPsnF5SkVCnFkFXhLwzpp6H7rBrTumCuYJCyVSeT8cFZ,BMV1AyAxyTuXTfwddphdRc3nwbySVbhqUZau8oatdTEJ,True,46244304,8118850,32334,16167,16167,C4UnXuShCvjSMgBAgVNMy1oakxCNk1et27A82fywU112,1841767,23749329,-21907562,398
2022-05-10 18:00:45-04:00,22185,6Y9imBXmExXnnPYEKtnQcEFQrv2zVCehMSDG5jDtz7Le,AxrpYyiKLPEa6jYAh55VDrScyjGwUbF6EGETsigvcRY7,True,433319542,108329885,612106,306053,306053,8sEswn3kzEhnYjAZVvCQnHEUvYd7pFVvc2Xc2Kd1BpbC,24484255,435412599,-410928344,565
2022-05-10 18:01:06-04:00,22186,4ffdaV4HxcgmHEbybBjEgrcT9nziJcNUnaSjWDm7odbM,UnYSFaXjRKn5bP8z6qQMQgkajnBejCEs43DoAUduz35,False,26057270,26057270,994451,49722,944729,8sEswn3kzEhnYjAZVvCQnHEUvYd7pFVvc2Xc2Kd1BpbC,994453,26265254,-25270801,381
2022-05-10 18:19:18-04:00,22187,CPsnF5SkVCnFkFXhLwzpp6H7rBrTumCuYJCyVSeT8cFZ,BMV1AyAxyTuXTfwddphdRc3nwbySVbhqUZau8oatdTEJ,True,38261210,3435177,14366,7183,7183,6L1WYrPiCMyi7XemPww4B4hvpKD1LQKD4RpiSKmrmgSC,1600162,28929211,-27329049,418
2022-05-10 18:25:20-04:00,22188,CPsnF5SkVCnFkFXhLwzpp6H7rBrTumCuYJCyVSeT8cFZ,BMV1AyAxyTuXTfwddphdRc3nwbySVbhqUZau8oatdTEJ,True,34669921,6137164,24310,12155,12155,6L1WYrPiCMyi7XemPww4B4hvpKD1LQKD4RpiSKmrmgSC,1373370,18201600,-16828230,396
2022-05-10 18:25:44-04:00,22189,7e93pExd85uEwZxZoQmH3HbzG3j3pEgJEakj7oQ6oXrj,5S8xzi46JZiWGdWtHeZ13iin6Yqny4n3DVSZot1dDyNy,False,173238,173238,10513,525,9988,3zqXX6kzhkbW3d4TwD2CNjMRwxTbREXySekvq37kfCNk,10513,483812,-473299,606
2022-05-10 18:27:01-04:00,22190,CPsnF5SkVCnFkFXhLwzpp6H7rBrTumCuYJCyVSeT8cFZ,BMV1AyAxyTuXTfwddphdRc3nwbySVbhqUZau8oatdTEJ,True,28288106,2475692,10123,5061,5062,Hu94aiQWvce6THeGyCFqGRPM1pQrK3ihzkcXo1EpJcJL,1156727,22051258,-20894531,408
2022-05-10 18:31:23-04:00,22191,CPsnF5SkVCnFkFXhLwzpp6H7rBrTumCuYJCyVSeT8cFZ,BMV1AyAxyTuXTfwddphdRc3nwbySVbhqUZau8oatdTEJ,False,25552029,25552029,935082,46754,888328,2a35JJeTUW1pm6M3e8DHCjp8qr4vbc2cRPhuzZWyFzYd,935083,13905508,-12970425,365
2022-05-10 18:35:35-04:00,22192,8YuVG1zMmMSPmiM62AphS86zuHattfr4QdPYUaSiWx95,9qeLiZqeLWASGUJaUWyKD7WLMXPtc5APAdAsmBLPTUr8,True,25548828,1841381,8099,4049,4050,6L1WYrPiCMyi7XemPww4B4hvpKD1LQKD4RpiSKmrmgSC,1123799,26825117,-25701318,439
2022-05-10 18:36:02-04:00,22193,5Rz9eK3UmttggdNZh5AgfbemJ5oUYeYkqynrhLg5gu2s,5jTR13yaQ4BTr44xdnZzwdTeMetGpirWHDjn8epGYvf6,True,1794864133,248644248,1530328,765164,765164,AmTrMPzuTp2BjnjqGNKqz9FTTCdpoKcPAJLwFc8ozcbh,110468382,5114406724,-5003938342,615
2022-05-10 18:39:03-04:00,22194,An9PgoB3s9T3TVC9vipP27wsPR9aZx8xPn7R6AbXojDa,2aoxARd4dXzvZ1uQpm8oETBLUF3JqzVU3Ek9LDH6ckWv,True,35980222842,4610148443,27405447,13702723,13702724,4yhyLx1phodwcvvwVU2bramHcdbJYvfadd7pANsRzX8M,2138877134,13971572302,-11832695168,594
2022-05-10 18:39:34-04:00,22195,8YuVG1zMmMSPmiM62AphS86zuHattfr4QdPYUaSiWx95,9qeLiZqeLWASGUJaUWyKD7WLMXPtc5APAdAsmBLPTUr8,True,23595899,3644892,15510,7755,7755,6L1WYrPiCMyi7XemPww4B4hvpKD1LQKD4RpiSKmrmgSC,1004152,25845893,-24841741,425
2022-05-10 18:39:45-04:00,22196,5Rz9eK3UmttggdNZh5AgfbemJ5oUYeYkqynrhLg5gu2s,5jTR13yaQ4BTr44xdnZzwdTeMetGpirWHDjn8epGYvf6,True,1527527379,196227270,1159300,579650,579650,68sueyVfmy5ToEGtLFGDkwebX47xAmzyXE29z8JrmcWv,90245548,4556587412,-4466341864,590
2022-05-10 18:40:34-04:00,22197,5Rz9eK3UmttggdNZh5AgfbemJ5oUYeYkqynrhLg5gu2s,5jTR13yaQ4BTr44xdnZzwdTeMetGpirWHDjn8epGYvf6,True,1324534038,185572672,1153339,576669,576670,6UQfSsLooL4pQKQfLtXCutQS2BnF7A7F7ewJopDLmUpc,82320177,3857004784,-3774684607,621
2022-05-10 18:41:27-04:00,22198,8YuVG1zMmMSPmiM62AphS86zuHattfr4QdPYUaSiWx95,9qeLiZqeLWASGUJaUWyKD7WLMXPtc5APAdAsmBLPTUr8,False,19834325,19834325,871958,43597,828361,6L1WYrPiCMyi7XemPww4B4hvpKD1LQKD4RpiSKmrmgSC,871960,24475265,-23603305,439
2022-05-10 18:41:34-04:00,22199,An9PgoB3s9T3TVC9vipP27wsPR9aZx8xPn7R6AbXojDa,2aoxARd4dXzvZ1uQpm8oETBLUF3JqzVU3Ek9LDH6ckWv,True,31118035851,3459383109,20671264,10335632,10335632,Hu94aiQWvce6THeGyCFqGRPM1pQrK3ihzkcXo1EpJcJL,1859433139,12739513287,-10880080148,597
2022-05-10 18:41:42-04:00,22200,5Rz9eK3UmttggdNZh5AgfbemJ5oUYeYkqynrhLg5gu2s,5jTR13yaQ4BTr44xdnZzwdTeMetGpirWHDjn8epGYvf6,True,1127776510,142764623,885897,442948,442949,DQCvC9mR68hJ3tJsUiddh6JwcBJAmntqGJR2nUsEq7yj,69981982,3437692506,-3367710524,620
2022-05-10 18:49:45-04:00,22201,9eWpSyu71Z6dmx7yTh7WrbVScdrrZN14d5tfmqEGFgXt,2r89PFKSD9zmSp2Wyx4CQ75HAtmUgwhAS2oG5MuYuiV6,True,33997330,2860195,11741,5870,5871,2a35JJeTUW1pm6M3e8DHCjp8qr4vbc2cRPhuzZWyFzYd,1395629,20630060,-19234431,410
2022-05-10 18:57:05-04:00,22202,B5Wb8KEmcm3rSG1pwpjNmNwUt6WZuveKurj5PZS283AF,HVMupm6S9jHMWw5njG7G4XW1kVeDmVgbkgrrNwHdcJRa,True,5152846882,1288211720,8533747,4266873,4266874,gjBMZYVujDjD1ECG4i97M8Q3gV9ESnwwTSUGropkusj,341349885,642564638,-301214753,662
2022-05-10 18:57:17-04:00,22203,HCDFVikyKGu5sBCobAo2gKX6syJbtsQ7QBuxvs4QX6ni,FbpP4HVgkjjzogfJn8NNSk7yAeVYgafNf12kqVKkmJrw,True,3248241460,812060365,4730397,2365198,2365199,6L1WYrPiCMyi7XemPww4B4hvpKD1LQKD4RpiSKmrmgSC,189215895,311704918,-122489023,582
2022-05-10 18:57:47-04:00,22204,HCDFVikyKGu5sBCobAo2gKX6syJbtsQ7QBuxvs4QX6ni,FbpP4HVgkjjzogfJn8NNSk7yAeVYgafNf12kqVKkmJrw,True,2480037882,620009470,3515717,1757858,1757859,C4UnXuShCvjSMgBAgVNMy1oakxCNk1et27A82fywU112,140628711,276510785,-135882074,567
2022-05-10 19:05:00-04:00,22205,HCDFVikyKGu5sBCobAo2gKX6syJbtsQ7QBuxvs4QX6ni,FbpP4HVgkjjzogfJn8NNSk7yAeVYgafNf12kqVKkmJrw,True,1896729820,474182455,2572704,1286352,1286352,DQCvC9mR68hJ3tJsUiddh6JwcBJAmntqGJR2nUsEq7yj,102908177,241611096,-138702919,542
2022-05-10 19:05:29-04:00,22206,HCDFVikyKGu5sBCobAo2gKX6syJbtsQ7QBuxvs4QX6ni,FbpP4HVgkjjzogfJn8NNSk7yAeVYgafNf12kqVKkmJrw,True,1442049702,360512425,2020828,1010414,1010414,DQCvC9mR68hJ3tJsUiddh6JwcBJAmntqGJR2nUsEq7yj,80833136,204413754,-123580618,560
2022-05-10 19:05:37-04:00,22207,B5Wb8KEmcm3rSG1pwpjNmNwUt6WZuveKurj5PZS283AF,HVMupm6S9jHMWw5njG7G4XW1kVeDmVgbkgrrNwHdcJRa,True,3928067432,982016858,6753516,3376758,3376758,2xTUy2RS74GJMMDnmFaegMzFLn19RVfYG4CibhBmjP1i,270140650,561516850,-291376200,687
2022-05-10 19:10:21-04:00,22208,HCDFVikyKGu5sBCobAo2gKX6syJbtsQ7QBuxvs4QX6ni,FbpP4HVgkjjzogfJn8NNSk7yAeVYgafNf12kqVKkmJrw,True,1103181890,275795472,1429192,714596,714596,DQCvC9mR68hJ3tJsUiddh6JwcBJAmntqGJR2nUsEq7yj,57167695,171526705,-114359010,518
2022-05-10 19:10:26-04:00,22209,98EU6xz94j8Hn2xDNB9LdUtZBSxEmKu6pxhRpC9E4v5v,Hn62HqTJg42gHoEcBRE6raaijqCEk2TNToMNubKAsxpV,True,1767987735,441996933,1277184,638592,638592,6UQfSsLooL4pQKQfLtXCutQS2BnF7A7F7ewJopDLmUpc,51087379,86435360,-35347981,288
2022-05-10 19:12:37-04:00,22210,EZHGiQNgEW2KKP2sy7ZsTK5i9m3rZJanVnKgJEzVEjfR,G1kbBYxXwc31PEoMMTC6jT2vzo1HqtMEdxT9B76DW5qB,False,6247126,6247126,432289,21614,410675,2a35JJeTUW1pm6M3e8DHCjp8qr4vbc2cRPhuzZWyFzYd,432289,640860,-208571,691
2022-05-10 19:13:02-04:00,22211,CFxQJ46pCtCLMzhjVnVZU346FkpqbJXXQR7CqvhDsUnJ,BuDNCmcsAfZgh3qUhuwewSMAx6HZcucdSau2wVYDoiX3,True,769133059,192283264,1023742,511871,511871,Hu94aiQWvce6THeGyCFqGRPM1pQrK3ihzkcXo1EpJcJL,40949758,67365373,-26415615,532
2022-05-10 19:13:03-04:00,22212,HCDFVikyKGu5sBCobAo2gKX6syJbtsQ7QBuxvs4QX6ni,FbpP4HVgkjjzogfJn8NNSk7yAeVYgafNf12kqVKkmJrw,False,853181446,853181446,29943475,1497173,28446302,8sEswn3kzEhnYjAZVvCQnHEUvYd7pFVvc2Xc2Kd1BpbC,29943475,141524197,-111580722,350
2022-05-10 20:20:44-04:00,22213,98EU6xz94j8Hn2xDNB9LdUtZBSxEmKu6pxhRpC9E4v5v,Hn62HqTJg42gHoEcBRE6raaijqCEk2TNToMNubKAsxpV,True,1336052786,334013196,997191,498595,498596,2xTUy2RS74GJMMDnmFaegMzFLn19RVfYG4CibhBmjP1i,39887651,76489107,-36601456,298
2022-05-10 20:20:48-04:00,22214,8uZhgcgTGB3fDBZdiNkp7oMGys2bBoiTzWyYwrmKKC3U,5cVp8ogiZsS7x8TWCAqihMQiNNxLqi3xVYQ4TkhHPsjS,True,110409353,27185431,82504,41252,41252,8sEswn3kzEhnYjAZVvCQnHEUvYd7pFVvc2Xc2Kd1BpbC,3350833,5297719,-1946886,303
2022-05-10 20:22:17-04:00,22215,98EU6xz94j8Hn2xDNB9LdUtZBSxEmKu6pxhRpC9E4v5v,Hn62HqTJg42gHoEcBRE6raaijqCEk2TNToMNubKAsxpV,True,1010472553,252618138,761437,380718,380719,2a35JJeTUW1pm6M3e8DHCjp8qr4vbc2cRPhuzZWyFzYd,30457497,66357636,-35900139,301
2022-05-10 20:23:09-04:00,22216,DmwHBt9RS9QZesz2k6NsiC9CXCvgaGSTWycWj8nCdkC6,EEN2iGeHGY9AbsrBTgs9CFNTfdiGWymzt6VGto8ZGyfF,True,7873314011,1968328502,12064998,6032499,6032499,2a35JJeTUW1pm6M3e8DHCjp8qr4vbc2cRPhuzZWyFzYd,482599948,921852437,-439252489,612
2022-05-10 20:23:19-04:00,22217,8uZhgcgTGB3fDBZdiNkp7oMGys2bBoiTzWyYwrmKKC3U,5cVp8ogiZsS7x8TWCAqihMQiNNxLqi3xVYQ4TkhHPsjS,True,83928170,20560898,62815,31407,31408,6L1WYrPiCMyi7XemPww4B4hvpKD1LQKD4RpiSKmrmgSC,2564081,4563132,-1999051,305
2022-05-10 20:25:34-04:00,22218,DmwHBt9RS9QZesz2k6NsiC9CXCvgaGSTWycWj8nCdkC6,EEN2iGeHGY9AbsrBTgs9CFNTfdiGWymzt6VGto8ZGyfF,True,6008145287,1502036321,9184379,4592189,4592190,DA18qE9qesbBqpwNv1M4befYcNQkbSBSeLPTmQzrmbJw,367375172,800820797,-433445625,611
2022-05-10 20:36:33-04:00,22219,DmwHBt9RS9QZesz2k6NsiC9CXCvgaGSTWycWj8nCdkC6,EEN2iGeHGY9AbsrBTgs9CFNTfdiGWymzt6VGto8ZGyfF,True,4578200185,1144550046,7152489,3576244,3576245,6UQfSsLooL4pQKQfLtXCutQS2BnF7A7F7ewJopDLmUpc,286099574,683755171,-397655597,624
2022-05-10 20:48:02-04:00,22220,8RCYYywQdAWrQjP5V9hHpc5a9nJn9BYZ1p7rySRSjrp9,FBg1YzFa8uFgqbDXtnuSrBc1yvAoReT7Xp9yXkBkEVUC,True,67139588,16784897,102234,51117,51117,2a35JJeTUW1pm6M3e8DHCjp8qr4vbc2cRPhuzZWyFzYd,4089386,6930020,-2840634,609
2022-05-10 20:51:17-04:00,22221,6fqbSyhh3PPdgRcLraHb7Jahj9s1oHHeX3SsjNSsGa6t,GpRUow48TYgttdYfsygbgjYQcmHyYjWETUDjDVphEgwq,True,8503991984,2125997996,13022983,6511491,6511492,4yhyLx1phodwcvvwVU2bramHcdbJYvfadd7pANsRzX8M,520919327,984032895,-463113568,612
2022-05-10 20:58:27-04:00,22222,8RCYYywQdAWrQjP5V9hHpc5a9nJn9BYZ1p7rySRSjrp9,FBg1YzFa8uFgqbDXtnuSrBc1yvAoReT7Xp9yXkBkEVUC,True,49457956,12364489,77260,38630,38630,5HnvdJnCCcmRsm4GkXnYWd4q9RpwuvYDGEUMPkYR3Ts9,3090417,6117697,-3027280,624
2022-05-10 21:00:03-04:00,22223,6fqbSyhh3PPdgRcLraHb7Jahj9s1oHHeX3SsjNSsGa6t,GpRUow48TYgttdYfsygbgjYQcmHyYjWETUDjDVphEgwq,True,6266934903,1566733725,9725087,4862543,4862544,DA18qE9qesbBqpwNv1M4befYcNQkbSBSeLPTmQzrmbJw,389003489,848514260,-459510771,620
2022-05-10 21:01:00-04:00,22224,8RCYYywQdAWrQjP5V9hHpc5a9nJn9BYZ1p7rySRSjrp9,FBg1YzFa8uFgqbDXtnuSrBc1yvAoReT7Xp9yXkBkEVUC,True,36353094,9088273,55672,27836,27836,Hu94aiQWvce6THeGyCFqGRPM1pQrK3ihzkcXo1EpJcJL,2226908,5237780,-3010872,612
2022-05-10 21:09:35-04:00,22225,6fqbSyhh3PPdgRcLraHb7Jahj9s1oHHeX3SsjNSsGa6t,GpRUow48TYgttdYfsygbgjYQcmHyYjWETUDjDVphEgwq,True,4607588012,1151897003,7166630,3583315,3583315,2a35JJeTUW1pm6M3e8DHCjp8qr4vbc2cRPhuzZWyFzYd,286665236,724534207,-437868971,622
2022-05-10 21:14:42-04:00,22226,6fqbSyhh3PPdgRcLraHb7Jahj9s1oHHeX3SsjNSsGa6t,GpRUow48TYgttdYfsygbgjYQcmHyYjWETUDjDVphEgwq,True,3387677387,846919346,5287124,2643562,2643562,4yhyLx1phodwcvvwVU2bramHcdbJYvfadd7pANsRzX8M,211484984,608247225,-396762241,624
2022-05-10 21:21:30-04:00,22227,6fqbSyhh3PPdgRcLraHb7Jahj9s1oHHeX3SsjNSsGa6t,GpRUow48TYgttdYfsygbgjYQcmHyYjWETUDjDVphEgwq,True,2487501773,621875443,3823539,1911769,1911770,5HnvdJnCCcmRsm4GkXnYWd4q9RpwuvYDGEUMPkYR3Ts9,152941592,503962769,-351021177,614
2022-05-10 21:34:31-04:00,22228,GMpoV2jRyLdf2V3Gb5TQZ5gEs5ftMjD3JhFUzkA6fWVz,5bi814d5gdToTLVWCmbdB6J15kMdsTQk74cZTRd62p81,True,21011030,5252757,37185,18592,18593,Hu94aiQWvce6THeGyCFqGRPM1pQrK3ihzkcXo1EpJcJL,1487419,12291823,-10804404,707
2022-05-10 21:34:39-04:00,22229,6fqbSyhh3PPdgRcLraHb7Jahj9s1oHHeX3SsjNSsGa6t,GpRUow48TYgttdYfsygbgjYQcmHyYjWETUDjDVphEgwq,True,1829824848,457456212,2832914,1416457,1416457,DQCvC9mR68hJ3tJsUiddh6JwcBJAmntqGJR2nUsEq7yj,113316571,412491495,-299174924,619
2022-05-10 21:45:25-04:00,22230,6fqbSyhh3PPdgRcLraHb7Jahj9s1oHHeX3SsjNSsGa6t,GpRUow48TYgttdYfsygbgjYQcmHyYjWETUDjDVphEgwq,True,1342666266,335666566,2019532,1009766,1009766,8HQmsTbxhLhy25fvfCb16HudTGQ9wkHoEBRz5WYeqiZw,80781287,334924774,-254143487,601
2022-05-10 21:48:56-04:00,22231,6fqbSyhh3PPdgRcLraHb7Jahj9s1oHHeX3SsjNSsGa6t,GpRUow48TYgttdYfsygbgjYQcmHyYjWETUDjDVphEgwq,True,989961807,247490451,1543096,771548,771548,DA18qE9qesbBqpwNv1M4befYcNQkbSBSeLPTmQzrmbJw,61723862,269402713,-207678851,623
2022-05-10 21:50:07-04:00,22232,29JVska5UEG3axs63EmtHpPvkswNEqYpZ3PKMSfupiAG,DCftNBUsuogxyaJe9G9m3eWipH6o3qo4Rn4TuQXdVaBF,True,93182539,23295634,70511,35255,35256,6L1WYrPiCMyi7XemPww4B4hvpKD1LQKD4RpiSKmrmgSC,2820473,4869380,-2048907,302
2022-05-10 22:00:05-04:00,22233,6fqbSyhh3PPdgRcLraHb7Jahj9s1oHHeX3SsjNSsGa6t,GpRUow48TYgttdYfsygbgjYQcmHyYjWETUDjDVphEgwq,True,728185992,182046498,1123360,561680,561680,A2p75MbAbeUdHkPLkAjgGeiwuu9WPrkMHzjCkDXF1Xr3,44934406,214997506,-170063100,617
2022-05-10 22:00:22-04:00,22234,9MSygCP2RKyYEK4xdCtASEGgnfuJYgcg48khe7oQuxfW,75zERuqSUGCy56S8TURMEhCwjpyMzPrMbGZdFHCoAvnS,True,8535542569,2133885642,13185834,6592917,6592917,5HnvdJnCCcmRsm4GkXnYWd4q9RpwuvYDGEUMPkYR3Ts9,527433368,1966453308,-1439019940,617
2022-05-10 22:01:20-04:00,22235,uFQBu1UoyNJBRpZCa5hTGW6Djv8658FXSZHVGDzox7A,4Rs1ZoK5GodHWQDZhXzk1o8zbujDDBLGszct1bXYWr5s,True,1126886150,116919642,491732,245866,245866,5HnvdJnCCcmRsm4GkXnYWd4q9RpwuvYDGEUMPkYR3Ts9,47393804,474520159,-427126355,420
2022-05-10 22:02:27-04:00,22236,DbhYDjULmvytv9CD9absZq9VABwNkBy3y6ugnQN7RdVD,73NGUFBEAToVdoVP52fDihvDtKE7N2VPJfbbXw4vysSD,True,621091348,155272837,1078896,539448,539448,5HnvdJnCCcmRsm4GkXnYWd4q9RpwuvYDGEUMPkYR3Ts9,43155849,70064500,-26908651,694
2022-05-10 22:03:08-04:00,22237,6fqbSyhh3PPdgRcLraHb7Jahj9s1oHHeX3SsjNSsGa6t,GpRUow48TYgttdYfsygbgjYQcmHyYjWETUDjDVphEgwq,True,535367278,133841819,825970,412985,412985,6L1WYrPiCMyi7XemPww4B4hvpKD1LQKD4RpiSKmrmgSC,33038830,171368731,-138329901,617
2022-05-10 22:03:31-04:00,22238,9MSygCP2RKyYEK4xdCtASEGgnfuJYgcg48khe7oQuxfW,75zERuqSUGCy56S8TURMEhCwjpyMzPrMbGZdFHCoAvnS,True,6270142247,1567535561,9568321,4784160,4784161,gjBMZYVujDjD1ECG4i97M8Q3gV9ESnwwTSUGropkusj,382732854,1594862233,-1212129379,610
2022-05-10 22:04:09-04:00,22239,uFQBu1UoyNJBRpZCa5hTGW6Djv8658FXSZHVGDzox7A,4Rs1ZoK5GodHWQDZhXzk1o8zbujDDBLGszct1bXYWr5s,True,997258885,85328575,348416,174208,174208,5HnvdJnCCcmRsm4GkXnYWd4q9RpwuvYDGEUMPkYR3Ts9,40720441,364100301,-323379860,408
2022-05-10 22:04:13-04:00,22240,6fqbSyhh3PPdgRcLraHb7Jahj9s1oHHeX3SsjNSsGa6t,GpRUow48TYgttdYfsygbgjYQcmHyYjWETUDjDVphEgwq,True,393715754,98428938,610078,305039,305039,A2p75MbAbeUdHkPLkAjgGeiwuu9WPrkMHzjCkDXF1Xr3,24403155,135966056,-111562901,619
2022-05-10 22:04:35-04:00,22241,9MSygCP2RKyYEK4xdCtASEGgnfuJYgcg48khe7oQuxfW,75zERuqSUGCy56S8TURMEhCwjpyMzPrMbGZdFHCoAvnS,True,4617930045,1154482511,7212197,3606098,3606099,72XWPCtRYEDZbddP7d6dHtUBRRDLSJsB2xZTAfefoEVZ,288487892,1283013198,-994525306,624
2022-05-10 22:08:18-04:00,22242,uFQBu1UoyNJBRpZCa5hTGW6Djv8658FXSZHVGDzox7A,4Rs1ZoK5GodHWQDZhXzk1o8zbujDDBLGszct1bXYWr5s,True,913362878,164776096,640169,320084,320085,C4UnXuShCvjSMgBAgVNMy1oakxCNk1et27A82fywU112,35484991,278941626,-243456635,388
2022-05-10 22:25:06-04:00,22243,DmwHBt9RS9QZesz2k6NsiC9CXCvgaGSTWycWj8nCdkC6,EEN2iGeHGY9AbsrBTgs9CFNTfdiGWymzt6VGto8ZGyfF,True,9013781245,2253445311,13791757,6895878,6895879,GXyFXZMNk2NFyEzw6JetVqsujqcz2yCixH7n8EpDJYWD,551670300,889351712,-337681412,612
2022-05-10 22:29:59-04:00,22244,uFQBu1UoyNJBRpZCa5hTGW6Djv8658FXSZHVGDzox7A,4Rs1ZoK5GodHWQDZhXzk1o8zbujDDBLGszct1bXYWr5s,True,773194922,66262216,272672,136336,136336,A2p75MbAbeUdHkPLkAjgGeiwuu9WPrkMHzjCkDXF1Xr3,31817426,281484704,-249667278,411
2022-05-10 22:31:38-04:00,22245,DmwHBt9RS9QZesz2k6NsiC9CXCvgaGSTWycWj8nCdkC6,EEN2iGeHGY9AbsrBTgs9CFNTfdiGWymzt6VGto8ZGyfF,True,6893171244,1723292811,10126080,5063040,5063040,5HnvdJnCCcmRsm4GkXnYWd4q9RpwuvYDGEUMPkYR3Ts9,405043233,792379565,-387336332,587
2022-05-10 22:37:05-04:00,22246,uFQBu1UoyNJBRpZCa5hTGW6Djv8658FXSZHVGDzox7A,4Rs1ZoK5GodHWQDZhXzk1o8zbujDDBLGszct1bXYWr5s,True,700374373,126762728,491878,245939,245939,AmTrMPzuTp2BjnjqGNKqz9FTTCdpoKcPAJLwFc8ozcbh,27176709,219868518,-192691809,388
2022-05-10 22:44:20-04:00,22247,uFQBu1UoyNJBRpZCa5hTGW6Djv8658FXSZHVGDzox7A,4Rs1ZoK5GodHWQDZhXzk1o8zbujDDBLGszct1bXYWr5s,True,572822161,47809707,194511,97255,97256,A9TwRM1BMxqb8DCC7YNAMV6zPenEJm3HTZBy7wJKK58U,23305051,218581633,-195276582,406
2022-05-10 22:46:01-04:00,22248,9MSygCP2RKyYEK4xdCtASEGgnfuJYgcg48khe7oQuxfW,75zERuqSUGCy56S8TURMEhCwjpyMzPrMbGZdFHCoAvnS,True,3381077511,845269377,4972641,2486320,2486321,C4UnXuShCvjSMgBAgVNMy1oakxCNk1et27A82fywU112,198905672,1027588742,-828683070,588
2022-05-10 22:46:03-04:00,22249,6fqbSyhh3PPdgRcLraHb7Jahj9s1oHHeX3SsjNSsGa6t,GpRUow48TYgttdYfsygbgjYQcmHyYjWETUDjDVphEgwq,True,287733252,71933313,405987,202993,202994,5HnvdJnCCcmRsm4GkXnYWd4q9RpwuvYDGEUMPkYR3Ts9,16239513,107468467,-91228954,564
2022-05-10 22:46:08-04:00,22250,5tW54mXQxtM7vGc91HrDeDtWkxJeH2uM4yAviqZnMZCN,7Kg5Zwx5afFdLbTifeyKJLSNVj2p9Xf5anbbqQozNzmY,True,155786877,38946719,206349,103174,103175,5HnvdJnCCcmRsm4GkXnYWd4q9RpwuvYDGEUMPkYR3Ts9,8253996,37806442,-29552446,529
2022-05-10 23:23:57-04:00,22251,5tW54mXQxtM7vGc91HrDeDtWkxJeH2uM4yAviqZnMZCN,7Kg5Zwx5afFdLbTifeyKJLSNVj2p9Xf5anbbqQozNzmY,True,116206548,29051637,181489,90744,90745,68sueyVfmy5ToEGtLFGDkwebX47xAmzyXE29z8JrmcWv,7259597,30058015,-22798418,624
2022-05-10 23:24:31-04:00,22252,6fqbSyhh3PPdgRcLraHb7Jahj9s1oHHeX3SsjNSsGa6t,GpRUow48TYgttdYfsygbgjYQcmHyYjWETUDjDVphEgwq,True,213389479,53347369,328445,164222,164223,5HnvdJnCCcmRsm4GkXnYWd4q9RpwuvYDGEUMPkYR3Ts9,13137824,83971785,-70833961,615
2022-05-10 23:28:04-04:00,22253,9MSygCP2RKyYEK4xdCtASEGgnfuJYgcg48khe7oQuxfW,75zERuqSUGCy56S8TURMEhCwjpyMzPrMbGZdFHCoAvnS,True,2500086310,625021577,3871469,1935734,1935735,C4UnXuShCvjSMgBAgVNMy1oakxCNk1et27A82fywU112,154858764,812325837,-657467073,619
2022-05-10 23:28:51-04:00,22254,5tW54mXQxtM7vGc91HrDeDtWkxJeH2uM4yAviqZnMZCN,7Kg5Zwx5afFdLbTifeyKJLSNVj2p9Xf5anbbqQozNzmY,True,85412771,21353192,133399,66699,66700,5HnvdJnCCcmRsm4GkXnYWd4q9RpwuvYDGEUMPkYR3Ts9,5335968,24177187,-18841219,624
2022-05-10 23:29:56-04:00,22255,uFQBu1UoyNJBRpZCa5hTGW6Djv8658FXSZHVGDzox7A,4Rs1ZoK5GodHWQDZhXzk1o8zbujDDBLGszct1bXYWr5s,True,513341563,94343317,362088,181044,181044,5HnvdJnCCcmRsm4GkXnYWd4q9RpwuvYDGEUMPkYR3Ts9,19702015,170333809,-150631794,383
2022-05-10 23:31:18-04:00,22256,6fqbSyhh3PPdgRcLraHb7Jahj9s1oHHeX3SsjNSsGa6t,GpRUow48TYgttdYfsygbgjYQcmHyYjWETUDjDVphEgwq,True,157039704,39259926,245174,122587,122587,5HnvdJnCCcmRsm4GkXnYWd4q9RpwuvYDGEUMPkYR3Ts9,9806973,65935849,-56128876,624
2022-05-10 23:40:37-04:00,22257,5Rz9eK3UmttggdNZh5AgfbemJ5oUYeYkqynrhLg5gu2s,5jTR13yaQ4BTr44xdnZzwdTeMetGpirWHDjn8epGYvf6,True,981291520,144821763,905023,452511,452512,A2p75MbAbeUdHkPLkAjgGeiwuu9WPrkMHzjCkDXF1Xr3,61323083,2904510766,-2843187683,624
2022-05-10 23:40:49-04:00,22258,9MSygCP2RKyYEK4xdCtASEGgnfuJYgcg48khe7oQuxfW,75zERuqSUGCy56S8TURMEhCwjpyMzPrMbGZdFHCoAvnS,True,1838662716,459665679,2864631,1432315,1432316,5HnvdJnCCcmRsm4GkXnYWd4q9RpwuvYDGEUMPkYR3Ts9,114585278,644217723,-529632445,623
2022-05-10 23:52:45-04:00,22259,5tW54mXQxtM7vGc91HrDeDtWkxJeH2uM4yAviqZnMZCN,7Kg5Zwx5afFdLbTifeyKJLSNVj2p9Xf5anbbqQozNzmY,True,62761934,15690483,97623,48811,48812,5HnvdJnCCcmRsm4GkXnYWd4q9RpwuvYDGEUMPkYR3Ts9,3904924,19333632,-15428708,622
2022-05-10 23:55:58-04:00,22260,5Rz9eK3UmttggdNZh5AgfbemJ5oUYeYkqynrhLg5gu2s,5jTR13yaQ4BTr44xdnZzwdTeMetGpirWHDjn8epGYvf6,True,827148210,108271573,668839,334419,334420,5HnvdJnCCcmRsm4GkXnYWd4q9RpwuvYDGEUMPkYR3Ts9,51096513,2595611531,-2544515018,617
2022-05-10 23:55:58-04:00,22261,6fqbSyhh3PPdgRcLraHb7Jahj9s1oHHeX3SsjNSsGa6t,GpRUow48TYgttdYfsygbgjYQcmHyYjWETUDjDVphEgwq,True,115216803,28804200,174970,87485,87485,68sueyVfmy5ToEGtLFGDkwebX47xAmzyXE29z8JrmcWv,6998824,51659013,-44660189,607
2022-05-11 00:03:36-04:00,22262,9MSygCP2RKyYEK4xdCtASEGgnfuJYgcg48khe7oQuxfW,75zERuqSUGCy56S8TURMEhCwjpyMzPrMbGZdFHCoAvnS,True,1352102659,338025664,2076672,1038336,1038336,C4UnXuShCvjSMgBAgVNMy1oakxCNk1et27A82fywU112,83066916,507258116,-424191200,614
2022-05-11 00:10:37-04:00,22263,uFQBu1UoyNJBRpZCa5hTGW6Djv8658FXSZHVGDzox7A,4Rs1ZoK5GodHWQDZhXzk1o8zbujDDBLGszct1bXYWr5s,True,414032503,70453163,283445,141722,141723,68sueyVfmy5ToEGtLFGDkwebX47xAmzyXE29z8JrmcWv,16657271,169951643,-153294372,402
2022-05-11 00:11:28-04:00,22264,5tW54mXQxtM7vGc91HrDeDtWkxJeH2uM4yAviqZnMZCN,7Kg5Zwx5afFdLbTifeyKJLSNVj2p9Xf5anbbqQozNzmY,True,46192659,11548164,71693,35846,35847,6L1WYrPiCMyi7XemPww4B4hvpKD1LQKD4RpiSKmrmgSC,2867727,15318133,-12450406,620
2022-05-11 00:12:01-04:00,22265,5Rz9eK3UmttggdNZh5AgfbemJ5oUYeYkqynrhLg5gu2s,5jTR13yaQ4BTr44xdnZzwdTeMetGpirWHDjn8epGYvf6,True,713647763,96878444,605312,302656,302656,5HnvdJnCCcmRsm4GkXnYWd4q9RpwuvYDGEUMPkYR3Ts9,44589938,2362983228,-2318393290,624
2022-05-11 00:12:06-04:00,22266,6fqbSyhh3PPdgRcLraHb7Jahj9s1oHHeX3SsjNSsGa6t,GpRUow48TYgttdYfsygbgjYQcmHyYjWETUDjDVphEgwq,True,84972218,21243054,131780,65890,65890,C4UnXuShCvjSMgBAgVNMy1oakxCNk1et27A82fywU112,5271208,40207045,-34935837,620
2022-05-11 00:12:40-04:00,22267,9MSygCP2RKyYEK4xdCtASEGgnfuJYgcg48khe7oQuxfW,75zERuqSUGCy56S8TURMEhCwjpyMzPrMbGZdFHCoAvnS,True,995110679,248777669,1550598,775299,775299,6L1WYrPiCMyi7XemPww4B4hvpKD1LQKD4RpiSKmrmgSC,62023928,399174022,-337150094,623
2022-05-11 00:13:51-04:00,22268,5Rz9eK3UmttggdNZh5AgfbemJ5oUYeYkqynrhLg5gu2s,5jTR13yaQ4BTr44xdnZzwdTeMetGpirWHDjn8epGYvf6,True,610959991,81020122,506246,253123,253123,5HnvdJnCCcmRsm4GkXnYWd4q9RpwuvYDGEUMPkYR3Ts9,38175298,1955989006,-1917813708,624
2022-05-11 00:14:34-04:00,22269,5tW54mXQxtM7vGc91HrDeDtWkxJeH2uM4yAviqZnMZCN,7Kg5Zwx5afFdLbTifeyKJLSNVj2p9Xf5anbbqQozNzmY,True,33956259,8489064,52694,26347,26347,5HnvdJnCCcmRsm4GkXnYWd4q9RpwuvYDGEUMPkYR3Ts9,2107798,12133885,-10026087,620
2022-05-11 00:14:55-04:00,22270,6fqbSyhh3PPdgRcLraHb7Jahj9s1oHHeX3SsjNSsGa6t,GpRUow48TYgttdYfsygbgjYQcmHyYjWETUDjDVphEgwq,True,62403109,15600777,95334,47667,47667,68sueyVfmy5ToEGtLFGDkwebX47xAmzyXE29z8JrmcWv,3813373,31341479,-27528106,611
2022-05-11 00:15:44-04:00,22271,uFQBu1UoyNJBRpZCa5hTGW6Djv8658FXSZHVGDzox7A,4Rs1ZoK5GodHWQDZhXzk1o8zbujDDBLGszct1bXYWr5s,True,337049562,31959795,134099,67049,67050,5HnvdJnCCcmRsm4GkXnYWd4q9RpwuvYDGEUMPkYR3Ts9,14142268,170070517,-155928249,419
2022-05-11 00:16:08-04:00,22272,9MSygCP2RKyYEK4xdCtASEGgnfuJYgcg48khe7oQuxfW,75zERuqSUGCy56S8TURMEhCwjpyMzPrMbGZdFHCoAvnS,True,728548641,182137160,1067224,533612,533612,DA18qE9qesbBqpwNv1M4befYcNQkbSBSeLPTmQzrmbJw,42688961,313358402,-270669441,585
2022-05-11 00:17:05-04:00,22273,5Rz9eK3UmttggdNZh5AgfbemJ5oUYeYkqynrhLg5gu2s,5jTR13yaQ4BTr44xdnZzwdTeMetGpirWHDjn8epGYvf6,True,524180289,70301068,427957,213978,213979,6L1WYrPiCMyi7XemPww4B4hvpKD1LQKD4RpiSKmrmgSC,31909472,1781780532,-1749871060,608
2022-05-11 00:18:14-04:00,22274,5tW54mXQxtM7vGc91HrDeDtWkxJeH2uM4yAviqZnMZCN,7Kg5Zwx5afFdLbTifeyKJLSNVj2p9Xf5anbbqQozNzmY,True,24969356,6242339,38931,19465,19466,68sueyVfmy5ToEGtLFGDkwebX47xAmzyXE29z8JrmcWv,1557265,9574696,-8017431,623
2022-05-11 00:18:43-04:00,22275,6fqbSyhh3PPdgRcLraHb7Jahj9s1oHHeX3SsjNSsGa6t,GpRUow48TYgttdYfsygbgjYQcmHyYjWETUDjDVphEgwq,True,45933437,11483359,71228,35614,35614,5HnvdJnCCcmRsm4GkXnYWd4q9RpwuvYDGEUMPkYR3Ts9,2849144,24364215,-21515071,620
2022-05-11 00:18:43-04:00,22276,uFQBu1UoyNJBRpZCa5hTGW6Djv8658FXSZHVGDzox7A,4Rs1ZoK5GodHWQDZhXzk1o8zbujDDBLGszct1bXYWr5s,True,303686866,52356321,209907,104953,104954,6L1WYrPiCMyi7XemPww4B4hvpKD1LQKD4RpiSKmrmgSC,12175454,130116713,-117941259,400
2022-05-11 00:19:07-04:00,22277,9MSygCP2RKyYEK4xdCtASEGgnfuJYgcg48khe7oQuxfW,75zERuqSUGCy56S8TURMEhCwjpyMzPrMbGZdFHCoAvnS,True,537718851,134429712,823227,411613,411614,DQCvC9mR68hJ3tJsUiddh6JwcBJAmntqGJR2nUsEq7yj,32929107,244636323,-211707216,612
2022-05-11 00:19:08-04:00,22278,5Rz9eK3UmttggdNZh5AgfbemJ5oUYeYkqynrhLg5gu2s,5jTR13yaQ4BTr44xdnZzwdTeMetGpirWHDjn8epGYvf6,True,450448852,60458321,376496,188248,188248,68sueyVfmy5ToEGtLFGDkwebX47xAmzyXE29z8JrmcWv,28051146,1474197224,-1446146078,622
2022-05-11 00:19:39-04:00,22279,DbhYDjULmvytv9CD9absZq9VABwNkBy3y6ugnQN7RdVD,73NGUFBEAToVdoVP52fDihvDtKE7N2VPJfbbXw4vysSD,True,328443199,82110799,509445,254722,254723,3zqXX6kzhkbW3d4TwD2CNjMRwxTbREXySekvq37kfCNk,20377830,52087183,-31709353,620
2022-05-11 00:20:39-04:00,22280,uFQBu1UoyNJBRpZCa5hTGW6Djv8658FXSZHVGDzox7A,4Rs1ZoK5GodHWQDZhXzk1o8zbujDDBLGszct1bXYWr5s,True,250115216,23238325,98153,49076,49077,5HnvdJnCCcmRsm4GkXnYWd4q9RpwuvYDGEUMPkYR3Ts9,10564322,130691768,-120127446,422
2022-05-11 00:21:18-04:00,22281,5tW54mXQxtM7vGc91HrDeDtWkxJeH2uM4yAviqZnMZCN,7Kg5Zwx5afFdLbTifeyKJLSNVj2p9Xf5anbbqQozNzmY,True,18312111,4578027,27585,13792,13793,68sueyVfmy5ToEGtLFGDkwebX47xAmzyXE29z8JrmcWv,1103428,7531422,-6427994,602
2022-05-11 00:21:40-04:00,22282,6fqbSyhh3PPdgRcLraHb7Jahj9s1oHHeX3SsjNSsGa6t,GpRUow48TYgttdYfsygbgjYQcmHyYjWETUDjDVphEgwq,True,33781570,8445392,52735,26367,26368,5HnvdJnCCcmRsm4GkXnYWd4q9RpwuvYDGEUMPkYR3Ts9,2109408,18914273,-16804865,624
2022-05-11 00:21:42-04:00,22283,4LmSt3e3ryXjEzS85QMLvZU6eS7trPbUPWPLNaKoLD4D,4tYBHL2EgdtmKBqVDus2b1DkhYEBoR4yN8FftedHzzzr,True,4367281623,1091820405,6811389,3405694,3405695,GXyFXZMNk2NFyEzw6JetVqsujqcz2yCixH7n8EpDJYWD,272455564,1009768718,-737313154,623
2022-05-11 00:21:47-04:00,22284,5Rz9eK3UmttggdNZh5AgfbemJ5oUYeYkqynrhLg5gu2s,5jTR13yaQ4BTr44xdnZzwdTeMetGpirWHDjn8epGYvf6,True,386326551,51267868,318635,159317,159318,5HnvdJnCCcmRsm4GkXnYWd4q9RpwuvYDGEUMPkYR3Ts9,24010670,1343234064,-1319223394,621
2022-05-11 00:22:04-04:00,22285,9MSygCP2RKyYEK4xdCtASEGgnfuJYgcg48khe7oQuxfW,75zERuqSUGCy56S8TURMEhCwjpyMzPrMbGZdFHCoAvnS,True,395769772,98942443,614662,307331,307331,68sueyVfmy5ToEGtLFGDkwebX47xAmzyXE29z8JrmcWv,24586513,190893271,-166306758,621
2022-05-11 00:22:22-04:00,22286,DbhYDjULmvytv9CD9absZq9VABwNkBy3y6ugnQN7RdVD,73NGUFBEAToVdoVP52fDihvDtKE7N2VPJfbbXw4vysSD,True,241530319,60382579,376657,188328,188329,6L1WYrPiCMyi7XemPww4B4hvpKD1LQKD4RpiSKmrmgSC,15066304,43652453,-28586149,623
2022-05-11 00:23:20-04:00,22287,uFQBu1UoyNJBRpZCa5hTGW6Djv8658FXSZHVGDzox7A,4Rs1ZoK5GodHWQDZhXzk1o8zbujDDBLGszct1bXYWr5s,True,226522682,39420434,157879,78939,78940,68sueyVfmy5ToEGtLFGDkwebX47xAmzyXE29z8JrmcWv,9072312,99997035,-90924723,400
2022-05-11 00:24:29-04:00,22288,5tW54mXQxtM7vGc91HrDeDtWkxJeH2uM4yAviqZnMZCN,7Kg5Zwx5afFdLbTifeyKJLSNVj2p9Xf5anbbqQozNzmY,False,13486136,13486136,827895,41394,786501,C4UnXuShCvjSMgBAgVNMy1oakxCNk1et27A82fywU112,827895,5896847,-5068952,613
2022-05-11 00:24:35-04:00,22289,5Rz9eK3UmttggdNZh5AgfbemJ5oUYeYkqynrhLg5gu2s,5jTR13yaQ4BTr44xdnZzwdTeMetGpirWHDjn8epGYvf6,False,321520644,321520644,10153995,507699,9646296,6L1WYrPiCMyi7XemPww4B4hvpKD1LQKD4RpiSKmrmgSC,10153996,1111087727,-1100933731,315
2022-05-11 00:24:35-04:00,22290,4LmSt3e3ryXjEzS85QMLvZU6eS7trPbUPWPLNaKoLD4D,4tYBHL2EgdtmKBqVDus2b1DkhYEBoR4yN8FftedHzzzr,False,2992855942,2992855942,0,0,0,5HnvdJnCCcmRsm4GkXnYWd4q9RpwuvYDGEUMPkYR3Ts9,0,819018167,-835979268,0
2022-05-11 00:24:36-04:00,22291,DbhYDjULmvytv9CD9absZq9VABwNkBy3y6ugnQN7RdVD,73NGUFBEAToVdoVP52fDihvDtKE7N2VPJfbbXw4vysSD,False,154913728,154913728,0,0,0,C4UnXuShCvjSMgBAgVNMy1oakxCNk1et27A82fywU112,0,36130403,-47674768,0
2022-05-11 00:24:40-04:00,22292,64Diz8zzEv1jDWnBQPTHPpXwaWf7vjM19RyJmkPy1viQ,G8wkGHRHMtT3mvXBkH3zgsKNs8wbpdiPUS17y4cozhkZ,False,242024299,242024299,0,0,0,C4UnXuShCvjSMgBAgVNMy1oakxCNk1et27A82fywU112,0,71132146,-79657993,0
2022-05-11 00:24:41-04:00,22293,6fqbSyhh3PPdgRcLraHb7Jahj9s1oHHeX3SsjNSsGa6t,GpRUow48TYgttdYfsygbgjYQcmHyYjWETUDjDVphEgwq,False,22097141,22097141,0,0,0,3uL2NSR2ZdDqCiKfzA5SwwpddAnit22DBJo6uvvz1rRs,0,14660352,-15842716,0
2022-05-11 00:24:41-04:00,22294,uFQBu1UoyNJBRpZCa5hTGW6Djv8658FXSZHVGDzox7A,4Rs1ZoK5GodHWQDZhXzk1o8zbujDDBLGszct1bXYWr5s,False,178294261,178294261,963835,48191,915644,3zqXX6kzhkbW3d4TwD2CNjMRwxTbREXySekvq37kfCNk,963836,100274503,-99310667,54
2022-05-11 00:24:41-04:00,22295,Hjfm6iGa54sbaqjwvJhC9HZ22S48iqt5gdUneRjv8qbR,94DWK2YsxQdw1sFoJstu3GeoUCWnBdcCZZyw4nkVg5ua,False,606832138,606832138,20545060,1027253,19517807,C4UnXuShCvjSMgBAgVNMy1oakxCNk1et27A82fywU112,20545060,440081183,-419536123,338
2022-05-11 00:24:41-04:00,22296,9sZW2rDL5B8wQ4kpYRMbiwr1wqmwNQ3D1P9zDX8wsWPc,CxuEQWMaiGh7ug62Q7Xo11iFpjgKZBFgpHseXjotiCUp,False,1505914301,1505914301,55838100,2791905,53046195,2py1FiYeL2f7J3HU36qiJz6TD6HCmiTN36RyxYtapQCZ,55838100,929844815,-874006715,370
2022-05-11 00:24:41-04:00,22297,9MSygCP2RKyYEK4xdCtASEGgnfuJYgcg48khe7oQuxfW,75zERuqSUGCy56S8TURMEhCwjpyMzPrMbGZdFHCoAvnS,False,259922936,259922936,0,0,0,C4UnXuShCvjSMgBAgVNMy1oakxCNk1et27A82fywU112,0,148705809,-161638351,0
2022-05-11 00:48:39-04:00,22298,GMpoV2jRyLdf2V3Gb5TQZ5gEs5ftMjD3JhFUzkA6fWVz,5bi814d5gdToTLVWCmbdB6J15kMdsTQk74cZTRd62p81,True,15397453,3849363,27156,13578,13578,6L1WYrPiCMyi7XemPww4B4hvpKD1LQKD4RpiSKmrmgSC,1086264,9550464,-8464200,705
2022-05-11 01:10:18-04:00,22299,2DEiHSwRUnrkbnDGJ3MbodNVQRv51dmNCaCzLURswiQK,4m6MGEEmNHdXKCoSeYpTjVzEu4EUdTEHHWMPpj1Njaru,True,10023678820,2505919705,15642847,7821423,7821424,8sEswn3kzEhnYjAZVvCQnHEUvYd7pFVvc2Xc2Kd1BpbC,625713881,959318504,-333604623,624
2022-05-11 01:11:42-04:00,22300,2DEiHSwRUnrkbnDGJ3MbodNVQRv51dmNCaCzLURswiQK,4m6MGEEmNHdXKCoSeYpTjVzEu4EUdTEHHWMPpj1Njaru,True,7706792710,1926698177,10525935,5262967,5262968,6L1WYrPiCMyi7XemPww4B4hvpKD1LQKD4RpiSKmrmgSC,421037439,862120266,-441082827,546
2022-05-11 01:12:09-04:00,22301,2DEiHSwRUnrkbnDGJ3MbodNVQRv51dmNCaCzLURswiQK,4m6MGEEmNHdXKCoSeYpTjVzEu4EUdTEHHWMPpj1Njaru,True,5882662745,1470665686,7698582,3849291,3849291,DA18qE9qesbBqpwNv1M4befYcNQkbSBSeLPTmQzrmbJw,307943292,742374374,-434431082,523
2022-05-11 01:12:09-04:00,22302,4T2MDxf43fxhNe8A2aF7G8hFFpPnkeWkMGPRiYVcBo9h,4cjUvZRpju4xAdS8b5CjxhVEk3o52KBGwjkH9hq23u8A,True,192519136,48129784,269467,134733,134734,8sEswn3kzEhnYjAZVvCQnHEUvYd7pFVvc2Xc2Kd1BpbC,10778691,18701059,-7922368,559
2022-05-11 01:12:11-04:00,22303,DmwHBt9RS9QZesz2k6NsiC9CXCvgaGSTWycWj8nCdkC6,EEN2iGeHGY9AbsrBTgs9CFNTfdiGWymzt6VGto8ZGyfF,True,11807265904,2951816476,17691479,8845739,8845740,8sEswn3kzEhnYjAZVvCQnHEUvYd7pFVvc2Xc2Kd1BpbC,707659181,1333195605,-625536424,599
2022-05-11 01:17:40-04:00,22304,2DEiHSwRUnrkbnDGJ3MbodNVQRv51dmNCaCzLURswiQK,4m6MGEEmNHdXKCoSeYpTjVzEu4EUdTEHHWMPpj1Njaru,True,4435366177,1108841544,6921889,3460944,3460945,Hu94aiQWvce6THeGyCFqGRPM1pQrK3ihzkcXo1EpJcJL,276875592,626664089,-349788497,624
2022-05-11 01:18:27-04:00,22305,DmwHBt9RS9QZesz2k6NsiC9CXCvgaGSTWycWj8nCdkC6,EEN2iGeHGY9AbsrBTgs9CFNTfdiGWymzt6VGto8ZGyfF,True,9004958584,2251239646,13511463,6755731,6755732,AmTrMPzuTp2BjnjqGNKqz9FTTCdpoKcPAJLwFc8ozcbh,540458546,1161585784,-621127238,600
2022-05-11 01:18:33-04:00,22306,4T2MDxf43fxhNe8A2aF7G8hFFpPnkeWkMGPRiYVcBo9h,4cjUvZRpju4xAdS8b5CjxhVEk3o52KBGwjkH9hq23u8A,True,146919279,36729819,199482,99741,99741,C4UnXuShCvjSMgBAgVNMy1oakxCNk1et27A82fywU112,7979297,16451660,-8472363,543
2022-05-11 01:18:38-04:00,22307,DmwHBt9RS9QZesz2k6NsiC9CXCvgaGSTWycWj8nCdkC6,EEN2iGeHGY9AbsrBTgs9CFNTfdiGWymzt6VGto8ZGyfF,True,6880366030,1720091507,10007499,5003749,5003750,DA18qE9qesbBqpwNv1M4befYcNQkbSBSeLPTmQzrmbJw,400299991,994190446,-593890455,581
2022-05-11 01:18:39-04:00,22308,2DEiHSwRUnrkbnDGJ3MbodNVQRv51dmNCaCzLURswiQK,4m6MGEEmNHdXKCoSeYpTjVzEu4EUdTEHHWMPpj1Njaru,True,3401120584,850280146,4883943,2441971,2441972,2xTUy2RS74GJMMDnmFaegMzFLn19RVfYG4CibhBmjP1i,195357752,532631165,-337273413,574
2022-05-11 01:18:39-04:00,22309,4T2MDxf43fxhNe8A2aF7G8hFFpPnkeWkMGPRiYVcBo9h,4cjUvZRpju4xAdS8b5CjxhVEk3o52KBGwjkH9hq23u8A,True,111347432,27836858,165546,82773,82773,68sueyVfmy5ToEGtLFGDkwebX47xAmzyXE29z8JrmcWv,6621843,14134462,-7512619,594
2022-05-11 01:18:59-04:00,22310,2DEiHSwRUnrkbnDGJ3MbodNVQRv51dmNCaCzLURswiQK,4m6MGEEmNHdXKCoSeYpTjVzEu4EUdTEHHWMPpj1Njaru,True,2594994880,648748720,3657984,1828992,1828992,A9TwRM1BMxqb8DCC7YNAMV6zPenEJm3HTZBy7wJKK58U,146319367,443619990,-297300623,563
2022-05-11 01:18:59-04:00,22311,DmwHBt9RS9QZesz2k6NsiC9CXCvgaGSTWycWj8nCdkC6,EEN2iGeHGY9AbsrBTgs9CFNTfdiGWymzt6VGto8ZGyfF,True,5251143658,1312785914,7485583,3742791,3742792,2xTUy2RS74GJMMDnmFaegMzFLn19RVfYG4CibhBmjP1i,299423357,836503702,-537080345,570
2022-05-11 01:19:01-04:00,22312,Cb6MEn1MN9XQcVVd3o9J8QdK3cFWxSNETsFzhVJ8jmdh,A6yTKbggUftjbjAVu5YR1M7rg7h78ghbfofmTSnmKNGz,True,448044565,112011141,674906,337453,337453,2a35JJeTUW1pm6M3e8DHCjp8qr4vbc2cRPhuzZWyFzYd,26996253,43371665,-16375412,602
2022-05-11 01:19:06-04:00,22313,4T2MDxf43fxhNe8A2aF7G8hFFpPnkeWkMGPRiYVcBo9h,4cjUvZRpju4xAdS8b5CjxhVEk3o52KBGwjkH9hq23u8A,True,84941624,21235406,125631,62815,62816,C4UnXuShCvjSMgBAgVNMy1oakxCNk1et27A82fywU112,5025247,12090973,-7065726,591
2022-05-11 01:31:48-04:00,22314,5B3nic6AUDSiweK5kgbwd6W9DqqX9tJ1zUSQHNWPe24b,2cpauDZ4j1ACSoFfR55NNEVh9quRiVcSFF7Zq3L26U8a,True,1055811269,263952817,1451853,725926,725927,4yhyLx1phodwcvvwVU2bramHcdbJYvfadd7pANsRzX8M,58074155,77464576,-19390421,550
2022-05-11 02:16:20-04:00,22315,GMpoV2jRyLdf2V3Gb5TQZ5gEs5ftMjD3JhFUzkA6fWVz,5bi814d5gdToTLVWCmbdB6J15kMdsTQk74cZTRd62p81,False,11299691,11299691,805670,40283,765387,C4UnXuShCvjSMgBAgVNMy1oakxCNk1et27A82fywU112,805670,7402262,-6596592,713
2022-05-11 02:16:57-04:00,22316,26wo1RqwKXrNnfgMdZEmkGhnDbURpZcp2hasB5EA5QtD,34gwTVGRrdoaBzLUG6SBwRwBovkjBjCebqVUBan6GDnB,True,20803288437,5200822109,34628398,17314199,17314199,DA18qE9qesbBqpwNv1M4befYcNQkbSBSeLPTmQzrmbJw,1385135947,6045346741,-4660210794,665
2022-05-11 02:17:06-04:00,22317,5L4rwphiDXABvFWjdFRCUjRjkvJoAdAhztB9nPn1vbTP,6KWPKfStxQ1HJ6mxAFG19EGmrccjZqdGvniPoEyy9Fij,True,144554158,36138539,227170,113585,113585,F31bVJvHB2XkhGdgjyTim48hY2cLFEx661AiPS3SzYJ2,9086818,92359084,-83272266,628
2022-05-11 02:17:26-04:00,22318,5FewDaMC9U7n5EHcto98GaAmDVxDh5SYimuTP6AtfakM,7DAULUoqV7f9hsBzKEhjQPnWaHSqiMWcBqWcdcadaQv4,True,23565479,5891369,36487,18243,18244,68sueyVfmy5ToEGtLFGDkwebX47xAmzyXE29z8JrmcWv,1459499,8715194,-7255695,619
2022-05-11 02:19:56-04:00,22319,84v7qCSdhRPUMVHXyWygBut7CoSSirqkMYdbg3pXn9Ru,DyekBxbVtxFuasKAvBQBKrdN8qjiWVPdJi3n9jdaqFdF,True,16638974343,1663460023,7165551,3582775,3582776,GXyFXZMNk2NFyEzw6JetVqsujqcz2yCixH7n8EpDJYWD,716743556,1955015802,-1238272246,430
2022-05-11 02:20:32-04:00,22320,5L4rwphiDXABvFWjdFRCUjRjkvJoAdAhztB9nPn1vbTP,6KWPKfStxQ1HJ6mxAFG19EGmrccjZqdGvniPoEyy9Fij,True,107150512,26787628,189863,94931,94932,2a35JJeTUW1pm6M3e8DHCjp8qr4vbc2cRPhuzZWyFzYd,7594541,71316660,-63722119,708
2022-05-11 02:22:54-04:00,22321,84v7qCSdhRPUMVHXyWygBut7CoSSirqkMYdbg3pXn9Ru,DyekBxbVtxFuasKAvBQBKrdN8qjiWVPdJi3n9jdaqFdF,True,14846152272,1215254505,4749446,2374723,2374723,4yhyLx1phodwcvvwVU2bramHcdbJYvfadd7pANsRzX8M,580215957,1674035636,-1093819679,390
2022-05-11 02:24:29-04:00,22322,84v7qCSdhRPUMVHXyWygBut7CoSSirqkMYdbg3pXn9Ru,DyekBxbVtxFuasKAvBQBKrdN8qjiWVPdJi3n9jdaqFdF,True,13608624467,2499737489,9653925,4826962,4826963,DQCvC9mR68hJ3tJsUiddh6JwcBJAmntqGJR2nUsEq7yj,525561797,1431097444,-905535647,386
2022-05-11 02:28:07-04:00,22323,26wo1RqwKXrNnfgMdZEmkGhnDbURpZcp2hasB5EA5QtD,34gwTVGRrdoaBzLUG6SBwRwBovkjBjCebqVUBan6GDnB,True,15303105229,3825776307,26278661,13139330,13139331,GXyFXZMNk2NFyEzw6JetVqsujqcz2yCixH7n8EpDJYWD,1051146450,4890891795,-3839745345,686
2022-05-11 02:32:36-04:00,22324,5L4rwphiDXABvFWjdFRCUjRjkvJoAdAhztB9nPn1vbTP,6KWPKfStxQ1HJ6mxAFG19EGmrccjZqdGvniPoEyy9Fij,True,78494875,19623718,138416,69208,69208,2a35JJeTUW1pm6M3e8DHCjp8qr4vbc2cRPhuzZWyFzYd,5536669,55197840,-49661171,705
2022-05-11 02:37:13-04:00,22325,26wo1RqwKXrNnfgMdZEmkGhnDbURpZcp2hasB5EA5QtD,34gwTVGRrdoaBzLUG6SBwRwBovkjBjCebqVUBan6GDnB,True,11252472094,2813118023,20000274,10000137,10000137,GXyFXZMNk2NFyEzw6JetVqsujqcz2yCixH7n8EpDJYWD,800010961,3929976308,-3129965347,710
2022-05-11 02:37:22-04:00,22326,CcHRe7yjr3pDZqHfqzWw7g8q59y2ayiFLUvVeywC5J39,HCDkE5M7hHrZxJZxF9nkEXp86VYcFqejohxmLGZkC9SG,True,41635370,10408842,64021,32010,32011,8sEswn3kzEhnYjAZVvCQnHEUvYd7pFVvc2Xc2Kd1BpbC,2560860,37050858,-34489998,615
2022-05-11 02:38:36-04:00,22327,84v7qCSdhRPUMVHXyWygBut7CoSSirqkMYdbg3pXn9Ru,DyekBxbVtxFuasKAvBQBKrdN8qjiWVPdJi3n9jdaqFdF,True,11013457439,1872097387,7515346,3757673,3757673,2a35JJeTUW1pm6M3e8DHCjp8qr4vbc2cRPhuzZWyFzYd,442124171,1386749753,-944625582,401
2022-05-11 02:38:45-04:00,22328,5B3nic6AUDSiweK5kgbwd6W9DqqX9tJ1zUSQHNWPe24b,2cpauDZ4j1ACSoFfR55NNEVh9quRiVcSFF7Zq3L26U8a,True,4109929239,1027482309,6164268,3082134,3082134,2a35JJeTUW1pm6M3e8DHCjp8qr4vbc2cRPhuzZWyFzYd,246570734,476948511,-230377777,599
2022-05-11 02:39:44-04:00,22329,84v7qCSdhRPUMVHXyWygBut7CoSSirqkMYdbg3pXn9Ru,DyekBxbVtxFuasKAvBQBKrdN8qjiWVPdJi3n9jdaqFdF,True,9071333087,866210802,3668550,1834275,1834275,DA18qE9qesbBqpwNv1M4befYcNQkbSBSeLPTmQzrmbJw,384186426,1354421598,-970235172,423
2022-05-11 02:40:09-04:00,22330,5L4rwphiDXABvFWjdFRCUjRjkvJoAdAhztB9nPn1vbTP,6KWPKfStxQ1HJ6mxAFG19EGmrccjZqdGvniPoEyy9Fij,True,57583325,14395831,102760,51380,51380,8sEswn3kzEhnYjAZVvCQnHEUvYd7pFVvc2Xc2Kd1BpbC,4110421,42645007,-38534586,713
2022-05-11 02:40:17-04:00,22331,84v7qCSdhRPUMVHXyWygBut7CoSSirqkMYdbg3pXn9Ru,DyekBxbVtxFuasKAvBQBKrdN8qjiWVPdJi3n9jdaqFdF,True,8147778028,1401601560,5562192,2781096,2781096,4yhyLx1phodwcvvwVU2bramHcdbJYvfadd7pANsRzX8M,323340891,1126606641,-803265750,396
2022-05-11 02:41:23-04:00,22332,29JVska5UEG3axs63EmtHpPvkswNEqYpZ3PKMSfupiAG,DCftNBUsuogxyaJe9G9m3eWipH6o3qo4Rn4TuQXdVaBF,True,69259831,17314957,52397,26198,26199,F31bVJvHB2XkhGdgjyTim48hY2cLFEx661AiPS3SzYJ2,2095889,4259727,-2163838,302
2022-05-11 02:43:18-04:00,22333,26wo1RqwKXrNnfgMdZEmkGhnDbURpZcp2hasB5EA5QtD,34gwTVGRrdoaBzLUG6SBwRwBovkjBjCebqVUBan6GDnB,True,8244681037,2061170259,14633441,7316720,7316721,4yhyLx1phodwcvvwVU2bramHcdbJYvfadd7pANsRzX8M,585337653,3141619276,-2556281623,709
2022-05-11 02:43:39-04:00,22334,84v7qCSdhRPUMVHXyWygBut7CoSSirqkMYdbg3pXn9Ru,DyekBxbVtxFuasKAvBQBKrdN8qjiWVPdJi3n9jdaqFdF,True,6655497987,618488533,2542739,1271369,1271370,A2p75MbAbeUdHkPLkAjgGeiwuu9WPrkMHzjCkDXF1Xr3,273621880,1104064915,-830443035,411
2022-05-11 02:43:39-04:00,22335,3mzsSB8LE669UtTd9B9PigEPa1meGqGFZwCdbaXbxz6M,2x14n73Pr5XXoedsyg92znoBvUPYVbUAT92uCSfk7fGs,True,30780092,2385186,9871,4935,4936,8sEswn3kzEhnYjAZVvCQnHEUvYd7pFVvc2Xc2Kd1BpbC,1273877,30493907,-29220030,413
2022-05-11 02:44:48-04:00,22336,84v7qCSdhRPUMVHXyWygBut7CoSSirqkMYdbg3pXn9Ru,DyekBxbVtxFuasKAvBQBKrdN8qjiWVPdJi3n9jdaqFdF,True,5971957336,1492989334,5150674,2575337,2575337,F31bVJvHB2XkhGdgjyTim48hY2cLFEx661AiPS3SzYJ2,206027023,902092238,-696065215,344
2022-05-11 02:44:49-04:00,22337,CcHRe7yjr3pDZqHfqzWw7g8q59y2ayiFLUvVeywC5J39,HCDkE5M7hHrZxJZxF9nkEXp86VYcFqejohxmLGZkC9SG,True,30631580,7657895,47547,23773,23774,5HnvdJnCCcmRsm4GkXnYWd4q9RpwuvYDGEUMPkYR3Ts9,1901891,28364461,-26462570,620
2022-05-11 02:45:28-04:00,22338,4nqsW3XCJxzSsDdQzvE3zeM9nqBv8xVdUG8GxFWn6Edf,6eVvNs2rckFeTGkXZgPEGLYg4rmz3MFtoVNPRNmktcrY,True,71897181,17974295,128054,64027,64027,6L1WYrPiCMyi7XemPww4B4hvpKD1LQKD4RpiSKmrmgSC,5122189,23738434,-18616245,712
2022-05-11 02:45:36-04:00,22339,GRqv7y5n92vQ7bXcBqUng4vaau6w1tQeou953s8kJNwD,Bk75oioYmUzfdpbxDHTFb2nWhJgNqAt8ud1ehem3VVhh,True,6767179118,1691794779,5059033,2529516,2529517,CGtKBgcWZ6HKE3tFNLPUM9khDv2Rc7d6BrPtxz7J1aY,202361356,335029187,-132667831,299
2022-05-11 02:45:49-04:00,22340,EyNCsqWu8zLyuRnXSbzJWnWZg7ZLjb4oJSZFdDSkbXmT,6rMMMkZibUHXYs8hXY3FmG4rgBx6gWDRGJwR2bP2t6ZD,True,3391605302,600049095,2382077,1191038,1191039,72XWPCtRYEDZbddP7d6dHtUBRRDLSJsB2xZTAfefoEVZ,134640083,1096904737,-962264654,396
2022-05-11 02:49:08-04:00,22341,3mzsSB8LE669UtTd9B9PigEPa1meGqGFZwCdbaXbxz6M,2x14n73Pr5XXoedsyg92znoBvUPYVbUAT92uCSfk7fGs,True,28248769,1782501,7053,3526,3527,5HnvdJnCCcmRsm4GkXnYWd4q9RpwuvYDGEUMPkYR3Ts9,1117869,29119222,-28001353,395
2022-05-11 02:51:38-04:00,22342,3mzsSB8LE669UtTd9B9PigEPa1meGqGFZwCdbaXbxz6M,2x14n73Pr5XXoedsyg92znoBvUPYVbUAT92uCSfk7fGs,False,26354298,26354298,998843,49942,948901,Hu94aiQWvce6THeGyCFqGRPM1pQrK3ihzkcXo1EpJcJL,998846,28082168,-27083322,379
2022-05-11 02:51:44-04:00,22343,5L4rwphiDXABvFWjdFRCUjRjkvJoAdAhztB9nPn1vbTP,6KWPKfStxQ1HJ6mxAFG19EGmrccjZqdGvniPoEyy9Fij,True,42144883,10536220,74126,37063,37063,2a35JJeTUW1pm6M3e8DHCjp8qr4vbc2cRPhuzZWyFzYd,2965050,32909088,-29944038,703
2022-05-11 02:52:27-04:00,22344,gRV31wGMzVC3CQnv2PMLQxKF8EDJEqY14LvWAQVXVuN,EESzw7ZdoHfCNQZkK6uivTyMzswM7HACTr2GXV8pB1pb,True,258682297,38905459,150814,75407,75407,6L1WYrPiCMyi7XemPww4B4hvpKD1LQKD4RpiSKmrmgSC,10027705,246242524,-236214819,387
2022-05-11 02:52:27-04:00,22345,29JVska5UEG3axs63EmtHpPvkswNEqYpZ3PKMSfupiAG,DCftNBUsuogxyaJe9G9m3eWipH6o3qo4Rn4TuQXdVaBF,True,51429206,12857301,38195,19097,19098,8sEswn3kzEhnYjAZVvCQnHEUvYd7pFVvc2Xc2Kd1BpbC,1527824,3666418,-2138594,297
2022-05-11 02:53:02-04:00,22346,GRqv7y5n92vQ7bXcBqUng4vaau6w1tQeou953s8kJNwD,Bk75oioYmUzfdpbxDHTFb2nWhJgNqAt8ud1ehem3VVhh,True,5028436273,1257109068,3758856,1879428,1879428,8sEswn3kzEhnYjAZVvCQnHEUvYd7pFVvc2Xc2Kd1BpbC,150354257,297243789,-146889532,299
2022-05-11 02:53:10-04:00,22347,84v7qCSdhRPUMVHXyWygBut7CoSSirqkMYdbg3pXn9Ru,DyekBxbVtxFuasKAvBQBKrdN8qjiWVPdJi3n9jdaqFdF,True,4376708882,774861177,3045893,1522946,1522947,DA18qE9qesbBqpwNv1M4befYcNQkbSBSeLPTmQzrmbJw,172043589,723631021,-551587432,393
2022-05-11 02:53:23-04:00,22348,gRV31wGMzVC3CQnv2PMLQxKF8EDJEqY14LvWAQVXVuN,EESzw7ZdoHfCNQZkK6uivTyMzswM7HACTr2GXV8pB1pb,True,218731396,17255212,69669,34834,34835,6L1WYrPiCMyi7XemPww4B4hvpKD1LQKD4RpiSKmrmgSC,8831449,235716430,-226884981,403
2022-05-11 02:56:32-04:00,22349,26wo1RqwKXrNnfgMdZEmkGhnDbURpZcp2hasB5EA5QtD,34gwTVGRrdoaBzLUG6SBwRwBovkjBjCebqVUBan6GDnB,True,6038223937,1509555984,10635434,5317717,5317717,4yhyLx1phodwcvvwVU2bramHcdbJYvfadd7pANsRzX8M,425417371,2495792023,-2070374652,704
2022-05-11 02:56:34-04:00,22350,HB4y3u86B6VLnmAdVdK2b7NKhPebePteXmhKbtK6MWRH,2qwFXGtCUtSgrJAuugoQqYB8XyQGTbTCeWb8yAsduLmR,True,29720379,2370797,9827,4913,4914,5HnvdJnCCcmRsm4GkXnYWd4q9RpwuvYDGEUMPkYR3Ts9,1232075,30496485,-29264410,414
2022-05-11 02:56:38-04:00,22351,G8Bnx7PhHFxsqY2KTVPpwwDWUend8DmzLNQfSaevrEDz,JCvjtN3aZsaSwQPaZcMFnQBm8NtgopQqdPa6FKrH4Bcm,True,1189665890,96417246,474044,237022,237022,2a35JJeTUW1pm6M3e8DHCjp8qr4vbc2cRPhuzZWyFzYd,58491006,518347256,-459856250,491
2022-05-11 02:56:40-04:00,22352,gRV31wGMzVC3CQnv2PMLQxKF8EDJEqY14LvWAQVXVuN,EESzw7ZdoHfCNQZkK6uivTyMzswM7HACTr2GXV8pB1pb,True,200417184,29074064,111742,55871,55871,6L1WYrPiCMyi7XemPww4B4hvpKD1LQKD4RpiSKmrmgSC,7702780,202959837,-195257057,384
2022-05-11 02:57:01-04:00,22353,EyNCsqWu8zLyuRnXSbzJWnWZg7ZLjb4oJSZFdDSkbXmT,6rMMMkZibUHXYs8hXY3FmG4rgBx6gWDRGJwR2bP2t6ZD,True,2775189318,247388946,1033088,516544,516544,A9TwRM1BMxqb8DCC7YNAMV6zPenEJm3HTZBy7wJKK58U,115891117,965623758,-849732641,417
2022-05-11 02:58:03-04:00,22354,A5Rke3PmcjUYSPVpJNU92DKJTSCADcFNBMVmMyM85jPH,GbuBDhVKLNHeoMmZRNSjtwzWUw3jTfGHEoBCJyWaHnZc,True,29683362,2211224,8957,4478,4479,5HnvdJnCCcmRsm4GkXnYWd4q9RpwuvYDGEUMPkYR3Ts9,1202475,30511557,-29309082,405
2022-05-11 02:58:13-04:00,22355,gRV31wGMzVC3CQnv2PMLQxKF8EDJEqY14LvWAQVXVuN,EESzw7ZdoHfCNQZkK6uivTyMzswM7HACTr2GXV8pB1pb,True,170459695,12610240,49621,24810,24811,Hu94aiQWvce6THeGyCFqGRPM1pQrK3ihzkcXo1EpJcJL,6707613,194961134,-188253521,393
2022-05-11 02:58:14-04:00,22356,84v7qCSdhRPUMVHXyWygBut7CoSSirqkMYdbg3pXn9Ru,DyekBxbVtxFuasKAvBQBKrdN8qjiWVPdJi3n9jdaqFdF,True,3553342488,310268492,1267171,633585,633586,Hu94aiQWvce6THeGyCFqGRPM1pQrK3ihzkcXo1EpJcJL,145122509,723952030,-578829521,408
2022-05-11 02:58:15-04:00,22357,9eWpSyu71Z6dmx7yTh7WrbVScdrrZN14d5tfmqEGFgXt,2r89PFKSD9zmSp2Wyx4CQ75HAtmUgwhAS2oG5MuYuiV6,True,30993906,5642089,22011,11005,11006,8sEswn3kzEhnYjAZVvCQnHEUvYd7pFVvc2Xc2Kd1BpbC,1209181,16843463,-15634282,390
2022-05-11 03:00:29-04:00,22358,5hfwMBNetuL1wYHVXrGkKWNAjKyN8WhmqjZd8EjXYN8d,DT9rQfjr27ULJ5PiQ3pShDFvT4LyV6ogcSXnp4mUdwhY,True,85345175,21336293,64095,32047,32048,F31bVJvHB2XkhGdgjyTim48hY2cLFEx661AiPS3SzYJ2,2563815,27148588,-24584773,300
2022-05-11 03:00:55-04:00,22359,gRV31wGMzVC3CQnv2PMLQxKF8EDJEqY14LvWAQVXVuN,EESzw7ZdoHfCNQZkK6uivTyMzswM7HACTr2GXV8pB1pb,True,156996990,21708958,79194,39597,39597,6L1WYrPiCMyi7XemPww4B4hvpKD1LQKD4RpiSKmrmgSC,5727308,169986786,-164259478,364
2022-05-11 03:00:56-04:00,22360,HB4y3u86B6VLnmAdVdK2b7NKhPebePteXmhKbtK6MWRH,2qwFXGtCUtSgrJAuugoQqYB8XyQGTbTCeWb8yAsduLmR,True,27209427,1776055,7045,3522,3523,2a35JJeTUW1pm6M3e8DHCjp8qr4vbc2cRPhuzZWyFzYd,1079434,29104794,-28025360,396
2022-05-11 03:01:15-04:00,22361,29JVska5UEG3axs63EmtHpPvkswNEqYpZ3PKMSfupiAG,DCftNBUsuogxyaJe9G9m3eWipH6o3qo4Rn4TuQXdVaBF,True,38240279,9560069,28671,14335,14336,8sEswn3kzEhnYjAZVvCQnHEUvYd7pFVvc2Xc2Kd1BpbC,1146853,3082451,-1935598,299
2022-05-11 03:01:54-04:00,22362,gRV31wGMzVC3CQnv2PMLQxKF8EDJEqY14LvWAQVXVuN,EESzw7ZdoHfCNQZkK6uivTyMzswM7HACTr2GXV8pB1pb,True,134675465,9190658,34363,17181,17182,5HnvdJnCCcmRsm4GkXnYWd4q9RpwuvYDGEUMPkYR3Ts9,5035547,163895516,-158859969,373
2022-05-11 03:02:18-04:00,22363,A5Rke3PmcjUYSPVpJNU92DKJTSCADcFNBMVmMyM85jPH,GbuBDhVKLNHeoMmZRNSjtwzWUw3jTfGHEoBCJyWaHnZc,True,27351345,1656895,6472,3236,3236,6L1WYrPiCMyi7XemPww4B4hvpKD1LQKD4RpiSKmrmgSC,1068416,29209515,-28141099,390
2022-05-11 03:02:28-04:00,22364,5L4rwphiDXABvFWjdFRCUjRjkvJoAdAhztB9nPn1vbTP,6KWPKfStxQ1HJ6mxAFG19EGmrccjZqdGvniPoEyy9Fij,True,30960743,7740185,55134,27567,27567,Hu94aiQWvce6THeGyCFqGRPM1pQrK3ihzkcXo1EpJcJL,2205361,25311581,-23106220,712
2022-05-11 03:03:11-04:00,22365,84v7qCSdhRPUMVHXyWygBut7CoSSirqkMYdbg3pXn9Ru,DyekBxbVtxFuasKAvBQBKrdN8qjiWVPdJi3n9jdaqFdF,True,3201168206,575015796,2246172,1123086,1123086,8sEswn3kzEhnYjAZVvCQnHEUvYd7pFVvc2Xc2Kd1BpbC,125046589,571452608,-446406019,390
2022-05-11 03:03:37-04:00,22366,G8Bnx7PhHFxsqY2KTVPpwwDWUend8DmzLNQfSaevrEDz,JCvjtN3aZsaSwQPaZcMFnQBm8NtgopQqdPa6FKrH4Bcm,True,1086539710,71786129,337350,168675,168675,2a35JJeTUW1pm6M3e8DHCjp8qr4vbc2cRPhuzZWyFzYd,51060660,487355877,-436295217,469
2022-05-11 03:03:48-04:00,22367,gRV31wGMzVC3CQnv2PMLQxKF8EDJEqY14LvWAQVXVuN,EESzw7ZdoHfCNQZkK6uivTyMzswM7HACTr2GXV8pB1pb,True,125027089,16241682,59021,29510,29511,8sEswn3kzEhnYjAZVvCQnHEUvYd7pFVvc2Xc2Kd1BpbC,4543466,144959172,-140415706,363
2022-05-11 03:04:03-04:00,22368,84v7qCSdhRPUMVHXyWygBut7CoSSirqkMYdbg3pXn9Ru,DyekBxbVtxFuasKAvBQBKrdN8qjiWVPdJi3n9jdaqFdF,True,2613836576,221778380,909002,454501,454501,Hu94aiQWvce6THeGyCFqGRPM1pQrK3ihzkcXo1EpJcJL,107133249,577712807,-470579558,409
2022-05-11 03:04:33-04:00,22369,gRV31wGMzVC3CQnv2PMLQxKF8EDJEqY14LvWAQVXVuN,EESzw7ZdoHfCNQZkK6uivTyMzswM7HACTr2GXV8pB1pb,True,108315320,6657828,24674,12337,12337,C4UnXuShCvjSMgBAgVNMy1oakxCNk1et27A82fywU112,4014358,140350908,-136336550,370
2022-05-11 03:05:21-04:00,22370,CcHRe7yjr3pDZqHfqzWw7g8q59y2ayiFLUvVeywC5J39,HCDkE5M7hHrZxJZxF9nkEXp86VYcFqejohxmLGZkC9SG,True,22523950,5630987,34712,17356,17356,C4UnXuShCvjSMgBAgVNMy1oakxCNk1et27A82fywU112,1388486,21685217,-20296731,616
2022-05-11 03:05:21-04:00,22371,4XLRja4kyic3cw5KH1R7jCKdaKrS3dE5kp8tZjGz24vG,6gRs1jjqCnKyZiev8CL1cB3vFnwxw6L7uBLo5qMsUdk,True,3133424270,783356067,4682174,2341087,2341087,C4UnXuShCvjSMgBAgVNMy1oakxCNk1et27A82fywU112,187286983,2052580257,-1865293274,597
2022-05-11 03:05:23-04:00,22372,84v7qCSdhRPUMVHXyWygBut7CoSSirqkMYdbg3pXn9Ru,DyekBxbVtxFuasKAvBQBKrdN8qjiWVPdJi3n9jdaqFdF,True,2384251610,432482978,1668800,834400,834400,DQCvC9mR68hJ3tJsUiddh6JwcBJAmntqGJR2nUsEq7yj,91999943,453417157,-361417214,385
2022-05-11 03:05:58-04:00,22373,gRV31wGMzVC3CQnv2PMLQxKF8EDJEqY14LvWAQVXVuN,EESzw7ZdoHfCNQZkK6uivTyMzswM7HACTr2GXV8pB1pb,True,101346568,12196288,44271,22135,22136,5HnvdJnCCcmRsm4GkXnYWd4q9RpwuvYDGEUMPkYR3Ts9,3678760,125914538,-122235778,362
2022-05-11 03:05:58-04:00,22374,4nqsW3XCJxzSsDdQzvE3zeM9nqBv8xVdUG8GxFWn6Edf,6eVvNs2rckFeTGkXZgPEGLYg4rmz3MFtoVNPRNmktcrY,True,52583900,13145975,91378,45689,45689,8sEswn3kzEhnYjAZVvCQnHEUvYd7pFVvc2Xc2Kd1BpbC,3655149,18957014,-15301865,695
2022-05-11 03:06:37-04:00,22375,84v7qCSdhRPUMVHXyWygBut7CoSSirqkMYdbg3pXn9Ru,DyekBxbVtxFuasKAvBQBKrdN8qjiWVPdJi3n9jdaqFdF,True,1934991007,160043238,651881,325940,325941,C4UnXuShCvjSMgBAgVNMy1oakxCNk1et27A82fywU112,78815284,456824435,-378009151,407
2022-05-11 03:06:53-04:00,22376,gRV31wGMzVC3CQnv2PMLQxKF8EDJEqY14LvWAQVXVuN,EESzw7ZdoHfCNQZkK6uivTyMzswM7HACTr2GXV8pB1pb,True,88784705,4848403,17850,8925,8925,6L1WYrPiCMyi7XemPww4B4hvpKD1LQKD4RpiSKmrmgSC,3268914,122473279,-119204365,368
2022-05-11 03:07:20-04:00,22377,HB4y3u86B6VLnmAdVdK2b7NKhPebePteXmhKbtK6MWRH,2qwFXGtCUtSgrJAuugoQqYB8XyQGTbTCeWb8yAsduLmR,False,25316341,25316341,954077,47703,906374,5HnvdJnCCcmRsm4GkXnYWd4q9RpwuvYDGEUMPkYR3Ts9,954078,28060021,-27105943,376
2022-05-11 03:07:20-04:00,22378,84v7qCSdhRPUMVHXyWygBut7CoSSirqkMYdbg3pXn9Ru,DyekBxbVtxFuasKAvBQBKrdN8qjiWVPdJi3n9jdaqFdF,True,1760734441,323331040,1229207,614603,614604,DQCvC9mR68hJ3tJsUiddh6JwcBJAmntqGJR2nUsEq7yj,66937855,357328541,-290390686,380
2022-05-11 03:07:32-04:00,22379,gRV31wGMzVC3CQnv2PMLQxKF8EDJEqY14LvWAQVXVuN,EESzw7ZdoHfCNQZkK6uivTyMzswM7HACTr2GXV8pB1pb,True,83563438,9127474,31438,15719,15719,5HnvdJnCCcmRsm4GkXnYWd4q9RpwuvYDGEUMPkYR3Ts9,2878200,111501663,-108623463,344
2022-05-11 03:07:33-04:00,22380,DsmZLe2HbtLzrXgL9rLbwpyHKcPHDJeeNLsquACBFrsB,Dq8GXoHBnMZXvtCRpwWAUovtDSyzctutLhW1ueNAyQ4T,True,249138165,42923392,169231,84615,84616,C4UnXuShCvjSMgBAgVNMy1oakxCNk1et27A82fywU112,9822651,208615566,-198792915,394
2022-05-11 03:07:51-04:00,22381,DwoQXrbwHmfnkWvYaHbPjir3WLmq3oSpSrAjnPdDqgtL,Hv6r5uYpyyn8B4PTzrki6mj5hdF64yaa564Zi277tANU,True,10262184411,2565546102,7731082,3865541,3865541,DA18qE9qesbBqpwNv1M4befYcNQkbSBSeLPTmQzrmbJw,309243283,754185498,-444942215,301
2022-05-11 03:07:52-04:00,22382,A5Rke3PmcjUYSPVpJNU92DKJTSCADcFNBMVmMyM85jPH,GbuBDhVKLNHeoMmZRNSjtwzWUw3jTfGHEoBCJyWaHnZc,False,25587552,25587552,955044,47752,907292,6L1WYrPiCMyi7XemPww4B4hvpKD1LQKD4RpiSKmrmgSC,955046,28234938,-27279892,373
2022-05-11 03:07:54-04:00,22383,gRV31wGMzVC3CQnv2PMLQxKF8EDJEqY14LvWAQVXVuN,EESzw7ZdoHfCNQZkK6uivTyMzswM7HACTr2GXV8pB1pb,True,74283733,8213473,29793,14896,14897,5HnvdJnCCcmRsm4GkXnYWd4q9RpwuvYDGEUMPkYR3Ts9,2694531,108902694,-106208163,362
2022-05-11 03:07:54-04:00,22384,8Bfgak1fCQHEvBgi1hq4XB64yr3iNE8tpHoAQNQh44E3,WW8C2MTgcYuDj12cZNptgihbfghgoKMWCZtrxZ7eMgV,False,11690152,11690152,350116,17505,332611,C4UnXuShCvjSMgBAgVNMy1oakxCNk1et27A82fywU112,350116,6655964,-6305848,299
2022-05-11 03:08:08-04:00,22385,DsmZLe2HbtLzrXgL9rLbwpyHKcPHDJeeNLsquACBFrsB,Dq8GXoHBnMZXvtCRpwWAUovtDSyzctutLhW1ueNAyQ4T,True,205218330,19175680,80890,40445,40445,Hu94aiQWvce6THeGyCFqGRPM1pQrK3ihzkcXo1EpJcJL,8656977,198346997,-189690020,421
2022-05-11 03:08:37-04:00,22386,gRV31wGMzVC3CQnv2PMLQxKF8EDJEqY14LvWAQVXVuN,EESzw7ZdoHfCNQZkK6uivTyMzswM7HACTr2GXV8pB1pb,True,65845876,3473647,12873,6436,6437,C4UnXuShCvjSMgBAgVNMy1oakxCNk1et27A82fywU112,2440354,92586406,-90146052,370
2022-05-11 03:08:55-04:00,22387,84v7qCSdhRPUMVHXyWygBut7CoSSirqkMYdbg3pXn9Ru,DyekBxbVtxFuasKAvBQBKrdN8qjiWVPdJi3n9jdaqFdF,True,1422467713,241654431,977235,488617,488618,2a35JJeTUW1pm6M3e8DHCjp8qr4vbc2cRPhuzZWyFzYd,57523756,360890907,-303367151,404
2022-05-11 03:09:31-04:00,22388,DsmZLe2HbtLzrXgL9rLbwpyHKcPHDJeeNLsquACBFrsB,Dq8GXoHBnMZXvtCRpwWAUovtDSyzctutLhW1ueNAyQ4T,True,183718705,45929675,156302,78151,78151,F31bVJvHB2XkhGdgjyTim48hY2cLFEx661AiPS3SzYJ2,6252142,158483494,-152231352,340
2022-05-11 03:09:34-04:00,22389,84v7qCSdhRPUMVHXyWygBut7CoSSirqkMYdbg3pXn9Ru,DyekBxbVtxFuasKAvBQBKrdN8qjiWVPdJi3n9jdaqFdF,True,1169534433,111228997,437079,218539,218540,DQCvC9mR68hJ3tJsUiddh6JwcBJAmntqGJR2nUsEq7yj,45957372,364324986,-318367614,392
2022-05-11 03:09:40-04:00,22390,gRV31wGMzVC3CQnv2PMLQxKF8EDJEqY14LvWAQVXVuN,EESzw7ZdoHfCNQZkK6uivTyMzswM7HACTr2GXV8pB1pb,True,62081879,6825089,23494,11747,11747,Hu94aiQWvce6THeGyCFqGRPM1pQrK3ihzkcXo1EpJcJL,2137131,84195540,-82058409,344
2022-05-11 03:10:01-04:00,22391,DsmZLe2HbtLzrXgL9rLbwpyHKcPHDJeeNLsquACBFrsB,Dq8GXoHBnMZXvtCRpwWAUovtDSyzctutLhW1ueNAyQ4T,True,137104298,24072665,95007,47503,47504,68sueyVfmy5ToEGtLFGDkwebX47xAmzyXE29z8JrmcWv,5411108,120270332,-114859224,394
2022-05-11 03:10:05-04:00,22392,84v7qCSdhRPUMVHXyWygBut7CoSSirqkMYdbg3pXn9Ru,DyekBxbVtxFuasKAvBQBKrdN8qjiWVPdJi3n9jdaqFdF,True,1052869142,181152504,689959,344979,344980,CGtKBgcWZ6HKE3tFNLPUM9khDv2Rc7d6BrPtxz7J1aY,40100855,280943856,-240843001,380
2022-05-11 03:10:08-04:00,22393,gRV31wGMzVC3CQnv2PMLQxKF8EDJEqY14LvWAQVXVuN,EESzw7ZdoHfCNQZkK6uivTyMzswM7HACTr2GXV8pB1pb,True,55096225,6159729,21834,10917,10917,6L1WYrPiCMyi7XemPww4B4hvpKD1LQKD4RpiSKmrmgSC,1953072,82225856,-80272784,354
2022-05-11 03:10:19-04:00,22394,6K2m4zFPFjecwWFiNFYXKzwuEXV8GKxYHsq6Kcq4S4xW,GxaHi77G2tXJzhL77GiH7pgiW76H7AeBhziu6YYtU6xc,True,324378443,81094610,518138,259069,259069,8sEswn3kzEhnYjAZVvCQnHEUvYd7pFVvc2Xc2Kd1BpbC,20725549,154769907,-134044358,638
2022-05-11 03:10:22-04:00,22395,5jK6QtEYhbjoe9DbNKgiiWEjPqvCVffsxn9fzCJCzy5j,edw5fNuBKUkn1oZu3jfKez58y75ZNMaPouQNVo84qak,True,15170752,3792688,26268,13134,13134,C4UnXuShCvjSMgBAgVNMy1oakxCNk1et27A82fywU112,1050730,1879978,-829248,692
2022-05-11 03:11:51-04:00,22396,H69q3Q8E74xm7swmMQpsJLVp2Q9JuBwBbxraAMX5Drzm,5RiCCwr1YLn1136t6pprm9FAvcrJNG8VA394CYHpYbtA,True,391165863825,74839222061,374564085,187282042,187282043,8sEswn3kzEhnYjAZVvCQnHEUvYd7pFVvc2Xc2Kd1BpbC,19577526375,15424669779,4152856596,500
2022-05-11 03:11:56-04:00,22397,H69q3Q8E74xm7swmMQpsJLVp2Q9JuBwBbxraAMX5Drzm,5RiCCwr1YLn1136t6pprm9FAvcrJNG8VA394CYHpYbtA,True,316326641764,74744634492,453745656,226872828,226872828,F31bVJvHB2XkhGdgjyTim48hY2cLFEx661AiPS3SzYJ2,19202962290,18977962895,224999395,607
2022-05-11 03:12:27-04:00,22398,H69q3Q8E74xm7swmMQpsJLVp2Q9JuBwBbxraAMX5Drzm,5RiCCwr1YLn1136t6pprm9FAvcrJNG8VA394CYHpYbtA,False,248434420369,79045670189,3785267787,189263389,3596004398,GXyFXZMNk2NFyEzw6JetVqsujqcz2yCixH7n8EpDJYWD,11896803537,20992881887,-9096078350,478
2022-05-11 03:12:40-04:00,22399,G8Bnx7PhHFxsqY2KTVPpwwDWUend8DmzLNQfSaevrEDz,JCvjtN3aZsaSwQPaZcMFnQBm8NtgopQqdPa6FKrH4Bcm,True,1009726031,159913967,723700,361850,361850,2xTUy2RS74GJMMDnmFaegMzFLn19RVfYG4CibhBmjP1i,45695760,463779916,-418084156,452
2022-05-11 03:16:08-04:00,22400,DmwHBt9RS9QZesz2k6NsiC9CXCvgaGSTWycWj8nCdkC6,EEN2iGeHGY9AbsrBTgs9CFNTfdiGWymzt6VGto8ZGyfF,True,149195579092,37298894773,199407275,99703637,99703638,CGtKBgcWZ6HKE3tFNLPUM9khDv2Rc7d6BrPtxz7J1aY,7976291034,19987253415,-12010962381,534
2022-05-11 03:16:50-04:00,22401,5B3nic6AUDSiweK5kgbwd6W9DqqX9tJ1zUSQHNWPe24b,2cpauDZ4j1ACSoFfR55NNEVh9quRiVcSFF7Zq3L26U8a,True,3402495199,609407032,4244974,2122487,2122487,2a35JJeTUW1pm6M3e8DHCjp8qr4vbc2cRPhuzZWyFzYd,237009189,226164678,10844511,696
2022-05-11 03:24:39-04:00,22402,84v7qCSdhRPUMVHXyWygBut7CoSSirqkMYdbg3pXn9Ru,DyekBxbVtxFuasKAvBQBKrdN8qjiWVPdJi3n9jdaqFdF,True,880022599,82749451,343987,171993,171994,Hu94aiQWvce6THeGyCFqGRPM1pQrK3ihzkcXo1EpJcJL,36582297,283636011,-247053714,415
2022-05-11 03:27:52-04:00,22403,84v7qCSdhRPUMVHXyWygBut7CoSSirqkMYdbg3pXn9Ru,DyekBxbVtxFuasKAvBQBKrdN8qjiWVPdJi3n9jdaqFdF,True,791488974,137134833,544476,272238,272238,6L1WYrPiCMyi7XemPww4B4hvpKD1LQKD4RpiSKmrmgSC,31425054,220407738,-188982684,397
2022-05-11 03:29:08-04:00,22404,84v7qCSdhRPUMVHXyWygBut7CoSSirqkMYdbg3pXn9Ru,DyekBxbVtxFuasKAvBQBKrdN8qjiWVPdJi3n9jdaqFdF,True,651542371,59941700,251404,125702,125702,8sEswn3kzEhnYjAZVvCQnHEUvYd7pFVvc2Xc2Kd1BpbC,27326668,221121185,-193794517,419
2022-05-11 03:29:19-04:00,22405,DsmZLe2HbtLzrXgL9rLbwpyHKcPHDJeeNLsquACBFrsB,Dq8GXoHBnMZXvtCRpwWAUovtDSyzctutLhW1ueNAyQ4T,True,112302936,9834585,40172,20086,20086,C4UnXuShCvjSMgBAgVNMy1oakxCNk1et27A82fywU112,4587404,114421968,-109834564,408
2022-05-11 03:29:19-04:00,22406,gRV31wGMzVC3CQnv2PMLQxKF8EDJEqY14LvWAQVXVuN,EESzw7ZdoHfCNQZkK6uivTyMzswM7HACTr2GXV8pB1pb,True,48785664,5171689,18873,9436,9437,C4UnXuShCvjSMgBAgVNMy1oakxCNk1et27A82fywU112,1780406,69988761,-68208355,364
2022-05-11 03:29:22-04:00,22407,EYZBLUmJ6BgMFdLCxS7ZQiU93FEQvwc75RCuZM9fivW,6j3N7RjTnSPrLuThMnc4waZT4pnw3vdqy2pApgxKwWHV,True,111364845,27841211,157676,78838,78838,8sEswn3kzEhnYjAZVvCQnHEUvYd7pFVvc2Xc2Kd1BpbC,6307063,242831465,-236524402,566
2022-05-11 03:30:20-04:00,22408,EYZBLUmJ6BgMFdLCxS7ZQiU93FEQvwc75RCuZM9fivW,6j3N7RjTnSPrLuThMnc4waZT4pnw3vdqy2pApgxKwWHV,True,82436750,20609187,126562,63281,63281,F31bVJvHB2XkhGdgjyTim48hY2cLFEx661AiPS3SzYJ2,5062503,183543725,-178481222,614
2022-05-11 03:30:20-04:00,22409,84v7qCSdhRPUMVHXyWygBut7CoSSirqkMYdbg3pXn9Ru,DyekBxbVtxFuasKAvBQBKrdN8qjiWVPdJi3n9jdaqFdF,True,586913054,102813356,410472,205236,205236,5HnvdJnCCcmRsm4GkXnYWd4q9RpwuvYDGEUMPkYR3Ts9,23431933,171583926,-148151993,399
2022-05-11 03:30:21-04:00,22410,gRV31wGMzVC3CQnv2PMLQxKF8EDJEqY14LvWAQVXVuN,EESzw7ZdoHfCNQZkK6uivTyMzswM7HACTr2GXV8pB1pb,True,43470319,2372913,8831,4415,4416,5HnvdJnCCcmRsm4GkXnYWd4q9RpwuvYDGEUMPkYR3Ts9,1617877,68563103,-66945226,372
2022-05-11 03:31:06-04:00,22411,DsmZLe2HbtLzrXgL9rLbwpyHKcPHDJeeNLsquACBFrsB,Dq8GXoHBnMZXvtCRpwWAUovtDSyzctutLhW1ueNAyQ4T,True,101872254,18212061,70635,35317,35318,Hu94aiQWvce6THeGyCFqGRPM1pQrK3ihzkcXo1EpJcJL,3951135,91052071,-87100936,387
2022-05-11 03:31:11-04:00,22412,84v7qCSdhRPUMVHXyWygBut7CoSSirqkMYdbg3pXn9Ru,DyekBxbVtxFuasKAvBQBKrdN8qjiWVPdJi3n9jdaqFdF,True,478429012,42529262,156514,78257,78257,6L1WYrPiCMyi7XemPww4B4hvpKD1LQKD4RpiSKmrmgSC,17606991,172149997,-154543006,368
2022-05-11 03:31:11-04:00,22413,gRV31wGMzVC3CQnv2PMLQxKF8EDJEqY14LvWAQVXVuN,EESzw7ZdoHfCNQZkK6uivTyMzswM7HACTr2GXV8pB1pb,True,40866150,4620464,15577,7788,7789,C4UnXuShCvjSMgBAgVNMy1oakxCNk1et27A82fywU112,1377790,62038446,-60660656,337
2022-05-11 03:31:11-04:00,22414,DsmZLe2HbtLzrXgL9rLbwpyHKcPHDJeeNLsquACBFrsB,Dq8GXoHBnMZXvtCRpwWAUovtDSyzctutLhW1ueNAyQ4T,True,82836445,7050064,26015,13007,13008,6L1WYrPiCMyi7XemPww4B4hvpKD1LQKD4RpiSKmrmgSC,3056752,86823804,-83767052,369
2022-05-11 03:31:11-04:00,22415,EYZBLUmJ6BgMFdLCxS7ZQiU93FEQvwc75RCuZM9fivW,6j3N7RjTnSPrLuThMnc4waZT4pnw3vdqy2pApgxKwWHV,False,59875841,59875841,2984219,149210,2835009,3zqXX6kzhkbW3d4TwD2CNjMRwxTbREXySekvq37kfCNk,2984219,138797438,-135813219,498
2022-05-11 03:31:13-04:00,22416,84v7qCSdhRPUMVHXyWygBut7CoSSirqkMYdbg3pXn9Ru,DyekBxbVtxFuasKAvBQBKrdN8qjiWVPdJi3n9jdaqFdF,True,435524268,77077990,302188,151094,151094,2a35JJeTUW1pm6M3e8DHCjp8qr4vbc2cRPhuzZWyFzYd,17074995,132600819,-115525824,392
2022-05-11 03:31:19-04:00,22417,DsmZLe2HbtLzrXgL9rLbwpyHKcPHDJeeNLsquACBFrsB,Dq8GXoHBnMZXvtCRpwWAUovtDSyzctutLhW1ueNAyQ4T,True,75693907,13653532,52999,26499,26500,2a35JJeTUW1pm6M3e8DHCjp8qr4vbc2cRPhuzZWyFzYd,2938263,68974560,-66036297,388
2022-05-11 03:31:49-04:00,22418,gRV31wGMzVC3CQnv2PMLQxKF8EDJEqY14LvWAQVXVuN,EESzw7ZdoHfCNQZkK6uivTyMzswM7HACTr2GXV8pB1pb,True,36073018,5552950,18310,9155,9155,5HnvdJnCCcmRsm4GkXnYWd4q9RpwuvYDGEUMPkYR3Ts9,1189545,52862084,-51672539,329
2022-05-11 03:37:54-04:00,22419,DsmZLe2HbtLzrXgL9rLbwpyHKcPHDJeeNLsquACBFrsB,Dq8GXoHBnMZXvtCRpwWAUovtDSyzctutLhW1ueNAyQ4T,True,61668911,5243397,21373,10686,10687,5HnvdJnCCcmRsm4GkXnYWd4q9RpwuvYDGEUMPkYR3Ts9,2513800,65797722,-63283922,407
2022-05-11 03:38:05-04:00,22420,cRuyjKev4AyNm2KjgTRQmicTEN5Fbp8whpuPj9VrkfW,3ckLGaEeLxLjBP5FGQhraSnPiFN751CnEp8urmF68BCv,False,3778576,3778576,235246,11762,223484,2a35JJeTUW1pm6M3e8DHCjp8qr4vbc2cRPhuzZWyFzYd,235246,7495554,-7260308,622
2022-05-11 03:38:32-04:00,22421,gRV31wGMzVC3CQnv2PMLQxKF8EDJEqY14LvWAQVXVuN,EESzw7ZdoHfCNQZkK6uivTyMzswM7HACTr2GXV8pB1pb,False,30303987,30303987,955152,47757,907395,6L1WYrPiCMyi7XemPww4B4hvpKD1LQKD4RpiSKmrmgSC,955154,46796303,-45841149,315
2022-05-11 03:38:36-04:00,22422,84v7qCSdhRPUMVHXyWygBut7CoSSirqkMYdbg3pXn9Ru,DyekBxbVtxFuasKAvBQBKrdN8qjiWVPdJi3n9jdaqFdF,True,351455920,30585725,122048,61024,61024,2a35JJeTUW1pm6M3e8DHCjp8qr4vbc2cRPhuzZWyFzYd,14024361,133060440,-119036079,399
2022-05-11 03:38:40-04:00,22423,DsmZLe2HbtLzrXgL9rLbwpyHKcPHDJeeNLsquACBFrsB,Dq8GXoHBnMZXvtCRpwWAUovtDSyzctutLhW1ueNAyQ4T,True,55708162,13927040,44375,22187,22188,2a35JJeTUW1pm6M3e8DHCjp8qr4vbc2cRPhuzZWyFzYd,1775075,52364742,-50589667,318
2022-05-11 03:39:12-04:00,22424,84v7qCSdhRPUMVHXyWygBut7CoSSirqkMYdbg3pXn9Ru,DyekBxbVtxFuasKAvBQBKrdN8qjiWVPdJi3n9jdaqFdF,True,315646776,78911694,246636,123318,123318,F31bVJvHB2XkhGdgjyTim48hY2cLFEx661AiPS3SzYJ2,9865512,102081989,-92216477,312
2022-05-11 03:39:12-04:00,22425,DsmZLe2HbtLzrXgL9rLbwpyHKcPHDJeeNLsquACBFrsB,Dq8GXoHBnMZXvtCRpwWAUovtDSyzctutLhW1ueNAyQ4T,True,41206068,10301517,28890,14445,14445,C4UnXuShCvjSMgBAgVNMy1oakxCNk1et27A82fywU112,1155646,39673047,-38517401,280
2022-05-11 03:39:23-04:00,22426,DsmZLe2HbtLzrXgL9rLbwpyHKcPHDJeeNLsquACBFrsB,Dq8GXoHBnMZXvtCRpwWAUovtDSyzctutLhW1ueNAyQ4T,False,30764433,30764433,986637,49331,937306,2a35JJeTUW1pm6M3e8DHCjp8qr4vbc2cRPhuzZWyFzYd,986638,30014861,-29028223,320
2022-05-11 03:39:50-04:00,22427,14ZiR6zzBL8mCCLvyaDXKK9u8CfKwmmJNRJq858iM6ih,H6VJf1HzEWoQEFgSqpLHzMnRPhQ7uNBNtd98srXhv4n7,False,1132647610,1132647610,38295044,1914752,36380292,4yhyLx1phodwcvvwVU2bramHcdbJYvfadd7pANsRzX8M,38295044,1351941993,-1313646949,338
2022-05-11 03:39:55-04:00,22428,84v7qCSdhRPUMVHXyWygBut7CoSSirqkMYdbg3pXn9Ru,DyekBxbVtxFuasKAvBQBKrdN8qjiWVPdJi3n9jdaqFdF,True,233486567,42530335,162248,81124,81124,C4UnXuShCvjSMgBAgVNMy1oakxCNk1et27A82fywU112,8907241,78783580,-69876339,381
2022-05-11 03:40:14-04:00,22429,G8Bnx7PhHFxsqY2KTVPpwwDWUend8DmzLNQfSaevrEDz,JCvjtN3aZsaSwQPaZcMFnQBm8NtgopQqdPa6FKrH4Bcm,True,845469356,53327318,256266,128133,128133,F31bVJvHB2XkhGdgjyTim48hY2cLFEx661AiPS3SzYJ2,40629352,400698734,-360069382,480
2022-05-11 03:41:32-04:00,22430,EMo1TMUMVTuVSpqQGTRNzUvFV5abe3zdNF8sFfQh93Xp,CfnRCCiiwm2GXmbkevHCcKCNWWqTxdciMZGBAiLShzrn,True,1735745672,433936418,2585763,1292881,1292882,2py1FiYeL2f7J3HU36qiJz6TD6HCmiTN36RyxYtapQCZ,103430533,2996327579,-2892897046,595
2022-05-11 03:41:39-04:00,22431,5FewDaMC9U7n5EHcto98GaAmDVxDh5SYimuTP6AtfakM,7DAULUoqV7f9hsBzKEhjQPnWaHSqiMWcBqWcdcadaQv4,True,17341119,4335279,26713,13356,13357,2a35JJeTUW1pm6M3e8DHCjp8qr4vbc2cRPhuzZWyFzYd,1068558,6843330,-5774772,616
2022-05-11 03:43:53-04:00,22432,EyNCsqWu8zLyuRnXSbzJWnWZg7ZLjb4oJSZFdDSkbXmT,6rMMMkZibUHXYs8hXY3FmG4rgBx6gWDRGJwR2bP2t6ZD,True,2513626534,444451669,1763182,881591,881591,6UQfSsLooL4pQKQfLtXCutQS2BnF7A7F7ewJopDLmUpc,99718007,851603549,-751885542,396
2022-05-11 03:44:40-04:00,22433,DrzqXAjzHcaTgAtbwkTjLAS8vw9faqAKn6n1K3rKRU83,BHD9PTJE9ZwMc6wjsMcV3z9ojfqhjqHEdsLWYPRAJ1jx,True,1045661468,261415367,1331511,665755,665756,C4UnXuShCvjSMgBAgVNMy1oakxCNk1et27A82fywU112,53260440,99003139,-45742699,509
2022-05-11 03:44:40-04:00,22434,86m3EiaumoL7jF7WTjuZ7hSQgpt4wBpVEZCDg4rSUjdZ,CZempUmBagER6i7wNcwVATVZxBnM3YEkVXQe6RnTfkZM,False,4203868361,4203868361,202637027,10131851,192505176,C4UnXuShCvjSMgBAgVNMy1oakxCNk1et27A82fywU112,202637027,397988360,-195351333,482
2022-05-11 03:44:40-04:00,22435,5BGPpyb8KHRgebUyoV1h6DwXCszgzQCL9N8osisfSpRt,Ci1u2V8Zfx7AsbnkuoftH7A4iAj3EMczVqvPTeRXwP9R,False,221660759,221660759,11017135,550856,10466279,5HnvdJnCCcmRsm4GkXnYWd4q9RpwuvYDGEUMPkYR3Ts9,11017135,21320838,-10303703,497
2022-05-11 03:45:28-04:00,22436,8DSiP9CwJm3AEcH6uuAYFpArRRDLYpDQgjHEvjkUgfg2,ERJ8kuhPRRmUAhSM4oxUheh39YUVVYNgaTt6AdMXcCvL,True,330473561,82618390,250312,125156,125156,F31bVJvHB2XkhGdgjyTim48hY2cLFEx661AiPS3SzYJ2,10012489,50706924,-40694435,302
2022-05-11 03:50:50-04:00,22437,DrzqXAjzHcaTgAtbwkTjLAS8vw9faqAKn6n1K3rKRU83,BHD9PTJE9ZwMc6wjsMcV3z9ojfqhjqHEdsLWYPRAJ1jx,True,792992681,198248170,1079558,539779,539779,AmTrMPzuTp2BjnjqGNKqz9FTTCdpoKcPAJLwFc8ozcbh,43182349,86264979,-43082630,544
2022-05-11 03:52:43-04:00,22438,FMdKLXhQEnNJtvM17ZX8jhaeMaSD9UgDuN3Kw7kMrd7K,5pURHYWB5LUGwJmWVBGH8p6oyR9NJvXnZk7uDVoiassv,True,2890490538,722622634,2188941,1094470,1094471,2a35JJeTUW1pm6M3e8DHCjp8qr4vbc2cRPhuzZWyFzYd,87557679,371599445,-284041766,302
2022-05-11 03:54:06-04:00,22439,DrzqXAjzHcaTgAtbwkTjLAS8vw9faqAKn6n1K3rKRU83,BHD9PTJE9ZwMc6wjsMcV3z9ojfqhjqHEdsLWYPRAJ1jx,True,602495735,150623933,858789,429394,429395,5HnvdJnCCcmRsm4GkXnYWd4q9RpwuvYDGEUMPkYR3Ts9,34351567,74431180,-40079613,570
2022-05-11 03:55:38-04:00,22440,DrzqXAjzHcaTgAtbwkTjLAS8vw9faqAKn6n1K3rKRU83,BHD9PTJE9ZwMc6wjsMcV3z9ojfqhjqHEdsLWYPRAJ1jx,False,462646429,462646429,22718151,1135907,21582244,5HnvdJnCCcmRsm4GkXnYWd4q9RpwuvYDGEUMPkYR3Ts9,22718151,63561782,-40843631,491
2022-05-11 04:00:20-04:00,22441,6kbTnDL9xhi1YvPLtFvRmk8aE1HWsxNAEALcQ9kdCJQW,3Z1kmT8dUJJTUqbrCWGSBqV12GHhzcs3ZGKwaXP8gpGW,True,10043449381,2510862345,14703106,7351553,7351553,GXyFXZMNk2NFyEzw6JetVqsujqcz2yCixH7n8EpDJYWD,588124271,1275646641,-687522370,585
2022-05-11 04:00:20-04:00,22442,8T4WK27RvWVGqPuNqY6whk1fmU4vd5qaUQPZG1GJ79bh,DvSz7knS8N3K7L6JhQf1s4mJSyxB8uJXNQXtyjJn8QRL,False,640875534,640875534,16170819,808540,15362279,A2p75MbAbeUdHkPLkAjgGeiwuu9WPrkMHzjCkDXF1Xr3,16170819,64407363,-48236544,252
2022-05-11 04:00:23-04:00,22443,Cb6MEn1MN9XQcVVd3o9J8QdK3cFWxSNETsFzhVJ8jmdh,A6yTKbggUftjbjAVu5YR1M7rg7h78ghbfofmTSnmKNGz,False,5708044380,5708044380,77268042,3863402,73404640,F31bVJvHB2XkhGdgjyTim48hY2cLFEx661AiPS3SzYJ2,77268042,345148573,-267880531,135
2022-05-11 04:00:56-04:00,22444,6kbTnDL9xhi1YvPLtFvRmk8aE1HWsxNAEALcQ9kdCJQW,3Z1kmT8dUJJTUqbrCWGSBqV12GHhzcs3ZGKwaXP8gpGW,True,7649250207,1912312551,11418949,5709474,5709475,72XWPCtRYEDZbddP7d6dHtUBRRDLSJsB2xZTAfefoEVZ,456757994,1091543564,-634785570,597
2022-05-11 04:00:57-04:00,22445,E17ZhGtTSwrU7xk8TMY9QvaBnktXnsRUrYeLQ5qNEJRp,A8UbD1ycKDGChJaK886FA4611RWDAW5cbU63siqiJWb1,True,1402687131,350671782,2127085,1063542,1063543,2xTUy2RS74GJMMDnmFaegMzFLn19RVfYG4CibhBmjP1i,85083439,206716278,-121632839,606
2022-05-11 04:01:22-04:00,22446,6kbTnDL9xhi1YvPLtFvRmk8aE1HWsxNAEALcQ9kdCJQW,3Z1kmT8dUJJTUqbrCWGSBqV12GHhzcs3ZGKwaXP8gpGW,True,5857310949,1464327737,8124143,4062071,4062072,gjBMZYVujDjD1ECG4i97M8Q3gV9ESnwwTSUGropkusj,324965752,922833469,-597867717,554
2022-05-11 04:01:22-04:00,22447,E17ZhGtTSwrU7xk8TMY9QvaBnktXnsRUrYeLQ5qNEJRp,A8UbD1ycKDGChJaK886FA4611RWDAW5cbU63siqiJWb1,True,1074411220,268602805,1514012,757006,757006,F31bVJvHB2XkhGdgjyTim48hY2cLFEx661AiPS3SzYJ2,60560483,174228042,-113667559,563
2022-05-11 04:01:34-04:00,22448,G8Bnx7PhHFxsqY2KTVPpwwDWUend8DmzLNQfSaevrEDz,JCvjtN3aZsaSwQPaZcMFnQBm8NtgopQqdPa6FKrH4Bcm,True,786284317,119855161,526125,263062,263063,2xTUy2RS74GJMMDnmFaegMzFLn19RVfYG4CibhBmjP1i,34515365,382495994,-347980629,438
2022-05-11 04:04:23-04:00,22449,DmwHBt9RS9QZesz2k6NsiC9CXCvgaGSTWycWj8nCdkC6,EEN2iGeHGY9AbsrBTgs9CFNTfdiGWymzt6VGto8ZGyfF,True,174348222761,43587055690,261367864,130683932,130683932,GXyFXZMNk2NFyEzw6JetVqsujqcz2yCixH7n8EpDJYWD,10454714569,17203919476,-6749204907,599
2022-05-11 04:04:24-04:00,22450,6kbTnDL9xhi1YvPLtFvRmk8aE1HWsxNAEALcQ9kdCJQW,3Z1kmT8dUJJTUqbrCWGSBqV12GHhzcs3ZGKwaXP8gpGW,False,4540078862,4540078862,169745959,8487297,161258662,2a35JJeTUW1pm6M3e8DHCjp8qr4vbc2cRPhuzZWyFzYd,169745959,766040726,-596294767,373
2022-05-11 04:12:42-04:00,22451,DmwHBt9RS9QZesz2k6NsiC9CXCvgaGSTWycWj8nCdkC6,EEN2iGeHGY9AbsrBTgs9CFNTfdiGWymzt6VGto8ZGyfF,True,133604181235,33401045308,183758313,91879156,91879157,AwTjKt2cvuznxP1kuaFvGoVmtp8aLdRQPjhnzWqDPFax,7350332541,16000125213,-8649792672,550
2022-05-11 04:12:44-04:00,22452,DmwHBt9RS9QZesz2k6NsiC9CXCvgaGSTWycWj8nCdkC6,EEN2iGeHGY9AbsrBTgs9CFNTfdiGWymzt6VGto8ZGyfF,True,101056075251,25264018812,157840872,78920436,78920436,DQCvC9mR68hJ3tJsUiddh6JwcBJAmntqGJR2nUsEq7yj,6313634904,14073088306,-7759453402,624
2022-05-11 04:12:54-04:00,22453,DmwHBt9RS9QZesz2k6NsiC9CXCvgaGSTWycWj8nCdkC6,EEN2iGeHGY9AbsrBTgs9CFNTfdiGWymzt6VGto8ZGyfF,True,77328449266,19332112316,115485030,57742515,57742515,AwTjKt2cvuznxP1kuaFvGoVmtp8aLdRQPjhnzWqDPFax,4619401205,12210324440,-7590923235,597
2022-05-11 04:12:56-04:00,22454,H69q3Q8E74xm7swmMQpsJLVp2Q9JuBwBbxraAMX5Drzm,5RiCCwr1YLn1136t6pprm9FAvcrJNG8VA394CYHpYbtA,True,243291665252,50520478502,182461145,91230572,91230573,3zqXX6kzhkbW3d4TwD2CNjMRwxTbREXySekvq37kfCNk,8786788559,33000709275,-24213920716,361
2022-05-11 04:12:56-04:00,22455,DmwHBt9RS9QZesz2k6NsiC9CXCvgaGSTWycWj8nCdkC6,EEN2iGeHGY9AbsrBTgs9CFNTfdiGWymzt6VGto8ZGyfF,True,59069915917,14767478979,85758430,42879215,42879215,GXyFXZMNk2NFyEzw6JetVqsujqcz2yCixH7n8EpDJYWD,3430337208,10329816242,-6899479034,580
2022-05-11 04:12:57-04:00,22456,H69q3Q8E74xm7swmMQpsJLVp2Q9JuBwBbxraAMX5Drzm,5RiCCwr1YLn1136t6pprm9FAvcrJNG8VA394CYHpYbtA,True,193359670710,38037479867,157686699,78843349,78843350,DA18qE9qesbBqpwNv1M4befYcNQkbSBSeLPTmQzrmbJw,8015843454,27677603556,-19661760102,414
2022-05-11 04:13:03-04:00,22457,Eo8sVTRFjtsTMBjKmXR4DWDgX7xoDwVsSXTrC4a6UQDd,FVgudMu9cVNFrQn2oE7QLcZPDeCe2Tdr4CShKZojGddU,False,132751977,132751977,5987737,299386,5688351,6L1WYrPiCMyi7XemPww4B4hvpKD1LQKD4RpiSKmrmgSC,5987737,37113866,-31126129,451
2022-05-11 04:16:23-04:00,22458,DmwHBt9RS9QZesz2k6NsiC9CXCvgaGSTWycWj8nCdkC6,EEN2iGeHGY9AbsrBTgs9CFNTfdiGWymzt6VGto8ZGyfF,True,44877585864,11219396466,69235746,34617873,34617873,HPeUprrN3igyQFZ1vsmFsp19rGXeiUY8tuqHrZnBoV1J,2769429852,8594191273,-5824761421,617
2022-05-11 04:23:23-04:00,22459,F16NiKzmgm5jDHZpcUhScqWEDzyPbFCNG6jhJJQ5foXf,8d1ouNJkdUW2T47DJY1G5h895vhgHFuqZ4bqMjnE38YR,False,1071718454,1071718454,26879519,1343975,25535544,2a35JJeTUW1pm6M3e8DHCjp8qr4vbc2cRPhuzZWyFzYd,26879519,99000403,-72120884,250
2022-05-11 04:35:06-04:00,22460,EMo1TMUMVTuVSpqQGTRNzUvFV5abe3zdNF8sFfQh93Xp,CfnRCCiiwm2GXmbkevHCcKCNWWqTxdciMZGBAiLShzrn,True,1280897956,320224489,1998336,999168,999168,8HQmsTbxhLhy25fvfCb16HudTGQ9wkHoEBRz5WYeqiZw,79933472,2270612621,-2190679149,624
2022-05-11 04:39:40-04:00,22461,26wo1RqwKXrNnfgMdZEmkGhnDbURpZcp2hasB5EA5QtD,34gwTVGRrdoaBzLUG6SBwRwBovkjBjCebqVUBan6GDnB,True,4433566808,1108391702,7854980,3927490,3927490,AwTjKt2cvuznxP1kuaFvGoVmtp8aLdRQPjhnzWqDPFax,314199209,1966467061,-1652267852,708
2022-05-11 04:45:40-04:00,22462,5FewDaMC9U7n5EHcto98GaAmDVxDh5SYimuTP6AtfakM,7DAULUoqV7f9hsBzKEhjQPnWaHSqiMWcBqWcdcadaQv4,False,12759556,12759556,795561,39778,755783,5HnvdJnCCcmRsm4GkXnYWd4q9RpwuvYDGEUMPkYR3Ts9,795561,5372930,-4577369,623
2022-05-11 05:07:45-04:00,22463,EMo1TMUMVTuVSpqQGTRNzUvFV5abe3zdNF8sFfQh93Xp,CfnRCCiiwm2GXmbkevHCcKCNWWqTxdciMZGBAiLShzrn,True,942782494,235695623,1472975,736487,736488,AmTrMPzuTp2BjnjqGNKqz9FTTCdpoKcPAJLwFc8ozcbh,58919025,1719872406,-1660953381,624
2022-05-11 05:24:46-04:00,22464,84v7qCSdhRPUMVHXyWygBut7CoSSirqkMYdbg3pXn9Ru,DyekBxbVtxFuasKAvBQBKrdN8qjiWVPdJi3n9jdaqFdF,True,202849348,17284455,70770,35385,35385,8sEswn3kzEhnYjAZVvCQnHEUvYd7pFVvc2Xc2Kd1BpbC,8305564,79782433,-71476869,409
2022-05-11 05:26:30-04:00,22465,84v7qCSdhRPUMVHXyWygBut7CoSSirqkMYdbg3pXn9Ru,DyekBxbVtxFuasKAvBQBKrdN8qjiWVPdJi3n9jdaqFdF,True,185236035,33521269,129549,64774,64775,C4UnXuShCvjSMgBAgVNMy1oakxCNk1et27A82fywU112,7158832,62434444,-55275612,386
2022-05-11 05:29:22-04:00,22466,84v7qCSdhRPUMVHXyWygBut7CoSSirqkMYdbg3pXn9Ru,DyekBxbVtxFuasKAvBQBKrdN8qjiWVPdJi3n9jdaqFdF,True,151426443,12632135,50659,25329,25330,F31bVJvHB2XkhGdgjyTim48hY2cLFEx661AiPS3SzYJ2,6072774,61620386,-55547612,401
2022-05-11 05:33:21-04:00,22467,29hcg7nN7unogHZTe72dL9C6SSG2hGbMtmK9egS7guub,B2y9KwPJe964UBYqfpMP3q6sRLBpvsT3xR5RwGGL7L2f,True,18152397236,4538099309,13721979,6860989,6860990,DQCvC9mR68hJ3tJsUiddh6JwcBJAmntqGJR2nUsEq7yj,548879160,588377435,-39498275,302
2022-05-11 05:33:33-04:00,22468,7agvoo7kQa27Gx8Vn4fr3PMZBeXSW3tSrg8DFCnLZAh3,5nFTJaKiqFRNxicLeyxywDgmasU97xtnZSRz8Dy8HpAd,True,246875028,61718756,155593,77796,77797,8sEswn3kzEhnYjAZVvCQnHEUvYd7pFVvc2Xc2Kd1BpbC,6223788,2108945,4114843,252
2022-05-11 05:33:34-04:00,22469,CmMkpR7Yewedgu4GvLCZAFKdGj19ex69w4EhCQ58i25o,5QWRVRgDMHoincpRD981hPaPsYhGGZnkRVYxtDDYYGLc,True,337951761,84487940,204633,102316,102317,Hu94aiQWvce6THeGyCFqGRPM1pQrK3ihzkcXo1EpJcJL,8185378,3415694,4769684,242
2022-05-11 05:33:36-04:00,22470,84v7qCSdhRPUMVHXyWygBut7CoSSirqkMYdbg3pXn9Ru,DyekBxbVtxFuasKAvBQBKrdN8qjiWVPdJi3n9jdaqFdF,True,140608646,25588057,89675,44837,44838,8sEswn3kzEhnYjAZVvCQnHEUvYd7pFVvc2Xc2Kd1BpbC,4927795,48280487,-43352692,350
2022-05-11 05:34:09-04:00,22471,29hcg7nN7unogHZTe72dL9C6SSG2hGbMtmK9egS7guub,B2y9KwPJe964UBYqfpMP3q6sRLBpvsT3xR5RwGGL7L2f,True,13804490337,3451122584,8624119,4312059,4312060,AmTrMPzuTp2BjnjqGNKqz9FTTCdpoKcPAJLwFc8ozcbh,344964771,567882990,-222918219,249
2022-05-11 05:35:23-04:00,22472,84v7qCSdhRPUMVHXyWygBut7CoSSirqkMYdbg3pXn9Ru,DyekBxbVtxFuasKAvBQBKrdN8qjiWVPdJi3n9jdaqFdF,True,113855239,9368150,36498,18249,18249,68sueyVfmy5ToEGtLFGDkwebX47xAmzyXE29z8JrmcWv,4435838,47230061,-42794223,389
2022-05-11 05:36:12-04:00,22473,84v7qCSdhRPUMVHXyWygBut7CoSSirqkMYdbg3pXn9Ru,DyekBxbVtxFuasKAvBQBKrdN8qjiWVPdJi3n9jdaqFdF,True,104070540,19096998,72887,36443,36444,Hu94aiQWvce6THeGyCFqGRPM1pQrK3ihzkcXo1EpJcJL,3972083,37120616,-33148533,381
2022-05-11 05:38:05-04:00,22474,84v7qCSdhRPUMVHXyWygBut7CoSSirqkMYdbg3pXn9Ru,DyekBxbVtxFuasKAvBQBKrdN8qjiWVPdJi3n9jdaqFdF,True,84318224,14307505,57112,28556,28556,8sEswn3kzEhnYjAZVvCQnHEUvYd7pFVvc2Xc2Kd1BpbC,3365826,36421059,-33055233,399
2022-05-11 05:38:42-04:00,22475,84v7qCSdhRPUMVHXyWygBut7CoSSirqkMYdbg3pXn9Ru,DyekBxbVtxFuasKAvBQBKrdN8qjiWVPdJi3n9jdaqFdF,True,70219794,6746352,27804,13902,13902,2a35JJeTUW1pm6M3e8DHCjp8qr4vbc2cRPhuzZWyFzYd,2894051,35909103,-33015052,412
2022-05-11 05:45:36-04:00,22476,84v7qCSdhRPUMVHXyWygBut7CoSSirqkMYdbg3pXn9Ru,DyekBxbVtxFuasKAvBQBKrdN8qjiWVPdJi3n9jdaqFdF,True,62494954,10744133,41319,20659,20660,2a35JJeTUW1pm6M3e8DHCjp8qr4vbc2cRPhuzZWyFzYd,2403461,28046791,-25643330,384
2022-05-11 05:46:28-04:00,22477,84v7qCSdhRPUMVHXyWygBut7CoSSirqkMYdbg3pXn9Ru,DyekBxbVtxFuasKAvBQBKrdN8qjiWVPdJi3n9jdaqFdF,True,51502936,4816921,19720,9860,9860,5HnvdJnCCcmRsm4GkXnYWd4q9RpwuvYDGEUMPkYR3Ts9,2108555,27650787,-25542232,409
2022-05-11 05:47:50-04:00,22478,84v7qCSdhRPUMVHXyWygBut7CoSSirqkMYdbg3pXn9Ru,DyekBxbVtxFuasKAvBQBKrdN8qjiWVPdJi3n9jdaqFdF,True,46531506,8078608,30833,15416,15417,Hu94aiQWvce6THeGyCFqGRPM1pQrK3ihzkcXo1EpJcJL,1775962,21512322,-19736360,381
2022-05-11 05:48:50-04:00,22479,84v7qCSdhRPUMVHXyWygBut7CoSSirqkMYdbg3pXn9Ru,DyekBxbVtxFuasKAvBQBKrdN8qjiWVPdJi3n9jdaqFdF,True,38404847,3526717,14442,7221,7221,2a35JJeTUW1pm6M3e8DHCjp8qr4vbc2cRPhuzZWyFzYd,1572772,21194940,-19622168,409
2022-05-09 19:47:08-04:00,21456,26wo1RqwKXrNnfgMdZEmkGhnDbURpZcp2hasB5EA5QtD,34gwTVGRrdoaBzLUG6SBwRwBovkjBjCebqVUBan6GDnB,True,155873004,38968251,277413,138706,138707,F31bVJvHB2XkhGdgjyTim48hY2cLFEx661AiPS3SzYJ2,11096557,147152695,-136056138,711
2022-05-09 19:47:42-04:00,21457,CS7E1f7LjgmwFUs85CMG45Q6qDy9NqmuGfJywfjjrf1U,Bem68iukByPcPpgzi63FufEhjTigKkPeeW2gY4o8zK2Z,True,231380437,57845109,354588,177294,177294,47z82br5WdW2DZajdnPDPSSRRKsyAggqXqK6oPUwTaLf,14183538,133587651,-119404113,612
2022-05-09 19:47:42-04:00,21458,3wr6taSTMEdDKUej5NWod2uGUC4wutem5dKJjEgEZntD,E3cAAUyuDQT2hSxLG6fhyCxkPPUAMp2xyaDLFtbnxBzQ,False,14909093,14909093,811906,40595,771311,47z82br5WdW2DZajdnPDPSSRRKsyAggqXqK6oPUwTaLf,811907,18599621,-17787714,544
2022-05-09 19:47:54-04:00,21459,75fFExuVbQ6dKrSdQK13NMMN1ZoGbaEXUpR8Yfr6ruTG,55Qjxz3zoBnt3sfFEHsyoC4HJVqEHZxcnRCAggVTiAcx,True,42049112,3082886,14165,7082,7083,3zqXX6kzhkbW3d4TwD2CNjMRwxTbREXySekvq37kfCNk,1932095,29893564,-27961469,459
2022-05-09 19:48:03-04:00,21460,Y3bqEwy46XfvKCYHYnEdBqsUAVMBRfq5qLtmvEA6Kb1,GCDPpvCjwjBJp8VZ4hTmnmeG3uVny1PcAmKQKCXHw3nV,True,36369569,2044250,8887,4443,4444,6L1WYrPiCMyi7XemPww4B4hvpKD1LQKD4RpiSKmrmgSC,1581178,26461722,-24880544,434
2022-05-09 19:48:03-04:00,21461,6UFULv9vPhgoU3TVW93BuP8fggZfGr9tiTPn11RR4Q5W,YftZrJvp8rmuHQP4LKKU48pqAraSnn9JeuH82rdV1CS,True,25263434,1115361,4538,2269,2269,3zqXX6kzhkbW3d4TwD2CNjMRwxTbREXySekvq37kfCNk,1027932,15842166,-14814234,406
2022-05-09 19:48:10-04:00,21462,626imJVkBoi7gjfXHtRi6yqrVTe8NX14gGDSyp8RDw9X,MLReNhLhuDBNRfMAXG6UKvjiuqkqGo1yQkR55YmNa2e,True,27077077,2663214,10911,5455,5456,Hu94aiQWvce6THeGyCFqGRPM1pQrK3ihzkcXo1EpJcJL,1109403,18719935,-17610532,409
2022-05-09 19:48:12-04:00,21463,E6naKBMrPoQXUx76w4t88u2DYhqyPSqp7u8h2xF5p7xm,Eg7ZTk4aG8BzNTNQxX2ae5c1HLeW5AHe8aTY97nA3gJv,True,42055694,3083432,13995,6997,6998,3zqXX6kzhkbW3d4TwD2CNjMRwxTbREXySekvq37kfCNk,1908920,29853322,-27944402,453
2022-05-09 19:48:38-04:00,21464,7bTEcer5k6PypbgPJEFqpTJgiwhU4oJARe4ioWYPy4na,Gu3g7ghunEhPxMPaFQ5r9BC4ZYLAXXmLkSUCuUTn1g7o,True,36333277,2040877,8894,4447,4447,47z82br5WdW2DZajdnPDPSSRRKsyAggqXqK6oPUwTaLf,1583512,26500380,-24916868,435
2022-05-09 19:49:02-04:00,21465,AzBK36Qny8VFVN6jFg8CBGsRU2FbdZYDMsgbJeRfZjRs,GSZ8veMKWDmYpAkZxtDL6DLreo9R6d7YhyGix4a6TgBJ,True,38852531,2305980,10266,5133,5133,72FwbpFGoLEazJEdpqNtPNefsadUrimUqma9wSoy4qiS,1729680,27877250,-26147570,445
2022-05-09 19:49:11-04:00,21466,5NVUmWQ4tXMta2VUoT2aw8bom8J2kaDTkzFFMWdvssP,9Mymya4ELvhhSM8EY8zmJTSGpB9aRoAEAnVhhRQoBZQJ,False,24160965,24160965,967427,48371,919056,3zqXX6kzhkbW3d4TwD2CNjMRwxTbREXySekvq37kfCNk,967429,14076216,-13108787,400
2022-05-09 19:49:12-04:00,21467,FVh55WrtFnwBDuf7cWHsATb8xFAGUiQs32bXQC7149Zr,EnpDNgzGrv9MjyztiMFiu2s4iAtMs13FEji5wT15YswX,True,25304738,1111563,4511,2255,2256,3zqXX6kzhkbW3d4TwD2CNjMRwxTbREXySekvq37kfCNk,1026970,15800164,-14773194,405
2022-05-09 19:49:12-04:00,21468,AhY1PdmLDeoiTjkMtetrNLLiaMsZKyrZQa1tTHw7qP1s,HcfVPu7sGkjvkRGV3FjaFUumNRw2cTYwpPSKLs9sc92M,True,24357222,1266732,5371,2685,2686,3zqXX6kzhkbW3d4TwD2CNjMRwxTbREXySekvq37kfCNk,1032954,17609154,-16576200,424
2022-05-09 19:49:13-04:00,21469,39AUegfuRbQqgyv5bCyDZ7HWiWBYUdUHJU5qoTJ6Nddy,DqBM1e2yjbCrASQiCPnA9sWT7RJwZL5CdVRacZcoSpm9,False,24122022,24122022,967008,48350,918658,3zqXX6kzhkbW3d4TwD2CNjMRwxTbREXySekvq37kfCNk,967010,14110700,-13143690,400
2022-05-09 19:49:24-04:00,21470,8ZsXyXgAV71qRor7YWFC8zMntN73XWm7GhTkE7XgV7Rq,D4QLFpaaetu9TcVxQH9j9WAXK7ZVKKLnW6KtHK6W9MZ9,True,36273771,2028742,8517,4258,4259,3zqXX6kzhkbW3d4TwD2CNjMRwxTbREXySekvq37kfCNk,1522944,26499288,-24976344,419
2022-05-09 19:49:24-04:00,21471,HBoZDxz6Qw1RQrDTtJWdNe9VHsS4v9js5EQS2PrUebAP,rkzyBzM1cS25cKStjD9884RsYgJTAsSp9smJtwLVumd,False,23036312,23036312,956100,47805,908295,6L1WYrPiCMyi7XemPww4B4hvpKD1LQKD4RpiSKmrmgSC,956102,16747997,-15791895,415
2022-05-09 19:49:26-04:00,21472,9cE3sPydeiFpAZajTK8ewa8pQLT5MvQPemwrHJUyzH1C,2XB63S8WX5FWQYTKuDrq75aMFVHZ3KCuZDiP5Cy95VPe,True,420489582,105122395,618437,309218,309219,6UQfSsLooL4pQKQfLtXCutQS2BnF7A7F7ewJopDLmUpc,24737490,154314907,-129577417,588
2022-05-09 19:49:26-04:00,21473,DKHnugPqCk62V5SC2BLqYJ6CrUFkZe3X45DM3PncjfrV,5Wk61GCcKBBfx2EtcBvKUaMtQKFSJUBBDsWbonTvcun1,True,41957268,3064976,13677,6838,6839,3zqXX6kzhkbW3d4TwD2CNjMRwxTbREXySekvq37kfCNk,1872389,29915252,-28042863,446
2022-05-09 19:49:28-04:00,21474,EXddheG5i73fJpvS4svYd16qxUhnvv3jNYhx3gn35jeE,HjYTR2AtVve381a2Rrp1JvoC3pbuFKbSViDJayJ8SXTh,True,24358996,1268281,5379,2689,2690,Hu94aiQWvce6THeGyCFqGRPM1pQrK3ihzkcXo1EpJcJL,1033242,17611852,-16578610,424
2022-05-09 19:49:28-04:00,21475,6UFULv9vPhgoU3TVW93BuP8fggZfGr9tiTPn11RR4Q5W,YftZrJvp8rmuHQP4LKKU48pqAraSnn9JeuH82rdV1CS,False,24092781,24092781,968100,48405,919695,2a35JJeTUW1pm6M3e8DHCjp8qr4vbc2cRPhuzZWyFzYd,968102,14140486,-13172384,401
2022-05-09 19:49:29-04:00,21476,626imJVkBoi7gjfXHtRi6yqrVTe8NX14gGDSyp8RDw9X,MLReNhLhuDBNRfMAXG6UKvjiuqkqGo1yQkR55YmNa2e,True,24354378,1267814,5408,2704,2704,8sEswn3kzEhnYjAZVvCQnHEUvYd7pFVvc2Xc2Kd1BpbC,1039007,17622226,-16583219,426
2022-05-09 19:49:31-04:00,21477,G8Bnx7PhHFxsqY2KTVPpwwDWUend8DmzLNQfSaevrEDz,JCvjtN3aZsaSwQPaZcMFnQBm8NtgopQqdPa6FKrH4Bcm,True,1524612880,181200664,979547,489773,489774,CGtKBgcWZ6HKE3tFNLPUM9khDv2Rc7d6BrPtxz7J1aY,82418656,601371276,-518952620,540
2022-05-09 19:49:31-04:00,21478,571gUhPVywRCh1J9AX65v3WpN8ZMXnhYrutLLTRsiRJy,GhvjW617NV9i3PQnNZUjEsbFtLWEnJRoCDisUHi57RJ,False,16062449,16062449,948813,47440,901373,3zqXX6kzhkbW3d4TwD2CNjMRwxTbREXySekvq37kfCNk,948813,7380757,-6431944,590
2022-05-09 19:49:31-04:00,21479,CpSUMCkXamfGm1FyxYQgmAKh1jaJ1DdmrRHxHANJpc3Q,2rVXtfeMhRgmU6eNBvg6RvQ4jRCAmgKVgLS8bPppCb8Q,True,41973530,3080237,13867,6933,6934,3zqXX6kzhkbW3d4TwD2CNjMRwxTbREXySekvq37kfCNk,1889736,29914114,-28024378,450
2022-05-09 19:49:31-04:00,21480,CZhzJ91hP1pFbNNz7YnUKXznvs6ZFVSRNLbe1SaTw29o,X3B4LpHFfeJPmCnEmRQ8V6MNMi7KpTE4MLD7LHYXUwy,True,125431016,7091673,25927,12963,12964,68sueyVfmy5ToEGtLFGDkwebX47xAmzyXE29z8JrmcWv,4585839,41908999,-37323160,365
2022-05-09 19:49:34-04:00,21481,6vWL8gpQtX2s3C9eqrUTnrK8iEUSMpAPh4C2Jsch7VF3,dgGLcKRBKvEWdXULyFLpxxcAEdMwiBVyXJB775RoDcJ,True,36274528,2030075,8537,4268,4269,3zqXX6kzhkbW3d4TwD2CNjMRwxTbREXySekvq37kfCNk,1525524,26501113,-24975589,420
2022-05-09 19:49:36-04:00,21482,DuNLzKUCCxrZY6JyBGwKJEJRygBd2vm1CesXgMDhfhn6,4PGnrVg4NTCuW5sZmkpg6g5ria57Jvhoaktsi9J8Ay13,True,96027121,24006780,143136,71568,71568,F31bVJvHB2XkhGdgjyTim48hY2cLFEx661AiPS3SzYJ2,5725447,39973666,-34248219,596
2022-05-09 19:50:04-04:00,21483,CZsnNXD5oC348mWZeawVj4K2bGxpTiXZzkpm8QtXLbBW,FmBXczLq7hkauf7C4JoxH5TY8HHJ83U5xqGXK3j6t5Fw,True,18345001,4586250,26540,13270,13270,72FwbpFGoLEazJEdpqNtPNefsadUrimUqma9wSoy4qiS,1061631,32159912,-31098281,578
2022-05-09 19:50:04-04:00,21484,6fqbSyhh3PPdgRcLraHb7Jahj9s1oHHeX3SsjNSsGa6t,GpRUow48TYgttdYfsygbgjYQcmHyYjWETUDjDVphEgwq,True,882978176,220744544,1292063,646031,646032,6UQfSsLooL4pQKQfLtXCutQS2BnF7A7F7ewJopDLmUpc,51682527,325793116,-274110589,585
2022-05-09 19:50:04-04:00,21485,DDmGzGuVK67aG3U7s85xJwt3gTiKK9S9tP43u6SSfuTM,ERwURauRuJAgpvQu6moTwDPYHNkuMHVvcF353RHJCaGg,True,5647057257,1009136112,3978987,1989493,1989494,A2p75MbAbeUdHkPLkAjgGeiwuu9WPrkMHzjCkDXF1Xr3,222661462,945072254,-722410792,394
2022-05-09 19:50:11-04:00,21486,BQYbbwd1MLtj6fBuBiTncAaXdAqKWa1JbcbGkZbLA728,2Wsyr6KoMbSVSvFy3YzutuEQ6skGUZyVHGM42SN4eU98,True,1900005846,72696386,255786,127893,127893,6UQfSsLooL4pQKQfLtXCutQS2BnF7A7F7ewJopDLmUpc,66852757,2583911916,-2517059159,351
2022-05-09 19:50:24-04:00,21487,nY4553VWeDS3nxxfojRgqViBWPUMkasBiso6oh1xVEk,36zbnL6yJGrEnC1gRMizbg2R5EH1o9X9hLbTur9AEM2U,False,13831202,13831202,860920,43046,817874,3zqXX6kzhkbW3d4TwD2CNjMRwxTbREXySekvq37kfCNk,860920,13745788,-12884868,622
2022-05-09 19:50:27-04:00,21488,J8FKUM9x5gNzz4wEpBEu5jCiy9Z115xzVtxy6tjDh5xK,BGUQKXLhZdjkPDJEREXyyTPwQFZAFuGMdxBzFhPqfVkr,True,43484786,4598780,16547,8273,8274,3zqXX6kzhkbW3d4TwD2CNjMRwxTbREXySekvq37kfCNk,1564646,21080873,-19516227,359
2022-05-09 19:50:27-04:00,21489,FVh55WrtFnwBDuf7cWHsATb8xFAGUiQs32bXQC7149Zr,EnpDNgzGrv9MjyztiMFiu2s4iAtMs13FEji5wT15YswX,False,24142497,24142497,971778,48588,923190,8sEswn3kzEhnYjAZVvCQnHEUvYd7pFVvc2Xc2Kd1BpbC,971781,14094828,-13123047,402
2022-05-09 19:50:33-04:00,21490,Y3bqEwy46XfvKCYHYnEdBqsUAVMBRfq5qLtmvEA6Kb1,GCDPpvCjwjBJp8VZ4hTmnmeG3uVny1PcAmKQKCXHw3nV,True,34188707,3575779,15015,7507,7508,3zqXX6kzhkbW3d4TwD2CNjMRwxTbREXySekvq37kfCNk,1435679,23497084,-22061405,419
2022-05-09 19:50:39-04:00,21491,AhY1PdmLDeoiTjkMtetrNLLiaMsZKyrZQa1tTHw7qP1s,HcfVPu7sGkjvkRGV3FjaFUumNRw2cTYwpPSKLs9sc92M,False,23018218,23018218,955310,47765,907545,Hu94aiQWvce6THeGyCFqGRPM1pQrK3ihzkcXo1EpJcJL,955311,16761137,-15805826,415
2022-05-09 19:50:42-04:00,21492,75fFExuVbQ6dKrSdQK13NMMN1ZoGbaEXUpR8Yfr6ruTG,55Qjxz3zoBnt3sfFEHsyoC4HJVqEHZxcnRCAggVTiAcx,True,38766911,2307736,10230,5115,5115,3zqXX6kzhkbW3d4TwD2CNjMRwxTbREXySekvq37kfCNk,1718615,27961449,-26242834,443
2022-05-09 19:50:45-04:00,21493,8ZsXyXgAV71qRor7YWFC8zMntN73XWm7GhTkE7XgV7Rq,D4QLFpaaetu9TcVxQH9j9WAXK7ZVKKLnW6KtHK6W9MZ9,True,34175511,3575786,15117,7558,7559,3zqXX6kzhkbW3d4TwD2CNjMRwxTbREXySekvq37kfCNk,1444909,23519516,-22074607,422
2022-05-09 19:50:46-04:00,21494,2A7ZobmSAddaDW7xJUbXKCKnPmnCd9hMV5UtzSbdgBMg,9aXtTVwGPwJoPL5V16y5T4SnAg8cAoF5YT5VsKcfS5GD,True,24489253,6122313,36230,18115,18115,3zqXX6kzhkbW3d4TwD2CNjMRwxTbREXySekvq37kfCNk,1449239,34136274,-32687035,591
2022-05-09 19:50:47-04:00,21495,7bTEcer5k6PypbgPJEFqpTJgiwhU4oJARe4ioWYPy4na,Gu3g7ghunEhPxMPaFQ5r9BC4ZYLAXXmLkSUCuUTn1g7o,True,34159785,3575736,15094,7547,7547,3zqXX6kzhkbW3d4TwD2CNjMRwxTbREXySekvq37kfCNk,1442003,23532362,-22090359,422
2022-05-09 19:50:47-04:00,21496,AzBK36Qny8VFVN6jFg8CBGsRU2FbdZYDMsgbJeRfZjRs,GSZ8veMKWDmYpAkZxtDL6DLreo9R6d7YhyGix4a6TgBJ,True,36396555,2016036,8693,4346,4347,3zqXX6kzhkbW3d4TwD2CNjMRwxTbREXySekvq37kfCNk,1569418,26422960,-24853542,431
2022-05-09 19:50:51-04:00,21497,E6naKBMrPoQXUx76w4t88u2DYhqyPSqp7u8h2xF5p7xm,Eg7ZTk4aG8BzNTNQxX2ae5c1HLeW5AHe8aTY97nA3gJv,True,38808486,2310220,10305,5152,5153,3zqXX6kzhkbW3d4TwD2CNjMRwxTbREXySekvq37kfCNk,1731149,27922761,-26191612,446
2022-05-09 19:51:54-04:00,21498,EHi1UBG8wMUFZECktsFUZkGjJPaBNEedswS62hyYn6jC,Drx9ErQhAjnPuJ83LPYFnY5ZV5XDzGuXDuSf16VqWayp,True,31301147,3448772,12429,6214,6215,5HnvdJnCCcmRsm4GkXnYWd4q9RpwuvYDGEUMPkYR3Ts9,1128117,26432336,-25304219,360
2022-05-09 19:52:26-04:00,21499,CS7E1f7LjgmwFUs85CMG45Q6qDy9NqmuGfJywfjjrf1U,Bem68iukByPcPpgzi63FufEhjTigKkPeeW2gY4o8zK2Z,True,170193248,42548312,262171,131085,131086,6L1WYrPiCMyi7XemPww4B4hvpKD1LQKD4RpiSKmrmgSC,10486870,103382874,-92896004,616
2022-05-09 19:52:31-04:00,21500,CZhzJ91hP1pFbNNz7YnUKXznvs6ZFVSRNLbe1SaTw29o,X3B4LpHFfeJPmCnEmRQ8V6MNMi7KpTE4MLD7LHYXUwy,True,117999151,12247107,43796,21898,21898,5HnvdJnCCcmRsm4GkXnYWd4q9RpwuvYDGEUMPkYR3Ts9,4219720,36460805,-32241085,357
2022-05-09 19:52:35-04:00,21501,6vWL8gpQtX2s3C9eqrUTnrK8iEUSMpAPh4C2Jsch7VF3,dgGLcKRBKvEWdXULyFLpxxcAEdMwiBVyXJB775RoDcJ,True,34173218,3581566,15152,7576,7576,3zqXX6kzhkbW3d4TwD2CNjMRwxTbREXySekvq37kfCNk,1445752,23522651,-22076899,423
2022-05-09 19:52:41-04:00,21502,EVMrznfJS54BZiywDD2WhUtxzicDtbEpm2a5yLrtCgRF,CpzsMYVYvKg8ihrX1cKRw7TDEYwD3kAyiX92hsf2KiTz,True,30963439,4300814,19138,9569,9569,6L1WYrPiCMyi7XemPww4B4hvpKD1LQKD4RpiSKmrmgSC,1377877,26407506,-25029629,445
2022-05-09 19:52:57-04:00,21503,626imJVkBoi7gjfXHtRi6yqrVTe8NX14gGDSyp8RDw9X,MLReNhLhuDBNRfMAXG6UKvjiuqkqGo1yQkR55YmNa2e,False,23001710,23001710,948743,47437,901306,5HnvdJnCCcmRsm4GkXnYWd4q9RpwuvYDGEUMPkYR3Ts9,948745,16775255,-15826510,412
2022-05-09 19:52:59-04:00,21504,J8FKUM9x5gNzz4wEpBEu5jCiy9Z115xzVtxy6tjDh5xK,BGUQKXLhZdjkPDJEREXyyTPwQFZAFuGMdxBzFhPqfVkr,True,38772673,2063848,7637,3818,3819,3zqXX6kzhkbW3d4TwD2CNjMRwxTbREXySekvq37kfCNk,1434766,20413103,-18978337,370
