ts,record_id,user_authority,user,partial,base_asset_value,base_asset_value_closed,liquidation_fee,fee_to_liquidator,fee_to_insurance_fund,liquidator,total_collateral,collateral,unrealized_pnl,margin_ratio
2022-01-21 18:02:16-05:00,6145,ApAgbKGyEYXRonGM33w56ZxHQNAGSd9ji4K3zAGN2yA8,FZAhAUDtEaNsFmh4fP8uXNjoHneNkpZ2wQCfEeU4RYRM,True,8082553,2020638,12624,6312,6312,3zqXX6kzhkbW3d4TwD2CNjMRwxTbREXySekvq37kfCNk,504968,4835193,-4330225,624
2022-01-21 18:02:16-05:00,6146,51yPLtXTgL9oLKs1cCf5TjL54Ld5vuVxat2NNtwZVsZG,7UjtM7Z1tiXEQMMiorQyncgi9SKu3v46DhVdgXbWqSiF,True,28374611,7093652,43775,21887,21888,3zqXX6kzhkbW3d4TwD2CNjMRwxTbREXySekvq37kfCNk,1751020,32870464,-31119444,617
2022-01-21 18:02:27-05:00,6147,BgNgALwBEuiumVgiXRmBZRnyFrr9QTDy2maHzsNwNHGf,ag35Ec2uFtqkarizCxFyhM2SPBuUwfmLRhAdFEWFCNa,True,19711996,4927999,30476,15238,15238,3zqXX6kzhkbW3d4TwD2CNjMRwxTbREXySekvq37kfCNk,1219060,6813960,-5594900,618
2022-01-21 18:03:55-05:00,6148,8MGEQ1KEMv9WSgVifjN7CQ7tDbJBJbWgGYu71dTDKEPQ,mQY2X9KYVXf9JmGY8XwMK4G8odM4HmWkgEmYYqKnkvF,True,13724219,3431054,20955,10477,10478,3zqXX6kzhkbW3d4TwD2CNjMRwxTbREXySekvq37kfCNk,838222,10388026,-9549804,610
2022-01-21 18:03:55-05:00,6149,AaMCg49sJwNtdB5wHACg15TYAzzJXy8xtG4zuVXhKiVE,HbDYqDa9bewGPvsiaHRM9HmEvh1scPaUaGvqog66gYir,True,13065444,3266361,20444,10222,10222,3zqXX6kzhkbW3d4TwD2CNjMRwxTbREXySekvq37kfCNk,817775,5547800,-4730025,625
2022-01-21 18:03:55-05:00,6150,o2aCmkxsxSiyUX8soTEjwUCbJeXmCZsEaf8CWwxDT5n,3pvS2bTsUuiQyqZp5rdnTpq4cqWGgtv4E5rN9HsBxpRt,True,1907,476,2,1,1,HfEnetJ7uBSmZWCjBNxdvv9HEC5nsW4wDV7wu6WnhWan,116,963,-847,608
2022-01-21 18:03:55-05:00,6151,CyWBZ1xJ9LahUnPesbXLZ4Rr5UyWAHgVFYwfrnhyrkNL,2Lpk87Xth8ZL5J9BfzmMpEE3x76FDrrrmdKiCNkSVip2,True,20731806,5182951,32039,16019,16020,3uL2NSR2ZdDqCiKfzA5SwwpddAnit22DBJo6uvvz1rRs,1281565,11727392,-10445827,618
2022-01-21 18:03:55-05:00,6152,6oroGB3mvzK3tDfiB9X2NJuL3x476pxhgRnt7VxqhdLo,2SoK8tKkLn2ppKURpTVazKsCEis4uahkHMsac1m85J4r,True,142909,35727,216,108,108,3uL2NSR2ZdDqCiKfzA5SwwpddAnit22DBJo6uvvz1rRs,8644,166389,-157745,604
2022-01-21 18:03:58-05:00,6153,2s9VGesQYbKr3LwuraMEa9sXbXz7f8299HPPAHgSaUdp,8uMS2GDsbmygjbRnc2gjwNkXKogmJX1i8nchmqt8ixCe,True,3573367773,893341943,5478421,2739210,2739211,3uL2NSR2ZdDqCiKfzA5SwwpddAnit22DBJo6uvvz1rRs,219136846,2407522513,-2188385667,613
2022-01-21 18:03:58-05:00,6154,5rW9kqXB9feGSKSvSMNJF1FCsBYV3vGmTmc8MvzaZ3pi,7AjnjcfPJevW5521hXw4VtgRCfHSsAqyzyArukKfNcHo,True,877383,219345,1338,669,669,3uL2NSR2ZdDqCiKfzA5SwwpddAnit22DBJo6uvvz1rRs,53544,672724,-619180,610
2022-01-21 18:03:58-05:00,6155,BJV5jbowrbELXfDvfMovaQy4PiRf12pLYHimW9bgzW5X,6WXrWso5FvLx7RMCFBzrbzh5qevKkk2LJAihUfWXxXzB,True,1727156,431789,2673,1336,1337,3zqXX6kzhkbW3d4TwD2CNjMRwxTbREXySekvq37kfCNk,106946,1933403,-1826457,619
2022-01-21 18:03:58-05:00,6156,FV9CBGGTbppLnBKh79f2LzD1diTiS5g6u89FcpZHZmnK,Fe7mtmCUziFqbbYTvrhAcAq1Ub7YLfTJRtQ1hG7GzJD1,True,434155,108538,670,335,335,3zqXX6kzhkbW3d4TwD2CNjMRwxTbREXySekvq37kfCNk,26834,269411,-242577,618
2022-01-21 18:03:58-05:00,6157,U3vvMQ4X4aKzVYfhMw1V1p58HRqaLnuXozqmmefYeD9,7JA94MArkNCFRhBq8f5a32DgMF6aPdFsoC5HvXDQ6NuR,True,25057776,6264444,38545,19272,19273,3uL2NSR2ZdDqCiKfzA5SwwpddAnit22DBJo6uvvz1rRs,1541811,19456547,-17914736,615
2022-01-21 18:03:58-05:00,6158,9VSpd4vToJrnQhmJ595Ua7GhmhutYRgd6rCk3pL4yNxr,7axwFe8aQVPYLNgM9rdUwnFf6vW69Jsw2XpKNjYRDn6N,True,26903665,6725916,40466,20233,20233,3zqXX6kzhkbW3d4TwD2CNjMRwxTbREXySekvq37kfCNk,1618643,15957494,-14338851,601
2022-01-21 18:03:58-05:00,6159,BXMMFy2k9b2hVBEG6RyXAq3qqXxJ7EY2xhyPZqtLvBiU,KpoZwr4ZFTHJgebbf4tcjT9iKvpC1EF8Aw4uaVPxXNd,True,5169082,1292270,7772,3886,3886,3zqXX6kzhkbW3d4TwD2CNjMRwxTbREXySekvq37kfCNk,310911,1465739,-1154828,601
2022-01-21 18:03:58-05:00,6160,B4Uc39nKzz9wBRQsCkMR4A7RwTJ8rSuwpR6EQn2AesRb,H49bGZgatRZVpj6QufZRVgYrQtH7LpdbiqKBs23151m,True,2064858,516214,3198,1599,1599,3zqXX6kzhkbW3d4TwD2CNjMRwxTbREXySekvq37kfCNk,127936,2503016,-2375080,619
2022-01-21 18:03:58-05:00,6161,GqAS41YJssg9aaEp3hs3sG98APCsXhiQBQszXaSjZ2bN,2wodJ3AhrXdE1T4oVL95KvoBND7PubG5Wd5GWiLCMZJU,True,15154408,3788602,23207,11603,11604,3zqXX6kzhkbW3d4TwD2CNjMRwxTbREXySekvq37kfCNk,928291,16941438,-16013147,612
2022-01-21 18:03:58-05:00,6162,BPsM1um9ZJf7eNoVMsQCRSwgARMuLCGGSDxf9tZeNeEy,BpzDdXfxVygiSYSmsHV6uPxQMeTFtrURMCCqhswQjd5X,True,96200,24050,147,73,74,3zqXX6kzhkbW3d4TwD2CNjMRwxTbREXySekvq37kfCNk,5909,60038,-54129,614
2022-01-21 18:04:00-05:00,6163,DGAQzgZhS2yioeZmG3cbacM3hdz4F1aZn1PWRwgiFukc,48KUtJaNCPNxkLXJBtWAdDxY4b9vZzLgbGxTNdwMqmjz,True,41686075,10421518,62317,31158,31159,3zqXX6kzhkbW3d4TwD2CNjMRwxTbREXySekvq37kfCNk,2492692,29415293,-26922601,597
2022-01-21 18:04:00-05:00,6164,9Hz4p7gcfDbXBJp8KzhaBBPh9i7xe9kun7zLfDtqPe6c,2bJ43Lep6kp6WY7Ct56oiscKnAbdtC265G5yRvRPFThU,True,75783842,18945960,116462,58231,58231,3zqXX6kzhkbW3d4TwD2CNjMRwxTbREXySekvq37kfCNk,4658516,29539539,-24881023,614
2022-01-21 18:04:00-05:00,6165,DMgD2KCEhTGFLUZ5GnfNcwfiiwKYbyVpoWiN6knMkCAf,5KU2vgBkPTNVHsSULjgX7ZkZS56U3Dy3xqLTxL5sUZJ3,True,113801536,28450384,176846,88423,88423,3zqXX6kzhkbW3d4TwD2CNjMRwxTbREXySekvq37kfCNk,7073850,99474472,-92400622,621
2022-01-21 18:04:00-05:00,6166,FF8rqfM9PTEjYiVFy8jS81weDRwdaYooux2uSa2LexrJ,JBk1JghH1gged1YpDbkczFXP9ka5ivYSkaYoVbbXD4kg,True,14968338,3742084,23175,11587,11588,3zqXX6kzhkbW3d4TwD2CNjMRwxTbREXySekvq37kfCNk,927029,10984534,-10057505,619
2022-01-21 18:04:02-05:00,6167,CagSUfZLwXuCdypC4KzU6FSNdmCj9dKDroPcNeaRtsyt,yxw5d1ztZuEUY2QjL7eLpr72QJAj5rJd6ERvg91cy1m,True,129048,32262,197,98,99,3zqXX6kzhkbW3d4TwD2CNjMRwxTbREXySekvq37kfCNk,7887,79195,-71308,611
2022-01-21 18:04:02-05:00,6168,ymyzGH4Qc7HH5PbKpVphCbsQgLLXyGkPcXamQJuNj5C,8oTLHaV2XzbKXNWRuUjCfHjUn61Pw93LYK14m9q2VDpZ,True,1097342,274335,1686,843,843,3zqXX6kzhkbW3d4TwD2CNjMRwxTbREXySekvq37kfCNk,67458,673768,-606310,614
2022-01-21 18:04:03-05:00,6169,3qnPsgqW11AcDEmyjmJquPcPLyE3EdJQuVLJ5kinDrd3,86rZadBB7emKio76aFTahpbrFtxd9tqZ4Mxgzaavq2xU,True,12606,3151,19,9,10,3zqXX6kzhkbW3d4TwD2CNjMRwxTbREXySekvq37kfCNk,775,8470,-7695,614
2022-01-21 18:04:03-05:00,6170,HVZkXeDR3mc8oB9qFFwCK4RXpPojdcHk9tRGep6xtKGK,Bh3py7awPejWqeTMxtAgF7mPotL2Asxf8YrYJykq9nBt,True,526021,131505,798,399,399,3uL2NSR2ZdDqCiKfzA5SwwpddAnit22DBJo6uvvz1rRs,31932,351637,-319705,607
2022-01-21 18:04:03-05:00,6171,2FEbsetZMkRqLjSC8GBbgecKgX5T1T1fci2sLQux29p8,H722Fcd6DkTFRZxqQWbPDufBfXEgmFfhiEpQZWhxwYv1,True,385454,96363,594,297,297,3zqXX6kzhkbW3d4TwD2CNjMRwxTbREXySekvq37kfCNk,23787,239594,-215807,617
2022-01-21 18:04:04-05:00,6172,DdAPWdHnb7ocaYtcwwwYnppsH39sZpmzMyANeoJbCV7s,3BVmC39L8dEypPN1BZhsf9bx9Ge2sXCZR8Y6RH4eBNMJ,True,83924479,20981119,124971,62485,62486,3zqXX6kzhkbW3d4TwD2CNjMRwxTbREXySekvq37kfCNk,4998859,85182529,-80183670,595
2022-01-21 18:04:04-05:00,6173,2jPxG5FL6D6XEJsRszJ9cmQ54AWSpZyPFSbn3DpWBSuM,3toQou4UVNvyWYvMvkuv379RVEF2aN2TzCpKKBUqeQV6,True,15405114,3851278,23562,11781,11781,3zqXX6kzhkbW3d4TwD2CNjMRwxTbREXySekvq37kfCNk,942515,10168702,-9226187,611
2022-01-21 18:04:04-05:00,6174,5yPGvUz6JWKjkViGwTCpygJii1rP2xv5yx146ULtBiYq,FMnHUCQWTf1UHu5qVFqUAsWh8aba9EQYTEoiXy55totD,True,387433006,96858251,595759,297879,297880,3zqXX6kzhkbW3d4TwD2CNjMRwxTbREXySekvq37kfCNk,23830387,125090284,-101259897,615
2022-01-21 18:04:04-05:00,6175,E1CShgy7M9998q9jyzpnHZxHJR6z5hvnshUJt37kVPtG,96f1nYW4S9APCJS3TXTGSb9UcJDdxJuoBR3pLYqcNz2b,True,14101395,3525348,21673,10836,10837,3zqXX6kzhkbW3d4TwD2CNjMRwxTbREXySekvq37kfCNk,866943,9288842,-8421899,614
2022-01-21 18:04:06-05:00,6176,6BQVtmNsxihi4PcA7MurtguTwa6SmbmKyP14RHyjVZkf,7ZFv5ms4HzVKiw7KgE8RUoKxW9rB6JUD7ujZxMx4DwnM,True,264485,66121,406,203,203,3zqXX6kzhkbW3d4TwD2CNjMRwxTbREXySekvq37kfCNk,16245,152176,-135931,614
2022-01-21 18:04:06-05:00,6177,6rb3fRVWJ5cSzFcmuC1YwdrNxiNctvboDF7HwsfyGoCA,H6JaYfFZkRk6iSJrA4nVeuFpMVQtVwQZHVgK1TyaupTE,True,3465,866,5,2,3,3zqXX6kzhkbW3d4TwD2CNjMRwxTbREXySekvq37kfCNk,216,3737,-3521,623
2022-01-21 18:04:06-05:00,6178,3C2MZQKh9x4zNTCMbhhvoafGaFMwUooqfy9MCgPyXs6E,AHjgWKpYPWe6ketjDHDKFBFsKQiRJ41jnkuo39MVYxZo,True,16890655,4222663,25897,12948,12949,3zqXX6kzhkbW3d4TwD2CNjMRwxTbREXySekvq37kfCNk,1035882,14137798,-13101916,613
2022-01-21 18:04:06-05:00,6179,BrHRMouGRz3LBNzd9anfdYMhWfg8yUPHL4PqJ8WdEDFS,4uzoLa3mC2VYHAPBoHLX4gTjPTC28rPf2fvEGtJWPYc,True,4854980,1213745,7438,3719,3719,3zqXX6kzhkbW3d4TwD2CNjMRwxTbREXySekvq37kfCNk,297556,5398309,-5100753,612
2022-01-21 18:04:06-05:00,6180,5sN3cfz4hZjwy2HkAStKWeL8wHhdbkW8F7USzwCzmggh,Fme7U7QY92biAsV3RR2Fj7rJPnpdcov13mmFhVDFuyYG,True,57064639,14266159,86926,43463,43463,3zqXX6kzhkbW3d4TwD2CNjMRwxTbREXySekvq37kfCNk,3477048,36100867,-32623819,609
2022-01-21 18:04:06-05:00,6181,BYvjENe16Ta77PqGV7JKEWrsqCTfkMGYwTSG5gXneDvd,EvxAXgvhPC6QkNurbK7vWyTApGo8J2R4EgMAknkHVU3d,True,246675,61668,380,190,190,3zqXX6kzhkbW3d4TwD2CNjMRwxTbREXySekvq37kfCNk,15225,219526,-204301,617
2022-01-21 18:04:07-05:00,6182,FKQVm9RsteDe7dQmwx4NGYhz3Wrvwh7TCp9rFbTgAomx,Dbwox8eRCdmH5KXyi5sBaqWzhxtaVPo1teWXJ2kRFT1f,True,55050462,13762615,84449,42224,42225,3zqXX6kzhkbW3d4TwD2CNjMRwxTbREXySekvq37kfCNk,3377963,59660730,-56282767,613
2022-01-21 18:04:09-05:00,6183,HPDN6Ro6gPgYbNgnv7yhFCpyY3uYzT18epFxRFNZ985w,3Jop74A52E7gYLXJRUAoPBzSZ6mmP2gmaCg7eG6eQHu5,True,88018329,22004582,133271,66635,66636,3zqXX6kzhkbW3d4TwD2CNjMRwxTbREXySekvq37kfCNk,5330853,37452527,-32121674,605
2022-01-21 18:04:09-05:00,6184,HGJoZvLakWfSDFwuvShNBc4kCf7nP7VqzyM3mELpbFEf,12Qn5jin7QvsBngXqYAv4UstyG3b6nRf1jsLp9Dp8G7k,True,1293916,323479,1994,997,997,3zqXX6kzhkbW3d4TwD2CNjMRwxTbREXySekvq37kfCNk,79777,899825,-820048,616
2022-01-21 18:04:10-05:00,6185,96StvqZyFUPtyMr4o9s7K4V29RSNyRpVi76vNwxG5rUf,GZKXFSFq4aGiTaqovtxqNCCVGkAFNXPh4Hep1ZMwdZ8g,True,1842541,460635,2868,1434,1434,3zqXX6kzhkbW3d4TwD2CNjMRwxTbREXySekvq37kfCNk,114722,2165663,-2050941,622
2022-01-21 18:04:10-05:00,6186,C9beggursF9WdLyzunVSoz2Bw6kAxoQpUifPHbo4ybvw,3R7KdKBK7FoudsNXUeRuC2AGVFusMhmTYXSGdnA88pJT,True,2931049025,732762256,4388982,2194491,2194491,3zqXX6kzhkbW3d4TwD2CNjMRwxTbREXySekvq37kfCNk,175559282,1137186699,-961627417,598
2022-01-21 18:04:10-05:00,6187,8nXbrdjjaHB73CRPRenGEQj73wbtEFGDwXsehRGMhsap,43pvdcJ6f27wz94D6ZboKwRJYbyvYCrjsJhYsvk7LJCM,True,5144840,1286210,8008,4004,4004,3zqXX6kzhkbW3d4TwD2CNjMRwxTbREXySekvq37kfCNk,320339,1944571,-1624232,622
2022-01-21 18:04:11-05:00,6188,Ckqos6cdncPKj13DnCmDVZsZTqp6eS7277CRrT9WhcEr,AtUV8m7VQJvZq7GLCAHMf3jV7iamKEPnWVZHWuuVZQp1,True,99029,24757,148,74,74,3zqXX6kzhkbW3d4TwD2CNjMRwxTbREXySekvq37kfCNk,5924,86673,-80749,598
2022-01-21 18:04:11-05:00,6189,54grbLQHZsNK4qTyXb8kXAU12Af9QUNFMujuzLLHHHef,3Ua1LDmZfPxvpaCp45RJ5xn3ovNuMxyWGrxnLcsK2ko3,True,127669579,31917394,199536,99768,99768,3zqXX6kzhkbW3d4TwD2CNjMRwxTbREXySekvq37kfCNk,7981471,80544400,-72562929,625
2022-01-21 18:04:11-05:00,6190,3EmGvYu72cR4Ta3wLA5HKZBEqgfChCyiRanwj5hGLJXc,6NEWPFaKi5uLsrj4n6RM1DBhQTcGFE9TwYeJ12pC7yyp,True,3163,790,4,2,2,3zqXX6kzhkbW3d4TwD2CNjMRwxTbREXySekvq37kfCNk,190,2059,-1869,600
2022-01-21 18:04:13-05:00,6191,BLJgLzizx2yLgd12pVBAHTMqn9J5JA3JHCF8PnLnPyUk,HhDmwMysBFWhXnd3mrV31w75WBRKBS8wJSiEMZgqdUSp,True,81542175,20385543,125444,62722,62722,3zqXX6kzhkbW3d4TwD2CNjMRwxTbREXySekvq37kfCNk,5017785,56951334,-51933549,615
2022-01-21 18:04:16-05:00,6192,8627qmFevGS1LSDyCgoJjbURcf8CjVFCcxE7U9mWVP5f,3sgQuNcZuGV59Q9apxSBQcV1XAa6og6xa8FLpumvN7iZ,True,3200,800,4,2,2,3zqXX6kzhkbW3d4TwD2CNjMRwxTbREXySekvq37kfCNk,198,2105,-1907,618
2022-01-21 18:04:20-05:00,6193,EL9JxeMvWWLTdVC5QrZzSSgApEwv1nDhZc6yNmH9G8ad,EqSQLSFx1eKkTYAdv5XhekttqVh7TappXAHuv9EedCXq,True,8355,2088,12,6,6,3zqXX6kzhkbW3d4TwD2CNjMRwxTbREXySekvq37kfCNk,515,5502,-4987,616
2022-01-21 18:04:21-05:00,6194,AvwHizRhHUSahmvSg4jmTUErc7vAFSmkRAEsiKhXfW1m,3UrWYx8y9N5o9GYneSe6zyyHRTZzxwvcipQfHHYh7tEs,True,216006,54001,334,167,167,3zqXX6kzhkbW3d4TwD2CNjMRwxTbREXySekvq37kfCNk,13371,131321,-117950,619
2022-01-21 18:04:21-05:00,6195,3WcJUt8jQ1ngL3ZCGo6dFrc3GmTMTYtzeDva7mri2Tqx,HeG1Pz2oMjqtkfsRMsbqP3VpatnVEQzcWmKDVoFp4Htr,True,1295367,323841,2023,1011,1012,3zqXX6kzhkbW3d4TwD2CNjMRwxTbREXySekvq37kfCNk,80933,899527,-818594,624
2022-01-21 18:04:21-05:00,6196,6Bq55LtGCEeGqh4JrFLCmmGc2iJfTTBJixivqH78aGSE,DSNrCgWJeNe2P9tAQu5FvCueTzNKDKds7wzuwTQSMRG,True,548101,137025,849,424,425,3zqXX6kzhkbW3d4TwD2CNjMRwxTbREXySekvq37kfCNk,33963,335985,-302022,619
2022-01-21 18:04:23-05:00,6197,CEtpqFD4BbeiNfaXyLLYEapY2mWgE26H5q6H34tWwRuD,BVqRyqwGFPzSkk1H2finiyfaL3LScbEiQGk3mihirxqs,True,15288510,3822127,23709,11854,11855,3zqXX6kzhkbW3d4TwD2CNjMRwxTbREXySekvq37kfCNk,948391,10121362,-9172971,620
2022-01-21 18:04:23-05:00,6198,HELPNUwAqTX7gfHS4cnJnqXFM6Rb156tYcpsitKR9iDu,3RdfgDvLvsdZG5Cf6hKiKMQMqfidyxHzjYvUx1FZpeHQ,True,36960135,9240033,57036,28518,28518,3zqXX6kzhkbW3d4TwD2CNjMRwxTbREXySekvq37kfCNk,2281446,32051761,-29770315,617
2022-01-21 18:04:24-05:00,6199,9ebpuMtXee3DSx4qWiEYEtTT1gK5FqCY2H5yQVWWtTts,9b71dTsTYD1bx6KsjFs5h6d3Jj4T9eX3nqmS7RQj3HS5,True,24153846,6038461,37783,18891,18892,3zqXX6kzhkbW3d4TwD2CNjMRwxTbREXySekvq37kfCNk,1511358,15865872,-14354514,625
2022-01-21 18:04:28-05:00,6200,BZwH7dXogZ1qX5RWqAyiMi8f99fGmebwM56C3QkWRqDd,3avt3UeuxPZj65bCYKotbqAyr5L2ycfkbQp9Z75xqAkN,True,5993,1498,9,4,5,3zqXX6kzhkbW3d4TwD2CNjMRwxTbREXySekvq37kfCNk,373,3970,-3597,622
2022-01-21 18:04:28-05:00,6201,M69XSefqeum2arinvHEqmA3L2XHWNFN17p4msRhRZXf,2vK15yYUANLSbAoiBfgJ9VLyqsmtEpd2iNytQjms8GaQ,True,21612325,5403081,32690,16345,16345,3zqXX6kzhkbW3d4TwD2CNjMRwxTbREXySekvq37kfCNk,1307625,19668153,-18360528,605
2022-01-21 18:04:29-05:00,6202,2sPD4f4d3CCeFSwSC5vAGS3YoTsTGypYKfDeoJczebop,HWCRpcq2sXqJL7Vi8MtipQDwGSViE73bUxS36ETmvnP2,True,15042628,3760657,23164,11582,11582,3zqXX6kzhkbW3d4TwD2CNjMRwxTbREXySekvq37kfCNk,926592,5319648,-4393056,615
2022-01-21 18:04:31-05:00,6203,3c4tj9J8QwB3exFchWei43nBh5xsYRZxEUfayi3JvYgm,Fyw1TEEDKhLFo16qxDsttsAwSkrfzpDe8Dmm3atEeXyN,True,33743703,8435925,51934,25967,25967,3zqXX6kzhkbW3d4TwD2CNjMRwxTbREXySekvq37kfCNk,2077395,20826229,-18748834,615
2022-01-21 18:04:31-05:00,6204,DC4UVUDFWL3gVtgkX9hPtFgtxaA8DH5p94i4k9U3wyWv,3HCWqVvQQfRgSKitsTjGTduJ82ointZUSNtj13uea4kD,True,146789089,36697272,225909,112954,112955,3zqXX6kzhkbW3d4TwD2CNjMRwxTbREXySekvq37kfCNk,9036373,86896362,-77859989,615
2022-01-21 18:08:57-05:00,6205,3Xbsek5MsEGoWr3G9yhuohREr26B2vSQcjqXdspTFHta,2rPxkUiMo9wGDq8EvAiwY3ngRpKmL223cBWWNTYoBmFp,True,30011111,7502777,46667,23333,23334,3uL2NSR2ZdDqCiKfzA5SwwpddAnit22DBJo6uvvz1rRs,1866695,11034449,-9167754,622
2022-01-21 18:09:50-05:00,6206,8ZBphuKHLmv5jNURAunz6pFb3zyyCePKoToEXefPhDYC,GiQaHVaAxgf6jrUquKHjext6AXk3Vo5KKejhb3iGoc8H,True,323786854,80946713,506064,253032,253032,3zqXX6kzhkbW3d4TwD2CNjMRwxTbREXySekvq37kfCNk,20242571,96455717,-76213146,625
2022-01-21 18:10:12-05:00,6207,8WHDaiE6LqFFmCVMnPeLEQ99R6ft8b74UfmP9BqzjcE8,CGmoDGsdnjo3zMNrW78n2xxQr1aDPAiBYiXbyciLXYMu,True,99305504,24826375,154646,77323,77323,3zqXX6kzhkbW3d4TwD2CNjMRwxTbREXySekvq37kfCNk,6185860,51991604,-45805744,622
2022-01-21 18:10:39-05:00,6208,EF6H6aW1p3qcAtiLFU9rbFYfsKfD683meHXDw8hLdaZK,8vfJbpnK7SQcjpEBCzZJRW8JosNbsmTeJ2YXZCbM225c,True,48479856,12119963,75801,37900,37901,3zqXX6kzhkbW3d4TwD2CNjMRwxTbREXySekvq37kfCNk,3032063,22592724,-19560661,625
2022-01-21 18:11:11-05:00,6209,Br1j5Ftafei7ysu5SmqVZSoRe4uS4qCPeKSPHg55pyiE,G8fc7QvXjfkgBFvAVUgJFQS3VaF1biL9rktBExGa87Ks,True,573479801,143369948,897389,448694,448695,3zqXX6kzhkbW3d4TwD2CNjMRwxTbREXySekvq37kfCNk,35895593,326309658,-290414065,625
2022-01-21 18:12:08-05:00,6210,2NdwSLxsGok8PczpCZj9CVX2BymNU5MvHt7hWfGetg2M,8AQbDXeA6mD9QoZBFJcYbnHvZwKNxzA9CCHLAgdSfTA3,False,916,916,45,2,43,3zqXX6kzhkbW3d4TwD2CNjMRwxTbREXySekvq37kfCNk,45,718,-673,491
2022-01-21 18:12:08-05:00,6211,E1wp3bmkcY3eiEYyGYwhTCsr7BZ7RfPa5DJTZFupcFwj,452hVdYkD5SDDrA6hv6DLPFvyS8PvR2P6DPNScGxWTsW,True,51901,12975,81,40,41,3zqXX6kzhkbW3d4TwD2CNjMRwxTbREXySekvq37kfCNk,3242,35904,-32662,624
2022-01-21 18:12:08-05:00,6212,8W9NJfM6cqCsvR1FC8Ab8YZPSQF7bz7inxJZxWnF7GsX,3exfPuVcTnPxs8GwCtS3ruKUGveYymwGV7RXQssPiizJ,True,25336181,6334045,39480,19740,19740,3zqXX6kzhkbW3d4TwD2CNjMRwxTbREXySekvq37kfCNk,1579213,28197053,-26617840,623
2022-01-21 18:12:08-05:00,6213,Cb4zhnvig11U4GcC4kqKrnDicGgPhUpfDQB1U7hP3nPa,DiRAMrKqaevGXeXg38KnhaYBERj8tNKU7oWFJvhS32kw,True,12983,3245,20,10,10,3zqXX6kzhkbW3d4TwD2CNjMRwxTbREXySekvq37kfCNk,812,7878,-7066,625
2022-01-21 18:12:08-05:00,6214,FX5sizQGZcDCaETDyJ3HbLxFwhu4t9bX6YyQM7cVEo9Z,6EqnCsv1JPjz6JX1yLNcf74rmkuhAUx6Sf35QMYGuuF6,True,14105853,3526463,21980,10990,10990,72FwbpFGoLEazJEdpqNtPNefsadUrimUqma9wSoy4qiS,879223,9341713,-8462490,623
2022-01-21 18:12:08-05:00,6215,89CkXnSZnr52Zsoh48efv9MQacrkB6GMtrbEpNJSyA2H,HcvRBS4Z22CpYgDNgm4TVF4AVXFDuYzBUAFcdHAwdpg4,True,193058,48264,300,150,150,3zqXX6kzhkbW3d4TwD2CNjMRwxTbREXySekvq37kfCNk,12025,128680,-116655,622
2022-01-21 18:12:08-05:00,6216,CP2qcTSw1Y5J7jZiEgbtsvJoigRbJ4m9oHGQS8Fiai2x,7Zd1uX1thbuGkp9H4r1t8aLTu9W8MxvUBNjji2FNJa8E,True,3234510,808627,5059,2529,2530,3zqXX6kzhkbW3d4TwD2CNjMRwxTbREXySekvq37kfCNk,202380,2148203,-1945823,625
2022-01-21 18:12:08-05:00,6217,6h43GsVT3TjtLa5nRpsXp15GDpAY4smWCYHgcq58dSPM,CTgbWridYWnfE5Emwr7qiCEb3LcXHupqeB9zwmddoEqB,True,10215799,2553949,15894,7947,7947,3zqXX6kzhkbW3d4TwD2CNjMRwxTbREXySekvq37kfCNk,635793,10994229,-10358436,622
2022-01-21 18:12:08-05:00,6218,EhANPABkSw9x9WnsDEi8pCg67iQTX2UGTTUpyjADTwdN,4FKLi98hyg9ZjM4MY6ctJsv7B6vPUnTYWdhrnNoYsztX,True,645715,161428,1008,504,504,3zqXX6kzhkbW3d4TwD2CNjMRwxTbREXySekvq37kfCNk,40328,515689,-475361,624
2022-01-21 18:12:11-05:00,6219,2PzBAkdXkrwH9VuoMALumQz86qkW7sSBQtCrHw14JUp3,D5vwWAMHVooobG2sCWv9EwtJrAFZG6cwKH4dfmA98tbt,True,167410,41852,259,129,130,3zqXX6kzhkbW3d4TwD2CNjMRwxTbREXySekvq37kfCNk,10391,113569,-103178,620
2022-01-21 18:12:11-05:00,6220,7vKmhLV45Q5etXhJL5ng8rxWhYSiUCDmAbGnwBPr7zcx,cP6xPeuHLnjr858QK1F9qYn7rJpEbPy7wEJHoju6oV7,True,2785811,696452,4350,2175,2175,72FwbpFGoLEazJEdpqNtPNefsadUrimUqma9wSoy4qiS,174024,1876439,-1702415,624
2022-01-21 18:12:11-05:00,6221,46TNhGwBVzedW8xSb9UY94HNeSom9iGiZzAjrKHiRM2G,7JVTiqNYeKHbyzRkKtvSEpqLPKykZso8cGUr3sX1j7QF,True,16126907,4031726,25125,12562,12563,3zqXX6kzhkbW3d4TwD2CNjMRwxTbREXySekvq37kfCNk,1005001,8023284,-7018283,623
2022-01-21 18:12:12-05:00,6222,Cs2YxkuqBK1kjoYZbUZdUcxapPbv8oC75trwGgWoCPfG,2PgHQM1GhHykE4bQ1ggueAw2Zs1BFUW5hxvMvr8DojKM,True,4531005,1132751,7000,3500,3500,3zqXX6kzhkbW3d4TwD2CNjMRwxTbREXySekvq37kfCNk,280017,3766399,-3486382,618
2022-01-21 18:12:12-05:00,6223,7D4rFmGMPKNAF75VRPxHAhSn2wTjiW8jmth1UD22Xqq9,GQ7BrT6vsXu8tHCMm75YdxFR2r9QTCrCUbdPEZBSAg9w,True,3085246,771311,4800,2400,2400,3zqXX6kzhkbW3d4TwD2CNjMRwxTbREXySekvq37kfCNk,192024,1837507,-1645483,622
2022-01-21 18:12:13-05:00,6224,DH6W3oB22rPJj7PPrey3Rgtn8Tz8kFKQjftajzUFBeKK,5gNsQSAUq8yFVt3FtU854NfuvFQaaCDC6oAqKA6hoZ3F,True,3289690,822422,5141,2570,2571,72FwbpFGoLEazJEdpqNtPNefsadUrimUqma9wSoy4qiS,205649,1987841,-1782192,625
2022-01-21 18:12:13-05:00,6225,Ar5QB4VBcUyzSCG23z2QNAbrWY55NbHCr1MNN6P2GAmh,BusFGTiDrJmxzwGUxWz9b3SFF3eseqtgh2DRHqyAwyVe,True,29791,7447,46,23,23,3zqXX6kzhkbW3d4TwD2CNjMRwxTbREXySekvq37kfCNk,1855,20650,-18795,622
2022-01-21 18:12:16-05:00,6226,2rCRdyfi65rpxRRmg7knaSb8t55FuPt3h8wF4Fzhy8MM,CLVY5nSG3jTdRo7tRSKgK9DJgW6aswfWKe4tLxzsENmb,True,40578,10144,63,31,32,3zqXX6kzhkbW3d4TwD2CNjMRwxTbREXySekvq37kfCNk,2535,24904,-22369,624
2022-01-21 18:12:16-05:00,6227,2VaLosQwagCVayTVjPGYW5FuiCWGFebMr34XzCa87Mjm,ARaeUMgGi3rHmtdYD9ShwzNnLRLvabEjcUqq8P1md7tW,True,5049799,1262449,7845,3922,3923,3zqXX6kzhkbW3d4TwD2CNjMRwxTbREXySekvq37kfCNk,313801,4183020,-3869219,621
2022-01-21 18:12:16-05:00,6228,2iG781tfP9H77hcFimqp5X9KB9QsbVkQVS9q7emJAJXX,5XDdJMfPSs8WwZZgEtv22RQXEbg748ia4gGfZCy1n4jy,True,961158,240289,1497,748,749,3zqXX6kzhkbW3d4TwD2CNjMRwxTbREXySekvq37kfCNk,59882,343759,-283877,623
2022-01-21 18:12:19-05:00,6229,i7TcF4weYcqgrRdH3GpndbEYxCxfcSfr9JWYrAUg1CF,BkDfknUir7PnSEW8auoB87PytycEFwyX5kT2GY4SGJJL,True,340315,85078,527,263,264,3zqXX6kzhkbW3d4TwD2CNjMRwxTbREXySekvq37kfCNk,21119,385457,-364338,620
2022-01-21 18:12:23-05:00,6230,F9s8a7Cpiw5dw3a2aNFMofqwyDWNXvDLnSdJzoj1gRiV,GpKsQKJD79KBRWdCTkyi4zX7NaoCWsLUjrKxAwJB6o6s,True,1752672,438168,2725,1362,1363,3zqXX6kzhkbW3d4TwD2CNjMRwxTbREXySekvq37kfCNk,109000,773214,-664214,621
2022-01-21 18:12:24-05:00,6231,HwosLQgDY1xtHQRQ4hzroPQHFWssPzTj5vRkP37FcviB,HKTNEYNXrephNkH7apbobK4mcQXcNayQA4W1NgM6sLr8,True,6967922,1741980,10652,5326,5326,3zqXX6kzhkbW3d4TwD2CNjMRwxTbREXySekvq37kfCNk,426083,3298834,-2872751,611
2022-01-21 18:12:26-05:00,6232,5NVD6QvomTAD35yNxSFZw4DhF2hCtV8drkbnGhBVtK5y,3JzkyPnREvoFZLL9JZuuDEnee3nuKcrqY3xLuXsmHwRo,True,3506110,876527,5445,2722,2723,3zqXX6kzhkbW3d4TwD2CNjMRwxTbREXySekvq37kfCNk,217804,2643134,-2425330,621
2022-01-21 18:12:27-05:00,6233,B5CTBTggmGFvGFSunjbB4C9tLKcYcULehmEiEXRihY2J,FX3ebF8P89rZBWfR74PDWUzxnLuDkUDgGcPYCBD5sMUG,True,133601735,33400433,206815,103407,103408,3zqXX6kzhkbW3d4TwD2CNjMRwxTbREXySekvq37kfCNk,8272629,54671342,-46398713,619
2022-01-21 18:12:27-05:00,6234,3JrhHRs4UkkuMoCrQAaAGKZQrWoU72zWArnDGxKFESzH,8yREVE3kMYB7UAwtUDnTDK3egXTuTsN4igtJ5yeHYkCP,True,154869370,38717342,234946,117473,117473,3zqXX6kzhkbW3d4TwD2CNjMRwxTbREXySekvq37kfCNk,9397855,55061502,-45663647,606
2022-01-21 18:12:33-05:00,6235,GjQQ2fQ7mrGjWZwjVYFUKp9NM1LmfkhEo675ovU5SPa8,ECgVUMRY5nB4MALs5drDyipF7YohCPuJpj2UegCs7HMn,True,1326186,331546,2053,1026,1027,3zqXX6kzhkbW3d4TwD2CNjMRwxTbREXySekvq37kfCNk,82144,897527,-815383,619
2022-01-21 18:13:00-05:00,6236,3REbHhGGpn5b2GH67yQy2Dn7ZLNGLfM6hkBNU8UE1BRm,FBeCamJw884cPNpzbzhjSF7CFXyyhjnj3qWWCdBCK1NP,True,381987,95496,596,298,298,3zqXX6kzhkbW3d4TwD2CNjMRwxTbREXySekvq37kfCNk,23850,152442,-128592,624
2022-01-21 18:13:00-05:00,6237,GaEpNGa8jnwSRvjzzEMYkZe1pKcr2eiZtePrqFxpABjB,5CFZHuyWbJv14zPdX5dSQDREgHrCb4vsFvB6hLiEe3Ji,True,9810,2452,15,7,8,3zqXX6kzhkbW3d4TwD2CNjMRwxTbREXySekvq37kfCNk,613,6595,-5982,624
2022-01-21 18:13:00-05:00,6238,3tmdrjoBp8JsjUxZ87Fqjwsfmow5pjYjRyuYdvtjwK2D,uhC85HiGrbC8fBsU227msvkzEDAcY2EDAJcYoBR31Qg,True,6958465,1739616,10854,5427,5427,3zqXX6kzhkbW3d4TwD2CNjMRwxTbREXySekvq37kfCNk,434190,6301309,-5867119,623
2022-01-21 18:13:04-05:00,6239,DrzTARa7RK8RXoxHZPKCBqYtMC8TAUHRw8SznXRKTa5M,FYANet92VhyXkKZqqBJR4sFxuCftWb68sgQU9VHCdTJk,True,2126,531,3,1,2,3zqXX6kzhkbW3d4TwD2CNjMRwxTbREXySekvq37kfCNk,133,1395,-1262,625
2022-01-21 18:13:06-05:00,6240,GKKRAsYGdcf47eFThG4KwhNv7egeHRuc2wmTh4kqpego,4ippJxgnqCtdtGzCkdZoYwv68fiXNSqQcgrnaHdXZDUa,True,118707240,29676809,185626,92813,92813,3zqXX6kzhkbW3d4TwD2CNjMRwxTbREXySekvq37kfCNk,7425067,67600262,-60175195,625
2022-01-21 18:13:17-05:00,6241,CK3ocyWzXQkJJZQmM6bBK4Nv6Rh3UEufjY6DvNU6gJZy,C924o4GY3p2BHLeAbFbe9SEysXqCUyD8sFu2d4NzkAV7,True,419299,104824,653,326,327,3zqXX6kzhkbW3d4TwD2CNjMRwxTbREXySekvq37kfCNk,26132,258207,-232075,623
2022-01-21 18:13:22-05:00,6242,3y34hmyz6rsVnpp7d6a9s2Xw9GdezLU1H44HfieG6SGG,9DCz2eyYsrk1Hd5zsSVBhKTV9QD6beym5zB5fH3aA4hE,True,66491801,16622950,103909,51954,51955,3zqXX6kzhkbW3d4TwD2CNjMRwxTbREXySekvq37kfCNk,4156388,71546370,-67389982,625
2022-01-21 18:13:26-05:00,6243,2NHv3c4ufYGo3xNr6KXymAZJdpfURrNiCKbXZ7s82Vwo,E4NYpYgHTvSG6LqH2bBV9Q1XJ6pAzCp9FLSKMzJmYRrQ,True,1664972,416243,2602,1301,1301,72FwbpFGoLEazJEdpqNtPNefsadUrimUqma9wSoy4qiS,104103,1350396,-1246293,625
2022-01-21 18:14:04-05:00,6244,4Enpw9W2mWGnNYagYQ8WW29RLSs4R5YX4qXCsVqMFeHn,9QwbJmm9QDKXyc4ZViq74BfS35zzewEceXQNnFCgczXu,True,2153534370,538383592,3339038,1669519,1669519,3zqXX6kzhkbW3d4TwD2CNjMRwxTbREXySekvq37kfCNk,133561537,479767167,-346205630,620
2022-01-21 18:14:04-05:00,6245,GxFxvEUdWofneMmVvhCSScH9V6Zia5WJ2J9q6CpPnaq3,ATLykiHDii3Lw53MoZXwqu1FbBNPJbVNVGe2SoQMjVmY,True,266847,66711,417,208,209,3zqXX6kzhkbW3d4TwD2CNjMRwxTbREXySekvq37kfCNk,16680,200756,-184076,625
2022-01-21 18:14:21-05:00,6246,BMn3FQ6axnUt5K3esCEgoVi8GZAcPCg3YrjcwAFVvTah,HEvRK6CPti7aoTaYExEQAyr9ZyTQ6u4jg5Y2btc7ovdd,True,96228,24056,147,73,74,3zqXX6kzhkbW3d4TwD2CNjMRwxTbREXySekvq37kfCNk,5914,22729,-16815,614
2022-01-21 18:14:21-05:00,6247,BgNgALwBEuiumVgiXRmBZRnyFrr9QTDy2maHzsNwNHGf,ag35Ec2uFtqkarizCxFyhM2SPBuUwfmLRhAdFEWFCNa,True,14453301,3613325,21447,10723,10724,3zqXX6kzhkbW3d4TwD2CNjMRwxTbREXySekvq37kfCNk,857888,5384767,-4526879,593
2022-01-21 18:14:22-05:00,6248,7Dm3syN4P2mbBLFKyHTrtnSWY4hadGXiKB9EekTdT68S,HF97QS1dqarPMWgNmtcoaq6z3rpJnzAAAfc1PP4FwRhV,True,14700944,3675236,22194,11097,11097,3zqXX6kzhkbW3d4TwD2CNjMRwxTbREXySekvq37kfCNk,887788,3276844,-2389056,603
2022-01-21 18:14:22-05:00,6249,243SAnGxchCVB1LQAUF4SsozR86yDwEdg2QQpbWGsMYe,5u8sNkb2oEQjUXJAB3yGStmv3Uwz16gBgExBo5myVK4b,True,7326176,1831544,9619,4809,4810,3zqXX6kzhkbW3d4TwD2CNjMRwxTbREXySekvq37kfCNk,384784,3072738,-2687954,525
2022-01-21 18:15:02-05:00,6250,2pKygdXJnjZBFfrZgDasmHQQgw8LgycmBBRuaoCU72cz,DXsomQ5yWw2ceZMbaCVsSaE4hKm9W6Gy785JG75Aaz18,True,14579780,3644945,22712,11356,11356,3zqXX6kzhkbW3d4TwD2CNjMRwxTbREXySekvq37kfCNk,908487,5308878,-4400391,623
2022-01-21 18:15:04-05:00,6251,3FF2rhr1RuT7UR7MmmGtrhfYbh6kbc5UXq51KmqFLZnq,AEmSYLt1dQ8suLugC4Lcw4kF3dG9GYcEfX54hEAKfmv5,True,16193805,4048451,25048,12524,12524,3zqXX6kzhkbW3d4TwD2CNjMRwxTbREXySekvq37kfCNk,1001949,5897694,-4895745,618
2022-01-21 18:18:27-05:00,6252,8T4WK27RvWVGqPuNqY6whk1fmU4vd5qaUQPZG1GJ79bh,DvSz7knS8N3K7L6JhQf1s4mJSyxB8uJXNQXtyjJn8QRL,True,10331840,2582959,16156,8078,8078,3zqXX6kzhkbW3d4TwD2CNjMRwxTbREXySekvq37kfCNk,646268,6915216,-6268948,625
2022-01-21 18:18:38-05:00,6253,CxLFMBDFkoMvpK9YUf7WtCq6hn7k3QACAuetAnGjU6KA,2gE52a1GWQnS6ifV6eVtKQyr13LXP5Jdt3yG9SjGPJPF,True,136891386,34222846,214191,107095,107096,3zqXX6kzhkbW3d4TwD2CNjMRwxTbREXySekvq37kfCNk,8567661,49657847,-41090186,625
2022-01-21 18:20:07-05:00,6254,B2hN3Lt5pFbUyfEUc5s48hkxUJ5rr2SeFxgdGdQ8pDD2,7bZJCCud253j9g411HQUDXUAADcwd5yJWznoTChBdB2H,True,683602974,170900743,1066485,533242,533243,3zqXX6kzhkbW3d4TwD2CNjMRwxTbREXySekvq37kfCNk,42659435,195734590,-153075155,624
2022-01-21 18:20:07-05:00,6255,4uygLJDk9DFCifJ56YwMrEsvd3oQNq8tYSLnMCyWorS6,GimL4uKGvg3FFmFQSWzAcjstv3Vmk5NMgDGMKTuXYVpB,True,58346384,14586596,90759,45379,45380,3zqXX6kzhkbW3d4TwD2CNjMRwxTbREXySekvq37kfCNk,3630371,36239450,-32609079,622
2022-01-21 18:20:09-05:00,6256,A4tDE948CPFPh1UwHb8sXryfKktbxZ8BCkqXgA5DJHA8,3zXeKMrsEpCe5fQumLNzCgpxcG1kLJFEAtJuqxLsC6ZG,True,9744844,2436211,15154,7577,7577,3zqXX6kzhkbW3d4TwD2CNjMRwxTbREXySekvq37kfCNk,606186,6373573,-5767387,622
2022-01-21 18:20:09-05:00,6257,9WJBnVi84E926j7xEd566WzrZJkPJWRgmEnYj9vyjuad,4dLaFS5F7TGyLdwuJLMGkz3bSL53aHzd9ZfpNmhHxXeF,True,1725711,431427,2622,1311,1311,3zqXX6kzhkbW3d4TwD2CNjMRwxTbREXySekvq37kfCNk,104905,1261559,-1156654,607
2022-01-21 18:20:09-05:00,6258,FgQrRo4eGQAonSsFfQgnp8trGGqGZCLeGX6yvJnMnTjd,8KhemHLBY6nGmo3xMDedW2wnCSxQq6LwbTExif4sUSxx,True,154314613,38578653,234579,117289,117290,3zqXX6kzhkbW3d4TwD2CNjMRwxTbREXySekvq37kfCNk,9383163,44056468,-34673305,608
2022-01-21 18:20:10-05:00,6259,3XZLp6JyrQYnufa1obczXqmK6cNR29ZMW1FdCYbWNTCP,8kUTi1Prio14m9LjCj6Mari6pXwJTYkE1mp21LMn235p,True,89792,22447,140,70,70,3zqXX6kzhkbW3d4TwD2CNjMRwxTbREXySekvq37kfCNk,5606,37000,-31394,624
2022-01-21 18:20:10-05:00,6260,BgN75npBkPws5uiFE9RAujmPuZyAv2MQUPmfmJ1YCCij,78UFLNDn782TY2P4F5kRkMRC2s3gw8ak7sRQZRWNq82D,True,27007614,6751903,41836,20918,20918,72FwbpFGoLEazJEdpqNtPNefsadUrimUqma9wSoy4qiS,1673455,8408341,-6734886,619
2022-01-21 18:20:10-05:00,6261,6N4PNbueNmkCECF8ojw5R6wGtxComzgGED179GiJaLjQ,AL8eRDEo8yCvD4n4kvruEuZzXBXrJrEiBt9SQwCcDPYd,True,520937535,130234383,810764,405382,405382,3zqXX6kzhkbW3d4TwD2CNjMRwxTbREXySekvq37kfCNk,32430569,183635819,-151205250,622
2022-01-21 18:20:10-05:00,6262,gMjmD7WioyUdQdwNqE5fobLcxPwoJv5rAvLmJaf8Jjw,5n77euFjVJiwKrnbYq1KpcENW1mzBZj2BuDGyzazrkJ8,True,25784475,6446117,38683,19341,19342,3zqXX6kzhkbW3d4TwD2CNjMRwxTbREXySekvq37kfCNk,1547358,9331649,-7784291,600
2022-01-21 18:20:10-05:00,6263,Hy3kzXneDN6FUkiZctU1vWe97BYvj6yZ7QvQzehfWmNr,EhXgQg8BTniANV525RpY76z7Hrh6DuqrMChjqEoXfVJe,True,32693599,8173398,49333,24666,24667,3zqXX6kzhkbW3d4TwD2CNjMRwxTbREXySekvq37kfCNk,1973355,12019357,-10046002,603
2022-01-21 18:20:10-05:00,6264,399591e8XgY52yCMorCQ2WL6dQZTC485ZooHtmGuirhZ,JCiXAooFmKmEPQ2S7C8iSk6CLcTyrPEe1SsPSLyUGySe,True,120382,30095,185,92,93,HfEnetJ7uBSmZWCjBNxdvv9HEC5nsW4wDV7wu6WnhWan,7402,97479,-90077,614
2022-01-21 18:20:10-05:00,6265,J3ggP7ZxL8HRh3CBp5iYG2WgjLyNSAWYT46uC9VYDLCz,2FqTRiRPiLvdAH2BS5vroVntpsSXvTJEn5UHWmtKHzh9,True,3302650,825662,4961,2480,2481,3zqXX6kzhkbW3d4TwD2CNjMRwxTbREXySekvq37kfCNk,198466,1688667,-1490201,600
2022-01-21 18:20:10-05:00,6266,8E3K7vCHJ2xjdFofPRGLbMxrkm8UYEi926QmXPAFwsqe,4qHUDA1c43Dg4qi1ZPKqmpGYiEMUZ6r4UuzB5ftHCEhW,True,159485647,39871411,243839,121919,121920,3zqXX6kzhkbW3d4TwD2CNjMRwxTbREXySekvq37kfCNk,9753563,117552303,-107798740,611
2022-01-21 18:20:10-05:00,6267,BgnsCfJ54ReunUtwPJLzkW4PWnqpBDWGNYxsW5PvDrbK,KpMqEkQ9dKMgCevsEK895wHd3fCLRPSzDmJSv3tKU4u,True,1630524737,407631184,2483789,1241894,1241895,3zqXX6kzhkbW3d4TwD2CNjMRwxTbREXySekvq37kfCNk,99351591,937285193,-837933602,609
2022-01-21 18:28:32-05:00,6268,2MbNCikBC3fdwqJKfMK1FjPg7wT3xWMXmN88XuikJ8r9,5eG6U5x63YYMpE7iwwu1TPcZapvQMyKczvtnFfST1BH3,True,39739,9934,62,31,31,3zqXX6kzhkbW3d4TwD2CNjMRwxTbREXySekvq37kfCNk,2484,16406,-13922,625
2022-01-21 18:33:45-05:00,6269,DYqdjjx7PHxaHWTv6QC98aYZPDopJsTwfzaydLHGPn2,3EjvG9CUHmfRFhkq7kec31dKjjqiqEDxZAjgLeDNDQWu,True,62420033,15605008,91284,45642,45642,3zqXX6kzhkbW3d4TwD2CNjMRwxTbREXySekvq37kfCNk,3651386,15301479,-11650093,584
2022-01-21 18:34:01-05:00,6270,4ne6vC7qdxQYHJCsaeFAKZrKdFt2SwXGHQ3jrMHqt4DL,Cf1dLHY2WXH9rXbRKq5TT8THbdo9SdNUZq4rYhRCF9z,True,10965351,2741337,17154,8577,8577,3zqXX6kzhkbW3d4TwD2CNjMRwxTbREXySekvq37kfCNk,686187,4401486,-3715299,625
2022-01-21 18:34:34-05:00,6271,EXP61AETWHw3kHSjrJH1jQBt6cXR9Zebz34Cueb3KAzg,2JT9GrgdUKjuQQtXvZqevbjFquUQBMYDoADmBjDKWXj3,True,270391124,67597781,403379,201689,201690,3zqXX6kzhkbW3d4TwD2CNjMRwxTbREXySekvq37kfCNk,16135165,105634909,-89499744,596
2022-01-21 18:34:43-05:00,6272,7tDiadLeMrob7yD6R5SDskYn41tnQZVPjEc6W2vv6irK,AHZidccE9ERBcipuRQ2iGM9kHRpTnty7UNuYTFurvXB7,True,277101070,69275267,426279,213139,213140,4BnQKPLuE3DMTtxp8MjUBytgnhvxqq3ZTqZHTVZo4JJh,17051196,77523907,-60472711,615
2022-01-21 18:38:19-05:00,6273,3Xbsek5MsEGoWr3G9yhuohREr26B2vSQcjqXdspTFHta,2rPxkUiMo9wGDq8EvAiwY3ngRpKmL223cBWWNTYoBmFp,True,22055632,5513908,34183,17091,17092,3zqXX6kzhkbW3d4TwD2CNjMRwxTbREXySekvq37kfCNk,1367326,8695862,-7328536,619
2022-01-21 18:44:33-05:00,6274,243SAnGxchCVB1LQAUF4SsozR86yDwEdg2QQpbWGsMYe,5u8sNkb2oEQjUXJAB3yGStmv3Uwz16gBgExBo5myVK4b,True,5445086,1361271,8140,4070,4070,3zqXX6kzhkbW3d4TwD2CNjMRwxTbREXySekvq37kfCNk,325619,2391132,-2065513,598
2022-01-21 18:44:36-05:00,6275,8aKqLY7GXxNnGRK8Utke7o6EDGZATNDDF8Ph9Q27ppyi,7MQKkebLEzQgjWjByBMzzkn68yqtYivS4VDcraAScZR6,False,713808,713808,35077,1753,33324,3zqXX6kzhkbW3d4TwD2CNjMRwxTbREXySekvq37kfCNk,35077,249384,-214307,491
2022-01-21 18:44:40-05:00,6276,25NUDrsdLhS3fcARLiTMbbmZHvvzvzPj9xAdoN8sJBN3,8baNRGHfYRcLdhbHNuH72ofAWM9UojqhTMLnbBayzGnW,True,16327565,4081891,24860,12430,12430,DddJ7EWCmYEEZETCBNgAUSg81Ls6fZtiAaY5ekJ5sXx1,994403,7354989,-6360586,609
2022-01-21 18:44:43-05:00,6277,4Enpw9W2mWGnNYagYQ8WW29RLSs4R5YX4qXCsVqMFeHn,9QwbJmm9QDKXyc4ZViq74BfS35zzewEceXQNnFCgczXu,True,1582064769,395516192,2428412,1214206,1214206,DddJ7EWCmYEEZETCBNgAUSg81Ls6fZtiAaY5ekJ5sXx1,97136490,389955022,-292818532,613
2022-01-21 18:45:28-05:00,6278,2MbNCikBC3fdwqJKfMK1FjPg7wT3xWMXmN88XuikJ8r9,5eG6U5x63YYMpE7iwwu1TPcZapvQMyKczvtnFfST1BH3,True,29210,7302,45,22,23,HfEnetJ7uBSmZWCjBNxdvv9HEC5nsW4wDV7wu6WnhWan,1827,12864,-11037,625
2022-01-21 18:46:11-05:00,6279,BJaaH1SK1pF2kZQzmYpLFfDtm52CR9a5rd39RAPtLe8q,HUsT5FVxaisdnCvG1BQxX6zffjfL2Rwx5mMo5y8SDV7e,True,8034659,2008663,12198,6099,6099,3uL2NSR2ZdDqCiKfzA5SwwpddAnit22DBJo6uvvz1rRs,487934,3531551,-3043617,607
2022-01-21 18:46:11-05:00,6280,B5CTBTggmGFvGFSunjbB4C9tLKcYcULehmEiEXRihY2J,FX3ebF8P89rZBWfR74PDWUzxnLuDkUDgGcPYCBD5sMUG,True,98156362,24539090,150521,75260,75261,3uL2NSR2ZdDqCiKfzA5SwwpddAnit22DBJo6uvvz1rRs,6020874,42865099,-36844225,613
2022-01-21 18:47:26-05:00,6281,DYqdjjx7PHxaHWTv6QC98aYZPDopJsTwfzaydLHGPn2,3EjvG9CUHmfRFhkq7kec31dKjjqiqEDxZAjgLeDNDQWu,True,46135925,11533981,72025,36012,36013,3zqXX6kzhkbW3d4TwD2CNjMRwxTbREXySekvq37kfCNk,2881002,12297742,-9416740,624
2022-01-21 18:47:48-05:00,6282,GBpe8E33cNkFmMUuP3WjhDBBuQz7MHaDkpCJjGFaFkvu,3QYFKkgzZ1PKKAxCh4hMhgqrupoCcfRVkjuJZRWVZo3H,True,46168135,11542033,71190,35595,35595,DddJ7EWCmYEEZETCBNgAUSg81Ls6fZtiAaY5ekJ5sXx1,2847601,18477974,-15630373,616
2022-01-21 18:47:51-05:00,6283,CmvNNpdGVDGujBadaMmgKc8xgFfyV6G9PNEjD8zEND6L,EzmfinKBZ8TXoSugyTqdEdHWrHdTdpHQtc1TApfaNfDR,True,7273279698,1818319924,11118885,5559442,5559443,DddJ7EWCmYEEZETCBNgAUSg81Ls6fZtiAaY5ekJ5sXx1,444755410,4425361748,-3980606338,611
2022-01-21 18:47:51-05:00,6284,7feC64HZfQpniey2iXsMMgQXnfcunJus74DiKDeKaEUw,GstsCxAiBBEUrXNkvZZ9Sg4vNK916PsKe2Mx6e4M6dU7,True,465072,116267,720,360,360,HfEnetJ7uBSmZWCjBNxdvv9HEC5nsW4wDV7wu6WnhWan,28818,275624,-246806,619
2022-01-21 18:47:58-05:00,6285,72woixtGAuGazCMfsYfYBYLP7FuRj8Fwz9fynFo4MCE4,5237BmWkKf58PBeTUEiu3Ld5uKXEe8wcrJRmCnUoWWku,True,57916785,14479196,90273,45136,45137,DddJ7EWCmYEEZETCBNgAUSg81Ls6fZtiAaY5ekJ5sXx1,3610936,25213982,-21603046,623
2022-01-21 18:47:59-05:00,6286,8JtUn4uue4WzrySwnDQ74qzzWaKsoo11MbMvRh1ePDJN,8iahKConWg6fyZrkoze5eeujyNHA26AybYBpHwUr76Cu,True,182136816,45534204,272986,136493,136493,4BnQKPLuE3DMTtxp8MjUBytgnhvxqq3ZTqZHTVZo4JJh,10919444,84262074,-73342630,599
2022-01-21 18:48:24-05:00,6287,EDSf2w1UyGvbgMuxyoXL58ifR1dviZinnLBYnFmgjcNG,DFenkzbL9SUjs9cSCaHJ1eXK75mHfk3GSPRFs8TSzrFV,True,497637076,124409269,777605,388802,388803,3zqXX6kzhkbW3d4TwD2CNjMRwxTbREXySekvq37kfCNk,31104224,162659288,-131555064,625
2022-01-21 18:48:48-05:00,6288,4hZG7dM716SxDagiFGwt1gSC99B2QK1emGLV9TJmmuR8,7vjfUWySkyx4Z5qAaRr2VWnVvxHHNsvPj1PirGNSjM6,True,15611753514,3902938378,24378633,12189316,12189317,3zqXX6kzhkbW3d4TwD2CNjMRwxTbREXySekvq37kfCNk,975145352,6484912032,-5509766680,624
2022-01-21 18:48:57-05:00,6289,7oxuCEhooUZ5z2nnZRD226rcqdZgAR75SamX9DD7ejUf,CPqBb5ptWUPUJhVjshxNZCHd5RDF3fve29z4vz72JhvM,True,64171,16040,100,50,50,3zqXX6kzhkbW3d4TwD2CNjMRwxTbREXySekvq37kfCNk,4013,30313,-26300,625
2022-01-21 18:49:16-05:00,6290,GCNi25P1Ywvfx5JpyxFVV68sRkio7LEhFgY85ZqveKR3,34mxz8fCss7KNAbEi2Wj9z5dTgXCGxuq2vyqzBPChtmq,True,1184966910,296241727,1793544,896772,896772,3zqXX6kzhkbW3d4TwD2CNjMRwxTbREXySekvq37kfCNk,71741768,692074078,-620332310,605
2022-01-21 18:49:16-05:00,6291,D7XummfEc3NTK4qMvZegV3FrYuqc8mNgnQu3ujwemZtg,HHiRcecqzW7sGFTio7Ph6TYv3dGt64KWv4DEKgKm84fQ,True,462241,115560,690,345,345,HfEnetJ7uBSmZWCjBNxdvv9HEC5nsW4wDV7wu6WnhWan,27623,353970,-326347,597
2022-01-21 18:49:16-05:00,6292,4xn9vTtLZyNtCbBLLpcXUMWU8AnnZCov9rJaY6rew16T,5UNWdFw2CP44qS8oc4uPt8zxw6zFg8oXz8SUCedZLLEC,True,1965077,491269,3019,1509,1510,3zqXX6kzhkbW3d4TwD2CNjMRwxTbREXySekvq37kfCNk,120783,821847,-701064,614
2022-01-21 18:50:11-05:00,6293,8kJu5aqVSmW8FSZR9h6F75ftn9V2U9uMLBEKeqRaC855,FhVHByujkvwwtjTVpZ4mqSUqoMoBgeLUc5H7rbz3FgAt,True,9927091,2481772,15417,7708,7709,3zqXX6kzhkbW3d4TwD2CNjMRwxTbREXySekvq37kfCNk,616684,8064971,-7448287,621
2022-01-21 18:50:11-05:00,6294,8eTH6eJyyVeMno3UQkffeBg32xofKsQfkhLhXdtaf87s,BCFC7CPXrQPsUfJb2eYSht8GhaApWHpc49AeCXqaYq13,True,25133399,6283349,38576,19288,19288,DddJ7EWCmYEEZETCBNgAUSg81Ls6fZtiAaY5ekJ5sXx1,1543056,9058521,-7515465,613
2022-01-21 18:50:11-05:00,6295,FnAT8HKGgisYfeAbxKU2gSbCp8KbZHULRpaJX1NVijHy,2u637Crc2QzfSJmCnRNqeib3aZQVn4NGncpgM3Ph6jvm,True,3852162,963040,6014,3007,3007,DddJ7EWCmYEEZETCBNgAUSg81Ls6fZtiAaY5ekJ5sXx1,240596,2047854,-1807258,624
2022-01-21 18:50:11-05:00,6296,D9VKhnfLLCrntDGFYSfoxFaY76VnHmYZ1ZbyFXdKdibz,2hRCRH2pMDyQGYcXHa8Y6BZo6FbcGZf5VJC1v8Bp6tGa,True,10329844,2582461,16057,8028,8029,3zqXX6kzhkbW3d4TwD2CNjMRwxTbREXySekvq37kfCNk,642288,6037992,-5395704,621
2022-01-21 18:51:06-05:00,6297,DvuRmJkfn6FQczUKgYeaSCqwy2NTMunuAKNrnmxMvnzS,7LpWTX9dgBtW75kfEoB5WuNsDwEdw5s8CYSHh3J4qagM,True,5240085,1310021,8182,4091,4091,3zqXX6kzhkbW3d4TwD2CNjMRwxTbREXySekvq37kfCNk,327284,4052450,-3725166,624
2022-01-21 18:51:08-05:00,6298,FV3G5EsSmyiLAAoREhgDXwvzbxoyDeq4Mwfj4jK5fJ7U,5nhzbJmm5JAwGDpTZoenkM1u3XtMY4uN7Qsm3vFGtRJE,True,5099082,1274770,7968,3984,3984,3zqXX6kzhkbW3d4TwD2CNjMRwxTbREXySekvq37kfCNk,318730,1987300,-1668570,625
2022-01-21 18:53:37-05:00,6299,72L76qDRMK3M7X52zuuB9GVyvFFLDBZwFMpVjWjghXzA,4m2ZVuemUctu1edv4YJVAcjXzKwpbCmBujzoUmLDeA7h,True,39637791,9909447,58925,29462,29463,HfEnetJ7uBSmZWCjBNxdvv9HEC5nsW4wDV7wu6WnhWan,2357031,14462240,-12105209,594
2022-01-21 18:53:37-05:00,6300,BRK2EePsnQq54oaD2Ua4cxxKhdgVS2Kx57JKXCrBkeg7,7yskmLp2oA9qN38G7NBqVGggzs4ZoQ63HD4EnMVweMyY,True,1099416266,274854066,1649487,824743,824744,HfEnetJ7uBSmZWCjBNxdvv9HEC5nsW4wDV7wu6WnhWan,65979494,389031122,-323051628,600
2022-01-21 18:53:37-05:00,6301,AUH6YGBV8tDVX1E1WTo92Mubfx1DGsqfGeyUBqxo4fSr,33QZgMwmW32WuvmxD8XNbmF9ea88bLe3YTtNwHV73Wwu,True,23371156,5842789,34998,17499,17499,HfEnetJ7uBSmZWCjBNxdvv9HEC5nsW4wDV7wu6WnhWan,1399950,12718229,-11318279,599
2022-01-21 18:53:38-05:00,6302,A36aouot1oFLUtswuBUM4EVcis9chKaSJu53MRoPDjab,33U9gpq1RRFMGWDrWa3ezXXkwgBewdAS6QGgGVPtGvqb,True,30137406,7534351,45872,22936,22936,3zqXX6kzhkbW3d4TwD2CNjMRwxTbREXySekvq37kfCNk,1834892,16053335,-14218443,608
2022-01-21 18:53:38-05:00,6303,3VdSA9CED9f5swRwHX2U15U7J6Muaq8VPnCNy9CaGDHe,2YYstfnfdYic5NWmEbcUEHpccNUVd1EhuCkExvMsoMk8,True,560950,140237,847,423,424,3zqXX6kzhkbW3d4TwD2CNjMRwxTbREXySekvq37kfCNk,33891,458912,-425021,604
2022-01-21 18:53:38-05:00,6304,4MSyrHopFkuaCEEvLAUV9cJfVre6cLAx5sJF5LEMSCTX,6HhLHoswuDKrcixShWCDcquW6PgmbS5FidEnkM3bwuJQ,True,5752885,1438221,8730,4365,4365,3zqXX6kzhkbW3d4TwD2CNjMRwxTbREXySekvq37kfCNk,349217,1917232,-1568015,607
2022-01-21 18:53:38-05:00,6305,FsMiJiJZibohKoV5QRisWCjzuFd86xSxFb4m73AQmu93,7p3TSKBaG9SV2YNDnhutQKacPKpTTmgsEfzmK51t6sYb,True,23352706,5838176,35153,17576,17577,HfEnetJ7uBSmZWCjBNxdvv9HEC5nsW4wDV7wu6WnhWan,1406124,12505932,-11099808,602
2022-01-21 18:53:38-05:00,6306,5kwvkEtRFFD84j4ntVgxkacadgJaFvQ9JLhJqzLR7Y3G,GpMMkTv9T7y8DTiizuoJUsWvnSk3GSxADjRMGyYpryxm,True,2631901,657975,4086,2043,2043,3zqXX6kzhkbW3d4TwD2CNjMRwxTbREXySekvq37kfCNk,163459,1359594,-1196135,621
2022-01-21 18:53:39-05:00,6307,H3394S5wdbwXB4scjGAY8NsXxCdGy1Xebct18s42FM1K,Hz84L1EquzhCvBJP75ScKug46hYGdNMVNH16AdG4y5D8,True,5254672,1313668,7907,3953,3954,3uL2NSR2ZdDqCiKfzA5SwwpddAnit22DBJo6uvvz1rRs,316285,3179153,-2862868,601
2022-01-21 18:53:39-05:00,6308,7ptPfZnqDCvTWotn8wPGyzERTJYLBgk47j7qf8Ciq941,AfAGcFqFFPi6LCQXydgsPWidN35c7NbhBa7RLEaDQQCu,True,1519890,379970,2373,1186,1187,HfEnetJ7uBSmZWCjBNxdvv9HEC5nsW4wDV7wu6WnhWan,94959,699107,-604148,624
2022-01-21 18:53:39-05:00,6309,EitU96ThqHErybDn2j1NY6JHkqV1R3mWM1uWH7wYKr1T,2p9eYbLyBqXrhHtRKp1jJb7VGjCmb4LkA6kzqLr1ijet,True,13054305,3263576,19934,9967,9967,DddJ7EWCmYEEZETCBNgAUSg81Ls6fZtiAaY5ekJ5sXx1,797370,6571383,-5774013,610
2022-01-21 18:53:39-05:00,6310,5Rxuqgs4CaSKbfDXqBMFXkLTQ9dxrUjThXzoy3ouYVtK,BgvbKru66ebrGUcFFymGTmsaQv6GgcGMybiWaXqzBtwX,True,17337,4334,27,13,14,3zqXX6kzhkbW3d4TwD2CNjMRwxTbREXySekvq37kfCNk,1082,14800,-13718,624
2022-01-21 18:53:39-05:00,6311,CpxZ136k95cVjGqkJnNpDZKUgrJrfg8HrFDZPL6BgsK4,Fo7HtcrneUTsnGqygsxPQ63G5rayYodYT65xP6B6HusH,True,174155740,43538935,257461,128730,128731,3zqXX6kzhkbW3d4TwD2CNjMRwxTbREXySekvq37kfCNk,10298442,48182746,-37884304,591
2022-01-21 18:53:39-05:00,6312,36ByQojnxEckWdQTjqHfxKqCx9yjqWQsPsZyqaN72UWR,AZoirtS1fjX61agRM64tqThVinnJTh3BWgiHyNHPTgZP,True,66642,16659,104,52,52,3zqXX6kzhkbW3d4TwD2CNjMRwxTbREXySekvq37kfCNk,4162,53835,-49673,624
2022-01-21 18:53:40-05:00,6313,9KD2AifD5wFD4QkHYuawXbJgLWHrfj2QPF3fT8jhGVA5,Ga9gAqmkuHbqrr31sUFPqa1xa5WNxLWJWGPUaMxQqLdj,True,108882,27220,162,81,81,DddJ7EWCmYEEZETCBNgAUSg81Ls6fZtiAaY5ekJ5sXx1,6497,89977,-83480,596
2022-01-21 18:55:26-05:00,6314,DC4UVUDFWL3gVtgkX9hPtFgtxaA8DH5p94i4k9U3wyWv,3HCWqVvQQfRgSKitsTjGTduJ82ointZUSNtj13uea4kD,True,107953996,26988499,166816,83408,83408,DddJ7EWCmYEEZETCBNgAUSg81Ls6fZtiAaY5ekJ5sXx1,6672643,67205828,-60533185,618
2022-01-21 18:55:26-05:00,6315,3c4tj9J8QwB3exFchWei43nBh5xsYRZxEUfayi3JvYgm,Fyw1TEEDKhLFo16qxDsttsAwSkrfzpDe8Dmm3atEeXyN,True,24816146,6204036,38345,19172,19173,DddJ7EWCmYEEZETCBNgAUSg81Ls6fZtiAaY5ekJ5sXx1,1533829,16087108,-14553279,618
2022-01-21 18:55:32-05:00,6316,HELPNUwAqTX7gfHS4cnJnqXFM6Rb156tYcpsitKR9iDu,3RdfgDvLvsdZG5Cf6hKiKMQMqfidyxHzjYvUx1FZpeHQ,True,27192619,6798154,42423,21211,21212,4BnQKPLuE3DMTtxp8MjUBytgnhvxqq3ZTqZHTVZo4JJh,1696927,24552175,-22855248,624
2022-01-21 18:55:33-05:00,6317,2sPD4f4d3CCeFSwSC5vAGS3YoTsTGypYKfDeoJczebop,HWCRpcq2sXqJL7Vi8MtipQDwGSViE73bUxS36ETmvnP2,True,11067284,2766821,17218,8609,8609,3zqXX6kzhkbW3d4TwD2CNjMRwxTbREXySekvq37kfCNk,688741,4198224,-3509483,622
2022-01-21 18:55:56-05:00,6318,H1Z83zVoskNuBvYao1FjdLfETfhPpQFQUkniJfGxbaNz,EVqbBRV6Zy1tPLRevxpAykp8Mvv6tDZVTc4RmCKw4Gq1,True,167332877,41833218,259804,129902,129902,3zqXX6kzhkbW3d4TwD2CNjMRwxTbREXySekvq37kfCNk,10392198,105561479,-95169281,621
2022-01-21 18:57:04-05:00,6319,BgNgALwBEuiumVgiXRmBZRnyFrr9QTDy2maHzsNwNHGf,ag35Ec2uFtqkarizCxFyhM2SPBuUwfmLRhAdFEWFCNa,True,10671460,2667865,16698,8349,8349,HfEnetJ7uBSmZWCjBNxdvv9HEC5nsW4wDV7wu6WnhWan,667925,4231605,-3563680,625
2022-01-21 18:58:34-05:00,6320,AvwHizRhHUSahmvSg4jmTUErc7vAFSmkRAEsiKhXfW1m,3UrWYx8y9N5o9GYneSe6zyyHRTZzxwvcipQfHHYh7tEs,True,158902,39725,248,124,124,72FwbpFGoLEazJEdpqNtPNefsadUrimUqma9wSoy4qiS,9934,101501,-91567,625
2022-01-21 19:01:06-05:00,6321,BMn3FQ6axnUt5K3esCEgoVi8GZAcPCg3YrjcwAFVvTah,HEvRK6CPti7aoTaYExEQAyr9ZyTQ6u4jg5Y2btc7ovdd,False,69698,69698,3254,162,3092,3zqXX6kzhkbW3d4TwD2CNjMRwxTbREXySekvq37kfCNk,3254,18341,-15087,466
2022-01-21 19:05:16-05:00,6322,7oxuCEhooUZ5z2nnZRD226rcqdZgAR75SamX9DD7ejUf,CPqBb5ptWUPUJhVjshxNZCHd5RDF3fve29z4vz72JhvM,False,45794,45794,1404,70,1334,HfEnetJ7uBSmZWCjBNxdvv9HEC5nsW4wDV7wu6WnhWan,1404,23606,-22202,306
2022-01-21 19:08:48-05:00,6323,7Dm3syN4P2mbBLFKyHTrtnSWY4hadGXiKB9EekTdT68S,HF97QS1dqarPMWgNmtcoaq6z3rpJnzAAAfc1PP4FwRhV,True,10851406,2712851,16864,8432,8432,HfEnetJ7uBSmZWCjBNxdvv9HEC5nsW4wDV7wu6WnhWan,674575,2640673,-1966098,621
2022-01-21 19:12:35-05:00,6324,FLQcLhAsRBKnLcSYkK94Za6NhGudrCGhGGxFTdDhVC6L,7vr92sRGp6DopaDv3wJr7gw4BFmxY74K8kFheKyxZdLX,True,30627,7656,47,23,24,3zqXX6kzhkbW3d4TwD2CNjMRwxTbREXySekvq37kfCNk,1892,16029,-14137,617
2022-01-21 19:22:29-05:00,6325,7dmoK7QPki7R66SPQST4veUgVfnJbVToxxBPZveECiwK,4vh4REBDm5zBDmcjRCD9zNsny1HGneu7B2co4dSJNLL6,True,48122004,12030500,75261,37630,37631,HfEnetJ7uBSmZWCjBNxdvv9HEC5nsW4wDV7wu6WnhWan,3010452,32764124,-29753672,625
2022-01-21 20:48:06-05:00,6326,3JrhHRs4UkkuMoCrQAaAGKZQrWoU72zWArnDGxKFESzH,8yREVE3kMYB7UAwtUDnTDK3egXTuTsN4igtJ5yeHYkCP,True,114348892,28587222,178394,89197,89197,DddJ7EWCmYEEZETCBNgAUSg81Ls6fZtiAaY5ekJ5sXx1,7135774,43186874,-36051100,624
2022-01-21 21:29:46-05:00,6327,GjQQ2fQ7mrGjWZwjVYFUKp9NM1LmfkhEo675ovU5SPa8,ECgVUMRY5nB4MALs5drDyipF7YohCPuJpj2UegCs7HMn,True,978454,244613,1528,764,764,3zqXX6kzhkbW3d4TwD2CNjMRwxTbREXySekvq37kfCNk,61128,688852,-627724,624
2022-01-21 21:51:54-05:00,6328,243SAnGxchCVB1LQAUF4SsozR86yDwEdg2QQpbWGsMYe,5u8sNkb2oEQjUXJAB3yGStmv3Uwz16gBgExBo5myVK4b,True,4030312,1007578,6227,3113,3114,DddJ7EWCmYEEZETCBNgAUSg81Ls6fZtiAaY5ekJ5sXx1,249118,1851757,-1602639,618
2022-01-21 21:52:57-05:00,6329,4Enpw9W2mWGnNYagYQ8WW29RLSs4R5YX4qXCsVqMFeHn,9QwbJmm9QDKXyc4ZViq74BfS35zzewEceXQNnFCgczXu,True,1169260075,292315018,1827500,913750,913750,72FwbpFGoLEazJEdpqNtPNefsadUrimUqma9wSoy4qiS,73100004,310046114,-236946110,625
2022-01-21 21:52:57-05:00,6330,25NUDrsdLhS3fcARLiTMbbmZHvvzvzPj9xAdoN8sJBN3,8baNRGHfYRcLdhbHNuH72ofAWM9UojqhTMLnbBayzGnW,True,12065958,3016489,18631,9315,9316,DddJ7EWCmYEEZETCBNgAUSg81Ls6fZtiAaY5ekJ5sXx1,745255,5695417,-4950162,617
2022-01-21 21:53:43-05:00,6331,5NVD6QvomTAD35yNxSFZw4DhF2hCtV8drkbnGhBVtK5y,3JzkyPnREvoFZLL9JZuuDEnee3nuKcrqY3xLuXsmHwRo,True,2586310,646577,4043,2021,2022,3zqXX6kzhkbW3d4TwD2CNjMRwxTbREXySekvq37kfCNk,161742,2024014,-1862272,625
2022-01-21 21:54:04-05:00,6332,F9s8a7Cpiw5dw3a2aNFMofqwyDWNXvDLnSdJzoj1gRiV,GpKsQKJD79KBRWdCTkyi4zX7NaoCWsLUjrKxAwJB6o6s,True,1292565,323141,2016,1008,1008,DddJ7EWCmYEEZETCBNgAUSg81Ls6fZtiAaY5ekJ5sXx1,80665,600765,-520100,624
2022-01-21 22:30:51-05:00,6333,4D7mDXe7SdmbAx7kaD1mBNuEa7DzMi6TAwXURxtLEazk,5pSnT91PHoLdN6uhPnUtoD7cboLmndn26y1XouPx8vwW,False,83555,83555,1690,84,1606,3zqXX6kzhkbW3d4TwD2CNjMRwxTbREXySekvq37kfCNk,1690,51748,-50058,202
2022-01-21 22:38:32-05:00,6334,8VT2nxz5ZYDJFd9uL2XZwEXxChd9pjuMJNMAcutZubL1,EhAkiRbouzUAWtqQFsN8HEEfi46UVN8H8tyBP7CbgeLe,False,791,791,39,1,38,HfEnetJ7uBSmZWCjBNxdvv9HEC5nsW4wDV7wu6WnhWan,39,570,-531,493
2022-01-21 22:38:43-05:00,6335,X5SF9srgzDgBRBhv8xUWyszYYSQiqFF6cVnVLWzQgp1,7rTqnMkPuUUJFt5px1DxwsUK8U5fQUtnx9N4v6dA4vGb,True,2133,533,3,1,2,3zqXX6kzhkbW3d4TwD2CNjMRwxTbREXySekvq37kfCNk,133,1442,-1309,623
2022-01-21 22:39:24-05:00,6336,9ydHRjDWvWV2XqbXKKpeLDh2RV7WnQZWDTi4ahgDjGNh,AiJQBv4a1Z4w2rsRog5WTaKb4dTjAXfAvXcWoW4DztSW,True,4036452,1009113,6312,3156,3156,4BnQKPLuE3DMTtxp8MjUBytgnhvxqq3ZTqZHTVZo4JJh,252482,1555395,-1302913,625
2022-01-21 22:39:43-05:00,6337,GABCjRvhnVZwwR9aZLhkTfaH9xdp2hJK7J6h4kD5VzkC,JabV7oy3dp6jshtccn89ybinAuaf9dHVmKuiEjXDPT9,True,3726906,931726,5674,2837,2837,3pStmNaV47N2sqUtHJHLAtCKiN9JZ6jzNY9h94ng8G1D,226999,2538302,-2311303,609
2022-01-21 22:39:47-05:00,6338,D3mXrJzhHf8qRaoCKLschUxAFoijFCFuT6bmNZH4W7Cj,9E3Xtqw7TncXWnbhAbFJMtuNmP6WS3ooGuptzyzw7UpA,True,3725,931,5,2,3,3zqXX6kzhkbW3d4TwD2CNjMRwxTbREXySekvq37kfCNk,229,3131,-2902,614
2022-01-21 22:39:47-05:00,6339,5JShzaRBGGeGTPfweCcNaxvkb6A1deQcAcFcxWz8WbW4,F5JEUUaTHnsxeH6jnvyHgXjuMHdjjnygu6aXHk3qLFqh,True,58609943,14652485,89448,44724,44724,3zqXX6kzhkbW3d4TwD2CNjMRwxTbREXySekvq37kfCNk,3577955,44957912,-41379957,610
2022-01-21 22:39:47-05:00,6340,GgBCXShHpprQGxz83aEykieANhQPw9wHE65AFuSJBiWZ,JAoJ6sM7B3d2kQ5yTXAuoUDpvBX1qkb5uq1T8a1ra2zC,True,5189403,1297350,8058,4029,4029,3zqXX6kzhkbW3d4TwD2CNjMRwxTbREXySekvq37kfCNk,322336,1456844,-1134508,621
2022-01-21 22:39:47-05:00,6341,9rfebymEFqy2SoBoDKKUppZVRPr1zNh6gkFYkmVsqbqz,6pQ3MsewzM8jzKEQG5zJDry8iEMUjGA1UDJPEQjFWTgR,True,532398,133099,814,407,407,3zqXX6kzhkbW3d4TwD2CNjMRwxTbREXySekvq37kfCNk,32588,210997,-178409,612
2022-01-21 22:39:47-05:00,6342,H458vCw7tnmFmPgmmg1HaMmN35mqfnMSugKxddMgSWfX,E25tbasspnw8yTYh7q2VLG7DSvDH7M8N19eQwAtgQtfV,True,5190147,1297536,8079,4039,4040,3zqXX6kzhkbW3d4TwD2CNjMRwxTbREXySekvq37kfCNk,323172,1456935,-1133763,622
2022-01-21 22:39:47-05:00,6343,Grw2snBvSDMa7ev2nWZo81WoLfyavmXXxCV1ugHGk5Xe,AF1WVCQcBmXCnWbDx2s62vU99zW1AdhNoqbWvdrbiQVm,True,998627,249656,1548,774,774,DddJ7EWCmYEEZETCBNgAUSg81Ls6fZtiAaY5ekJ5sXx1,61930,639927,-577997,620
2022-01-21 22:39:47-05:00,6344,A7HnmwpMzu9yYuvURa1Zct5JUoFujFybc6Ympjciuz99,E41s3xNbU4haxQQjR8nXZwTpJCoLiJ2BJSncHDfc6HzS,True,35801824,8950456,55640,27820,27820,DddJ7EWCmYEEZETCBNgAUSg81Ls6fZtiAaY5ekJ5sXx1,2225608,19812302,-17586694,621
2022-01-21 22:39:47-05:00,6345,9TL17gjvWFdhSJkpXgfnX7fKF9c2hfw59k3g8WUqm8Cb,7TyxFBKG4z5Xv3js3n1gbEWWj1M9KBF7dEmFxjCPGidC,True,11903322,2975830,18148,9074,9074,3zqXX6kzhkbW3d4TwD2CNjMRwxTbREXySekvq37kfCNk,725936,6835843,-6109907,609
2022-01-21 22:39:47-05:00,6346,9YEzjb49Awvedv9yNc6LG54SkGBug2RYiJwiUV13mGsS,3H8w5WCD187NWWoZMNUCzUDdxTgqrRJLga8gDzUVXBgZ,True,70626,17656,110,55,55,3zqXX6kzhkbW3d4TwD2CNjMRwxTbREXySekvq37kfCNk,4400,62723,-58323,623
2022-01-21 22:39:47-05:00,6347,6kbTnDL9xhi1YvPLtFvRmk8aE1HWsxNAEALcQ9kdCJQW,3Z1kmT8dUJJTUqbrCWGSBqV12GHhzcs3ZGKwaXP8gpGW,True,861621383,215405345,1332355,666177,666178,3zqXX6kzhkbW3d4TwD2CNjMRwxTbREXySekvq37kfCNk,53294217,336682055,-283387838,618
2022-01-21 22:39:47-05:00,6348,AA6QgBaH9F8QfPT9xjztv9uELcADPxwUuXofkBV8dYg4,FCMXozSstTNA74FVCJ5hpYvNJamjutnoakHoBVnzwcWj,True,1712,428,2,1,1,3zqXX6kzhkbW3d4TwD2CNjMRwxTbREXySekvq37kfCNk,105,1221,-1116,613
2022-01-21 22:39:47-05:00,6349,6tWqNUhr9XZVB1sc33W8VEo7gbptDtnKzGVvMZ4Xh68n,8NdrSzU8Tc6Ng2o1RWKfXyZb7i8jm6waYTBomq24F8wZ,True,211219,52804,323,161,162,3zqXX6kzhkbW3d4TwD2CNjMRwxTbREXySekvq37kfCNk,12922,74253,-61331,611
2022-01-21 22:39:47-05:00,6350,CAkknoa9UFPMEZ1KWSfqtmnL7ArVNV3HRETLwecuuXP,4cHJYv3dxA6qjcuxUkGRuL7STWobGPKtoHFD4ACUbiWq,True,674507,168626,1055,527,528,3zqXX6kzhkbW3d4TwD2CNjMRwxTbREXySekvq37kfCNk,42206,445028,-402822,625
2022-01-21 22:39:47-05:00,6351,EV21gv8jEvXtmGDoGRNm5LJEvTBccLMZyVDCLsp54jP3,DGxxoU52aQNoUQcxdvQtv2H5q2PhK6TGkLgNSaFgnZrb,True,287304,71826,446,223,223,3zqXX6kzhkbW3d4TwD2CNjMRwxTbREXySekvq37kfCNk,17851,198359,-180508,621
2022-01-21 22:39:47-05:00,6352,KoCscQ9Q8TZHhmya5KaXBrwUEMTdCkEMRtrhvtgEmiZ,6aZ5AFMFoqf1X64RwAt1J4Yrx4WGGe2JMiEjqnQ2gEtk,True,30371,7592,47,23,24,3zqXX6kzhkbW3d4TwD2CNjMRwxTbREXySekvq37kfCNk,1884,13753,-11869,620
2022-01-21 22:39:47-05:00,6353,EeUACm9TkjHKES5U7Yj1oPhYmcp7R3tvesGBiP8txEzq,3qkmm4aS6EDirEDejmbm5PDw2jpYkC7zKqrMkmgeE5BA,True,14881,3720,23,11,12,DddJ7EWCmYEEZETCBNgAUSg81Ls6fZtiAaY5ekJ5sXx1,923,8907,-7984,620
2022-01-21 22:39:47-05:00,6354,2BH44k4TYoQSqsSs5EASqJhxpH17Fr8Ahxbg2MAkWa72,HwvvVWpqfN7NDsVYdxbCSbqxSrLCThwnJiZQHh2w2zJb,True,1156,289,1,0,1,3zqXX6kzhkbW3d4TwD2CNjMRwxTbREXySekvq37kfCNk,72,763,-691,622
2022-01-21 22:39:47-05:00,6355,BzSJ77zKaqtBk2cEL1XqFL97zTXXMRHmxtkgtXwCc3C,2g4KXTwy2MPSRQ2khNp1o1rn7CradEr9H4ySYKDoSWN9,True,650555,162638,1006,503,503,3zqXX6kzhkbW3d4TwD2CNjMRwxTbREXySekvq37kfCNk,40244,845761,-805517,618
2022-01-21 22:39:47-05:00,6356,EHJXCJ4ZxPY7F1CeDQkXxVCLyTBXAY2ouWMJfKic9EcK,3yxXBa3sJhUhK9auop8niypnuWiasge5waVTM1zzuhU7,True,71085011,17771252,109984,54992,54992,3zqXX6kzhkbW3d4TwD2CNjMRwxTbREXySekvq37kfCNk,4399394,29484343,-25084949,618
2022-01-21 22:39:47-05:00,6357,AKxRtcdpi7gWhAuL8ENj7zhgeQezzEXe9TSANE6bQoRA,2YH4vrU9deP8Cu6E8Hzf8GqKG1yVjv5pdz4FE7r5YKir,True,440524,110131,671,335,336,3zqXX6kzhkbW3d4TwD2CNjMRwxTbREXySekvq37kfCNk,26876,293263,-266387,610
2022-01-21 22:39:47-05:00,6358,AxjhBwz3yoP6bEtH1shjztXfMQwhTXyku2fk6oPYStef,6yB7A8yhvugS5fVnU7nYjJvU9KJWEQvT66TMCFTzWiP8,True,6146311,1536577,9571,4785,4786,3zqXX6kzhkbW3d4TwD2CNjMRwxTbREXySekvq37kfCNk,382873,2673215,-2290342,622
2022-01-21 22:39:47-05:00,6359,6WNPf4rFCX74PuyvdmzRFqbxWhguuxTQqBSdnaTVBd5D,9N7a9aiHGQsxFMgVbmWoCF9w95d12xyT7XFAwpHGkTLA,True,96993,24248,148,74,74,3zqXX6kzhkbW3d4TwD2CNjMRwxTbREXySekvq37kfCNk,5926,49107,-43181,610
2022-01-21 22:39:47-05:00,6360,75ycx5sUFBxDhY1uwuPCW22s2C6BydkJTje7q7zEQFGT,FpEgrVFRubjGK4DRjTqdVbxSECURpn16zfpoC31NbwnN,True,410292,102573,632,316,316,DddJ7EWCmYEEZETCBNgAUSg81Ls6fZtiAaY5ekJ5sXx1,25289,327649,-302360,616
2022-01-21 22:39:47-05:00,6361,8dE8PJp7BEYbmSrpMhvxh2Ro9KUiKoEFs3Mi7Xh18Cgz,CfiSeqS4D8EcG882PSLNXhwm5KJH7F1KGo5nSz13tGP8,True,4484498,1121124,6874,3437,3437,DddJ7EWCmYEEZETCBNgAUSg81Ls6fZtiAaY5ekJ5sXx1,274990,1414370,-1139380,613
2022-01-21 22:39:47-05:00,6362,JCagxpXPs6wVRUWbNBPCZ4uLCkZsachnofN7SZEEwGwB,5uGj1TBCkc7FV4ffdBJg31yLcCxkQLxRExjcinnJUow9,True,4949395275,1237348818,7689903,3844951,3844952,3zqXX6kzhkbW3d4TwD2CNjMRwxTbREXySekvq37kfCNk,307596145,3403066522,-3095470377,621
2022-01-21 22:39:51-05:00,6363,DZay4ADcfoFainzjooJ9To7sb4Dn4iEoMs8tnYVrdwN1,AV8ndys1dnL31GKm5tEJLk74y4L9DuP6gC8ZvUtuVxfM,True,61949282,15487320,96610,48305,48305,DddJ7EWCmYEEZETCBNgAUSg81Ls6fZtiAaY5ekJ5sXx1,3864405,55528863,-51664458,623
2022-01-21 22:39:51-05:00,6364,9jdfc9GFTecsdRuTjWFGX13niKKmeBxRgtv5j86uhSnU,HLWMShobjSkaLyXrNjgwVaUGVtbtdUSnr1XjqpXn1bLR,True,18863,4715,29,14,15,DddJ7EWCmYEEZETCBNgAUSg81Ls6fZtiAaY5ekJ5sXx1,1174,13629,-12455,622
2022-01-21 22:39:51-05:00,6365,J1CrDBB5Bk55z9ByXQavcHwRMTGpgVdndjWxRQthEvXQ,F9mDV56ds2RodotLvXfHdkMp4mhrBtFMse8iMYWUnSvw,True,37039800,9259950,57073,28536,28537,3zqXX6kzhkbW3d4TwD2CNjMRwxTbREXySekvq37kfCNk,2282922,32736442,-30453520,616
2022-01-21 22:39:51-05:00,6366,4miF1JWfTjjFHkrpffjGFGVfkkWFME4smk47dEcxpH4y,c4QGrEkmzRKVDbYJe3FuQfrzqBqajt8mnaKJYF2Fy3t,True,268656956,67164239,419740,209870,209870,3zqXX6kzhkbW3d4TwD2CNjMRwxTbREXySekvq37kfCNk,16789610,80332584,-63542974,624
2022-01-21 22:39:51-05:00,6367,HutRztBianNUgm9sJDWKUQBmoVyy8y7CfnNk4hHjSkEW,EtVfvPyiy5bizbCZxR19TNUgETf3QcmziBvMtc6o5zjr,True,15867628,3966907,24098,12049,12049,DddJ7EWCmYEEZETCBNgAUSg81Ls6fZtiAaY5ekJ5sXx1,963933,18563311,-17599378,607
2022-01-21 22:39:52-05:00,6368,4MmpDGUTyMcYEqJ1RoZ46AN2BhrBUseHaHqF8AmiTPyD,7HW2YZpYM349HMfW7u4h9ESZ1AXkwN8JcVDTNFzp9aTz,True,7730738,1932684,11994,5997,5997,3zqXX6kzhkbW3d4TwD2CNjMRwxTbREXySekvq37kfCNk,479786,6134558,-5654772,620
2022-01-21 22:40:29-05:00,6369,7CSCMFa9W52tBDVUbXbc3woAy3GByeA1wPJdp3MgznPa,3447ptuVFu6G8B6N63RmS8mRv4n9PfHneypHLvbeaGLn,True,8819152,2204787,13741,6870,6871,4BnQKPLuE3DMTtxp8MjUBytgnhvxqq3ZTqZHTVZo4JJh,549666,6208185,-5658519,623
2022-01-21 22:42:36-05:00,6370,FLMmm1T383a2eWS45cBbMXKCWFqgmiBAB662R4fhA78N,B8dRmhYvTJzZWZYthEchwKTKkBWHrqkFzBJAUMvG5eQE,True,31590816,7897704,48026,24013,24013,3zqXX6kzhkbW3d4TwD2CNjMRwxTbREXySekvq37kfCNk,1921054,19557475,-17636421,608
2022-01-21 22:42:36-05:00,6371,GhV3DChNShu8mGwUUy7VLidabCV6Y2aKdp7cqPynd6Ci,8R8QkgruGRCeE1pjXmn3WjdVDiawNbXFid8gU8BfabZA,True,1147,286,1,0,1,3zqXX6kzhkbW3d4TwD2CNjMRwxTbREXySekvq37kfCNk,70,756,-686,610
2022-01-21 22:42:36-05:00,6372,8BMDSWFtzq9fu1ubVGtSFw8fEaMg1uvJiECuJnN8e1pd,FwkETAXL296CirvQ2AJuSHHtdKsxkZkmXSwZVVHXVDhA,True,8366731,2091682,12730,6365,6365,DddJ7EWCmYEEZETCBNgAUSg81Ls6fZtiAaY5ekJ5sXx1,509207,5506205,-4996998,608
2022-01-21 22:42:36-05:00,6373,99NHcwD1iaf5FXM3UNb91SjNiiT3HwyQFQMhkGd5ASts,8syAydy52vSQQLzsLXW24BFw4VPeK66Vp3BmAbnHfgod,True,3181562,795390,4874,2437,2437,4BnQKPLuE3DMTtxp8MjUBytgnhvxqq3ZTqZHTVZo4JJh,194973,2216844,-2021871,612
2022-01-21 22:42:36-05:00,6374,2RZPBo8Z2BgZmsASo14ySTSwqqgqmfVEjPkiAwQ1VTgf,BRS5cYtEoPRoSvTAiQaT1svWRdLJWVfy8LUb4SCudCjS,True,314891,78722,488,244,244,3zqXX6kzhkbW3d4TwD2CNjMRwxTbREXySekvq37kfCNk,19538,210447,-190909,620
2022-01-21 22:42:36-05:00,6375,2fk7wZ4M5ZqaQ5ZeLuh6uivNhtiRkCsCe8T44JBFahn3,HgtXtbcJzNLsrh9asZbcgiYVRhiPpYAyp2BpSq9VKEsW,True,9376454,2344113,14518,7259,7259,4BnQKPLuE3DMTtxp8MjUBytgnhvxqq3ZTqZHTVZo4JJh,580757,5770024,-5189267,619
2022-01-21 22:42:36-05:00,6376,96DzqyUxsB1FKWrhLdTdjDcokuus6rbx83gLsghqPPwt,74CWb7SVoSy3ADysEzFEeMiS2fxHJ9gdUF9pzM3E52Gj,True,1246,311,1,0,1,DddJ7EWCmYEEZETCBNgAUSg81Ls6fZtiAaY5ekJ5sXx1,77,829,-752,617
2022-01-21 22:42:36-05:00,6377,D58t4uTjFumsUeYFaKnpV8BRTEQEqKXBreFTdwGrott7,67p6kHDfVqQijfcwugvZK59c3aRRH9x3eHxruqH8WEqF,True,31991406,7997850,49562,24781,24781,3zqXX6kzhkbW3d4TwD2CNjMRwxTbREXySekvq37kfCNk,1982516,11572719,-9590203,619
2022-01-21 22:42:36-05:00,6378,24X28Jdpnxsm2L1SdqSMhRtEuqvou95nHVHFXrnsvMBn,7gRi4quFb53FxbQrACq2SHmAyi1iftkcFjxn4imaC6n5,True,1706518,426629,2596,1298,1298,3zqXX6kzhkbW3d4TwD2CNjMRwxTbREXySekvq37kfCNk,103859,481406,-377547,608
2022-01-21 22:42:38-05:00,6379,6XHt7CrURSomkQrtVXV5JuKSZY4tQRpUyQKfCDaSTYaD,GCgcmPSDDBsn2smYbpiX3PJybDkQWtufPu4YRsbEEU8X,True,21687069,5421767,33004,16502,16502,3zqXX6kzhkbW3d4TwD2CNjMRwxTbREXySekvq37kfCNk,1320185,19605979,-18285794,608
2022-01-21 22:42:38-05:00,6380,5hUZ9uQFcYnjAQVVaGLJWdKyg7y1XMpoo8osQ9DeY7Xd,BdYiKWsjuzJLcHh3814mJ4xQ9JxoQKKcr7AHZ7Vxoavq,True,2609,652,4,2,2,3zqXX6kzhkbW3d4TwD2CNjMRwxTbREXySekvq37kfCNk,163,1786,-1623,624
2022-01-21 22:42:38-05:00,6381,4j19AEcDwhtAZrnoDc4epNPmEL1jPpVUMeg7RmQ72Qkb,84WB42AAGbczVE9txZPwXrx4FD5jP87r8QdDzEABTm5G,True,4230500673,1057625168,6437317,3218658,3218659,3zqXX6kzhkbW3d4TwD2CNjMRwxTbREXySekvq37kfCNk,257492681,3550690320,-3293197639,608
2022-01-21 22:42:38-05:00,6382,9fTuwsgtFHkUNTTeRR1DWYTno8bbdvNLvqjxLymzbnTe,DacYn36aCNRJmYKiP697yGJTPZDK1nCq7Q1Y7KiXW7Jq,True,182958816,45739703,280724,140362,140362,3zqXX6kzhkbW3d4TwD2CNjMRwxTbREXySekvq37kfCNk,11228990,73893712,-62664722,613
2022-01-21 22:42:39-05:00,6383,C7a8BtMjuLXkzxZBC4Wk2gjkGBmucLmDjokf9pyA1Mu6,GxwYNWwYTtFMUxuZvNC5qrEYuJzYiEURQVuBxssfCJzr,True,98548,24637,152,76,76,3zqXX6kzhkbW3d4TwD2CNjMRwxTbREXySekvq37kfCNk,6082,50082,-44000,617
2022-01-21 22:42:39-05:00,6384,GZZ8WePhKCrJLhXXvRD21rp79pFiaJeGykVsyeKAYe9W,6P1C9RDFQoFqZ5eFo59UwVnNrnyAWaNnACNQMqR3uJhs,True,91587331,22896832,141330,70665,70665,4BnQKPLuE3DMTtxp8MjUBytgnhvxqq3ZTqZHTVZo4JJh,5653205,30334667,-24681462,617
2022-01-21 22:42:39-05:00,6385,CEbGTNX6WpaoKp4RBGSn9LzYM6yAYyeiMrgVYgJxA4zb,AiXUcGAFFm4tc7vKBscSNjZawV5YJqbv7D1KpxD3Zufg,True,1174465,293616,1825,912,913,DddJ7EWCmYEEZETCBNgAUSg81Ls6fZtiAaY5ekJ5sXx1,73025,974064,-901039,621
2022-01-21 22:42:39-05:00,6386,7nByfyoLmMrzzVHsjxL2FRF72tfW3KiRT27BRGUp4PhP,36SF6NBnUc5wK41yfGCnujpCaCwExR3iRXJQx1WNakyM,True,2557264,639316,3894,1947,1947,4BnQKPLuE3DMTtxp8MjUBytgnhvxqq3ZTqZHTVZo4JJh,155767,988999,-833232,609
2022-01-21 22:42:39-05:00,6387,C3k34T2x8fW171coEG9YvoUePvxtHmrQMjVsX1Cb5ZbU,4mh5Tp4Jjh5X3GDERpSMAFgsfYJvysRdd1Nu5oJQ1Dhw,True,1467,366,2,1,1,DddJ7EWCmYEEZETCBNgAUSg81Ls6fZtiAaY5ekJ5sXx1,91,963,-872,620
2022-01-21 22:42:39-05:00,6388,B8kSMCHEX64joQD9EWuQFN15QunybWnKiiE8DuGZyMLk,EkKznVWgH3CLUXJk1uVWZUMvBRVPXakAVDwHXZwfm3bA,True,47097386,11774346,72649,36324,36325,3zqXX6kzhkbW3d4TwD2CNjMRwxTbREXySekvq37kfCNk,2905972,22899338,-19993366,617
2022-01-21 22:42:39-05:00,6389,8mbMH9EKd9kQDyFrYiDJCV9VaWxWCzpZBQZLyYN2yNVx,J9gT39dF1egMeQvweXYWeRAX3kpmBABijYZhfj6M2UqU,True,1445301,361325,2242,1121,1121,4BnQKPLuE3DMTtxp8MjUBytgnhvxqq3ZTqZHTVZo4JJh,89715,849133,-759418,620
2022-01-21 22:42:39-05:00,6390,3axqGcX5yuJ2vGxRjtNguefXUvSQHDQmn2zskhyCuQkf,EYrZo9zZDaHqFdc1fam63W3jvqqmbU67wzp6yFcppwsL,True,1728971,432242,2676,1338,1338,4BnQKPLuE3DMTtxp8MjUBytgnhvxqq3ZTqZHTVZo4JJh,107067,1981807,-1874740,619
2022-01-21 22:42:39-05:00,6391,6AHFxqjtpMsrCJ9E4ofrq4DVbaZSpDqyVMp6bznPqMg9,F3EauaowTvSs4NZ1EpUVonpNMmpMijcWHNi1AiKFZVxY,True,20273847,5068461,31330,15665,15665,3zqXX6kzhkbW3d4TwD2CNjMRwxTbREXySekvq37kfCNk,1253208,6931097,-5677889,618
2022-01-21 22:42:40-05:00,6392,4hrm69kAKNcfBkiP2YgtW94Pbip6FLfQAwnDRAAack69,BjbZRdGMoC7Mfoa4H19UvE2eQafgKD5rqnK7BSGwqS1s,True,2181,545,3,1,2,DddJ7EWCmYEEZETCBNgAUSg81Ls6fZtiAaY5ekJ5sXx1,136,1475,-1339,623
2022-01-21 22:42:40-05:00,6393,BmDwvPUjxBakng8ARj7cfjgYJUYCJhLeVnRYXcLDMy4G,8YVEshruc7LMMPf7vrPK9x5eLQGwe7py6bhZoxb9yfkz,True,23633481,5908370,36481,18240,18241,DddJ7EWCmYEEZETCBNgAUSg81Ls6fZtiAaY5ekJ5sXx1,1459245,7583865,-6124620,617
2022-01-21 22:42:40-05:00,6394,8sneA6wAg6geVDJ1g7YWg4R1PfjuRVzeHp1nUBJinhZa,14i1uWtmcTjrdbg3DSr9vzd5NBnxqsn1A4QdgFBZqeYM,True,17741,4435,27,13,14,3zqXX6kzhkbW3d4TwD2CNjMRwxTbREXySekvq37kfCNk,1104,11153,-10049,622
2022-01-21 22:42:40-05:00,6395,5rZTX6W9vTLL7uYzw8KWwY4zttCSQQTubfRn27QG7tBU,3Cdy8QmuBh7WvRxz18qAs1XVUU97ppqCyTS54huxGn2c,True,14461,3615,22,11,11,DddJ7EWCmYEEZETCBNgAUSg81Ls6fZtiAaY5ekJ5sXx1,895,9663,-8768,618
2022-01-21 22:42:40-05:00,6396,Mcbzp1LhZwpfmXTv1pqe9D1jCKHw443j9QKp6tUpzgM,8uforSMAKEih5jHfHp3gCqCvaugtCmhzVfVHA63Akz7F,True,128250,32062,196,98,98,DddJ7EWCmYEEZETCBNgAUSg81Ls6fZtiAaY5ekJ5sXx1,7871,102582,-94711,613
2022-01-21 22:42:40-05:00,6397,7LRBswSEDBjJzQ4YurfTxLydh7tFS2jVn5V95Z6wL7ci,fD41VYGmk66MW46KKb23vAqQvUSDScgXnVdsHhJBZzu,True,7576,1894,11,5,6,3zqXX6kzhkbW3d4TwD2CNjMRwxTbREXySekvq37kfCNk,463,5736,-5273,611
2022-01-21 22:42:41-05:00,6398,AVon82fTHT5KeqJkdoG4KkbGoVF3ocK4rqz52umUeEBy,LdgtwakPuhGZCh47WNERa6op7z2YtouJFv4mhFLtVgs,True,8189282,2047320,12715,6357,6358,HfEnetJ7uBSmZWCjBNxdvv9HEC5nsW4wDV7wu6WnhWan,508628,7979894,-7471266,621
2022-01-21 22:42:41-05:00,6399,8xQ3tsWVUe75EG1HmocULJ3kh52utveoFMEPotTGrKno,i3SKW3ywrwYucX9ySEx1C4zaUKGnzLerP3V38437NyV,True,8353797,2088448,13037,6518,6519,HfEnetJ7uBSmZWCjBNxdvv9HEC5nsW4wDV7wu6WnhWan,521486,6676489,-6155003,624
2022-01-21 22:42:42-05:00,6400,44iCXTAbcJMVscvvJQfTuVqj88V9QDgwXJDmVk7YcFBS,Dz3doggGiqe6rpazVjeA2j3XpRFmqesx7CRKsPAGKEVf,True,3644,911,5,2,3,3zqXX6kzhkbW3d4TwD2CNjMRwxTbREXySekvq37kfCNk,223,2431,-2208,611
2022-01-21 22:44:08-05:00,6401,Frobc1KZTVcsyfwyKwSpHJobxmiJBomzHhGCLdrzdAz8,HziyKP9uxWCuXddtbRzWMczHNdgyQB5UXQZj4MnMm14,True,28724686,7181171,43897,21948,21949,3zqXX6kzhkbW3d4TwD2CNjMRwxTbREXySekvq37kfCNk,1755915,11243248,-9487333,611
2022-01-21 22:44:08-05:00,6402,HwosLQgDY1xtHQRQ4hzroPQHFWssPzTj5vRkP37FcviB,HKTNEYNXrephNkH7apbobK4mcQXcNayQA4W1NgM6sLr8,True,5139889,1284972,7972,3986,3986,3zqXX6kzhkbW3d4TwD2CNjMRwxTbREXySekvq37kfCNk,318889,2559508,-2240619,620
2022-01-21 22:44:25-05:00,6403,DiB9SeCFXjioNGPJM3GuZ3FCG9KBZhHK27zCSN5b6gkq,GtK8UtKDQy9jgtTXvam4jja9N7c4EFuDQr4TKHgNyhXT,True,260212,65053,406,203,203,3zqXX6kzhkbW3d4TwD2CNjMRwxTbREXySekvq37kfCNk,16270,186937,-170667,625
2022-01-21 22:44:25-05:00,6404,3JzquEXUqphLYNmaVQLUTyrD6mJKXDcSSu9m39YCYvHf,Dk8mswH5HnCUmTEFvX4xHhUPk2m8VmgZW344BiNqg819,True,305733609,76433402,477875,238937,238938,3zqXX6kzhkbW3d4TwD2CNjMRwxTbREXySekvq37kfCNk,19115021,179480864,-160365843,625
2022-01-21 22:44:27-05:00,6405,ZoNjrSjYh4NJLW38LUPcf7jtEBxdaaM7T1zp795qjHE,FZx6v8cU25NwEosbKJ2n141o9uFAWURZB7NeCeX1trEn,True,90485,22621,141,70,71,3zqXX6kzhkbW3d4TwD2CNjMRwxTbREXySekvq37kfCNk,5659,45844,-40185,625
2022-01-21 22:45:39-05:00,6406,3ogBPSRcKfmwzgumVDHBkXLi1eCsEFG2xzSJgD4LQDNy,7TXyqWgJqfe71MSWFA2n7ufZbUdzf7JJoWej8FNNtMXo,True,1758395,439598,2742,1371,1371,3zqXX6kzhkbW3d4TwD2CNjMRwxTbREXySekvq37kfCNk,109711,1053356,-943645,623
2022-01-21 22:45:40-05:00,6407,7iUx7JBwqUvPVPeCqMEXQdLccZJmaFYm1DUQiu3ouHa3,3EVZzhRmJnX9ZiBZZo9tenDtMogAyuA1yf2cKzvUWiuu,True,97126571,24281641,151733,75866,75867,3zqXX6kzhkbW3d4TwD2CNjMRwxTbREXySekvq37kfCNk,6069348,29285057,-23215709,624
2022-01-21 22:46:18-05:00,6408,Buioe5v3DyFwD9nquW5XdYeVYbSABCyg79eUHEvtvfaW,7T9gi7prCcZJkYJMSB5Ef6Bu4pAuBw4XLvumSFnqKDSi,True,41906,10476,65,32,33,3zqXX6kzhkbW3d4TwD2CNjMRwxTbREXySekvq37kfCNk,2623,34872,-32249,625
2022-01-21 22:46:18-05:00,6409,FjDp4bWCtqehFD7FunCrjrcdxMezTJj5aqh2VnBvHDQU,HRYeZqcqhP1RPiAGXziR1qCWwk4sF6c5ZYbvSDhX7foN,True,475077,118769,743,371,372,4BnQKPLuE3DMTtxp8MjUBytgnhvxqq3ZTqZHTVZo4JJh,29726,306277,-276551,625
2022-01-21 22:46:18-05:00,6410,4wYJCHSQDev9kD8UVUEy3gEm9owvBCmXLX8QfTAXSyfd,4AUFhPprSux7rN1DVv6KXKxAGVAevx2DwCEUCpx2BAaw,True,1368030,342007,2140,1070,1070,HfEnetJ7uBSmZWCjBNxdvv9HEC5nsW4wDV7wu6WnhWan,85621,826755,-741134,625
2022-01-21 22:46:19-05:00,6411,FuoFPNTdYVDkSHaBac6UC1aNJXafSNTvFJuBCdrgQQrH,ApBS1Fx83tcECMzDV6wEzEzEdg4e2hgj3djtjRUoSKK5,True,248361123,62090280,388554,194277,194277,4BnQKPLuE3DMTtxp8MjUBytgnhvxqq3ZTqZHTVZo4JJh,15542174,132577036,-117034862,625
2022-01-21 22:47:05-05:00,6412,3FF2rhr1RuT7UR7MmmGtrhfYbh6kbc5UXq51KmqFLZnq,AEmSYLt1dQ8suLugC4Lcw4kF3dG9GYcEfX54hEAKfmv5,True,11953196,2988299,18661,9330,9331,3zqXX6kzhkbW3d4TwD2CNjMRwxTbREXySekvq37kfCNk,746454,4610425,-3863971,624
2022-01-21 22:47:06-05:00,6413,GxFxvEUdWofneMmVvhCSScH9V6Zia5WJ2J9q6CpPnaq3,ATLykiHDii3Lw53MoZXwqu1FbBNPJbVNVGe2SoQMjVmY,True,196808,49202,307,153,154,3zqXX6kzhkbW3d4TwD2CNjMRwxTbREXySekvq37kfCNk,12305,153691,-141386,625
2022-01-21 22:47:29-05:00,6414,8xvLGVeDmhVYQhN2ZpWkVG9jCrukRsNQ4926a4TMiZqa,9ciBySSjvADwp47WkETiFWZKVTFL8Hf1XvK7aSxhcgQS,True,2077563,519390,3251,1625,1626,3zqXX6kzhkbW3d4TwD2CNjMRwxTbREXySekvq37kfCNk,130048,1333245,-1203197,625
2022-01-21 22:47:58-05:00,6415,2pKygdXJnjZBFfrZgDasmHQQgw8LgycmBBRuaoCU72cz,DXsomQ5yWw2ceZMbaCVsSaE4hKm9W6Gy785JG75Aaz18,True,10740301,2685075,16419,8209,8210,3zqXX6kzhkbW3d4TwD2CNjMRwxTbREXySekvq37kfCNk,656769,4151600,-3494831,611
2022-01-21 22:48:41-05:00,6416,8JtUn4uue4WzrySwnDQ74qzzWaKsoo11MbMvRh1ePDJN,8iahKConWg6fyZrkoze5eeujyNHA26AybYBpHwUr76Cu,True,134756780,33689195,209193,104596,104597,3zqXX6kzhkbW3d4TwD2CNjMRwxTbREXySekvq37kfCNk,8367747,65221079,-56853332,620
2022-01-21 22:51:00-05:00,6417,A1j2G5FZRyWSjFt6dK87WHhLkQrPUVqHaM3KhSzhAKDT,2fMiHLYm4pL3YCd8aveTR4mT9uVxztQeMwb5eRZb4wUW,True,58337,14584,91,45,46,DddJ7EWCmYEEZETCBNgAUSg81Ls6fZtiAaY5ekJ5sXx1,3643,40330,-36687,624
2022-01-21 22:51:51-05:00,6418,9aQrdyfAvcBbBj7iKQB17eAS4zBqymdd3kzkTkuRhdLU,BDHhukMF5rALuSwCxaw8g73m2MN4oX1D4e7uNmx3SiVt,True,216240071,54060017,332616,166308,166308,4BnQKPLuE3DMTtxp8MjUBytgnhvxqq3ZTqZHTVZo4JJh,13304644,59373079,-46068435,615
2022-01-21 22:51:58-05:00,6419,woTXSsDkL9TQNxc3zwxSPagVijX7PE24bgKjvxexRwQ,A5M5EEPfDgvAxGLhpNgfn8AzPmyXxmPVgkEKnyoVzsz6,True,837175,209293,1309,654,655,3zqXX6kzhkbW3d4TwD2CNjMRwxTbREXySekvq37kfCNk,52381,730208,-677827,625
2022-01-21 22:52:56-05:00,6420,zLTuMVfVswjMkhyvjaXnvjcKXv5xNk3iSWSjRGpVqXf,J3D8NHUJCiSjvFYfJ5Es4YDhF1KcPZWRUmCQ5L92t8eB,True,35581000,8895250,55055,27527,27528,3zqXX6kzhkbW3d4TwD2CNjMRwxTbREXySekvq37kfCNk,2202223,8857872,-6655649,618
2022-01-21 22:52:57-05:00,6421,7hTjPRQSYAoWHhtpsVz2oKK5SAuFJd8dPHShKgKJq8dy,6DcHcrtcXR88d8e2KahhAiWTeRznNfF8oXLHmh5wE7wz,True,79600473,19900118,123925,61962,61963,DddJ7EWCmYEEZETCBNgAUSg81Ls6fZtiAaY5ekJ5sXx1,4957025,47767110,-42810085,622
2022-01-21 22:52:57-05:00,6422,78EeyPYzQjrmW6z9VGhRci6ihMUZb5rtpXo3GAxugf55,9AgZ45TMxaqwWGVWSgnEkvio3s6fXtHjAVRVCA7Zgsd2,True,4626450,1156612,7215,3607,3608,4BnQKPLuE3DMTtxp8MjUBytgnhvxqq3ZTqZHTVZo4JJh,288604,2430961,-2142357,623
2022-01-21 22:53:41-05:00,6423,CmvNNpdGVDGujBadaMmgKc8xgFfyV6G9PNEjD8zEND6L,EzmfinKBZ8TXoSugyTqdEdHWrHdTdpHQtc1TApfaNfDR,True,5368815854,1342203963,8255024,4127512,4127512,4BnQKPLuE3DMTtxp8MjUBytgnhvxqq3ZTqZHTVZo4JJh,330200974,3402725534,-3072524560,615
2022-01-21 22:54:29-05:00,6424,72woixtGAuGazCMfsYfYBYLP7FuRj8Fwz9fynFo4MCE4,5237BmWkKf58PBeTUEiu3Ld5uKXEe8wcrJRmCnUoWWku,True,42727493,10681873,66823,33411,33412,HfEnetJ7uBSmZWCjBNxdvv9HEC5nsW4wDV7wu6WnhWan,2672920,19585353,-16912433,625
2022-01-21 22:55:01-05:00,6425,J41kECimnpqjpS8nhNF8tAyGJFKoUr2FGKBsRbM4ae6P,CXGbaRB9isy46bFZ23HTDF1ULrLC3zfmuZwMkJYq8cjC,True,800252513,200063128,1250456,625228,625228,HfEnetJ7uBSmZWCjBNxdvv9HEC5nsW4wDV7wu6WnhWan,50018254,214375416,-164357162,625
2022-01-21 22:55:02-05:00,6426,4UGy8TajoMVzJNVVgyG5HHGseVNd6StrpA4XptQdm5Ej,9iRZ44dq3w9kMceCkbzwYQAPv6Wxnk2yKV8WDo7QXHfu,True,1707712,426928,2666,1333,1333,HfEnetJ7uBSmZWCjBNxdvv9HEC5nsW4wDV7wu6WnhWan,106668,1398806,-1292138,624
2022-01-21 22:55:47-05:00,6427,8pjAmnuqsXh8eP7XWphZmeCKYPGc8J2ux6u9VEGjjkPp,Bv67SHZoVqFhDZ7QRQLTUi1NR9zUPD9T7uw1zmoAuuTh,True,1378741,344685,2151,1075,1076,3zqXX6kzhkbW3d4TwD2CNjMRwxTbREXySekvq37kfCNk,86052,1238310,-1152258,624
2022-01-21 22:55:52-05:00,6428,C4dbwF9mioaBkZnyBFvFs6Cqd362VuGPBGPbTY9CAnAk,CcUqBfu1hbWm5VVxbtF2Xm6HUz4CLFzuDsjUi6KtnZQg,True,105277,26319,163,81,82,DddJ7EWCmYEEZETCBNgAUSg81Ls6fZtiAaY5ekJ5sXx1,6533,53308,-46775,620
2022-01-21 22:56:06-05:00,6429,6pUtYz474QrpATEZnfb3iFbTKYA65pNyKAo4TQZAjtqe,8dipRUXvxJiDLdHEtCPkso4vErbVwshHQiRfvSngBS9J,True,29223205042,7305801259,45578678,22789339,22789339,3zqXX6kzhkbW3d4TwD2CNjMRwxTbREXySekvq37kfCNk,1823147151,9272766145,-7449618994,623
2022-01-21 22:56:06-05:00,6430,2JXP6KUwPSmCrXT2uQRqSoCwH8RLYWwmqYsj3zXtv9xF,4qcFVgugXsHVQzFRP2he9CVzvv47xqgokJjigee8oPpP,True,384307912,96076978,590580,295290,295290,3zqXX6kzhkbW3d4TwD2CNjMRwxTbREXySekvq37kfCNk,23623200,127873593,-104250393,614
2022-01-21 22:56:09-05:00,6431,8trFFwvXKKMwMx952ugCZmqyw29e1HxEKBuQmFn8ZwTf,FsD7gCvHXM3QchQiDcd292ksy5afZMWApneNTat5ndeS,True,46269958,11567489,71967,35983,35984,3zqXX6kzhkbW3d4TwD2CNjMRwxTbREXySekvq37kfCNk,2878709,16365557,-13486848,622
2022-01-21 22:56:13-05:00,6432,F1G1Yb2jhT1hULYuNM9QMuNNA6vHZ2Wg4LhFGWsJmr78,2oF52s77UVwjbZMLmxyNsGRZ36RHqSJiV5VL7FzoWgyB,True,158158660,39539665,247250,123625,123625,3zqXX6kzhkbW3d4TwD2CNjMRwxTbREXySekvq37kfCNk,9890031,67397367,-57507336,625
2022-01-21 22:56:23-05:00,6433,EuvK7bsc3hbxqeJjJkLELCvS7kruCMAGDctn5u7Q7BnP,Dv4XTdwnp6Sv5zxkSwRwsdSzxApDtBr4A13x4vvzTVjm,True,3080979,770244,4788,2394,2394,DddJ7EWCmYEEZETCBNgAUSg81Ls6fZtiAaY5ekJ5sXx1,191551,2116227,-1924676,621
2022-01-21 22:56:23-05:00,6434,69byqtDPmgEY1NqKBCR95CEPVHRUxgbNW9Y4P4HjQ7ND,E47T4q4zMGzNL6vDxgWdLn3EQbW3WfVryr8Jsymy1hAL,True,34187576,8546894,53240,26620,26620,4BnQKPLuE3DMTtxp8MjUBytgnhvxqq3ZTqZHTVZo4JJh,2129621,20671194,-18541573,622
2022-01-21 22:56:23-05:00,6435,EgU9hX6VK7YXeCgCHVaJAMekCcyZa2MVWdKra5pN7Gwv,7y8Ad9XY34bqREvheXHT2tr8Jy11D6X3pu7yLVtjU4QV,True,585894,146473,911,455,456,4BnQKPLuE3DMTtxp8MjUBytgnhvxqq3ZTqZHTVZo4JJh,36440,447274,-410834,621
2022-01-21 22:56:23-05:00,6436,DiPSJvnnEwg1En7HJfEsKrUbBgtUf4KzGMyMCZDQSYgp,s8UVC6vPBofuXUS6RW1aQmZ8C35PrC5r4A6ugmvzLGB,True,115056,28764,179,89,90,4BnQKPLuE3DMTtxp8MjUBytgnhvxqq3ZTqZHTVZo4JJh,7173,58423,-51250,623
2022-01-21 22:56:26-05:00,6437,EEcTbsFTUEifcdbPyjBLkS943daEx1RpR8F3uZxKRZbT,8V3JzDQ1VWYQLas8fxUsWJZZHe4gEmn74RehtUwLw3k5,True,316585,79146,490,245,245,3zqXX6kzhkbW3d4TwD2CNjMRwxTbREXySekvq37kfCNk,19631,240236,-220605,620
2022-01-21 22:56:26-05:00,6438,2ce2v2TCbjNH635NgbwTG3sqiRWYrRRaBpxPxBZJ929q,9cnoebT43FkWDFhidndGCVNiFD4NErv8DuL1Va4Jv9S8,True,355891,88972,554,277,277,3zqXX6kzhkbW3d4TwD2CNjMRwxTbREXySekvq37kfCNk,22164,386952,-364788,622
2022-01-21 22:56:27-05:00,6439,4KMzwWHPeW51cxu4nMpbqCaqo96dMqaHWyRCGQktfQfd,F7q4GNYcbnZa8dJ4qovQwjmxpKpdEmdxQMXRPb9nQupa,True,58028930,14507232,87103,43551,43552,3zqXX6kzhkbW3d4TwD2CNjMRwxTbREXySekvq37kfCNk,3484157,17887366,-14403209,600
2022-01-21 22:56:30-05:00,6440,GGcsY84pkqUn2xySuLYrUUg8gWMBWgfHaQ7rK42NoZaH,4EyjJvctL9WBQiauD2Eaf2Hus8htYzHxP5GR2HsUfuks,True,193477726,48369431,291840,145920,145920,DddJ7EWCmYEEZETCBNgAUSg81Ls6fZtiAaY5ekJ5sXx1,11673611,90223801,-78550190,603
2022-01-21 22:56:33-05:00,6441,CbhrZUdan1axNDFUrX1ZuEohfNMEGrszKSkk6pppVQuw,DHEAjJNtuEePezYAv77thWabbVxxqQpfuiC6moRSrpG1,True,7651551,1912887,10681,5340,5341,3zqXX6kzhkbW3d4TwD2CNjMRwxTbREXySekvq37kfCNk,427279,6289986,-5862707,558
2022-01-21 22:56:33-05:00,6442,HHHj6EinpgAJeZkDXfsvCo3UXnmAdiAZNvPSUfVPc5Sg,3gx9c31MDtJtByxkUuWcqf1oARnZTjpx3QtxsM1Xb6Gp,True,62150800,15537700,93672,46836,46836,3zqXX6kzhkbW3d4TwD2CNjMRwxTbREXySekvq37kfCNk,3746892,34571252,-30824360,602
2022-01-21 22:56:33-05:00,6443,2jDRvE3pQNjWy1NRFa4tzB3KmU5UkbUCHw8sQRFujo66,C4zNi2szDrEEh4coTF3WRUghfP4ZwAVVSYTLWfkejQRu,True,39688250,9922062,61726,30863,30863,3zqXX6kzhkbW3d4TwD2CNjMRwxTbREXySekvq37kfCNk,2469055,23578006,-21108951,622
2022-01-21 22:56:33-05:00,6444,GufVttJatW8NLeztT1NRQSLZpQNRk45kaG41p3QcWhx7,GTJUsWoWRyeafYJVhx2aRo8NE94U5UrBjaehmJ4PRUhn,True,2320209,580052,3523,1761,1762,3zqXX6kzhkbW3d4TwD2CNjMRwxTbREXySekvq37kfCNk,140936,1198806,-1057870,607
2022-01-21 22:56:33-05:00,6445,6kqKSyVVF4xxUbsvBCkY1kt4XcKzb98eSaqNw5fxSLtw,4T9DKFUmkcPG7mM3CKzW3m81LqqpU7oFTv35Pha4zHNe,True,137294648,34323662,207825,103912,103913,3zqXX6kzhkbW3d4TwD2CNjMRwxTbREXySekvq37kfCNk,8313011,84270133,-75957122,605
2022-01-21 22:56:33-05:00,6446,JDeYjCLpfnzcfxDFgHf4aBcHsajwdR14GUaKAA9euzVf,EJbvKoyMZcoCx4vWa61uMbW2vr6mUhrgEuECdteVBuZZ,True,643630,160907,922,461,461,3zqXX6kzhkbW3d4TwD2CNjMRwxTbREXySekvq37kfCNk,36908,546720,-509812,573
2022-01-21 22:56:33-05:00,6447,5eMLdQ4gYA5iqvTXSNdGvctHp7s5VpyFuwtJKqx6chBc,Ckxc5K39nkBNXBTmFTM8J48R7wGqNm3vHKZu4G5baumZ,True,27092785,6773196,39457,19728,19729,3zqXX6kzhkbW3d4TwD2CNjMRwxTbREXySekvq37kfCNk,1578294,15273392,-13695098,582
2022-01-21 22:56:33-05:00,6448,DY6k3Dkwe18iLneaT8Xo3VpJWB6V4jWwQQjoDvEzdg2j,3GGV7S9FpRQGbARBXkvGFVqLrmw8JvYAcpnR1aKVUY2f,True,1025846,256461,1585,792,793,3zqXX6kzhkbW3d4TwD2CNjMRwxTbREXySekvq37kfCNk,63406,858784,-795378,618
2022-01-21 22:56:33-05:00,6449,DWTaeNeq5x83cBvKUz2jZfXDz5z4F5wbSZLNv7smnjvd,9pQGArZnJV4Fu8tBVEfknmmfmrRv5RKV2u58BJBuhzpF,True,7734337,1933584,11724,5862,5862,3zqXX6kzhkbW3d4TwD2CNjMRwxTbREXySekvq37kfCNk,468991,4599952,-4130961,606
2022-01-21 22:56:35-05:00,6450,DkvR2xUPMyXWGGkUSmDSfhp7RtvMkfbT1ThKCS3TwrXd,F7jYV6TtT1LZ5XCNn1zkbUfNMo4gGcQUczAQy1jLHpaW,True,50460610,12615152,77926,38963,38963,DddJ7EWCmYEEZETCBNgAUSg81Ls6fZtiAaY5ekJ5sXx1,3117047,33470911,-30353864,617
2022-01-21 22:56:37-05:00,6451,8swGZMrPrLAxZd7MxTbkCL13k3DmAJUw41jCp6Xo6awW,3fKnX7yTNXAT4uMmXVdTy47ALJT8h8YSD3WiBb4BGuzH,True,19222659,4805664,29368,14684,14684,HfEnetJ7uBSmZWCjBNxdvv9HEC5nsW4wDV7wu6WnhWan,1174727,12990707,-11815980,611
2022-01-21 22:56:37-05:00,6452,HpDwBPWZHfLzJUvTTABTA6qddyLLJiVTfqBx5gUktSUb,BqXLpaAeTNfNSeevfdazNqTgqEXj6Edgp8txWvCoxEz6,True,72192721,18048180,102335,51167,51168,DddJ7EWCmYEEZETCBNgAUSg81Ls6fZtiAaY5ekJ5sXx1,4093417,55639578,-51546161,567
2022-01-21 22:56:37-05:00,6453,Bsr6kx1B6BSEd5UnJ7Z61M49iUb3bFrDVhiEtMVtPDF2,3CFd1pUJAJPA9fobwn4Jj2mRju1CWmoop4Mh4znypNWT,True,2420699,605174,3559,1779,1780,3uL2NSR2ZdDqCiKfzA5SwwpddAnit22DBJo6uvvz1rRs,142383,1447923,-1305540,588
2022-01-21 22:56:38-05:00,6454,Fani89KviVFZek4si6YZ3apVuM2kSqVUijDnLBqtvJEH,EpC29dECx1cLC69bj2ncG3jFp7obPaxbH7F6mju27cwL,True,1816712,454178,2710,1355,1355,DddJ7EWCmYEEZETCBNgAUSg81Ls6fZtiAaY5ekJ5sXx1,108405,624405,-516000,596
2022-01-21 22:56:38-05:00,6455,G25vsB3sDqRhHoSK4KwR1TywfrJDtpejVbbevEG9sQ9a,5xFC3Hm13magnAA9GD1EnwC9PrPoEfQ7omEa9p9zCrB1,True,24706072,6176516,34892,17446,17446,3zqXX6kzhkbW3d4TwD2CNjMRwxTbREXySekvq37kfCNk,1395687,9373081,-7977394,564
2022-01-21 22:56:38-05:00,6456,AWvHDdb2ikqV8wc7qQ8azbvNTZdixMNxhQjhQdhayYtR,9EpgEPBb1nog6aQeFdMXfSRiLSnzGQFQ39mbLdCxgYTv,True,3824977,956244,5534,2767,2767,DddJ7EWCmYEEZETCBNgAUSg81Ls6fZtiAaY5ekJ5sXx1,221395,1996365,-1774970,578
2022-01-21 22:56:39-05:00,6457,D64rDiWT3YG28fCgXCmbNjYa2JakZbpKQ1D2XuLChUfV,8WmMWq8cTsGQym5pUbHm9dPCpJugBeWUMVERYFGLxWHj,True,2955228,738807,4408,2204,2204,3zqXX6kzhkbW3d4TwD2CNjMRwxTbREXySekvq37kfCNk,176320,1675213,-1498893,596
2022-01-21 22:56:39-05:00,6458,DDuXUcRDez68Tx651sVKxjubhTdNHkuarbeDEKFp5HRs,DNWcrd23zaT7LuXHuhPVqqAvLVpEzoqebr4sho45CphT,True,2791250,697812,4300,2150,2150,3zqXX6kzhkbW3d4TwD2CNjMRwxTbREXySekvq37kfCNk,172018,963800,-791782,616
2022-01-21 22:56:39-05:00,6459,6NJFN855M3Q3RLTDNo57gTgAmwPD6G2E3WvMb1m5eNCN,3YpqNnonsvXaRT4nCC3G5FZx1jjVtbDPc36LiR6WK5jR,True,6291164,1572791,9490,4745,4745,DddJ7EWCmYEEZETCBNgAUSg81Ls6fZtiAaY5ekJ5sXx1,379631,5256182,-4876551,603
2022-01-21 22:56:39-05:00,6460,8trkirSQNdMmAcJdeswxs5cPjH8dD6U4eJtWiAdMsrDB,HaSzpQ45x2MipfN17U6jGBxX8tXboomVDhXNSrnEfLDr,True,273671,68417,416,208,208,3zqXX6kzhkbW3d4TwD2CNjMRwxTbREXySekvq37kfCNk,16658,180534,-163876,608
2022-01-21 22:56:41-05:00,6461,BhiAaiZu7fF8ndggJrLyiFVCRq526cNBw7VaeascEmNL,4en8MipPi7vq15NGhpPMQfptNdEyhp2j7fpgxBBtjyfz,True,77121455,19280362,116759,58379,58380,4BnQKPLuE3DMTtxp8MjUBytgnhvxqq3ZTqZHTVZo4JJh,4670367,23344708,-18674341,605
2022-01-21 22:56:42-05:00,6462,CYkojG4q1SnizNs59qsYTEBU1c11XC8nteMhxRbwhCBq,A9MsPy3aeMzdQUWXK6qmWLiZfKREiBrSVaJAKp2nEcSt,True,1858871,464717,2646,1323,1323,3zqXX6kzhkbW3d4TwD2CNjMRwxTbREXySekvq37kfCNk,105866,1121895,-1016029,569
2022-01-21 22:57:03-05:00,6463,5BjBPqumCb9KC82ZNNch3dcRzbpGdRLJneru7o9a1D9R,FuZtBWKktxFu4yoiLVMzxq8fMhQyN8SGzGPz49xs3m6P,True,8713804,2178451,13623,6811,6812,3zqXX6kzhkbW3d4TwD2CNjMRwxTbREXySekvq37kfCNk,544954,6649250,-6104296,625
2022-01-21 22:57:09-05:00,6464,DXCbqHqSGrq8dG6CmA5JwKXQTidVBSqE8vCxHxNBcF2z,6z5Ghi47Miuie5Tn72rLp4uBf1EALB8wPsmzrtb1DwZS,True,5194589,1298647,8118,4059,4059,4BnQKPLuE3DMTtxp8MjUBytgnhvxqq3ZTqZHTVZo4JJh,324727,1454048,-1129321,625
2022-01-21 22:59:46-05:00,6465,91tPxdvLhrVtytKuNkf33XocRnpEqA1x3jDb1Je6xeui,2ByoMpaZg1uzkA48vMufvcx8BLYxWLXUK3tXAJcupanF,True,1866,466,2,1,1,HfEnetJ7uBSmZWCjBNxdvv9HEC5nsW4wDV7wu6WnhWan,116,1234,-1118,621
2022-01-21 22:59:46-05:00,6466,7MSzV5yy5FmrM4j1BcYSRiTGWfit1AJahheRUaXzz349,aPSTZLxBpVr3sucjbj95emRV2J1GrUWr7wbARYqJkQZ,True,263252,65813,410,205,205,3zqXX6kzhkbW3d4TwD2CNjMRwxTbREXySekvq37kfCNk,16436,154628,-138192,624
2022-01-21 23:32:04-05:00,6467,442usWu6XpJZvU25bqXeynRrQ15jAzWwU9DWMgHpTn3Q,CtvADKp39bjJf3cPKWNL3wxnhq273fVM4fC5DmEcg5cC,True,3353670631,838417657,5227069,2613534,2613535,HfEnetJ7uBSmZWCjBNxdvv9HEC5nsW4wDV7wu6WnhWan,209082771,1163686352,-954603581,623
2022-01-21 23:32:47-05:00,6468,BgNgALwBEuiumVgiXRmBZRnyFrr9QTDy2maHzsNwNHGf,ag35Ec2uFtqkarizCxFyhM2SPBuUwfmLRhAdFEWFCNa,True,7884015,1971003,12299,6149,6150,HfEnetJ7uBSmZWCjBNxdvv9HEC5nsW4wDV7wu6WnhWan,491975,3281780,-2789805,624
2022-01-21 23:34:54-05:00,6469,7Dm3syN4P2mbBLFKyHTrtnSWY4hadGXiKB9EekTdT68S,HF97QS1dqarPMWgNmtcoaq6z3rpJnzAAAfc1PP4FwRhV,True,8009210,2002302,12513,6256,6257,HfEnetJ7uBSmZWCjBNxdvv9HEC5nsW4wDV7wu6WnhWan,500543,2104464,-1603921,624
2022-01-21 23:38:09-05:00,6470,2SNV9Q6vzQP5XxxqSrwXpQdRvk45FPiqLXmhNZzbLt1k,6dLG3ojK5Unm1mBh9aDZfryvoT2a6cSuWA8CxXy3oi7n,True,155848163,38962039,243471,121735,121736,HfEnetJ7uBSmZWCjBNxdvv9HEC5nsW4wDV7wu6WnhWan,9738859,91196843,-81457984,624
2022-01-21 23:38:45-05:00,6471,2r64Rnbu3ZjmJTHHUxxV9TWWGzwpAepA4ySbtKivBXCj,6RRzx6KLkMiFK9JSuznrSJGiPgkHwatBSskudHqbfKJ5,True,877234716,219308678,1364661,682330,682331,HfEnetJ7uBSmZWCjBNxdvv9HEC5nsW4wDV7wu6WnhWan,54586478,444385156,-389798678,622
2022-01-21 23:41:26-05:00,6472,HGAFdundf5voDqeh9g7d6Q9mgMf8eEg898QMRBqwPZ6C,deanBuZXWBHEe2TGfP37S9aMBEnEgmZoyRJjAvruzfA,True,9605924,2401480,14996,7498,7498,4BnQKPLuE3DMTtxp8MjUBytgnhvxqq3ZTqZHTVZo4JJh,599868,7147892,-6548024,624
2022-01-21 23:42:54-05:00,6473,DRVtEzZs9u9ysrcANZLEjrvbuuGqYn77v2h4cDFKuNUx,Fv9qiMZhuSBL2cs9AWUYbDLQjB46W2ZwrhxaNXtPLDpC,True,9996867,2499216,15493,7746,7747,HfEnetJ7uBSmZWCjBNxdvv9HEC5nsW4wDV7wu6WnhWan,619731,2752738,-2133007,619
2022-01-21 23:57:43-05:00,6474,HEFpdWLZaiQnjftmXgxs6RNzhH72YiMjortxPkKekkvb,5Q8mmxBgVTijNGrWsnoA3VMArLHZEX5MkaigYXHpgXHE,True,79642393,19910597,124202,62101,62101,HfEnetJ7uBSmZWCjBNxdvv9HEC5nsW4wDV7wu6WnhWan,4968081,23034878,-18066797,623
2022-01-21 23:58:51-05:00,6475,B5CTBTggmGFvGFSunjbB4C9tLKcYcULehmEiEXRihY2J,FX3ebF8P89rZBWfR74PDWUzxnLuDkUDgGcPYCBD5sMUG,True,72442927,18110731,110259,55129,55130,3zqXX6kzhkbW3d4TwD2CNjMRwxTbREXySekvq37kfCNk,4410361,33218016,-28807655,608
2022-01-21 23:59:09-05:00,6476,BJaaH1SK1pF2kZQzmYpLFfDtm52CR9a5rd39RAPtLe8q,HUsT5FVxaisdnCvG1BQxX6zffjfL2Rwx5mMo5y8SDV7e,True,5942633,1485657,9296,4648,4648,4BnQKPLuE3DMTtxp8MjUBytgnhvxqq3ZTqZHTVZo4JJh,371846,2737924,-2366078,625
2022-01-22 00:00:30-05:00,6477,6qDAr9rGtFMeiTx9KfAeu3WBqiZzRzEtMfipFaZ2gQiJ,MGfCsHXhA5C6S28qKoQjeZmn28dehGUJ4MLSaic7CfB,True,3174299552,793574888,4895955,2447977,2447978,3zqXX6kzhkbW3d4TwD2CNjMRwxTbREXySekvq37kfCNk,195838233,771478736,-575640503,616
2022-01-22 00:00:41-05:00,6478,FtF3PVw8YNJseWPMcA2GEuQZ6nni1mq5kYPa2LrSzfkW,4yr1TM2dXrBvLNMpSaoryuGU2P8D3WG1ZCkvVzWFiQRH,True,16112536454,4028134112,25196411,12598205,12598206,3zqXX6kzhkbW3d4TwD2CNjMRwxTbREXySekvq37kfCNk,1007856470,5166992071,-4159135601,625
2022-01-22 00:03:50-05:00,6479,8ZBphuKHLmv5jNURAunz6pFb3zyyCePKoToEXefPhDYC,GiQaHVaAxgf6jrUquKHjext6AXk3Vo5KKejhb3iGoc8H,True,238569766,59642441,369310,184655,184655,3zqXX6kzhkbW3d4TwD2CNjMRwxTbREXySekvq37kfCNk,14772424,76204605,-61432181,619
2022-01-22 00:03:50-05:00,6480,Gbxc51WERLLeCtiHv7rDvE52aqF541RoQWG5n5aqErq6,4ngBoHbfXijLMqGKxFMNht9sbmxy2g5eqBmn8QsBmbx1,True,60233906,15058475,93280,46640,46640,4BnQKPLuE3DMTtxp8MjUBytgnhvxqq3ZTqZHTVZo4JJh,3731217,18639595,-14908378,619
2022-01-22 00:04:06-05:00,6481,8WHDaiE6LqFFmCVMnPeLEQ99R6ft8b74UfmP9BqzjcE8,CGmoDGsdnjo3zMNrW78n2xxQr1aDPAiBYiXbyciLXYMu,True,73171808,18292950,113896,56948,56948,4BnQKPLuE3DMTtxp8MjUBytgnhvxqq3ZTqZHTVZo4JJh,4555861,40217597,-35661736,622
2022-01-22 00:05:06-05:00,6482,D7XummfEc3NTK4qMvZegV3FrYuqc8mNgnQu3ujwemZtg,HHiRcecqzW7sGFTio7Ph6TYv3dGt64KWv4DEKgKm84fQ,True,342378,85594,534,267,267,4BnQKPLuE3DMTtxp8MjUBytgnhvxqq3ZTqZHTVZo4JJh,21390,270454,-249064,624
2022-01-22 00:05:06-05:00,6483,7feC64HZfQpniey2iXsMMgQXnfcunJus74DiKDeKaEUw,GstsCxAiBBEUrXNkvZZ9Sg4vNK916PsKe2Mx6e4M6dU7,True,343219,85804,534,267,267,4BnQKPLuE3DMTtxp8MjUBytgnhvxqq3ZTqZHTVZo4JJh,21397,212090,-190693,623
2022-01-22 00:05:06-05:00,6484,BCGTaPQxGEMjD7xUxwfwmVVYJ9CEGH33yJRi3QjwyiLE,JBct1cZ9a959UKwABBEefwxZnGTAAGLzyUdXrXqGGCZd,True,296317982,74079495,463305,231652,231653,HfEnetJ7uBSmZWCjBNxdvv9HEC5nsW4wDV7wu6WnhWan,18532225,155597279,-137065054,625
2022-01-22 00:05:25-05:00,6485,EF6H6aW1p3qcAtiLFU9rbFYfsKfD683meHXDw8hLdaZK,8vfJbpnK7SQcjpEBCzZJRW8JosNbsmTeJ2YXZCbM225c,True,35706237,8926558,55844,27922,27922,3zqXX6kzhkbW3d4TwD2CNjMRwxTbREXySekvq37kfCNk,2233778,17557969,-15324191,625
2022-01-22 00:07:03-05:00,6486,4hZG7dM716SxDagiFGwt1gSC99B2QK1emGLV9TJmmuR8,7vjfUWySkyx4Z5qAaRr2VWnVvxHHNsvPj1PirGNSjM6,True,11488952604,2872238151,17227665,8613832,8613833,3zqXX6kzhkbW3d4TwD2CNjMRwxTbREXySekvq37kfCNk,689106625,5045029008,-4355922383,599
2022-01-22 00:07:03-05:00,6487,961Wz2gAzstN9CQjgoe22Htq41zJsYbn8T2pAJqUVo4G,66vPnY7rg7HS9VchM2H33BBqkZK53RDMbrQwj6gSMCdR,True,1001978746,250494686,1562333,781166,781167,3zqXX6kzhkbW3d4TwD2CNjMRwxTbREXySekvq37kfCNk,62493325,298052240,-235558915,623
2022-01-22 00:07:03-05:00,6488,6BPPDj3BVgBPD3agd8b4B12d9Gvp4bFPXRWjzbtsmtRF,8VZnAwXPyKK2AHoMTZxKXthAiFMrL6b5EXAGqsAMTdhm,True,1866,466,2,1,1,4BnQKPLuE3DMTtxp8MjUBytgnhvxqq3ZTqZHTVZo4JJh,116,1233,-1117,621
2022-01-22 00:07:03-05:00,6489,FS5xx53Bo65G21gJLta7LEEiS132VJM1kGpUzuqyfzoy,2kbTLjdBBA9K1coxKmwmYbjq2heSnuNg4Nh2EfVNYgwj,True,33749845,8437461,52606,26303,26303,3zqXX6kzhkbW3d4TwD2CNjMRwxTbREXySekvq37kfCNk,2104240,12783373,-10679133,623
2022-01-22 00:07:03-05:00,6490,GCNi25P1Ywvfx5JpyxFVV68sRkio7LEhFgY85ZqveKR3,34mxz8fCss7KNAbEi2Wj9z5dTgXCGxuq2vyqzBPChtmq,True,874605434,218651358,1316188,658094,658094,4BnQKPLuE3DMTtxp8MjUBytgnhvxqq3ZTqZHTVZo4JJh,52647551,532040803,-479393252,601
2022-01-22 00:07:03-05:00,6491,E9FFPvygPSF22u7gqFq4w6yE5kV15zbeGDXFQc349RsG,yi1REPVUwKhr5ss5YJc56crYz8LVfkqNVMpKcdSfwfY,True,98788,24697,154,77,77,4BnQKPLuE3DMTtxp8MjUBytgnhvxqq3ZTqZHTVZo4JJh,6180,49940,-43760,625
2022-01-22 00:07:03-05:00,6492,Hc2e1tBoiCVKrbD7GvV5i8jgpcd219DoKJwokHvZQumE,xREhnQUqoWUi5HUxkehdh9qw7g89CgkrYemD9ZJYLaJ,True,10594,2648,16,8,8,3zqXX6kzhkbW3d4TwD2CNjMRwxTbREXySekvq37kfCNk,661,7112,-6451,623
2022-01-22 00:07:04-05:00,6493,4xn9vTtLZyNtCbBLLpcXUMWU8AnnZCov9rJaY6rew16T,5UNWdFw2CP44qS8oc4uPt8zxw6zFg8oXz8SUCedZLLEC,True,1450354,362588,2225,1112,1113,3zqXX6kzhkbW3d4TwD2CNjMRwxTbREXySekvq37kfCNk,89036,638289,-549253,613
2022-01-22 00:07:05-05:00,6494,6xbPoFjPYUcSejbTk5iiTZRWyZkicfkSzM1Fhbj3w9L5,7xTAbaXwhxxVY3TM88TLakPPwPyL4zT4TsVvtUvniVec,True,229478448,57369612,358615,179307,179308,3zqXX6kzhkbW3d4TwD2CNjMRwxTbREXySekvq37kfCNk,14344637,67496355,-53151718,625
2022-01-22 00:07:06-05:00,6495,87R8o8xLjHw2GpunYkm7pX7uJ8hjM4B1y4Qm7aQf6Yh4,48aSVPQoFYdncF5NtJ114urbdTzVjTgYLgPzMfpJbZB3,True,3777132,944283,5823,2911,2912,3zqXX6kzhkbW3d4TwD2CNjMRwxTbREXySekvq37kfCNk,232934,4818351,-4585417,616
2022-01-22 00:07:07-05:00,6496,DqBDL1BcCT99qqNXJeTbzP8pt6123zKKUrsX5DfPZPPW,FNaFupygF8timeWhwZkwDZ4YnsfGXA3pHqjzedda7RxN,True,1436070,359017,2222,1111,1111,4BnQKPLuE3DMTtxp8MjUBytgnhvxqq3ZTqZHTVZo4JJh,88906,355338,-266432,619
2022-01-22 00:07:12-05:00,6497,Es6UDmhJTnRsCUCFBtSfc4KYhFBPAVtBuX2EN2DS3FsH,J5gi9V4pQq4ke9tun4pf4oJPVtVPfYUKRX1RArAJMVLv,True,160867287,40216821,247341,123670,123671,3zqXX6kzhkbW3d4TwD2CNjMRwxTbREXySekvq37kfCNk,9893668,46237778,-36344110,615
2022-01-22 00:07:16-05:00,6498,4FazDUgfQ3AKoFcnWHr8E9Ht8jLA3tkxf75yrGZVHdmF,HzRMH6mbgEKydRCnnMvSsKgTEVNQi6nuzoR1xutYFdzg,True,3624,906,5,2,3,3zqXX6kzhkbW3d4TwD2CNjMRwxTbREXySekvq37kfCNk,226,3737,-3511,623
2022-01-22 00:07:17-05:00,6499,ECuu1L4QGdemZ7FjAjVAAxYN6piinweY7Fuk5csVovfT,Amd8WGcpdtB8yoA83R1BUT5uryuqoKbcBexYacbrbGVX,True,180388,45097,281,140,141,3zqXX6kzhkbW3d4TwD2CNjMRwxTbREXySekvq37kfCNk,11241,111673,-100432,623
2022-01-22 00:07:17-05:00,6500,8nwpM4BmiMV8t2GgMnNy8zhPwBLM8xcBnCNTHyPySbuA,2bVCmJNzMi7ZqTfRB6Nwbk9omrY7urgPuDFvTVeVxc94,True,15817,3954,24,12,12,3zqXX6kzhkbW3d4TwD2CNjMRwxTbREXySekvq37kfCNk,989,4719,-3730,625
2022-01-22 00:07:17-05:00,6501,AQr9mVmcXCNQhBVCfx63MwR6c4WqDSC9K2BZqr7N8LCx,CB7TWUaL381ounsLw6neAUaKRxJL9P1HC9uGX5e1Uxod,True,34009335,8502333,52820,26410,26410,4BnQKPLuE3DMTtxp8MjUBytgnhvxqq3ZTqZHTVZo4JJh,2112800,32727542,-30614742,621
2022-01-22 00:07:17-05:00,6502,9LZ3rShLfzErXsGkh4dYfAm58GNPWhK6ohDy5RrLJhc,41tLyuvuJ5M7YctkSASD2R7RGGetD7FmKaZUdkTdgXgt,True,85487,21371,133,66,67,3zqXX6kzhkbW3d4TwD2CNjMRwxTbREXySekvq37kfCNk,5346,43401,-38055,625
2022-01-22 00:07:17-05:00,6503,2kqN3TbCDgM4x8XfZvKgqJvDAHqvZxtT89NcfmQSQa5b,8fEx56PjuPAP61CBnrsnnnQnZmt8cw6KVjhYDK1mWJzP,True,33711093,8427773,52619,26309,26310,3zqXX6kzhkbW3d4TwD2CNjMRwxTbREXySekvq37kfCNk,2104778,13322915,-11218137,624
2022-01-22 00:07:54-05:00,6504,FLTW9fwjWqGPm5PiE3C9LFzwZxtDh8c2MnEoRq8W7MfQ,GKsfzKBP2QkmoEWvTaUN1h4nqrT3kAcwYRC9WxW9bB3h,True,727555,181888,1131,565,566,3zqXX6kzhkbW3d4TwD2CNjMRwxTbREXySekvq37kfCNk,45249,431187,-385938,621
2022-01-22 00:07:54-05:00,6505,Sapmbypb7FUXhKQEdjyH2AUDgh8QWQ1mu6SSHm7673N,7AGij8bP7Kq3iARJ41duwggPrDfuXDoKwRSKV9SG8nk2,True,16554132,4138533,25893,12946,12947,3zqXX6kzhkbW3d4TwD2CNjMRwxTbREXySekvq37kfCNk,1035729,5044870,-4009141,625
2022-01-22 00:07:54-05:00,6506,6d6HN8LWikwW2HYdy3BABWuxKHt1sgv4DcneACR133sE,4eKvzmfFvX96XbujKBhUauAvWP4yQYwZH3pd7gXzbCvJ,True,98533,24633,153,76,77,3zqXX6kzhkbW3d4TwD2CNjMRwxTbREXySekvq37kfCNk,6122,50137,-44015,621
2022-01-22 00:07:54-05:00,6507,CCHzYXr5zMXFu8MMZNkfUWGyUcF8xy7Vvhq7tNCtZg2L,AuEXkCJTTJ3HK8iP4qTWpQr4vp6HPRJZyZwfRjF8zjfp,True,8647,2161,13,6,7,3zqXX6kzhkbW3d4TwD2CNjMRwxTbREXySekvq37kfCNk,539,5128,-4589,623
2022-01-22 00:07:56-05:00,6508,2p2fGXdKrmxjomLSnyaNg84J82cBBBNympZ6qQc8UZgU,HKAM8bazuLMUY6yapZJqYsgaWkTBqKHyMs1hSfpYsZGi,True,47898668,11974667,74650,37325,37325,4BnQKPLuE3DMTtxp8MjUBytgnhvxqq3ZTqZHTVZo4JJh,2986036,38002435,-35016399,623
2022-01-22 00:07:56-05:00,6509,7T5Z5qX5petKARUrhAuB7xaWJPTKrcQTx9n63cM85Pvz,Hw2gx2SBkEj2SA4RE2hWETJNYmLUBqSZirAaRpuvMgH1,True,1225325,306331,1903,951,952,4BnQKPLuE3DMTtxp8MjUBytgnhvxqq3ZTqZHTVZo4JJh,76126,722052,-645926,621
2022-01-22 00:07:56-05:00,6510,BPRoaqrDs8vhqv2T7d9qV2oPU33pi1K1LUaotM7yuD2i,6qo8uQGAEwBfYQR36v6nRiqA2xGV6SjJAsXsdzy5bqNH,True,61147547,15286886,95410,47705,47705,4BnQKPLuE3DMTtxp8MjUBytgnhvxqq3ZTqZHTVZo4JJh,3816417,44039046,-40222629,624
2022-01-22 00:07:57-05:00,6511,HhwiZPKZBGa16oVi739s4qtMDMTwzWXc7iwNfX63t2UP,5AnbMbAFKy85yHt5y2M5S38nNkA1vT4ejY5NjGbRNUqn,True,81667,20416,127,63,64,3zqXX6kzhkbW3d4TwD2CNjMRwxTbREXySekvq37kfCNk,5083,73915,-68832,622
2022-01-22 00:07:57-05:00,6512,9gYrMXAGmGSV4VFjXzYP5WwH2aFpB1TxA6CqpYsosKLv,Dh8aH6RK48wu4fkT9xKw5XL7itxnPDuw3SDwPwvL5sva,True,1566,391,2,1,1,3zqXX6kzhkbW3d4TwD2CNjMRwxTbREXySekvq37kfCNk,98,1049,-951,625
2022-01-22 00:07:57-05:00,6513,6gFbxvPafnpqZjWW94MMmL8mGp2FHZGqoJC5fWqgwNxS,C6WcDycp3Ff3xYmb81i8JbD39Xv1o5G2AdtPs1FdXtr4,True,135835110,33958777,211628,105814,105814,3zqXX6kzhkbW3d4TwD2CNjMRwxTbREXySekvq37kfCNk,8465156,52821004,-44355848,623
2022-01-22 00:07:58-05:00,6514,6osqTNxgZv1Y1EjnVR7D1G4cywof1CrWswj87tAnktWV,Fah93R9W7SFuajFif4AbXDdxouWA5rrLz29vzVRGsMxv,True,737250,184312,1144,572,572,3zqXX6kzhkbW3d4TwD2CNjMRwxTbREXySekvq37kfCNk,45770,885304,-839534,620
2022-01-22 00:08:23-05:00,6515,Avok5yeEYbNXwtBCqqb2y3WRnGgoXeuGKCtUBYxf3N7U,Byms3hWr4yaf3TYW8HALsNvhFhMgLYwvdpiKqJqegyVY,True,3881312,970328,5960,2980,2980,3zqXX6kzhkbW3d4TwD2CNjMRwxTbREXySekvq37kfCNk,238413,3339905,-3101492,614
2022-01-22 00:08:23-05:00,6516,FEKYaAbNo9UF62dkkV8JbV9HvHYsiBLmvQp561HEXWx6,2Bcc55F83cWDvW4X2QQMfgpZQZWMVZsMD3W98KNL8GqK,True,83438993,20859748,127957,63978,63979,3zqXX6kzhkbW3d4TwD2CNjMRwxTbREXySekvq37kfCNk,5118317,71664338,-66546021,613
2022-01-22 00:08:23-05:00,6517,HkRKcvAWLM5sCDL6a5DvYsH55bg5BnZnyP9WwX7wLUDF,GXtDJS8BCoZKnvviGaUb2QfKs2LQQZPMa9564tf5Jq8Y,True,89931383,22482845,137598,68799,68799,3zqXX6kzhkbW3d4TwD2CNjMRwxTbREXySekvq37kfCNk,5503922,39764878,-34260956,612
2022-01-22 00:08:23-05:00,6518,9k5YHTFCHczFg6KAZXf2ostkFLH7WdVAxiA9zCGRprg3,2b52r1TA8dkJsnuMuM9cNfGxKEynd42WjQUuzcQTRcD9,True,3754,938,5,2,3,3zqXX6kzhkbW3d4TwD2CNjMRwxTbREXySekvq37kfCNk,231,2537,-2306,615
2022-01-22 00:08:23-05:00,6519,GWkVXmZNQdcdWNNu8dvRqct4aMhLoDNqijrTvxbfEdKN,6LKRNbJv2XkyjJQKCFAqFRPzvANrRBSTmu8doRWqTicU,True,6391923,1597980,9833,4916,4917,72FwbpFGoLEazJEdpqNtPNefsadUrimUqma9wSoy4qiS,393352,2640196,-2246844,615
2022-01-22 00:08:23-05:00,6520,HSZrdquqBs1gWQGSBcLGs4aa4ox27rLHh6KKmdHrgrVs,DywbuaDt997DQA1GT9GsLL8ML73CxQgHwMLw2MyG8m7M,True,935602,233900,1432,716,716,72FwbpFGoLEazJEdpqNtPNefsadUrimUqma9wSoy4qiS,57300,305596,-248296,612
2022-01-22 00:08:24-05:00,6521,4kbcrzH6o2LvLUCNphyL52i8uGzVD8wcUNEqoQ14z3VG,5Q1atmEBs2AqaDZsiZFG5stHzj1fE6ZvypgfkEc9LYqE,True,10505491,2626372,16175,8087,8088,3zqXX6kzhkbW3d4TwD2CNjMRwxTbREXySekvq37kfCNk,647033,8819581,-8172548,615
2022-01-22 00:08:24-05:00,6522,duKo8riX1qpX1K1qpgwZniMtUeWqu2eYgchTu5n7Rbu,9vAVwfVtdsaZMbeZvoymjHqwASeuM38gfEJkbTVwDqya,True,3946849,986712,6058,3029,3029,3zqXX6kzhkbW3d4TwD2CNjMRwxTbREXySekvq37kfCNk,242350,2601996,-2359646,614
2022-01-22 00:08:24-05:00,6523,3onLoSaH9BskwjFu4nbEFykBsDaFgKgWVHPqdSUjHraw,D3YAuBorbpirBJmvhxQvFJbQPRycWyyymjsvm8GDetv3,True,46649215,11662303,71790,35895,35895,4BnQKPLuE3DMTtxp8MjUBytgnhvxqq3ZTqZHTVZo4JJh,2871617,41250405,-38378788,615
2022-01-22 00:08:24-05:00,6524,921FBgLS3A1wA77uWitsnTvW737Q2jY7tzvgWtWLXNC7,E4eJ9H7cqP9zNpMH5xRBTAp9yaBCBihuJBNd6pqzteDG,True,8633,2158,13,6,7,4BnQKPLuE3DMTtxp8MjUBytgnhvxqq3ZTqZHTVZo4JJh,531,5132,-4601,615
2022-01-22 00:08:24-05:00,6525,DJiXXW7sjNsAAxWupDKBUsFhXSgPoerVYaAtJqqNgVbn,2MsqvNuJw1xQhJ3UnXt9i7oNHDuZpR9w7iE1WQcGqt5m,True,8633,2158,13,6,7,3zqXX6kzhkbW3d4TwD2CNjMRwxTbREXySekvq37kfCNk,532,5134,-4602,616
2022-01-22 00:08:24-05:00,6526,HjkXypCkrCSprGVXBkrbHMZJji2gMToLvCLweRhcH7Vs,2ddyaPR86fCsVf4VJRG1VdZgdkY84TzXb8NMPqRyDqzV,True,42607079,10651769,65554,32777,32777,3zqXX6kzhkbW3d4TwD2CNjMRwxTbREXySekvq37kfCNk,2622172,13985377,-11363205,615
2022-01-22 00:08:25-05:00,6527,2bikYf33ZxxDmvkMNjWDGGqEpbYJPvWv5At3hzyeLEQK,5FtirUBjRAZ3k5arFFVwKz42ixWzhkEBLkaK9PraRZ78,True,8633,2158,13,6,7,3zqXX6kzhkbW3d4TwD2CNjMRwxTbREXySekvq37kfCNk,530,5133,-4603,613
2022-01-22 00:08:27-05:00,6528,DdEiAJ4pcXU213GVEa5KeDonBXZhTV7zeNcKigEQwN8Y,FoAs2bsVjQFKaJW7dpVKMxoJf7Qe5PcuH6i9jJzAR5e1,True,40332542,10083135,62267,31133,31134,3zqXX6kzhkbW3d4TwD2CNjMRwxTbREXySekvq37kfCNk,2490686,11924271,-9433585,617
2022-01-22 00:08:28-05:00,6529,8hpAXzimCw2bTwLXoRFAbqNW8qoj5VV3JDYCuJwqHpHm,DkfsL2M7oRBX6grAfy15C4urwL6ToMJ7TWJEFAGhWjYX,True,544878,136219,850,425,425,3zqXX6kzhkbW3d4TwD2CNjMRwxTbREXySekvq37kfCNk,34015,239238,-205223,624
2022-01-22 00:08:28-05:00,6530,6u6bPgAmK8ufACrQV99A1Y5nhGkue3KEUHmQQkcNkxwP,7636yXT5w4DcVpc7LJdN46aiggzSq6U2GXHXL5kyy9F3,True,6986046,1746511,10880,5440,5440,3zqXX6kzhkbW3d4TwD2CNjMRwxTbREXySekvq37kfCNk,435210,5324192,-4888982,622
2022-01-22 00:08:28-05:00,6531,AM5fwZR9BUW8AFkhdGWXW4PHd2cy8ora63kDf2z2eknw,E7ru6hg4MchnRG5zcr5YazwX8Snt55r5Xq9zCHCGaYZT,True,56287,14071,87,43,44,3zqXX6kzhkbW3d4TwD2CNjMRwxTbREXySekvq37kfCNk,3510,42248,-38738,623
2022-01-22 00:08:28-05:00,6532,6CeKxTJvFqhyNEyzySiBBKEwYVMe7j3A6nkMes4BW6o2,DzDR9XvwY1z7ygQ8YrCXrwDGHSf67JZF8BzUnuFE2fxQ,True,257779,64444,400,200,200,3zqXX6kzhkbW3d4TwD2CNjMRwxTbREXySekvq37kfCNk,16021,159050,-143029,621
2022-01-22 00:08:28-05:00,6533,5jin5wXjQQ25nGM2ECrCXcg1a95vquh6kM7rMRru6Ke7,EKM657EQ8HWWgf4cssByoYHoXGjFfTspTKXAGmygAPQG,True,2215102,553775,3457,1728,1729,3zqXX6kzhkbW3d4TwD2CNjMRwxTbREXySekvq37kfCNk,138288,1692749,-1554461,624
2022-01-22 00:08:28-05:00,6534,ioPHEVyheRnHYomVS7PmP6Coyhjk6LCs7hMD5Mq9Ngv,DYTpFmZ4yXVghKwkaovgCdpv3jfWkjtXRzxsZjKJfXNN,True,1418,354,2,1,1,3zqXX6kzhkbW3d4TwD2CNjMRwxTbREXySekvq37kfCNk,87,959,-872,613
2022-01-22 00:08:28-05:00,6535,2QStaRnbSnDhA891Lb1bxjVeMYpJUpNdqaVkw3rqU45V,DakRWPnttPoRcjY5V7WLwiwBx39BapCo9Atog8dL17Ku,True,133367,33341,208,104,104,3zqXX6kzhkbW3d4TwD2CNjMRwxTbREXySekvq37kfCNk,8336,75427,-67091,625
2022-01-22 00:08:28-05:00,6536,DAku12iueL13vRoTpKLyqdGaLQ2rWF6REe8Dr8soFvNs,H2vVH3LxkhGe6x6Mdwy67BYwTKNQM6XayKx7mhrwyfJM,True,26269,6567,41,20,21,4BnQKPLuE3DMTtxp8MjUBytgnhvxqq3ZTqZHTVZo4JJh,1642,20481,-18839,625
2022-01-22 00:08:28-05:00,6537,6xikA6d7sjCBnSfqkFwrL4nPrtQUNWdRhXB7i1AccnxC,G8t7u2R9qjRfdTdULs74v3nVrTM2WeKvc4dK4FFAvuG1,True,2206157,551539,3438,1719,1719,3zqXX6kzhkbW3d4TwD2CNjMRwxTbREXySekvq37kfCNk,137528,991456,-853928,623
2022-01-22 00:08:28-05:00,6538,AA9zFZTXqBR8Mw1fwEH59edzBiswoGasRNWsi6aLeysB,4VeitxYqqtRxyfdSVpshdJ3EDcgksRVnaHvAqWxTeujH,True,100175,25043,155,77,78,3zqXX6kzhkbW3d4TwD2CNjMRwxTbREXySekvq37kfCNk,6234,50982,-44748,622
2022-01-22 00:08:28-05:00,6539,3g1debT8Z2efQPuMNSDPUNZzDqarBG2acErsZ4HP7QGA,42wDHagxr5Nno3mUx6kyYGDjwR98aedRbh3ByB468agB,True,1116,279,1,0,1,3zqXX6kzhkbW3d4TwD2CNjMRwxTbREXySekvq37kfCNk,69,754,-685,618
2022-01-22 00:08:31-05:00,6540,7g4NJBHwDTRm58GqX7Tz1JzqwbAhF6EWJUQH3SoDxSf7,82Ypv7STZeSCBPf3HckWdyatELpvaDaWxFXhD5dNSML4,True,1372,343,2,1,1,3zqXX6kzhkbW3d4TwD2CNjMRwxTbREXySekvq37kfCNk,85,928,-843,619
2022-01-22 00:08:31-05:00,6541,FpqCxvTkSiwDwD5qEt6hXJxzFDLFLAQ8VevK8zwRqYun,A3p6YQisCJKpNkF7vkjZRbEfbnUt7vTZdR2zPBUSdTkk,True,24176872,6044218,37642,18821,18821,HfEnetJ7uBSmZWCjBNxdvv9HEC5nsW4wDV7wu6WnhWan,1505715,14918828,-13413113,622
2022-01-22 00:08:32-05:00,6542,GH6Q9E1jZPTTp46aDd57UNZPNS2D6PBSwyLL3EHSjGn2,2XvwZXNsrPWx4EfPvhTP933bzCC3SJHDQ8xARfrXdVY9,True,1162999,290749,1799,899,900,3uL2NSR2ZdDqCiKfzA5SwwpddAnit22DBJo6uvvz1rRs,71989,1383974,-1311985,618
2022-01-22 00:08:32-05:00,6543,F2v1YwVAwXLiUgsJ5uwn4qAAkTXitn1E75fJcPnGuAcy,5rdJ4H5GxPg4Juu77mGc7uya5LwEqLzDSRyG8mQ2mDbK,True,1136038,284009,1767,883,884,3zqXX6kzhkbW3d4TwD2CNjMRwxTbREXySekvq37kfCNk,70708,863781,-793073,622
2022-01-22 00:08:32-05:00,6544,5nauZoaxftcYR591YH4v52myeJLnXtY4okdttL9qSdkg,7x3G299D3bC7EwUQojhTXUv29BG4NGzrLbgS4mEyqG5r,True,27243615,6810903,42594,21297,21297,3zqXX6kzhkbW3d4TwD2CNjMRwxTbREXySekvq37kfCNk,1703786,11998531,-10294745,625
2022-01-22 00:08:32-05:00,6545,8VnGmfop6qcUezAJ2M15jz2Nn6mPQgehDcJPvypq4XJn,6F6sqXNhgkW9ev8QNMm4ydywUUmemhwgydRQYNeqyUmi,True,623699,155924,973,486,487,3zqXX6kzhkbW3d4TwD2CNjMRwxTbREXySekvq37kfCNk,38950,751604,-712654,624
2022-01-22 00:08:34-05:00,6546,4ne6vC7qdxQYHJCsaeFAKZrKdFt2SwXGHQ3jrMHqt4DL,Cf1dLHY2WXH9rXbRKq5TT8THbdo9SdNUZq4rYhRCF9z,True,8077986,2019496,12325,6162,6163,3zqXX6kzhkbW3d4TwD2CNjMRwxTbREXySekvq37kfCNk,493026,3425531,-2932505,610
2022-01-22 00:08:35-05:00,6547,6uZobpBuFcQeYgZ4dApFi6iy4DB9GLHP1AAsQcCj6212,SGGFiPjjhscwroiWMqY4jTAHFw8eakpsEv35wNoHUPY,True,32346023,8086504,50310,25155,25155,3zqXX6kzhkbW3d4TwD2CNjMRwxTbREXySekvq37kfCNk,2012439,9299566,-7287127,622
2022-01-22 00:08:35-05:00,6548,Ehw3RgdbzyAHHddgSv7F6f3WtYhyBtRg2ropQaWGgwcL,GGw3xDe5jKd5UNB9bPLqp2xzw2SKz7CMg358Fy7UypDL,True,987891238,246972809,1528312,764156,764156,3uL2NSR2ZdDqCiKfzA5SwwpddAnit22DBJo6uvvz1rRs,61132492,461040379,-399907887,618
2022-01-22 00:08:40-05:00,6549,EXP61AETWHw3kHSjrJH1jQBt6cXR9Zebz34Cueb3KAzg,2JT9GrgdUKjuQQtXvZqevbjFquUQBMYDoADmBjDKWXj3,True,200278598,50069649,311843,155921,155922,3zqXX6kzhkbW3d4TwD2CNjMRwxTbREXySekvq37kfCNk,12473733,82114755,-69641022,622
2022-01-22 00:08:43-05:00,6550,AHm7zF4rpaxaayBLn5QDHgJSp8KAr647s4cNvQ9wLgd7,FDM33WngED24pukBvSDpPAzinW6afVAeGReum5nyLRiC,True,48789,12197,76,38,38,4BnQKPLuE3DMTtxp8MjUBytgnhvxqq3ZTqZHTVZo4JJh,3054,38101,-35047,625
2022-01-22 00:08:43-05:00,6551,GBpe8E33cNkFmMUuP3WjhDBBuQz7MHaDkpCJjGFaFkvu,3QYFKkgzZ1PKKAxCh4hMhgqrupoCcfRVkjuJZRWVZo3H,True,34083825,8520955,52733,26366,26367,3zqXX6kzhkbW3d4TwD2CNjMRwxTbREXySekvq37kfCNk,2109340,14374418,-12265078,618
2022-01-22 00:09:01-05:00,6552,Fd2HrzBAr4JobRPARZwpQHHVoSCEoog32A6tKMWAC1sK,BYappsar5sQf8VLem4wrLuTtrDFH9y8pEx1aMxfuU4Pq,True,1773191,443297,2761,1380,1381,3zqXX6kzhkbW3d4TwD2CNjMRwxTbREXySekvq37kfCNk,110451,1349073,-1238622,622
2022-01-22 00:09:01-05:00,6553,3Lv2XpiD4KBUHq7Zx6u3zNhpXoySodXHH8o8f5yaaPxG,H6TN4rhpBXkEH3mZnymYNcKfmnxRH2uzfwzeLH2q6ahP,True,10996,2749,17,8,9,3zqXX6kzhkbW3d4TwD2CNjMRwxTbREXySekvq37kfCNk,684,7647,-6963,622
2022-01-22 00:09:01-05:00,6554,7W6ih2ZGXaE6tvuQFUPCvc7NvEJHy7UffgoVX3ZPdLXt,6uQCkeMjEXHBQxE2HD33RM1zyTsSko1fYZA1mWUggJ5B,True,1516,379,2,1,1,3zqXX6kzhkbW3d4TwD2CNjMRwxTbREXySekvq37kfCNk,94,1048,-954,620
2022-01-22 00:09:02-05:00,6555,H6fVnghBUSJRKp2mxSG7Fq2Lr4dE3YMS7yM1XTrxoe3Z,JjgtLi79grUZXofhWukB1yNXZkXFMUX5jm9HcXNDsB6,True,1785574,446393,2790,1395,1395,3zqXX6kzhkbW3d4TwD2CNjMRwxTbREXySekvq37kfCNk,111610,995448,-883838,625
2022-01-22 00:09:04-05:00,6556,ES1MDwRUa3hoToPKQiiZkzMYe9PDVnAQwMrEvZrzvnc1,C4wBG3xTDkmDQneB28xYnf1aBNEeq7UB8oR7NuEfLkFg,True,1620877,405219,2532,1266,1266,3zqXX6kzhkbW3d4TwD2CNjMRwxTbREXySekvq37kfCNk,101319,958045,-856726,625
2022-01-22 00:09:05-05:00,6557,3njiRuSRMXRzKmamyiR72Hc38PU8UDDmWdfPhgxmGxEW,5WoF3gkgygyNNbwxWgVfqGWkExcDixuzgJQQjXEZQ6J5,True,15018387,3754596,23480,11740,11740,4BnQKPLuE3DMTtxp8MjUBytgnhvxqq3ZTqZHTVZo4JJh,939229,15019639,-14080410,625
2022-01-22 00:09:05-05:00,6558,BTouoY9doTYwX8wAa6QcZHzJjfZfEAtiLYR2JHKd5V8Z,H4ByqCdZy7AMx7VJZEwQwQmZLVA8vHg55C7ypwZwv67u,True,1247486627,311871656,1952187,976093,976094,3zqXX6kzhkbW3d4TwD2CNjMRwxTbREXySekvq37kfCNk,78087493,537748684,-459661191,625
2022-01-22 00:09:07-05:00,6559,EFHg5FatMRRSZnKJPJF9e1iw2cjPJRmwTTZYtkHno9DP,84LnLKhZDJgWFnbBYnYjqWkjymemXfidecPFwnUAvuFj,True,126888313,31722078,198508,99254,99254,3zqXX6kzhkbW3d4TwD2CNjMRwxTbREXySekvq37kfCNk,7940354,74733690,-66793336,625
2022-01-22 00:09:07-05:00,6560,6yw4GPvkqUbakcEWtqSCfjVLukty11xqjDpGxtEN9Km2,5ppEx7wkpqbG5nApCWMdRja3oRSheFmAAsNHUX7h2w2Y,True,97250,24312,152,76,76,3zqXX6kzhkbW3d4TwD2CNjMRwxTbREXySekvq37kfCNk,6087,119046,-112959,625
2022-01-22 00:09:35-05:00,6561,D2L7ST8iGsRfZ4zj2pdfKTptbojQ4cDtHKQ8ngcFVQwA,7cNrHGWJ6FGGazfGaCePs8XyaK6bwVLrYFCUJQi9w2Wc,True,3980,995,6,3,3,HfEnetJ7uBSmZWCjBNxdvv9HEC5nsW4wDV7wu6WnhWan,249,2678,-2429,625
2022-01-22 00:09:35-05:00,6562,7uHMFnppZKtV7nAySv8UGcoGTSQ98RVz1GP47dsFWpYr,FmS9WPYVTT8i4agyidApdLnoHAUMfdRFPnAVJQUwfWr5,True,100957816,25239454,155992,77996,77996,3zqXX6kzhkbW3d4TwD2CNjMRwxTbREXySekvq37kfCNk,6239714,36536392,-30296678,618
2022-01-22 00:09:35-05:00,6563,2FrqGFZjbiNykJyo9BZ5S9FguQJPJiTi681rJJsQ5dta,3QUncYP92NKrfpaTvuF9iQg11PXKgZAgEngwh6BbnCCj,True,48592,12148,75,37,38,3zqXX6kzhkbW3d4TwD2CNjMRwxTbREXySekvq37kfCNk,3007,32705,-29698,618
2022-01-22 00:09:35-05:00,6564,6dr65yANjSMmfBeKAuSxG3i16S9vMgF1CQ3zDyzh55Pn,EhrE5QpnshD41S4zPEBy2A5q2Gs2mwUrbHGo6WnT9zDP,True,19679,4919,30,15,15,3zqXX6kzhkbW3d4TwD2CNjMRwxTbREXySekvq37kfCNk,1217,15369,-14152,618
2022-01-22 00:09:35-05:00,6565,BAczoNDnbwj5AJX5LwzynzYab7ji7VbhRy9edA9Prax,34sbkUKnMetUNyMs6BhiWut85d5UZtBWnPtwx8jEpJNA,True,76453,19113,118,59,59,3zqXX6kzhkbW3d4TwD2CNjMRwxTbREXySekvq37kfCNk,4737,54981,-50244,619
2022-01-22 00:09:36-05:00,6566,5PVUmELKMD7mf2vbXbiXXsiZW2myGmZuMe757raBAj8Y,5eikdsebvyBh27aPz9t9KPswYWd8X4Cbk2TSiif6vn36,True,554703014,138675753,864278,432139,432139,3zqXX6kzhkbW3d4TwD2CNjMRwxTbREXySekvq37kfCNk,34571127,451786343,-417215216,623
2022-01-22 00:09:36-05:00,6567,5SskSWkRPP5BNaqvHkJCbTAgHPUkHEwFh5pFr4t8PoBr,EqdX8Sdm9LCfdrzVKzisKaFcP2YEdSRNZYmev5RWjGqb,True,230488,57622,356,178,178,3zqXX6kzhkbW3d4TwD2CNjMRwxTbREXySekvq37kfCNk,14260,102853,-88593,618
2022-01-22 00:09:36-05:00,6568,LNX7AwwiGpuaXA4J86d1xqqtF6kD7qbCusssSZqtpKd,45a5FGVssw2NoGipB7NRN4XDLPob4GHNxSM9fqgsTpqA,True,50854777,12713694,78684,39342,39342,3zqXX6kzhkbW3d4TwD2CNjMRwxTbREXySekvq37kfCNk,3147366,21038408,-17891042,618
2022-01-22 00:09:37-05:00,6569,CYv2hNAzvRak1LBSayFxMJEXoAQdMEZHnNpQLZ5G5RVo,HkvTQbtKxWv2E5z6MsViv1LS4jm8T286fiY1C7n6ZZ9C,True,499990469,124997617,775872,387936,387936,HfEnetJ7uBSmZWCjBNxdvv9HEC5nsW4wDV7wu6WnhWan,31034899,408469169,-377434270,620
2022-01-22 00:09:37-05:00,6570,6tFQaTqqffino9kwMZTL2xVNBG8k9VREFhXqVi2si3A3,3w3wGxBbS4bmXeqmvd595SAWFeXekVpnH4UdbeEs8Sx5,True,257873,64468,399,199,200,4BnQKPLuE3DMTtxp8MjUBytgnhvxqq3ZTqZHTVZo4JJh,15987,158923,-142936,619
2022-01-22 00:09:37-05:00,6571,C2Dmfw4G8KKzFq38aRH2pLCRngnGZDvUUN3fHDMjFkoG,7kzJk3BTNvY3hGFNj7nDy9L5CAYus6eNiCAxWH8dSioX,True,21833,5458,33,16,17,4BnQKPLuE3DMTtxp8MjUBytgnhvxqq3ZTqZHTVZo4JJh,1354,19694,-18340,620
2022-01-22 00:09:37-05:00,6572,HqYn1PU7foJ9daTJMbd19LjTqWR2vQ1XqMEmffM2kCFA,8o6U7rDTtzSvywjzENEZSDYxCf7XK85rueCYVM4vZjY1,True,32174308,8043577,49852,24926,24926,3zqXX6kzhkbW3d4TwD2CNjMRwxTbREXySekvq37kfCNk,1994112,27134228,-25140116,619
2022-01-22 00:09:37-05:00,6573,BjyZWwz1ARSfmPkHXHBzehq5NsH4DRJiu4zFMkqsKu6A,7WUCSZ9SnKDsbomDRZ7CKsHfHJFwboKJwFFdaGkBURBS,True,287348604,71837151,448039,224019,224020,4BnQKPLuE3DMTtxp8MjUBytgnhvxqq3ZTqZHTVZo4JJh,17921568,180576898,-162655330,623
2022-01-22 00:09:38-05:00,6574,5RvNKzSeJ1fvqsKpcQu25evEZGmKjyEDgwsMZkykoT3P,BRqSGfE4XHXu4HrinwetWumfVTmr82iuF6Y5oSV6eMiK,True,8629,2157,13,6,7,HfEnetJ7uBSmZWCjBNxdvv9HEC5nsW4wDV7wu6WnhWan,535,5140,-4605,620
2022-01-22 00:09:38-05:00,6575,5XrU9QLKHL8m66mpfcsqvndBBeQ9t8vA7zhNdB1yAi9s,3FDocKqsT3aUigiW2P7MESU8anAYqg1D9domHCDsxCB1,True,393726248,98431562,613363,306681,306682,3zqXX6kzhkbW3d4TwD2CNjMRwxTbREXySekvq37kfCNk,24534533,87918285,-63383752,623
2022-01-22 00:09:39-05:00,6576,GGGyesjbt7h2XHHp9u8vpiWGugFwEbrtYaKrNQSDhQd7,8tydo1ZjGHmPBSqU33tywB3f9szdsHk1ckGFe4Ay5pgs,True,2968990,742247,4610,2305,2305,3zqXX6kzhkbW3d4TwD2CNjMRwxTbREXySekvq37kfCNk,184432,3206433,-3022001,621
2022-01-22 00:09:39-05:00,6577,8NdcaYUC1X5CP7FMDip78uqtqmCt8GcZdCzLRTYTihmb,9Ei1K9bXWXSXcBfeX5exPSXGCAu62WSKzvnnd4wHvyVh,True,7731,1932,12,6,6,3zqXX6kzhkbW3d4TwD2CNjMRwxTbREXySekvq37kfCNk,480,5438,-4958,620
2022-01-22 00:13:26-05:00,6578,GNkEoVMpNAgfyDBZ986MR9BEVc485xpLuZWwSCyZk5zJ,AT2eiaMyZNHZGqgTdie8QjLWCTrWSdkRmQxU2vZNgtDs,True,9120657,2280164,14269,7134,7135,HfEnetJ7uBSmZWCjBNxdvv9HEC5nsW4wDV7wu6WnhWan,570772,3010576,-2439804,625
2022-01-22 00:13:29-05:00,6579,2mfcg17QocKKvDcqDH88TwxHRiS8dAQiJAGoAh1brns9,8aQLELBgaA9eXsxSciMjxWv8B1hpbUPfLwqVjEnasZbe,True,25358520,6339630,39670,19835,19835,3zqXX6kzhkbW3d4TwD2CNjMRwxTbREXySekvq37kfCNk,1586814,10013759,-8426945,625
2022-01-22 00:15:17-05:00,6580,243SAnGxchCVB1LQAUF4SsozR86yDwEdg2QQpbWGsMYe,5u8sNkb2oEQjUXJAB3yGStmv3Uwz16gBgExBo5myVK4b,True,2970629,742657,4633,2316,2317,3zqXX6kzhkbW3d4TwD2CNjMRwxTbREXySekvq37kfCNk,185359,1439444,-1254085,623
2022-01-22 00:20:10-05:00,6581,FV3G5EsSmyiLAAoREhgDXwvzbxoyDeq4Mwfj4jK5fJ7U,5nhzbJmm5JAwGDpTZoenkM1u3XtMY4uN7Qsm3vFGtRJE,True,3759483,939870,5806,2903,2903,3zqXX6kzhkbW3d4TwD2CNjMRwxTbREXySekvq37kfCNk,232240,1548498,-1316258,617
2022-01-22 00:20:10-05:00,6582,DvuRmJkfn6FQczUKgYeaSCqwy2NTMunuAKNrnmxMvnzS,7LpWTX9dgBtW75kfEoB5WuNsDwEdw5s8CYSHh3J4qagM,True,3863441,965860,5960,2980,2980,3zqXX6kzhkbW3d4TwD2CNjMRwxTbREXySekvq37kfCNk,238407,3098906,-2860499,617
2022-01-22 00:20:10-05:00,6583,C1rjefgArnN3nBn5Wu3yXij2wAyGWFtWdjGNLR9vpjmj,GsLCESLzYGZ1brEh8RJrZttE7hxcpSq7iUqdhwJhnDVB,True,7571380,1892845,11765,5882,5883,3zqXX6kzhkbW3d4TwD2CNjMRwxTbREXySekvq37kfCNk,470618,4879438,-4408820,621
2022-01-22 00:22:54-05:00,6584,DYCYiQFH9QHzCo3eAw1pFoDu7pzwFMo1E2WDZjVFRz5w,CPh4FWsGak1kd1WFEH9qBjNhnun3R2tHtZA57zW8ugn5,True,4148462,1037114,6428,3214,3214,3zqXX6kzhkbW3d4TwD2CNjMRwxTbREXySekvq37kfCNk,257124,3181947,-2924823,619
2022-01-22 00:22:56-05:00,6585,8T4WK27RvWVGqPuNqY6whk1fmU4vd5qaUQPZG1GJ79bh,DvSz7knS8N3K7L6JhQf1s4mJSyxB8uJXNQXtyjJn8QRL,True,7608317,1902079,11888,5944,5944,4BnQKPLuE3DMTtxp8MjUBytgnhvxqq3ZTqZHTVZo4JJh,475540,5317822,-4842282,625
2022-01-22 00:24:20-05:00,6586,AvwHizRhHUSahmvSg4jmTUErc7vAFSmkRAEsiKhXfW1m,3UrWYx8y9N5o9GYneSe6zyyHRTZzxwvcipQfHHYh7tEs,True,117193,29298,181,90,91,3zqXX6kzhkbW3d4TwD2CNjMRwxTbREXySekvq37kfCNk,7274,77934,-70660,620
2022-01-22 00:24:20-05:00,6587,3c4tj9J8QwB3exFchWei43nBh5xsYRZxEUfayi3JvYgm,Fyw1TEEDKhLFo16qxDsttsAwSkrfzpDe8Dmm3atEeXyN,True,18307390,4576847,28097,14048,14049,4BnQKPLuE3DMTtxp8MjUBytgnhvxqq3ZTqZHTVZo4JJh,1123887,12343579,-11219692,613
2022-01-22 00:24:20-05:00,6588,HELPNUwAqTX7gfHS4cnJnqXFM6Rb156tYcpsitKR9iDu,3RdfgDvLvsdZG5Cf6hKiKMQMqfidyxHzjYvUx1FZpeHQ,True,20052402,5013100,30979,15489,15490,3zqXX6kzhkbW3d4TwD2CNjMRwxTbREXySekvq37kfCNk,1239190,18722706,-17483516,617
2022-01-22 00:24:23-05:00,6589,DC4UVUDFWL3gVtgkX9hPtFgtxaA8DH5p94i4k9U3wyWv,3HCWqVvQQfRgSKitsTjGTduJ82ointZUSNtj13uea4kD,True,79639766,19909941,122229,61114,61115,3zqXX6kzhkbW3d4TwD2CNjMRwxTbREXySekvq37kfCNk,4889170,51614997,-46725827,613
2022-01-22 00:24:23-05:00,6590,2sPD4f4d3CCeFSwSC5vAGS3YoTsTGypYKfDeoJczebop,HWCRpcq2sXqJL7Vi8MtipQDwGSViE73bUxS36ETmvnP2,True,8161222,2040305,12561,6280,6281,72FwbpFGoLEazJEdpqNtPNefsadUrimUqma9wSoy4qiS,502469,3273825,-2771356,615
2022-01-22 00:25:37-05:00,6591,CyWBZ1xJ9LahUnPesbXLZ4Rr5UyWAHgVFYwfrnhyrkNL,2Lpk87Xth8ZL5J9BfzmMpEE3x76FDrrrmdKiCNkSVip2,True,15294093,3823522,23924,11962,11962,4BnQKPLuE3DMTtxp8MjUBytgnhvxqq3ZTqZHTVZo4JJh,956963,9046102,-8089139,625
2022-01-22 00:25:37-05:00,6592,HdRgh9niYSd3YKCxzGdusYFquiVoFTP2mEGEzJJL5Nii,78C68Gbb1jYFQmYNCHHjL52keEKMXtGukmBwT7ahon4B,True,1241762763,310440690,1942627,971313,971314,3zqXX6kzhkbW3d4TwD2CNjMRwxTbREXySekvq37kfCNk,77705089,749694881,-671989792,625
2022-01-22 00:26:19-05:00,6593,46TNhGwBVzedW8xSb9UY94HNeSom9iGiZzAjrKHiRM2G,7JVTiqNYeKHbyzRkKtvSEpqLPKykZso8cGUr3sX1j7QF,True,11871546,2967886,18208,9104,9104,4BnQKPLuE3DMTtxp8MjUBytgnhvxqq3ZTqZHTVZo4JJh,728342,6215693,-5487351,613
2022-01-22 00:26:21-05:00,6594,9aQrdyfAvcBbBj7iKQB17eAS4zBqymdd3kzkTkuRhdLU,BDHhukMF5rALuSwCxaw8g73m2MN4oX1D4e7uNmx3SiVt,True,158689539,39672384,235236,117618,117618,HfEnetJ7uBSmZWCjBNxdvv9HEC5nsW4wDV7wu6WnhWan,9409466,47452141,-38042675,592
2022-01-22 00:26:22-05:00,6595,56488NdcUy6Hi6X5SLs2GFtW5pG4u5wJpH7vHdxTCx4z,tGgXjJeVr3W2m3T2NXPCqpBEd6HJKE2cRsgCyiDZQy4,True,8119542,2029885,12698,6349,6349,HfEnetJ7uBSmZWCjBNxdvv9HEC5nsW4wDV7wu6WnhWan,507950,5059123,-4551173,625
2022-01-22 00:26:44-05:00,6596,7tDiadLeMrob7yD6R5SDskYn41tnQZVPjEc6W2vv6irK,AHZidccE9ERBcipuRQ2iGM9kHRpTnty7UNuYTFurvXB7,True,204450918,51112729,312202,156101,156101,3zqXX6kzhkbW3d4TwD2CNjMRwxTbREXySekvq37kfCNk,12488115,61218945,-48730830,610
2022-01-22 00:27:01-05:00,6597,3Xbsek5MsEGoWr3G9yhuohREr26B2vSQcjqXdspTFHta,2rPxkUiMo9wGDq8EvAiwY3ngRpKmL223cBWWNTYoBmFp,True,16281305,4070326,25298,12649,12649,HfEnetJ7uBSmZWCjBNxdvv9HEC5nsW4wDV7wu6WnhWan,1011930,6768761,-5756831,621
2022-01-22 00:28:14-05:00,6598,Br1j5Ftafei7ysu5SmqVZSoRe4uS4qCPeKSPHg55pyiE,G8fc7QvXjfkgBFvAVUgJFQS3VaF1biL9rktBExGa87Ks,True,422601475,105650368,660141,330070,330071,3zqXX6kzhkbW3d4TwD2CNjMRwxTbREXySekvq37kfCNk,26405671,251726082,-225320411,624
2022-01-22 00:28:46-05:00,6599,5hJereyPSCNUrGW7TdYXHKjhXMWTbGZzc2GF9MWksLJE,AUE3NpqaeamHGBKUVuKnUhnBb4Lzt7xWU1FHMu1Hq5dC,True,137770457,34442614,203654,101827,101827,4BnQKPLuE3DMTtxp8MjUBytgnhvxqq3ZTqZHTVZo4JJh,8146178,59869907,-51723729,591
2022-01-22 00:33:12-05:00,6600,BjCNaM7YbE9SjFi7tzi4677zg1fKXGJwtecz2GWwWuhd,6rNsSrKZezQrLb2whToNjnizpnurDXrobHqfEK3QqU1M,True,5590569401,1397642350,8622082,4311041,4311041,3zqXX6kzhkbW3d4TwD2CNjMRwxTbREXySekvq37kfCNk,344883317,1817463721,-1472580404,616
2022-01-22 00:33:12-05:00,6601,84SgzR8J6DeqPJ1uXphP1BHMotYGKh3kS4owMMj9x58x,CL7Jkwe3NK4qaAVK2QjuftXnQ5YLqDT9qYeeEi7kJXrV,True,22307795791,5576948947,34792568,17396284,17396284,3zqXX6kzhkbW3d4TwD2CNjMRwxTbREXySekvq37kfCNk,1391702725,17695832643,-16304129918,623
2022-01-22 00:33:12-05:00,6602,EmGW2aAG69ssWqCtbfDocRaM2u3TJsczn2HHP9jdmRvD,aypkDKsp9uqAB4F6mwvm5LofpsrFBuZT2MMWtE2eHdB,True,37957,9489,58,29,29,3zqXX6kzhkbW3d4TwD2CNjMRwxTbREXySekvq37kfCNk,2352,27818,-25466,619
2022-01-22 00:33:16-05:00,6603,AATMHH4e4B6SL9bThnXGktzWuqWkPdx3JbRXk8HwkbPW,6F3u2yLx7P9gtpAAXASx7uF8xNyVBgJiKosMKUrgpicA,True,14689188,3672297,22269,11134,11135,HfEnetJ7uBSmZWCjBNxdvv9HEC5nsW4wDV7wu6WnhWan,890765,10016083,-9125318,606
2022-01-22 00:33:17-05:00,6604,WMUVFELv3C3KdMKJ5ZL4rG7o1YrV1qTP6Mmp2S5Rp8S,7UNzS3zDqT1oeq9a7eJGU8cgf8eUzEAZubSBQvNmK6uJ,True,1064873,266218,1604,802,802,3zqXX6kzhkbW3d4TwD2CNjMRwxTbREXySekvq37kfCNk,64178,451242,-387064,602
2022-01-22 00:33:18-05:00,6605,9zpPiboHF5HW7NfCx7hYdmJGwUomVMTiUFc4Um5KrDi3,8q3eBpuwV6dMNkib9N8XQAq2tBUcjSANRe5SXpd4dFhZ,True,481862,120465,730,365,365,3zqXX6kzhkbW3d4TwD2CNjMRwxTbREXySekvq37kfCNk,29210,282211,-253001,606
2022-01-22 00:33:18-05:00,6606,E8ifvhmyJGBGVQomo3AnZw2UcaLHcpGsTtuoCid8voU3,FMQUWTbTAfSLfrc6GTrz4DM2ZSgoxF3KtqGn8AyjVtsf,True,417692,104423,633,316,317,3zqXX6kzhkbW3d4TwD2CNjMRwxTbREXySekvq37kfCNk,25354,255465,-230111,607
2022-01-22 00:33:21-05:00,6607,A3E9T7xYkPeNiWKdvhNTYiD5j7k2Xecpe318eFqVro4m,2QJk8iVJEy2QZmbFHnR7RBJsi7NpXWFFkEmweWtKKHfE,True,114761029,28690257,174998,87499,87499,4BnQKPLuE3DMTtxp8MjUBytgnhvxqq3ZTqZHTVZo4JJh,6999922,91730770,-84730848,609
2022-01-22 00:33:21-05:00,6608,9UyQC8vc6zJJaSdnjvTAzgmcsw4fC3xFBBiCC1w9Sbjx,3ppBfboe6FPmt7f6WrivspMUoAznZKWQMeh3rCgw7vjQ,True,526008,131502,805,402,403,4BnQKPLuE3DMTtxp8MjUBytgnhvxqq3ZTqZHTVZo4JJh,32214,307939,-275725,612
2022-01-22 00:33:21-05:00,6609,pgzvXpnUYiY7hLrfjmwScqLd8oj9vYcXpFvpm4y4JvG,GdqdQgoyBAFuXdbvoZyDhB3jyqJzVo4nkGh7EPFxkBF2,True,124446,31111,192,96,96,3zqXX6kzhkbW3d4TwD2CNjMRwxTbREXySekvq37kfCNk,7707,153584,-145877,619
2022-01-22 00:33:21-05:00,6610,CvZssqscu2dm35mwcE3zg9zedavbRjVJjWD59Py5ExUK,7pXaoR6aHKYofCmg1eHipygNYDteEaf8rbbS8BDYGQK6,True,41312,10328,64,32,32,HfEnetJ7uBSmZWCjBNxdvv9HEC5nsW4wDV7wu6WnhWan,2574,25549,-22975,623
2022-01-22 00:33:21-05:00,6611,6Y1UoGwrKyKsScZQm9ng1rNrXXykKT82V7kUopc43kAy,8YtWQTTKymCESbPMWCP9TMehbMU25zJMtxt9grqrpbD4,True,2238907,559726,3397,1698,1699,3zqXX6kzhkbW3d4TwD2CNjMRwxTbREXySekvq37kfCNk,135908,2701943,-2566035,607
2022-01-22 00:33:21-05:00,6612,CBL2NbekJrXvBiAcoj4fzQ4PfLDwTntW7Zt4nruHFYEw,59EvfgYTdKkfjUJz5LddLUAqbEdLaihcMzjcrTZsyzyS,False,739,739,37,1,36,3zqXX6kzhkbW3d4TwD2CNjMRwxTbREXySekvq37kfCNk,37,497,-460,500
2022-01-22 00:33:23-05:00,6613,CCi9urfx5bFFMazAAVz1WtJzJotHA8E1i8RrtgMP97Fp,2DFvm5fZj29qvqoLmbReUaisd9qBTNUfuE7HgmmHUc7w,True,4658401,1164600,7145,3572,3573,3zqXX6kzhkbW3d4TwD2CNjMRwxTbREXySekvq37kfCNk,285826,4005937,-3720111,613
2022-01-22 00:33:23-05:00,6614,Ayx8dFsVzUBb9b7QKxw7YHJuhptdSitBXFEczXTaxe85,EvU1VLChnowi6ccSPeJRSk65njrqZfYouAN7SHePxsxf,True,1374,343,2,1,1,3zqXX6kzhkbW3d4TwD2CNjMRwxTbREXySekvq37kfCNk,84,1083,-999,611
2022-01-22 00:33:25-05:00,6615,CwTus4FyoXYqyTKAYDp69NLhA1joYZ3tarzY6FFTr6fn,6ivuvYWU6i25MzJSY8rG9rPDKiq38E6QtrV1jvRubLGr,False,826,826,41,2,39,3zqXX6kzhkbW3d4TwD2CNjMRwxTbREXySekvq37kfCNk,41,571,-530,496
2022-01-22 00:33:25-05:00,6616,2F45BX9mRmtNCHPejKFknN5aNgGvR4vVLFjMaY1a7dR8,ALdSutsvEFRUEQGGBbi31QywTL1pdXSDWrNJzvNTaoXL,True,1471572,367893,2235,1117,1118,3zqXX6kzhkbW3d4TwD2CNjMRwxTbREXySekvq37kfCNk,89400,1092255,-1002855,607
2022-01-22 00:33:26-05:00,6617,Ht2oWgWWVsA4u5fwp8o8dwgUjoGSRDF2gAwQPDXCwKfZ,8pYWhoNFpmDYuawZub9rd5qkSsAJuPGeJwoa23YyVVym,True,3178230,794557,4824,2412,2412,72FwbpFGoLEazJEdpqNtPNefsadUrimUqma9wSoy4qiS,192994,2730074,-2537080,607
2022-01-22 00:33:26-05:00,6618,6SqJHnwgDCdUdUercq1UushY4tKpbJPKTapGM3ub7Sgm,8MQCsx2SzMUCBWkbriEgkP2ooWC6MDRJvT23xLYEYHTe,True,7113687,1778421,11129,5564,5565,72FwbpFGoLEazJEdpqNtPNefsadUrimUqma9wSoy4qiS,445195,5330296,-4885101,625
2022-01-22 00:33:30-05:00,6619,J4krKPBBTMVLZRgrSeYJAMyHQs2FkNm5TXk7nQWwDB43,ASmLbfNbhTD2HHeV7qzAqiHjUx5a8Traj8oPDwbkMdFg,True,1669215,417303,2600,1300,1300,HfEnetJ7uBSmZWCjBNxdvv9HEC5nsW4wDV7wu6WnhWan,104029,1047650,-943621,623
2022-01-22 00:33:53-05:00,6620,FuoFPNTdYVDkSHaBac6UC1aNJXafSNTvFJuBCdrgQQrH,ApBS1Fx83tcECMzDV6wEzEzEdg4e2hgj3djtjRUoSKK5,True,182644434,45661108,285697,142848,142849,3zqXX6kzhkbW3d4TwD2CNjMRwxTbREXySekvq37kfCNk,11427903,102830813,-91402910,625
2022-01-22 00:38:16-05:00,6621,Dng7By2saPu5TVxcvXidBe71ggBo8tiHkAXPi4kKL1tk,75ufEJmHbLHffphL7tvAXhGyftKLr1z2PXXoB2GGY5fG,True,108643846,27160960,169626,84813,84813,3zqXX6kzhkbW3d4TwD2CNjMRwxTbREXySekvq37kfCNk,6785054,28168308,-21383254,624
2022-01-22 00:38:31-05:00,6622,5acohGZShYQVNGZEfy7pTyX7E8MzqRDwByhFL1H53UNv,4Z454ZseKbWGEtdrE9eotbDZ7o9VHhooMYriTfSFHiGt,True,484544230,121136056,755772,377886,377886,3zqXX6kzhkbW3d4TwD2CNjMRwxTbREXySekvq37kfCNk,30230885,129781882,-99550997,623
2022-01-22 00:38:44-05:00,6623,7E3Zc3g1eJ7ueosPPoHDSkhuHvBVfN41eXcJXWeffozU,CGA8dcsZjfLqSYijYmssZwd9TXAsvSafNVT6JvUajGdu,True,187910837,46977709,293359,146679,146680,HfEnetJ7uBSmZWCjBNxdvv9HEC5nsW4wDV7wu6WnhWan,11734391,154910100,-143175709,624
2022-01-22 00:38:44-05:00,6624,51yPLtXTgL9oLKs1cCf5TjL54Ld5vuVxat2NNtwZVsZG,7UjtM7Z1tiXEQMMiorQyncgi9SKu3v46DhVdgXbWqSiF,True,20935444,5233861,32723,16361,16362,4BnQKPLuE3DMTtxp8MjUBytgnhvxqq3ZTqZHTVZo4JJh,1308931,24994043,-23685112,625
2022-01-22 00:39:32-05:00,6625,9Ft21UZ66egkMCtZprBPc72WF1aj2fQwLs6XJWPXUbUV,6DGSgHegc23W5MQ6hqSsSSdwNvRqU3piR9GBoZ6fU23f,True,124287530,31071882,194162,97081,97081,3zqXX6kzhkbW3d4TwD2CNjMRwxTbREXySekvq37kfCNk,7766516,50546439,-42779923,624
2022-01-22 00:40:12-05:00,6626,gMjmD7WioyUdQdwNqE5fobLcxPwoJv5rAvLmJaf8Jjw,5n77euFjVJiwKrnbYq1KpcENW1mzBZj2BuDGyzazrkJ8,True,19048545,4762135,29740,14870,14870,3zqXX6kzhkbW3d4TwD2CNjMRwxTbREXySekvq37kfCNk,1189617,7317682,-6128065,624
2022-01-22 00:40:15-05:00,6627,2aK454FrEuA6JQZo2hLUabd4E6wyQtVuJWw2rWz2pGVy,3dJvhEh7kykf8hCCWQRarh2s5ybJUAzbaPdDUmX4XokW,True,186538698,46634674,291123,145561,145562,3zqXX6kzhkbW3d4TwD2CNjMRwxTbREXySekvq37kfCNk,11644958,46546760,-34901802,624
2022-01-22 00:40:15-05:00,6628,J3ggP7ZxL8HRh3CBp5iYG2WgjLyNSAWYT46uC9VYDLCz,2FqTRiRPiLvdAH2BS5vroVntpsSXvTJEn5UHWmtKHzh9,True,2439648,609912,3811,1905,1906,3zqXX6kzhkbW3d4TwD2CNjMRwxTbREXySekvq37kfCNk,152461,1307453,-1154992,624
2022-01-22 00:40:53-05:00,6629,Hy3kzXneDN6FUkiZctU1vWe97BYvj6yZ7QvQzehfWmNr,EhXgQg8BTniANV525RpY76z7Hrh6DuqrMChjqEoXfVJe,True,24132155,6033038,37466,18733,18733,3zqXX6kzhkbW3d4TwD2CNjMRwxTbREXySekvq37kfCNk,1498647,9421245,-7922598,621
2022-01-22 00:40:55-05:00,6630,CxLFMBDFkoMvpK9YUf7WtCq6hn7k3QACAuetAnGjU6KA,2gE52a1GWQnS6ifV6eVtKQyr13LXP5Jdt3yG9SjGPJPF,True,100753331,25188332,157129,78564,78565,4BnQKPLuE3DMTtxp8MjUBytgnhvxqq3ZTqZHTVZo4JJh,6285168,39018900,-32733732,623
2022-01-22 00:41:11-05:00,6631,9WJBnVi84E926j7xEd566WzrZJkPJWRgmEnYj9vyjuad,4dLaFS5F7TGyLdwuJLMGkz3bSL53aHzd9ZfpNmhHxXeF,True,1272145,318036,1955,977,978,4BnQKPLuE3DMTtxp8MjUBytgnhvxqq3ZTqZHTVZo4JJh,78209,967840,-889631,614
2022-01-22 00:41:11-05:00,6632,FgQrRo4eGQAonSsFfQgnp8trGGqGZCLeGX6yvJnMnTjd,8KhemHLBY6nGmo3xMDedW2wnCSxQq6LwbTExif4sUSxx,True,113757985,28439496,174938,87469,87469,3zqXX6kzhkbW3d4TwD2CNjMRwxTbREXySekvq37kfCNk,6997541,34981554,-27984013,615
2022-01-22 00:41:12-05:00,6633,399591e8XgY52yCMorCQ2WL6dQZTC485ZooHtmGuirhZ,JCiXAooFmKmEPQ2S7C8iSk6CLcTyrPEe1SsPSLyUGySe,True,88748,22187,138,69,69,3zqXX6kzhkbW3d4TwD2CNjMRwxTbREXySekvq37kfCNk,5543,74641,-69098,624
2022-01-22 00:41:12-05:00,6634,8E3K7vCHJ2xjdFofPRGLbMxrkm8UYEi926QmXPAFwsqe,4qHUDA1c43Dg4qi1ZPKqmpGYiEMUZ6r4UuzB5ftHCEhW,True,117577405,29394351,182350,91175,91175,3zqXX6kzhkbW3d4TwD2CNjMRwxTbREXySekvq37kfCNk,7294012,90181445,-82887433,620
2022-01-22 00:41:12-05:00,6635,BgnsCfJ54ReunUtwPJLzkW4PWnqpBDWGNYxsW5PvDrbK,KpMqEkQ9dKMgCevsEK895wHd3fCLRPSzDmJSv3tKU4u,True,1202247730,300561932,1859812,929906,929906,3zqXX6kzhkbW3d4TwD2CNjMRwxTbREXySekvq37kfCNk,74392482,723634529,-649242047,618
2022-01-22 00:41:16-05:00,6636,67Z7ZGhNu5xxEh9BYKWcXp9m1T4tFiE1o1M16hCzUWQA,CT7YKWixz7BhTbvg5F6M5HCyPGnHoFLNFuDV9GhoLTo3,True,191591,47897,298,149,149,4BnQKPLuE3DMTtxp8MjUBytgnhvxqq3ZTqZHTVZo4JJh,11957,166510,-154553,624
2022-01-22 00:41:16-05:00,6637,C9beggursF9WdLyzunVSoz2Bw6kAxoQpUifPHbo4ybvw,3R7KdKBK7FoudsNXUeRuC2AGVFusMhmTYXSGdnA88pJT,True,2168059121,542014780,3386741,1693370,1693371,3zqXX6kzhkbW3d4TwD2CNjMRwxTbREXySekvq37kfCNk,135469645,887000294,-751530649,624
2022-01-22 00:41:16-05:00,6638,CRaKcudjkQiSw5YPVjTLVdXvJskeGiHSYtq5ZcMPJhgQ,AgqTg3b3bAcaBmRidhNC4Uf9ZwNbeH52RQEqumWyuUs7,True,51078,12769,79,39,40,3zqXX6kzhkbW3d4TwD2CNjMRwxTbREXySekvq37kfCNk,3179,46165,-42986,622
2022-01-22 00:41:16-05:00,6639,DdAPWdHnb7ocaYtcwwwYnppsH39sZpmzMyANeoJbCV7s,3BVmC39L8dEypPN1BZhsf9bx9Ge2sXCZR8Y6RH4eBNMJ,True,62070940,15517735,96119,48059,48060,3zqXX6kzhkbW3d4TwD2CNjMRwxTbREXySekvq37kfCNk,3844784,64855057,-61010273,619
2022-01-22 00:41:16-05:00,6640,DdYgcyV1T2CDYiQVr4VL9Ym8RdKm93a7SKy8HxuyaoMW,GPdAeqeXb1UJ56AttcwwY1CyFhRyfptDC4BAX2Tc8MpE,True,31011,7752,48,24,24,3zqXX6kzhkbW3d4TwD2CNjMRwxTbREXySekvq37kfCNk,1935,24379,-22444,623
2022-01-22 00:41:16-05:00,6641,6nJyqvFKprwaVCE1gAa2P4RHKc6Pa6XFSJymx654zZ9K,4e7iJmdwzAPxp1Zi8Azo38YyPQdPKqqY4VLJyQ5rpdYP,True,146967,36741,229,114,115,3zqXX6kzhkbW3d4TwD2CNjMRwxTbREXySekvq37kfCNk,9160,116232,-107072,623
2022-01-22 00:41:16-05:00,6642,Ckqos6cdncPKj13DnCmDVZsZTqp6eS7277CRrT9WhcEr,AtUV8m7VQJvZq7GLCAHMf3jV7iamKEPnWVZHWuuVZQp1,True,73247,18311,114,57,57,4BnQKPLuE3DMTtxp8MjUBytgnhvxqq3ZTqZHTVZo4JJh,4567,66155,-61588,623
2022-01-22 00:41:16-05:00,6643,DZSNYptWi3UbyYo4heSHfJFmCWjUNk1iDb75nJfPCPWp,D6dtmxaPmcRSWSRgb1wX4G2eMgeEw2oweCW8YJTHxuDc,True,13856,3464,21,10,11,3zqXX6kzhkbW3d4TwD2CNjMRwxTbREXySekvq37kfCNk,863,9226,-8363,622
2022-01-22 00:41:20-05:00,6644,DGAQzgZhS2yioeZmG3cbacM3hdz4F1aZn1PWRwgiFukc,48KUtJaNCPNxkLXJBtWAdDxY4b9vZzLgbGxTNdwMqmjz,True,30831008,7707752,47975,23987,23988,4BnQKPLuE3DMTtxp8MjUBytgnhvxqq3ZTqZHTVZo4JJh,1919000,22544522,-20625522,622
2022-01-22 00:41:20-05:00,6645,brCL9pzP6q4b6rKgAH1AJbMoqffBWyXLX8oAnZDoi77,Dx4G5UP9jTb47JQypWJnv48mPTzhJvqPD1BtBtDT7TJF,True,476472,119118,744,372,372,3zqXX6kzhkbW3d4TwD2CNjMRwxTbREXySekvq37kfCNk,29767,176224,-146457,624
2022-01-22 00:41:45-05:00,6646,5Z3ZFCA65WoWhm3okRuuziEMi7ajGAEHWUFchzBNba5S,FcomdrWidygkxMKzcsY5xELbmwC652uMci648LMTv7AB,False,791,791,39,1,38,3zqXX6kzhkbW3d4TwD2CNjMRwxTbREXySekvq37kfCNk,39,534,-495,493
2022-01-22 00:41:45-05:00,6647,ApAgbKGyEYXRonGM33w56ZxHQNAGSd9ji4K3zAGN2yA8,FZAhAUDtEaNsFmh4fP8uXNjoHneNkpZ2wQCfEeU4RYRM,True,5950497,1487624,9147,4573,4574,3zqXX6kzhkbW3d4TwD2CNjMRwxTbREXySekvq37kfCNk,365887,3724975,-3359088,614
2022-01-22 00:41:45-05:00,6648,M69XSefqeum2arinvHEqmA3L2XHWNFN17p4msRhRZXf,2vK15yYUANLSbAoiBfgJ9VLyqsmtEpd2iNytQjms8GaQ,True,15965253,3991313,24764,12382,12382,3zqXX6kzhkbW3d4TwD2CNjMRwxTbREXySekvq37kfCNk,990592,15004986,-14014394,620
2022-01-22 00:41:45-05:00,6649,5sN3cfz4hZjwy2HkAStKWeL8wHhdbkW8F7USzwCzmggh,Fme7U7QY92biAsV3RR2Fj7rJPnpdcov13mmFhVDFuyYG,True,42151517,10537879,65915,32957,32958,HfEnetJ7uBSmZWCjBNxdvv9HEC5nsW4wDV7wu6WnhWan,2636621,27751487,-25114866,625
2022-01-22 00:41:45-05:00,6650,CgQB5KmWNz21q9mPfFBve8Ksbqdsdr8jNfwkrxmNZPLN,2dtPpz7Ck4hhBQq8DUywp4Bq21Jk1enHLe8AgXa8ARZu,True,67892089,16973022,105147,52573,52574,3zqXX6kzhkbW3d4TwD2CNjMRwxTbREXySekvq37kfCNk,4205904,44628942,-40423038,619
2022-01-22 00:41:45-05:00,6651,9vcKW1GfrDZ3KLPh2pEVFF8ZyKqD1pJW1hiE8H98Av7S,C6Ki27mo4sCHu6u8UnR1p7WSgsTjFQxGGR9Lk9n5Rhjq,True,163683,40920,252,126,126,3zqXX6kzhkbW3d4TwD2CNjMRwxTbREXySekvq37kfCNk,10095,124060,-113965,616
2022-01-22 00:41:45-05:00,6652,4cKgCTttVp8pzJnp43PP7uLLUXNcU7YGPJ3cCGHaUFe7,BBQqjwTpVEgpDzMk4wDDH8rCjaSxCRPWVhtFxERSujTD,True,2383311,595827,3672,1836,1836,3zqXX6kzhkbW3d4TwD2CNjMRwxTbREXySekvq37kfCNk,146903,1648843,-1501940,616
2022-01-22 00:41:45-05:00,6653,H1LftKtj94Zs6PG2A7gJt9rPurBkXkTy2hbbArQwAehi,8bANmhgdnPYa3PqdPnk5BA2xhvqJmPyaMF77mrBePJ13,True,2244,561,3,1,2,4BnQKPLuE3DMTtxp8MjUBytgnhvxqq3ZTqZHTVZo4JJh,139,2550,-2411,619
2022-01-22 00:41:45-05:00,6654,2hirR46fpyHEg1Fv9vAzYgnoNRBWaky7LoFGVof4DnpK,DXTEHauVDdz4Mjjj6sJHPUh6TnzU6ob6Nj63To2vCNPW,True,132696671,33174167,203856,101928,101928,3zqXX6kzhkbW3d4TwD2CNjMRwxTbREXySekvq37kfCNk,8154267,45014685,-36860418,614
2022-01-22 00:41:45-05:00,6655,9VSpd4vToJrnQhmJ595Ua7GhmhutYRgd6rCk3pL4yNxr,7axwFe8aQVPYLNgM9rdUwnFf6vW69Jsw2XpKNjYRDn6N,True,19872311,4968077,30562,15281,15281,4BnQKPLuE3DMTtxp8MjUBytgnhvxqq3ZTqZHTVZo4JJh,1222512,12282097,-11059585,615
2022-01-22 00:41:45-05:00,6656,6oroGB3mvzK3tDfiB9X2NJuL3x476pxhgRnt7VxqhdLo,2SoK8tKkLn2ppKURpTVazKsCEis4uahkHMsac1m85J4r,True,105552,26388,163,81,82,4BnQKPLuE3DMTtxp8MjUBytgnhvxqq3ZTqZHTVZo4JJh,6532,126472,-119940,618
2022-01-22 00:41:45-05:00,6657,BXMMFy2k9b2hVBEG6RyXAq3qqXxJ7EY2xhyPZqtLvBiU,KpoZwr4ZFTHJgebbf4tcjT9iKvpC1EF8Aw4uaVPxXNd,True,3818126,954531,5870,2935,2935,4BnQKPLuE3DMTtxp8MjUBytgnhvxqq3ZTqZHTVZo4JJh,234803,1159611,-924808,614
2022-01-22 00:41:45-05:00,6658,HVZkXeDR3mc8oB9qFFwCK4RXpPojdcHk9tRGep6xtKGK,Bh3py7awPejWqeTMxtAgF7mPotL2Asxf8YrYJykq9nBt,True,388546,97136,604,302,302,4BnQKPLuE3DMTtxp8MjUBytgnhvxqq3ZTqZHTVZo4JJh,24182,269931,-245749,622
2022-01-22 00:41:45-05:00,6659,HPDN6Ro6gPgYbNgnv7yhFCpyY3uYzT18epFxRFNZ985w,3Jop74A52E7gYLXJRUAoPBzSZ6mmP2gmaCg7eG6eQHu5,True,65006251,16251562,100634,50317,50317,3zqXX6kzhkbW3d4TwD2CNjMRwxTbREXySekvq37kfCNk,4025385,29124213,-25098828,619
2022-01-22 00:41:50-05:00,6660,3EmGvYu72cR4Ta3wLA5HKZBEqgfChCyiRanwj5hGLJXc,6NEWPFaKi5uLsrj4n6RM1DBhQTcGFE9TwYeJ12pC7yyp,True,2337,584,3,1,2,3zqXX6kzhkbW3d4TwD2CNjMRwxTbREXySekvq37kfCNk,145,1584,-1439,620
2022-01-22 00:42:13-05:00,6661,H1Z83zVoskNuBvYao1FjdLfETfhPpQFQUkniJfGxbaNz,EVqbBRV6Zy1tPLRevxpAykp8Mvv6tDZVTc4RmCKw4Gq1,True,123277475,30819368,192328,96164,96164,3zqXX6kzhkbW3d4TwD2CNjMRwxTbREXySekvq37kfCNk,7693150,81293061,-73599911,624
2022-01-22 00:42:27-05:00,6662,A4tDE948CPFPh1UwHb8sXryfKktbxZ8BCkqXgA5DJHA8,3zXeKMrsEpCe5fQumLNzCgpxcG1kLJFEAtJuqxLsC6ZG,True,7176910,1794227,11209,5604,5605,3uL2NSR2ZdDqCiKfzA5SwwpddAnit22DBJo6uvvz1rRs,448381,4905651,-4457270,624
2022-01-22 00:42:31-05:00,6663,4uygLJDk9DFCifJ56YwMrEsvd3oQNq8tYSLnMCyWorS6,GimL4uKGvg3FFmFQSWzAcjstv3Vmk5NMgDGMKTuXYVpB,True,42971041,10742760,67135,33567,33568,3zqXX6kzhkbW3d4TwD2CNjMRwxTbREXySekvq37kfCNk,2685430,27931180,-25245750,624
2022-01-22 00:42:35-05:00,6664,BgN75npBkPws5uiFE9RAujmPuZyAv2MQUPmfmJ1YCCij,78UFLNDn782TY2P4F5kRkMRC2s3gw8ak7sRQZRWNq82D,True,19890900,4972725,30912,15456,15456,3zqXX6kzhkbW3d4TwD2CNjMRwxTbREXySekvq37kfCNk,1236519,6652528,-5416009,621
2022-01-22 00:42:38-05:00,6665,6N4PNbueNmkCECF8ojw5R6wGtxComzgGED179GiJaLjQ,AL8eRDEo8yCvD4n4kvruEuZzXBXrJrEiBt9SQwCcDPYd,True,383685302,95921325,600441,300220,300221,4BnQKPLuE3DMTtxp8MjUBytgnhvxqq3ZTqZHTVZo4JJh,24017647,144452138,-120434491,625
2022-01-22 00:44:42-05:00,6666,GqPZDwm3EWGMiVy7BY6qHM4Vzt2B9vW3Zs1CLScrtjAD,63h2HEdkmc54a8txd4LZ69TUBLR6VphxBoXLx6hjCLg4,True,1362716309,340679077,2128335,1064167,1064168,3zqXX6kzhkbW3d4TwD2CNjMRwxTbREXySekvq37kfCNk,85133422,323552415,-238418993,624
2022-01-22 00:45:14-05:00,6667,8eTH6eJyyVeMno3UQkffeBg32xofKsQfkhLhXdtaf87s,BCFC7CPXrQPsUfJb2eYSht8GhaApWHpc49AeCXqaYq13,True,18532487,4633121,28967,14483,14484,HfEnetJ7uBSmZWCjBNxdvv9HEC5nsW4wDV7wu6WnhWan,1158691,7112883,-5954192,625
2022-01-22 00:45:14-05:00,6668,B2hN3Lt5pFbUyfEUc5s48hkxUJ5rr2SeFxgdGdQ8pDD2,7bZJCCud253j9g411HQUDXUAADcwd5yJWznoTChBdB2H,True,503355363,125838840,786983,393491,393492,4BnQKPLuE3DMTtxp8MjUBytgnhvxqq3ZTqZHTVZo4JJh,31479359,155653342,-124173983,625
2022-01-22 00:46:04-05:00,6669,CpxZ136k95cVjGqkJnNpDZKUgrJrfg8HrFDZPL6BgsK4,Fo7HtcrneUTsnGqygsxPQ63G5rayYodYT65xP6B6HusH,True,128754969,32188742,199566,99783,99783,3zqXX6kzhkbW3d4TwD2CNjMRwxTbREXySekvq37kfCNk,7982671,38259079,-30276408,619
2022-01-22 00:46:04-05:00,6670,72L76qDRMK3M7X52zuuB9GVyvFFLDBZwFMpVjWjghXzA,4m2ZVuemUctu1edv4YJVAcjXzKwpbCmBujzoUmLDeA7h,True,29300300,7325075,45633,22816,22817,3zqXX6kzhkbW3d4TwD2CNjMRwxTbREXySekvq37kfCNk,1825352,11332378,-9507026,622
2022-01-22 00:46:04-05:00,6671,FnAT8HKGgisYfeAbxKU2gSbCp8KbZHULRpaJX1NVijHy,2u637Crc2QzfSJmCnRNqeib3aZQVn4NGncpgM3Ph6jvm,True,2835109,708777,4406,2203,2203,3zqXX6kzhkbW3d4TwD2CNjMRwxTbREXySekvq37kfCNk,176243,1585701,-1409458,621
2022-01-22 00:46:05-05:00,6672,D9VKhnfLLCrntDGFYSfoxFaY76VnHmYZ1ZbyFXdKdibz,2hRCRH2pMDyQGYcXHa8Y6BZo6FbcGZf5VJC1v8Bp6tGa,True,7602551,1900637,11744,5872,5872,3zqXX6kzhkbW3d4TwD2CNjMRwxTbREXySekvq37kfCNk,469798,4661415,-4191617,617
2022-01-22 00:46:05-05:00,6673,8kJu5aqVSmW8FSZR9h6F75ftn9V2U9uMLBEKeqRaC855,FhVHByujkvwwtjTVpZ4mqSUqoMoBgeLUc5H7rbz3FgAt,True,7306101,1826525,11272,5636,5636,3zqXX6kzhkbW3d4TwD2CNjMRwxTbREXySekvq37kfCNk,450901,6176342,-5725441,617
2022-01-22 00:47:41-05:00,6674,Cv5oVktxmqbU1SxraxH67NEWMKnjgA18R832Fhe9h74a,Cs7xBD4BDiohyopnaYDDChUtR9vmx7uwot6Qp9beQLzt,True,54302919,13575729,84482,42241,42241,HfEnetJ7uBSmZWCjBNxdvv9HEC5nsW4wDV7wu6WnhWan,3379281,17897443,-14518162,622
2022-01-22 00:47:43-05:00,6675,FsMiJiJZibohKoV5QRisWCjzuFd86xSxFb4m73AQmu93,7p3TSKBaG9SV2YNDnhutQKacPKpTTmgsEfzmK51t6sYb,True,17245346,4311336,26886,13443,13443,3zqXX6kzhkbW3d4TwD2CNjMRwxTbREXySekvq37kfCNk,1075443,9669513,-8594070,623
2022-01-22 00:47:43-05:00,6676,cG5VSSaBpjNdRLMQT7dmotpcWRTfdmJZYdWsrzNzRTE,5RESxV6aZenjAdaqw1jxoYSGttpLrNuZiRJy2WeLAVJv,True,163409308,40852327,251908,125954,125954,HfEnetJ7uBSmZWCjBNxdvv9HEC5nsW4wDV7wu6WnhWan,10076330,91026027,-80949697,616
2022-01-22 00:47:43-05:00,6677,9KD2AifD5wFD4QkHYuawXbJgLWHrfj2QPF3fT8jhGVA5,Ga9gAqmkuHbqrr31sUFPqa1xa5WNxLWJWGPUaMxQqLdj,True,80407,20101,123,61,62,3zqXX6kzhkbW3d4TwD2CNjMRwxTbREXySekvq37kfCNk,4958,68824,-63866,616
2022-01-22 00:47:44-05:00,6678,H3394S5wdbwXB4scjGAY8NsXxCdGy1Xebct18s42FM1K,Hz84L1EquzhCvBJP75ScKug46hYGdNMVNH16AdG4y5D8,True,3880368,970092,6045,3022,3023,HfEnetJ7uBSmZWCjBNxdvv9HEC5nsW4wDV7wu6WnhWan,241815,2449604,-2207789,623
2022-01-22 00:47:46-05:00,6679,BRK2EePsnQq54oaD2Ua4cxxKhdgVS2Kx57JKXCrBkeg7,7yskmLp2oA9qN38G7NBqVGggzs4ZoQ63HD4EnMVweMyY,True,811869400,202967350,1259919,629959,629960,4BnQKPLuE3DMTtxp8MjUBytgnhvxqq3ZTqZHTVZo4JJh,50396764,305435183,-255038419,620
2022-01-22 00:47:48-05:00,6680,AUH6YGBV8tDVX1E1WTo92Mubfx1DGsqfGeyUBqxo4fSr,33QZgMwmW32WuvmxD8XNbmF9ea88bLe3YTtNwHV73Wwu,True,17257195,4314298,26685,13342,13343,72FwbpFGoLEazJEdpqNtPNefsadUrimUqma9wSoy4qiS,1067415,9827327,-8759912,618
2022-01-22 00:47:58-05:00,6681,3VdSA9CED9f5swRwHX2U15U7J6Muaq8VPnCNy9CaGDHe,2YYstfnfdYic5NWmEbcUEHpccNUVd1EhuCkExvMsoMk8,True,414205,103551,647,323,324,3zqXX6kzhkbW3d4TwD2CNjMRwxTbREXySekvq37kfCNk,25904,351179,-325275,625
2022-01-22 00:48:45-05:00,6682,9yDHiv4vGbQWYby3dAMCdVnwiYgXBV1jV6WCzKYUPiUs,FPyemR1VdBnhxW2V7j7EkQyhzW894bCb3f6wRUMSn6jB,True,654691911,163672977,1020656,510328,510328,3zqXX6kzhkbW3d4TwD2CNjMRwxTbREXySekvq37kfCNk,40826267,150876256,-110049989,623
2022-01-22 00:48:45-05:00,6683,2MbNCikBC3fdwqJKfMK1FjPg7wT3xWMXmN88XuikJ8r9,5eG6U5x63YYMpE7iwwu1TPcZapvQMyKczvtnFfST1BH3,True,21550,5387,33,16,17,HfEnetJ7uBSmZWCjBNxdvv9HEC5nsW4wDV7wu6WnhWan,1344,9981,-8637,623
2022-01-22 00:48:51-05:00,6684,F6wpqqx576XRuYo8y6XPLYphojrQtK4VvdY79Jk6My5N,38VbNLaQzLFcVqHuSR9zn9UX3Yv9SCVy1mrwmxX9PpVQ,True,110054689,27513672,171925,85962,85963,HfEnetJ7uBSmZWCjBNxdvv9HEC5nsW4wDV7wu6WnhWan,6877014,23912325,-17035311,624
2022-01-22 00:53:37-05:00,6685,A36aouot1oFLUtswuBUM4EVcis9chKaSJu53MRoPDjab,33U9gpq1RRFMGWDrWa3ezXXkwgBewdAS6QGgGVPtGvqb,True,22237820,5559455,34744,17372,17372,3zqXX6kzhkbW3d4TwD2CNjMRwxTbREXySekvq37kfCNk,1389787,12418904,-11029117,624
2022-01-22 00:53:39-05:00,6686,4MSyrHopFkuaCEEvLAUV9cJfVre6cLAx5sJF5LEMSCTX,6HhLHoswuDKrcixShWCDcquW6PgmbS5FidEnkM3bwuJQ,True,4244938,1061234,6606,3303,3303,4BnQKPLuE3DMTtxp8MjUBytgnhvxqq3ZTqZHTVZo4JJh,264272,1510012,-1245740,622
2022-01-22 00:54:08-05:00,6687,8MGEQ1KEMv9WSgVifjN7CQ7tDbJBJbWgGYu71dTDKEPQ,mQY2X9KYVXf9JmGY8XwMK4G8odM4HmWkgEmYYqKnkvF,True,10134593,2533648,15826,7913,7913,4BnQKPLuE3DMTtxp8MjUBytgnhvxqq3ZTqZHTVZo4JJh,633075,7954003,-7320928,624
2022-01-22 00:54:10-05:00,6688,5rW9kqXB9feGSKSvSMNJF1FCsBYV3vGmTmc8MvzaZ3pi,7AjnjcfPJevW5521hXw4VtgRCfHSsAqyzyArukKfNcHo,True,647945,161986,1011,505,506,3zqXX6kzhkbW3d4TwD2CNjMRwxTbREXySekvq37kfCNk,40475,514954,-474479,624
2022-01-22 00:54:47-05:00,6689,36ByQojnxEckWdQTjqHfxKqCx9yjqWQsPsZyqaN72UWR,AZoirtS1fjX61agRM64tqThVinnJTh3BWgiHyNHPTgZP,True,49061,12265,76,38,38,3zqXX6kzhkbW3d4TwD2CNjMRwxTbREXySekvq37kfCNk,3053,41233,-38180,622
2022-01-22 00:54:50-05:00,6690,EitU96ThqHErybDn2j1NY6JHkqV1R3mWM1uWH7wYKr1T,2p9eYbLyBqXrhHtRKp1jJb7VGjCmb4LkA6kzqLr1ijet,True,9620033,2405008,14800,7400,7400,3zqXX6kzhkbW3d4TwD2CNjMRwxTbREXySekvq37kfCNk,592014,5093230,-4501216,615
2022-01-22 00:54:50-05:00,6691,2jPxG5FL6D6XEJsRszJ9cmQ54AWSpZyPFSbn3DpWBSuM,3toQou4UVNvyWYvMvkuv379RVEF2aN2TzCpKKBUqeQV6,True,11375252,2843813,17790,8895,8895,3zqXX6kzhkbW3d4TwD2CNjMRwxTbREXySekvq37kfCNk,711609,7809837,-7098228,625
2022-01-22 00:54:58-05:00,6692,CagSUfZLwXuCdypC4KzU6FSNdmCj9dKDroPcNeaRtsyt,yxw5d1ztZuEUY2QjL7eLpr72QJAj5rJd6ERvg91cy1m,True,95290,23822,148,74,74,4BnQKPLuE3DMTtxp8MjUBytgnhvxqq3ZTqZHTVZo4JJh,5954,60932,-54978,624
2022-01-21 17:42:41-05:00,5669,4FazDUgfQ3AKoFcnWHr8E9Ht8jLA3tkxf75yrGZVHdmF,HzRMH6mbgEKydRCnnMvSsKgTEVNQi6nuzoR1xutYFdzg,True,6682,1670,10,5,5,3zqXX6kzhkbW3d4TwD2CNjMRwxTbREXySekvq37kfCNk,418,6416,-5998,625
2022-01-21 17:42:41-05:00,5670,961Wz2gAzstN9CQjgoe22Htq41zJsYbn8T2pAJqUVo4G,66vPnY7rg7HS9VchM2H33BBqkZK53RDMbrQwj6gSMCdR,True,1846598907,461649726,2885403,1442701,1442702,3zqXX6kzhkbW3d4TwD2CNjMRwxTbREXySekvq37kfCNk,115416127,468817220,-353401093,625
2022-01-21 17:42:42-05:00,5671,7MSzV5yy5FmrM4j1BcYSRiTGWfit1AJahheRUaXzz349,aPSTZLxBpVr3sucjbj95emRV2J1GrUWr7wbARYqJkQZ,True,485343,121335,755,377,378,3zqXX6kzhkbW3d4TwD2CNjMRwxTbREXySekvq37kfCNk,30234,258565,-228331,622
2022-01-21 17:42:42-05:00,5672,69byqtDPmgEY1NqKBCR95CEPVHRUxgbNW9Y4P4HjQ7ND,E47T4q4zMGzNL6vDxgWdLn3EQbW3WfVryr8Jsymy1hAL,True,62997790,15749447,97500,48750,48750,3zqXX6kzhkbW3d4TwD2CNjMRwxTbREXySekvq37kfCNk,3900011,34642828,-30742817,619
2022-01-21 17:42:42-05:00,5673,5BjBPqumCb9KC82ZNNch3dcRzbpGdRLJneru7o9a1D9R,FuZtBWKktxFu4yoiLVMzxq8fMhQyN8SGzGPz49xs3m6P,True,16059311,4014827,24956,12478,12478,3zqXX6kzhkbW3d4TwD2CNjMRwxTbREXySekvq37kfCNk,998248,11282215,-10283967,621
2022-01-21 17:42:42-05:00,5674,DXCbqHqSGrq8dG6CmA5JwKXQTidVBSqE8vCxHxNBcF2z,6z5Ghi47Miuie5Tn72rLp4uBf1EALB8wPsmzrtb1DwZS,True,9573492,2393373,14871,7435,7436,3zqXX6kzhkbW3d4TwD2CNjMRwxTbREXySekvq37kfCNk,594840,2263850,-1669010,621
2022-01-21 17:42:42-05:00,5675,Es6UDmhJTnRsCUCFBtSfc4KYhFBPAVtBuX2EN2DS3FsH,J5gi9V4pQq4ke9tun4pf4oJPVtVPfYUKRX1RArAJMVLv,True,296678537,74169634,462665,231332,231333,3zqXX6kzhkbW3d4TwD2CNjMRwxTbREXySekvq37kfCNk,18506632,72424416,-53917784,623
2022-01-21 17:42:43-05:00,5676,93ho4cgnpAJiJsG6uu2udkLVNU7rkz4QjCYfsqvpbPA5,45ouQn9gGwXqnTGfaP5CvU8fCKadBRA5kPwtfvJzykRU,True,6915777,1728944,10771,5385,5386,3zqXX6kzhkbW3d4TwD2CNjMRwxTbREXySekvq37kfCNk,430846,3773573,-3342727,622
2022-01-21 17:43:01-05:00,5677,H3x9b27yHVdCxvtDf7mmJxkNeubcmQMwfAkLTYADPWNv,HGVCCz23rWx78vrTB2wvm2aesbLZuYFhhNuznGiSSAyA,True,699904265,174976066,1054076,527038,527038,3zqXX6kzhkbW3d4TwD2CNjMRwxTbREXySekvq37kfCNk,42163049,232574462,-190411413,602
2022-01-21 17:43:01-05:00,5678,GqPZDwm3EWGMiVy7BY6qHM4Vzt2B9vW3Zs1CLScrtjAD,63h2HEdkmc54a8txd4LZ69TUBLR6VphxBoXLx6hjCLg4,True,1840296265,460074066,2729393,1364696,1364697,3zqXX6kzhkbW3d4TwD2CNjMRwxTbREXySekvq37kfCNk,109175748,403659483,-294483735,593
2022-01-21 17:43:03-05:00,5679,D58t4uTjFumsUeYFaKnpV8BRTEQEqKXBreFTdwGrott7,67p6kHDfVqQijfcwugvZK59c3aRRH9x3eHxruqH8WEqF,True,43425075,10856267,67423,33711,33712,HfEnetJ7uBSmZWCjBNxdvv9HEC5nsW4wDV7wu6WnhWan,2696946,14713982,-12017036,621
2022-01-21 17:43:05-05:00,5680,7hTjPRQSYAoWHhtpsVz2oKK5SAuFJd8dPHShKgKJq8dy,6DcHcrtcXR88d8e2KahhAiWTeRznNfF8oXLHmh5wE7wz,True,107973281,26993320,165713,82856,82857,3zqXX6kzhkbW3d4TwD2CNjMRwxTbREXySekvq37kfCNk,6628542,61868489,-55239947,613
2022-01-21 17:43:09-05:00,5681,GNkEoVMpNAgfyDBZ986MR9BEVc485xpLuZWwSCyZk5zJ,AT2eiaMyZNHZGqgTdie8QjLWCTrWSdkRmQxU2vZNgtDs,True,12292259,3073064,17813,8906,8907,3uL2NSR2ZdDqCiKfzA5SwwpddAnit22DBJo6uvvz1rRs,712549,3834232,-3121683,579
2022-01-21 17:43:09-05:00,5682,CLVUzXSNsQnX7n5cvxMuTjyMSjy1pNpPnWejFaeuonvb,BXZzBujr8DAUcGJcHQBaz1ZSwkATAHg3NX3bLnrjQpLh,True,40751162,10187790,61573,30786,30787,3uL2NSR2ZdDqCiKfzA5SwwpddAnit22DBJo6uvvz1rRs,2462923,9546868,-7083945,604
2022-01-21 17:43:09-05:00,5683,H1oYXGZTagwv48FdDe6RNkjNaesedqLKyXxTmPc5k4Fp,Am3rx6XrkrZ4MdeZDyZUv1YW2fBujcz4dLjVCnRQHKZa,True,384210404,96052601,589141,294570,294571,3zqXX6kzhkbW3d4TwD2CNjMRwxTbREXySekvq37kfCNk,23565677,98505419,-74939742,613
2022-01-21 17:43:09-05:00,5684,DMACzuFBuj2vGqxZ3FV7QAo24jMV3EHKL8MrDrGbRkaJ,EnLfmDVW4ba2uqZKhj3X1TFnx8AHv7xwSWrMbVBYwcu9,True,18986958,4746739,29658,14829,14829,3zqXX6kzhkbW3d4TwD2CNjMRwxTbREXySekvq37kfCNk,1186342,8519452,-7333110,624
2022-01-21 17:43:09-05:00,5685,CbhrZUdan1axNDFUrX1ZuEohfNMEGrszKSkk6pppVQuw,DHEAjJNtuEePezYAv77thWabbVxxqQpfuiC6moRSrpG1,True,10456261,2614065,16157,8078,8079,3zqXX6kzhkbW3d4TwD2CNjMRwxTbREXySekvq37kfCNk,646313,8209052,-7562739,618
2022-01-21 17:43:10-05:00,5686,4KMzwWHPeW51cxu4nMpbqCaqo96dMqaHWyRCGQktfQfd,F7q4GNYcbnZa8dJ4qovQwjmxpKpdEmdxQMXRPb9nQupa,True,78634555,19658638,116558,58279,58279,HfEnetJ7uBSmZWCjBNxdvv9HEC5nsW4wDV7wu6WnhWan,4662355,22603874,-17941519,592
2022-01-21 17:43:12-05:00,5687,G25vsB3sDqRhHoSK4KwR1TywfrJDtpejVbbevEG9sQ9a,5xFC3Hm13magnAA9GD1EnwC9PrPoEfQ7omEa9p9zCrB1,True,33747467,8436866,52315,26157,26158,3zqXX6kzhkbW3d4TwD2CNjMRwxTbREXySekvq37kfCNk,2092612,11923029,-9830417,620
2022-01-21 17:43:42-05:00,5688,HpDwBPWZHfLzJUvTTABTA6qddyLLJiVTfqBx5gUktSUb,BqXLpaAeTNfNSeevfdazNqTgqEXj6Edgp8txWvCoxEz6,True,98581464,24645366,152620,76310,76310,3zqXX6kzhkbW3d4TwD2CNjMRwxTbREXySekvq37kfCNk,6104833,72507760,-66402927,619
2022-01-21 17:43:42-05:00,5689,CYkojG4q1SnizNs59qsYTEBU1c11XC8nteMhxRbwhCBq,A9MsPy3aeMzdQUWXK6qmWLiZfKREiBrSVaJAKp2nEcSt,True,2537728,634432,3929,1964,1965,3zqXX6kzhkbW3d4TwD2CNjMRwxTbREXySekvq37kfCNk,157191,1452662,-1295471,619
2022-01-21 17:43:48-05:00,5690,46TNhGwBVzedW8xSb9UY94HNeSom9iGiZzAjrKHiRM2G,7JVTiqNYeKHbyzRkKtvSEpqLPKykZso8cGUr3sX1j7QF,True,21924362,5481090,34310,17155,17155,3zqXX6kzhkbW3d4TwD2CNjMRwxTbREXySekvq37kfCNk,1372420,10308303,-8935883,625
2022-01-21 17:44:03-05:00,5691,GjQQ2fQ7mrGjWZwjVYFUKp9NM1LmfkhEo675ovU5SPa8,ECgVUMRY5nB4MALs5drDyipF7YohCPuJpj2UegCs7HMn,True,1801863,450465,2819,1409,1410,3zqXX6kzhkbW3d4TwD2CNjMRwxTbREXySekvq37kfCNk,112785,1166345,-1053560,625
2022-01-21 17:44:07-05:00,5692,AWvHDdb2ikqV8wc7qQ8azbvNTZdixMNxhQjhQdhayYtR,9EpgEPBb1nog6aQeFdMXfSRiLSnzGQFQ39mbLdCxgYTv,True,5215675,1303918,8058,4029,4029,3zqXX6kzhkbW3d4TwD2CNjMRwxTbREXySekvq37kfCNk,322347,2573264,-2250917,618
2022-01-21 17:44:10-05:00,5693,5eMLdQ4gYA5iqvTXSNdGvctHp7s5VpyFuwtJKqx6chBc,Ckxc5K39nkBNXBTmFTM8J48R7wGqNm3vHKZu4G5baumZ,True,36946296,9236574,57398,28699,28699,3zqXX6kzhkbW3d4TwD2CNjMRwxTbREXySekvq37kfCNk,2295943,19733393,-17437450,621
2022-01-21 17:44:16-05:00,5694,JDeYjCLpfnzcfxDFgHf4aBcHsajwdR14GUaKAA9euzVf,EJbvKoyMZcoCx4vWa61uMbW2vr6mUhrgEuECdteVBuZZ,True,877714,219428,1348,674,674,3zqXX6kzhkbW3d4TwD2CNjMRwxTbREXySekvq37kfCNk,53940,714146,-660206,614
2022-01-21 17:44:37-05:00,5695,7jvKp6onXyWgwsFrFWj4hYTXJsYYD6ot5mn6rPFuJriy,J7N6HiozevJVTiY9hDEUs2ud5BwT5QSE7wnMBS1w5ie2,True,6552164,1638040,9936,4968,4968,3zqXX6kzhkbW3d4TwD2CNjMRwxTbREXySekvq37kfCNk,397467,4549972,-4152505,606
2022-01-21 17:44:39-05:00,5696,HmspGdpobjC5Vbmo3FcKdw4RLPN7wJKxv3uKqDjVhLee,3YEX8TzdyJyuHo76Kw76imVCJjzrC9m188YuRKvwwSwD,True,65302956,16325739,101976,50988,50988,3zqXX6kzhkbW3d4TwD2CNjMRwxTbREXySekvq37kfCNk,4079068,22181361,-18102293,624
2022-01-21 17:44:40-05:00,5697,DkKumyFA6dGw77wcwd16nWzTEC9McvmasAbmGfQXLkB7,9u6QyrruYFjhyLV5AXYUKkrBggzrxXfNH57smUAap5Ro,True,9191071,2297767,14260,7130,7130,3zqXX6kzhkbW3d4TwD2CNjMRwxTbREXySekvq37kfCNk,570430,4143135,-3572705,620
2022-01-21 17:44:40-05:00,5698,3idUQDMPAN9f6F6BipHAYFZyhG5JADey1y7JcFYx5BRh,D6UMk8WsSRahs4nGyi9DLt2HyZQy4wAywDwL31sL8BVj,True,7842985,1960746,11566,5783,5783,3uL2NSR2ZdDqCiKfzA5SwwpddAnit22DBJo6uvvz1rRs,462647,2774282,-2311635,589
2022-01-21 17:44:41-05:00,5699,56488NdcUy6Hi6X5SLs2GFtW5pG4u5wJpH7vHdxTCx4z,tGgXjJeVr3W2m3T2NXPCqpBEd6HJKE2cRsgCyiDZQy4,True,10979177,2744793,16566,8283,8283,3zqXX6kzhkbW3d4TwD2CNjMRwxTbREXySekvq37kfCNk,662657,6577760,-5915103,603
2022-01-21 17:44:41-05:00,5700,9E97vZ6evPgg1Ao8KwvjjZhBFW6dXZrrJENk1HvZ3SU,D7U38PB8BXLwUVKbRNv9po7VcFdnn7Y4tWY9xpRiNJsT,True,10591087,2647771,15773,7886,7887,3zqXX6kzhkbW3d4TwD2CNjMRwxTbREXySekvq37kfCNk,630947,4176556,-3545609,595
2022-01-21 17:44:42-05:00,5701,J1sBDjpdBZcsSBS5eg95SSRjRqmQUR9cXJCsLJu8yCUt,F5wRpD2senMkGbL8Uquqo8W9x5NQDDa268dHuVFAZCww,True,735618,183904,1073,536,537,3zqXX6kzhkbW3d4TwD2CNjMRwxTbREXySekvq37kfCNk,42946,449537,-406591,583
2022-01-21 17:44:42-05:00,5702,6pUtYz474QrpATEZnfb3iFbTKYA65pNyKAo4TQZAjtqe,8dipRUXvxJiDLdHEtCPkso4vErbVwshHQiRfvSngBS9J,True,39621051602,9905262899,61460636,30730318,30730318,3zqXX6kzhkbW3d4TwD2CNjMRwxTbREXySekvq37kfCNk,2458425477,11718787368,-9260361891,620
2022-01-21 17:44:42-05:00,5703,EYNh72buYHmKWRSqF8omcFHRbqKWV76iXB2vrjHgQMck,Efm7bH2DFg5Y5M39jq3uDcoDHUa95zmey8n7Ld72jG84,True,92174149,23043537,136725,68362,68363,3zqXX6kzhkbW3d4TwD2CNjMRwxTbREXySekvq37kfCNk,5469034,35776441,-30307407,593
2022-01-21 17:44:42-05:00,5704,C33hfnDHzVwKXxr6AwFAXhd1vJYrPKhtqc75Qpjm19Zt,2WYBMSyrHQEYZqxEtxBMe2xn7eioJEGsudqdCmGvssGh,True,10039379,2509844,15444,7722,7722,3zqXX6kzhkbW3d4TwD2CNjMRwxTbREXySekvq37kfCNk,617778,3258150,-2640372,615
2022-01-21 17:44:43-05:00,5705,5NVD6QvomTAD35yNxSFZw4DhF2hCtV8drkbnGhBVtK5y,3JzkyPnREvoFZLL9JZuuDEnee3nuKcrqY3xLuXsmHwRo,True,4762327,1190581,7444,3722,3722,3zqXX6kzhkbW3d4TwD2CNjMRwxTbREXySekvq37kfCNk,297785,3444041,-3146256,625
2022-01-21 17:44:44-05:00,5706,AQr9mVmcXCNQhBVCfx63MwR6c4WqDSC9K2BZqr7N8LCx,CB7TWUaL381ounsLw6neAUaKRxJL9P1HC9uGX5e1Uxod,True,62692659,15673164,97811,48905,48906,3zqXX6kzhkbW3d4TwD2CNjMRwxTbREXySekvq37kfCNk,3912467,56106933,-52194466,624
2022-01-21 17:44:44-05:00,5707,2kqN3TbCDgM4x8XfZvKgqJvDAHqvZxtT89NcfmQSQa5b,8fEx56PjuPAP61CBnrsnnnQnZmt8cw6KVjhYDK1mWJzP,True,62142849,15535712,97239,48619,48620,3zqXX6kzhkbW3d4TwD2CNjMRwxTbREXySekvq37kfCNk,3889581,21620835,-17731254,625
2022-01-21 17:44:44-05:00,5708,GKCeRcHQYMhcTwEm5wu1SbkXAT19gjGUGji43HS36B5N,EYQKX5sWsmXoge5xbTcMYAjvRbSUTXXpHEzckPY2LV8W,True,375997,93999,586,293,293,3zqXX6kzhkbW3d4TwD2CNjMRwxTbREXySekvq37kfCNk,23448,147969,-124521,623
2022-01-21 17:44:44-05:00,5709,E9FFPvygPSF22u7gqFq4w6yE5kV15zbeGDXFQc349RsG,yi1REPVUwKhr5ss5YJc56crYz8LVfkqNVMpKcdSfwfY,True,181984,45496,283,141,142,3zqXX6kzhkbW3d4TwD2CNjMRwxTbREXySekvq37kfCNk,11337,82768,-71431,622
2022-01-21 17:44:44-05:00,5710,F9s8a7Cpiw5dw3a2aNFMofqwyDWNXvDLnSdJzoj1gRiV,GpKsQKJD79KBRWdCTkyi4zX7NaoCWsLUjrKxAwJB6o6s,True,2380643,595160,3724,1862,1862,3uL2NSR2ZdDqCiKfzA5SwwpddAnit22DBJo6uvvz1rRs,148985,990854,-841869,625
2022-01-21 17:44:44-05:00,5711,6xbPoFjPYUcSejbTk5iiTZRWyZkicfkSzM1Fhbj3w9L5,7xTAbaXwhxxVY3TM88TLakPPwPyL4zT4TsVvtUvniVec,True,422730528,105682632,658050,329025,329025,3zqXX6kzhkbW3d4TwD2CNjMRwxTbREXySekvq37kfCNk,26322003,106041599,-79719596,622
2022-01-21 17:44:44-05:00,5712,5acohGZShYQVNGZEfy7pTyX7E8MzqRDwByhFL1H53UNv,4Z454ZseKbWGEtdrE9eotbDZ7o9VHhooMYriTfSFHiGt,True,657315826,164328955,1022272,511136,511136,3zqXX6kzhkbW3d4TwD2CNjMRwxTbREXySekvq37kfCNk,40890892,162360822,-121469930,622
2022-01-21 17:44:45-05:00,5713,87R8o8xLjHw2GpunYkm7pX7uJ8hjM4B1y4Qm7aQf6Yh4,48aSVPQoFYdncF5NtJ114urbdTzVjTgYLgPzMfpJbZB3,True,6962836,1740709,10820,5410,5410,3zqXX6kzhkbW3d4TwD2CNjMRwxTbREXySekvq37kfCNk,432805,8336718,-7903913,621
2022-01-21 17:44:45-05:00,5714,Bsr6kx1B6BSEd5UnJ7Z61M49iUb3bFrDVhiEtMVtPDF2,3CFd1pUJAJPA9fobwn4Jj2mRju1CWmoop4Mh4znypNWT,True,3298725,824681,5117,2558,2559,3zqXX6kzhkbW3d4TwD2CNjMRwxTbREXySekvq37kfCNk,204714,1874305,-1669591,620
2022-01-21 17:44:58-05:00,5715,ECuu1L4QGdemZ7FjAjVAAxYN6piinweY7Fuk5csVovfT,Amd8WGcpdtB8yoA83R1BUT5uryuqoKbcBexYacbrbGVX,True,332339,83084,515,257,258,3zqXX6kzhkbW3d4TwD2CNjMRwxTbREXySekvq37kfCNk,20636,187528,-166892,620
2022-01-21 17:44:59-05:00,5716,9gYrMXAGmGSV4VFjXzYP5WwH2aFpB1TxA6CqpYsosKLv,Dh8aH6RK48wu4fkT9xKw5XL7itxnPDuw3SDwPwvL5sva,True,2885,721,4,2,2,3zqXX6kzhkbW3d4TwD2CNjMRwxTbREXySekvq37kfCNk,179,1763,-1584,620
2022-01-21 17:45:00-05:00,5717,FLTW9fwjWqGPm5PiE3C9LFzwZxtDh8c2MnEoRq8W7MfQ,GKsfzKBP2QkmoEWvTaUN1h4nqrT3kAcwYRC9WxW9bB3h,True,1341575,335393,2095,1047,1048,3zqXX6kzhkbW3d4TwD2CNjMRwxTbREXySekvq37kfCNk,83831,721795,-637964,624
2022-01-21 17:45:00-05:00,5718,CCHzYXr5zMXFu8MMZNkfUWGyUcF8xy7Vvhq7tNCtZg2L,AuEXkCJTTJ3HK8iP4qTWpQr4vp6HPRJZyZwfRjF8zjfp,True,15943,3985,24,12,12,3zqXX6kzhkbW3d4TwD2CNjMRwxTbREXySekvq37kfCNk,997,8580,-7583,625
2022-01-21 17:45:00-05:00,5719,ioPHEVyheRnHYomVS7PmP6Coyhjk6LCs7hMD5Mq9Ngv,DYTpFmZ4yXVghKwkaovgCdpv3jfWkjtXRzxsZjKJfXNN,True,2617,654,4,2,2,3zqXX6kzhkbW3d4TwD2CNjMRwxTbREXySekvq37kfCNk,163,1611,-1448,622
2022-01-21 17:45:00-05:00,5720,6osqTNxgZv1Y1EjnVR7D1G4cywof1CrWswj87tAnktWV,Fah93R9W7SFuajFif4AbXDdxouWA5rrLz29vzVRGsMxv,True,1359458,339864,2121,1060,1061,3zqXX6kzhkbW3d4TwD2CNjMRwxTbREXySekvq37kfCNk,84866,1528576,-1443710,624
2022-01-21 17:45:00-05:00,5721,9LZ3rShLfzErXsGkh4dYfAm58GNPWhK6ohDy5RrLJhc,41tLyuvuJ5M7YctkSASD2R7RGGetD7FmKaZUdkTdgXgt,True,157497,39374,245,122,123,3zqXX6kzhkbW3d4TwD2CNjMRwxTbREXySekvq37kfCNk,9803,71933,-62130,622
2022-01-21 17:45:00-05:00,5722,6d6HN8LWikwW2HYdy3BABWuxKHt1sgv4DcneACR133sE,4eKvzmfFvX96XbujKBhUauAvWP4yQYwZH3pd7gXzbCvJ,True,181689,45422,283,141,142,3zqXX6kzhkbW3d4TwD2CNjMRwxTbREXySekvq37kfCNk,11345,83071,-71726,624
2022-01-21 17:45:13-05:00,5723,6gFbxvPafnpqZjWW94MMmL8mGp2FHZGqoJC5fWqgwNxS,C6WcDycp3Ff3xYmb81i8JbD39Xv1o5G2AdtPs1FdXtr4,True,250334812,62583703,389276,194638,194638,3uL2NSR2ZdDqCiKfzA5SwwpddAnit22DBJo6uvvz1rRs,15571062,85574404,-70003342,622
2022-01-21 17:45:13-05:00,5724,DJiXXW7sjNsAAxWupDKBUsFhXSgPoerVYaAtJqqNgVbn,2MsqvNuJw1xQhJ3UnXt9i7oNHDuZpR9w7iE1WQcGqt5m,True,15934,3983,24,12,12,3uL2NSR2ZdDqCiKfzA5SwwpddAnit22DBJo6uvvz1rRs,997,8588,-7591,625
2022-01-21 17:45:16-05:00,5725,Sapmbypb7FUXhKQEdjyH2AUDgh8QWQ1mu6SSHm7673N,7AGij8bP7Kq3iARJ41duwggPrDfuXDoKwRSKV9SG8nk2,True,30508137,7627034,47547,23773,23774,3zqXX6kzhkbW3d4TwD2CNjMRwxTbREXySekvq37kfCNk,1901895,7950667,-6048772,623
2022-01-21 17:45:19-05:00,5726,duKo8riX1qpX1K1qpgwZniMtUeWqu2eYgchTu5n7Rbu,9vAVwfVtdsaZMbeZvoymjHqwASeuM38gfEJkbTVwDqya,True,7285263,1821315,11387,5693,5694,3zqXX6kzhkbW3d4TwD2CNjMRwxTbREXySekvq37kfCNk,455496,4381772,-3926276,625
2022-01-21 17:45:19-05:00,5727,HhwiZPKZBGa16oVi739s4qtMDMTwzWXc7iwNfX63t2UP,5AnbMbAFKy85yHt5y2M5S38nNkA1vT4ejY5NjGbRNUqn,True,150508,37627,233,116,117,3zqXX6kzhkbW3d4TwD2CNjMRwxTbREXySekvq37kfCNk,9353,126396,-117043,621
2022-01-21 17:45:19-05:00,5728,921FBgLS3A1wA77uWitsnTvW737Q2jY7tzvgWtWLXNC7,E4eJ9H7cqP9zNpMH5xRBTAp9yaBCBihuJBNd6pqzteDG,True,15933,3983,24,12,12,3zqXX6kzhkbW3d4TwD2CNjMRwxTbREXySekvq37kfCNk,995,8586,-7591,624
2022-01-21 17:45:19-05:00,5729,2p2fGXdKrmxjomLSnyaNg84J82cBBBNympZ6qQc8UZgU,HKAM8bazuLMUY6yapZJqYsgaWkTBqKHyMs1hSfpYsZGi,True,88273773,22068443,137303,68651,68652,3zqXX6kzhkbW3d4TwD2CNjMRwxTbREXySekvq37kfCNk,5492120,64622690,-59130570,622
2022-01-21 17:45:23-05:00,5730,9k5YHTFCHczFg6KAZXf2ostkFLH7WdVAxiA9zCGRprg3,2b52r1TA8dkJsnuMuM9cNfGxKEynd42WjQUuzcQTRcD9,True,6929,1732,10,5,5,3uL2NSR2ZdDqCiKfzA5SwwpddAnit22DBJo6uvvz1rRs,432,4274,-3842,623
2022-01-21 17:45:23-05:00,5731,BPRoaqrDs8vhqv2T7d9qV2oPU33pi1K1LUaotM7yuD2i,6qo8uQGAEwBfYQR36v6nRiqA2xGV6SjJAsXsdzy5bqNH,True,112690325,28172581,175391,87695,87696,3zqXX6kzhkbW3d4TwD2CNjMRwxTbREXySekvq37kfCNk,7015648,74538629,-67522981,622
2022-01-21 17:45:24-05:00,5732,2bikYf33ZxxDmvkMNjWDGGqEpbYJPvWv5At3hzyeLEQK,5FtirUBjRAZ3k5arFFVwKz42ixWzhkEBLkaK9PraRZ78,True,15934,3983,24,12,12,3zqXX6kzhkbW3d4TwD2CNjMRwxTbREXySekvq37kfCNk,995,8586,-7591,624
2022-01-21 17:45:26-05:00,5733,GxFxvEUdWofneMmVvhCSScH9V6Zia5WJ2J9q6CpPnaq3,ATLykiHDii3Lw53MoZXwqu1FbBNPJbVNVGe2SoQMjVmY,True,362239,90559,565,282,283,3zqXX6kzhkbW3d4TwD2CNjMRwxTbREXySekvq37kfCNk,22603,261592,-238989,623
2022-01-21 17:45:26-05:00,5734,Gbxc51WERLLeCtiHv7rDvE52aqF541RoQWG5n5aqErq6,4ngBoHbfXijLMqGKxFMNht9sbmxy2g5eqBmn8QsBmbx1,True,81655363,20413839,126393,63196,63197,3zqXX6kzhkbW3d4TwD2CNjMRwxTbREXySekvq37kfCNk,5055756,23589951,-18534195,619
2022-01-21 17:45:43-05:00,5735,3FF2rhr1RuT7UR7MmmGtrhfYbh6kbc5UXq51KmqFLZnq,AEmSYLt1dQ8suLugC4Lcw4kF3dG9GYcEfX54hEAKfmv5,True,21982599,5495649,34025,17012,17013,3zqXX6kzhkbW3d4TwD2CNjMRwxTbREXySekvq37kfCNk,1361028,7497818,-6136790,619
2022-01-21 17:45:47-05:00,5736,2pKygdXJnjZBFfrZgDasmHQQgw8LgycmBBRuaoCU72cz,DXsomQ5yWw2ceZMbaCVsSaE4hKm9W6Gy785JG75Aaz18,True,19791588,4947897,30798,15399,15399,3zqXX6kzhkbW3d4TwD2CNjMRwxTbREXySekvq37kfCNk,1231925,6747223,-5515298,622
2022-01-21 17:46:01-05:00,5737,4kbcrzH6o2LvLUCNphyL52i8uGzVD8wcUNEqoQ14z3VG,5Q1atmEBs2AqaDZsiZFG5stHzj1fE6ZvypgfkEc9LYqE,True,19385851,4846462,30328,15164,15164,3zqXX6kzhkbW3d4TwD2CNjMRwxTbREXySekvq37kfCNk,1213159,15032696,-13819537,625
2022-01-21 17:46:01-05:00,5738,3g1debT8Z2efQPuMNSDPUNZzDqarBG2acErsZ4HP7QGA,42wDHagxr5Nno3mUx6kyYGDjwR98aedRbh3ByB468agB,True,2058,514,3,1,2,3zqXX6kzhkbW3d4TwD2CNjMRwxTbREXySekvq37kfCNk,128,1268,-1140,621
2022-01-21 17:47:07-05:00,5739,Fani89KviVFZek4si6YZ3apVuM2kSqVUijDnLBqtvJEH,EpC29dECx1cLC69bj2ncG3jFp7obPaxbH7F6mju27cwL,True,2472261,618065,3815,1907,1908,3zqXX6kzhkbW3d4TwD2CNjMRwxTbREXySekvq37kfCNk,152608,790628,-638020,617
2022-01-21 17:47:07-05:00,5740,6NJFN855M3Q3RLTDNo57gTgAmwPD6G2E3WvMb1m5eNCN,3YpqNnonsvXaRT4nCC3G5FZx1jjVtbDPc36LiR6WK5jR,True,8561314,2140328,13320,6660,6660,3zqXX6kzhkbW3d4TwD2CNjMRwxTbREXySekvq37kfCNk,532830,6861794,-6328964,622
2022-01-21 17:47:07-05:00,5741,HHHj6EinpgAJeZkDXfsvCo3UXnmAdiAZNvPSUfVPc5Sg,3gx9c31MDtJtByxkUuWcqf1oARnZTjpx3QtxsM1Xb6Gp,True,84582320,21145580,131594,65797,65797,3zqXX6kzhkbW3d4TwD2CNjMRwxTbREXySekvq37kfCNk,5263787,44647840,-39384053,622
2022-01-21 17:47:07-05:00,5742,D64rDiWT3YG28fCgXCmbNjYa2JakZbpKQ1D2XuLChUfV,8WmMWq8cTsGQym5pUbHm9dPCpJugBeWUMVERYFGLxWHj,True,4021578,1005394,6205,3102,3103,3zqXX6kzhkbW3d4TwD2CNjMRwxTbREXySekvq37kfCNk,248205,2165452,-1917247,617
2022-01-21 17:47:07-05:00,5743,6kqKSyVVF4xxUbsvBCkY1kt4XcKzb98eSaqNw5fxSLtw,4T9DKFUmkcPG7mM3CKzW3m81LqqpU7oFTv35Pha4zHNe,True,186845296,46711324,291585,145792,145793,3zqXX6kzhkbW3d4TwD2CNjMRwxTbREXySekvq37kfCNk,11663419,109151252,-97487833,624
2022-01-21 17:47:39-05:00,5744,8swGZMrPrLAxZd7MxTbkCL13k3DmAJUw41jCp6Xo6awW,3fKnX7yTNXAT4uMmXVdTy47ALJT8h8YSD3WiBb4BGuzH,True,26139313,6534828,40699,20349,20350,3uL2NSR2ZdDqCiKfzA5SwwpddAnit22DBJo6uvvz1rRs,1627984,16873469,-15245485,622
2022-01-21 17:47:45-05:00,5745,Cv5oVktxmqbU1SxraxH67NEWMKnjgA18R832Fhe9h74a,Cs7xBD4BDiohyopnaYDDChUtR9vmx7uwot6Qp9beQLzt,True,73686034,18421508,114591,57295,57296,3zqXX6kzhkbW3d4TwD2CNjMRwxTbREXySekvq37kfCNk,4583667,22658949,-18075282,622
2022-01-21 17:47:45-05:00,5746,DWTaeNeq5x83cBvKUz2jZfXDz5z4F5wbSZLNv7smnjvd,9pQGArZnJV4Fu8tBVEfknmmfmrRv5RKV2u58BJBuhzpF,True,10517178,2629294,16279,8139,8140,3uL2NSR2ZdDqCiKfzA5SwwpddAnit22DBJo6uvvz1rRs,651182,5954391,-5303209,619
2022-01-21 17:47:45-05:00,5747,GufVttJatW8NLeztT1NRQSLZpQNRk45kaG41p3QcWhx7,GTJUsWoWRyeafYJVhx2aRo8NE94U5UrBjaehmJ4PRUhn,True,3154976,788744,4888,2444,2444,3uL2NSR2ZdDqCiKfzA5SwwpddAnit22DBJo6uvvz1rRs,195556,1544683,-1349127,619
2022-01-21 17:49:40-05:00,5748,BJUNK2orMVx6mYsD9pnQzmsEh95ZF2NWPm9KJ1ZM67Qn,FpxLa3DwWrspYvHVsScSDcscHB2eBHGxRrQ4gVvn4VW,True,3127371336,781842834,4864273,2432136,2432137,HfEnetJ7uBSmZWCjBNxdvv9HEC5nsW4wDV7wu6WnhWan,194570952,727860931,-533289979,622
2022-01-21 17:50:01-05:00,5749,8JtUn4uue4WzrySwnDQ74qzzWaKsoo11MbMvRh1ePDJN,8iahKConWg6fyZrkoze5eeujyNHA26AybYBpHwUr76Cu,True,247770761,61942690,383883,191941,191942,3zqXX6kzhkbW3d4TwD2CNjMRwxTbREXySekvq37kfCNk,15355341,108222580,-92867239,619
2022-01-21 17:50:32-05:00,5750,CmvNNpdGVDGujBadaMmgKc8xgFfyV6G9PNEjD8zEND6L,EzmfinKBZ8TXoSugyTqdEdHWrHdTdpHQtc1TApfaNfDR,True,9880940908,2470235227,15297195,7648597,7648598,3zqXX6kzhkbW3d4TwD2CNjMRwxTbREXySekvq37kfCNk,611887806,5733913524,-5122025718,619
2022-01-21 17:50:32-05:00,5751,EXP61AETWHw3kHSjrJH1jQBt6cXR9Zebz34Cueb3KAzg,2JT9GrgdUKjuQQtXvZqevbjFquUQBMYDoADmBjDKWXj3,True,368143574,92035893,573776,286888,286888,3zqXX6kzhkbW3d4TwD2CNjMRwxTbREXySekvq37kfCNk,22951050,134658452,-111707402,623
2022-01-21 17:50:36-05:00,5752,2SNV9Q6vzQP5XxxqSrwXpQdRvk45FPiqLXmhNZzbLt1k,6dLG3ojK5Unm1mBh9aDZfryvoT2a6cSuWA8CxXy3oi7n,True,211364598,52841148,330758,165379,165379,3zqXX6kzhkbW3d4TwD2CNjMRwxTbREXySekvq37kfCNk,13230340,118273639,-105043299,625
2022-01-21 17:50:39-05:00,5753,DDuXUcRDez68Tx651sVKxjubhTdNHkuarbeDEKFp5HRs,DNWcrd23zaT7LuXHuhPVqqAvLVpEzoqebr4sho45CphT,True,3795203,948800,5939,2969,2970,3zqXX6kzhkbW3d4TwD2CNjMRwxTbREXySekvq37kfCNk,237572,1219742,-982170,625
2022-01-21 17:51:04-05:00,5754,EDSf2w1UyGvbgMuxyoXL58ifR1dviZinnLBYnFmgjcNG,DFenkzbL9SUjs9cSCaHJ1eXK75mHfk3GSPRFs8TSzrFV,True,805115486,201278871,1255937,627968,627969,HfEnetJ7uBSmZWCjBNxdvv9HEC5nsW4wDV7wu6WnhWan,50237496,229795233,-179557737,623
2022-01-21 17:51:10-05:00,5755,C21232Uu2r4AmbR3mzrEKF5ZHoFDZbCmy88x8u6cLyZV,8sppny1HRFKX6LuqT6KDn1x9wS7z61K9V5akSuAimxgS,True,1580199685,395049921,2459561,1229780,1229781,HfEnetJ7uBSmZWCjBNxdvv9HEC5nsW4wDV7wu6WnhWan,98382448,393093449,-294711001,622
2022-01-21 17:51:11-05:00,5756,C1CsbgQFvEvSXzuVHTr39tQHr3drDhjxeYiotd8eNocF,4rAaTCAMj5VpgNVKiYizabH7cMLhEA12seu2QXQNTyV3,True,9738989,2434747,15108,7554,7554,HfEnetJ7uBSmZWCjBNxdvv9HEC5nsW4wDV7wu6WnhWan,604352,3424810,-2820458,620
2022-01-21 17:51:14-05:00,5757,6uZobpBuFcQeYgZ4dApFi6iy4DB9GLHP1AAsQcCj6212,SGGFiPjjhscwroiWMqY4jTAHFw8eakpsEv35wNoHUPY,True,43816029,10954006,68107,34053,34054,3uL2NSR2ZdDqCiKfzA5SwwpddAnit22DBJo6uvvz1rRs,2724307,11752455,-9028148,621
2022-01-21 17:51:43-05:00,5758,72woixtGAuGazCMfsYfYBYLP7FuRj8Fwz9fynFo4MCE4,5237BmWkKf58PBeTUEiu3Ld5uKXEe8wcrJRmCnUoWWku,True,78633907,19658476,122674,61337,61337,3zqXX6kzhkbW3d4TwD2CNjMRwxTbREXySekvq37kfCNk,4906971,32299378,-27392407,624
2022-01-21 17:51:54-05:00,5759,DY6k3Dkwe18iLneaT8Xo3VpJWB6V4jWwQQjoDvEzdg2j,3GGV7S9FpRQGbARBXkvGFVqLrmw8JvYAcpnR1aKVUY2f,True,1394550,348637,2182,1091,1091,3zqXX6kzhkbW3d4TwD2CNjMRwxTbREXySekvq37kfCNk,87295,1121041,-1033746,625
2022-01-21 17:52:02-05:00,5760,DkvR2xUPMyXWGGkUSmDSfhp7RtvMkfbT1ThKCS3TwrXd,F7jYV6TtT1LZ5XCNn1zkbUfNMo4gGcQUczAQy1jLHpaW,True,68553950,17138487,106476,53238,53238,3zqXX6kzhkbW3d4TwD2CNjMRwxTbREXySekvq37kfCNk,4259049,43457373,-39198324,621
2022-01-21 17:52:17-05:00,5761,5RvNKzSeJ1fvqsKpcQu25evEZGmKjyEDgwsMZkykoT3P,BRqSGfE4XHXu4HrinwetWumfVTmr82iuF6Y5oSV6eMiK,True,15914,3978,24,12,12,3zqXX6kzhkbW3d4TwD2CNjMRwxTbREXySekvq37kfCNk,993,8603,-7610,623
2022-01-21 17:52:17-05:00,5762,FpqCxvTkSiwDwD5qEt6hXJxzFDLFLAQ8VevK8zwRqYun,A3p6YQisCJKpNkF7vkjZRbEfbnUt7vTZdR2zPBUSdTkk,True,44527644,11131911,68580,34290,34290,3zqXX6kzhkbW3d4TwD2CNjMRwxTbREXySekvq37kfCNk,2743200,25042145,-22298945,616
2022-01-21 17:52:17-05:00,5763,DAku12iueL13vRoTpKLyqdGaLQ2rWF6REe8Dr8soFvNs,H2vVH3LxkhGe6x6Mdwy67BYwTKNQM6XayKx7mhrwyfJM,True,48379,12094,74,37,37,3zqXX6kzhkbW3d4TwD2CNjMRwxTbREXySekvq37kfCNk,2986,34792,-31806,617
2022-01-21 17:52:17-05:00,5764,3njiRuSRMXRzKmamyiR72Hc38PU8UDDmWdfPhgxmGxEW,5WoF3gkgygyNNbwxWgVfqGWkExcDixuzgJQQjXEZQ6J5,True,27672457,6918114,43007,21503,21504,3zqXX6kzhkbW3d4TwD2CNjMRwxTbREXySekvq37kfCNk,1720295,25779006,-24058711,621
2022-01-21 17:52:17-05:00,5765,4D7mDXe7SdmbAx7kaD1mBNuEa7DzMi6TAwXURxtLEazk,5pSnT91PHoLdN6uhPnUtoD7cboLmndn26y1XouPx8vwW,True,160891,40222,247,123,124,3zqXX6kzhkbW3d4TwD2CNjMRwxTbREXySekvq37kfCNk,9896,86536,-76640,615
2022-01-21 17:52:17-05:00,5766,7uHMFnppZKtV7nAySv8UGcoGTSQ98RVz1GP47dsFWpYr,FmS9WPYVTT8i4agyidApdLnoHAUMfdRFPnAVJQUwfWr5,True,186185397,46546349,289595,144797,144798,3zqXX6kzhkbW3d4TwD2CNjMRwxTbREXySekvq37kfCNk,11583819,58739023,-47155204,622
2022-01-21 17:52:17-05:00,5767,AA9zFZTXqBR8Mw1fwEH59edzBiswoGasRNWsi6aLeysB,4VeitxYqqtRxyfdSVpshdJ3EDcgksRVnaHvAqWxTeujH,True,184495,46123,283,141,142,3zqXX6kzhkbW3d4TwD2CNjMRwxTbREXySekvq37kfCNk,11358,84501,-73143,615
2022-01-21 17:52:17-05:00,5768,CYv2hNAzvRak1LBSayFxMJEXoAQdMEZHnNpQLZ5G5RVo,HkvTQbtKxWv2E5z6MsViv1LS4jm8T286fiY1C7n6ZZ9C,True,922064224,230516056,1442622,721311,721311,3zqXX6kzhkbW3d4TwD2CNjMRwxTbREXySekvq37kfCNk,57704903,695483119,-637778216,625
2022-01-21 17:52:17-05:00,5769,7W6ih2ZGXaE6tvuQFUPCvc7NvEJHy7UffgoVX3ZPdLXt,6uQCkeMjEXHBQxE2HD33RM1zyTsSko1fYZA1mWUggJ5B,True,2791,697,4,2,2,3zqXX6kzhkbW3d4TwD2CNjMRwxTbREXySekvq37kfCNk,171,1765,-1594,612
2022-01-21 17:52:17-05:00,5770,C2Dmfw4G8KKzFq38aRH2pLCRngnGZDvUUN3fHDMjFkoG,7kzJk3BTNvY3hGFNj7nDy9L5CAYus6eNiCAxWH8dSioX,True,40263,10065,62,31,31,3zqXX6kzhkbW3d4TwD2CNjMRwxTbREXySekvq37kfCNk,2516,33668,-31152,624
2022-01-21 17:52:17-05:00,5771,7feC64HZfQpniey2iXsMMgQXnfcunJus74DiKDeKaEUw,GstsCxAiBBEUrXNkvZZ9Sg4vNK916PsKe2Mx6e4M6dU7,True,631751,157937,983,491,492,3zqXX6kzhkbW3d4TwD2CNjMRwxTbREXySekvq37kfCNk,39348,356765,-317417,622
2022-01-21 17:52:17-05:00,5772,GH6Q9E1jZPTTp46aDd57UNZPNS2D6PBSwyLL3EHSjGn2,2XvwZXNsrPWx4EfPvhTP933bzCC3SJHDQ8xARfrXdVY9,True,2141903,535475,3287,1643,1644,3zqXX6kzhkbW3d4TwD2CNjMRwxTbREXySekvq37kfCNk,131500,2389563,-2258063,613
2022-01-21 17:52:17-05:00,5773,HkRKcvAWLM5sCDL6a5DvYsH55bg5BnZnyP9WwX7wLUDF,GXtDJS8BCoZKnvviGaUb2QfKs2LQQZPMa9564tf5Jq8Y,True,165625522,41406380,251826,125913,125913,3zqXX6kzhkbW3d4TwD2CNjMRwxTbREXySekvq37kfCNk,10073077,65233328,-55160251,608
2022-01-21 17:52:17-05:00,5774,HjkXypCkrCSprGVXBkrbHMZJji2gMToLvCLweRhcH7Vs,2ddyaPR86fCsVf4VJRG1VdZgdkY84TzXb8NMPqRyDqzV,True,78469156,19617289,119695,59847,59848,3zqXX6kzhkbW3d4TwD2CNjMRwxTbREXySekvq37kfCNk,4787816,22265704,-17477888,610
2022-01-21 17:52:18-05:00,5775,5jin5wXjQQ25nGM2ECrCXcg1a95vquh6kM7rMRru6Ke7,EKM657EQ8HWWgf4cssByoYHoXGjFfTspTKXAGmygAPQG,True,4079547,1019886,6290,3145,3145,3uL2NSR2ZdDqCiKfzA5SwwpddAnit22DBJo6uvvz1rRs,251633,2873525,-2621892,616
2022-01-21 17:52:18-05:00,5776,Ehw3RgdbzyAHHddgSv7F6f3WtYhyBtRg2ropQaWGgwcL,GGw3xDe5jKd5UNB9bPLqp2xzw2SKz7CMg358Fy7UypDL,True,1819289239,454822309,2789822,1394911,1394911,3zqXX6kzhkbW3d4TwD2CNjMRwxTbREXySekvq37kfCNk,111592912,759427946,-647835034,613
2022-01-21 17:52:18-05:00,5777,LNX7AwwiGpuaXA4J86d1xqqtF6kD7qbCusssSZqtpKd,45a5FGVssw2NoGipB7NRN4XDLPob4GHNxSM9fqgsTpqA,True,93781714,23445428,146418,73209,73209,3zqXX6kzhkbW3d4TwD2CNjMRwxTbREXySekvq37kfCNk,5856754,34289635,-28432881,624
2022-01-21 17:52:18-05:00,5778,HSZrdquqBs1gWQGSBcLGs4aa4ox27rLHh6KKmdHrgrVs,DywbuaDt997DQA1GT9GsLL8ML73CxQgHwMLw2MyG8m7M,True,1723027,430756,2619,1309,1310,3zqXX6kzhkbW3d4TwD2CNjMRwxTbREXySekvq37kfCNk,104780,486457,-381677,608
2022-01-21 17:52:18-05:00,5779,ES1MDwRUa3hoToPKQiiZkzMYe9PDVnAQwMrEvZrzvnc1,C4wBG3xTDkmDQneB28xYnf1aBNEeq7UB8oR7NuEfLkFg,True,2986398,746599,4636,2318,2318,3zqXX6kzhkbW3d4TwD2CNjMRwxTbREXySekvq37kfCNk,185471,1603698,-1418227,621
2022-01-21 17:52:18-05:00,5780,7g4NJBHwDTRm58GqX7Tz1JzqwbAhF6EWJUQH3SoDxSf7,82Ypv7STZeSCBPf3HckWdyatELpvaDaWxFXhD5dNSML4,True,2527,631,3,1,2,3zqXX6kzhkbW3d4TwD2CNjMRwxTbREXySekvq37kfCNk,154,1562,-1408,609
2022-01-21 17:52:18-05:00,5781,5nauZoaxftcYR591YH4v52myeJLnXtY4okdttL9qSdkg,7x3G299D3bC7EwUQojhTXUv29BG4NGzrLbgS4mEyqG5r,True,50172638,12543159,77618,38809,38809,3zqXX6kzhkbW3d4TwD2CNjMRwxTbREXySekvq37kfCNk,3104744,19666908,-16562164,618
2022-01-21 17:52:19-05:00,5782,6dr65yANjSMmfBeKAuSxG3i16S9vMgF1CQ3zDyzh55Pn,EhrE5QpnshD41S4zPEBy2A5q2Gs2mwUrbHGo6WnT9zDP,True,36290,9072,56,28,28,3zqXX6kzhkbW3d4TwD2CNjMRwxTbREXySekvq37kfCNk,2267,26118,-23851,624
2022-01-21 17:52:19-05:00,5783,2FrqGFZjbiNykJyo9BZ5S9FguQJPJiTi681rJJsQ5dta,3QUncYP92NKrfpaTvuF9iQg11PXKgZAgEngwh6BbnCCj,True,89608,22402,140,70,70,3zqXX6kzhkbW3d4TwD2CNjMRwxTbREXySekvq37kfCNk,5604,55175,-49571,625
2022-01-21 17:52:19-05:00,5784,H6fVnghBUSJRKp2mxSG7Fq2Lr4dE3YMS7yM1XTrxoe3Z,JjgtLi79grUZXofhWukB1yNXZkXFMUX5jm9HcXNDsB6,True,3289841,822460,5107,2553,2554,3zqXX6kzhkbW3d4TwD2CNjMRwxTbREXySekvq37kfCNk,204309,1660087,-1455778,621
2022-01-21 17:52:19-05:00,5785,GWkVXmZNQdcdWNNu8dvRqct4aMhLoDNqijrTvxbfEdKN,6LKRNbJv2XkyjJQKCFAqFRPzvANrRBSTmu8doRWqTicU,True,11771512,2942878,17945,8972,8973,3zqXX6kzhkbW3d4TwD2CNjMRwxTbREXySekvq37kfCNk,717824,4304115,-3586291,609
2022-01-21 17:52:19-05:00,5786,3onLoSaH9BskwjFu4nbEFykBsDaFgKgWVHPqdSUjHraw,D3YAuBorbpirBJmvhxQvFJbQPRycWyyymjsvm8GDetv3,True,85910072,21477518,131003,65501,65502,3zqXX6kzhkbW3d4TwD2CNjMRwxTbREXySekvq37kfCNk,5240124,70490727,-65250603,609
2022-01-21 17:52:19-05:00,5787,DdEiAJ4pcXU213GVEa5KeDonBXZhTV7zeNcKigEQwN8Y,FoAs2bsVjQFKaJW7dpVKMxoJf7Qe5PcuH6i9jJzAR5e1,True,74277203,18569300,113752,56876,56876,3zqXX6kzhkbW3d4TwD2CNjMRwxTbREXySekvq37kfCNk,4550097,18745895,-14195798,612
2022-01-21 17:52:19-05:00,5788,8NdcaYUC1X5CP7FMDip78uqtqmCt8GcZdCzLRTYTihmb,9Ei1K9bXWXSXcBfeX5exPSXGCAu62WSKzvnnd4wHvyVh,True,14255,3563,22,11,11,3zqXX6kzhkbW3d4TwD2CNjMRwxTbREXySekvq37kfCNk,892,9189,-8297,625
2022-01-21 17:52:24-05:00,5789,BAczoNDnbwj5AJX5LwzynzYab7ji7VbhRy9edA9Prax,34sbkUKnMetUNyMs6BhiWut85d5UZtBWnPtwx8jEpJNA,True,140986,35246,220,110,110,3zqXX6kzhkbW3d4TwD2CNjMRwxTbREXySekvq37kfCNk,8824,93074,-84250,625
2022-01-21 17:52:26-05:00,5790,GGGyesjbt7h2XHHp9u8vpiWGugFwEbrtYaKrNQSDhQd7,8tydo1ZjGHmPBSqU33tywB3f9szdsHk1ckGFe4Ay5pgs,True,5475256,1368814,8567,4283,4284,3zqXX6kzhkbW3d4TwD2CNjMRwxTbREXySekvq37kfCNk,342714,5518106,-5175392,625
2022-01-21 17:52:30-05:00,5791,D2L7ST8iGsRfZ4zj2pdfKTptbojQ4cDtHKQ8ngcFVQwA,7cNrHGWJ6FGGazfGaCePs8XyaK6bwVLrYFCUJQi9w2Wc,True,7338,1834,11,5,6,HfEnetJ7uBSmZWCjBNxdvv9HEC5nsW4wDV7wu6WnhWan,459,4512,-4053,625
2022-01-21 17:52:48-05:00,5792,4hZG7dM716SxDagiFGwt1gSC99B2QK1emGLV9TJmmuR8,7vjfUWySkyx4Z5qAaRr2VWnVvxHHNsvPj1PirGNSjM6,True,21191212634,5297803158,33021006,16510503,16510503,3zqXX6kzhkbW3d4TwD2CNjMRwxTbREXySekvq37kfCNk,1320840241,8282727049,-6961886808,623
2022-01-21 17:53:17-05:00,5793,7CSCMFa9W52tBDVUbXbc3woAy3GByeA1wPJdp3MgznPa,3447ptuVFu6G8B6N63RmS8mRv4n9PfHneypHLvbeaGLn,True,11943385,2985845,18268,9134,9134,3zqXX6kzhkbW3d4TwD2CNjMRwxTbREXySekvq37kfCNk,730749,8090917,-7360168,611
2022-01-21 17:53:17-05:00,5794,AM5fwZR9BUW8AFkhdGWXW4PHd2cy8ora63kDf2z2eknw,E7ru6hg4MchnRG5zcr5YazwX8Snt55r5Xq9zCHCGaYZT,True,103182,25795,150,75,75,3zqXX6kzhkbW3d4TwD2CNjMRwxTbREXySekvq37kfCNk,6019,71765,-65746,583
2022-01-21 17:53:19-05:00,5795,9zpPiboHF5HW7NfCx7hYdmJGwUomVMTiUFc4Um5KrDi3,8q3eBpuwV6dMNkib9N8XQAq2tBUcjSANRe5SXpd4dFhZ,True,886995,221748,1332,666,666,3zqXX6kzhkbW3d4TwD2CNjMRwxTbREXySekvq37kfCNk,53286,472709,-419423,600
2022-01-21 17:53:19-05:00,5796,DdAPWdHnb7ocaYtcwwwYnppsH39sZpmzMyANeoJbCV7s,3BVmC39L8dEypPN1BZhsf9bx9Ge2sXCZR8Y6RH4eBNMJ,True,114383889,28595972,178618,89309,89309,3zqXX6kzhkbW3d4TwD2CNjMRwxTbREXySekvq37kfCNk,7144759,111571496,-104426737,624
2022-01-21 17:53:19-05:00,5797,5PVUmELKMD7mf2vbXbiXXsiZW2myGmZuMe757raBAj8Y,5eikdsebvyBh27aPz9t9KPswYWd8X4Cbk2TSiif6vn36,True,1018191066,254547766,1515100,757550,757550,3zqXX6kzhkbW3d4TwD2CNjMRwxTbREXySekvq37kfCNk,60604013,770238419,-709634406,595
2022-01-21 17:53:19-05:00,5798,2hirR46fpyHEg1Fv9vAzYgnoNRBWaky7LoFGVof4DnpK,DXTEHauVDdz4Mjjj6sJHPUh6TnzU6ob6Nj63To2vCNPW,True,244840912,61210228,381200,190600,190600,3zqXX6kzhkbW3d4TwD2CNjMRwxTbREXySekvq37kfCNk,15248007,71840695,-56592688,622
2022-01-21 17:53:19-05:00,5799,AATMHH4e4B6SL9bThnXGktzWuqWkPdx3JbRXk8HwkbPW,6F3u2yLx7P9gtpAAXASx7uF8xNyVBgJiKosMKUrgpicA,True,27038704,6759676,40604,20302,20302,3zqXX6kzhkbW3d4TwD2CNjMRwxTbREXySekvq37kfCNk,1624188,16922360,-15298172,600
2022-01-21 17:53:19-05:00,5800,HqYn1PU7foJ9daTJMbd19LjTqWR2vQ1XqMEmffM2kCFA,8o6U7rDTtzSvywjzENEZSDYxCf7XK85rueCYVM4vZjY1,True,59059608,14764902,87452,43726,43726,3zqXX6kzhkbW3d4TwD2CNjMRwxTbREXySekvq37kfCNk,3498118,46330716,-42832598,592
2022-01-21 17:53:19-05:00,5801,6u6bPgAmK8ufACrQV99A1Y5nhGkue3KEUHmQQkcNkxwP,7636yXT5w4DcVpc7LJdN46aiggzSq6U2GXHXL5kyy9F3,True,12806308,3201577,18718,9359,9359,3zqXX6kzhkbW3d4TwD2CNjMRwxTbREXySekvq37kfCNk,748758,9053602,-8304844,584
2022-01-21 17:53:19-05:00,5802,F2v1YwVAwXLiUgsJ5uwn4qAAkTXitn1E75fJcPnGuAcy,5rdJ4H5GxPg4Juu77mGc7uya5LwEqLzDSRyG8mQ2mDbK,True,2082503,520625,3053,1526,1527,3zqXX6kzhkbW3d4TwD2CNjMRwxTbREXySekvq37kfCNk,122140,1469162,-1347022,586
2022-01-21 17:53:19-05:00,5803,6xikA6d7sjCBnSfqkFwrL4nPrtQUNWdRhXB7i1AccnxC,G8t7u2R9qjRfdTdULs74v3nVrTM2WeKvc4dK4FFAvuG1,True,4044166,1011041,5897,2948,2949,3zqXX6kzhkbW3d4TwD2CNjMRwxTbREXySekvq37kfCNk,235891,1631873,-1395982,583
2022-01-21 17:53:19-05:00,5804,9UyQC8vc6zJJaSdnjvTAzgmcsw4fC3xFBBiCC1w9Sbjx,3ppBfboe6FPmt7f6WrivspMUoAznZKWQMeh3rCgw7vjQ,True,968234,242058,1462,731,731,3zqXX6kzhkbW3d4TwD2CNjMRwxTbREXySekvq37kfCNk,58493,515557,-457064,604
2022-01-21 17:53:19-05:00,5805,FuoFPNTdYVDkSHaBac6UC1aNJXafSNTvFJuBCdrgQQrH,ApBS1Fx83tcECMzDV6wEzEzEdg4e2hgj3djtjRUoSKK5,True,336347884,84086970,520707,260353,260354,3zqXX6kzhkbW3d4TwD2CNjMRwxTbREXySekvq37kfCNk,20828296,171674216,-150845920,619
2022-01-21 17:53:19-05:00,5806,6tFQaTqqffino9kwMZTL2xVNBG8k9VREFhXqVi2si3A3,3w3wGxBbS4bmXeqmvd595SAWFeXekVpnH4UdbeEs8Sx5,True,473354,118338,702,351,351,3zqXX6kzhkbW3d4TwD2CNjMRwxTbREXySekvq37kfCNk,28092,267284,-239192,593
2022-01-21 17:53:19-05:00,5807,F1JT1p2VuwK4L7zj7NNnZtYiZiNUCcTGKDkgdoX3BZdZ,3BKe4yzTwnnBnvTWP3britpPJ4oAWL7JZJzNLCxjUufS,False,762,762,38,1,37,3zqXX6kzhkbW3d4TwD2CNjMRwxTbREXySekvq37kfCNk,38,319,-281,498
2022-01-21 17:53:20-05:00,5808,WMUVFELv3C3KdMKJ5ZL4rG7o1YrV1qTP6Mmp2S5Rp8S,7UNzS3zDqT1oeq9a7eJGU8cgf8eUzEAZubSBQvNmK6uJ,True,1960127,490031,2933,1466,1467,3zqXX6kzhkbW3d4TwD2CNjMRwxTbREXySekvq37kfCNk,117321,738411,-621090,598
2022-01-21 17:53:20-05:00,5809,AHm7zF4rpaxaayBLn5QDHgJSp8KAr647s4cNvQ9wLgd7,FDM33WngED24pukBvSDpPAzinW6afVAeGReum5nyLRiC,True,89436,22359,131,65,66,3zqXX6kzhkbW3d4TwD2CNjMRwxTbREXySekvq37kfCNk,5244,64846,-59602,586
2022-01-21 17:53:20-05:00,5810,J4krKPBBTMVLZRgrSeYJAMyHQs2FkNm5TXk7nQWwDB43,ASmLbfNbhTD2HHeV7qzAqiHjUx5a8Traj8oPDwbkMdFg,True,3072558,768139,4724,2362,2362,3zqXX6kzhkbW3d4TwD2CNjMRwxTbREXySekvq37kfCNk,188983,1761460,-1572477,615
2022-01-21 17:53:20-05:00,5811,H1LftKtj94Zs6PG2A7gJt9rPurBkXkTy2hbbArQwAehi,8bANmhgdnPYa3PqdPnk5BA2xhvqJmPyaMF77mrBePJ13,True,4140,1035,6,3,3,3zqXX6kzhkbW3d4TwD2CNjMRwxTbREXySekvq37kfCNk,256,4390,-4134,618
2022-01-21 17:53:20-05:00,5812,3EmGvYu72cR4Ta3wLA5HKZBEqgfChCyiRanwj5hGLJXc,6NEWPFaKi5uLsrj4n6RM1DBhQTcGFE9TwYeJ12pC7yyp,True,4310,1077,6,3,3,3zqXX6kzhkbW3d4TwD2CNjMRwxTbREXySekvq37kfCNk,269,2667,-2398,624
2022-01-21 17:53:20-05:00,5813,CRaKcudjkQiSw5YPVjTLVdXvJskeGiHSYtq5ZcMPJhgQ,AgqTg3b3bAcaBmRidhNC4Uf9ZwNbeH52RQEqumWyuUs7,True,94124,23531,145,72,73,3zqXX6kzhkbW3d4TwD2CNjMRwxTbREXySekvq37kfCNk,5838,78935,-73097,620
2022-01-21 17:53:20-05:00,5814,FS5xx53Bo65G21gJLta7LEEiS132VJM1kGpUzuqyfzoy,2kbTLjdBBA9K1coxKmwmYbjq2heSnuNg4Nh2EfVNYgwj,True,45666681,11416669,69591,34795,34796,3zqXX6kzhkbW3d4TwD2CNjMRwxTbREXySekvq37kfCNk,2783668,16355603,-13571935,609
2022-01-21 17:53:20-05:00,5815,brCL9pzP6q4b6rKgAH1AJbMoqffBWyXLX8oAnZDoi77,Dx4G5UP9jTb47JQypWJnv48mPTzhJvqPD1BtBtDT7TJF,True,878015,219503,1364,682,682,3zqXX6kzhkbW3d4TwD2CNjMRwxTbREXySekvq37kfCNk,54586,283995,-229409,621
2022-01-21 17:53:20-05:00,5816,67Z7ZGhNu5xxEh9BYKWcXp9m1T4tFiE1o1M16hCzUWQA,CT7YKWixz7BhTbvg5F6M5HCyPGnHoFLNFuDV9GhoLTo3,True,353037,88259,548,274,274,3zqXX6kzhkbW3d4TwD2CNjMRwxTbREXySekvq37kfCNk,21926,284253,-262327,621
2022-01-21 17:53:20-05:00,5817,84SgzR8J6DeqPJ1uXphP1BHMotYGKh3kS4owMMj9x58x,CL7Jkwe3NK4qaAVK2QjuftXnQ5YLqDT9qYeeEi7kJXrV,True,40909020692,10227255173,60156596,30078298,30078298,3zqXX6kzhkbW3d4TwD2CNjMRwxTbREXySekvq37kfCNk,2406263852,30094114486,-27687850634,588
2022-01-21 17:53:20-05:00,5818,6Y1UoGwrKyKsScZQm9ng1rNrXXykKT82V7kUopc43kAy,8YtWQTTKymCESbPMWCP9TMehbMU25zJMtxt9grqrpbD4,True,4118002,1029500,6130,3065,3065,3zqXX6kzhkbW3d4TwD2CNjMRwxTbREXySekvq37kfCNk,245237,4669348,-4424111,595
2022-01-21 17:53:20-05:00,5819,EFHg5FatMRRSZnKJPJF9e1iw2cjPJRmwTTZYtkHno9DP,84LnLKhZDJgWFnbBYnYjqWkjymemXfidecPFwnUAvuFj,True,232529654,58132413,340311,170155,170156,3zqXX6kzhkbW3d4TwD2CNjMRwxTbREXySekvq37kfCNk,13612465,125404411,-111791946,585
2022-01-21 17:53:20-05:00,5820,Frobc1KZTVcsyfwyKwSpHJobxmiJBomzHhGCLdrzdAz8,HziyKP9uxWCuXddtbRzWMczHNdgyQB5UXQZj4MnMm14,True,38949128,9737282,59186,29593,29593,3zqXX6kzhkbW3d4TwD2CNjMRwxTbREXySekvq37kfCNk,2367445,14367646,-12000201,607
2022-01-21 17:53:20-05:00,5821,6CeKxTJvFqhyNEyzySiBBKEwYVMe7j3A6nkMes4BW6o2,DzDR9XvwY1z7ygQ8YrCXrwDGHSf67JZF8BzUnuFE2fxQ,True,472170,118042,680,340,340,3zqXX6kzhkbW3d4TwD2CNjMRwxTbREXySekvq37kfCNk,27226,267599,-240373,576
2022-01-21 17:53:20-05:00,5822,5SskSWkRPP5BNaqvHkJCbTAgHPUkHEwFh5pFr4t8PoBr,EqdX8Sdm9LCfdrzVKzisKaFcP2YEdSRNZYmev5RWjGqb,True,422750,105687,619,309,310,3zqXX6kzhkbW3d4TwD2CNjMRwxTbREXySekvq37kfCNk,24774,169277,-144503,586
2022-01-21 17:53:20-05:00,5823,ApAgbKGyEYXRonGM33w56ZxHQNAGSd9ji4K3zAGN2yA8,FZAhAUDtEaNsFmh4fP8uXNjoHneNkpZ2wQCfEeU4RYRM,True,10970749,2742687,16934,8467,8467,3zqXX6kzhkbW3d4TwD2CNjMRwxTbREXySekvq37kfCNk,677378,6256997,-5579619,617
2022-01-21 17:53:20-05:00,5824,CvZssqscu2dm35mwcE3zg9zedavbRjVJjWD59Py5ExUK,7pXaoR6aHKYofCmg1eHipygNYDteEaf8rbbS8BDYGQK6,True,75984,18996,115,57,58,3zqXX6kzhkbW3d4TwD2CNjMRwxTbREXySekvq37kfCNk,4628,42930,-38302,609
2022-01-21 17:53:20-05:00,5825,6yw4GPvkqUbakcEWtqSCfjVLukty11xqjDpGxtEN9Km2,5ppEx7wkpqbG5nApCWMdRja3oRSheFmAAsNHUX7h2w2Y,True,178217,44554,260,130,130,3zqXX6kzhkbW3d4TwD2CNjMRwxTbREXySekvq37kfCNk,10433,205918,-195485,585
2022-01-21 17:53:20-05:00,5826,6nJyqvFKprwaVCE1gAa2P4RHKc6Pa6XFSJymx654zZ9K,4e7iJmdwzAPxp1Zi8Azo38YyPQdPKqqY4VLJyQ5rpdYP,True,270610,67652,416,208,208,3zqXX6kzhkbW3d4TwD2CNjMRwxTbREXySekvq37kfCNk,16646,197656,-181010,615
2022-01-21 17:53:20-05:00,5827,51yPLtXTgL9oLKs1cCf5TjL54Ld5vuVxat2NNtwZVsZG,7UjtM7Z1tiXEQMMiorQyncgi9SKu3v46DhVdgXbWqSiF,True,38513894,9628473,58892,29446,29446,3zqXX6kzhkbW3d4TwD2CNjMRwxTbREXySekvq37kfCNk,2355715,43167197,-40811482,611
2022-01-21 17:53:20-05:00,5828,Ayx8dFsVzUBb9b7QKxw7YHJuhptdSitBXFEczXTaxe85,EvU1VLChnowi6ccSPeJRSk65njrqZfYouAN7SHePxsxf,True,2525,631,3,1,2,3zqXX6kzhkbW3d4TwD2CNjMRwxTbREXySekvq37kfCNk,148,1836,-1688,586
2022-01-21 17:53:22-05:00,5829,8VnGmfop6qcUezAJ2M15jz2Nn6mPQgehDcJPvypq4XJn,6F6sqXNhgkW9ev8QNMm4ydywUUmemhwgydRQYNeqyUmi,True,1142425,285606,1651,825,826,3zqXX6kzhkbW3d4TwD2CNjMRwxTbREXySekvq37kfCNk,66077,1299388,-1233311,578
2022-01-21 17:53:22-05:00,5830,Fd2HrzBAr4JobRPARZwpQHHVoSCEoog32A6tKMWAC1sK,BYappsar5sQf8VLem4wrLuTtrDFH9y8pEx1aMxfuU4Pq,True,3249312,812328,4739,2369,2370,3zqXX6kzhkbW3d4TwD2CNjMRwxTbREXySekvq37kfCNk,189592,2294611,-2105019,583
2022-01-21 17:53:23-05:00,5831,9vcKW1GfrDZ3KLPh2pEVFF8ZyKqD1pJW1hiE8H98Av7S,C6Ki27mo4sCHu6u8UnR1p7WSgsTjFQxGGR9Lk9n5Rhjq,True,301775,75443,466,233,233,3zqXX6kzhkbW3d4TwD2CNjMRwxTbREXySekvq37kfCNk,18665,210482,-191817,618
2022-01-21 17:53:23-05:00,5832,BjyZWwz1ARSfmPkHXHBzehq5NsH4DRJiu4zFMkqsKu6A,7WUCSZ9SnKDsbomDRZ7CKsHfHJFwboKJwFFdaGkBURBS,True,527038794,131759698,777335,388667,388668,72FwbpFGoLEazJEdpqNtPNefsadUrimUqma9wSoy4qiS,31093434,304054640,-272961206,589
2022-01-21 17:53:24-05:00,5833,8hpAXzimCw2bTwLXoRFAbqNW8qoj5VV3JDYCuJwqHpHm,DkfsL2M7oRBX6grAfy15C4urwL6ToMJ7TWJEFAGhWjYX,True,998037,249509,1446,723,723,72FwbpFGoLEazJEdpqNtPNefsadUrimUqma9wSoy4qiS,57857,393330,-335473,579
2022-01-21 17:53:31-05:00,5834,DdYgcyV1T2CDYiQVr4VL9Ym8RdKm93a7SKy8HxuyaoMW,GPdAeqeXb1UJ56AttcwwY1CyFhRyfptDC4BAX2Tc8MpE,True,57099,14274,87,43,44,72FwbpFGoLEazJEdpqNtPNefsadUrimUqma9wSoy4qiS,3514,41440,-37926,615
2022-01-21 17:53:31-05:00,5835,3Lv2XpiD4KBUHq7Zx6u3zNhpXoySodXHH8o8f5yaaPxG,H6TN4rhpBXkEH3mZnymYNcKfmnxRH2uzfwzeLH2q6ahP,True,20149,5037,29,14,15,3zqXX6kzhkbW3d4TwD2CNjMRwxTbREXySekvq37kfCNk,1167,12941,-11774,579
2022-01-21 17:53:35-05:00,5836,C9beggursF9WdLyzunVSoz2Bw6kAxoQpUifPHbo4ybvw,3R7KdKBK7FoudsNXUeRuC2AGVFusMhmTYXSGdnA88pJT,True,3991313762,997828440,6195456,3097728,3097728,3zqXX6kzhkbW3d4TwD2CNjMRwxTbREXySekvq37kfCNk,247818240,1446543202,-1198724962,620
2022-01-21 17:53:36-05:00,5837,E8ifvhmyJGBGVQomo3AnZw2UcaLHcpGsTtuoCid8voU3,FMQUWTbTAfSLfrc6GTrz4DM2ZSgoxF3KtqGn8AyjVtsf,True,768185,192046,1142,571,571,3zqXX6kzhkbW3d4TwD2CNjMRwxTbREXySekvq37kfCNk,45694,429157,-383463,594
2022-01-21 17:53:36-05:00,5838,pgzvXpnUYiY7hLrfjmwScqLd8oj9vYcXpFvpm4y4JvG,GdqdQgoyBAFuXdbvoZyDhB3jyqJzVo4nkGh7EPFxkBF2,True,228870,57217,347,173,174,3zqXX6kzhkbW3d4TwD2CNjMRwxTbREXySekvq37kfCNk,13883,265583,-251700,606
2022-01-21 17:53:36-05:00,5839,DGAQzgZhS2yioeZmG3cbacM3hdz4F1aZn1PWRwgiFukc,48KUtJaNCPNxkLXJBtWAdDxY4b9vZzLgbGxTNdwMqmjz,True,56764322,14191080,87985,43992,43993,3zqXX6kzhkbW3d4TwD2CNjMRwxTbREXySekvq37kfCNk,3519424,38233286,-34713862,620
2022-01-21 17:53:36-05:00,5840,4cKgCTttVp8pzJnp43PP7uLLUXNcU7YGPJ3cCGHaUFe7,BBQqjwTpVEgpDzMk4wDDH8rCjaSxCRPWVhtFxERSujTD,True,4393662,1098415,6785,3392,3393,3zqXX6kzhkbW3d4TwD2CNjMRwxTbREXySekvq37kfCNk,271433,2784879,-2513446,617
2022-01-21 17:53:36-05:00,5841,2F45BX9mRmtNCHPejKFknN5aNgGvR4vVLFjMaY1a7dR8,ALdSutsvEFRUEQGGBbi31QywTL1pdXSDWrNJzvNTaoXL,True,2706398,676599,4019,2009,2010,3zqXX6kzhkbW3d4TwD2CNjMRwxTbREXySekvq37kfCNk,160767,1853346,-1692579,594
2022-01-21 17:53:36-05:00,5842,2QStaRnbSnDhA891Lb1bxjVeMYpJUpNdqaVkw3rqU45V,DakRWPnttPoRcjY5V7WLwiwBx39BapCo9Atog8dL17Ku,True,244263,61065,353,176,177,3zqXX6kzhkbW3d4TwD2CNjMRwxTbREXySekvq37kfCNk,14157,126258,-112101,579
2022-01-21 17:53:36-05:00,5843,Ckqos6cdncPKj13DnCmDVZsZTqp6eS7277CRrT9WhcEr,AtUV8m7VQJvZq7GLCAHMf3jV7iamKEPnWVZHWuuVZQp1,True,134858,33714,209,104,105,3zqXX6kzhkbW3d4TwD2CNjMRwxTbREXySekvq37kfCNk,8370,113214,-104844,620
2022-01-21 17:53:36-05:00,5844,EmGW2aAG69ssWqCtbfDocRaM2u3TJsczn2HHP9jdmRvD,aypkDKsp9uqAB4F6mwvm5LofpsrFBuZT2MMWtE2eHdB,True,69672,17418,102,51,51,3zqXX6kzhkbW3d4TwD2CNjMRwxTbREXySekvq37kfCNk,4112,47188,-43076,590
2022-01-21 17:53:47-05:00,5845,M69XSefqeum2arinvHEqmA3L2XHWNFN17p4msRhRZXf,2vK15yYUANLSbAoiBfgJ9VLyqsmtEpd2iNytQjms8GaQ,True,29432045,7358011,46053,23026,23027,3zqXX6kzhkbW3d4TwD2CNjMRwxTbREXySekvq37kfCNk,1842131,25707207,-23865076,625
2022-01-21 17:54:06-05:00,5846,D7XummfEc3NTK4qMvZegV3FrYuqc8mNgnQu3ujwemZtg,HHiRcecqzW7sGFTio7Ph6TYv3dGt64KWv4DEKgKm84fQ,True,628884,157221,973,486,487,3zqXX6kzhkbW3d4TwD2CNjMRwxTbREXySekvq37kfCNk,38938,461503,-422565,619
2022-01-21 17:54:33-05:00,5847,GCNi25P1Ywvfx5JpyxFVV68sRkio7LEhFgY85ZqveKR3,34mxz8fCss7KNAbEi2Wj9z5dTgXCGxuq2vyqzBPChtmq,True,1610646425,402661606,2490275,1245137,1245138,3zqXX6kzhkbW3d4TwD2CNjMRwxTbREXySekvq37kfCNk,99611026,895972144,-796361118,618
2022-01-21 17:54:36-05:00,5848,GBpe8E33cNkFmMUuP3WjhDBBuQz7MHaDkpCJjGFaFkvu,3QYFKkgzZ1PKKAxCh4hMhgqrupoCcfRVkjuJZRWVZo3H,True,62696347,15674086,97252,48626,48626,3zqXX6kzhkbW3d4TwD2CNjMRwxTbREXySekvq37kfCNk,3890108,23591723,-19701615,620
2022-01-21 17:55:08-05:00,5849,FKQVm9RsteDe7dQmwx4NGYhz3Wrvwh7TCp9rFbTgAomx,Dbwox8eRCdmH5KXyi5sBaqWzhxtaVPo1teWXJ2kRFT1f,True,74803439,18700859,115338,57669,57669,3zqXX6kzhkbW3d4TwD2CNjMRwxTbREXySekvq37kfCNk,4613536,78254294,-73640758,616
2022-01-21 17:55:08-05:00,5850,2FEbsetZMkRqLjSC8GBbgecKgX5T1T1fci2sLQux29p8,H722Fcd6DkTFRZxqQWbPDufBfXEgmFfhiEpQZWhxwYv1,True,523754,130938,810,405,405,3zqXX6kzhkbW3d4TwD2CNjMRwxTbREXySekvq37kfCNk,32435,310360,-277925,619
2022-01-21 17:55:08-05:00,5851,o2aCmkxsxSiyUX8soTEjwUCbJeXmCZsEaf8CWwxDT5n,3pvS2bTsUuiQyqZp5rdnTpq4cqWGgtv4E5rN9HsBxpRt,True,2591,647,3,1,2,3zqXX6kzhkbW3d4TwD2CNjMRwxTbREXySekvq37kfCNk,158,1237,-1079,609
2022-01-21 17:55:08-05:00,5852,BLJgLzizx2yLgd12pVBAHTMqn9J5JA3JHCF8PnLnPyUk,HhDmwMysBFWhXnd3mrV31w75WBRKBS8wJSiEMZgqdUSp,True,110807413,27701853,171335,85667,85668,3zqXX6kzhkbW3d4TwD2CNjMRwxTbREXySekvq37kfCNk,6853409,74013439,-67160030,618
2022-01-21 17:55:08-05:00,5853,GqAS41YJssg9aaEp3hs3sG98APCsXhiQBQszXaSjZ2bN,2wodJ3AhrXdE1T4oVL95KvoBND7PubG5Wd5GWiLCMZJU,True,20591664,5147916,31702,15851,15851,3zqXX6kzhkbW3d4TwD2CNjMRwxTbREXySekvq37kfCNk,1268084,22233151,-20965067,615
2022-01-21 17:55:08-05:00,5854,EL9JxeMvWWLTdVC5QrZzSSgApEwv1nDhZc6yNmH9G8ad,EqSQLSFx1eKkTYAdv5XhekttqVh7TappXAHuv9EedCXq,True,11354,2838,17,8,9,3zqXX6kzhkbW3d4TwD2CNjMRwxTbREXySekvq37kfCNk,703,7137,-6434,619
2022-01-21 17:55:08-05:00,5855,HVZkXeDR3mc8oB9qFFwCK4RXpPojdcHk9tRGep6xtKGK,Bh3py7awPejWqeTMxtAgF7mPotL2Asxf8YrYJykq9nBt,True,714755,178688,1093,546,547,3zqXX6kzhkbW3d4TwD2CNjMRwxTbREXySekvq37kfCNk,43721,456598,-412877,611
2022-01-21 17:55:08-05:00,5856,E1CShgy7M9998q9jyzpnHZxHJR6z5hvnshUJt37kVPtG,96f1nYW4S9APCJS3TXTGSb9UcJDdxJuoBR3pLYqcNz2b,True,19161109,4790277,29585,14792,14793,3zqXX6kzhkbW3d4TwD2CNjMRwxTbREXySekvq37kfCNk,1183413,12053356,-10869943,617
2022-01-21 17:55:08-05:00,5857,FLQcLhAsRBKnLcSYkK94Za6NhGudrCGhGGxFTdDhVC6L,7vr92sRGp6DopaDv3wJr7gw4BFmxY74K8kFheKyxZdLX,True,41535,10383,63,31,32,3zqXX6kzhkbW3d4TwD2CNjMRwxTbREXySekvq37kfCNk,2548,20695,-18147,613
2022-01-21 17:55:09-05:00,5858,6rb3fRVWJ5cSzFcmuC1YwdrNxiNctvboDF7HwsfyGoCA,H6JaYfFZkRk6iSJrA4nVeuFpMVQtVwQZHVgK1TyaupTE,True,4707,1176,7,3,4,3zqXX6kzhkbW3d4TwD2CNjMRwxTbREXySekvq37kfCNk,293,4898,-4605,622
2022-01-21 17:55:09-05:00,5859,CEtpqFD4BbeiNfaXyLLYEapY2mWgE26H5q6H34tWwRuD,BVqRyqwGFPzSkk1H2finiyfaL3LScbEiQGk3mihirxqs,True,20775519,5193879,32318,16159,16159,3zqXX6kzhkbW3d4TwD2CNjMRwxTbREXySekvq37kfCNk,1292757,13132537,-11839780,622
2022-01-21 17:55:09-05:00,5860,CagSUfZLwXuCdypC4KzU6FSNdmCj9dKDroPcNeaRtsyt,yxw5d1ztZuEUY2QjL7eLpr72QJAj5rJd6ERvg91cy1m,True,175350,43837,269,134,135,3zqXX6kzhkbW3d4TwD2CNjMRwxTbREXySekvq37kfCNk,10780,102569,-91789,614
2022-01-21 17:55:09-05:00,5861,BPsM1um9ZJf7eNoVMsQCRSwgARMuLCGGSDxf9tZeNeEy,BpzDdXfxVygiSYSmsHV6uPxQMeTFtrURMCCqhswQjd5X,True,130715,32678,201,100,101,3zqXX6kzhkbW3d4TwD2CNjMRwxTbREXySekvq37kfCNk,8066,77787,-69721,617
2022-01-21 17:55:09-05:00,5862,FF8rqfM9PTEjYiVFy8jS81weDRwdaYooux2uSa2LexrJ,JBk1JghH1gged1YpDbkczFXP9ka5ivYSkaYoVbbXD4kg,True,20338906,5084726,31574,15787,15787,3zqXX6kzhkbW3d4TwD2CNjMRwxTbREXySekvq37kfCNk,1262966,14291842,-13028876,620
2022-01-21 17:55:10-05:00,5863,9Hz4p7gcfDbXBJp8KzhaBBPh9i7xe9kun7zLfDtqPe6c,2bJ43Lep6kp6WY7Ct56oiscKnAbdtC265G5yRvRPFThU,True,102974142,25743535,158950,79475,79475,3zqXX6kzhkbW3d4TwD2CNjMRwxTbREXySekvq37kfCNk,6358002,37603547,-31245545,617
2022-01-21 17:55:10-05:00,5864,BZwH7dXogZ1qX5RWqAyiMi8f99fGmebwM56C3QkWRqDd,3avt3UeuxPZj65bCYKotbqAyr5L2ycfkbQp9Z75xqAkN,True,8143,2035,12,6,6,3zqXX6kzhkbW3d4TwD2CNjMRwxTbREXySekvq37kfCNk,507,5148,-4641,622
2022-01-21 17:55:11-05:00,5865,FV9CBGGTbppLnBKh79f2LzD1diTiS5g6u89FcpZHZmnK,Fe7mtmCUziFqbbYTvrhAcAq1Ub7YLfTJRtQ1hG7GzJD1,True,589922,147480,914,457,457,3zqXX6kzhkbW3d4TwD2CNjMRwxTbREXySekvq37kfCNk,36572,348957,-312385,619
2022-01-21 17:55:12-05:00,5866,DMgD2KCEhTGFLUZ5GnfNcwfiiwKYbyVpoWiN6knMkCAf,5KU2vgBkPTNVHsSULjgX7ZkZS56U3Dy3xqLTxL5sUZJ3,True,154631879,38657969,240693,120346,120347,3zqXX6kzhkbW3d4TwD2CNjMRwxTbREXySekvq37kfCNk,9627730,129931655,-120303925,622
2022-01-21 17:55:12-05:00,5867,U3vvMQ4X4aKzVYfhMw1V1p58HRqaLnuXozqmmefYeD9,7JA94MArkNCFRhBq8f5a32DgMF6aPdFsoC5HvXDQ6NuR,True,34047996,8511999,52590,26295,26295,3zqXX6kzhkbW3d4TwD2CNjMRwxTbREXySekvq37kfCNk,2103627,25352294,-23248667,617
2022-01-21 17:55:12-05:00,5868,8nXbrdjjaHB73CRPRenGEQj73wbtEFGDwXsehRGMhsap,43pvdcJ6f27wz94D6ZboKwRJYbyvYCrjsJhYsvk7LJCM,True,6991240,1747810,10904,5452,5452,3zqXX6kzhkbW3d4TwD2CNjMRwxTbREXySekvq37kfCNk,436199,2470387,-2034188,623
2022-01-21 17:55:12-05:00,5869,BXMMFy2k9b2hVBEG6RyXAq3qqXxJ7EY2xhyPZqtLvBiU,KpoZwr4ZFTHJgebbf4tcjT9iKvpC1EF8Aw4uaVPxXNd,True,7023649,1755912,10665,5332,5333,3zqXX6kzhkbW3d4TwD2CNjMRwxTbREXySekvq37kfCNk,426626,1834855,-1408229,607
2022-01-21 17:55:12-05:00,5870,2s9VGesQYbKr3LwuraMEa9sXbXz7f8299HPPAHgSaUdp,8uMS2GDsbmygjbRnc2gjwNkXKogmJX1i8nchmqt8ixCe,True,4854631127,1213657781,7465749,3732874,3732875,3zqXX6kzhkbW3d4TwD2CNjMRwxTbREXySekvq37kfCNk,298629965,3125982012,-2827352047,615
2022-01-21 17:55:12-05:00,5871,HGJoZvLakWfSDFwuvShNBc4kCf7nP7VqzyM3mELpbFEf,12Qn5jin7QvsBngXqYAv4UstyG3b6nRf1jsLp9Dp8G7k,True,1758018,439504,2717,1358,1359,3zqXX6kzhkbW3d4TwD2CNjMRwxTbREXySekvq37kfCNk,108693,1169291,-1060598,618
2022-01-21 17:55:12-05:00,5872,2jPxG5FL6D6XEJsRszJ9cmQ54AWSpZyPFSbn3DpWBSuM,3toQou4UVNvyWYvMvkuv379RVEF2aN2TzCpKKBUqeQV6,True,20930371,5232592,32160,16080,16080,72FwbpFGoLEazJEdpqNtPNefsadUrimUqma9wSoy4qiS,1286401,13197755,-11911354,614
2022-01-21 17:55:12-05:00,5873,HPDN6Ro6gPgYbNgnv7yhFCpyY3uYzT18epFxRFNZ985w,3Jop74A52E7gYLXJRUAoPBzSZ6mmP2gmaCg7eG6eQHu5,True,119558046,29889510,181805,90902,90903,72FwbpFGoLEazJEdpqNtPNefsadUrimUqma9wSoy4qiS,7272234,47900677,-40628443,608
2022-01-21 17:55:12-05:00,5874,3qnPsgqW11AcDEmyjmJquPcPLyE3EdJQuVLJ5kinDrd3,86rZadBB7emKio76aFTahpbrFtxd9tqZ4Mxgzaavq2xU,True,17126,4281,26,13,13,3zqXX6kzhkbW3d4TwD2CNjMRwxTbREXySekvq37kfCNk,1055,10995,-9940,616
2022-01-21 17:55:12-05:00,5875,AaMCg49sJwNtdB5wHACg15TYAzzJXy8xtG4zuVXhKiVE,HbDYqDa9bewGPvsiaHRM9HmEvh1scPaUaGvqog66gYir,True,17750132,4437533,27720,13860,13860,3zqXX6kzhkbW3d4TwD2CNjMRwxTbREXySekvq37kfCNk,1108815,7085970,-5977155,624
2022-01-21 17:55:12-05:00,5876,8MGEQ1KEMv9WSgVifjN7CQ7tDbJBJbWgGYu71dTDKEPQ,mQY2X9KYVXf9JmGY8XwMK4G8odM4HmWkgEmYYqKnkvF,True,18645101,4661275,28584,14292,14292,3zqXX6kzhkbW3d4TwD2CNjMRwxTbREXySekvq37kfCNk,1143393,13530316,-12386923,613
2022-01-21 17:55:12-05:00,5877,5rW9kqXB9feGSKSvSMNJF1FCsBYV3vGmTmc8MvzaZ3pi,7AjnjcfPJevW5521hXw4VtgRCfHSsAqyzyArukKfNcHo,True,1192056,298014,1827,913,914,3zqXX6kzhkbW3d4TwD2CNjMRwxTbREXySekvq37kfCNk,73115,876475,-803360,613
2022-01-21 17:55:12-05:00,5878,3WcJUt8jQ1ngL3ZCGo6dFrc3GmTMTYtzeDva7mri2Tqx,HeG1Pz2oMjqtkfsRMsbqP3VpatnVEQzcWmKDVoFp4Htr,True,1760091,440022,2749,1374,1375,3zqXX6kzhkbW3d4TwD2CNjMRwxTbREXySekvq37kfCNk,109986,1168507,-1058521,624
2022-01-21 17:55:12-05:00,5879,4xn9vTtLZyNtCbBLLpcXUMWU8AnnZCov9rJaY6rew16T,5UNWdFw2CP44qS8oc4uPt8zxw6zFg8oXz8SUCedZLLEC,True,2668874,667218,4135,2067,2068,3zqXX6kzhkbW3d4TwD2CNjMRwxTbREXySekvq37kfCNk,165412,1051391,-885979,619
2022-01-21 17:55:12-05:00,5880,6BQVtmNsxihi4PcA7MurtguTwa6SmbmKyP14RHyjVZkf,7ZFv5ms4HzVKiw7KgE8RUoKxW9rB6JUD7ujZxMx4DwnM,True,359347,89836,553,276,277,3zqXX6kzhkbW3d4TwD2CNjMRwxTbREXySekvq37kfCNk,22151,196690,-174539,616
2022-01-21 17:55:12-05:00,5881,6Bq55LtGCEeGqh4JrFLCmmGc2iJfTTBJixivqH78aGSE,DSNrCgWJeNe2P9tAQu5FvCueTzNKDKds7wzuwTQSMRG,True,744737,186184,1156,578,578,3zqXX6kzhkbW3d4TwD2CNjMRwxTbREXySekvq37kfCNk,46249,435008,-388759,621
2022-01-21 17:55:12-05:00,5882,ymyzGH4Qc7HH5PbKpVphCbsQgLLXyGkPcXamQJuNj5C,8oTLHaV2XzbKXNWRuUjCfHjUn61Pw93LYK14m9q2VDpZ,True,1490912,372728,2298,1149,1149,3zqXX6kzhkbW3d4TwD2CNjMRwxTbREXySekvq37kfCNk,91955,872578,-780623,616
2022-01-21 17:55:13-05:00,5883,9VSpd4vToJrnQhmJ595Ua7GhmhutYRgd6rCk3pL4yNxr,7axwFe8aQVPYLNgM9rdUwnFf6vW69Jsw2XpKNjYRDn6N,True,36552631,9138157,55454,27727,27727,3zqXX6kzhkbW3d4TwD2CNjMRwxTbREXySekvq37kfCNk,2218195,20655564,-18437369,606
2022-01-21 17:55:13-05:00,5884,BJV5jbowrbELXfDvfMovaQy4PiRf12pLYHimW9bgzW5X,6WXrWso5FvLx7RMCFBzrbzh5qevKkk2LJAihUfWXxXzB,True,2346597,586649,3637,1818,1819,3zqXX6kzhkbW3d4TwD2CNjMRwxTbREXySekvq37kfCNk,145512,2537064,-2391552,620
2022-01-21 17:55:13-05:00,5885,96StvqZyFUPtyMr4o9s7K4V29RSNyRpVi76vNwxG5rUf,GZKXFSFq4aGiTaqovtxqNCCVGkAFNXPh4Hep1ZMwdZ8g,True,2503415,625853,3898,1949,1949,3zqXX6kzhkbW3d4TwD2CNjMRwxTbREXySekvq37kfCNk,155920,2843811,-2687891,622
2022-01-21 17:55:13-05:00,5886,5yPGvUz6JWKjkViGwTCpygJii1rP2xv5yx146ULtBiYq,FMnHUCQWTf1UHu5qVFqUAsWh8aba9EQYTEoiXy55totD,True,526384052,131596013,811918,405959,405959,3zqXX6kzhkbW3d4TwD2CNjMRwxTbREXySekvq37kfCNk,32476737,157679959,-125203222,616
2022-01-21 17:55:13-05:00,5887,3C2MZQKh9x4zNTCMbhhvoafGaFMwUooqfy9MCgPyXs6E,AHjgWKpYPWe6ketjDHDKFBFsKQiRJ41jnkuo39MVYxZo,True,22948578,5737144,35322,17661,17661,3zqXX6kzhkbW3d4TwD2CNjMRwxTbREXySekvq37kfCNk,1412882,18454388,-17041506,615
2022-01-21 17:55:13-05:00,5888,8627qmFevGS1LSDyCgoJjbURcf8CjVFCcxE7U9mWVP5f,3sgQuNcZuGV59Q9apxSBQcV1XAa6og6xa8FLpumvN7iZ,True,4347,1086,6,3,3,3zqXX6kzhkbW3d4TwD2CNjMRwxTbREXySekvq37kfCNk,268,2728,-2460,616
2022-01-21 17:55:13-05:00,5889,5sN3cfz4hZjwy2HkAStKWeL8wHhdbkW8F7USzwCzmggh,Fme7U7QY92biAsV3RR2Fj7rJPnpdcov13mmFhVDFuyYG,True,77531097,19382774,118752,59376,59376,3zqXX6kzhkbW3d4TwD2CNjMRwxTbREXySekvq37kfCNk,4750094,46803518,-42053424,612
2022-01-21 17:55:13-05:00,5890,6oroGB3mvzK3tDfiB9X2NJuL3x476pxhgRnt7VxqhdLo,2SoK8tKkLn2ppKURpTVazKsCEis4uahkHMsac1m85J4r,True,194146,48536,295,147,148,3uL2NSR2ZdDqCiKfzA5SwwpddAnit22DBJo6uvvz1rRs,11816,218540,-206724,608
2022-01-21 17:55:15-05:00,5891,BrHRMouGRz3LBNzd9anfdYMhWfg8yUPHL4PqJ8WdEDFS,4uzoLa3mC2VYHAPBoHLX4gTjPTC28rPf2fvEGtJWPYc,True,6596235,1649058,10147,5073,5074,3uL2NSR2ZdDqCiKfzA5SwwpddAnit22DBJo6uvvz1rRs,405907,7083979,-6678072,615
2022-01-21 17:55:18-05:00,5892,BYvjENe16Ta77PqGV7JKEWrsqCTfkMGYwTSG5gXneDvd,EvxAXgvhPC6QkNurbK7vWyTApGo8J2R4EgMAknkHVU3d,True,335146,83786,518,259,259,72FwbpFGoLEazJEdpqNtPNefsadUrimUqma9wSoy4qiS,20733,286887,-266154,618
2022-01-21 17:55:18-05:00,5893,Cs2YxkuqBK1kjoYZbUZdUcxapPbv8oC75trwGgWoCPfG,2PgHQM1GhHykE4bQ1ggueAw2Zs1BFUW5hxvMvr8DojKM,True,6161729,1540432,9638,4819,4819,3zqXX6kzhkbW3d4TwD2CNjMRwxTbREXySekvq37kfCNk,385558,4913677,-4528119,625
2022-01-21 17:55:18-05:00,5894,B4Uc39nKzz9wBRQsCkMR4A7RwTJ8rSuwpR6EQn2AesRb,H49bGZgatRZVpj6QufZRVgYrQtH7LpdbiqKBs23151m,True,2805384,701346,4350,2175,2175,3zqXX6kzhkbW3d4TwD2CNjMRwxTbREXySekvq37kfCNk,174020,3288552,-3114532,620
2022-01-21 17:55:42-05:00,5895,FV3G5EsSmyiLAAoREhgDXwvzbxoyDeq4Mwfj4jK5fJ7U,5nhzbJmm5JAwGDpTZoenkM1u3XtMY4uN7Qsm3vFGtRJE,True,6922890,1730722,10819,5409,5410,3zqXX6kzhkbW3d4TwD2CNjMRwxTbREXySekvq37kfCNk,432799,2533442,-2100643,625
2022-01-21 17:55:42-05:00,5896,DvuRmJkfn6FQczUKgYeaSCqwy2NTMunuAKNrnmxMvnzS,7LpWTX9dgBtW75kfEoB5WuNsDwEdw5s8CYSHh3J4qagM,True,7114324,1778581,11112,5556,5556,3zqXX6kzhkbW3d4TwD2CNjMRwxTbREXySekvq37kfCNk,444499,5283841,-4839342,624
2022-01-21 17:55:44-05:00,5897,3tmdrjoBp8JsjUxZ87Fqjwsfmow5pjYjRyuYdvtjwK2D,uhC85HiGrbC8fBsU227msvkzEDAcY2EDAJcYoBR31Qg,True,9456809,2364202,14793,7396,7397,3zqXX6kzhkbW3d4TwD2CNjMRwxTbREXySekvq37kfCNk,591745,8235712,-7643967,625
2022-01-21 17:55:44-05:00,5898,CwTus4FyoXYqyTKAYDp69NLhA1joYZ3tarzY6FFTr6fn,6ivuvYWU6i25MzJSY8rG9rPDKiq38E6QtrV1jvRubLGr,True,1136,284,1,0,1,3zqXX6kzhkbW3d4TwD2CNjMRwxTbREXySekvq37kfCNk,71,742,-671,625
2022-01-21 17:55:44-05:00,5899,9ebpuMtXee3DSx4qWiEYEtTT1gK5FqCY2H5yQVWWtTts,9b71dTsTYD1bx6KsjFs5h6d3Jj4T9eX3nqmS7RQj3HS5,True,32790443,8197610,50775,25387,25388,3zqXX6kzhkbW3d4TwD2CNjMRwxTbREXySekvq37kfCNk,2031009,20585027,-18554018,619
2022-01-21 17:55:44-05:00,5900,CK3ocyWzXQkJJZQmM6bBK4Nv6Rh3UEufjY6DvNU6gJZy,C924o4GY3p2BHLeAbFbe9SEysXqCUyD8sFu2d4NzkAV7,True,569900,142475,891,445,446,3zqXX6kzhkbW3d4TwD2CNjMRwxTbREXySekvq37kfCNk,35668,334266,-298598,625
2022-01-21 17:55:46-05:00,5901,2iG781tfP9H77hcFimqp5X9KB9QsbVkQVS9q7emJAJXX,5XDdJMfPSs8WwZZgEtv22RQXEbg748ia4gGfZCy1n4jy,True,1305951,326487,2035,1017,1018,72FwbpFGoLEazJEdpqNtPNefsadUrimUqma9wSoy4qiS,81413,435506,-354093,623
2022-01-21 17:55:46-05:00,5902,FX5sizQGZcDCaETDyJ3HbLxFwhu4t9bX6YyQM7cVEo9Z,6EqnCsv1JPjz6JX1yLNcf74rmkuhAUx6Sf35QMYGuuF6,True,19165979,4791494,29880,14940,14940,3zqXX6kzhkbW3d4TwD2CNjMRwxTbREXySekvq37kfCNk,1195205,12120342,-10925137,623
2022-01-21 17:55:46-05:00,5903,X5SF9srgzDgBRBhv8xUWyszYYSQiqFF6cVnVLWzQgp1,7rTqnMkPuUUJFt5px1DxwsUK8U5fQUtnx9N4v6dA4vGb,True,2894,723,4,2,2,3zqXX6kzhkbW3d4TwD2CNjMRwxTbREXySekvq37kfCNk,181,1874,-1693,625
2022-01-21 17:55:46-05:00,5904,woTXSsDkL9TQNxc3zwxSPagVijX7PE24bgKjvxexRwQ,A5M5EEPfDgvAxGLhpNgfn8AzPmyXxmPVgkEKnyoVzsz6,True,1134846,283711,1761,880,881,72FwbpFGoLEazJEdpqNtPNefsadUrimUqma9wSoy4qiS,70466,955620,-885154,620
2022-01-21 17:55:46-05:00,5905,54grbLQHZsNK4qTyXb8kXAU12Af9QUNFMujuzLLHHHef,3Ua1LDmZfPxvpaCp45RJ5xn3ovNuMxyWGrxnLcsK2ko3,True,173318494,43329623,268172,134086,134086,72FwbpFGoLEazJEdpqNtPNefsadUrimUqma9wSoy4qiS,10726919,104384660,-93657741,618
2022-01-21 17:55:48-05:00,5906,6h43GsVT3TjtLa5nRpsXp15GDpAY4smWCYHgcq58dSPM,CTgbWridYWnfE5Emwr7qiCEb3LcXHupqeB9zwmddoEqB,True,13880419,3470104,21614,10807,10807,3zqXX6kzhkbW3d4TwD2CNjMRwxTbREXySekvq37kfCNk,864575,14416463,-13551888,622
2022-01-21 17:55:48-05:00,5907,E1wp3bmkcY3eiEYyGYwhTCsr7BZ7RfPa5DJTZFupcFwj,452hVdYkD5SDDrA6hv6DLPFvyS8PvR2P6DPNScGxWTsW,True,70518,17629,110,55,55,3zqXX6kzhkbW3d4TwD2CNjMRwxTbREXySekvq37kfCNk,4404,46634,-42230,624
2022-01-21 17:55:50-05:00,5908,CBL2NbekJrXvBiAcoj4fzQ4PfLDwTntW7Zt4nruHFYEw,59EvfgYTdKkfjUJz5LddLUAqbEdLaihcMzjcrTZsyzyS,True,1015,253,1,0,1,3zqXX6kzhkbW3d4TwD2CNjMRwxTbREXySekvq37kfCNk,63,644,-581,620
2022-01-21 17:55:50-05:00,5909,3REbHhGGpn5b2GH67yQy2Dn7ZLNGLfM6hkBNU8UE1BRm,FBeCamJw884cPNpzbzhjSF7CFXyyhjnj3qWWCdBCK1NP,True,519132,129783,812,406,406,3zqXX6kzhkbW3d4TwD2CNjMRwxTbREXySekvq37kfCNk,32497,194136,-161639,625
2022-01-21 17:55:50-05:00,5910,8W9NJfM6cqCsvR1FC8Ab8YZPSQF7bz7inxJZxWnF7GsX,3exfPuVcTnPxs8GwCtS3ruKUGveYymwGV7RXQssPiizJ,True,34424748,8606187,53665,26832,26833,3zqXX6kzhkbW3d4TwD2CNjMRwxTbREXySekvq37kfCNk,2146636,36993892,-34847256,623
2022-01-21 17:55:50-05:00,5911,CP2qcTSw1Y5J7jZiEgbtsvJoigRbJ4m9oHGQS8Fiai2x,7Zd1uX1thbuGkp9H4r1t8aLTu9W8MxvUBNjji2FNJa8E,True,4394793,1098698,6871,3435,3436,3zqXX6kzhkbW3d4TwD2CNjMRwxTbREXySekvq37kfCNk,274841,2787157,-2512316,625
2022-01-21 17:55:50-05:00,5912,Cb4zhnvig11U4GcC4kqKrnDicGgPhUpfDQB1U7hP3nPa,DiRAMrKqaevGXeXg38KnhaYBERj8tNKU7oWFJvhS32kw,True,17640,4410,27,13,14,3zqXX6kzhkbW3d4TwD2CNjMRwxTbREXySekvq37kfCNk,1102,10193,-9091,624
2022-01-21 17:55:50-05:00,5913,DH6W3oB22rPJj7PPrey3Rgtn8Tz8kFKQjftajzUFBeKK,5gNsQSAUq8yFVt3FtU854NfuvFQaaCDC6oAqKA6hoZ3F,True,4469769,1117442,6983,3491,3492,3zqXX6kzhkbW3d4TwD2CNjMRwxTbREXySekvq37kfCNk,279343,2572082,-2292739,624
2022-01-21 17:55:51-05:00,5914,GaEpNGa8jnwSRvjzzEMYkZe1pKcr2eiZtePrqFxpABjB,5CFZHuyWbJv14zPdX5dSQDREgHrCb4vsFvB6hLiEe3Ji,True,13331,3332,20,10,10,3zqXX6kzhkbW3d4TwD2CNjMRwxTbREXySekvq37kfCNk,834,8556,-7722,625
2022-01-21 17:56:44-05:00,5915,i7TcF4weYcqgrRdH3GpndbEYxCxfcSfr9JWYrAUg1CF,BkDfknUir7PnSEW8auoB87PytycEFwyX5kT2GY4SGJJL,True,461455,115363,700,350,350,3zqXX6kzhkbW3d4TwD2CNjMRwxTbREXySekvq37kfCNk,28017,506097,-478080,607
2022-01-21 17:56:46-05:00,5916,2PzBAkdXkrwH9VuoMALumQz86qkW7sSBQtCrHw14JUp3,D5vwWAMHVooobG2sCWv9EwtJrAFZG6cwKH4dfmA98tbt,True,227001,56750,344,172,172,3zqXX6kzhkbW3d4TwD2CNjMRwxTbREXySekvq37kfCNk,13783,147564,-133781,607
2022-01-21 17:56:46-05:00,5917,75ycx5sUFBxDhY1uwuPCW22s2C6BydkJTje7q7zEQFGT,FpEgrVFRubjGK4DRjTqdVbxSECURpn16zfpoC31NbwnN,True,556682,139170,864,432,432,3zqXX6kzhkbW3d4TwD2CNjMRwxTbREXySekvq37kfCNk,34578,428097,-393519,621
2022-01-21 17:56:47-05:00,5918,EHJXCJ4ZxPY7F1CeDQkXxVCLyTBXAY2ouWMJfKic9EcK,3yxXBa3sJhUhK9auop8niypnuWiasge5waVTM1zzuhU7,True,96447536,24111884,150229,75114,75115,HfEnetJ7uBSmZWCjBNxdvv9HEC5nsW4wDV7wu6WnhWan,6009164,37788123,-31778959,623
2022-01-21 17:56:47-05:00,5919,5Z3ZFCA65WoWhm3okRuuziEMi7ajGAEHWUFchzBNba5S,FcomdrWidygkxMKzcsY5xELbmwC652uMci648LMTv7AB,True,1087,271,1,0,1,3zqXX6kzhkbW3d4TwD2CNjMRwxTbREXySekvq37kfCNk,67,692,-625,616
2022-01-21 17:56:47-05:00,5920,7vKmhLV45Q5etXhJL5ng8rxWhYSiUCDmAbGnwBPr7zcx,cP6xPeuHLnjr858QK1F9qYn7rJpEbPy7wEJHoju6oV7,True,3777456,944364,5762,2881,2881,3zqXX6kzhkbW3d4TwD2CNjMRwxTbREXySekvq37kfCNk,230517,2437361,-2206844,610
2022-01-21 17:56:47-05:00,5921,KoCscQ9Q8TZHhmya5KaXBrwUEMTdCkEMRtrhvtgEmiZ,6aZ5AFMFoqf1X64RwAt1J4Yrx4WGGe2JMiEjqnQ2gEtk,True,41206,10301,64,32,32,3zqXX6kzhkbW3d4TwD2CNjMRwxTbREXySekvq37kfCNk,2571,17683,-15112,623
2022-01-21 17:56:47-05:00,5922,89CkXnSZnr52Zsoh48efv9MQacrkB6GMtrbEpNJSyA2H,HcvRBS4Z22CpYgDNgm4TVF4AVXFDuYzBUAFcdHAwdpg4,True,261779,65444,398,199,199,3zqXX6kzhkbW3d4TwD2CNjMRwxTbREXySekvq37kfCNk,15939,167108,-151169,608
2022-01-21 17:56:47-05:00,5923,Ar5QB4VBcUyzSCG23z2QNAbrWY55NbHCr1MNN6P2GAmh,BusFGTiDrJmxzwGUxWz9b3SFF3eseqtgh2DRHqyAwyVe,True,40396,10099,61,30,31,3zqXX6kzhkbW3d4TwD2CNjMRwxTbREXySekvq37kfCNk,2458,26843,-24385,608
2022-01-21 17:56:48-05:00,5924,9ydHRjDWvWV2XqbXKKpeLDh2RV7WnQZWDTi4ahgDjGNh,AiJQBv4a1Z4w2rsRog5WTaKb4dTjAXfAvXcWoW4DztSW,True,5465957,1366489,8393,4196,4197,3zqXX6kzhkbW3d4TwD2CNjMRwxTbREXySekvq37kfCNk,335729,1988924,-1653195,614
2022-01-21 17:56:48-05:00,5925,EeUACm9TkjHKES5U7Yj1oPhYmcp7R3tvesGBiP8txEzq,3qkmm4aS6EDirEDejmbm5PDw2jpYkC7zKqrMkmgeE5BA,True,20190,5047,31,15,16,HfEnetJ7uBSmZWCjBNxdvv9HEC5nsW4wDV7wu6WnhWan,1259,11554,-10295,623
2022-01-21 17:56:48-05:00,5926,HutRztBianNUgm9sJDWKUQBmoVyy8y7CfnNk4hHjSkEW,EtVfvPyiy5bizbCZxR19TNUgETf3QcmziBvMtc6o5zjr,True,21530137,5382534,33090,16545,16545,3zqXX6kzhkbW3d4TwD2CNjMRwxTbREXySekvq37kfCNk,1323631,24416157,-23092526,614
2022-01-21 17:56:48-05:00,5927,GgBCXShHpprQGxz83aEykieANhQPw9wHE65AFuSJBiWZ,JAoJ6sM7B3d2kQ5yTXAuoUDpvBX1qkb5uq1T8a1ra2zC,True,7040806,1760201,10994,5497,5497,3zqXX6kzhkbW3d4TwD2CNjMRwxTbREXySekvq37kfCNk,439782,1830855,-1391073,624
2022-01-21 17:56:48-05:00,5928,6tWqNUhr9XZVB1sc33W8VEo7gbptDtnKzGVvMZ4Xh68n,8NdrSzU8Tc6Ng2o1RWKfXyZb7i8jm6waYTBomq24F8wZ,True,286580,71645,442,221,221,3zqXX6kzhkbW3d4TwD2CNjMRwxTbREXySekvq37kfCNk,17700,94519,-76819,617
2022-01-21 17:56:48-05:00,5929,9rfebymEFqy2SoBoDKKUppZVRPr1zNh6gkFYkmVsqbqz,6pQ3MsewzM8jzKEQG5zJDry8iEMUjGA1UDJPEQjFWTgR,True,722339,180584,1115,557,558,3zqXX6kzhkbW3d4TwD2CNjMRwxTbREXySekvq37kfCNk,44624,270025,-225401,617
2022-01-21 17:56:48-05:00,5930,DrzTARa7RK8RXoxHZPKCBqYtMC8TAUHRw8SznXRKTa5M,FYANet92VhyXkKZqqBJR4sFxuCftWb68sgQU9VHCdTJk,True,2884,721,4,2,2,3zqXX6kzhkbW3d4TwD2CNjMRwxTbREXySekvq37kfCNk,176,1809,-1633,610
2022-01-21 17:56:49-05:00,5931,2NHv3c4ufYGo3xNr6KXymAZJdpfURrNiCKbXZ7s82Vwo,E4NYpYgHTvSG6LqH2bBV9Q1XJ6pAzCp9FLSKMzJmYRrQ,True,2258389,564597,3461,1730,1731,3zqXX6kzhkbW3d4TwD2CNjMRwxTbREXySekvq37kfCNk,138446,1761742,-1623296,613
2022-01-21 17:56:49-05:00,5932,8dE8PJp7BEYbmSrpMhvxh2Ro9KUiKoEFs3Mi7Xh18Cgz,CfiSeqS4D8EcG882PSLNXhwm5KJH7F1KGo5nSz13tGP8,True,6084531,1521132,9412,4706,4706,3zqXX6kzhkbW3d4TwD2CNjMRwxTbREXySekvq37kfCNk,376481,1790451,-1413970,618
2022-01-21 17:56:49-05:00,5933,J1CrDBB5Bk55z9ByXQavcHwRMTGpgVdndjWxRQthEvXQ,F9mDV56ds2RodotLvXfHdkMp4mhrBtFMse8iMYWUnSvw,True,50257434,12564358,78078,39039,39039,3zqXX6kzhkbW3d4TwD2CNjMRwxTbREXySekvq37kfCNk,3123131,42856745,-39733614,621
2022-01-21 17:56:49-05:00,5934,2BH44k4TYoQSqsSs5EASqJhxpH17Fr8Ahxbg2MAkWa72,HwvvVWpqfN7NDsVYdxbCSbqxSrLCThwnJiZQHh2w2zJb,True,1567,391,2,1,1,3zqXX6kzhkbW3d4TwD2CNjMRwxTbREXySekvq37kfCNk,97,990,-893,619
2022-01-21 17:56:49-05:00,5935,4MmpDGUTyMcYEqJ1RoZ46AN2BhrBUseHaHqF8AmiTPyD,7HW2YZpYM349HMfW7u4h9ESZ1AXkwN8JcVDTNFzp9aTz,True,10489511,2622377,16382,8191,8191,3zqXX6kzhkbW3d4TwD2CNjMRwxTbREXySekvq37kfCNk,655283,8013115,-7357832,624
2022-01-21 17:56:49-05:00,5936,GhV3DChNShu8mGwUUy7VLidabCV6Y2aKdp7cqPynd6Ci,8R8QkgruGRCeE1pjXmn3WjdVDiawNbXFid8gU8BfabZA,True,1558,389,2,1,1,72FwbpFGoLEazJEdpqNtPNefsadUrimUqma9wSoy4qiS,97,981,-884,622
2022-01-21 17:56:49-05:00,5937,7D4rFmGMPKNAF75VRPxHAhSn2wTjiW8jmth1UD22Xqq9,GQ7BrT6vsXu8tHCMm75YdxFR2r9QTCrCUbdPEZBSAg9w,True,4183472,1045868,6364,3182,3182,3zqXX6kzhkbW3d4TwD2CNjMRwxTbREXySekvq37kfCNk,254567,2378732,-2124165,608
2022-01-21 17:56:49-05:00,5938,BzSJ77zKaqtBk2cEL1XqFL97zTXXMRHmxtkgtXwCc3C,2g4KXTwy2MPSRQ2khNp1o1rn7CradEr9H4ySYKDoSWN9,True,882665,220666,1374,687,687,3zqXX6kzhkbW3d4TwD2CNjMRwxTbREXySekvq37kfCNk,54973,1113736,-1058763,622
2022-01-21 17:56:49-05:00,5939,EhANPABkSw9x9WnsDEi8pCg67iQTX2UGTTUpyjADTwdN,4FKLi98hyg9ZjM4MY6ctJsv7B6vPUnTYWdhrnNoYsztX,True,875562,218890,1335,667,668,3zqXX6kzhkbW3d4TwD2CNjMRwxTbREXySekvq37kfCNk,53419,672623,-619204,610
2022-01-21 17:56:49-05:00,5940,GABCjRvhnVZwwR9aZLhkTfaH9xdp2hJK7J6h4kD5VzkC,JabV7oy3dp6jshtccn89ybinAuaf9dHVmKuiEjXDPT9,True,5056526,1264131,7780,3890,3890,3zqXX6kzhkbW3d4TwD2CNjMRwxTbREXySekvq37kfCNk,311220,3305637,-2994417,615
2022-01-21 17:56:49-05:00,5941,AKxRtcdpi7gWhAuL8ENj7zhgeQezzEXe9TSANE6bQoRA,2YH4vrU9deP8Cu6E8Hzf8GqKG1yVjv5pdz4FE7r5YKir,True,597698,149424,921,460,461,3zqXX6kzhkbW3d4TwD2CNjMRwxTbREXySekvq37kfCNk,36841,381689,-344848,616
2022-01-21 17:56:49-05:00,5942,D3mXrJzhHf8qRaoCKLschUxAFoijFCFuT6bmNZH4W7Cj,9E3Xtqw7TncXWnbhAbFJMtuNmP6WS3ooGuptzyzw7UpA,True,5054,1263,7,3,4,3zqXX6kzhkbW3d4TwD2CNjMRwxTbREXySekvq37kfCNk,312,4092,-3780,617
2022-01-21 17:56:50-05:00,5943,9TL17gjvWFdhSJkpXgfnX7fKF9c2hfw59k3g8WUqm8Cb,7TyxFBKG4z5Xv3js3n1gbEWWj1M9KBF7dEmFxjCPGidC,True,16150010,4037502,24874,12437,12437,3zqXX6kzhkbW3d4TwD2CNjMRwxTbREXySekvq37kfCNk,994976,8862599,-7867623,616
2022-01-21 17:56:50-05:00,5944,6kbTnDL9xhi1YvPLtFvRmk8aE1HWsxNAEALcQ9kdCJQW,3Z1kmT8dUJJTUqbrCWGSBqV12GHhzcs3ZGKwaXP8gpGW,True,1168991759,292247939,1819199,909599,909600,3zqXX6kzhkbW3d4TwD2CNjMRwxTbREXySekvq37kfCNk,72767974,430438155,-357670181,622
2022-01-21 17:56:50-05:00,5945,EV21gv8jEvXtmGDoGRNm5LJEvTBccLMZyVDCLsp54jP3,DGxxoU52aQNoUQcxdvQtv2H5q2PhK6TGkLgNSaFgnZrb,True,389802,97450,608,304,304,3zqXX6kzhkbW3d4TwD2CNjMRwxTbREXySekvq37kfCNk,24351,258296,-233945,624
2022-01-21 17:56:50-05:00,5946,3y34hmyz6rsVnpp7d6a9s2Xw9GdezLU1H44HfieG6SGG,9DCz2eyYsrk1Hd5zsSVBhKTV9QD6beym5zB5fH3aA4hE,True,90187862,22546965,138150,69075,69075,3zqXX6kzhkbW3d4TwD2CNjMRwxTbREXySekvq37kfCNk,5526011,93847037,-88321026,612
2022-01-21 17:56:52-05:00,5947,AA6QgBaH9F8QfPT9xjztv9uELcADPxwUuXofkBV8dYg4,FCMXozSstTNA74FVCJ5hpYvNJamjutnoakHoBVnzwcWj,True,2322,580,3,1,2,3zqXX6kzhkbW3d4TwD2CNjMRwxTbREXySekvq37kfCNk,143,1589,-1446,615
2022-01-21 17:56:53-05:00,5948,2rCRdyfi65rpxRRmg7knaSb8t55FuPt3h8wF4Fzhy8MM,CLVY5nSG3jTdRo7tRSKgK9DJgW6aswfWKe4tLxzsENmb,True,55021,13755,83,41,42,3zqXX6kzhkbW3d4TwD2CNjMRwxTbREXySekvq37kfCNk,3356,32263,-28907,609
2022-01-21 17:56:55-05:00,5949,9jdfc9GFTecsdRuTjWFGX13niKKmeBxRgtv5j86uhSnU,HLWMShobjSkaLyXrNjgwVaUGVtbtdUSnr1XjqpXn1bLR,True,25588,6397,39,19,20,72FwbpFGoLEazJEdpqNtPNefsadUrimUqma9wSoy4qiS,1596,17765,-16169,623
2022-01-21 17:57:03-05:00,5950,AxjhBwz3yoP6bEtH1shjztXfMQwhTXyku2fk6oPYStef,6yB7A8yhvugS5fVnU7nYjJvU9KJWEQvT66TMCFTzWiP8,True,8337015,2084253,13009,6504,6505,3zqXX6kzhkbW3d4TwD2CNjMRwxTbREXySekvq37kfCNk,520395,3432247,-2911852,624
2022-01-21 17:57:04-05:00,5951,9YEzjb49Awvedv9yNc6LG54SkGBug2RYiJwiUV13mGsS,3H8w5WCD187NWWoZMNUCzUDdxTgqrRJLga8gDzUVXBgZ,True,95797,23949,149,74,75,3zqXX6kzhkbW3d4TwD2CNjMRwxTbREXySekvq37kfCNk,5978,82112,-76134,624
2022-01-21 17:57:08-05:00,5952,H458vCw7tnmFmPgmmg1HaMmN35mqfnMSugKxddMgSWfX,E25tbasspnw8yTYh7q2VLG7DSvDH7M8N19eQwAtgQtfV,True,7039914,1759978,10979,5489,5490,HfEnetJ7uBSmZWCjBNxdvv9HEC5nsW4wDV7wu6WnhWan,439192,1831156,-1391964,623
2022-01-21 17:57:11-05:00,5953,7tDiadLeMrob7yD6R5SDskYn41tnQZVPjEc6W2vv6irK,AHZidccE9ERBcipuRQ2iGM9kHRpTnty7UNuYTFurvXB7,True,376581441,94145360,587818,293909,293909,3zqXX6kzhkbW3d4TwD2CNjMRwxTbREXySekvq37kfCNk,23512734,97026293,-73513559,624
2022-01-21 17:57:29-05:00,5954,FLMmm1T383a2eWS45cBbMXKCWFqgmiBAB662R4fhA78N,B8dRmhYvTJzZWZYthEchwKTKkBWHrqkFzBJAUMvG5eQE,True,42925837,10731459,67118,33559,33559,3zqXX6kzhkbW3d4TwD2CNjMRwxTbREXySekvq37kfCNk,2684756,25395207,-22710451,625
2022-01-21 17:57:29-05:00,5955,4miF1JWfTjjFHkrpffjGFGVfkkWFME4smk47dEcxpH4y,c4QGrEkmzRKVDbYJe3FuQfrzqBqajt8mnaKJYF2Fy3t,True,364341028,91085257,568666,284333,284333,3zqXX6kzhkbW3d4TwD2CNjMRwxTbREXySekvq37kfCNk,22746647,101337319,-78590672,624
2022-01-21 17:57:29-05:00,5956,6XHt7CrURSomkQrtVXV5JuKSZY4tQRpUyQKfCDaSTYaD,GCgcmPSDDBsn2smYbpiX3PJybDkQWtufPu4YRsbEEU8X,True,29468368,7367092,46109,23054,23055,3zqXX6kzhkbW3d4TwD2CNjMRwxTbREXySekvq37kfCNk,1844360,25673127,-23828767,625
2022-01-21 17:57:30-05:00,5957,3zH1b58jqbNU37y9kDTZZrotSeT8XzS1tuyAHPKWrbah,4trxDWV16x6sVcz7bxHehYHkjjyKebh3S9fyJf8txzK5,False,813,813,40,2,38,3zqXX6kzhkbW3d4TwD2CNjMRwxTbREXySekvq37kfCNk,40,501,-461,492
2022-01-21 17:57:31-05:00,5958,4j19AEcDwhtAZrnoDc4epNPmEL1jPpVUMeg7RmQ72Qkb,84WB42AAGbczVE9txZPwXrx4FD5jP87r8QdDzEABTm5G,True,5747766821,1436941705,8981443,4490721,4490722,3zqXX6kzhkbW3d4TwD2CNjMRwxTbREXySekvq37kfCNk,359257735,4642538657,-4283280922,625
2022-01-21 17:57:33-05:00,5959,24X28Jdpnxsm2L1SdqSMhRtEuqvou95nHVHFXrnsvMBn,7gRi4quFb53FxbQrACq2SHmAyi1iftkcFjxn4imaC6n5,True,2318560,579640,3622,1811,1811,3zqXX6kzhkbW3d4TwD2CNjMRwxTbREXySekvq37kfCNk,144908,605100,-460192,624
2022-01-21 17:57:34-05:00,5960,7nByfyoLmMrzzVHsjxL2FRF72tfW3KiRT27BRGUp4PhP,36SF6NBnUc5wK41yfGCnujpCaCwExR3iRXJQx1WNakyM,True,3474728,868682,5437,2718,2719,3zqXX6kzhkbW3d4TwD2CNjMRwxTbREXySekvq37kfCNk,217516,1263449,-1045933,625
2022-01-21 17:57:34-05:00,5961,8BMDSWFtzq9fu1ubVGtSFw8fEaMg1uvJiECuJnN8e1pd,FwkETAXL296CirvQ2AJuSHHtdKsxkZkmXSwZVVHXVDhA,True,11367448,2841862,17761,8880,8881,3uL2NSR2ZdDqCiKfzA5SwwpddAnit22DBJo6uvvz1rRs,710459,7161313,-6450854,624
2022-01-21 17:58:02-05:00,5962,AVon82fTHT5KeqJkdoG4KkbGoVF3ocK4rqz52umUeEBy,LdgtwakPuhGZCh47WNERa6op7z2YtouJFv4mhFLtVgs,True,11102733,2775683,17192,8596,8596,3zqXX6kzhkbW3d4TwD2CNjMRwxTbREXySekvq37kfCNk,687704,10465698,-9777994,619
2022-01-21 17:58:02-05:00,5963,99NHcwD1iaf5FXM3UNb91SjNiiT3HwyQFQMhkGd5ASts,8syAydy52vSQQLzsLXW24BFw4VPeK66Vp3BmAbnHfgod,True,4313062,1078265,6604,3302,3302,3zqXX6kzhkbW3d4TwD2CNjMRwxTbREXySekvq37kfCNk,264180,2889027,-2624847,612
2022-01-21 17:58:03-05:00,5964,2RZPBo8Z2BgZmsASo14ySTSwqqgqmfVEjPkiAwQ1VTgf,BRS5cYtEoPRoSvTAiQaT1svWRdLJWVfy8LUb4SCudCjS,True,426880,106720,659,329,330,3zqXX6kzhkbW3d4TwD2CNjMRwxTbREXySekvq37kfCNk,26393,273912,-247519,618
2022-01-21 17:58:03-05:00,5965,AtKuDfcFXqWUMnRqQpjedUMTb5CQKLc2zoqEAcQpysKQ,9bPFLYp5TDZruLLDXDYYCiPYcD982iF8xt5rfTkqwNsL,True,972,243,1,0,1,3zqXX6kzhkbW3d4TwD2CNjMRwxTbREXySekvq37kfCNk,60,612,-552,617
2022-01-21 17:58:03-05:00,5966,Mcbzp1LhZwpfmXTv1pqe9D1jCKHw443j9QKp6tUpzgM,8uforSMAKEih5jHfHp3gCqCvaugtCmhzVfVHA63Akz7F,True,173875,43468,266,133,133,3zqXX6kzhkbW3d4TwD2CNjMRwxTbREXySekvq37kfCNk,10671,134074,-123403,613
2022-01-21 17:58:03-05:00,5967,96DzqyUxsB1FKWrhLdTdjDcokuus6rbx83gLsghqPPwt,74CWb7SVoSy3ADysEzFEeMiS2fxHJ9gdUF9pzM3E52Gj,True,1688,422,2,1,1,3zqXX6kzhkbW3d4TwD2CNjMRwxTbREXySekvq37kfCNk,102,1077,-975,604
2022-01-21 17:58:03-05:00,5968,BmDwvPUjxBakng8ARj7cfjgYJUYCJhLeVnRYXcLDMy4G,8YVEshruc7LMMPf7vrPK9x5eLQGwe7py6bhZoxb9yfkz,True,32041384,8010346,49394,24697,24697,3zqXX6kzhkbW3d4TwD2CNjMRwxTbREXySekvq37kfCNk,1975793,9611864,-7636071,616
2022-01-21 17:58:03-05:00,5969,3JzquEXUqphLYNmaVQLUTyrD6mJKXDcSSu9m39YCYvHf,Dk8mswH5HnCUmTEFvX4xHhUPk2m8VmgZW344BiNqg819,True,414622009,103655502,647398,323699,323699,3zqXX6kzhkbW3d4TwD2CNjMRwxTbREXySekvq37kfCNk,25895937,232737402,-206841465,624
2022-01-21 17:58:05-05:00,5970,C7a8BtMjuLXkzxZBC4Wk2gjkGBmucLmDjokf9pyA1Mu6,GxwYNWwYTtFMUxuZvNC5qrEYuJzYiEURQVuBxssfCJzr,True,133605,33401,205,102,103,3zqXX6kzhkbW3d4TwD2CNjMRwxTbREXySekvq37kfCNk,8233,64691,-56458,616
2022-01-21 17:58:05-05:00,5971,DiB9SeCFXjioNGPJM3GuZ3FCG9KBZhHK27zCSN5b6gkq,GtK8UtKDQy9jgtTXvam4jja9N7c4EFuDQr4TKHgNyhXT,True,352888,88222,551,275,276,HfEnetJ7uBSmZWCjBNxdvv9HEC5nsW4wDV7wu6WnhWan,22041,243657,-221616,624
2022-01-21 17:58:05-05:00,5972,7LRBswSEDBjJzQ4YurfTxLydh7tFS2jVn5V95Z6wL7ci,fD41VYGmk66MW46KKb23vAqQvUSDScgXnVdsHhJBZzu,True,10270,2567,15,7,8,3zqXX6kzhkbW3d4TwD2CNjMRwxTbREXySekvq37kfCNk,627,7487,-6860,610
2022-01-21 17:58:07-05:00,5973,C3k34T2x8fW171coEG9YvoUePvxtHmrQMjVsX1Cb5ZbU,4mh5Tp4Jjh5X3GDERpSMAFgsfYJvysRdd1Nu5oJQ1Dhw,True,1989,497,3,1,2,HfEnetJ7uBSmZWCjBNxdvv9HEC5nsW4wDV7wu6WnhWan,123,1252,-1129,618
2022-01-21 17:58:07-05:00,5974,8sneA6wAg6geVDJ1g7YWg4R1PfjuRVzeHp1nUBJinhZa,14i1uWtmcTjrdbg3DSr9vzd5NBnxqsn1A4QdgFBZqeYM,True,24041,6009,37,18,19,HfEnetJ7uBSmZWCjBNxdvv9HEC5nsW4wDV7wu6WnhWan,1490,14498,-13008,619
2022-01-21 17:58:07-05:00,5975,ZoNjrSjYh4NJLW38LUPcf7jtEBxdaaM7T1zp795qjHE,FZx6v8cU25NwEosbKJ2n141o9uFAWURZB7NeCeX1trEn,True,122711,30677,191,95,96,HfEnetJ7uBSmZWCjBNxdvv9HEC5nsW4wDV7wu6WnhWan,7665,59178,-51513,624
2022-01-21 17:58:07-05:00,5976,44iCXTAbcJMVscvvJQfTuVqj88V9QDgwXJDmVk7YcFBS,Dz3doggGiqe6rpazVjeA2j3XpRFmqesx7CRKsPAGKEVf,True,4940,1235,7,3,4,3zqXX6kzhkbW3d4TwD2CNjMRwxTbREXySekvq37kfCNk,301,3162,-2861,609
2022-01-21 17:58:07-05:00,5977,C4dbwF9mioaBkZnyBFvFs6Cqd362VuGPBGPbTY9CAnAk,CcUqBfu1hbWm5VVxbtF2Xm6HUz4CLFzuDsjUi6KtnZQg,True,142862,35715,223,111,112,3zqXX6kzhkbW3d4TwD2CNjMRwxTbREXySekvq37kfCNk,8936,68808,-59872,625
2022-01-21 17:58:07-05:00,5978,6AHFxqjtpMsrCJ9E4ofrq4DVbaZSpDqyVMp6bznPqMg9,F3EauaowTvSs4NZ1EpUVonpNMmpMijcWHNi1AiKFZVxY,True,27486274,6871568,42404,21202,21202,3zqXX6kzhkbW3d4TwD2CNjMRwxTbREXySekvq37kfCNk,1696174,8812204,-7116030,617
2022-01-21 17:58:07-05:00,5979,3axqGcX5yuJ2vGxRjtNguefXUvSQHDQmn2zskhyCuQkf,EYrZo9zZDaHqFdc1fam63W3jvqqmbU67wzp6yFcppwsL,True,2344052,586013,3621,1810,1811,3zqXX6kzhkbW3d4TwD2CNjMRwxTbREXySekvq37kfCNk,144847,2605741,-2460894,617
2022-01-21 17:58:07-05:00,5980,B8kSMCHEX64joQD9EWuQFN15QunybWnKiiE8DuGZyMLk,EkKznVWgH3CLUXJk1uVWZUMvBRVPXakAVDwHXZwfm3bA,True,63852156,15963039,98369,49184,49185,3zqXX6kzhkbW3d4TwD2CNjMRwxTbREXySekvq37kfCNk,3934767,29536892,-25602125,616
2022-01-21 17:58:07-05:00,5981,2fk7wZ4M5ZqaQ5ZeLuh6uivNhtiRkCsCe8T44JBFahn3,HgtXtbcJzNLsrh9asZbcgiYVRhiPpYAyp2BpSq9VKEsW,True,12710990,3177747,19619,9809,9810,3zqXX6kzhkbW3d4TwD2CNjMRwxTbREXySekvq37kfCNk,784774,7494741,-6709967,617
2022-01-21 17:58:07-05:00,5982,Buioe5v3DyFwD9nquW5XdYeVYbSABCyg79eUHEvtvfaW,7T9gi7prCcZJkYJMSB5Ef6Bu4pAuBw4XLvumSFnqKDSi,True,56833,14208,88,44,44,HfEnetJ7uBSmZWCjBNxdvv9HEC5nsW4wDV7wu6WnhWan,3553,45592,-42039,625
2022-01-21 17:58:16-05:00,5983,DZay4ADcfoFainzjooJ9To7sb4Dn4iEoMs8tnYVrdwN1,AV8ndys1dnL31GKm5tEJLk74y4L9DuP6gC8ZvUtuVxfM,True,83816641,20954160,127170,63585,63585,HfEnetJ7uBSmZWCjBNxdvv9HEC5nsW4wDV7wu6WnhWan,5086835,72755058,-67668223,606
2022-01-21 17:58:17-05:00,5984,CAkknoa9UFPMEZ1KWSfqtmnL7ArVNV3HRETLwecuuXP,4cHJYv3dxA6qjcuxUkGRuL7STWobGPKtoHFD4ACUbiWq,True,912560,228140,1387,693,694,3zqXX6kzhkbW3d4TwD2CNjMRwxTbREXySekvq37kfCNk,55488,579365,-523877,608
2022-01-21 17:58:17-05:00,5985,6WNPf4rFCX74PuyvdmzRFqbxWhguuxTQqBSdnaTVBd5D,9N7a9aiHGQsxFMgVbmWoCF9w95d12xyT7XFAwpHGkTLA,True,130659,32664,184,92,92,3zqXX6kzhkbW3d4TwD2CNjMRwxTbREXySekvq37kfCNk,7397,63634,-56237,566
2022-01-21 17:58:17-05:00,5986,7dmoK7QPki7R66SPQST4veUgVfnJbVToxxBPZveECiwK,4vh4REBDm5zBDmcjRCD9zNsny1HGneu7B2co4dSJNLL6,True,65106970,16276742,98758,49379,49379,3zqXX6kzhkbW3d4TwD2CNjMRwxTbREXySekvq37kfCNk,3950327,42677541,-38727214,606
2022-01-21 17:58:17-05:00,5987,A7HnmwpMzu9yYuvURa1Zct5JUoFujFybc6Ympjciuz99,E41s3xNbU4haxQQjR8nXZwTpJCoLiJ2BJSncHDfc6HzS,True,48227673,12056918,69224,34612,34612,3zqXX6kzhkbW3d4TwD2CNjMRwxTbREXySekvq37kfCNk,2768973,25725956,-22956983,574
2022-01-21 17:58:18-05:00,5988,Grw2snBvSDMa7ev2nWZo81WoLfyavmXXxCV1ugHGk5Xe,AF1WVCQcBmXCnWbDx2s62vU99zW1AdhNoqbWvdrbiQVm,True,1345224,336306,1927,963,964,3zqXX6kzhkbW3d4TwD2CNjMRwxTbREXySekvq37kfCNk,77082,834023,-756941,573
2022-01-21 17:58:20-05:00,5989,5hUZ9uQFcYnjAQVVaGLJWdKyg7y1XMpoo8osQ9DeY7Xd,BdYiKWsjuzJLcHh3814mJ4xQ9JxoQKKcr7AHZ7Vxoavq,True,3521,880,5,2,3,3zqXX6kzhkbW3d4TwD2CNjMRwxTbREXySekvq37kfCNk,207,2327,-2120,587
2022-01-21 17:58:20-05:00,5990,GZZ8WePhKCrJLhXXvRD21rp79pFiaJeGykVsyeKAYe9W,6P1C9RDFQoFqZ5eFo59UwVnNrnyAWaNnACNQMqR3uJhs,True,123633227,30908306,181038,90519,90519,3zqXX6kzhkbW3d4TwD2CNjMRwxTbREXySekvq37kfCNk,7241544,38633188,-31391644,585
2022-01-21 17:58:20-05:00,5991,FfpzVu4rcnwxNbx9EoNpZ4LmCYTjhYTkhwrUGCpnSJvh,5rRoUEuDVtaXQBH9xvq4vUvPWJDytFoEByNrcWfiq1E8,False,107048,107048,5319,265,5054,3zqXX6kzhkbW3d4TwD2CNjMRwxTbREXySekvq37kfCNk,5319,37206,-31887,496
2022-01-21 17:58:21-05:00,5992,6d6HN8LWikwW2HYdy3BABWuxKHt1sgv4DcneACR133sE,4eKvzmfFvX96XbujKBhUauAvWP4yQYwZH3pd7gXzbCvJ,True,133478,33369,206,103,103,3zqXX6kzhkbW3d4TwD2CNjMRwxTbREXySekvq37kfCNk,8273,64857,-56584,619
2022-01-21 17:58:24-05:00,5993,8trkirSQNdMmAcJdeswxs5cPjH8dD6U4eJtWiAdMsrDB,HaSzpQ45x2MipfN17U6jGBxX8tXboomVDhXNSrnEfLDr,True,371784,92945,574,287,287,3zqXX6kzhkbW3d4TwD2CNjMRwxTbREXySekvq37kfCNk,22993,234602,-211609,618
2022-01-21 17:58:24-05:00,5994,EEcTbsFTUEifcdbPyjBLkS943daEx1RpR8F3uZxKRZbT,8V3JzDQ1VWYQLas8fxUsWJZZHe4gEmn74RehtUwLw3k5,True,428136,107034,643,321,322,3zqXX6kzhkbW3d4TwD2CNjMRwxTbREXySekvq37kfCNk,25724,313840,-288116,600
2022-01-21 17:58:24-05:00,5995,FLTW9fwjWqGPm5PiE3C9LFzwZxtDh8c2MnEoRq8W7MfQ,GKsfzKBP2QkmoEWvTaUN1h4nqrT3kAcwYRC9WxW9bB3h,True,985592,246398,1528,764,764,3zqXX6kzhkbW3d4TwD2CNjMRwxTbREXySekvq37kfCNk,61146,560210,-499064,620
2022-01-21 17:58:24-05:00,5996,2ce2v2TCbjNH635NgbwTG3sqiRWYrRRaBpxPxBZJ929q,9cnoebT43FkWDFhidndGCVNiFD4NErv8DuL1Va4Jv9S8,True,481291,120322,725,362,363,3zqXX6kzhkbW3d4TwD2CNjMRwxTbREXySekvq37kfCNk,29016,508627,-479611,602
2022-01-21 17:58:24-05:00,5997,HGAFdundf5voDqeh9g7d6Q9mgMf8eEg898QMRBqwPZ6C,deanBuZXWBHEe2TGfP37S9aMBEnEgmZoyRJjAvruzfA,True,12987826,3246956,19610,9805,9805,72FwbpFGoLEazJEdpqNtPNefsadUrimUqma9wSoy4qiS,784417,9335184,-8550767,603
2022-01-21 17:58:24-05:00,5998,FjDp4bWCtqehFD7FunCrjrcdxMezTJj5aqh2VnBvHDQU,HRYeZqcqhP1RPiAGXziR1qCWwk4sF6c5ZYbvSDhX7foN,True,641519,160379,953,476,477,3zqXX6kzhkbW3d4TwD2CNjMRwxTbREXySekvq37kfCNk,38141,398790,-360649,594
2022-01-21 17:58:24-05:00,5999,69byqtDPmgEY1NqKBCR95CEPVHRUxgbNW9Y4P4HjQ7ND,E47T4q4zMGzNL6vDxgWdLn3EQbW3WfVryr8Jsymy1hAL,True,46233739,11558434,69697,34848,34849,3zqXX6kzhkbW3d4TwD2CNjMRwxTbREXySekvq37kfCNk,2787907,26859666,-24071759,603
2022-01-21 17:58:24-05:00,6000,8nwpM4BmiMV8t2GgMnNy8zhPwBLM8xcBnCNTHyPySbuA,2bVCmJNzMi7ZqTfRB6Nwbk9omrY7urgPuDFvTVeVxc94,True,21409,5352,33,16,17,72FwbpFGoLEazJEdpqNtPNefsadUrimUqma9wSoy4qiS,1321,5973,-4652,617
2022-01-21 17:58:26-05:00,6001,4FazDUgfQ3AKoFcnWHr8E9Ht8jLA3tkxf75yrGZVHdmF,HzRMH6mbgEKydRCnnMvSsKgTEVNQi6nuzoR1xutYFdzg,True,4905,1226,7,3,4,3zqXX6kzhkbW3d4TwD2CNjMRwxTbREXySekvq37kfCNk,301,4908,-4607,613
2022-01-21 17:58:26-05:00,6002,6osqTNxgZv1Y1EjnVR7D1G4cywof1CrWswj87tAnktWV,Fah93R9W7SFuajFif4AbXDdxouWA5rrLz29vzVRGsMxv,True,998728,249682,1546,773,773,3zqXX6kzhkbW3d4TwD2CNjMRwxTbREXySekvq37kfCNk,61879,1165529,-1103650,619
2022-01-21 17:58:26-05:00,6003,DqBDL1BcCT99qqNXJeTbzP8pt6123zKKUrsX5DfPZPPW,FNaFupygF8timeWhwZkwDZ4YnsfGXA3pHqjzedda7RxN,True,1943759,485939,2975,1487,1488,3zqXX6kzhkbW3d4TwD2CNjMRwxTbREXySekvq37kfCNk,119016,445257,-326241,612
2022-01-21 17:58:28-05:00,6004,ECuu1L4QGdemZ7FjAjVAAxYN6piinweY7Fuk5csVovfT,Amd8WGcpdtB8yoA83R1BUT5uryuqoKbcBexYacbrbGVX,True,244154,61038,375,187,188,3zqXX6kzhkbW3d4TwD2CNjMRwxTbREXySekvq37kfCNk,15020,145291,-130271,615
2022-01-21 17:58:28-05:00,6005,4hrm69kAKNcfBkiP2YgtW94Pbip6FLfQAwnDRAAack69,BjbZRdGMoC7Mfoa4H19UvE2eQafgKD5rqnK7BSGwqS1s,True,2943,735,4,2,2,3zqXX6kzhkbW3d4TwD2CNjMRwxTbREXySekvq37kfCNk,173,1921,-1748,587
2022-01-21 17:58:28-05:00,6006,4mB2DVbQVqVk535v98Cj8SPNg1tTc3DFyY2Q7VBbY645,HXo255k3RgsTGsc4hiP6ZTXUspBTqJ37duQa5eK7tqp3,True,76465630,19116406,119098,59549,59549,3zqXX6kzhkbW3d4TwD2CNjMRwxTbREXySekvq37kfCNk,4763922,42103567,-37339645,623
2022-01-21 17:58:28-05:00,6007,4UGy8TajoMVzJNVVgyG5HHGseVNd6StrpA4XptQdm5Ej,9iRZ44dq3w9kMceCkbzwYQAPv6Wxnk2yKV8WDo7QXHfu,True,2306953,576738,3441,1720,1721,HfEnetJ7uBSmZWCjBNxdvv9HEC5nsW4wDV7wu6WnhWan,137644,1830489,-1692845,596
2022-01-21 17:58:28-05:00,6008,ioPHEVyheRnHYomVS7PmP6Coyhjk6LCs7hMD5Mq9Ngv,DYTpFmZ4yXVghKwkaovgCdpv3jfWkjtXRzxsZjKJfXNN,True,1923,480,2,1,1,72FwbpFGoLEazJEdpqNtPNefsadUrimUqma9wSoy4qiS,119,1246,-1127,618
2022-01-21 17:58:28-05:00,6009,FtF3PVw8YNJseWPMcA2GEuQZ6nni1mq5kYPa2LrSzfkW,4yr1TM2dXrBvLNMpSaoryuGU2P8D3WG1ZCkvVzWFiQRH,True,21811973113,5452993277,33935496,16967748,16967748,3zqXX6kzhkbW3d4TwD2CNjMRwxTbREXySekvq37kfCNk,1357419848,6572100269,-5214680421,622
2022-01-21 17:58:28-05:00,6010,AQr9mVmcXCNQhBVCfx63MwR6c4WqDSC9K2BZqr7N8LCx,CB7TWUaL381ounsLw6neAUaKRxJL9P1HC9uGX5e1Uxod,True,46025429,11506357,70514,35257,35257,3zqXX6kzhkbW3d4TwD2CNjMRwxTbREXySekvq37kfCNk,2820590,42960558,-40139968,612
2022-01-21 17:58:28-05:00,6011,9fTuwsgtFHkUNTTeRR1DWYTno8bbdvNLvqjxLymzbnTe,DacYn36aCNRJmYKiP697yGJTPZDK1nCq7Q1Y7KiXW7Jq,True,247372466,61843116,370311,185155,185156,3zqXX6kzhkbW3d4TwD2CNjMRwxTbREXySekvq37kfCNk,14812472,94937506,-80125034,598
2022-01-21 17:58:28-05:00,6012,8xQ3tsWVUe75EG1HmocULJ3kh52utveoFMEPotTGrKno,i3SKW3ywrwYucX9ySEx1C4zaUKGnzLerP3V38437NyV,True,11305826,2826455,17377,8688,8689,3zqXX6kzhkbW3d4TwD2CNjMRwxTbREXySekvq37kfCNk,695097,8734332,-8039235,614
2022-01-21 17:58:28-05:00,6013,CEbGTNX6WpaoKp4RBGSn9LzYM6yAYyeiMrgVYgJxA4zb,AiXUcGAFFm4tc7vKBscSNjZawV5YJqbv7D1KpxD3Zufg,True,1585188,396297,2331,1165,1166,3zqXX6kzhkbW3d4TwD2CNjMRwxTbREXySekvq37kfCNk,93240,1275389,-1182149,588
2022-01-21 17:58:28-05:00,6014,E9FFPvygPSF22u7gqFq4w6yE5kV15zbeGDXFQc349RsG,yi1REPVUwKhr5ss5YJc56crYz8LVfkqNVMpKcdSfwfY,True,133602,33400,204,102,102,72FwbpFGoLEazJEdpqNtPNefsadUrimUqma9wSoy4qiS,8168,64628,-56460,611
2022-01-21 17:58:28-05:00,6015,Es6UDmhJTnRsCUCFBtSfc4KYhFBPAVtBuX2EN2DS3FsH,J5gi9V4pQq4ke9tun4pf4oJPVtVPfYUKRX1RArAJMVLv,True,217702079,54425519,330928,165464,165464,3zqXX6kzhkbW3d4TwD2CNjMRwxTbREXySekvq37kfCNk,13237143,58483042,-45245899,608
2022-01-21 17:58:29-05:00,6016,8pjAmnuqsXh8eP7XWphZmeCKYPGc8J2ux6u9VEGjjkPp,Bv67SHZoVqFhDZ7QRQLTUi1NR9zUPD9T7uw1zmoAuuTh,True,1862431,465607,2774,1387,1387,3zqXX6kzhkbW3d4TwD2CNjMRwxTbREXySekvq37kfCNk,110972,1623203,-1512231,595
2022-01-21 17:58:29-05:00,6017,EgU9hX6VK7YXeCgCHVaJAMekCcyZa2MVWdKra5pN7Gwv,7y8Ad9XY34bqREvheXHT2tr8Jy11D6X3pu7yLVtjU4QV,True,792225,198056,1190,595,595,3zqXX6kzhkbW3d4TwD2CNjMRwxTbREXySekvq37kfCNk,47633,584377,-536744,601
2022-01-21 17:58:29-05:00,6018,DiPSJvnnEwg1En7HJfEsKrUbBgtUf4KzGMyMCZDQSYgp,s8UVC6vPBofuXUS6RW1aQmZ8C35PrC5r4A6ugmvzLGB,True,155574,38893,234,117,117,3zqXX6kzhkbW3d4TwD2CNjMRwxTbREXySekvq37kfCNk,9371,75536,-66165,602
2022-01-21 17:58:29-05:00,6019,8mbMH9EKd9kQDyFrYiDJCV9VaWxWCzpZBQZLyYN2yNVx,J9gT39dF1egMeQvweXYWeRAX3kpmBABijYZhfj6M2UqU,True,1950730,487682,2864,1432,1432,3zqXX6kzhkbW3d4TwD2CNjMRwxTbREXySekvq37kfCNk,114582,1103475,-988893,587
2022-01-21 17:58:29-05:00,6020,DXCbqHqSGrq8dG6CmA5JwKXQTidVBSqE8vCxHxNBcF2z,6z5Ghi47Miuie5Tn72rLp4uBf1EALB8wPsmzrtb1DwZS,True,7024938,1756234,10619,5309,5310,3zqXX6kzhkbW3d4TwD2CNjMRwxTbREXySekvq37kfCNk,424788,1831728,-1406940,604
2022-01-21 17:58:29-05:00,6021,HhwiZPKZBGa16oVi739s4qtMDMTwzWXc7iwNfX63t2UP,5AnbMbAFKy85yHt5y2M5S38nNkA1vT4ejY5NjGbRNUqn,True,110616,27654,171,85,86,72FwbpFGoLEazJEdpqNtPNefsadUrimUqma9wSoy4qiS,6855,96903,-90048,619
2022-01-21 17:58:29-05:00,6022,2bikYf33ZxxDmvkMNjWDGGqEpbYJPvWv5At3hzyeLEQK,5FtirUBjRAZ3k5arFFVwKz42ixWzhkEBLkaK9PraRZ78,True,11711,2927,18,9,9,3zqXX6kzhkbW3d4TwD2CNjMRwxTbREXySekvq37kfCNk,731,6665,-5934,624
2022-01-21 17:58:29-05:00,6023,FEKYaAbNo9UF62dkkV8JbV9HvHYsiBLmvQp561HEXWx6,2Bcc55F83cWDvW4X2QQMfgpZQZWMVZsMD3W98KNL8GqK,True,113193449,28298362,176617,88308,88309,3zqXX6kzhkbW3d4TwD2CNjMRwxTbREXySekvq37kfCNk,7064698,93851049,-86786351,624
2022-01-21 17:58:29-05:00,6024,9gYrMXAGmGSV4VFjXzYP5WwH2aFpB1TxA6CqpYsosKLv,Dh8aH6RK48wu4fkT9xKw5XL7itxnPDuw3SDwPwvL5sva,True,2119,529,3,1,2,3zqXX6kzhkbW3d4TwD2CNjMRwxTbREXySekvq37kfCNk,130,1364,-1234,613
2022-01-21 17:58:29-05:00,6025,9LZ3rShLfzErXsGkh4dYfAm58GNPWhK6ohDy5RrLJhc,41tLyuvuJ5M7YctkSASD2R7RGGetD7FmKaZUdkTdgXgt,True,115690,28922,178,89,89,3zqXX6kzhkbW3d4TwD2CNjMRwxTbREXySekvq37kfCNk,7125,56156,-49031,615
2022-01-21 17:58:29-05:00,6026,961Wz2gAzstN9CQjgoe22Htq41zJsYbn8T2pAJqUVo4G,66vPnY7rg7HS9VchM2H33BBqkZK53RDMbrQwj6gSMCdR,True,1355011918,338752979,2064836,1032418,1032418,3zqXX6kzhkbW3d4TwD2CNjMRwxTbREXySekvq37kfCNk,82593461,377610310,-295016849,609
2022-01-21 17:58:30-05:00,6027,4wYJCHSQDev9kD8UVUEy3gEm9owvBCmXLX8QfTAXSyfd,4AUFhPprSux7rN1DVv6KXKxAGVAevx2DwCEUCpx2BAaw,True,1847005,461751,2740,1370,1370,3zqXX6kzhkbW3d4TwD2CNjMRwxTbREXySekvq37kfCNk,109615,1074827,-965212,593
2022-01-21 17:58:30-05:00,6028,7T5Z5qX5petKARUrhAuB7xaWJPTKrcQTx9n63cM85Pvz,Hw2gx2SBkEj2SA4RE2hWETJNYmLUBqSZirAaRpuvMgH1,True,1659620,414905,2567,1283,1284,3zqXX6kzhkbW3d4TwD2CNjMRwxTbREXySekvq37kfCNk,102682,938062,-835380,618
2022-01-21 17:58:30-05:00,6029,2kqN3TbCDgM4x8XfZvKgqJvDAHqvZxtT89NcfmQSQa5b,8fEx56PjuPAP61CBnrsnnnQnZmt8cw6KVjhYDK1mWJzP,True,45620136,11405034,70133,35066,35067,3zqXX6kzhkbW3d4TwD2CNjMRwxTbREXySekvq37kfCNk,2805341,17090818,-14285477,614
2022-01-21 17:58:30-05:00,6030,GWkVXmZNQdcdWNNu8dvRqct4aMhLoDNqijrTvxbfEdKN,6LKRNbJv2XkyjJQKCFAqFRPzvANrRBSTmu8doRWqTicU,True,8671085,2167771,13558,6779,6779,3zqXX6kzhkbW3d4TwD2CNjMRwxTbREXySekvq37kfCNk,542330,3389599,-2847269,625
2022-01-21 17:58:30-05:00,6031,Sapmbypb7FUXhKQEdjyH2AUDgh8QWQ1mu6SSHm7673N,7AGij8bP7Kq3iARJ41duwggPrDfuXDoKwRSKV9SG8nk2,True,22421404,5605351,34866,17433,17433,3zqXX6kzhkbW3d4TwD2CNjMRwxTbREXySekvq37kfCNk,1394649,6390935,-4996286,622
2022-01-21 17:58:30-05:00,6032,87R8o8xLjHw2GpunYkm7pX7uJ8hjM4B1y4Qm7aQf6Yh4,48aSVPQoFYdncF5NtJ114urbdTzVjTgYLgPzMfpJbZB3,True,5111577,1277894,7785,3892,3893,72FwbpFGoLEazJEdpqNtPNefsadUrimUqma9wSoy4qiS,311435,6349921,-6038486,609
2022-01-21 17:58:30-05:00,6033,DYCYiQFH9QHzCo3eAw1pFoDu7pzwFMo1E2WDZjVFRz5w,CPh4FWsGak1kd1WFEH9qBjNhnun3R2tHtZA57zW8ugn5,True,5624186,1406046,8663,4331,4332,3zqXX6kzhkbW3d4TwD2CNjMRwxTbREXySekvq37kfCNk,346540,4153396,-3806856,616
2022-01-21 17:58:31-05:00,6034,HSZrdquqBs1gWQGSBcLGs4aa4ox27rLHh6KKmdHrgrVs,DywbuaDt997DQA1GT9GsLL8ML73CxQgHwMLw2MyG8m7M,True,1269208,317302,1977,988,989,3zqXX6kzhkbW3d4TwD2CNjMRwxTbREXySekvq37kfCNk,79098,388420,-309322,623
2022-01-21 17:58:31-05:00,6035,DJiXXW7sjNsAAxWupDKBUsFhXSgPoerVYaAtJqqNgVbn,2MsqvNuJw1xQhJ3UnXt9i7oNHDuZpR9w7iE1WQcGqt5m,True,11711,2927,18,9,9,3zqXX6kzhkbW3d4TwD2CNjMRwxTbREXySekvq37kfCNk,733,6667,-5934,625
2022-01-21 17:58:31-05:00,6036,93ho4cgnpAJiJsG6uu2udkLVNU7rkz4QjCYfsqvpbPA5,45ouQn9gGwXqnTGfaP5CvU8fCKadBRA5kPwtfvJzykRU,True,5074609,1268652,7696,3848,3848,72FwbpFGoLEazJEdpqNtPNefsadUrimUqma9wSoy4qiS,307851,2927121,-2619270,606
2022-01-21 17:58:31-05:00,6037,91tPxdvLhrVtytKuNkf33XocRnpEqA1x3jDb1Je6xeui,2ByoMpaZg1uzkA48vMufvcx8BLYxWLXUK3tXAJcupanF,True,2524,631,3,1,2,72FwbpFGoLEazJEdpqNtPNefsadUrimUqma9wSoy4qiS,151,1604,-1453,598
2022-01-21 17:58:31-05:00,6038,6BPPDj3BVgBPD3agd8b4B12d9Gvp4bFPXRWjzbtsmtRF,8VZnAwXPyKK2AHoMTZxKXthAiFMrL6b5EXAGqsAMTdhm,True,2524,631,3,1,2,3zqXX6kzhkbW3d4TwD2CNjMRwxTbREXySekvq37kfCNk,152,1604,-1452,602
2022-01-21 17:58:33-05:00,6039,6xbPoFjPYUcSejbTk5iiTZRWyZkicfkSzM1Fhbj3w9L5,7xTAbaXwhxxVY3TM88TLakPPwPyL4zT4TsVvtUvniVec,True,310335726,77583931,473794,236897,236897,3zqXX6kzhkbW3d4TwD2CNjMRwxTbREXySekvq37kfCNk,18951783,85455155,-66503372,610
2022-01-21 17:58:33-05:00,6040,Hc2e1tBoiCVKrbD7GvV5i8jgpcd219DoKJwokHvZQumE,xREhnQUqoWUi5HUxkehdh9qw7g89CgkrYemD9ZJYLaJ,True,14327,3581,21,10,11,HfEnetJ7uBSmZWCjBNxdvv9HEC5nsW4wDV7wu6WnhWan,873,9270,-8397,609
2022-01-21 17:58:33-05:00,6041,duKo8riX1qpX1K1qpgwZniMtUeWqu2eYgchTu5n7Rbu,9vAVwfVtdsaZMbeZvoymjHqwASeuM38gfEJkbTVwDqya,True,5354138,1338534,8357,4178,4179,3zqXX6kzhkbW3d4TwD2CNjMRwxTbREXySekvq37kfCNk,334299,3388818,-3054519,624
2022-01-21 17:58:35-05:00,6042,EuvK7bsc3hbxqeJjJkLELCvS7kruCMAGDctn5u7Q7BnP,Dv4XTdwnp6Sv5zxkSwRwsdSzxApDtBr4A13x4vvzTVjm,True,4165837,1041459,6257,3128,3129,3zqXX6kzhkbW3d4TwD2CNjMRwxTbREXySekvq37kfCNk,250296,2758664,-2508368,600
2022-01-21 17:58:35-05:00,6043,Gs3WP18hbzNpbBgiU39e6tfkggfCKRyNqPqJQcthuHFD,4XAY25YUma6gUdG2GdbXeivum3t21g93ZagfWGTZYkWZ,True,1488336,372083,2279,1139,1140,3zqXX6kzhkbW3d4TwD2CNjMRwxTbREXySekvq37kfCNk,91176,1006517,-915341,612
2022-01-21 17:58:35-05:00,6044,BJaaH1SK1pF2kZQzmYpLFfDtm52CR9a5rd39RAPtLe8q,HUsT5FVxaisdnCvG1BQxX6zffjfL2Rwx5mMo5y8SDV7e,True,10913869,2728467,16703,8351,8352,3zqXX6kzhkbW3d4TwD2CNjMRwxTbREXySekvq37kfCNk,668122,4525284,-3857162,612
2022-01-21 17:58:35-05:00,6045,6gFbxvPafnpqZjWW94MMmL8mGp2FHZGqoJC5fWqgwNxS,C6WcDycp3Ff3xYmb81i8JbD39Xv1o5G2AdtPs1FdXtr4,True,183977675,45994418,285208,142604,142604,3zqXX6kzhkbW3d4TwD2CNjMRwxTbREXySekvq37kfCNk,11408352,67684862,-56276510,620
2022-01-21 17:58:35-05:00,6046,J41kECimnpqjpS8nhNF8tAyGJFKoUr2FGKBsRbM4ae6P,CXGbaRB9isy46bFZ23HTDF1ULrLC3zfmuZwMkJYq8cjC,True,1080829356,270207339,1608876,804438,804438,3zqXX6kzhkbW3d4TwD2CNjMRwxTbREXySekvq37kfCNk,64355058,269658600,-205303542,595
2022-01-21 17:58:35-05:00,6047,921FBgLS3A1wA77uWitsnTvW737Q2jY7tzvgWtWLXNC7,E4eJ9H7cqP9zNpMH5xRBTAp9yaBCBihuJBNd6pqzteDG,True,11710,2927,18,9,9,3zqXX6kzhkbW3d4TwD2CNjMRwxTbREXySekvq37kfCNk,731,6665,-5934,624
2022-01-21 17:58:36-05:00,6048,CCHzYXr5zMXFu8MMZNkfUWGyUcF8xy7Vvhq7tNCtZg2L,AuEXkCJTTJ3HK8iP4qTWpQr4vp6HPRJZyZwfRjF8zjfp,True,11711,2927,18,9,9,3zqXX6kzhkbW3d4TwD2CNjMRwxTbREXySekvq37kfCNk,726,6661,-5935,619
2022-01-21 17:58:36-05:00,6049,BPRoaqrDs8vhqv2T7d9qV2oPU33pi1K1LUaotM7yuD2i,6qo8uQGAEwBfYQR36v6nRiqA2xGV6SjJAsXsdzy5bqNH,True,82817463,20704365,128499,64249,64250,3zqXX6kzhkbW3d4TwD2CNjMRwxTbREXySekvq37kfCNk,5139976,57482637,-52342661,620
2022-01-21 17:58:36-05:00,6050,5BjBPqumCb9KC82ZNNch3dcRzbpGdRLJneru7o9a1D9R,FuZtBWKktxFu4yoiLVMzxq8fMhQyN8SGzGPz49xs3m6P,True,11783437,2945859,17806,8903,8903,3zqXX6kzhkbW3d4TwD2CNjMRwxTbREXySekvq37kfCNk,712245,8686271,-7974026,604
2022-01-21 17:58:36-05:00,6051,7MSzV5yy5FmrM4j1BcYSRiTGWfit1AJahheRUaXzz349,aPSTZLxBpVr3sucjbj95emRV2J1GrUWr7wbARYqJkQZ,True,356118,89029,539,269,270,3zqXX6kzhkbW3d4TwD2CNjMRwxTbREXySekvq37kfCNk,21589,200728,-179139,606
2022-01-21 17:58:36-05:00,6052,Avok5yeEYbNXwtBCqqb2y3WRnGgoXeuGKCtUBYxf3N7U,Byms3hWr4yaf3TYW8HALsNvhFhMgLYwvdpiKqJqegyVY,True,5265075,1316268,8217,4108,4109,3zqXX6kzhkbW3d4TwD2CNjMRwxTbREXySekvq37kfCNk,328715,4374043,-4045328,624
2022-01-21 17:58:36-05:00,6053,HkRKcvAWLM5sCDL6a5DvYsH55bg5BnZnyP9WwX7wLUDF,GXtDJS8BCoZKnvviGaUb2QfKs2LQQZPMa9564tf5Jq8Y,True,121993597,30498399,189892,94946,94946,3zqXX6kzhkbW3d4TwD2CNjMRwxTbREXySekvq37kfCNk,7595706,51191699,-43595993,622
2022-01-21 17:58:36-05:00,6054,HjkXypCkrCSprGVXBkrbHMZJji2gMToLvCLweRhcH7Vs,2ddyaPR86fCsVf4VJRG1VdZgdkY84TzXb8NMPqRyDqzV,True,57797410,14449352,90341,45170,45171,3zqXX6kzhkbW3d4TwD2CNjMRwxTbREXySekvq37kfCNk,3613664,17776591,-14162927,625
2022-01-21 17:58:39-05:00,6055,3onLoSaH9BskwjFu4nbEFykBsDaFgKgWVHPqdSUjHraw,D3YAuBorbpirBJmvhxQvFJbQPRycWyyymjsvm8GDetv3,True,63280519,15820129,98927,49463,49464,3zqXX6kzhkbW3d4TwD2CNjMRwxTbREXySekvq37kfCNk,3957086,54047166,-50090080,625
2022-01-21 17:58:39-05:00,6056,2p2fGXdKrmxjomLSnyaNg84J82cBBBNympZ6qQc8UZgU,HKAM8bazuLMUY6yapZJqYsgaWkTBqKHyMs1hSfpYsZGi,True,64872883,16218220,100559,50279,50280,3zqXX6kzhkbW3d4TwD2CNjMRwxTbREXySekvq37kfCNk,4022370,49702838,-45680468,620
2022-01-21 17:58:45-05:00,6057,9k5YHTFCHczFg6KAZXf2ostkFLH7WdVAxiA9zCGRprg3,2b52r1TA8dkJsnuMuM9cNfGxKEynd42WjQUuzcQTRcD9,True,5092,1273,7,3,4,3zqXX6kzhkbW3d4TwD2CNjMRwxTbREXySekvq37kfCNk,317,3304,-2987,622
2022-01-21 17:59:09-05:00,6058,AM5fwZR9BUW8AFkhdGWXW4PHd2cy8ora63kDf2z2eknw,E7ru6hg4MchnRG5zcr5YazwX8Snt55r5Xq9zCHCGaYZT,True,76287,19071,119,59,60,3zqXX6kzhkbW3d4TwD2CNjMRwxTbREXySekvq37kfCNk,4769,55179,-50410,625
2022-01-21 17:59:10-05:00,6059,4kbcrzH6o2LvLUCNphyL52i8uGzVD8wcUNEqoQ14z3VG,5Q1atmEBs2AqaDZsiZFG5stHzj1fE6ZvypgfkEc9LYqE,True,14238574,3559643,22050,11025,11025,3zqXX6kzhkbW3d4TwD2CNjMRwxTbREXySekvq37kfCNk,882016,11547489,-10665473,619
2022-01-21 17:59:10-05:00,6060,7W6ih2ZGXaE6tvuQFUPCvc7NvEJHy7UffgoVX3ZPdLXt,6uQCkeMjEXHBQxE2HD33RM1zyTsSko1fYZA1mWUggJ5B,True,2055,513,3,1,2,3zqXX6kzhkbW3d4TwD2CNjMRwxTbREXySekvq37kfCNk,128,1364,-1236,622
2022-01-21 17:59:10-05:00,6061,DdEiAJ4pcXU213GVEa5KeDonBXZhTV7zeNcKigEQwN8Y,FoAs2bsVjQFKaJW7dpVKMxoJf7Qe5PcuH6i9jJzAR5e1,True,54664598,13666149,84826,42413,42413,3zqXX6kzhkbW3d4TwD2CNjMRwxTbREXySekvq37kfCNk,3393040,15083241,-11690201,620
2022-01-21 17:59:10-05:00,6062,FpqCxvTkSiwDwD5qEt6hXJxzFDLFLAQ8VevK8zwRqYun,A3p6YQisCJKpNkF7vkjZRbEfbnUt7vTZdR2zPBUSdTkk,True,32768069,8192017,51173,25586,25587,3zqXX6kzhkbW3d4TwD2CNjMRwxTbREXySekvq37kfCNk,2046956,19398850,-17351894,624
2022-01-21 17:59:10-05:00,6063,3g1debT8Z2efQPuMNSDPUNZzDqarBG2acErsZ4HP7QGA,42wDHagxr5Nno3mUx6kyYGDjwR98aedRbh3ByB468agB,True,1513,378,2,1,1,3zqXX6kzhkbW3d4TwD2CNjMRwxTbREXySekvq37kfCNk,94,981,-887,621
2022-01-21 17:59:16-05:00,6064,AA9zFZTXqBR8Mw1fwEH59edzBiswoGasRNWsi6aLeysB,4VeitxYqqtRxyfdSVpshdJ3EDcgksRVnaHvAqWxTeujH,True,135772,33943,211,105,106,3zqXX6kzhkbW3d4TwD2CNjMRwxTbREXySekvq37kfCNk,8475,65933,-57458,624
2022-01-21 17:59:17-05:00,6065,5jin5wXjQQ25nGM2ECrCXcg1a95vquh6kM7rMRru6Ke7,EKM657EQ8HWWgf4cssByoYHoXGjFfTspTKXAGmygAPQG,True,3002103,750525,4694,2347,2347,3zqXX6kzhkbW3d4TwD2CNjMRwxTbREXySekvq37kfCNk,187785,2211763,-2023978,625
2022-01-21 17:59:18-05:00,6066,6CeKxTJvFqhyNEyzySiBBKEwYVMe7j3A6nkMes4BW6o2,DzDR9XvwY1z7ygQ8YrCXrwDGHSf67JZF8BzUnuFE2fxQ,True,349350,87337,544,272,272,3zqXX6kzhkbW3d4TwD2CNjMRwxTbREXySekvq37kfCNk,21768,206827,-185059,623
2022-01-21 17:59:18-05:00,6067,6xikA6d7sjCBnSfqkFwrL4nPrtQUNWdRhXB7i1AccnxC,G8t7u2R9qjRfdTdULs74v3nVrTM2WeKvc4dK4FFAvuG1,True,2989854,747463,4668,2334,2334,3zqXX6kzhkbW3d4TwD2CNjMRwxTbREXySekvq37kfCNk,186723,1276981,-1090258,624
2022-01-21 17:59:18-05:00,6068,7g4NJBHwDTRm58GqX7Tz1JzqwbAhF6EWJUQH3SoDxSf7,82Ypv7STZeSCBPf3HckWdyatELpvaDaWxFXhD5dNSML4,True,1860,465,2,1,1,3zqXX6kzhkbW3d4TwD2CNjMRwxTbREXySekvq37kfCNk,115,1208,-1093,618
2022-01-21 17:59:19-05:00,6069,Ehw3RgdbzyAHHddgSv7F6f3WtYhyBtRg2ropQaWGgwcL,GGw3xDe5jKd5UNB9bPLqp2xzw2SKz7CMg358Fy7UypDL,True,1338788515,334697128,2078116,1039058,1039058,3zqXX6kzhkbW3d4TwD2CNjMRwxTbREXySekvq37kfCNk,83124675,594711216,-511586541,620
2022-01-21 17:59:19-05:00,6070,4D7mDXe7SdmbAx7kaD1mBNuEa7DzMi6TAwXURxtLEazk,5pSnT91PHoLdN6uhPnUtoD7cboLmndn26y1XouPx8vwW,True,118388,29597,184,92,92,3zqXX6kzhkbW3d4TwD2CNjMRwxTbREXySekvq37kfCNk,7368,67130,-59762,622
2022-01-21 17:59:20-05:00,6071,GH6Q9E1jZPTTp46aDd57UNZPNS2D6PBSwyLL3EHSjGn2,2XvwZXNsrPWx4EfPvhTP933bzCC3SJHDQ8xARfrXdVY9,True,1576094,394023,2446,1223,1223,3uL2NSR2ZdDqCiKfzA5SwwpddAnit22DBJo6uvvz1rRs,97879,1821762,-1723883,621
2022-01-21 17:59:20-05:00,6072,DAku12iueL13vRoTpKLyqdGaLQ2rWF6REe8Dr8soFvNs,H2vVH3LxkhGe6x6Mdwy67BYwTKNQM6XayKx7mhrwyfJM,True,35599,8899,55,27,28,3zqXX6kzhkbW3d4TwD2CNjMRwxTbREXySekvq37kfCNk,2226,26768,-24542,625
2022-01-21 17:59:20-05:00,6073,8VnGmfop6qcUezAJ2M15jz2Nn6mPQgehDcJPvypq4XJn,6F6sqXNhgkW9ev8QNMm4ydywUUmemhwgydRQYNeqyUmi,True,845236,211309,1321,660,661,3zqXX6kzhkbW3d4TwD2CNjMRwxTbREXySekvq37kfCNk,52843,989410,-936567,625
2022-01-21 17:59:25-05:00,6074,3Lv2XpiD4KBUHq7Zx6u3zNhpXoySodXHH8o8f5yaaPxG,H6TN4rhpBXkEH3mZnymYNcKfmnxRH2uzfwzeLH2q6ahP,True,14907,3726,23,11,12,3zqXX6kzhkbW3d4TwD2CNjMRwxTbREXySekvq37kfCNk,933,9969,-9036,625
2022-01-21 17:59:52-05:00,6075,5nauZoaxftcYR591YH4v52myeJLnXtY4okdttL9qSdkg,7x3G299D3bC7EwUQojhTXUv29BG4NGzrLbgS4mEyqG5r,True,36888363,9222090,57150,28575,28575,3zqXX6kzhkbW3d4TwD2CNjMRwxTbREXySekvq37kfCNk,2286010,15448774,-13162764,619
2022-01-21 17:59:53-05:00,6076,7uHMFnppZKtV7nAySv8UGcoGTSQ98RVz1GP47dsFWpYr,FmS9WPYVTT8i4agyidApdLnoHAUMfdRFPnAVJQUwfWr5,True,136880615,34220153,213394,106697,106697,3zqXX6kzhkbW3d4TwD2CNjMRwxTbREXySekvq37kfCNk,8535791,46660936,-38125145,623
2022-01-21 17:59:53-05:00,6077,3njiRuSRMXRzKmamyiR72Hc38PU8UDDmWdfPhgxmGxEW,5WoF3gkgygyNNbwxWgVfqGWkExcDixuzgJQQjXEZQ6J5,True,20344236,5086059,31679,15839,15840,3zqXX6kzhkbW3d4TwD2CNjMRwxTbREXySekvq37kfCNk,1267181,19721333,-18454152,622
2022-01-21 17:59:53-05:00,6078,8hpAXzimCw2bTwLXoRFAbqNW8qoj5VV3JDYCuJwqHpHm,DkfsL2M7oRBX6grAfy15C4urwL6ToMJ7TWJEFAGhWjYX,True,737772,184443,1141,570,571,3zqXX6kzhkbW3d4TwD2CNjMRwxTbREXySekvq37kfCNk,45655,308017,-262362,618
2022-01-21 17:59:54-05:00,6079,H6fVnghBUSJRKp2mxSG7Fq2Lr4dE3YMS7yM1XTrxoe3Z,JjgtLi79grUZXofhWukB1yNXZkXFMUX5jm9HcXNDsB6,True,2418777,604694,3764,1882,1882,3zqXX6kzhkbW3d4TwD2CNjMRwxTbREXySekvq37kfCNk,150598,1291036,-1140438,622
2022-01-21 17:59:54-05:00,6080,ES1MDwRUa3hoToPKQiiZkzMYe9PDVnAQwMrEvZrzvnc1,C4wBG3xTDkmDQneB28xYnf1aBNEeq7UB8oR7NuEfLkFg,True,2195676,548919,3417,1708,1709,3zqXX6kzhkbW3d4TwD2CNjMRwxTbREXySekvq37kfCNk,136712,1244506,-1107794,622
2022-01-21 17:59:55-05:00,6081,BTouoY9doTYwX8wAa6QcZHzJjfZfEAtiLYR2JHKd5V8Z,H4ByqCdZy7AMx7VJZEwQwQmZLVA8vHg55C7ypwZwv67u,True,1689817643,422454410,2632207,1316103,1316104,3zqXX6kzhkbW3d4TwD2CNjMRwxTbREXySekvq37kfCNk,105288306,691630822,-586342516,623
2022-01-21 17:59:55-05:00,6082,2QStaRnbSnDhA891Lb1bxjVeMYpJUpNdqaVkw3rqU45V,DakRWPnttPoRcjY5V7WLwiwBx39BapCo9Atog8dL17Ku,True,180574,45143,279,139,140,3zqXX6kzhkbW3d4TwD2CNjMRwxTbREXySekvq37kfCNk,11180,97881,-86701,619
2022-01-21 17:59:55-05:00,6083,AHm7zF4rpaxaayBLn5QDHgJSp8KAr647s4cNvQ9wLgd7,FDM33WngED24pukBvSDpPAzinW6afVAeGReum5nyLRiC,True,66059,16514,102,51,51,3zqXX6kzhkbW3d4TwD2CNjMRwxTbREXySekvq37kfCNk,4095,49815,-45720,619
2022-01-21 17:59:58-05:00,6084,6u6bPgAmK8ufACrQV99A1Y5nhGkue3KEUHmQQkcNkxwP,7636yXT5w4DcVpc7LJdN46aiggzSq6U2GXHXL5kyy9F3,True,9458891,2364722,14605,7302,7303,3zqXX6kzhkbW3d4TwD2CNjMRwxTbREXySekvq37kfCNk,584200,6958676,-6374476,617
2022-01-21 18:00:00-05:00,6085,Fd2HrzBAr4JobRPARZwpQHHVoSCEoog32A6tKMWAC1sK,BYappsar5sQf8VLem4wrLuTtrDFH9y8pEx1aMxfuU4Pq,True,2401864,600466,3669,1834,1835,72FwbpFGoLEazJEdpqNtPNefsadUrimUqma9wSoy4qiS,146781,1760666,-1613885,611
2022-01-21 18:00:04-05:00,6086,6yw4GPvkqUbakcEWtqSCfjVLukty11xqjDpGxtEN9Km2,5ppEx7wkpqbG5nApCWMdRja3oRSheFmAAsNHUX7h2w2Y,True,131736,32934,202,101,101,3zqXX6kzhkbW3d4TwD2CNjMRwxTbREXySekvq37kfCNk,8085,156627,-148542,613
2022-01-21 18:00:05-05:00,6087,F2v1YwVAwXLiUgsJ5uwn4qAAkTXitn1E75fJcPnGuAcy,5rdJ4H5GxPg4Juu77mGc7uya5LwEqLzDSRyG8mQ2mDbK,True,1538162,384540,2337,1168,1169,3zqXX6kzhkbW3d4TwD2CNjMRwxTbREXySekvq37kfCNk,93481,1127465,-1033984,607
2022-01-21 18:00:05-05:00,6088,LNX7AwwiGpuaXA4J86d1xqqtF6kD7qbCusssSZqtpKd,45a5FGVssw2NoGipB7NRN4XDLPob4GHNxSM9fqgsTpqA,True,68948415,17237103,105942,52971,52971,3zqXX6kzhkbW3d4TwD2CNjMRwxTbREXySekvq37kfCNk,4237716,26950330,-22712614,614
2022-01-21 18:00:05-05:00,6089,EFHg5FatMRRSZnKJPJF9e1iw2cjPJRmwTTZYtkHno9DP,84LnLKhZDJgWFnbBYnYjqWkjymemXfidecPFwnUAvuFj,True,171883450,42970862,263677,131838,131839,3zqXX6kzhkbW3d4TwD2CNjMRwxTbREXySekvq37kfCNk,10547087,96905408,-86358321,613
2022-01-21 18:00:05-05:00,6090,5RvNKzSeJ1fvqsKpcQu25evEZGmKjyEDgwsMZkykoT3P,BRqSGfE4XHXu4HrinwetWumfVTmr82iuF6Y5oSV6eMiK,True,11700,2925,17,8,9,3zqXX6kzhkbW3d4TwD2CNjMRwxTbREXySekvq37kfCNk,719,6663,-5944,614
2022-01-21 18:00:05-05:00,6091,2jDRvE3pQNjWy1NRFa4tzB3KmU5UkbUCHw8sQRFujo66,C4zNi2szDrEEh4coTF3WRUghfP4ZwAVVSYTLWfkejQRu,True,53899515,13474878,83860,41930,41930,3zqXX6kzhkbW3d4TwD2CNjMRwxTbREXySekvq37kfCNk,3354402,30517734,-27163332,622
2022-01-21 18:00:05-05:00,6092,Ayx8dFsVzUBb9b7QKxw7YHJuhptdSitBXFEczXTaxe85,EvU1VLChnowi6ccSPeJRSk65njrqZfYouAN7SHePxsxf,True,1867,466,2,1,1,3zqXX6kzhkbW3d4TwD2CNjMRwxTbREXySekvq37kfCNk,116,1410,-1294,621
2022-01-21 18:00:06-05:00,6093,GGGyesjbt7h2XHHp9u8vpiWGugFwEbrtYaKrNQSDhQd7,8tydo1ZjGHmPBSqU33tywB3f9szdsHk1ckGFe4Ay5pgs,True,4025412,1006353,6204,3102,3102,3zqXX6kzhkbW3d4TwD2CNjMRwxTbREXySekvq37kfCNk,248170,4210745,-3962575,616
2022-01-21 18:00:06-05:00,6094,5SskSWkRPP5BNaqvHkJCbTAgHPUkHEwFh5pFr4t8PoBr,EqdX8Sdm9LCfdrzVKzisKaFcP2YEdSRNZYmev5RWjGqb,True,312492,78123,480,240,240,3zqXX6kzhkbW3d4TwD2CNjMRwxTbREXySekvq37kfCNk,19200,132149,-112949,614
2022-01-21 18:00:06-05:00,6095,EmGW2aAG69ssWqCtbfDocRaM2u3TJsczn2HHP9jdmRvD,aypkDKsp9uqAB4F6mwvm5LofpsrFBuZT2MMWtE2eHdB,True,51505,12876,79,39,40,3zqXX6kzhkbW3d4TwD2CNjMRwxTbREXySekvq37kfCNk,3198,36255,-33057,620
2022-01-21 18:00:06-05:00,6096,HqYn1PU7foJ9daTJMbd19LjTqWR2vQ1XqMEmffM2kCFA,8o6U7rDTtzSvywjzENEZSDYxCf7XK85rueCYVM4vZjY1,True,43621882,10905470,67105,33552,33553,3zqXX6kzhkbW3d4TwD2CNjMRwxTbREXySekvq37kfCNk,2684223,35481539,-32797316,615
2022-01-21 18:00:06-05:00,6097,C2Dmfw4G8KKzFq38aRH2pLCRngnGZDvUUN3fHDMjFkoG,7kzJk3BTNvY3hGFNj7nDy9L5CAYus6eNiCAxWH8dSioX,True,29600,7400,45,22,23,3zqXX6kzhkbW3d4TwD2CNjMRwxTbREXySekvq37kfCNk,1820,25783,-23963,614
2022-01-21 18:00:06-05:00,6098,2F45BX9mRmtNCHPejKFknN5aNgGvR4vVLFjMaY1a7dR8,ALdSutsvEFRUEQGGBbi31QywTL1pdXSDWrNJzvNTaoXL,True,2000709,500177,3129,1564,1565,3zqXX6kzhkbW3d4TwD2CNjMRwxTbREXySekvq37kfCNk,125199,1423724,-1298525,625
2022-01-21 18:00:06-05:00,6099,HdRgh9niYSd3YKCxzGdusYFquiVoFTP2mEGEzJJL5Nii,78C68Gbb1jYFQmYNCHHjL52keEKMXtGukmBwT7ahon4B,True,1683941225,420985305,2609477,1304738,1304739,3zqXX6kzhkbW3d4TwD2CNjMRwxTbREXySekvq37kfCNk,104379085,972064420,-867685335,619
2022-01-21 18:00:06-05:00,6100,D2L7ST8iGsRfZ4zj2pdfKTptbojQ4cDtHKQ8ngcFVQwA,7cNrHGWJ6FGGazfGaCePs8XyaK6bwVLrYFCUJQi9w2Wc,True,5396,1349,8,4,4,3zqXX6kzhkbW3d4TwD2CNjMRwxTbREXySekvq37kfCNk,334,3483,-3149,618
2022-01-21 18:00:06-05:00,6101,CYv2hNAzvRak1LBSayFxMJEXoAQdMEZHnNpQLZ5G5RVo,HkvTQbtKxWv2E5z6MsViv1LS4jm8T286fiY1C7n6ZZ9C,True,677856992,169464248,1043446,521723,521723,3zqXX6kzhkbW3d4TwD2CNjMRwxTbREXySekvq37kfCNk,41737859,533772903,-492035044,615
2022-01-21 18:00:14-05:00,6102,84SgzR8J6DeqPJ1uXphP1BHMotYGKh3kS4owMMj9x58x,CL7Jkwe3NK4qaAVK2QjuftXnQ5YLqDT9qYeeEi7kJXrV,True,30238313088,7559578272,46636051,23318025,23318026,72FwbpFGoLEazJEdpqNtPNefsadUrimUqma9wSoy4qiS,1865442041,23094749281,-21229307240,616
2022-01-21 18:00:14-05:00,6103,5PVUmELKMD7mf2vbXbiXXsiZW2myGmZuMe757raBAj8Y,5eikdsebvyBh27aPz9t9KPswYWd8X4Cbk2TSiif6vn36,True,751576660,187894165,1152446,576223,576223,3zqXX6kzhkbW3d4TwD2CNjMRwxTbREXySekvq37kfCNk,46097856,590402814,-544304958,613
2022-01-21 18:00:14-05:00,6104,2FrqGFZjbiNykJyo9BZ5S9FguQJPJiTi681rJJsQ5dta,3QUncYP92NKrfpaTvuF9iQg11PXKgZAgEngwh6BbnCCj,True,65838,16459,100,50,50,3zqXX6kzhkbW3d4TwD2CNjMRwxTbREXySekvq37kfCNk,4016,42563,-38547,609
2022-01-21 18:00:14-05:00,6105,BAczoNDnbwj5AJX5LwzynzYab7ji7VbhRy9edA9Prax,34sbkUKnMetUNyMs6BhiWut85d5UZtBWnPtwx8jEpJNA,True,103588,25897,158,79,79,3zqXX6kzhkbW3d4TwD2CNjMRwxTbREXySekvq37kfCNk,6325,71665,-65340,610
2022-01-21 18:00:14-05:00,6106,BjyZWwz1ARSfmPkHXHBzehq5NsH4DRJiu4zFMkqsKu6A,7WUCSZ9SnKDsbomDRZ7CKsHfHJFwboKJwFFdaGkBURBS,True,389339277,97334819,597435,298717,298718,3zqXX6kzhkbW3d4TwD2CNjMRwxTbREXySekvq37kfCNk,23897404,234561128,-210663724,613
2022-01-21 18:00:15-05:00,6107,WMUVFELv3C3KdMKJ5ZL4rG7o1YrV1qTP6Mmp2S5Rp8S,7UNzS3zDqT1oeq9a7eJGU8cgf8eUzEAZubSBQvNmK6uJ,True,1446847,361711,2234,1117,1117,72FwbpFGoLEazJEdpqNtPNefsadUrimUqma9wSoy4qiS,89360,578427,-489067,617
2022-01-21 18:00:15-05:00,6108,CCi9urfx5bFFMazAAVz1WtJzJotHA8E1i8RrtgMP97Fp,2DFvm5fZj29qvqoLmbReUaisd9qBTNUfuE7HgmmHUc7w,True,6329405,1582351,9903,4951,4952,3zqXX6kzhkbW3d4TwD2CNjMRwxTbREXySekvq37kfCNk,396128,5238070,-4841942,625
2022-01-21 18:00:15-05:00,6109,6dr65yANjSMmfBeKAuSxG3i16S9vMgF1CQ3zDyzh55Pn,EhrE5QpnshD41S4zPEBy2A5q2Gs2mwUrbHGo6WnT9zDP,True,26664,6666,40,20,20,3zqXX6kzhkbW3d4TwD2CNjMRwxTbREXySekvq37kfCNk,1625,20068,-18443,609
2022-01-21 18:00:16-05:00,6110,6tFQaTqqffino9kwMZTL2xVNBG8k9VREFhXqVi2si3A3,3w3wGxBbS4bmXeqmvd595SAWFeXekVpnH4UdbeEs8Sx5,True,349401,87350,533,266,267,3zqXX6kzhkbW3d4TwD2CNjMRwxTbREXySekvq37kfCNk,21346,206356,-185010,610
2022-01-21 18:00:19-05:00,6111,9zpPiboHF5HW7NfCx7hYdmJGwUomVMTiUFc4Um5KrDi3,8q3eBpuwV6dMNkib9N8XQAq2tBUcjSANRe5SXpd4dFhZ,True,654707,163676,1015,507,508,3zqXX6kzhkbW3d4TwD2CNjMRwxTbREXySekvq37kfCNk,40609,365717,-325108,620
2022-01-21 18:00:19-05:00,6112,AATMHH4e4B6SL9bThnXGktzWuqWkPdx3JbRXk8HwkbPW,6F3u2yLx7P9gtpAAXASx7uF8xNyVBgJiKosMKUrgpicA,True,19958251,4989562,30956,15478,15478,3zqXX6kzhkbW3d4TwD2CNjMRwxTbREXySekvq37kfCNk,1238260,13032675,-11794415,620
2022-01-21 18:00:19-05:00,6113,8NdcaYUC1X5CP7FMDip78uqtqmCt8GcZdCzLRTYTihmb,9Ei1K9bXWXSXcBfeX5exPSXGCAu62WSKzvnnd4wHvyVh,True,10474,2618,16,8,8,3zqXX6kzhkbW3d4TwD2CNjMRwxTbREXySekvq37kfCNk,640,7082,-6442,611
2022-01-21 18:00:23-05:00,6114,9UyQC8vc6zJJaSdnjvTAzgmcsw4fC3xFBBiCC1w9Sbjx,3ppBfboe6FPmt7f6WrivspMUoAznZKWQMeh3rCgw7vjQ,True,714690,178672,1116,558,558,3zqXX6kzhkbW3d4TwD2CNjMRwxTbREXySekvq37kfCNk,44666,398951,-354285,624
2022-01-21 18:00:25-05:00,6115,E8ifvhmyJGBGVQomo3AnZw2UcaLHcpGsTtuoCid8voU3,FMQUWTbTAfSLfrc6GTrz4DM2ZSgoxF3KtqGn8AyjVtsf,True,567520,141880,880,440,440,3zqXX6kzhkbW3d4TwD2CNjMRwxTbREXySekvq37kfCNk,35235,331452,-296217,620
2022-01-21 18:00:25-05:00,6116,6Y1UoGwrKyKsScZQm9ng1rNrXXykKT82V7kUopc43kAy,8YtWQTTKymCESbPMWCP9TMehbMU25zJMtxt9grqrpbD4,True,3042018,760504,4722,2361,2361,3zqXX6kzhkbW3d4TwD2CNjMRwxTbREXySekvq37kfCNk,188882,3553451,-3364569,620
2022-01-21 18:00:55-05:00,6117,J6jBKPDR6R5cLMqLufw3zoVfheNYs1KF7C4Ft2dakXeA,6wTTLK675Ym6toJRp7tYaUZzisWfgGjSp3X3yJ31xiKt,True,11307617,2826904,17346,8673,8673,3zqXX6kzhkbW3d4TwD2CNjMRwxTbREXySekvq37kfCNk,693840,5108246,-4414406,613
2022-01-21 18:00:55-05:00,6118,4vW2Q76fdGmfhU2Tx3R2XQkGcQUi6hSM9ixvK5RWvurJ,w8cGbqVpVr6WHSRJFXv469RMgRB3ty3TGpkVXRs7K7H,True,15045097,3761274,22877,11438,11439,3zqXX6kzhkbW3d4TwD2CNjMRwxTbREXySekvq37kfCNk,915080,5243483,-4328403,608
2022-01-21 18:00:55-05:00,6119,A1VornXbzK5rFgsy9D4qThcPnYVP8AB9RRzWsV1h6L17,9M4dQgz1zWrtKHqZMt9w7PbM9CvmyjhY5ZZ6jjajMzqm,True,7577692,1894423,11753,5876,5877,3zqXX6kzhkbW3d4TwD2CNjMRwxTbREXySekvq37kfCNk,470151,2867295,-2397144,620
2022-01-21 18:00:55-05:00,6120,3MEiFqy4F9nBW8gHxvGjv7norSBHwxhbzzNKngPk1RHq,2tcsJ4NUJegcEfHNwWPh979yKjKmq568CpNm5iWGbuoR,True,3747797,936948,5840,2920,2920,3zqXX6kzhkbW3d4TwD2CNjMRwxTbREXySekvq37kfCNk,233613,2003162,-1769549,623
2022-01-21 18:00:55-05:00,6121,DXEJNyHSCbGZezXHy2xQaSzd37dwJs4dMTgt5VF5UZAG,7fCYM9DWrAX7vgZ11CwQMNd5NU8FB1yrbctxHaPYshpB,True,7116634,1779158,10647,5323,5324,3zqXX6kzhkbW3d4TwD2CNjMRwxTbREXySekvq37kfCNk,425915,2800524,-2374609,598
2022-01-21 18:00:55-05:00,6122,8abFwhhZyq3xkvjp4NWDBt7qAPXBbzBxksUk8SAUeVkN,A9u4dhWZbBwthC4WXQg1Dfp3wHYXr67SGs5na1EQ1k3r,True,11836544,2959135,17896,8948,8948,3zqXX6kzhkbW3d4TwD2CNjMRwxTbREXySekvq37kfCNk,715848,3729886,-3014038,604
2022-01-21 18:00:57-05:00,6123,DDsY5V3F9wnEGBoQFCEf1hvEYuKUaJdysbc7TxhNqe9G,5oBCGzvy8odB8MCxCUvPDqYCnTyteZ4Yy1JDroroygbi,True,11374668,2843667,17291,8645,8646,3uL2NSR2ZdDqCiKfzA5SwwpddAnit22DBJo6uvvz1rRs,691652,4322811,-3631159,608
2022-01-21 18:00:58-05:00,6124,4WSiQCTqMvpSYvrbenQGFoV6fuDALSWMwZZ9MgP82fwb,6Y5GdgKErVfXrabSTi89X7xCEsZnoqDqwFD4hZ3FVtfN,True,18152940,4538235,26863,13431,13432,3uL2NSR2ZdDqCiKfzA5SwwpddAnit22DBJo6uvvz1rRs,1074527,11345660,-10271133,591
2022-01-21 18:00:58-05:00,6125,B9WJfmrYEkVH3L1UWz4qqWpaexHydymbzvEfwNVtB9BV,6mQb4yzGq8jE1NbweKCKSbevnnYVhHYxyc6Gz2a5kJLn,True,51874268,12968567,80323,40161,40162,3zqXX6kzhkbW3d4TwD2CNjMRwxTbREXySekvq37kfCNk,3212938,18463681,-15250743,619
2022-01-21 18:01:21-05:00,6126,DRVtEzZs9u9ysrcANZLEjrvbuuGqYn77v2h4cDFKuNUx,Fv9qiMZhuSBL2cs9AWUYbDLQjB46W2ZwrhxaNXtPLDpC,True,13534417,3383603,20793,10396,10397,3zqXX6kzhkbW3d4TwD2CNjMRwxTbREXySekvq37kfCNk,831742,3470484,-2638742,614
2022-01-21 18:01:21-05:00,6127,6qDAr9rGtFMeiTx9KfAeu3WBqiZzRzEtMfipFaZ2gQiJ,MGfCsHXhA5C6S28qKoQjeZmn28dehGUJ4MLSaic7CfB,True,4296581241,1074145310,6491632,3245816,3245816,3zqXX6kzhkbW3d4TwD2CNjMRwxTbREXySekvq37kfCNk,259665292,962574051,-702908759,604
2022-01-21 18:02:03-05:00,6128,9vcKW1GfrDZ3KLPh2pEVFF8ZyKqD1pJW1hiE8H98Av7S,C6Ki27mo4sCHu6u8UnR1p7WSgsTjFQxGGR9Lk9n5Rhjq,True,222317,55579,347,173,174,3zqXX6kzhkbW3d4TwD2CNjMRwxTbREXySekvq37kfCNk,13910,161789,-147879,625
2022-01-21 18:02:05-05:00,6129,4cKgCTttVp8pzJnp43PP7uLLUXNcU7YGPJ3cCGHaUFe7,BBQqjwTpVEgpDzMk4wDDH8rCjaSxCRPWVhtFxERSujTD,True,3237070,809267,5061,2530,2531,3zqXX6kzhkbW3d4TwD2CNjMRwxTbREXySekvq37kfCNk,202479,2145742,-1943263,625
2022-01-21 18:02:05-05:00,6130,CRaKcudjkQiSw5YPVjTLVdXvJskeGiHSYtq5ZcMPJhgQ,AgqTg3b3bAcaBmRidhNC4Uf9ZwNbeH52RQEqumWyuUs7,True,69286,17321,107,53,54,3zqXX6kzhkbW3d4TwD2CNjMRwxTbREXySekvq37kfCNk,4301,60431,-56130,620
2022-01-21 18:02:05-05:00,6131,J4krKPBBTMVLZRgrSeYJAMyHQs2FkNm5TXk7nQWwDB43,ASmLbfNbhTD2HHeV7qzAqiHjUx5a8Traj8oPDwbkMdFg,True,2261767,565441,3470,1735,1735,3zqXX6kzhkbW3d4TwD2CNjMRwxTbREXySekvq37kfCNk,138818,1360829,-1222011,613
2022-01-21 18:02:05-05:00,6132,A3E9T7xYkPeNiWKdvhNTYiD5j7k2Xecpe318eFqVro4m,2QJk8iVJEy2QZmbFHnR7RBJsi7NpXWFFkEmweWtKKHfE,True,155499062,38874765,234681,117340,117341,3zqXX6kzhkbW3d4TwD2CNjMRwxTbREXySekvq37kfCNk,9387241,119876948,-110489707,603
2022-01-21 18:02:05-05:00,6133,DdYgcyV1T2CDYiQVr4VL9Ym8RdKm93a7SKy8HxuyaoMW,GPdAeqeXb1UJ56AttcwwY1CyFhRyfptDC4BAX2Tc8MpE,True,42065,10516,65,32,33,3zqXX6kzhkbW3d4TwD2CNjMRwxTbREXySekvq37kfCNk,2616,31822,-29206,621
2022-01-21 18:02:05-05:00,6134,Ht2oWgWWVsA4u5fwp8o8dwgUjoGSRDF2gAwQPDXCwKfZ,8pYWhoNFpmDYuawZub9rd5qkSsAJuPGeJwoa23YyVVym,True,4306452,1076613,6477,3238,3239,3zqXX6kzhkbW3d4TwD2CNjMRwxTbREXySekvq37kfCNk,259093,3573053,-3313960,601
2022-01-21 18:02:05-05:00,6135,pgzvXpnUYiY7hLrfjmwScqLd8oj9vYcXpFvpm4y4JvG,GdqdQgoyBAFuXdbvoZyDhB3jyqJzVo4nkGh7EPFxkBF2,True,168622,42155,257,128,129,3uL2NSR2ZdDqCiKfzA5SwwpddAnit22DBJo6uvvz1rRs,10298,202105,-191807,610
2022-01-21 18:02:09-05:00,6136,7jvKp6onXyWgwsFrFWj4hYTXJsYYD6ot5mn6rPFuJriy,J7N6HiozevJVTiY9hDEUs2ud5BwT5QSE7wnMBS1w5ie2,True,4827332,1206832,7402,3701,3701,3zqXX6kzhkbW3d4TwD2CNjMRwxTbREXySekvq37kfCNk,296117,3497290,-3201173,613
2022-01-21 18:02:09-05:00,6137,H1LftKtj94Zs6PG2A7gJt9rPurBkXkTy2hbbArQwAehi,8bANmhgdnPYa3PqdPnk5BA2xhvqJmPyaMF77mrBePJ13,True,3048,762,4,2,2,3uL2NSR2ZdDqCiKfzA5SwwpddAnit22DBJo6uvvz1rRs,190,3348,-3158,623
2022-01-21 18:02:09-05:00,6138,CvZssqscu2dm35mwcE3zg9zedavbRjVJjWD59Py5ExUK,7pXaoR6aHKYofCmg1eHipygNYDteEaf8rbbS8BDYGQK6,True,55985,13996,86,43,43,3uL2NSR2ZdDqCiKfzA5SwwpddAnit22DBJo6uvvz1rRs,3441,33171,-29730,614
2022-01-21 18:02:09-05:00,6139,6nJyqvFKprwaVCE1gAa2P4RHKc6Pa6XFSJymx654zZ9K,4e7iJmdwzAPxp1Zi8Azo38YyPQdPKqqY4VLJyQ5rpdYP,True,199386,49846,310,155,155,3zqXX6kzhkbW3d4TwD2CNjMRwxTbREXySekvq37kfCNk,12413,151744,-139331,622
2022-01-21 18:02:12-05:00,6140,BjCNaM7YbE9SjFi7tzi4677zg1fKXGJwtecz2GWwWuhd,6rNsSrKZezQrLb2whToNjnizpnurDXrobHqfEK3QqU1M,True,7591631592,1897907897,11874072,5937036,5937036,3zqXX6kzhkbW3d4TwD2CNjMRwxTbREXySekvq37kfCNk,474962907,2300379210,-1825416303,625
2022-01-21 18:02:15-05:00,6141,BZxJ6CtrVoiU86DMMieMeDFLNWtMpHGTvZfM7nyay6o4,6CRxRR8bisRLHFJBFWjyumYuy7j4C4PkjYH1K8gXhdWD,True,577267,144315,896,448,448,3zqXX6kzhkbW3d4TwD2CNjMRwxTbREXySekvq37kfCNk,35879,266376,-230497,621
2022-01-21 18:02:15-05:00,6142,2hirR46fpyHEg1Fv9vAzYgnoNRBWaky7LoFGVof4DnpK,DXTEHauVDdz4Mjjj6sJHPUh6TnzU6ob6Nj63To2vCNPW,True,180242225,45060556,281401,140700,140701,3zqXX6kzhkbW3d4TwD2CNjMRwxTbREXySekvq37kfCNk,11256061,57089561,-45833500,624
2022-01-21 18:02:15-05:00,6143,67Z7ZGhNu5xxEh9BYKWcXp9m1T4tFiE1o1M16hCzUWQA,CT7YKWixz7BhTbvg5F6M5HCyPGnHoFLNFuDV9GhoLTo3,True,259893,64973,404,202,202,3zqXX6kzhkbW3d4TwD2CNjMRwxTbREXySekvq37kfCNk,16173,217804,-201631,622
2022-01-21 18:02:15-05:00,6144,brCL9pzP6q4b6rKgAH1AJbMoqffBWyXLX8oAnZDoi77,Dx4G5UP9jTb47JQypWJnv48mPTzhJvqPD1BtBtDT7TJF,True,646362,161590,1006,503,503,3zqXX6kzhkbW3d4TwD2CNjMRwxTbREXySekvq37kfCNk,40275,224483,-184208,623
