ts,record_id,user_authority,user,partial,base_asset_value,base_asset_value_closed,liquidation_fee,fee_to_liquidator,fee_to_insurance_fund,liquidator,total_collateral,collateral,unrealized_pnl,margin_ratio
2022-01-24 05:51:18-05:00,10241,2pKygdXJnjZBFfrZgDasmHQQgw8LgycmBBRuaoCU72cz,DXsomQ5yWw2ceZMbaCVsSaE4hKm9W6Gy785JG75Aaz18,True,943516,235879,1472,736,736,3zqXX6kzhkbW3d4TwD2CNjMRwxTbREXySekvq37kfCNk,58892,540502,-481610,624
2022-01-24 05:51:18-05:00,10242,6mCEvqP1YwHZNUT9orECs4tE3YzfD2Hfa5FTt9TLo8DH,ApWyeUDzPp6TBczuStvXxEAivhVVJrqC1rodNTNKNFR3,True,4311154,1077788,6720,3360,3360,HfEnetJ7uBSmZWCjBNxdvv9HEC5nsW4wDV7wu6WnhWan,268823,2562007,-2293184,623
2022-01-24 05:51:19-05:00,10243,B5CTBTggmGFvGFSunjbB4C9tLKcYcULehmEiEXRihY2J,FX3ebF8P89rZBWfR74PDWUzxnLuDkUDgGcPYCBD5sMUG,True,11743088,2935771,18262,9131,9131,HfEnetJ7uBSmZWCjBNxdvv9HEC5nsW4wDV7wu6WnhWan,730495,7007906,-6277411,622
2022-01-24 05:51:34-05:00,10244,7FB6X8YgiDn7YK9bZZmcFyzhuvVLVWPCfBbenwMXhx5,2EaDCpL9MpAKuiC2bvUCGRfvqYvgVXGFHXt35QdNakfG,True,783620,195905,1222,611,611,3zqXX6kzhkbW3d4TwD2CNjMRwxTbREXySekvq37kfCNk,48884,320692,-271808,623
2022-01-24 05:51:35-05:00,10245,33CE2t84MhG7SMsphhZaxvwFVRbK5wcUMUdEw8UBhoq8,DjNko7SbbK9nQT4K5oBWKiSiXiYS9Rv1k5vT3PNiMyaf,True,781330,195332,1220,610,610,HfEnetJ7uBSmZWCjBNxdvv9HEC5nsW4wDV7wu6WnhWan,48818,601441,-552623,624
2022-01-24 05:53:22-05:00,10246,8JtUn4uue4WzrySwnDQ74qzzWaKsoo11MbMvRh1ePDJN,8iahKConWg6fyZrkoze5eeujyNHA26AybYBpHwUr76Cu,True,11841793,2960448,18457,9228,9229,HfEnetJ7uBSmZWCjBNxdvv9HEC5nsW4wDV7wu6WnhWan,738282,8079278,-7340996,623
2022-01-24 05:54:18-05:00,10247,72woixtGAuGazCMfsYfYBYLP7FuRj8Fwz9fynFo4MCE4,5237BmWkKf58PBeTUEiu3Ld5uKXEe8wcrJRmCnUoWWku,True,3764018,941004,5873,2936,2937,3zqXX6kzhkbW3d4TwD2CNjMRwxTbREXySekvq37kfCNk,234941,2441668,-2206727,624
2022-01-24 05:54:57-05:00,10248,DkvR2xUPMyXWGGkUSmDSfhp7RtvMkfbT1ThKCS3TwrXd,F7jYV6TtT1LZ5XCNn1zkbUfNMo4gGcQUczAQy1jLHpaW,False,8002611,8002611,381258,19062,362196,3zqXX6kzhkbW3d4TwD2CNjMRwxTbREXySekvq37kfCNk,381258,6762006,-6380748,476
2022-01-24 05:54:57-05:00,10249,HHHj6EinpgAJeZkDXfsvCo3UXnmAdiAZNvPSUfVPc5Sg,3gx9c31MDtJtByxkUuWcqf1oARnZTjpx3QtxsM1Xb6Gp,False,9856324,9856324,436587,21829,414758,3zqXX6kzhkbW3d4TwD2CNjMRwxTbREXySekvq37kfCNk,436587,7128011,-6691424,442
2022-01-24 05:54:57-05:00,10250,HwosLQgDY1xtHQRQ4hzroPQHFWssPzTj5vRkP37FcviB,HKTNEYNXrephNkH7apbobK4mcQXcNayQA4W1NgM6sLr8,True,609160,152289,910,455,455,HfEnetJ7uBSmZWCjBNxdvv9HEC5nsW4wDV7wu6WnhWan,36434,412462,-376028,598
2022-01-24 05:54:57-05:00,10251,8xvLGVeDmhVYQhN2ZpWkVG9jCrukRsNQ4926a4TMiZqa,9ciBySSjvADwp47WkETiFWZKVTFL8Hf1XvK7aSxhcgQS,True,245031,61257,351,175,176,HfEnetJ7uBSmZWCjBNxdvv9HEC5nsW4wDV7wu6WnhWan,14067,206969,-192902,574
2022-01-24 05:54:57-05:00,10252,6pUtYz474QrpATEZnfb3iFbTKYA65pNyKAo4TQZAjtqe,8dipRUXvxJiDLdHEtCPkso4vErbVwshHQiRfvSngBS9J,True,4704151410,1176037852,6824650,3412325,3412325,HfEnetJ7uBSmZWCjBNxdvv9HEC5nsW4wDV7wu6WnhWan,272986038,2100879509,-1827893471,580
2022-01-24 05:54:57-05:00,10253,7CSCMFa9W52tBDVUbXbc3woAy3GByeA1wPJdp3MgznPa,3447ptuVFu6G8B6N63RmS8mRv4n9PfHneypHLvbeaGLn,True,415325,103830,617,308,309,3zqXX6kzhkbW3d4TwD2CNjMRwxTbREXySekvq37kfCNk,24690,424671,-399981,594
2022-01-24 05:54:57-05:00,10254,G5NLYTLxDZfJFKsJdMeWS8Ez95ZFwR5AX4hKhnfVJvoE,AwrC3pKhTeEDr1HCTWoKWjadteZccvqcisbC7vxTjn7w,True,5264711,1316177,7800,3900,3900,HfEnetJ7uBSmZWCjBNxdvv9HEC5nsW4wDV7wu6WnhWan,312019,5461891,-5149872,592
2022-01-24 05:54:57-05:00,10255,9WJBnVi84E926j7xEd566WzrZJkPJWRgmEnYj9vyjuad,4dLaFS5F7TGyLdwuJLMGkz3bSL53aHzd9ZfpNmhHxXeF,True,202112,50528,254,127,127,HfEnetJ7uBSmZWCjBNxdvv9HEC5nsW4wDV7wu6WnhWan,10186,192828,-182642,503
2022-01-24 05:54:57-05:00,10256,EitU96ThqHErybDn2j1NY6JHkqV1R3mWM1uWH7wYKr1T,2p9eYbLyBqXrhHtRKp1jJb7VGjCmb4LkA6kzqLr1ijet,True,1537910,384477,2172,1086,1086,3zqXX6kzhkbW3d4TwD2CNjMRwxTbREXySekvq37kfCNk,86905,1062282,-975377,565
2022-01-24 05:54:57-05:00,10257,78EeyPYzQjrmW6z9VGhRci6ihMUZb5rtpXo3GAxugf55,9AgZ45TMxaqwWGVWSgnEkvio3s6fXtHjAVRVCA7Zgsd2,True,546114,136528,806,403,403,3zqXX6kzhkbW3d4TwD2CNjMRwxTbREXySekvq37kfCNk,32259,389676,-357417,590
2022-01-24 05:54:57-05:00,10258,5acohGZShYQVNGZEfy7pTyX7E8MzqRDwByhFL1H53UNv,4Z454ZseKbWGEtdrE9eotbDZ7o9VHhooMYriTfSFHiGt,True,77759791,19439947,111924,55962,55962,3zqXX6kzhkbW3d4TwD2CNjMRwxTbREXySekvq37kfCNk,4476961,30676115,-26199154,575
2022-01-24 05:54:57-05:00,10259,5eMLdQ4gYA5iqvTXSNdGvctHp7s5VpyFuwtJKqx6chBc,Ckxc5K39nkBNXBTmFTM8J48R7wGqNm3vHKZu4G5baumZ,True,3221986,805496,4709,2354,2355,3zqXX6kzhkbW3d4TwD2CNjMRwxTbREXySekvq37kfCNk,188376,2410944,-2222568,584
2022-01-24 05:54:57-05:00,10260,95yx3SCWcW9Cp8oSEDV68kGXRKWGyNdYUtNb5UnWMGBD,7PncaFWqW2iKR6EUKf78EW6LLZr7ZWU5b2d2rP22fsU3,True,2686583,671645,3979,1989,1990,3zqXX6kzhkbW3d4TwD2CNjMRwxTbREXySekvq37kfCNk,159170,2218694,-2059524,592
2022-01-24 05:54:57-05:00,10261,3ogBPSRcKfmwzgumVDHBkXLi1eCsEFG2xzSJgD4LQDNy,7TXyqWgJqfe71MSWFA2n7ufZbUdzf7JJoWej8FNNtMXo,True,207140,51785,309,154,155,HfEnetJ7uBSmZWCjBNxdvv9HEC5nsW4wDV7wu6WnhWan,12383,165927,-153544,597
2022-01-24 05:54:57-05:00,10262,Cv5oVktxmqbU1SxraxH67NEWMKnjgA18R832Fhe9h74a,Cs7xBD4BDiohyopnaYDDChUtR9vmx7uwot6Qp9beQLzt,True,11843991,2960997,16791,8395,8396,3zqXX6kzhkbW3d4TwD2CNjMRwxTbREXySekvq37kfCNk,671668,5159298,-4487630,567
2022-01-24 05:54:57-05:00,10263,DY6k3Dkwe18iLneaT8Xo3VpJWB6V4jWwQQjoDvEzdg2j,3GGV7S9FpRQGbARBXkvGFVqLrmw8JvYAcpnR1aKVUY2f,False,162664,162664,7731,386,7345,3zqXX6kzhkbW3d4TwD2CNjMRwxTbREXySekvq37kfCNk,7731,169212,-161481,475
2022-01-24 05:54:57-05:00,10264,CYkojG4q1SnizNs59qsYTEBU1c11XC8nteMhxRbwhCBq,A9MsPy3aeMzdQUWXK6qmWLiZfKREiBrSVaJAKp2nEcSt,True,221012,55253,323,161,162,3zqXX6kzhkbW3d4TwD2CNjMRwxTbREXySekvq37kfCNk,12946,175692,-162746,585
2022-01-24 05:54:57-05:00,10265,GufVttJatW8NLeztT1NRQSLZpQNRk45kaG41p3QcWhx7,GTJUsWoWRyeafYJVhx2aRo8NE94U5UrBjaehmJ4PRUhn,False,367898,367898,16799,839,15960,3zqXX6kzhkbW3d4TwD2CNjMRwxTbREXySekvq37kfCNk,16799,250132,-233333,456
2022-01-24 05:54:57-05:00,10266,GYgxUfZ19oSyHuovGRA6gBJT32goSxCrKR8hQQdBsrRG,2r8c6SU74hRq7xEmYBJ92WoSB6v6XCAXR3JcDznfCxkN,True,285185867,71296466,410858,205429,205429,HfEnetJ7uBSmZWCjBNxdvv9HEC5nsW4wDV7wu6WnhWan,16434351,237488992,-221054641,576
2022-01-24 05:54:57-05:00,10267,6kqKSyVVF4xxUbsvBCkY1kt4XcKzb98eSaqNw5fxSLtw,4T9DKFUmkcPG7mM3CKzW3m81LqqpU7oFTv35Pha4zHNe,False,21769980,21769980,982153,49107,933046,3zqXX6kzhkbW3d4TwD2CNjMRwxTbREXySekvq37kfCNk,982153,17167232,-16185079,451
2022-01-24 05:54:57-05:00,10268,Frobc1KZTVcsyfwyKwSpHJobxmiJBomzHhGCLdrzdAz8,HziyKP9uxWCuXddtbRzWMczHNdgyQB5UXQZj4MnMm14,True,1000429,250107,1492,746,746,3zqXX6kzhkbW3d4TwD2CNjMRwxTbREXySekvq37kfCNk,59704,673176,-613472,596
2022-01-24 05:54:57-05:00,10269,FgQrRo4eGQAonSsFfQgnp8trGGqGZCLeGX6yvJnMnTjd,8KhemHLBY6nGmo3xMDedW2wnCSxQq6LwbTExif4sUSxx,True,18073011,4518252,22711,11355,11356,72FwbpFGoLEazJEdpqNtPNefsadUrimUqma9wSoy4qiS,908458,8062934,-7154476,502
2022-01-24 05:54:57-05:00,10270,3vh8kCnb8sL3uvCELRoASWf7uxJLz3uNJ5baCxaf5x8p,BaySYuamXrAqX52tJu3ESK6pa2WvKwQfKbVZQhhPePic,False,23375510,23375510,1060787,53039,1007748,HfEnetJ7uBSmZWCjBNxdvv9HEC5nsW4wDV7wu6WnhWan,1060787,18685909,-17625122,453
2022-01-24 05:54:57-05:00,10271,8swGZMrPrLAxZd7MxTbkCL13k3DmAJUw41jCp6Xo6awW,3fKnX7yTNXAT4uMmXVdTy47ALJT8h8YSD3WiBb4BGuzH,False,3047910,3047910,139862,6993,132869,3zqXX6kzhkbW3d4TwD2CNjMRwxTbREXySekvq37kfCNk,139862,2616182,-2476320,458
2022-01-24 05:54:57-05:00,10272,Dcitj55ABpkgXvpnPCssy8GgKF46xd1GLaRMyPWoW6G8,62znTXs74bywWfcXptJkvwYuuTxgen8bhYaCnG8Z7y2B,True,329611717,82402929,415835,207917,207918,3zqXX6kzhkbW3d4TwD2CNjMRwxTbREXySekvq37kfCNk,16633408,181737557,-165104149,504
2022-01-24 05:54:57-05:00,10273,HpDwBPWZHfLzJUvTTABTA6qddyLLJiVTfqBx5gUktSUb,BqXLpaAeTNfNSeevfdazNqTgqEXj6Edgp8txWvCoxEz6,True,8584930,2146232,12401,6200,6201,3zqXX6kzhkbW3d4TwD2CNjMRwxTbREXySekvq37kfCNk,496041,8428462,-7932421,577
2022-01-24 05:54:57-05:00,10274,ATS5VRAN1aPKBiATDcUs5yd6yVuTmWqrqqRFNdfz6DZT,7VKq4rZLEtY2dhDFZMTQMvCYyJa1ASM9RHobUaYhHWAe,True,3255642,813910,4961,2480,2481,HfEnetJ7uBSmZWCjBNxdvv9HEC5nsW4wDV7wu6WnhWan,198451,2309244,-2110793,609
2022-01-24 05:54:57-05:00,10275,CxLFMBDFkoMvpK9YUf7WtCq6hn7k3QACAuetAnGjU6KA,2gE52a1GWQnS6ifV6eVtKQyr13LXP5Jdt3yG9SjGPJPF,True,15986321,3996580,20062,10031,10031,72FwbpFGoLEazJEdpqNtPNefsadUrimUqma9wSoy4qiS,802511,8574400,-7771889,501
2022-01-24 05:54:57-05:00,10276,4rwzdgkP7REWtQxRf9ftWKYXs1QoZQQBo6YQvNJYjZBY,4EmBTVv6MbdPC6WqTNrSABrP9aTZPrDSPxy9a2KbVgqu,False,1436274278,1436274278,68572685,3428634,65144051,HfEnetJ7uBSmZWCjBNxdvv9HEC5nsW4wDV7wu6WnhWan,68572685,676546876,-607974191,477
2022-01-24 05:54:57-05:00,10277,9otCHuzKcxUCC4EgPJkio8Df5gXWB6DtZQnZvWtPfsh6,8cNPdP8rA9sBpcKpmCNcp4W2AYonYdFNoyVmboT6y1Bb,True,86590494,21647623,116280,58140,58140,72FwbpFGoLEazJEdpqNtPNefsadUrimUqma9wSoy4qiS,4651209,38299866,-33648657,537
2022-01-24 05:54:57-05:00,10278,9UKMqQgFYdJb5vXVqPhA8CAMRY1eifgWivANiKQqj3yb,DpE3uNQUZbyYnqjpfHWqp9CHqPBs2uTQLRM6AtzF6Por,True,3261208,815302,4765,2382,2383,72FwbpFGoLEazJEdpqNtPNefsadUrimUqma9wSoy4qiS,190621,1550982,-1360361,584
2022-01-24 05:54:57-05:00,10279,9gY3X17t7jarkWhnSEHPR51U9nVv8Dv99NqpCi3ewuPf,4Z6TdTW1d4JFRZqZyWA9X7upKhJwVPSfTQjFp14M59uv,True,36938720,9234679,51324,25662,25662,3zqXX6kzhkbW3d4TwD2CNjMRwxTbREXySekvq37kfCNk,2052984,41052001,-38999017,555
2022-01-24 05:54:57-05:00,10280,AUH6YGBV8tDVX1E1WTo92Mubfx1DGsqfGeyUBqxo4fSr,33QZgMwmW32WuvmxD8XNbmF9ea88bLe3YTtNwHV73Wwu,True,2751393,687848,3718,1859,1859,3zqXX6kzhkbW3d4TwD2CNjMRwxTbREXySekvq37kfCNk,148752,2027862,-1879110,540
2022-01-24 05:54:57-05:00,10281,8eTH6eJyyVeMno3UQkffeBg32xofKsQfkhLhXdtaf87s,BCFC7CPXrQPsUfJb2eYSht8GhaApWHpc49AeCXqaYq13,True,2945643,736410,3800,1900,1900,72FwbpFGoLEazJEdpqNtPNefsadUrimUqma9wSoy4qiS,152036,1564512,-1412476,516
2022-01-24 05:54:57-05:00,10282,GGcsY84pkqUn2xySuLYrUUg8gWMBWgfHaQ7rK42NoZaH,4EyjJvctL9WBQiauD2Eaf2Hus8htYzHxP5GR2HsUfuks,True,42388897,10597223,59644,29822,29822,72FwbpFGoLEazJEdpqNtPNefsadUrimUqma9wSoy4qiS,2385762,24550892,-22165130,562
2022-01-24 05:54:57-05:00,10283,6VJcr3VAEcEZaHEpt48QL8QxHKABufVp8n2JSEVTLh9U,8naR6kiySKj3vai9dCetdgCnCHgf2oyLjGqKTJ3Lz64Y,True,31898126,7974531,45504,22752,22752,72FwbpFGoLEazJEdpqNtPNefsadUrimUqma9wSoy4qiS,1820179,27617514,-25797335,570
2022-01-24 05:54:57-05:00,10284,3VdSA9CED9f5swRwHX2U15U7J6Muaq8VPnCNy9CaGDHe,2YYstfnfdYic5NWmEbcUEHpccNUVd1EhuCkExvMsoMk8,True,66038,16509,90,45,45,72FwbpFGoLEazJEdpqNtPNefsadUrimUqma9wSoy4qiS,3606,69182,-65576,546
2022-01-24 05:54:57-05:00,10285,2pMGfXreJV4ZGoQtRyvhdE8TFccLhkguLb7JsjGnyr7p,7FVhyNsmwmSKF8H73YfLmx6ASLw9G13r3LXDnRqKjWKL,True,4976934,1244233,7474,3737,3737,72FwbpFGoLEazJEdpqNtPNefsadUrimUqma9wSoy4qiS,298962,5868275,-5569313,600
2022-01-24 05:54:57-05:00,10286,6NJFN855M3Q3RLTDNo57gTgAmwPD6G2E3WvMb1m5eNCN,3YpqNnonsvXaRT4nCC3G5FZx1jjVtbDPc36LiR6WK5jR,False,996775,996775,43742,2187,41555,HfEnetJ7uBSmZWCjBNxdvv9HEC5nsW4wDV7wu6WnhWan,43742,1034586,-990844,438
2022-01-24 05:54:57-05:00,10287,H3394S5wdbwXB4scjGAY8NsXxCdGy1Xebct18s42FM1K,Hz84L1EquzhCvBJP75ScKug46hYGdNMVNH16AdG4y5D8,True,618610,154652,843,421,422,72FwbpFGoLEazJEdpqNtPNefsadUrimUqma9wSoy4qiS,33726,498682,-464956,545
2022-01-24 05:54:57-05:00,10288,4ULhASByyNafHdp8HFAu8F7JWU8vZY73gmk11wWGpBH7,5GWVtW86nA33hveEygKzjCqeMkRNb8J6RsGrbzVad8nJ,True,162076149,40519037,204733,102366,102367,72FwbpFGoLEazJEdpqNtPNefsadUrimUqma9wSoy4qiS,8189358,93428449,-85239091,505
2022-01-24 05:54:57-05:00,10289,5inuJkWfHc2MtCqy2toH5VR4VzT43A7t2wTagA2ft91B,6kXdkHMTcY1PodfiSdMGX7X4KqvcTJWMf5amCskLPCXy,False,5110190,5110190,238317,11915,226402,HfEnetJ7uBSmZWCjBNxdvv9HEC5nsW4wDV7wu6WnhWan,238317,3588930,-3350613,466
2022-01-24 05:54:57-05:00,10290,CbhrZUdan1axNDFUrX1ZuEohfNMEGrszKSkk6pppVQuw,DHEAjJNtuEePezYAv77thWabbVxxqQpfuiC6moRSrpG1,True,909275,227318,1335,667,668,72FwbpFGoLEazJEdpqNtPNefsadUrimUqma9wSoy4qiS,53437,948103,-894666,587
2022-01-24 05:54:57-05:00,10291,8T4WK27RvWVGqPuNqY6whk1fmU4vd5qaUQPZG1GJ79bh,DvSz7knS8N3K7L6JhQf1s4mJSyxB8uJXNQXtyjJn8QRL,True,1215205,303801,1730,865,865,HfEnetJ7uBSmZWCjBNxdvv9HEC5nsW4wDV7wu6WnhWan,69215,1069966,-1000751,569
2022-01-24 05:54:57-05:00,10292,D9VKhnfLLCrntDGFYSfoxFaY76VnHmYZ1ZbyFXdKdibz,2hRCRH2pMDyQGYcXHa8Y6BZo6FbcGZf5VJC1v8Bp6tGa,True,1210630,302657,1585,792,793,72FwbpFGoLEazJEdpqNtPNefsadUrimUqma9wSoy4qiS,63415,951901,-888486,523
2022-01-24 05:54:57-05:00,10293,HSF97F9d5EPgx4kGYuG4AfwHnh6bovzyTneYUouszBQp,Bh8fR6QoGS1ykk27256kFb2gjCVbQtu8Nu4Ls7GEKSAs,True,5877721429,1469430357,7869772,3934886,3934886,3zqXX6kzhkbW3d4TwD2CNjMRwxTbREXySekvq37kfCNk,314790890,4432069461,-4117278571,535
2022-01-24 05:54:57-05:00,10294,BgnsCfJ54ReunUtwPJLzkW4PWnqpBDWGNYxsW5PvDrbK,KpMqEkQ9dKMgCevsEK895wHd3fCLRPSzDmJSv3tKU4u,False,190830160,190830160,9551424,477571,9073853,3zqXX6kzhkbW3d4TwD2CNjMRwxTbREXySekvq37kfCNk,9551424,148309250,-138757826,500
2022-01-24 05:54:57-05:00,10295,A36aouot1oFLUtswuBUM4EVcis9chKaSJu53MRoPDjab,33U9gpq1RRFMGWDrWa3ezXXkwgBewdAS6QGgGVPtGvqb,True,3545458,886364,4936,2468,2468,3zqXX6kzhkbW3d4TwD2CNjMRwxTbREXySekvq37kfCNk,197441,2572808,-2375367,556
2022-01-24 05:54:57-05:00,10296,72L76qDRMK3M7X52zuuB9GVyvFFLDBZwFMpVjWjghXzA,4m2ZVuemUctu1edv4YJVAcjXzKwpbCmBujzoUmLDeA7h,True,4662600,1165650,6128,3064,3064,3zqXX6kzhkbW3d4TwD2CNjMRwxTbREXySekvq37kfCNk,245159,2489465,-2244306,525
2022-01-24 05:54:57-05:00,10297,6rpuf35EHPrQ3LVPUcdfRTh3igu9wvRcfvoA6uSMNmYq,B1aor5NFukbUeT5tzi9oXgRGxcRoojff8sfbwzmwywBq,False,3479217,3479217,170001,8500,161501,3zqXX6kzhkbW3d4TwD2CNjMRwxTbREXySekvq37kfCNk,170001,2130786,-1960785,488
2022-01-24 05:54:57-05:00,10298,8E3K7vCHJ2xjdFofPRGLbMxrkm8UYEi926QmXPAFwsqe,4qHUDA1c43Dg4qi1ZPKqmpGYiEMUZ6r4UuzB5ftHCEhW,False,18654597,18654597,926739,46336,880403,3zqXX6kzhkbW3d4TwD2CNjMRwxTbREXySekvq37kfCNk,926739,17951242,-17024503,496
2022-01-24 05:54:57-05:00,10299,AWvHDdb2ikqV8wc7qQ8azbvNTZdixMNxhQjhQdhayYtR,9EpgEPBb1nog6aQeFdMXfSRiLSnzGQFQ39mbLdCxgYTv,True,454199,113549,632,316,316,3zqXX6kzhkbW3d4TwD2CNjMRwxTbREXySekvq37kfCNk,25315,318622,-293307,557
2022-01-24 05:54:57-05:00,10300,J3ggP7ZxL8HRh3CBp5iYG2WgjLyNSAWYT46uC9VYDLCz,2FqTRiRPiLvdAH2BS5vroVntpsSXvTJEn5UHWmtKHzh9,False,386279,386279,18687,934,17753,HfEnetJ7uBSmZWCjBNxdvv9HEC5nsW4wDV7wu6WnhWan,18687,272180,-253493,483
2022-01-24 05:54:57-05:00,10301,m7gf1jAYXBZjRZEY9w4MjPfhzLwgDKaXyaCVhRD6C5E,Aa2aTZnpPux1i5K2MT4i1TsVM8vR7qR7rZGijQW4zpwd,True,1425995779,356498944,2066873,1033436,1033437,3zqXX6kzhkbW3d4TwD2CNjMRwxTbREXySekvq37kfCNk,82674954,647153038,-564478084,579
2022-01-24 05:54:57-05:00,10302,8otVEtwXkAdnt5XmBzL8hmzAgRcaDDxiuqpRxY6ZhR24,7333dFedtBjo3yhbp2bU1XbAfdDeBvvCd9QKitYVUU7v,False,143088148,143088148,7114194,355709,6758485,3zqXX6kzhkbW3d4TwD2CNjMRwxTbREXySekvq37kfCNk,7114194,44054057,-36939863,497
2022-01-24 05:54:57-05:00,10303,A4tDE948CPFPh1UwHb8sXryfKktbxZ8BCkqXgA5DJHA8,3zXeKMrsEpCe5fQumLNzCgpxcG1kLJFEAtJuqxLsC6ZG,True,1139477,284869,1450,725,725,3zqXX6kzhkbW3d4TwD2CNjMRwxTbREXySekvq37kfCNk,58033,989196,-931163,509
2022-01-24 05:54:57-05:00,10304,4Eh2J8pz6nSz2E2BaPSMbDNhEovGA4QRmNtzAJPw9ZRi,CrHeEQC5KpQFLGhz2EpLYWgk7kWsqLPvEfLsSQvUxv61,True,9281826,2320456,12425,6212,6213,HfEnetJ7uBSmZWCjBNxdvv9HEC5nsW4wDV7wu6WnhWan,497023,7035580,-6538557,535
2022-01-24 05:54:57-05:00,10305,zLTuMVfVswjMkhyvjaXnvjcKXv5xNk3iSWSjRGpVqXf,J3D8NHUJCiSjvFYfJ5Es4YDhF1KcPZWRUmCQ5L92t8eB,True,4193356,1048339,5843,2921,2922,3zqXX6kzhkbW3d4TwD2CNjMRwxTbREXySekvq37kfCNk,233720,1678313,-1444593,557
2022-01-24 05:54:57-05:00,10306,4uygLJDk9DFCifJ56YwMrEsvd3oQNq8tYSLnMCyWorS6,GimL4uKGvg3FFmFQSWzAcjstv3Vmk5NMgDGMKTuXYVpB,True,6822574,1705643,8707,4353,4354,3zqXX6kzhkbW3d4TwD2CNjMRwxTbREXySekvq37kfCNk,348310,5666946,-5318636,510
2022-01-24 05:54:57-05:00,10307,7hTjPRQSYAoWHhtpsVz2oKK5SAuFJd8dPHShKgKJq8dy,6DcHcrtcXR88d8e2KahhAiWTeRznNfF8oXLHmh5wE7wz,True,9381377,2345344,13571,6785,6786,3zqXX6kzhkbW3d4TwD2CNjMRwxTbREXySekvq37kfCNk,542862,7501541,-6958679,578
2022-01-24 05:54:57-05:00,10308,FnAT8HKGgisYfeAbxKU2gSbCp8KbZHULRpaJX1NVijHy,2u637Crc2QzfSJmCnRNqeib3aZQVn4NGncpgM3Ph6jvm,True,451068,112767,588,294,294,3zqXX6kzhkbW3d4TwD2CNjMRwxTbREXySekvq37kfCNk,23520,327898,-304378,521
2022-01-24 05:54:57-05:00,10309,8kJu5aqVSmW8FSZR9h6F75ftn9V2U9uMLBEKeqRaC855,FhVHByujkvwwtjTVpZ4mqSUqoMoBgeLUc5H7rbz3FgAt,True,1162408,290602,1494,747,747,3zqXX6kzhkbW3d4TwD2CNjMRwxTbREXySekvq37kfCNk,59786,1216719,-1156933,514
2022-01-24 05:54:57-05:00,10310,4MSyrHopFkuaCEEvLAUV9cJfVre6cLAx5sJF5LEMSCTX,6HhLHoswuDKrcixShWCDcquW6PgmbS5FidEnkM3bwuJQ,True,676657,169164,928,464,464,72FwbpFGoLEazJEdpqNtPNefsadUrimUqma9wSoy4qiS,37130,337701,-300571,548
2022-01-24 05:54:57-05:00,10311,B2hN3Lt5pFbUyfEUc5s48hkxUJ5rr2SeFxgdGdQ8pDD2,7bZJCCud253j9g411HQUDXUAADcwd5yJWznoTChBdB2H,True,79946490,19986622,102555,51277,51278,3zqXX6kzhkbW3d4TwD2CNjMRwxTbREXySekvq37kfCNk,4102221,35851358,-31749137,513
2022-01-24 05:54:57-05:00,10312,EgpRPHPAC2cPBiar3SUD5PGZnzbCXBzUpa4KVTF5q9XY,2zf7NkfWagBWWts9RgacdRgkSzgJaChpFW5mMZczXa18,True,249266611,62316652,348717,174358,174359,72FwbpFGoLEazJEdpqNtPNefsadUrimUqma9wSoy4qiS,13948699,261091773,-247143074,559
2022-01-24 05:54:58-05:00,10313,Bsr6kx1B6BSEd5UnJ7Z61M49iUb3bFrDVhiEtMVtPDF2,3CFd1pUJAJPA9fobwn4Jj2mRju1CWmoop4Mh4znypNWT,True,287396,71849,416,208,208,HfEnetJ7uBSmZWCjBNxdvv9HEC5nsW4wDV7wu6WnhWan,16678,226679,-210001,580
2022-01-24 05:54:58-05:00,10314,GKKRAsYGdcf47eFThG4KwhNv7egeHRuc2wmTh4kqpego,4ippJxgnqCtdtGzCkdZoYwv68fiXNSqQcgrnaHdXZDUa,True,19171778,4792943,28832,14416,14416,HfEnetJ7uBSmZWCjBNxdvv9HEC5nsW4wDV7wu6WnhWan,1153314,13818942,-12665628,601
2022-01-24 05:54:58-05:00,10315,CpxZ136k95cVjGqkJnNpDZKUgrJrfg8HrFDZPL6BgsK4,Fo7HtcrneUTsnGqygsxPQ63G5rayYodYT65xP6B6HusH,True,20484782,5121195,26661,13330,13331,72FwbpFGoLEazJEdpqNtPNefsadUrimUqma9wSoy4qiS,1066446,8886413,-7819967,520
2022-01-24 05:54:58-05:00,10316,BgN75npBkPws5uiFE9RAujmPuZyAv2MQUPmfmJ1YCCij,78UFLNDn782TY2P4F5kRkMRC2s3gw8ak7sRQZRWNq82D,True,3157975,789493,4009,2004,2005,72FwbpFGoLEazJEdpqNtPNefsadUrimUqma9wSoy4qiS,160366,1506495,-1346129,507
2022-01-24 05:54:58-05:00,10317,JDeYjCLpfnzcfxDFgHf4aBcHsajwdR14GUaKAA9euzVf,EJbvKoyMZcoCx4vWa61uMbW2vr6mUhrgEuECdteVBuZZ,True,76419,19104,110,55,55,72FwbpFGoLEazJEdpqNtPNefsadUrimUqma9wSoy4qiS,4410,81961,-77551,577
2022-01-24 05:54:58-05:00,10318,D58t4uTjFumsUeYFaKnpV8BRTEQEqKXBreFTdwGrott7,67p6kHDfVqQijfcwugvZK59c3aRRH9x3eHxruqH8WEqF,True,2042453,510613,2771,1385,1386,3zqXX6kzhkbW3d4TwD2CNjMRwxTbREXySekvq37kfCNk,110879,1190585,-1079706,542
2022-01-24 05:54:58-05:00,10319,DDuXUcRDez68Tx651sVKxjubhTdNHkuarbeDEKFp5HRs,DNWcrd23zaT7LuXHuhPVqqAvLVpEzoqebr4sho45CphT,False,441837,441837,20117,1005,19112,3zqXX6kzhkbW3d4TwD2CNjMRwxTbREXySekvq37kfCNk,20117,215988,-195871,455
2022-01-24 05:54:58-05:00,10320,cG5VSSaBpjNdRLMQT7dmotpcWRTfdmJZYdWsrzNzRTE,5RESxV6aZenjAdaqw1jxoYSGttpLrNuZiRJy2WeLAVJv,True,26027456,6506864,34419,17209,17210,3zqXX6kzhkbW3d4TwD2CNjMRwxTbREXySekvq37kfCNk,1376779,18841106,-17464327,528
2022-01-24 05:54:58-05:00,10321,F23iDhSYDE7CXDrzZ3Skd47y2BEeWNCzU5D7w28Z4dUN,GExxthvXk5BRzqYndwoCVpcYmeSfTAxbdxeFpNwgYLNV,False,27173131,27173131,1188956,59447,1129509,3zqXX6kzhkbW3d4TwD2CNjMRwxTbREXySekvq37kfCNk,1188956,21759097,-20570141,437
2022-01-24 05:54:58-05:00,10322,FsMiJiJZibohKoV5QRisWCjzuFd86xSxFb4m73AQmu93,7p3TSKBaG9SV2YNDnhutQKacPKpTTmgsEfzmK51t6sYb,True,2746628,686657,3694,1847,1847,3zqXX6kzhkbW3d4TwD2CNjMRwxTbREXySekvq37kfCNk,147774,2000023,-1852249,538
2022-01-24 05:54:58-05:00,10323,CxQ4CV5aLiLE4KHbPN3qRrpW87gBgX1V7a58MjCnyi3y,87Wj2ZQ48EyTn3HxfscMhEK9y4ri4TFu1phycMYrDzTv,False,24354157,24354157,1095049,54752,1040297,3zqXX6kzhkbW3d4TwD2CNjMRwxTbREXySekvq37kfCNk,1095049,19472416,-18377367,449
2022-01-24 05:54:58-05:00,10324,DWTaeNeq5x83cBvKUz2jZfXDz5z4F5wbSZLNv7smnjvd,9pQGArZnJV4Fu8tBVEfknmmfmrRv5RKV2u58BJBuhzpF,False,1224371,1224371,53746,2687,51059,HfEnetJ7uBSmZWCjBNxdvv9HEC5nsW4wDV7wu6WnhWan,53746,941150,-887404,438
2022-01-24 05:54:58-05:00,10325,DBhvfqBC6si4wSJRkB2S89CKxK27rUyzxWNghK2ghaN8,3SHC2Q839Dms5LSofDgDkAixqZaA9FvZUk3yrKYLERxS,False,83396092,83396092,4167709,208385,3959324,HfEnetJ7uBSmZWCjBNxdvv9HEC5nsW4wDV7wu6WnhWan,4167709,70757340,-66589631,499
2022-01-24 05:55:03-05:00,10326,5Tf1yqxsjGf6ALPmGxxFzjmmXgP2jVVHuPqkuqLCi4uu,9cWJzD8QLERJZJJTpXkDEfsTK3geNZQoigTuCL4a3PLG,False,179298693,179298693,8720532,436026,8284506,HfEnetJ7uBSmZWCjBNxdvv9HEC5nsW4wDV7wu6WnhWan,8720532,77703927,-68983395,486
2022-01-24 05:55:05-05:00,10327,Fani89KviVFZek4si6YZ3apVuM2kSqVUijDnLBqtvJEH,EpC29dECx1cLC69bj2ncG3jFp7obPaxbH7F6mju27cwL,True,215656,53914,320,160,160,3zqXX6kzhkbW3d4TwD2CNjMRwxTbREXySekvq37kfCNk,12838,108566,-95728,595
2022-01-24 05:55:07-05:00,10328,D64rDiWT3YG28fCgXCmbNjYa2JakZbpKQ1D2XuLChUfV,8WmMWq8cTsGQym5pUbHm9dPCpJugBeWUMVERYFGLxWHj,True,351074,87768,532,266,266,HfEnetJ7uBSmZWCjBNxdvv9HEC5nsW4wDV7wu6WnhWan,21299,264782,-243483,606
2022-01-24 05:55:07-05:00,10329,6mCEvqP1YwHZNUT9orECs4tE3YzfD2Hfa5FTt9TLo8DH,ApWyeUDzPp6TBczuStvXxEAivhVVJrqC1rodNTNKNFR3,True,3167713,791928,4911,2455,2456,HfEnetJ7uBSmZWCjBNxdvv9HEC5nsW4wDV7wu6WnhWan,196450,1981993,-1785543,620
2022-01-24 05:56:44-05:00,10330,CmvNNpdGVDGujBadaMmgKc8xgFfyV6G9PNEjD8zEND6L,EzmfinKBZ8TXoSugyTqdEdHWrHdTdpHQtc1TApfaNfDR,True,472190918,118047729,735769,367884,367885,3zqXX6kzhkbW3d4TwD2CNjMRwxTbREXySekvq37kfCNk,29430778,402571303,-373140525,623
2022-01-24 05:58:15-05:00,10331,8xQ3tsWVUe75EG1HmocULJ3kh52utveoFMEPotTGrKno,i3SKW3ywrwYucX9ySEx1C4zaUKGnzLerP3V38437NyV,True,159006,39751,246,123,123,HfEnetJ7uBSmZWCjBNxdvv9HEC5nsW4wDV7wu6WnhWan,9861,195556,-185695,620
2022-01-24 05:59:27-05:00,10332,6uZobpBuFcQeYgZ4dApFi6iy4DB9GLHP1AAsQcCj6212,SGGFiPjjhscwroiWMqY4jTAHFw8eakpsEv35wNoHUPY,True,3841692,960422,6006,3003,3003,3zqXX6kzhkbW3d4TwD2CNjMRwxTbREXySekvq37kfCNk,240272,1688985,-1448713,625
2022-01-24 05:59:57-05:00,10333,BJaaH1SK1pF2kZQzmYpLFfDtm52CR9a5rd39RAPtLe8q,HUsT5FVxaisdnCvG1BQxX6zffjfL2Rwx5mMo5y8SDV7e,True,281903,70475,433,216,217,HfEnetJ7uBSmZWCjBNxdvv9HEC5nsW4wDV7wu6WnhWan,17351,202276,-184925,615
2022-01-24 05:59:59-05:00,10334,75NA5QiXEHG4caSB9BpafGZPA9eT9S6MhKTFM6eHjz8H,FmoxAVw2zdG6qbyaXKy6gsvi1XY8ZVbSgUNbjsp9EpVd,True,430636,107659,661,330,331,HfEnetJ7uBSmZWCjBNxdvv9HEC5nsW4wDV7wu6WnhWan,26447,463099,-436652,614
2022-01-24 05:59:59-05:00,10335,52hhBAuVyifMNFKGQmSitc8smiEgscXQMzVuZj55j7E5,6B5DBJx9NLytR3fkrYqe5W5ek4rUWsR4nPsRTvRfRwzC,True,6951881,1737970,10856,5428,5428,HfEnetJ7uBSmZWCjBNxdvv9HEC5nsW4wDV7wu6WnhWan,434247,8055299,-7621052,624
2022-01-24 05:59:59-05:00,10336,BZn1DDE568UHeL2Qniv9EDT1yAAWvPJcTtSw4K4GQx44,CCaroU4YwKvYgibMsRPdEBxeDbzcNC4s5ZthxrhywSm5,True,420402,105100,640,320,320,HfEnetJ7uBSmZWCjBNxdvv9HEC5nsW4wDV7wu6WnhWan,25609,469322,-443713,609
2022-01-24 05:59:59-05:00,10337,DiPSJvnnEwg1En7HJfEsKrUbBgtUf4KzGMyMCZDQSYgp,s8UVC6vPBofuXUS6RW1aQmZ8C35PrC5r4A6ugmvzLGB,True,1180,295,1,0,1,3zqXX6kzhkbW3d4TwD2CNjMRwxTbREXySekvq37kfCNk,72,1120,-1048,610
2022-01-24 05:59:59-05:00,10338,51VhgthsxrRRr2PT5gLnDfL1A3soqwCxA1UzH9vRUGTh,4QCcd7hfsydQ63LH7Lqsp8oVXw7HuKamzQf8VMH6Lgu2,True,323674,80918,500,250,250,HfEnetJ7uBSmZWCjBNxdvv9HEC5nsW4wDV7wu6WnhWan,20020,362563,-342543,618
2022-01-24 05:59:59-05:00,10339,Gk4mpwDEggypoPjyrZcFDbHT8WBwspC5AbQ5uDgaQufL,GTDi3mKTcw1NfwbYx8s8YCkzqbaJUM8YUwYifNr9sjgH,True,37641184,9410296,58669,29334,29335,HfEnetJ7uBSmZWCjBNxdvv9HEC5nsW4wDV7wu6WnhWan,2346765,27881343,-25534578,623
2022-01-24 05:59:59-05:00,10340,Fs8MQLaMyr1Q96HsZivKLY7Kjdeu2ZoB2n3VTZ15KbSn,DREfCs5CTVNUUF8H3hD8CWvtxztiYxoLYh8HUWDecMyZ,True,6526861,1631715,10191,5095,5096,HfEnetJ7uBSmZWCjBNxdvv9HEC5nsW4wDV7wu6WnhWan,407659,7565308,-7157649,624
2022-01-24 05:59:59-05:00,10341,yWK6vFZq58uYYiHscQTPSBqTDrWEW1SVbqe8NszoTEN,6H1zT5ifGaMKjdvZmptuDYf4Vou7tntdZQPVzQ4hWyjg,True,5120952,1280238,7957,3978,3979,HfEnetJ7uBSmZWCjBNxdvv9HEC5nsW4wDV7wu6WnhWan,318292,3501829,-3183537,621
2022-01-24 06:00:01-05:00,10342,9XHC2Ycm9f56cDYxRPVKYiYWGKA4y7Utpv3e9gpMsZq3,HpqAdpkzWqoJUNqmHEnn4PZwSB6C6jt8FJZQtZtFqXWA,True,1856719,464179,2899,1449,1450,HfEnetJ7uBSmZWCjBNxdvv9HEC5nsW4wDV7wu6WnhWan,115994,2013140,-1897146,624
2022-01-24 06:00:01-05:00,10343,CxePQ6ZEn2NCLYgGegSeFX1PyBuczP9j5v131VQSPh1c,9gPk7qTRb5JHqBXRKp3uZfhA2VjQAJDQHTzYXGLUdAUC,True,376332,94083,583,291,292,3zqXX6kzhkbW3d4TwD2CNjMRwxTbREXySekvq37kfCNk,23338,421874,-398536,620
2022-01-24 06:00:01-05:00,10344,JDg1bbHkYeznDUtSBLhagRJ45aSzeSF5V8iDRJCay9wL,8n7ic28zq5PjJtRcM7Fcy5vLW2YVXw4EWMK6UAt2zh3V,True,4705928,1176482,7299,3649,3650,3zqXX6kzhkbW3d4TwD2CNjMRwxTbREXySekvq37kfCNk,291960,5271018,-4979058,620
2022-01-24 06:00:01-05:00,10345,57Vsw8jXaaoLriYEkvPAVyq66r4a4zMfLWbDaTBMjFzC,7AVDWUTHa6729UkXgCXASphSmrLvXYGAA9ygTMSqvwvY,True,206323,51580,318,159,159,3zqXX6kzhkbW3d4TwD2CNjMRwxTbREXySekvq37kfCNk,12722,239578,-226856,616
2022-01-24 06:00:01-05:00,10346,6kZoofhL5S3U8aQU2VW2TDRZdiBYo1e1o8AUSbSttsAy,4zUpycP3EDmXrC1qjmnHuymGVoBjXQT6yAkvKGW9Gext,True,182928090,45732022,285779,142889,142890,3zqXX6kzhkbW3d4TwD2CNjMRwxTbREXySekvq37kfCNk,11431196,53369246,-41938050,624
2022-01-24 06:00:06-05:00,10347,7aM6r3HXMKzhj1hoDWjjkVCVy2y1rhDx2QV8Sdgr9DoM,4yBtGoYqo6dX4T3NMVbgMN3731hEnugL1dsR1A5vXF8f,True,10343231,2585807,16087,8043,8044,3zqXX6kzhkbW3d4TwD2CNjMRwxTbREXySekvq37kfCNk,643492,4623941,-3980449,622
2022-01-24 06:00:06-05:00,10348,49hagnoMSB3ozBBMaTgeZ2nwEbKKS3NZWUuPShMBUwp9,6ivAhvY6bUr98jqBp4ye1w8Vz8NesEubqKDSn1jeqxmr,True,18922675,4730668,29445,14722,14723,3zqXX6kzhkbW3d4TwD2CNjMRwxTbREXySekvq37kfCNk,1177838,6425399,-5247561,622
2022-01-24 06:00:06-05:00,10349,3idUQDMPAN9f6F6BipHAYFZyhG5JADey1y7JcFYx5BRh,D6UMk8WsSRahs4nGyi9DLt2HyZQy4wAywDwL31sL8BVj,True,1745002,436250,2726,1363,1363,HfEnetJ7uBSmZWCjBNxdvv9HEC5nsW4wDV7wu6WnhWan,109044,773784,-664740,624
2022-01-24 06:00:07-05:00,10350,EToREv5PrDmMUqRH43RdhooZMpmzXdic79KSoBatakPp,4ZTacQQnxq89V64pELPFkmvwJgkVY7m29g2sXfnn3mPD,True,10657780,2664445,16515,8257,8258,72FwbpFGoLEazJEdpqNtPNefsadUrimUqma9wSoy4qiS,660628,3555620,-2894992,619
2022-01-24 06:00:32-05:00,10351,3EgUBHBeKWegibDcCsTGaGehnwHYvpMbcPaT1UTbwQ49,Hxd4dsnLD8uHnG7KR7GVmKXBcpN1egMUvoTccPvBcaYA,True,6906892,1726723,10633,5316,5317,HfEnetJ7uBSmZWCjBNxdvv9HEC5nsW4wDV7wu6WnhWan,425338,7990772,-7565434,615
2022-01-24 06:00:32-05:00,10352,7EtGovzHsbD8cKGqq4R5rvKBbncR4Kc7CDkTjof2QBMf,8ShjeNWM2vcvUF9yYztYCHUQfcGsyg2A1LyWiPbQDDvq,True,40327,10081,62,31,31,HfEnetJ7uBSmZWCjBNxdvv9HEC5nsW4wDV7wu6WnhWan,2501,46642,-44141,620
2022-01-24 06:00:34-05:00,10353,7A1v7bFDJwxM7XomePFyRh58SMHxrNSkM3fJygd8pQUN,DL9jCFHaM8BXJ5KE1YJHXNCbXgSdRgt18MHhAgC6TNmg,True,504252,126063,779,389,390,HfEnetJ7uBSmZWCjBNxdvv9HEC5nsW4wDV7wu6WnhWan,31198,541923,-510725,618
2022-01-24 06:00:35-05:00,10354,HabA6MLjygaKE6i9Sad4c6B8rnyobMYbtFext51rCmHj,516FG8YJxZmnGfvzWiV3TcwSF7UDdwWefjZkmi3R2SPX,True,32574127,8143530,50920,25460,25460,3zqXX6kzhkbW3d4TwD2CNjMRwxTbREXySekvq37kfCNk,2036827,21120774,-19083947,625
2022-01-24 06:00:35-05:00,10355,68qWTKE41JPQMbF7zwqoELSVn2XbjcUMA4UTfER4fcz6,HrDYnhxX1Gm72Kq9H9k44xUfxqELLkC2yoEkkR3LEEHM,True,127643928,31910982,198215,99107,99108,3zqXX6kzhkbW3d4TwD2CNjMRwxTbREXySekvq37kfCNk,7928636,86039944,-78111308,621
2022-01-24 06:02:13-05:00,10356,8HWpccoTmPZ9MsrxtvQ5BV5y8a8WBAB1Sxx2WAiYKRLH,9chtr2Nqg77CCCnjC5JqENmUBNxpDHVH6BG3wojn9gHQ,True,232407,58101,358,179,179,HfEnetJ7uBSmZWCjBNxdvv9HEC5nsW4wDV7wu6WnhWan,14348,273116,-258768,617
2022-01-24 06:02:13-05:00,10357,8d4LtUwpkNSKRUdFbxhbeeaVc8hABhwjUExt3QgEVQbz,BieULGWXC1yEtuK9y27SMo9ApNDo6jLjxs5egr1Ebsda,True,1033225,258306,1569,784,785,HfEnetJ7uBSmZWCjBNxdvv9HEC5nsW4wDV7wu6WnhWan,62787,1231532,-1168745,607
2022-01-24 06:02:14-05:00,10358,FwTGq3BeMLyRFRa5r4E6nySLgoLNcNdqJsCQxA2i6uh6,88w6ti3WSriyu2FvNjVfrLpGyU5PUvaiJyqrAGPM8TKp,True,199969,49992,308,154,154,HfEnetJ7uBSmZWCjBNxdvv9HEC5nsW4wDV7wu6WnhWan,12349,231850,-219501,617
2022-01-24 06:02:14-05:00,10359,3PPCwAjj8GNphb3cRs7kP1QVghEUX6gWUH3M4JarQsTD,28UR4WKAziiJmPwas5E5JrY3WaUrR2NkYYXCKuxPHTMR,True,55688891,13922222,84755,42377,42378,3zqXX6kzhkbW3d4TwD2CNjMRwxTbREXySekvq37kfCNk,3390228,60321965,-56931737,608
2022-01-24 06:02:14-05:00,10360,HfwGSiwGiyDFaTS2usYRp82zSmPPQqZukbw2d1BuFs5w,ArtgZbmA33k8Y3EfR6oMJiqT72MUrVBQqifPBdcnrzea,True,124604,31151,189,94,95,HfEnetJ7uBSmZWCjBNxdvv9HEC5nsW4wDV7wu6WnhWan,7577,89791,-82214,608
2022-01-24 06:02:48-05:00,10361,FtF3PVw8YNJseWPMcA2GEuQZ6nni1mq5kYPa2LrSzfkW,4yr1TM2dXrBvLNMpSaoryuGU2P8D3WG1ZCkvVzWFiQRH,True,1039057022,259764254,1613569,806784,806785,3zqXX6kzhkbW3d4TwD2CNjMRwxTbREXySekvq37kfCNk,64542780,547918166,-483375386,621
2022-01-24 06:03:14-05:00,10362,HdRgh9niYSd3YKCxzGdusYFquiVoFTP2mEGEzJJL5Nii,78C68Gbb1jYFQmYNCHHjL52keEKMXtGukmBwT7ahon4B,True,31909973,7977493,49926,24963,24963,3zqXX6kzhkbW3d4TwD2CNjMRwxTbREXySekvq37kfCNk,1997049,30710705,-28713656,625
2022-01-24 06:03:49-05:00,10363,5gN3624v6n1zQ1BKtZi1e9ZLpbCa4MEfhgHySFB81Qfm,UXT3oB5ud18rBsygsfxwA93kQYdSNbbzTCjt4gtU2jP,True,15044231,3761057,23521,11760,11761,HfEnetJ7uBSmZWCjBNxdvv9HEC5nsW4wDV7wu6WnhWan,940878,5115811,-4174933,625
2022-01-24 06:03:54-05:00,10364,B2hN3Lt5pFbUyfEUc5s48hkxUJ5rr2SeFxgdGdQ8pDD2,7bZJCCud253j9g411HQUDXUAADcwd5yJWznoTChBdB2H,True,59780751,14945187,93466,46733,46733,3zqXX6kzhkbW3d4TwD2CNjMRwxTbREXySekvq37kfCNk,3738679,27729994,-23991315,625
2022-01-24 06:03:55-05:00,10365,BgN75npBkPws5uiFE9RAujmPuZyAv2MQUPmfmJ1YCCij,78UFLNDn782TY2P4F5kRkMRC2s3gw8ak7sRQZRWNq82D,True,2361460,590365,3652,1826,1826,HfEnetJ7uBSmZWCjBNxdvv9HEC5nsW4wDV7wu6WnhWan,146101,1162721,-1016620,618
2022-01-24 06:03:55-05:00,10366,4ULhASByyNafHdp8HFAu8F7JWU8vZY73gmk11wWGpBH7,5GWVtW86nA33hveEygKzjCqeMkRNb8J6RsGrbzVad8nJ,True,121086194,30271548,183696,91848,91848,3zqXX6kzhkbW3d4TwD2CNjMRwxTbREXySekvq37kfCNk,7347875,71749659,-64401784,606
2022-01-24 06:03:55-05:00,10367,A4tDE948CPFPh1UwHb8sXryfKktbxZ8BCkqXgA5DJHA8,3zXeKMrsEpCe5fQumLNzCgpxcG1kLJFEAtJuqxLsC6ZG,True,852029,213007,1320,660,660,3zqXX6kzhkbW3d4TwD2CNjMRwxTbREXySekvq37kfCNk,52838,753790,-700952,620
2022-01-24 06:03:55-05:00,10368,CxLFMBDFkoMvpK9YUf7WtCq6hn7k3QACAuetAnGjU6KA,2gE52a1GWQnS6ifV6eVtKQyr13LXP5Jdt3yG9SjGPJPF,True,11935676,2983919,17800,8900,8900,HfEnetJ7uBSmZWCjBNxdvv9HEC5nsW4wDV7wu6WnhWan,712038,6595035,-5882997,596
2022-01-24 06:03:55-05:00,10369,Dcitj55ABpkgXvpnPCssy8GgKF46xd1GLaRMyPWoW6G8,62znTXs74bywWfcXptJkvwYuuTxgen8bhYaCnG8Z7y2B,True,246093094,61523273,369120,184560,184560,HfEnetJ7uBSmZWCjBNxdvv9HEC5nsW4wDV7wu6WnhWan,14764831,139714929,-124950098,599
2022-01-24 06:03:57-05:00,10370,4uygLJDk9DFCifJ56YwMrEsvd3oQNq8tYSLnMCyWorS6,GimL4uKGvg3FFmFQSWzAcjstv3Vmk5NMgDGMKTuXYVpB,True,5101365,1275341,7926,3963,3963,3zqXX6kzhkbW3d4TwD2CNjMRwxTbREXySekvq37kfCNk,317051,4321598,-4004547,621
2022-01-24 06:03:57-05:00,10371,FgQrRo4eGQAonSsFfQgnp8trGGqGZCLeGX6yvJnMnTjd,8KhemHLBY6nGmo3xMDedW2wnCSxQq6LwbTExif4sUSxx,True,13492629,3373157,20128,10064,10064,HfEnetJ7uBSmZWCjBNxdvv9HEC5nsW4wDV7wu6WnhWan,805138,6233144,-5428006,596
2022-01-24 06:03:57-05:00,10372,8WHDaiE6LqFFmCVMnPeLEQ99R6ft8b74UfmP9BqzjcE8,CGmoDGsdnjo3zMNrW78n2xxQr1aDPAiBYiXbyciLXYMu,True,21553563,5388390,33716,16858,16858,HfEnetJ7uBSmZWCjBNxdvv9HEC5nsW4wDV7wu6WnhWan,1348651,14230781,-12882130,625
2022-01-24 06:03:57-05:00,10373,9WJBnVi84E926j7xEd566WzrZJkPJWRgmEnYj9vyjuad,4dLaFS5F7TGyLdwuJLMGkz3bSL53aHzd9ZfpNmhHxXeF,True,150881,37720,225,112,113,HfEnetJ7uBSmZWCjBNxdvv9HEC5nsW4wDV7wu6WnhWan,9023,146708,-137685,598
2022-01-24 06:03:57-05:00,10374,8eTH6eJyyVeMno3UQkffeBg32xofKsQfkhLhXdtaf87s,BCFC7CPXrQPsUfJb2eYSht8GhaApWHpc49AeCXqaYq13,True,2200534,550133,3413,1706,1707,3zqXX6kzhkbW3d4TwD2CNjMRwxTbREXySekvq37kfCNk,136524,1204582,-1068058,620
2022-01-24 06:04:31-05:00,10375,4hZG7dM716SxDagiFGwt1gSC99B2QK1emGLV9TJmmuR8,7vjfUWySkyx4Z5qAaRr2VWnVvxHHNsvPj1PirGNSjM6,True,1015426703,253856675,1583949,791974,791975,HfEnetJ7uBSmZWCjBNxdvv9HEC5nsW4wDV7wu6WnhWan,63357979,635192558,-571834579,623
2022-01-24 06:04:31-05:00,10376,DvuRmJkfn6FQczUKgYeaSCqwy2NTMunuAKNrnmxMvnzS,7LpWTX9dgBtW75kfEoB5WuNsDwEdw5s8CYSHh3J4qagM,True,341673,85418,533,266,267,HfEnetJ7uBSmZWCjBNxdvv9HEC5nsW4wDV7wu6WnhWan,21341,352826,-331485,624
2022-01-24 06:05:21-05:00,10377,FuoFPNTdYVDkSHaBac6UC1aNJXafSNTvFJuBCdrgQQrH,ApBS1Fx83tcECMzDV6wEzEzEdg4e2hgj3djtjRUoSKK5,True,21558266,5389566,33703,16851,16852,3zqXX6kzhkbW3d4TwD2CNjMRwxTbREXySekvq37kfCNk,1348143,16370913,-15022770,625
2022-01-24 06:11:28-05:00,10378,71DcjZY2Fd1Jg9YkDXUH5usC9QcHeQqSxoEk7tH3fhzo,3o4iDHXNpNVAHaHzVirbcNevP6YfoP2EqddBNoSRU4hn,True,12199528,3049882,18744,9372,9372,HfEnetJ7uBSmZWCjBNxdvv9HEC5nsW4wDV7wu6WnhWan,749792,5226070,-4476278,614
2022-01-24 06:11:28-05:00,10379,9E97vZ6evPgg1Ao8KwvjjZhBFW6dXZrrJENk1HvZ3SU,D7U38PB8BXLwUVKbRNv9po7VcFdnn7Y4tWY9xpRiNJsT,True,2352244,588060,3612,1806,1806,HfEnetJ7uBSmZWCjBNxdvv9HEC5nsW4wDV7wu6WnhWan,144500,1146970,-1002470,614
2022-01-24 06:11:30-05:00,10380,EYNh72buYHmKWRSqF8omcFHRbqKWV76iXB2vrjHgQMck,Efm7bH2DFg5Y5M39jq3uDcoDHUa95zmey8n7Ld72jG84,True,20486738,5121684,31818,15909,15909,HfEnetJ7uBSmZWCjBNxdvv9HEC5nsW4wDV7wu6WnhWan,1272737,9851588,-8578851,621
2022-01-24 06:11:38-05:00,10381,DkKumyFA6dGw77wcwd16nWzTEC9McvmasAbmGfQXLkB7,9u6QyrruYFjhyLV5AXYUKkrBggzrxXfNH57smUAap5Ro,True,2040626,510156,3179,1589,1590,3zqXX6kzhkbW3d4TwD2CNjMRwxTbREXySekvq37kfCNk,127167,1115450,-988283,623
2022-01-24 06:11:38-05:00,10382,HmspGdpobjC5Vbmo3FcKdw4RLPN7wJKxv3uKqDjVhLee,3YEX8TzdyJyuHo76Kw76imVCJjzrC9m188YuRKvwwSwD,True,14498783,3624695,22636,11318,11318,3zqXX6kzhkbW3d4TwD2CNjMRwxTbREXySekvq37kfCNk,905456,6199200,-5293744,624
2022-01-24 06:11:58-05:00,10383,EDCJpkYBNcvKbqWmFwtnbeGYEiE6iACp4aQHgX5FXnNq,AubiccN4FqTZszcX3kJQQWc1JuDgDQG6XEN3TsTm55Zs,True,175136124,43784031,267097,133548,133549,HfEnetJ7uBSmZWCjBNxdvv9HEC5nsW4wDV7wu6WnhWan,10683882,49105647,-38421765,610
2022-01-24 06:11:59-05:00,10384,C21232Uu2r4AmbR3mzrEKF5ZHoFDZbCmy88x8u6cLyZV,8sppny1HRFKX6LuqT6KDn1x9wS7z61K9V5akSuAimxgS,True,350733623,87683405,548597,274298,274299,HfEnetJ7uBSmZWCjBNxdvv9HEC5nsW4wDV7wu6WnhWan,21943908,116171803,-94227895,625
2022-01-24 06:11:59-05:00,10385,CcV2aMbd36MCH9wKTJPH1wyEUgErHBbT3gBWedPFeMgh,4nT6pkWKa6P8LmVX9Cur45xqJaqe3YnRFqjeFzUY9eMa,True,82965482,20741370,128918,64459,64459,3zqXX6kzhkbW3d4TwD2CNjMRwxTbREXySekvq37kfCNk,5156737,23542706,-18385969,621
2022-01-24 06:11:59-05:00,10386,9qGz5Mh1XNUXqY1vEg5S1ZEMzPFvBLRbp1qaXwxSFMby,D8KnbVXStSUz3QhZGzY5o853ASocjkyu9x682oHgVoZh,True,16526525663,4131631415,25545570,12772785,12772785,HfEnetJ7uBSmZWCjBNxdvv9HEC5nsW4wDV7wu6WnhWan,1021822829,5020210840,-3998388011,618
2022-01-24 06:11:59-05:00,10387,C33hfnDHzVwKXxr6AwFAXhd1vJYrPKhtqc75Qpjm19Zt,2WYBMSyrHQEYZqxEtxBMe2xn7eioJEGsudqdCmGvssGh,True,2222901,555725,3433,1716,1717,HfEnetJ7uBSmZWCjBNxdvv9HEC5nsW4wDV7wu6WnhWan,137356,923425,-786069,617
2022-01-24 06:11:59-05:00,10388,3JrhHRs4UkkuMoCrQAaAGKZQrWoU72zWArnDGxKFESzH,8yREVE3kMYB7UAwtUDnTDK3egXTuTsN4igtJ5yeHYkCP,True,18570057,4642513,28773,14386,14387,HfEnetJ7uBSmZWCjBNxdvv9HEC5nsW4wDV7wu6WnhWan,1150954,9348973,-8198019,619
2022-01-24 06:11:59-05:00,10389,BJUNK2orMVx6mYsD9pnQzmsEh95ZF2NWPm9KJ1ZM67Qn,FpxLa3DwWrspYvHVsScSDcscHB2eBHGxRrQ4gVvn4VW,True,693056788,173264197,1058129,529064,529065,HfEnetJ7uBSmZWCjBNxdvv9HEC5nsW4wDV7wu6WnhWan,42325168,218101100,-175775932,610
2022-01-24 07:00:07-05:00,10390,FV3G5EsSmyiLAAoREhgDXwvzbxoyDeq4Mwfj4jK5fJ7U,5nhzbJmm5JAwGDpTZoenkM1u3XtMY4uN7Qsm3vFGtRJE,True,332508,83127,515,257,258,HfEnetJ7uBSmZWCjBNxdvv9HEC5nsW4wDV7wu6WnhWan,20614,196258,-175644,619
2022-01-24 07:01:31-05:00,10391,C1rjefgArnN3nBn5Wu3yXij2wAyGWFtWdjGNLR9vpjmj,GsLCESLzYGZ1brEh8RJrZttE7hxcpSq7iUqdhwJhnDVB,True,668935,167233,1043,521,522,HfEnetJ7uBSmZWCjBNxdvv9HEC5nsW4wDV7wu6WnhWan,41742,572184,-530442,624
2022-01-24 07:16:10-05:00,10392,7Dm3syN4P2mbBLFKyHTrtnSWY4hadGXiKB9EekTdT68S,HF97QS1dqarPMWgNmtcoaq6z3rpJnzAAAfc1PP4FwRhV,True,1300935,325233,2031,1015,1016,3zqXX6kzhkbW3d4TwD2CNjMRwxTbREXySekvq37kfCNk,81251,491251,-410000,624
2022-01-24 07:20:16-05:00,10393,3c4tj9J8QwB3exFchWei43nBh5xsYRZxEUfayi3JvYgm,Fyw1TEEDKhLFo16qxDsttsAwSkrfzpDe8Dmm3atEeXyN,True,1618157,404539,2525,1262,1263,3zqXX6kzhkbW3d4TwD2CNjMRwxTbREXySekvq37kfCNk,101003,1438896,-1337893,624
2022-01-24 07:20:33-05:00,10394,DC4UVUDFWL3gVtgkX9hPtFgtxaA8DH5p94i4k9U3wyWv,3HCWqVvQQfRgSKitsTjGTduJ82ointZUSNtj13uea4kD,True,7038341,1759585,11005,5502,5503,3zqXX6kzhkbW3d4TwD2CNjMRwxTbREXySekvq37kfCNk,440215,6052762,-5612547,625
2022-01-24 07:22:13-05:00,10395,AgokoeqypXXfMsjAyBXPRrJFGeP7B7D6SXvnGUTwMdap,53zBz3fTZisWQH1v6NHyhCdpLXx5NaPNp7uW9KPXLDan,True,10967230,2741807,17112,8556,8556,HfEnetJ7uBSmZWCjBNxdvv9HEC5nsW4wDV7wu6WnhWan,684517,6588544,-5904027,624
2022-01-24 07:22:29-05:00,10396,2sPD4f4d3CCeFSwSC5vAGS3YoTsTGypYKfDeoJczebop,HWCRpcq2sXqJL7Vi8MtipQDwGSViE73bUxS36ETmvnP2,True,720118,180029,1110,555,555,HfEnetJ7uBSmZWCjBNxdvv9HEC5nsW4wDV7wu6WnhWan,44435,418814,-374379,617
2022-01-24 07:34:32-05:00,10397,HELPNUwAqTX7gfHS4cnJnqXFM6Rb156tYcpsitKR9iDu,3RdfgDvLvsdZG5Cf6hKiKMQMqfidyxHzjYvUx1FZpeHQ,True,1768406,442101,2759,1379,1380,3zqXX6kzhkbW3d4TwD2CNjMRwxTbREXySekvq37kfCNk,110389,2099823,-1989434,624
2022-01-24 07:40:24-05:00,10398,8Xt3qHjZG3zLxozgM5vPHMVxp8eYFMg89kaVW7vdHKoA,2i8riSsQpfADD9LUVpiBJBfX5qjVAgmZegzfKx6RG9dW,True,29704997,7426248,45892,22946,22946,HfEnetJ7uBSmZWCjBNxdvv9HEC5nsW4wDV7wu6WnhWan,1835697,15469593,-13633896,617
2022-01-24 07:40:29-05:00,10399,4SQQdHTJUDv8taPXQRvEVJpUu91iCWQsv9su8tfehaQG,33CJXj1pmmatAofRvgt5in9E6SLEuy7tq4jqSwnUWP2A,True,112904462,28226115,176560,88280,88280,HfEnetJ7uBSmZWCjBNxdvv9HEC5nsW4wDV7wu6WnhWan,7062435,125755541,-118693106,625
2022-01-24 07:41:02-05:00,10400,cG5VSSaBpjNdRLMQT7dmotpcWRTfdmJZYdWsrzNzRTE,5RESxV6aZenjAdaqw1jxoYSGttpLrNuZiRJy2WeLAVJv,True,19428068,4857017,30184,15092,15092,HfEnetJ7uBSmZWCjBNxdvv9HEC5nsW4wDV7wu6WnhWan,1207392,14398206,-13190814,621
2022-01-24 07:41:02-05:00,10401,8kJu5aqVSmW8FSZR9h6F75ftn9V2U9uMLBEKeqRaC855,FhVHByujkvwwtjTVpZ4mqSUqoMoBgeLUc5H7rbz3FgAt,True,867637,216909,1305,652,653,HfEnetJ7uBSmZWCjBNxdvv9HEC5nsW4wDV7wu6WnhWan,52228,924098,-871870,601
2022-01-24 07:41:02-05:00,10402,D9VKhnfLLCrntDGFYSfoxFaY76VnHmYZ1ZbyFXdKdibz,2hRCRH2pMDyQGYcXHa8Y6BZo6FbcGZf5VJC1v8Bp6tGa,True,902843,225710,1368,684,684,3zqXX6kzhkbW3d4TwD2CNjMRwxTbREXySekvq37kfCNk,54728,726224,-671496,606
2022-01-24 07:41:02-05:00,10403,72L76qDRMK3M7X52zuuB9GVyvFFLDBZwFMpVjWjghXzA,4m2ZVuemUctu1edv4YJVAcjXzKwpbCmBujzoUmLDeA7h,True,3479572,869893,5351,2675,2676,3zqXX6kzhkbW3d4TwD2CNjMRwxTbREXySekvq37kfCNk,214052,1914661,-1700609,615
2022-01-24 07:41:02-05:00,10404,CpxZ136k95cVjGqkJnNpDZKUgrJrfg8HrFDZPL6BgsK4,Fo7HtcrneUTsnGqygsxPQ63G5rayYodYT65xP6B6HusH,True,15290677,3822669,23336,11668,11668,3zqXX6kzhkbW3d4TwD2CNjMRwxTbREXySekvq37kfCNk,933470,6871379,-5937909,610
2022-01-24 07:41:02-05:00,10405,FnAT8HKGgisYfeAbxKU2gSbCp8KbZHULRpaJX1NVijHy,2u637Crc2QzfSJmCnRNqeib3aZQVn4NGncpgM3Ph6jvm,True,336683,84170,514,257,257,3zqXX6kzhkbW3d4TwD2CNjMRwxTbREXySekvq37kfCNk,20579,250481,-229902,611
2022-01-24 07:41:03-05:00,10406,H1Z83zVoskNuBvYao1FjdLfETfhPpQFQUkniJfGxbaNz,EVqbBRV6Zy1tPLRevxpAykp8Mvv6tDZVTc4RmCKw4Gq1,True,26804238,6701058,41235,20617,20618,HfEnetJ7uBSmZWCjBNxdvv9HEC5nsW4wDV7wu6WnhWan,1649411,21565512,-19916101,615
2022-01-24 07:41:03-05:00,10407,9otCHuzKcxUCC4EgPJkio8Df5gXWB6DtZQnZvWtPfsh6,8cNPdP8rA9sBpcKpmCNcp4W2AYonYdFNoyVmboT6y1Bb,True,64573918,16143479,100622,50311,50311,3zqXX6kzhkbW3d4TwD2CNjMRwxTbREXySekvq37kfCNk,4024898,29630747,-25605849,623
2022-01-24 07:41:20-05:00,10408,F9s8a7Cpiw5dw3a2aNFMofqwyDWNXvDLnSdJzoj1gRiV,GpKsQKJD79KBRWdCTkyi4zX7NaoCWsLUjrKxAwJB6o6s,True,83623,20905,130,65,65,HfEnetJ7uBSmZWCjBNxdvv9HEC5nsW4wDV7wu6WnhWan,5203,57689,-52486,622
2022-01-24 07:41:22-05:00,10409,5NVD6QvomTAD35yNxSFZw4DhF2hCtV8drkbnGhBVtK5y,3JzkyPnREvoFZLL9JZuuDEnee3nuKcrqY3xLuXsmHwRo,True,167279,41819,259,129,130,3zqXX6kzhkbW3d4TwD2CNjMRwxTbREXySekvq37kfCNk,10395,177142,-166747,621
2022-01-24 07:41:22-05:00,10410,HSF97F9d5EPgx4kGYuG4AfwHnh6bovzyTneYUouszBQp,Bh8fR6QoGS1ykk27256kFb2gjCVbQtu8Nu4Ls7GEKSAs,True,4385235958,1096308989,6856875,3428437,3428438,HfEnetJ7uBSmZWCjBNxdvv9HEC5nsW4wDV7wu6WnhWan,274275031,3387557185,-3113282154,625
2022-01-24 07:41:25-05:00,10411,AUH6YGBV8tDVX1E1WTo92Mubfx1DGsqfGeyUBqxo4fSr,33QZgMwmW32WuvmxD8XNbmF9ea88bLe3YTtNwHV73Wwu,True,2050526,512631,3188,1594,1594,3zqXX6kzhkbW3d4TwD2CNjMRwxTbREXySekvq37kfCNk,127533,1549886,-1422353,621
2022-01-24 07:41:26-05:00,10412,EF6H6aW1p3qcAtiLFU9rbFYfsKfD683meHXDw8hLdaZK,8vfJbpnK7SQcjpEBCzZJRW8JosNbsmTeJ2YXZCbM225c,True,10508610,2627152,16379,8189,8190,3zqXX6kzhkbW3d4TwD2CNjMRwxTbREXySekvq37kfCNk,655194,6292960,-5637766,623
2022-01-24 07:41:27-05:00,10413,4Eh2J8pz6nSz2E2BaPSMbDNhEovGA4QRmNtzAJPw9ZRi,CrHeEQC5KpQFLGhz2EpLYWgk7kWsqLPvEfLsSQvUxv61,True,6923645,1730911,10793,5396,5397,3zqXX6kzhkbW3d4TwD2CNjMRwxTbREXySekvq37kfCNk,431738,5373387,-4941649,623
2022-01-24 07:41:27-05:00,10414,2jDRvE3pQNjWy1NRFa4tzB3KmU5UkbUCHw8sQRFujo66,C4zNi2szDrEEh4coTF3WRUghfP4ZwAVVSYTLWfkejQRu,True,1876909,469227,2933,1466,1467,3zqXX6kzhkbW3d4TwD2CNjMRwxTbREXySekvq37kfCNk,117341,1664155,-1546814,625
2022-01-24 07:42:38-05:00,10415,4ne6vC7qdxQYHJCsaeFAKZrKdFt2SwXGHQ3jrMHqt4DL,Cf1dLHY2WXH9rXbRKq5TT8THbdo9SdNUZq4rYhRCF9z,True,151377,37844,233,116,117,3zqXX6kzhkbW3d4TwD2CNjMRwxTbREXySekvq37kfCNk,9330,119536,-110206,616
2022-01-24 07:42:38-05:00,10416,GBpe8E33cNkFmMUuP3WjhDBBuQz7MHaDkpCJjGFaFkvu,3QYFKkgzZ1PKKAxCh4hMhgqrupoCcfRVkjuJZRWVZo3H,True,1617716,404428,2524,1262,1262,3zqXX6kzhkbW3d4TwD2CNjMRwxTbREXySekvq37kfCNk,100984,1093348,-992364,624
2022-01-24 07:42:49-05:00,10417,3FF2rhr1RuT7UR7MmmGtrhfYbh6kbc5UXq51KmqFLZnq,AEmSYLt1dQ8suLugC4Lcw4kF3dG9GYcEfX54hEAKfmv5,True,772196,193049,1201,600,601,HfEnetJ7uBSmZWCjBNxdvv9HEC5nsW4wDV7wu6WnhWan,48047,463484,-415437,622
2022-01-24 07:42:50-05:00,10418,2r64Rnbu3ZjmJTHHUxxV9TWWGzwpAepA4ySbtKivBXCj,6RRzx6KLkMiFK9JSuznrSJGiPgkHwatBSskudHqbfKJ5,True,190719075,47679768,297747,148873,148874,HfEnetJ7uBSmZWCjBNxdvv9HEC5nsW4wDV7wu6WnhWan,11909880,121870816,-109960936,624
2022-01-24 07:42:50-05:00,10419,2pKygdXJnjZBFfrZgDasmHQQgw8LgycmBBRuaoCU72cz,DXsomQ5yWw2ceZMbaCVsSaE4hKm9W6Gy785JG75Aaz18,True,695229,173807,1085,542,543,3zqXX6kzhkbW3d4TwD2CNjMRwxTbREXySekvq37kfCNk,43411,417027,-373616,624
2022-01-24 07:42:53-05:00,10420,EAtQUZAkQxwJF779DwPcWHZ455FzYX8mzm1uV5LBnhPB,8h8t6GW1Y7xMBfWpfyFfUVBP4apMbJVNg7igZUYZLsyr,True,923861,230965,1438,719,719,3zqXX6kzhkbW3d4TwD2CNjMRwxTbREXySekvq37kfCNk,57543,558808,-501265,622
2022-01-24 07:42:54-05:00,10421,8JtUn4uue4WzrySwnDQ74qzzWaKsoo11MbMvRh1ePDJN,8iahKConWg6fyZrkoze5eeujyNHA26AybYBpHwUr76Cu,True,8725512,2181378,13597,6798,6799,HfEnetJ7uBSmZWCjBNxdvv9HEC5nsW4wDV7wu6WnhWan,543883,6205467,-5661584,623
2022-01-24 07:43:04-05:00,10422,EXP61AETWHw3kHSjrJH1jQBt6cXR9Zebz34Cueb3KAzg,2JT9GrgdUKjuQQtXvZqevbjFquUQBMYDoADmBjDKWXj3,True,3748539,937134,5848,2924,2924,3zqXX6kzhkbW3d4TwD2CNjMRwxTbREXySekvq37kfCNk,233956,2898072,-2664116,624
2022-01-24 07:43:10-05:00,10423,72woixtGAuGazCMfsYfYBYLP7FuRj8Fwz9fynFo4MCE4,5237BmWkKf58PBeTUEiu3Ld5uKXEe8wcrJRmCnUoWWku,True,2773070,693267,4318,2159,2159,3zqXX6kzhkbW3d4TwD2CNjMRwxTbREXySekvq37kfCNk,172730,1877720,-1704990,622
2022-01-24 07:43:11-05:00,10424,23FjS7S6hwPkaBsziThnqwAqy3dZvDYvNLdCKfxp7Jr4,CpGixAiKhjCWJ8tD8hWxuSUeU7mQeoZU5TVdqsAEMvLQ,True,14796915,3699228,22771,11385,11386,3zqXX6kzhkbW3d4TwD2CNjMRwxTbREXySekvq37kfCNk,910867,24553517,-23642650,615
2022-01-24 07:43:11-05:00,10425,4oop1mjCh1Ao9NoWAUacAGc75GxiRTXr8KJ3NtzZ7btf,BfntjUunXBhnrKmocQ7pZr3wwxruRGudMyWQYC2MUhei,True,650329,162582,999,499,500,3zqXX6kzhkbW3d4TwD2CNjMRwxTbREXySekvq37kfCNk,39969,741034,-701065,614
2022-01-24 07:43:13-05:00,10426,HukFwJRwbT4R5P1YBDg61HphUfBHLiiawpvwf7C8VYzR,ATQqXSEQcZJL1hjfbQZ2ihUuRbxG6fJppJhv7ycWEhPd,True,315068270,78767067,489908,244954,244954,3zqXX6kzhkbW3d4TwD2CNjMRwxTbREXySekvq37kfCNk,19596337,283729062,-264132725,621
2022-01-24 07:43:13-05:00,10427,JCagxpXPs6wVRUWbNBPCZ4uLCkZsachnofN7SZEEwGwB,5uGj1TBCkc7FV4ffdBJg31yLcCxkQLxRExjcinnJUow9,True,235753234,58938307,367935,183967,183968,3zqXX6kzhkbW3d4TwD2CNjMRwxTbREXySekvq37kfCNk,14717409,232049168,-217331759,624
2022-01-24 07:43:16-05:00,10428,EBpxGcrs4eWAbBU5rEjFxbr24MjUstZQRMV9jK4q8kMp,EYVd6pztEuz8PC7rUnJ1AjVZ81WWpynyn2qEKtveqrHG,True,275656,68914,425,212,213,3zqXX6kzhkbW3d4TwD2CNjMRwxTbREXySekvq37kfCNk,17029,319367,-302338,617
2022-01-24 07:43:29-05:00,10429,CmvNNpdGVDGujBadaMmgKc8xgFfyV6G9PNEjD8zEND6L,EzmfinKBZ8TXoSugyTqdEdHWrHdTdpHQtc1TApfaNfDR,True,347896239,86974059,541113,270556,270557,3zqXX6kzhkbW3d4TwD2CNjMRwxTbREXySekvq37kfCNk,21644554,307751776,-286107222,622
2022-01-24 07:43:33-05:00,10430,GQviUdocJ1s4FsVDDexanvo5yQWRZgwwkGJBCg7TMtJC,HAX4VAKgQpKtm1149iRgtzvUaUkiXWcA1bJ9ERu6tXkd,True,810388,202597,1267,633,634,3zqXX6kzhkbW3d4TwD2CNjMRwxTbREXySekvq37kfCNk,50695,491212,-440517,625
2022-01-24 07:43:56-05:00,10431,9Hz4p7gcfDbXBJp8KzhaBBPh9i7xe9kun7zLfDtqPe6c,2bJ43Lep6kp6WY7Ct56oiscKnAbdtC265G5yRvRPFThU,True,576462,144115,898,449,449,3zqXX6kzhkbW3d4TwD2CNjMRwxTbREXySekvq37kfCNk,35953,468422,-432469,623
2022-01-24 07:43:56-05:00,10432,A4Q7Vrc9M3GtEXNUSiVBFkansyf5sKBtSeVT92WFacqv,EWLNfsTKqzkd7KAhnrPRre4Dyk6exb3H9wSbrJuyWprg,True,4016728,1004182,6264,3132,3132,HfEnetJ7uBSmZWCjBNxdvv9HEC5nsW4wDV7wu6WnhWan,250568,4696948,-4446380,623
2022-01-24 07:43:58-05:00,10433,FYdUiU3rPpbYKWnEpekQQsocSJKjXmscohi4v6DYqix7,daPyq9YdunQJhhLoW5ifhJ7UFPTtRZhGs4JwE1nqZhN,True,158648,39662,248,124,124,3zqXX6kzhkbW3d4TwD2CNjMRwxTbREXySekvq37kfCNk,9930,189429,-179499,625
2022-01-24 07:43:58-05:00,10434,2EkjFzKuqQaT9iLsf4qHnXM6rnbj7ftEyzzRsWx6D347,9NpHNbrRJF3U8Ub4KraPHhhZpyZk9Teo836dJSktJMEV,True,1396019,349004,2180,1090,1090,HfEnetJ7uBSmZWCjBNxdvv9HEC5nsW4wDV7wu6WnhWan,87208,1026495,-939287,624
2022-01-24 07:44:02-05:00,10435,ymyzGH4Qc7HH5PbKpVphCbsQgLLXyGkPcXamQJuNj5C,8oTLHaV2XzbKXNWRuUjCfHjUn61Pw93LYK14m9q2VDpZ,True,8348,2087,13,6,7,3zqXX6kzhkbW3d4TwD2CNjMRwxTbREXySekvq37kfCNk,522,9256,-8734,625
2022-01-24 07:44:03-05:00,10436,3sGCWcgPY7TzRCkFR1uuY8KcUzVRbdTyFYxh7V1csNMX,CcRFNnG2uhyLwhNAbX4U49jkMeC11kJtVhhyqDWdDK5r,True,4487362,1121840,7012,3506,3506,3zqXX6kzhkbW3d4TwD2CNjMRwxTbREXySekvq37kfCNk,280511,5252914,-4972403,625
2022-01-24 07:44:03-05:00,10437,2ZSfbqxhiCTDrDPeRhoWayTZHNmW7ajVXBCxpFS4eGBF,3ZmWsPdQD7qfSMGKQSNhmBtuH7S6qMFRc8oEmBcHXEiR,True,157609,39402,246,123,123,3zqXX6kzhkbW3d4TwD2CNjMRwxTbREXySekvq37kfCNk,9857,188238,-178381,625
2022-01-24 07:44:11-05:00,10438,2niazdR63iWLyZ3ABWZVAnJiEjVyDyLGo4jZ6wh3j2Zz,4RvU5UtyE5CqMStPciiCTdhYCdaUUfdKSYS5nkATs1qn,True,819900,204975,1271,635,636,3zqXX6kzhkbW3d4TwD2CNjMRwxTbREXySekvq37kfCNk,50879,497724,-446845,620
2022-01-24 07:44:12-05:00,10439,5y8ZSWUnrm4B3emh7vLQKTh89vHtCvXqUhk7fJBA52is,Bu1AoKU2QQWpGH54ZzugvvACB3E1d3VvymnegNmTgHqg,True,4407681,1101920,6704,3352,3352,3zqXX6kzhkbW3d4TwD2CNjMRwxTbREXySekvq37kfCNk,268198,5151358,-4883160,608
2022-01-24 07:44:12-05:00,10440,GHn96Ev7UmKJWqch3H3wzXpRT7qLg5FBuSBJAATVED1f,BXBSUddfz9MThXqk4517M7YVRDGdTm4pC6G4ipT69TMV,True,653553,163388,1017,508,509,3zqXX6kzhkbW3d4TwD2CNjMRwxTbREXySekvq37kfCNk,40685,395460,-354775,622
2022-01-24 07:44:12-05:00,10441,BrHRMouGRz3LBNzd9anfdYMhWfg8yUPHL4PqJ8WdEDFS,4uzoLa3mC2VYHAPBoHLX4gTjPTC28rPf2fvEGtJWPYc,True,19973,4993,30,15,15,3zqXX6kzhkbW3d4TwD2CNjMRwxTbREXySekvq37kfCNk,1224,35327,-34103,612
2022-01-24 07:44:12-05:00,10442,CJpe9bNHxS63QMaGJhmnr4u7eTo6e5GApZQZyPtXLAkk,EMVL4sDfVXwGEoGEYwLp8D6itfy3eu4FZBAj1kMz6uXa,True,4204676,1051169,6461,3230,3231,3zqXX6kzhkbW3d4TwD2CNjMRwxTbREXySekvq37kfCNk,258474,4922328,-4663854,614
2022-01-24 07:44:12-05:00,10443,U3vvMQ4X4aKzVYfhMw1V1p58HRqaLnuXozqmmefYeD9,7JA94MArkNCFRhBq8f5a32DgMF6aPdFsoC5HvXDQ6NuR,True,190226,47556,293,146,147,3zqXX6kzhkbW3d4TwD2CNjMRwxTbREXySekvq37kfCNk,11746,252222,-240476,617
2022-01-24 07:44:12-05:00,10444,FdYFnEYtFQKcZPmzUqnvNLzozxdR1emtkmvnYcMgYykS,7arWNJQf2cWxerjhLgQh9CJxwTat1efnr5KmhuD7Qnv4,True,122435,30608,187,93,94,3zqXX6kzhkbW3d4TwD2CNjMRwxTbREXySekvq37kfCNk,7485,146635,-139150,611
2022-01-24 07:44:12-05:00,10445,6k9unyyhVTrGhAhBrFjgumRfBtKFRBrVaeWtYB56LgEg,3n9VYUH53fxmwFwdYKT9xAZYDzjodhMsJ5iGAoJTqCt4,True,819974,204993,1278,639,639,3zqXX6kzhkbW3d4TwD2CNjMRwxTbREXySekvq37kfCNk,51138,497908,-446770,623
2022-01-24 07:44:12-05:00,10446,BLJgLzizx2yLgd12pVBAHTMqn9J5JA3JHCF8PnLnPyUk,HhDmwMysBFWhXnd3mrV31w75WBRKBS8wJSiEMZgqdUSp,True,619076,154769,953,476,477,3zqXX6kzhkbW3d4TwD2CNjMRwxTbREXySekvq37kfCNk,38129,756835,-718706,615
2022-01-24 07:44:13-05:00,10447,9gY3X17t7jarkWhnSEHPR51U9nVv8Dv99NqpCi3ewuPf,4Z6TdTW1d4JFRZqZyWA9X7upKhJwVPSfTQjFp14M59uv,True,27363265,6840816,40097,20048,20049,3zqXX6kzhkbW3d4TwD2CNjMRwxTbREXySekvq37kfCNk,1603891,31193963,-29590072,586
2022-01-24 07:44:13-05:00,10448,AvpYg74EBhwAXE8rcdGkpwmbBMRyVidF6zMRSFtWAVC6,4WgpqTp4r9wMpMptYMNbvCaP2faBnVr6FdShCAobetpL,True,156077,39019,240,120,120,3zqXX6kzhkbW3d4TwD2CNjMRwxTbREXySekvq37kfCNk,9637,186872,-177235,617
2022-01-24 07:44:13-05:00,10449,Aop82qT6CwZbomif4QowqP3VaSHKB1837B2yNKqw4tER,65BVa4jrCx9etU5eXBAXT2PVnwVot2HLWGYyNXbVJDFk,True,2164129,541032,3320,1660,1660,3zqXX6kzhkbW3d4TwD2CNjMRwxTbREXySekvq37kfCNk,132825,2529645,-2396820,613
2022-01-24 07:44:13-05:00,10450,As81koHnSP9quoXuUVNHp3VR3Qaks8HLa4sFgJDocYiF,AMVm8dXia5s974VgZSbeE6uPDgyXDHZFyJ2W1J1CWvKW,True,4406306,1101576,6729,3364,3365,HfEnetJ7uBSmZWCjBNxdvv9HEC5nsW4wDV7wu6WnhWan,269196,5153731,-4884535,610
2022-01-24 07:44:14-05:00,10451,FF8rqfM9PTEjYiVFy8jS81weDRwdaYooux2uSa2LexrJ,JBk1JghH1gged1YpDbkczFXP9ka5ivYSkaYoVbbXD4kg,True,113626,28406,176,88,88,3zqXX6kzhkbW3d4TwD2CNjMRwxTbREXySekvq37kfCNk,7075,144278,-137203,622
2022-01-24 07:44:14-05:00,10452,8ARSFh2vPjz7M1pjNqFRsRrHFGwVsUNnD7kLbqhmMrZR,9TGsutLwHv259Le8zfZ75FM4eLZffi6itgWBgYqeKkAy,True,1054054,263513,1615,807,808,HfEnetJ7uBSmZWCjBNxdvv9HEC5nsW4wDV7wu6WnhWan,64630,1252884,-1188254,613
2022-01-24 07:44:14-05:00,10453,5V5gFVMYSwGYfHFecRoHg8G22Rg4bXfVK2FSRTMhPQty,73raXd5MvixmDvJRnVjRL7yQaHZGFRiC9aBxL9ysiRvy,True,17408225,4352056,26751,13375,13376,3zqXX6kzhkbW3d4TwD2CNjMRwxTbREXySekvq37kfCNk,1070063,11344418,-10274355,614
2022-01-24 07:44:14-05:00,10454,3ogBPSRcKfmwzgumVDHBkXLi1eCsEFG2xzSJgD4LQDNy,7TXyqWgJqfe71MSWFA2n7ufZbUdzf7JJoWej8FNNtMXo,True,152998,38249,234,117,117,HfEnetJ7uBSmZWCjBNxdvv9HEC5nsW4wDV7wu6WnhWan,9380,126896,-117516,613
2022-01-24 07:44:14-05:00,10455,95yx3SCWcW9Cp8oSEDV68kGXRKWGyNdYUtNb5UnWMGBD,7PncaFWqW2iKR6EUKf78EW6LLZr7ZWU5b2d2rP22fsU3,True,1984365,496091,3006,1503,1503,HfEnetJ7uBSmZWCjBNxdvv9HEC5nsW4wDV7wu6WnhWan,120244,1695462,-1575218,605
2022-01-24 07:44:14-05:00,10456,8T4WK27RvWVGqPuNqY6whk1fmU4vd5qaUQPZG1GJ79bh,DvSz7knS8N3K7L6JhQf1s4mJSyxB8uJXNQXtyjJn8QRL,True,897703,224425,1298,649,649,HfEnetJ7uBSmZWCjBNxdvv9HEC5nsW4wDV7wu6WnhWan,51944,816211,-764267,578
2022-01-24 07:44:14-05:00,10457,FsMiJiJZibohKoV5QRisWCjzuFd86xSxFb4m73AQmu93,7p3TSKBaG9SV2YNDnhutQKacPKpTTmgsEfzmK51t6sYb,True,2032046,508011,2791,1395,1396,HfEnetJ7uBSmZWCjBNxdvv9HEC5nsW4wDV7wu6WnhWan,111676,1528789,-1417113,549
2022-01-24 07:44:14-05:00,10458,H3394S5wdbwXB4scjGAY8NsXxCdGy1Xebct18s42FM1K,Hz84L1EquzhCvBJP75ScKug46hYGdNMVNH16AdG4y5D8,True,457237,114309,628,314,314,HfEnetJ7uBSmZWCjBNxdvv9HEC5nsW4wDV7wu6WnhWan,25155,380594,-355439,550
2022-01-24 07:44:14-05:00,10459,D58t4uTjFumsUeYFaKnpV8BRTEQEqKXBreFTdwGrott7,67p6kHDfVqQijfcwugvZK59c3aRRH9x3eHxruqH8WEqF,True,1515976,378993,2224,1112,1112,3zqXX6kzhkbW3d4TwD2CNjMRwxTbREXySekvq37kfCNk,88998,914644,-825646,587
2022-01-24 07:44:14-05:00,10460,92vHa65f4WpuqzSCMESDMPxZ2yfLxXJMMPYLof75EiN,3QZvcV1wL2ZYnw9yY9sbhiCP3dYYHeUZB7gcqtSutuLK,True,99950983,24987745,153120,76560,76560,3zqXX6kzhkbW3d4TwD2CNjMRwxTbREXySekvq37kfCNk,6124839,67526815,-61401976,612
2022-01-24 07:44:14-05:00,10461,Bsr6kx1B6BSEd5UnJ7Z61M49iUb3bFrDVhiEtMVtPDF2,3CFd1pUJAJPA9fobwn4Jj2mRju1CWmoop4Mh4znypNWT,True,212621,53155,321,160,161,HfEnetJ7uBSmZWCjBNxdvv9HEC5nsW4wDV7wu6WnhWan,12868,173296,-160428,605
2022-01-24 07:44:14-05:00,10462,F1G1Yb2jhT1hULYuNM9QMuNNA6vHZ2Wg4LhFGWsJmr78,2oF52s77UVwjbZMLmxyNsGRZ36RHqSJiV5VL7FzoWgyB,True,25543869,6385967,38716,19358,19358,HfEnetJ7uBSmZWCjBNxdvv9HEC5nsW4wDV7wu6WnhWan,1548664,14389029,-12840365,606
2022-01-24 07:44:14-05:00,10463,7hTjPRQSYAoWHhtpsVz2oKK5SAuFJd8dPHShKgKJq8dy,6DcHcrtcXR88d8e2KahhAiWTeRznNfF8oXLHmh5wE7wz,True,6940283,1735070,10456,5228,5228,HfEnetJ7uBSmZWCjBNxdvv9HEC5nsW4wDV7wu6WnhWan,418243,5733009,-5314766,602
2022-01-24 07:44:14-05:00,10464,GYgxUfZ19oSyHuovGRA6gBJT32goSxCrKR8hQQdBsrRG,2r8c6SU74hRq7xEmYBJ92WoSB6v6XCAXR3JcDznfCxkN,True,210649995,52662498,307993,153996,153997,HfEnetJ7uBSmZWCjBNxdvv9HEC5nsW4wDV7wu6WnhWan,12319737,181355695,-169035958,584
2022-01-24 07:44:14-05:00,10465,HpDwBPWZHfLzJUvTTABTA6qddyLLJiVTfqBx5gUktSUb,BqXLpaAeTNfNSeevfdazNqTgqEXj6Edgp8txWvCoxEz6,True,6341401,1585350,9309,4654,4655,HfEnetJ7uBSmZWCjBNxdvv9HEC5nsW4wDV7wu6WnhWan,372365,6418984,-6046619,587
2022-01-24 07:44:14-05:00,10466,zLTuMVfVswjMkhyvjaXnvjcKXv5xNk3iSWSjRGpVqXf,J3D8NHUJCiSjvFYfJ5Es4YDhF1KcPZWRUmCQ5L92t8eB,True,3102141,775535,4454,2227,2227,HfEnetJ7uBSmZWCjBNxdvv9HEC5nsW4wDV7wu6WnhWan,178163,1304485,-1126322,574
2022-01-24 07:44:14-05:00,10467,EitU96ThqHErybDn2j1NY6JHkqV1R3mWM1uWH7wYKr1T,2p9eYbLyBqXrhHtRKp1jJb7VGjCmb4LkA6kzqLr1ijet,True,1135898,283974,1617,808,809,3zqXX6kzhkbW3d4TwD2CNjMRwxTbREXySekvq37kfCNk,64695,813764,-749069,569
2022-01-24 07:44:15-05:00,10468,JDeYjCLpfnzcfxDFgHf4aBcHsajwdR14GUaKAA9euzVf,EJbvKoyMZcoCx4vWa61uMbW2vr6mUhrgEuECdteVBuZZ,True,56535,14133,84,42,42,3zqXX6kzhkbW3d4TwD2CNjMRwxTbREXySekvq37kfCNk,3396,62341,-58945,600
2022-01-24 07:44:15-05:00,10469,4MSyrHopFkuaCEEvLAUV9cJfVre6cLAx5sJF5LEMSCTX,6HhLHoswuDKrcixShWCDcquW6PgmbS5FidEnkM3bwuJQ,True,500575,125143,704,352,352,HfEnetJ7uBSmZWCjBNxdvv9HEC5nsW4wDV7wu6WnhWan,28181,260528,-232347,562
2022-01-24 07:44:15-05:00,10470,A36aouot1oFLUtswuBUM4EVcis9chKaSJu53MRoPDjab,33U9gpq1RRFMGWDrWa3ezXXkwgBewdAS6QGgGVPtGvqb,True,2622351,655587,3749,1874,1875,HfEnetJ7uBSmZWCjBNxdvv9HEC5nsW4wDV7wu6WnhWan,149982,1968252,-1818270,571
2022-01-24 07:44:15-05:00,10471,9UKMqQgFYdJb5vXVqPhA8CAMRY1eifgWivANiKQqj3yb,DpE3uNQUZbyYnqjpfHWqp9CHqPBs2uTQLRM6AtzF6Por,True,2410393,602598,3625,1812,1813,HfEnetJ7uBSmZWCjBNxdvv9HEC5nsW4wDV7wu6WnhWan,145030,1200815,-1055785,601
2022-01-24 07:44:15-05:00,10472,G5NLYTLxDZfJFKsJdMeWS8Ez95ZFwR5AX4hKhnfVJvoE,AwrC3pKhTeEDr1HCTWoKWjadteZccvqcisbC7vxTjn7w,True,3888503,972125,5890,2945,2945,HfEnetJ7uBSmZWCjBNxdvv9HEC5nsW4wDV7wu6WnhWan,235617,4158056,-3922439,605
2022-01-24 07:44:15-05:00,10473,8xvLGVeDmhVYQhN2ZpWkVG9jCrukRsNQ4926a4TMiZqa,9ciBySSjvADwp47WkETiFWZKVTFL8Hf1XvK7aSxhcgQS,True,180954,45238,262,131,131,HfEnetJ7uBSmZWCjBNxdvv9HEC5nsW4wDV7wu6WnhWan,10498,157996,-147498,580
2022-01-24 07:44:15-05:00,10474,3VdSA9CED9f5swRwHX2U15U7J6Muaq8VPnCNy9CaGDHe,2YYstfnfdYic5NWmEbcUEHpccNUVd1EhuCkExvMsoMk8,True,48811,12202,67,33,34,HfEnetJ7uBSmZWCjBNxdvv9HEC5nsW4wDV7wu6WnhWan,2691,52592,-49901,551
2022-01-24 07:44:15-05:00,10475,m7gf1jAYXBZjRZEY9w4MjPfhzLwgDKaXyaCVhRD6C5E,Aa2aTZnpPux1i5K2MT4i1TsVM8vR7qR7rZGijQW4zpwd,True,1053293364,263323341,1551476,775738,775738,HfEnetJ7uBSmZWCjBNxdvv9HEC5nsW4wDV7wu6WnhWan,62059041,501689971,-439630930,589
2022-01-24 07:44:15-05:00,10476,78EeyPYzQjrmW6z9VGhRci6ihMUZb5rtpXo3GAxugf55,9AgZ45TMxaqwWGVWSgnEkvio3s6fXtHjAVRVCA7Zgsd2,True,403324,100831,607,303,304,HfEnetJ7uBSmZWCjBNxdvv9HEC5nsW4wDV7wu6WnhWan,24302,298628,-274326,602
2022-01-24 07:44:15-05:00,10477,AWvHDdb2ikqV8wc7qQ8azbvNTZdixMNxhQjhQdhayYtR,9EpgEPBb1nog6aQeFdMXfSRiLSnzGQFQ39mbLdCxgYTv,True,335916,83979,480,240,240,HfEnetJ7uBSmZWCjBNxdvv9HEC5nsW4wDV7wu6WnhWan,19209,243924,-224715,571
2022-01-24 07:44:16-05:00,10478,7CSCMFa9W52tBDVUbXbc3woAy3GByeA1wPJdp3MgznPa,3447ptuVFu6G8B6N63RmS8mRv4n9PfHneypHLvbeaGLn,True,306931,76732,471,235,236,3zqXX6kzhkbW3d4TwD2CNjMRwxTbREXySekvq37kfCNk,18852,323405,-304553,614
2022-01-24 07:44:16-05:00,10479,6VJcr3VAEcEZaHEpt48QL8QxHKABufVp8n2JSEVTLh9U,8naR6kiySKj3vai9dCetdgCnCHgf2oyLjGqKTJ3Lz64Y,True,23574349,5893587,34336,17168,17168,3zqXX6kzhkbW3d4TwD2CNjMRwxTbREXySekvq37kfCNk,1373459,21070778,-19697319,582
2022-01-24 07:44:16-05:00,10480,5eMLdQ4gYA5iqvTXSNdGvctHp7s5VpyFuwtJKqx6chBc,Ckxc5K39nkBNXBTmFTM8J48R7wGqNm3vHKZu4G5baumZ,True,2379548,594887,3537,1768,1769,HfEnetJ7uBSmZWCjBNxdvv9HEC5nsW4wDV7wu6WnhWan,141480,1845350,-1703870,594
2022-01-24 07:44:17-05:00,10481,CyWBZ1xJ9LahUnPesbXLZ4Rr5UyWAHgVFYwfrnhyrkNL,2Lpk87Xth8ZL5J9BfzmMpEE3x76FDrrrmdKiCNkSVip2,True,720736,180183,1104,552,552,3zqXX6kzhkbW3d4TwD2CNjMRwxTbREXySekvq37kfCNk,44191,640269,-596078,613
2022-01-24 07:44:17-05:00,10482,CbhrZUdan1axNDFUrX1ZuEohfNMEGrszKSkk6pppVQuw,DHEAjJNtuEePezYAv77thWabbVxxqQpfuiC6moRSrpG1,True,672013,168003,1016,508,508,3zqXX6kzhkbW3d4TwD2CNjMRwxTbREXySekvq37kfCNk,40677,721622,-680945,605
2022-01-24 07:44:18-05:00,10483,EgpRPHPAC2cPBiar3SUD5PGZnzbCXBzUpa4KVTF5q9XY,2zf7NkfWagBWWts9RgacdRgkSzgJaChpFW5mMZczXa18,True,184391082,46097770,265864,132932,132932,HfEnetJ7uBSmZWCjBNxdvv9HEC5nsW4wDV7wu6WnhWan,10634596,198555558,-187920962,576
2022-01-24 07:44:18-05:00,10484,Fani89KviVFZek4si6YZ3apVuM2kSqVUijDnLBqtvJEH,EpC29dECx1cLC69bj2ncG3jFp7obPaxbH7F6mju27cwL,True,159543,39885,249,124,125,3zqXX6kzhkbW3d4TwD2CNjMRwxTbREXySekvq37kfCNk,9968,83964,-73996,624
2022-01-24 07:44:23-05:00,10485,Cv5oVktxmqbU1SxraxH67NEWMKnjgA18R832Fhe9h74a,Cs7xBD4BDiohyopnaYDDChUtR9vmx7uwot6Qp9beQLzt,True,8798460,2199615,13766,6883,6883,3zqXX6kzhkbW3d4TwD2CNjMRwxTbREXySekvq37kfCNk,550644,4000905,-3450261,625
2022-01-24 07:44:24-05:00,10486,CYkojG4q1SnizNs59qsYTEBU1c11XC8nteMhxRbwhCBq,A9MsPy3aeMzdQUWXK6qmWLiZfKREiBrSVaJAKp2nEcSt,True,163222,40805,243,121,122,HfEnetJ7uBSmZWCjBNxdvv9HEC5nsW4wDV7wu6WnhWan,9727,134324,-124597,595
2022-01-24 07:45:48-05:00,10487,ATS5VRAN1aPKBiATDcUs5yd6yVuTmWqrqqRFNdfz6DZT,7VKq4rZLEtY2dhDFZMTQMvCYyJa1ASM9RHobUaYhHWAe,True,2403080,600770,3738,1869,1869,HfEnetJ7uBSmZWCjBNxdvv9HEC5nsW4wDV7wu6WnhWan,149537,1771285,-1621748,622
2022-01-24 07:45:48-05:00,10488,6pUtYz474QrpATEZnfb3iFbTKYA65pNyKAo4TQZAjtqe,8dipRUXvxJiDLdHEtCPkso4vErbVwshHQiRfvSngBS9J,True,3487306388,871826595,5437281,2718640,2718641,HfEnetJ7uBSmZWCjBNxdvv9HEC5nsW4wDV7wu6WnhWan,217491264,1629416824,-1411925560,623
2022-01-24 07:45:48-05:00,10489,4KMzwWHPeW51cxu4nMpbqCaqo96dMqaHWyRCGQktfQfd,F7q4GNYcbnZa8dJ4qovQwjmxpKpdEmdxQMXRPb9nQupa,True,9432705,2358175,14647,7323,7324,HfEnetJ7uBSmZWCjBNxdvv9HEC5nsW4wDV7wu6WnhWan,585914,4044617,-3458703,621
2022-01-24 07:45:52-05:00,10490,D64rDiWT3YG28fCgXCmbNjYa2JakZbpKQ1D2XuLChUfV,8WmMWq8cTsGQym5pUbHm9dPCpJugBeWUMVERYFGLxWHj,True,259340,64835,405,202,203,3zqXX6kzhkbW3d4TwD2CNjMRwxTbREXySekvq37kfCNk,16229,202808,-186579,625
2022-01-24 07:46:33-05:00,10491,7dmoK7QPki7R66SPQST4veUgVfnJbVToxxBPZveECiwK,4vh4REBDm5zBDmcjRCD9zNsny1HGneu7B2co4dSJNLL6,True,1241451,310362,1935,967,968,3zqXX6kzhkbW3d4TwD2CNjMRwxTbREXySekvq37kfCNk,77421,1302802,-1225381,623
2022-01-24 07:46:34-05:00,10492,9BMHbUs4d3qX49fnroHv2FTPDs4yoDFrvDMqf8p9U4pE,2yL7zwMr7qVG5Sdwkf7z6ppnNqt1ASppBbmxwYjfFY6Z,True,2444945,611236,3820,1910,1910,HfEnetJ7uBSmZWCjBNxdvv9HEC5nsW4wDV7wu6WnhWan,152828,2929384,-2776556,625
2022-01-24 07:46:34-05:00,10493,DMgD2KCEhTGFLUZ5GnfNcwfiiwKYbyVpoWiN6knMkCAf,5KU2vgBkPTNVHsSULjgX7ZkZS56U3Dy3xqLTxL5sUZJ3,True,863402,215850,1347,673,674,HfEnetJ7uBSmZWCjBNxdvv9HEC5nsW4wDV7wu6WnhWan,53907,1257200,-1203293,624
2022-01-24 07:46:34-05:00,10494,4SX2pj4eHRwFMtyDCrMZ8ZT6ASAMi7yfZWZnccw5dGn8,Ads49ZqvTmPHxfzNYm4oJb4HBYhwS6vXQbarqmpUi5VZ,True,128194,32048,199,99,100,HfEnetJ7uBSmZWCjBNxdvv9HEC5nsW4wDV7wu6WnhWan,7973,153550,-145577,621
2022-01-24 07:46:34-05:00,10495,9kYkFDNE3qD6s73fn8kJowgqbDZoDSw22XaUJ7rTD43D,E8zJz8pT2c9aZsxe4kLMNs4bY7skt38SU5wK5JTqbGr6,True,2414171,603542,3752,1876,1876,3zqXX6kzhkbW3d4TwD2CNjMRwxTbREXySekvq37kfCNk,150097,2892460,-2742363,621
2022-01-24 07:46:35-05:00,10496,6Z6y2QLJUZ5s6zdjanJcKprTAotx8tqr9DRNqqycMeS4,JCYwt8MHVaBb14GB2qAvDWwYVMaL7VTxyNEt7Eo5Zy8x,True,129002,32250,201,100,101,3zqXX6kzhkbW3d4TwD2CNjMRwxTbREXySekvq37kfCNk,8075,154170,-146095,625
2022-01-24 07:46:35-05:00,10497,7EvJoetxJVTgpJXqE1VC3fZN1CQ5xdWdv29yCiDuH9gU,6RTEusjGEHNDdMj75qkpzYHjHZ3R2XN5xvptCwkRJz5j,True,176306,44076,274,137,137,HfEnetJ7uBSmZWCjBNxdvv9HEC5nsW4wDV7wu6WnhWan,10982,211198,-200216,622
2022-01-24 07:46:35-05:00,10498,FV9CBGGTbppLnBKh79f2LzD1diTiS5g6u89FcpZHZmnK,Fe7mtmCUziFqbbYTvrhAcAq1Ub7YLfTJRtQ1hG7GzJD1,True,3295,823,5,2,3,HfEnetJ7uBSmZWCjBNxdvv9HEC5nsW4wDV7wu6WnhWan,206,3699,-3493,625
2022-01-24 07:46:35-05:00,10499,3tQBuHwr3V8AZu8Yqhg1UfmnFoxzkUq9UeGeLm41UHy4,9cESwduiHBgrxZK1hN1eAFwnyfxw3FEHezTa8Ue5Kpye,True,12659178,3164794,19764,9882,9882,3zqXX6kzhkbW3d4TwD2CNjMRwxTbREXySekvq37kfCNk,790566,10296610,-9506044,624
2022-01-24 07:46:36-05:00,10500,64Diz8zzEv1jDWnBQPTHPpXwaWf7vjM19RyJmkPy1viQ,G8wkGHRHMtT3mvXBkH3zgsKNs8wbpdiPUS17y4cozhkZ,True,78759714,19689927,123103,61551,61552,HfEnetJ7uBSmZWCjBNxdvv9HEC5nsW4wDV7wu6WnhWan,4924138,33326917,-28402779,625
2022-01-24 07:47:00-05:00,10501,7ayTm4uC5VbtMt9w6g9tFban4fYVwbqCzJZpiFMjmBiB,BvidnEZHHtXVhtgv4qFKThEaFZsFmyAuDVqZQwMppjSg,True,352891796,88222949,552191,276095,276096,3zqXX6kzhkbW3d4TwD2CNjMRwxTbREXySekvq37kfCNk,22087669,282627061,-260539392,625
2022-01-24 07:47:06-05:00,10502,98pwBGgiSDuwuas6WYW2hc9qUxfULwvNE34aixaxbxXY,BLrjKxekjThtJ9rKtQxs1Y4rZ225EE2Q16VkP9TkThyV,True,638436,159609,992,496,496,3zqXX6kzhkbW3d4TwD2CNjMRwxTbREXySekvq37kfCNk,39719,391876,-352157,622
2022-01-24 07:47:10-05:00,10503,3NhNdphQiKwgHTmTJc4qVhp3aWjqnwMTYbRW1y9CZrZg,BNpP1sKPAr7Dk1ymSrupge9KGMVpk4LfjTjawgi9YaC5,True,921677,230419,1432,716,716,3zqXX6kzhkbW3d4TwD2CNjMRwxTbREXySekvq37kfCNk,57298,1078248,-1020950,621
2022-01-24 07:47:10-05:00,10504,BJV5jbowrbELXfDvfMovaQy4PiRf12pLYHimW9bgzW5X,6WXrWso5FvLx7RMCFBzrbzh5qevKkk2LJAihUfWXxXzB,True,13096,3274,20,10,10,3zqXX6kzhkbW3d4TwD2CNjMRwxTbREXySekvq37kfCNk,814,23341,-22527,621
2022-01-24 07:47:10-05:00,10505,73PpLzJmAimmqtjGpRcYHua8t6wx3gYiiXFvQxnSDMJV,CRCpLcS8LNKX22co94spJBXEes9Fnh5rYBvbVEte4JXA,True,18473637,4618409,28879,14439,14440,3zqXX6kzhkbW3d4TwD2CNjMRwxTbREXySekvq37kfCNk,1155173,19878545,-18723372,625
2022-01-24 07:47:10-05:00,10506,Frobc1KZTVcsyfwyKwSpHJobxmiJBomzHhGCLdrzdAz8,HziyKP9uxWCuXddtbRzWMczHNdgyQB5UXQZj4MnMm14,True,739977,184993,1158,579,579,HfEnetJ7uBSmZWCjBNxdvv9HEC5nsW4wDV7wu6WnhWan,46321,516772,-470451,625
2022-01-24 07:47:11-05:00,10507,2FEbsetZMkRqLjSC8GBbgecKgX5T1T1fci2sLQux29p8,H722Fcd6DkTFRZxqQWbPDufBfXEgmFfhiEpQZWhxwYv1,True,2924,731,4,2,2,3zqXX6kzhkbW3d4TwD2CNjMRwxTbREXySekvq37kfCNk,183,3292,-3109,625
2022-01-24 07:47:12-05:00,10508,HGJoZvLakWfSDFwuvShNBc4kCf7nP7VqzyM3mELpbFEf,12Qn5jin7QvsBngXqYAv4UstyG3b6nRf1jsLp9Dp8G7k,True,9812,2453,15,7,8,3zqXX6kzhkbW3d4TwD2CNjMRwxTbREXySekvq37kfCNk,610,11992,-11382,621
2022-01-24 07:47:12-05:00,10509,BjCNaM7YbE9SjFi7tzi4677zg1fKXGJwtecz2GWwWuhd,6rNsSrKZezQrLb2whToNjnizpnurDXrobHqfEK3QqU1M,True,195681755,48920438,305877,152938,152939,3zqXX6kzhkbW3d4TwD2CNjMRwxTbREXySekvq37kfCNk,12235096,114909221,-102674125,625
2022-01-24 07:47:12-05:00,10510,EBnMKbaJEjNXjt14hxssR8wd3Ua37McPQxUZnKxxbgtd,FAALK2LRFhg98ezHEBFrgrzxTg66eZpmo7ctKDEck8q5,True,276591,69147,430,215,215,3zqXX6kzhkbW3d4TwD2CNjMRwxTbREXySekvq37kfCNk,17224,303717,-286493,622
2022-01-24 07:47:21-05:00,10511,3Xbsek5MsEGoWr3G9yhuohREr26B2vSQcjqXdspTFHta,2rPxkUiMo9wGDq8EvAiwY3ngRpKmL223cBWWNTYoBmFp,True,305246,76311,475,237,238,3zqXX6kzhkbW3d4TwD2CNjMRwxTbREXySekvq37kfCNk,19006,237332,-218326,622
2022-01-24 07:47:22-05:00,10512,28JujYG1mbpYSjF7LNqXpup17TXb45VJHhhnFMVXtft2,DAqyVExAtmsovPGrkpkFDxm6T7pKWLztfh9iPjTNDqrd,True,1009458,252364,1572,786,786,HfEnetJ7uBSmZWCjBNxdvv9HEC5nsW4wDV7wu6WnhWan,62895,620819,-557924,623
2022-01-24 07:47:22-05:00,10513,95urWGJ4HN1bTarbDi8Dpj4K4ms7dovs8gwaYdaSLC6e,2THhqxjhXjp2Zui9ML2MzAbGN4dsfa3dkdqzC8LYhnbQ,True,230171,57542,358,179,179,3zqXX6kzhkbW3d4TwD2CNjMRwxTbREXySekvq37kfCNk,14324,267285,-252961,622
2022-01-24 07:47:22-05:00,10514,9rgrRAMcGSarfz8xXckw1LjkemMwwjzJLApPjpfY2XZ3,BRtNdDDtCiNDYDERZTBCefUiYvjShucRX1hxEBLyeggT,True,124147,31036,192,96,96,3zqXX6kzhkbW3d4TwD2CNjMRwxTbREXySekvq37kfCNk,7714,148690,-140976,621
2022-01-24 07:47:22-05:00,10515,9T6bCVf7AshQP1NNbsF3eCdbChKbcfrFUPFWUXRijY5M,4ZFq3kdwaUhiotXCXzDFjVCAP3udzGsx5CicgLLXd4PR,True,88306162,22076540,137991,68995,68996,3zqXX6kzhkbW3d4TwD2CNjMRwxTbREXySekvq37kfCNk,5519665,60292300,-54772635,625
2022-01-24 07:47:22-05:00,10516,HZSJVNb6g4o52N7pAJCLkGjur8evF5Ex1sAx7uUxUDdm,8LQHKhXStrwcd6f4AxaTVcrGdYpGjQz8vWf5JXsAzcsp,True,180825,45206,282,141,141,3zqXX6kzhkbW3d4TwD2CNjMRwxTbREXySekvq37kfCNk,11290,216704,-205414,624
2022-01-24 07:47:22-05:00,10517,BtS853vNEgvkEFhfkBPiHdcfry7SFVTC4hAX14rPhDiE,2LnfhTwvctYdZmmBvVkajF8XPnzGk4ghvZKaTnyHxZLP,True,160522406,40130601,249622,124811,124811,HfEnetJ7uBSmZWCjBNxdvv9HEC5nsW4wDV7wu6WnhWan,9984908,132190502,-122205594,622
2022-01-24 07:47:22-05:00,10518,Fw2e6jxKVeFcJSe9MyVhSz3dUdJQLs3XULHrT1mtMU9U,591U5bexgLRJXygtK5fpCRXcZEq89KgewFTdfPkti8bY,True,18610989,4652747,29022,14511,14511,3zqXX6kzhkbW3d4TwD2CNjMRwxTbREXySekvq37kfCNk,1160898,20046785,-18885887,623
2022-01-24 07:47:23-05:00,10519,E8iuHK2DErFnMAYfWmNoix4jVb4WDG8Sc41hBycLUxbd,77Zoru23JmnK5EJ8eURonQoEpJcLP4edabjD8MR8NKdX,True,2438715,609678,3806,1903,1903,3zqXX6kzhkbW3d4TwD2CNjMRwxTbREXySekvq37kfCNk,152246,2921623,-2769377,624
2022-01-24 07:47:23-05:00,10520,EPWsutEpgpcz776maq552k8QhDKdmkSfAED5E3jgpTdY,CCwGZYDvqoHEBBtSSieAJgy5e3k4jYrpjyDffypwnWxu,True,6538767,1634691,10181,5090,5091,3zqXX6kzhkbW3d4TwD2CNjMRwxTbREXySekvq37kfCNk,407276,7569135,-7161859,622
2022-01-24 07:47:23-05:00,10521,4yhW5mBsFVNgQ5QQc2Yg65guctPsTSXcERbzmYM6rdnL,5uJnMZ6DWA9bMSvHvS5zomwtt1sv7YCWq3GDJh77YC3q,True,154700,38675,241,120,121,3zqXX6kzhkbW3d4TwD2CNjMRwxTbREXySekvq37kfCNk,9667,185644,-175977,624
2022-01-24 07:47:24-05:00,10522,Hqzz5RdbkkmMPCVdxF3Q3sLuh7XVJHEwAP6zpz7pCwTj,TNwXSETgrJGM9S5zbBY3mMWKbPFskbKjPAhBrWFNfuK,True,140582,35145,219,109,110,HfEnetJ7uBSmZWCjBNxdvv9HEC5nsW4wDV7wu6WnhWan,8761,167712,-158951,623
2022-01-24 07:47:24-05:00,10523,43EtYHdVkdBxHTtFR3QWVgvCKj1SqsAf7xLY2yphsv1x,8WJbP4mVJWYuN1dVzHpRg7YR2nBELB4Krkq8Zch8sp4g,True,192341,48085,299,149,150,3zqXX6kzhkbW3d4TwD2CNjMRwxTbREXySekvq37kfCNk,11970,214988,-203018,622
2022-01-24 07:47:24-05:00,10524,43wwd6zLB8yKfXEu7rtbeDFhKBuxFR66MnyhTKW3zqa3,A9t6AMvVNenwWymz3QMtdUuuGYjjTPLaA9bhRjTzNY9h,True,2450633,612658,3811,1905,1906,3zqXX6kzhkbW3d4TwD2CNjMRwxTbREXySekvq37kfCNk,152461,2933340,-2780879,622
2022-01-24 07:47:24-05:00,10525,4nhdidD6SASYzwZ7mUnWKyP4xyWXhdBe2gp5F4qDtLrL,HLk6YPhVidsn3i8HfoASvoim1ztxb4bi8JnioiyvorpV,True,883371,220842,1374,687,687,3zqXX6kzhkbW3d4TwD2CNjMRwxTbREXySekvq37kfCNk,54983,1029777,-974794,622
2022-01-24 07:47:24-05:00,10526,BMawc4jLJMER4ryGcwdm27H3MU8JQCiSfwb9onVfYDpr,5ciaGDuaB3rBKvV7MphT2eMkCUxBzWZc7zYXQM7vbQ46,True,924498,231124,1437,718,719,3zqXX6kzhkbW3d4TwD2CNjMRwxTbREXySekvq37kfCNk,57496,1075626,-1018130,621
2022-01-24 07:47:24-05:00,10527,GcjcaWoMUcGkLaJBx3svxtzwGNn5SLcFrwaLqnpadUZY,Ep9sDjTMMasVjKdshsE88uk3mWYkKuMTVRooVJWvCq9F,True,2391171,597792,3734,1867,1867,HfEnetJ7uBSmZWCjBNxdvv9HEC5nsW4wDV7wu6WnhWan,149388,2861680,-2712292,624
2022-01-24 07:47:24-05:00,10528,446VESPwhh16pG3VcpgraT83MoqWy87qgU36mKZC8BsW,SmUPkPpnnRfSH3tcKUnbpK6HHNJtLfvMiUWk9eUwkNy,True,6499143,1624785,10112,5056,5056,HfEnetJ7uBSmZWCjBNxdvv9HEC5nsW4wDV7wu6WnhWan,404491,7523162,-7118671,622
2022-01-24 07:47:24-05:00,10529,C1tcxAjMzZaFVcF2ke2nSyiCjcLBwsz5yKXShy5MB14h,GYkrJj2zHVZuzPC45MbuevYkRJHdeL4Sqj9SWqZfUdiE,True,8227496,2056874,12832,6416,6416,HfEnetJ7uBSmZWCjBNxdvv9HEC5nsW4wDV7wu6WnhWan,513319,9488369,-8975050,623
2022-01-24 07:47:24-05:00,10530,B4Uc39nKzz9wBRQsCkMR4A7RwTJ8rSuwpR6EQn2AesRb,H49bGZgatRZVpj6QufZRVgYrQtH7LpdbiqKBs23151m,True,15645,3911,24,12,12,HfEnetJ7uBSmZWCjBNxdvv9HEC5nsW4wDV7wu6WnhWan,975,29837,-28862,623
2022-01-24 07:47:24-05:00,10531,4eaXYcx5ayhTq9TmmQFgLDjy6p3z93txUN97v8PTSh1J,J3vgUnjDUy5ngrmrs6FwpZTexxJNxXM1UjsHvsgw9g9y,True,157295,39323,245,122,123,3zqXX6kzhkbW3d4TwD2CNjMRwxTbREXySekvq37kfCNk,9833,188139,-178306,625
2022-01-24 07:47:24-05:00,10532,28YQqynu5oRud5xEcsDvAaGhJhgpiVJSTNeMwkrbpbyv,9zYqRWiRatbohCdBfV3PrAxp8v1kwgbvV9ta4RJRRp68,True,6407276,1601819,9994,4997,4997,HfEnetJ7uBSmZWCjBNxdvv9HEC5nsW4wDV7wu6WnhWan,399795,7416062,-7016267,623
2022-01-24 07:47:24-05:00,10533,DD1a8rMoUCwmEiLKRN43VpdqL8Qgfr5yi92ejQxDVRMo,3vMJVNAuyRhM9jkaEZARhwbR6MerR5UmcgoZ9c5bs1VS,True,2877587,719396,4491,2245,2246,3zqXX6kzhkbW3d4TwD2CNjMRwxTbREXySekvq37kfCNk,179651,3444972,-3265321,624
2022-01-24 07:47:24-05:00,10534,Bt37YbHvD2M8zcGmanksKy8MCi4Qzto7hEnGRJyNvWyg,4WGRnDhpoY4zJi74iJyALasETpJNJMCJtf9aWJUVrHQv,True,200745249,50186312,312995,156497,156498,HfEnetJ7uBSmZWCjBNxdvv9HEC5nsW4wDV7wu6WnhWan,12519823,136954509,-124434686,623
2022-01-24 07:47:24-05:00,10535,5iRLEmB6qBHqkJBPyyubnd9f1TpRr4EY8BTxuHUREeLB,GkY73KL6HJ4ycdggFtYWALBgmTRZVCx66P2ZJ7E8ENwC,True,134251,33562,209,104,105,HfEnetJ7uBSmZWCjBNxdvv9HEC5nsW4wDV7wu6WnhWan,8362,160694,-152332,622
2022-01-24 07:47:33-05:00,10536,DvuRmJkfn6FQczUKgYeaSCqwy2NTMunuAKNrnmxMvnzS,7LpWTX9dgBtW75kfEoB5WuNsDwEdw5s8CYSHh3J4qagM,True,251348,62837,390,195,195,3zqXX6kzhkbW3d4TwD2CNjMRwxTbREXySekvq37kfCNk,15636,269158,-253522,622
2022-01-24 07:47:34-05:00,10537,FV3G5EsSmyiLAAoREhgDXwvzbxoyDeq4Mwfj4jK5fJ7U,5nhzbJmm5JAwGDpTZoenkM1u3XtMY4uN7Qsm3vFGtRJE,True,244585,61146,382,191,191,HfEnetJ7uBSmZWCjBNxdvv9HEC5nsW4wDV7wu6WnhWan,15303,151833,-136530,625
2022-01-24 07:47:34-05:00,10538,4hZG7dM716SxDagiFGwt1gSC99B2QK1emGLV9TJmmuR8,7vjfUWySkyx4Z5qAaRr2VWnVvxHHNsvPj1PirGNSjM6,True,746988331,186747082,1160049,580024,580025,HfEnetJ7uBSmZWCjBNxdvv9HEC5nsW4wDV7wu6WnhWan,46401987,489879327,-443477340,621
2022-01-24 07:47:34-05:00,10539,5FgPU7KpsDnx4Xc1UdQoLPR7MDd5cBkJXW2Q8ctopMZR,9GWzAZFVfTY8WjTYvDAE2YcAjgeKiDXgToK76KBZF7Rv,True,207726,51931,320,160,160,3zqXX6kzhkbW3d4TwD2CNjMRwxTbREXySekvq37kfCNk,12825,241052,-228227,617
2022-01-24 07:47:34-05:00,10540,EmXaq1sxmAZUiwYW6LXpKtKFZXu5MzQ3sK4MEAojDK1h,HuAsa5G2wJi8Ah9stxEmggwcB5zW1QjBsP3Ndgke7r8X,True,210359,52589,325,162,163,HfEnetJ7uBSmZWCjBNxdvv9HEC5nsW4wDV7wu6WnhWan,13038,251515,-238477,619
2022-01-24 07:47:34-05:00,10541,9wsQcvpqPp8c9q42RntWDNbqNCnmJeW4GMG2AtKAHkBu,EMqRbzGvXTU1LtmoSw9uSrpTX2L4tpJQAMJJJ4duvzf5,True,22300561,5575140,34488,17244,17244,3zqXX6kzhkbW3d4TwD2CNjMRwxTbREXySekvq37kfCNk,1379526,15263307,-13883781,618
2022-01-24 07:47:35-05:00,10542,5zCfNUARbvDrkdkf8rKNnf6D7HXn7Wz6D61jQGTGpw3N,6T76MLTxS5vnRuodEgADt3iXMx8WUFLQzoyKh7f2uPFy,True,284468404,71117101,439561,219780,219781,3zqXX6kzhkbW3d4TwD2CNjMRwxTbREXySekvq37kfCNk,17582447,195591289,-178008842,618
2022-01-24 07:47:35-05:00,10543,96StvqZyFUPtyMr4o9s7K4V29RSNyRpVi76vNwxG5rUf,GZKXFSFq4aGiTaqovtxqNCCVGkAFNXPh4Hep1ZMwdZ8g,True,13948,3487,21,10,11,3zqXX6kzhkbW3d4TwD2CNjMRwxTbREXySekvq37kfCNk,861,25942,-25081,617
2022-01-24 07:47:35-05:00,10544,C1CsbgQFvEvSXzuVHTr39tQHr3drDhjxeYiotd8eNocF,4rAaTCAMj5VpgNVKiYizabH7cMLhEA12seu2QXQNTyV3,True,861168,215291,1345,672,673,3zqXX6kzhkbW3d4TwD2CNjMRwxTbREXySekvq37kfCNk,53839,450045,-396206,625
2022-01-24 07:47:35-05:00,10545,5acohGZShYQVNGZEfy7pTyX7E8MzqRDwByhFL1H53UNv,4Z454ZseKbWGEtdrE9eotbDZ7o9VHhooMYriTfSFHiGt,True,57690637,14422658,90196,45098,45098,3zqXX6kzhkbW3d4TwD2CNjMRwxTbREXySekvq37kfCNk,3607868,23886541,-20278673,625
2022-01-24 07:47:35-05:00,10546,8xjstKJD2RopRxxRP8JbMYRmpBKgSZivMFRXXRZ5syPh,HUfevkvBsm5SDpxnZ4NBD8Re7LvqBQLrx5UWXCeYTBgK,True,232727,58181,359,179,180,3zqXX6kzhkbW3d4TwD2CNjMRwxTbREXySekvq37kfCNk,14384,270367,-255983,618
2022-01-24 07:47:38-05:00,10547,8YMEydGnQH9W5AEXFGquFkb1bcf3PcxiMvYBSMPXKJyQ,3CmWH8eYtkmHNisqMmMBLff6C6z6ZcSj38KoQ34DPUE7,True,123319,30829,192,96,96,HfEnetJ7uBSmZWCjBNxdvv9HEC5nsW4wDV7wu6WnhWan,7709,137988,-130279,625
2022-01-24 07:47:38-05:00,10548,8GdYhwX26GRmVfGFCbJ3MJrH1UdneN2FNRUexhLsqprN,DpUTHSVucDPyCWoLCdpm8EFRZFiKL88tmnSiWG2TRpS8,True,140926,35231,218,109,109,HfEnetJ7uBSmZWCjBNxdvv9HEC5nsW4wDV7wu6WnhWan,8733,168114,-159381,619
2022-01-24 07:47:38-05:00,10549,GwYr2DmtMVLWxVz6kVSXR6rvxL4x3DXtvNC7taswSWHN,2otMHa7JT1twPSSN6XF9fqGkKrEK8nnuMFZG1TtAgFQk,True,1073,268,1,0,1,HfEnetJ7uBSmZWCjBNxdvv9HEC5nsW4wDV7wu6WnhWan,67,1265,-1198,624
2022-01-24 07:47:38-05:00,10550,6sK2PQyTvStxT9qigrFaPmf9GSe4X4wLb4ig7izrzwaB,6iyTuXdnBiLrKPCat7ajRnUq2245L9bbJrHAvsnyFx8e,True,1073,268,1,0,1,HfEnetJ7uBSmZWCjBNxdvv9HEC5nsW4wDV7wu6WnhWan,67,1266,-1199,624
2022-01-24 07:47:38-05:00,10551,8nXbrdjjaHB73CRPRenGEQj73wbtEFGDwXsehRGMhsap,43pvdcJ6f27wz94D6ZboKwRJYbyvYCrjsJhYsvk7LJCM,True,38946,9736,60,30,30,HfEnetJ7uBSmZWCjBNxdvv9HEC5nsW4wDV7wu6WnhWan,2415,31318,-28903,620
2022-01-24 07:47:38-05:00,10552,6Bq55LtGCEeGqh4JrFLCmmGc2iJfTTBJixivqH78aGSE,DSNrCgWJeNe2P9tAQu5FvCueTzNKDKds7wzuwTQSMRG,True,4151,1037,6,3,3,HfEnetJ7uBSmZWCjBNxdvv9HEC5nsW4wDV7wu6WnhWan,258,4633,-4375,621
2022-01-24 07:47:39-05:00,10553,HpRYrL8HzCPaBJTLFgZmYg2aXBnBQUpf1mikVkzkY56z,8DzHRd8qWcEjnX6cefwYtgRGpQJUaw9QPjyfAsN7j33r,True,1602842,400710,2477,1238,1239,3zqXX6kzhkbW3d4TwD2CNjMRwxTbREXySekvq37kfCNk,99115,1874754,-1775639,618
2022-01-24 07:47:40-05:00,10554,6aW9dhnTNerVd1MPv5GrcYqgjVPE9LsNCGYSJSrNdgS8,8kmJu2UxTk2T37sqxDSrf6pDWhJZRxfRdJB7DLeoWddJ,True,5203497,1300874,8088,4044,4044,3zqXX6kzhkbW3d4TwD2CNjMRwxTbREXySekvq37kfCNk,323548,5939120,-5615572,621
2022-01-24 07:47:40-05:00,10555,Gfe4UgUGqvzcehSbETrWwLRAcqzFnkTrs6vJx8h6kTxi,7exMQ8sLti4Pmb2ZQtZhyuWRuQ6pq7XSXL9sCcWTqCvF,True,12773706,3193426,19869,9934,9935,3zqXX6kzhkbW3d4TwD2CNjMRwxTbREXySekvq37kfCNk,794784,15035599,-14240815,622
2022-01-24 07:47:41-05:00,10556,CEtpqFD4BbeiNfaXyLLYEapY2mWgE26H5q6H34tWwRuD,BVqRyqwGFPzSkk1H2finiyfaL3LScbEiQGk3mihirxqs,True,115724,28931,178,89,89,HfEnetJ7uBSmZWCjBNxdvv9HEC5nsW4wDV7wu6WnhWan,7151,136602,-129451,617
2022-01-24 07:47:41-05:00,10557,G3vArDs7nb18se4xMZ68oMHmTAsYP63x8dfY57jAogwp,EY7J8Hw8jWbryw11CYdPVUSdAoDGGNEfacqghVnJn3JK,True,2357307,589326,3625,1812,1813,HfEnetJ7uBSmZWCjBNxdvv9HEC5nsW4wDV7wu6WnhWan,145004,1451025,-1306021,615
2022-01-24 07:47:41-05:00,10558,EDSf2w1UyGvbgMuxyoXL58ifR1dviZinnLBYnFmgjcNG,DFenkzbL9SUjs9cSCaHJ1eXK75mHfk3GSPRFs8TSzrFV,True,9299735,2324933,14371,7185,7186,HfEnetJ7uBSmZWCjBNxdvv9HEC5nsW4wDV7wu6WnhWan,574874,6281984,-5707110,618
2022-01-24 07:47:42-05:00,10559,4cNmhgaMic1xBiaDJ6phrQuXmm8WfF1qjyYMqZcKG4c9,43vgfXiLTtcs1bkrcDar2iz9M6RMbGqbA6BMkBHdh7T4,True,147667,36916,230,115,115,3zqXX6kzhkbW3d4TwD2CNjMRwxTbREXySekvq37kfCNk,9235,177708,-168473,625
2022-01-24 07:47:43-05:00,10560,BYvjENe16Ta77PqGV7JKEWrsqCTfkMGYwTSG5gXneDvd,EvxAXgvhPC6QkNurbK7vWyTApGo8J2R4EgMAknkHVU3d,True,1868,467,2,1,1,3zqXX6kzhkbW3d4TwD2CNjMRwxTbREXySekvq37kfCNk,116,2775,-2659,620
2022-01-24 07:47:54-05:00,10561,2pMGfXreJV4ZGoQtRyvhdE8TFccLhkguLb7JsjGnyr7p,7FVhyNsmwmSKF8H73YfLmx6ASLw9G13r3LXDnRqKjWKL,True,3678444,919610,5739,2869,2870,HfEnetJ7uBSmZWCjBNxdvv9HEC5nsW4wDV7wu6WnhWan,229599,4460843,-4231244,624
2022-01-24 07:47:57-05:00,10562,GGcsY84pkqUn2xySuLYrUUg8gWMBWgfHaQ7rK42NoZaH,4EyjJvctL9WBQiauD2Eaf2Hus8htYzHxP5GR2HsUfuks,True,31507017,7876753,49260,24630,24630,3zqXX6kzhkbW3d4TwD2CNjMRwxTbREXySekvq37kfCNk,1970433,18878969,-16908536,625
2022-01-24 07:47:57-05:00,10563,4WSiQCTqMvpSYvrbenQGFoV6fuDALSWMwZZ9MgP82fwb,6Y5GdgKErVfXrabSTi89X7xCEsZnoqDqwFD4hZ3FVtfN,True,4044710,1011177,6304,3152,3152,3zqXX6kzhkbW3d4TwD2CNjMRwxTbREXySekvq37kfCNk,252176,2952643,-2700467,623
2022-01-24 07:47:57-05:00,10564,6kt64nJRnYaWMi9GbpZaUuhbToAVRd7FUMTGASAAJrve,2Sdxv9ZtogNcVbJwBPxKmVjwAiKyX5GHEfnRmFcydQ1G,True,18284539,4571134,28563,14281,14282,3zqXX6kzhkbW3d4TwD2CNjMRwxTbREXySekvq37kfCNk,1142554,19738400,-18595846,624
2022-01-24 07:47:58-05:00,10565,C1rjefgArnN3nBn5Wu3yXij2wAyGWFtWdjGNLR9vpjmj,GsLCESLzYGZ1brEh8RJrZttE7hxcpSq7iUqdhwJhnDVB,True,491754,122938,768,384,384,HfEnetJ7uBSmZWCjBNxdvv9HEC5nsW4wDV7wu6WnhWan,30751,438532,-407781,625
2022-01-24 07:48:02-05:00,10566,2DHhfXSzcuSwsKfAYLMuWuD17w84mCwNer9fcBNLTpSc,89BVfDycKjdSkQzFVqCXd5c16DntdND7WsqoZtCafYFH,True,7536661,1884165,11786,5893,5893,HfEnetJ7uBSmZWCjBNxdvv9HEC5nsW4wDV7wu6WnhWan,471446,8771543,-8300097,625
2022-01-24 07:48:02-05:00,10567,4qWzk4JP2gEsTP252Y4SJrjSmfRBxDfE4ZdbPmwavfb2,CAgDhCNVyy61FG2YPMnm9zxgY56s2UqPhvssH5G1LjXP,True,16799480,4199870,26271,13135,13136,HfEnetJ7uBSmZWCjBNxdvv9HEC5nsW4wDV7wu6WnhWan,1050879,18054148,-17003269,625
2022-01-24 07:48:02-05:00,10568,45AiuRBbmupfwYXqsWwKHtmEWN8XNJDUSHwHL3b6PvHc,CfvwVkxYPP3jqK2dpAvSRFA1513E9ti84mEpYgtkzFUt,True,267793,66948,418,209,209,HfEnetJ7uBSmZWCjBNxdvv9HEC5nsW4wDV7wu6WnhWan,16753,309949,-293196,625
2022-01-24 07:48:12-05:00,10569,8xQ3tsWVUe75EG1HmocULJ3kh52utveoFMEPotTGrKno,i3SKW3ywrwYucX9ySEx1C4zaUKGnzLerP3V38437NyV,True,117200,29300,182,91,91,HfEnetJ7uBSmZWCjBNxdvv9HEC5nsW4wDV7wu6WnhWan,7315,148644,-141329,624
2022-01-24 07:48:12-05:00,10570,HxhVxMpFpKzeuC6Z6CpsuUhPHdHUzvpMNYJ8LpQ3NYCp,8KyiipC39iU15zVErVvj6hdhbv89STsexrB8dVw3RcLs,True,164702,41175,251,125,126,3zqXX6kzhkbW3d4TwD2CNjMRwxTbREXySekvq37kfCNk,10076,197615,-187539,611
2022-01-24 07:48:13-05:00,10571,8GhXRNmsEgFgKPhGNNgEPUywVzW3bE7uZRWys2P1yNeJ,Bvi5vD5fhRFNdVhEXsSv9vkJzyQzgEswFHBxowkUEgF,True,1355993,338998,2073,1036,1037,3zqXX6kzhkbW3d4TwD2CNjMRwxTbREXySekvq37kfCNk,82948,1609922,-1526974,611
2022-01-24 07:48:13-05:00,10572,3R2wxFQwjCqUwwxJmp9tNrT6osYFpB5gczq2QYik6QYm,7At5Ej3ZsynfWr56FYrd4P4Y6UtD8FHA4gCFB8TaAyaG,True,157268,39317,241,120,121,3zqXX6kzhkbW3d4TwD2CNjMRwxTbREXySekvq37kfCNk,9671,188500,-178829,614
2022-01-24 07:48:13-05:00,10573,CygwJ5Z1ZP6xfjN1ZGH7yw8b2oYvf6JTpenXx7A5yFdt,59VKgJtBCTb3Pji7BWtqttisBYVVCnWtyEn5Eba5r52Y,True,2731798,682949,4170,2085,2085,3zqXX6kzhkbW3d4TwD2CNjMRwxTbREXySekvq37kfCNk,166801,3065804,-2899003,610
2022-01-24 07:48:13-05:00,10574,G8nRLTWTT5aD7q7TcSa2mw7p12GUuHDVq5ev4vyXbdKi,3DmQyungZMK4T1a1PgXh5shBskwP69tTLmZPh7HZ76vh,True,229787,57446,356,178,178,3zqXX6kzhkbW3d4TwD2CNjMRwxTbREXySekvq37kfCNk,14242,274924,-260682,619
2022-01-24 07:48:13-05:00,10575,8VQ21PFXdHBNmiZiF18LyGvsRSpr13vkyktfembNCe3m,5exbVC7vaGFeHEGAx7epYfMaU932QafqzfhFm5FKAq2H,True,142236,35559,220,110,110,HfEnetJ7uBSmZWCjBNxdvv9HEC5nsW4wDV7wu6WnhWan,8838,170168,-161330,621
2022-01-24 07:48:13-05:00,10576,HZJyrD4eqM4nKnyRh2JAs1sC2TaJxFhNPixBdK7PLMuS,Hycz71z4tEsKUogJnefT2GN3MPCLdTJdv9B6T82Ngw2u,True,676656,169164,1039,519,520,3zqXX6kzhkbW3d4TwD2CNjMRwxTbREXySekvq37kfCNk,41565,816535,-774970,614
2022-01-24 07:48:13-05:00,10577,9WRDBHzD4aNHw5qvrhc6nqXCBLA5D7YYP8TvSrLksXd6,GwxWNmv9XDkqQsx7DfCMccFjVik8asPnFU9gtnb4UVx,True,121652,30413,186,93,93,HfEnetJ7uBSmZWCjBNxdvv9HEC5nsW4wDV7wu6WnhWan,7455,145785,-138330,612
2022-01-24 07:48:13-05:00,10578,7afnF1MkAootZGWc7zsMVLpBuve83hGmvAHkfmwgsq5A,HKdJE8bReznq1Qxqd5iZ4nWQGCk62Vo5TpkRD51bpbGp,True,161436,40359,247,123,124,3zqXX6kzhkbW3d4TwD2CNjMRwxTbREXySekvq37kfCNk,9885,193424,-183539,612
2022-01-24 07:48:13-05:00,10579,6X5por58mMECmNZQEWpo8M8aA1eHJqr5LNeV9vC7GW5e,DPB2C5UB2Ls1kNzbs1GP33junQvhUyFJWP75RoYjqByn,True,8381723,2095430,12978,6489,6489,3zqXX6kzhkbW3d4TwD2CNjMRwxTbREXySekvq37kfCNk,519145,15534061,-15014916,619
2022-01-24 07:48:13-05:00,10580,6TvTxJWSPeyaTVm8PmarVDzxhbTqnkyoabQTgihXyGMj,62ngTMHaRDFjpvzasDgfmgyJ5T6jS9PmYgy97HCkyQS4,True,4444840,1111210,6870,3435,3435,3zqXX6kzhkbW3d4TwD2CNjMRwxTbREXySekvq37kfCNk,274831,1289058,-1014227,618
2022-01-24 07:48:13-05:00,10581,AiLCB8xw3k5FXdJE1T42PLFhHrz1bLTKpNekR61a915N,HB7CNWxLipWAc6MPGq9wV4TT7AYjiELA5T3onYeVqBbU,True,3161510,790377,4930,2465,2465,HfEnetJ7uBSmZWCjBNxdvv9HEC5nsW4wDV7wu6WnhWan,197239,3813822,-3616583,623
2022-01-24 07:48:13-05:00,10582,73Wkg27usHy8knWENTmb9zbikugYh93JvBB2bF855vZ2,J9WaUA7r8ct4ZG8o8ATZjvHUPuCYqY42aTsr9xveW5BX,True,164571219,41142804,251979,125989,125990,3zqXX6kzhkbW3d4TwD2CNjMRwxTbREXySekvq37kfCNk,10079174,241022209,-230943035,612
2022-01-24 07:48:13-05:00,10583,68F35fonSGS1P6LMYmAmeoM8kC6Z78NabMqYLeCZr9GJ,8apmWSZdS8s1ScoNVj4AvSJsbQCj1drU3HL74khuANT2,True,167196,41799,257,128,129,3zqXX6kzhkbW3d4TwD2CNjMRwxTbREXySekvq37kfCNk,10304,200178,-189874,616
2022-01-24 07:48:13-05:00,10584,oTq8BsGLNc2ddcdR7ELnCXgzf4KvtA7REmfbFKo56FT,4PgxGgi2UaB753PFyELQCrJy7phAkYsW4e39J9wGWrcM,True,9877104,2469276,15201,7600,7601,3zqXX6kzhkbW3d4TwD2CNjMRwxTbREXySekvq37kfCNk,608070,18855980,-18247910,615
2022-01-24 07:48:13-05:00,10585,2AAWghW6BUAFBtF3R6hB9uoqMc5oUDkU8FTd2JrXKema,798cfEUZ2YhXwNTNjXMS4Z2J8gAHaK4zZwpMkq2HzWWM,True,844348506,211087126,1290908,645454,645454,HfEnetJ7uBSmZWCjBNxdvv9HEC5nsW4wDV7wu6WnhWan,51636345,697709007,-646072662,611
2022-01-24 07:48:13-05:00,10586,Dqnxcekm1QfxGQ2FSJ6SjFiwmaQRWEjW9WTJQG4AjEpE,9JiMtjm5AJqngosRg787FiN8NyuBPuAPD2jYpRQkAc1d,True,204819,51204,319,159,160,3zqXX6kzhkbW3d4TwD2CNjMRwxTbREXySekvq37kfCNk,12775,245168,-232393,623
2022-01-24 07:48:13-05:00,10587,9QZvB1Gqhk5PKt3MoJMjZL3FaU2bTbTDcVw3nF316zh7,DGJWGr9RCWkzdWn21mWG7NyUN8uuvSQbA53HojFJe1rH,True,2024763,506190,3145,1572,1573,3zqXX6kzhkbW3d4TwD2CNjMRwxTbREXySekvq37kfCNk,125821,2339658,-2213837,621
2022-01-24 07:48:14-05:00,10588,AECUZGm5DjFvbLZEUYhepSPg1Wa7hBjxF9e7ZRBzRPhm,Ar7e1iLKAqa54QiQnXifvnETixDZT1T8KL5YWJA8Ykv1,True,190414,47603,290,145,145,HfEnetJ7uBSmZWCjBNxdvv9HEC5nsW4wDV7wu6WnhWan,11609,227777,-216168,609
2022-01-24 07:48:14-05:00,10589,AzLdwyd8Q4V3iMaSwWgvWwQ9nCs7X7YV2YKpd6CH33nP,BYjeXF5YkcJy3mNMbvfHzXTtyjkc4U53hM5tvfERUH8y,True,156276,39069,241,120,121,3zqXX6kzhkbW3d4TwD2CNjMRwxTbREXySekvq37kfCNk,9650,186977,-177327,617
2022-01-24 07:48:14-05:00,10590,EAUFD16wab8qRMJ4H6updHGt4xFqgRCDeRHVCsLCTSTL,8vkfYSyCyBY9g4TZrp52jUcQj6udy9xAaA4fioRE2RXx,True,94233362,23558340,145861,72930,72931,3zqXX6kzhkbW3d4TwD2CNjMRwxTbREXySekvq37kfCNk,5834447,67262583,-61428136,619
2022-01-24 07:48:14-05:00,10591,ANXYsUNpZ34dBt7cp6HEE7oi2pTKsbj7B5TeFHKPbHBU,2pqeP4fuMREosHcfWUecEBssp1GM4isihNjn7ALUD51d,True,191339,47834,297,148,149,HfEnetJ7uBSmZWCjBNxdvv9HEC5nsW4wDV7wu6WnhWan,11916,228911,-216995,622
2022-01-24 07:48:15-05:00,10592,69byqtDPmgEY1NqKBCR95CEPVHRUxgbNW9Y4P4HjQ7ND,E47T4q4zMGzNL6vDxgWdLn3EQbW3WfVryr8Jsymy1hAL,True,259595,64898,400,200,200,HfEnetJ7uBSmZWCjBNxdvv9HEC5nsW4wDV7wu6WnhWan,16024,284918,-268894,617
2022-01-24 07:48:22-05:00,10593,52pCCDDTo6uQhENab7rCsqS5ZihDDBmMSTQdCj8QLoea,GZh4ev3p6RrDRo98WfQQ7ZzzMBbqWF9gj9WbicU7YWD4,True,56909731,14227432,88857,44428,44429,3zqXX6kzhkbW3d4TwD2CNjMRwxTbREXySekvq37kfCNk,3554287,21644682,-18090395,624
2022-01-24 07:49:54-05:00,10594,3c4tj9J8QwB3exFchWei43nBh5xsYRZxEUfayi3JvYgm,Fyw1TEEDKhLFo16qxDsttsAwSkrfzpDe8Dmm3atEeXyN,True,1189600,297400,1861,930,931,3zqXX6kzhkbW3d4TwD2CNjMRwxTbREXySekvq37kfCNk,74460,1101899,-1027439,625
2022-01-24 07:53:21-05:00,10595,4PZZxNrWLhNCuT5VJ1DQe3XxQVVwMPrjfUpdeAY8qS7U,A7CvKre7y5VbUN1HneNHmuBv7jWtayV78oozAqaVbQrv,True,47050900,11762725,73319,36659,36660,3zqXX6kzhkbW3d4TwD2CNjMRwxTbREXySekvq37kfCNk,2932794,51313080,-48380286,623
2022-01-24 07:54:09-05:00,10596,HwosLQgDY1xtHQRQ4hzroPQHFWssPzTj5vRkP37FcviB,HKTNEYNXrephNkH7apbobK4mcQXcNayQA4W1NgM6sLr8,True,450514,112628,705,352,353,3zqXX6kzhkbW3d4TwD2CNjMRwxTbREXySekvq37kfCNk,28200,316580,-288380,625
2022-01-24 08:00:24-05:00,10597,DC4UVUDFWL3gVtgkX9hPtFgtxaA8DH5p94i4k9U3wyWv,3HCWqVvQQfRgSKitsTjGTduJ82ointZUSNtj13uea4kD,True,5175715,1293928,8014,4007,4007,HfEnetJ7uBSmZWCjBNxdvv9HEC5nsW4wDV7wu6WnhWan,320579,4633032,-4312453,619
2022-01-24 08:00:24-05:00,10598,2sPD4f4d3CCeFSwSC5vAGS3YoTsTGypYKfDeoJczebop,HWCRpcq2sXqJL7Vi8MtipQDwGSViE73bUxS36ETmvnP2,True,530389,132597,826,413,413,HfEnetJ7uBSmZWCjBNxdvv9HEC5nsW4wDV7wu6WnhWan,33053,323538,-290485,623
2022-01-24 08:00:55-05:00,10599,DXEJNyHSCbGZezXHy2xQaSzd37dwJs4dMTgt5VF5UZAG,7fCYM9DWrAX7vgZ11CwQMNd5NU8FB1yrbctxHaPYshpB,True,1584428,396107,2428,1214,1214,HfEnetJ7uBSmZWCjBNxdvv9HEC5nsW4wDV7wu6WnhWan,97149,765042,-667893,613
2022-01-24 08:00:58-05:00,10600,3oCun4gm3k8sXxVxiYM8okGi8iCXH9LvDkHf9PBQWYXR,E1np1dZ7jUm811ddvy1jQerBwGSYb5BbZWnUHeotvrfH,True,485584,121396,753,376,377,HfEnetJ7uBSmZWCjBNxdvv9HEC5nsW4wDV7wu6WnhWan,30127,264038,-233911,620
2022-01-24 08:00:59-05:00,10601,CM95f7KjJuAf1xVTWhu3wrp6BfMz116FbgkxBhcRNs4k,EG55wkH5NcoasfBUYhD5D2dc2uvo11dZ3uTu5wgs4gf2,True,274981,68745,427,213,214,3zqXX6kzhkbW3d4TwD2CNjMRwxTbREXySekvq37kfCNk,17106,316085,-298979,622
2022-01-24 08:00:59-05:00,10602,Bbd196A866Y9rQWQFt4YGg2R6Jqj7WQGXWPDmrNtPcKf,5gmWk1KwLoRHnhkjxps4Ad6aVk4ZpcfC3McZCWDVCUbu,True,150858,37714,235,117,118,3zqXX6kzhkbW3d4TwD2CNjMRwxTbREXySekvq37kfCNk,9407,186685,-177278,623
2022-01-24 08:01:00-05:00,10603,DjbEch16uzdDtujFUeqxjquTTS3JXzEys8e9ogUv3aTy,6N8eKb3kfcbJEUZKZERiFiUR4hubB635D8Sotiji2TU8,True,18949370,4737342,29655,14827,14828,3zqXX6kzhkbW3d4TwD2CNjMRwxTbREXySekvq37kfCNk,1186219,20527392,-19341173,625
2022-01-24 08:01:00-05:00,10604,4eba4qAmwfqmihaYvTWFU9hm4VYrKvNhNywHNyimQJNK,G1DyxJcNQD8u4KGfnwxttyrJMfse1FBAsofioEMdTS9U,True,976833,244208,1527,763,764,HfEnetJ7uBSmZWCjBNxdvv9HEC5nsW4wDV7wu6WnhWan,61109,1174711,-1113602,625
2022-01-24 08:01:00-05:00,10605,GM22yjVoBCzgBcVTT5EcgRhVWiXVV82kSj1dPCbegKWj,CDDy8JmJMwJyx1YAvEPpj8AYxCpngRovf3wWfVzao5Rc,True,93001,23250,144,72,72,3zqXX6kzhkbW3d4TwD2CNjMRwxTbREXySekvq37kfCNk,5792,63035,-57243,622
2022-01-24 08:01:00-05:00,10606,8XcMucCQpWfNtbdCYnKuabk91NQ9wfYp7byk496CwU9n,DLrApDfWcyMqufEFZm9PvddsMoiediT58X8e8pxpnzrk,True,257978,64494,402,201,201,3zqXX6kzhkbW3d4TwD2CNjMRwxTbREXySekvq37kfCNk,16090,297946,-281856,623
2022-01-24 08:01:00-05:00,10607,2ZX5NexeuZq25mAfBFDrwd44UfKhWgzmSwdhWFmo48c7,CpNnhSqg7EHn9g84gHoo831sVrAe5SkwNaEZAash4CXs,True,1064865,266216,1661,830,831,3zqXX6kzhkbW3d4TwD2CNjMRwxTbREXySekvq37kfCNk,66457,1282069,-1215612,624
2022-01-24 08:01:01-05:00,10608,Go3ne58krEsFsZ5yu9EBT7od15VCYmtbs1KhumRMTiXS,HCvwQ7HjmmeDXrguZQPrAbJjcCJzHqVZK2JMSFkFDWfe,True,53916,13479,84,42,42,3zqXX6kzhkbW3d4TwD2CNjMRwxTbREXySekvq37kfCNk,3367,66894,-63527,624
2022-01-24 08:01:01-05:00,10609,D6qMab7uevXTa89ssv4BRyHwrw3FYpNimAmX2VH2uf4B,8ZauZ5dAp7kyawkPdxi4mqfempFHubJebfBenQdDektD,True,86083,21520,134,67,67,HfEnetJ7uBSmZWCjBNxdvv9HEC5nsW4wDV7wu6WnhWan,5377,106732,-101355,624
2022-01-24 08:01:02-05:00,10610,AnqmmhzVDCNq4dE4VvYkPDGB9nMXr4ykqvUhwxhR21pd,CcMeofCvvrDaBzgAGzoPwRt5eQmzdB1z2Y6UiwGqhFbG,True,1811605,452901,2822,1411,1411,3zqXX6kzhkbW3d4TwD2CNjMRwxTbREXySekvq37kfCNk,112910,2627708,-2514798,623
2022-01-24 08:05:04-05:00,10611,HELPNUwAqTX7gfHS4cnJnqXFM6Rb156tYcpsitKR9iDu,3RdfgDvLvsdZG5Cf6hKiKMQMqfidyxHzjYvUx1FZpeHQ,True,1300591,325147,2012,1006,1006,3zqXX6kzhkbW3d4TwD2CNjMRwxTbREXySekvq37kfCNk,80509,1598300,-1517791,619
2022-01-24 08:07:26-05:00,10612,pFCQLWBcx4YmtALBatWXwLR3MErHAxAyq1LVjgZJWbo,Hc3WoJQAV3Ue2yzxFxBdsx47ZsH6Hart62y89WRWCtqT,True,16836093,4209023,26164,13082,13082,HfEnetJ7uBSmZWCjBNxdvv9HEC5nsW4wDV7wu6WnhWan,1046560,7605267,-6558707,621
2022-01-24 08:07:27-05:00,10613,AoPQqPjLPi8fZiLkhMGLRj6oD5k2asrvJtCkpW19DvGr,H5Sgmf1VuY13iHjPuLJ2q9wtSdkXG1AQsEv2eq6zzm8Y,True,18526313,4631578,28987,14493,14494,HfEnetJ7uBSmZWCjBNxdvv9HEC5nsW4wDV7wu6WnhWan,1159486,6360481,-5200995,625
2022-01-24 08:25:47-05:00,10614,243SAnGxchCVB1LQAUF4SsozR86yDwEdg2QQpbWGsMYe,5u8sNkb2oEQjUXJAB3yGStmv3Uwz16gBgExBo5myVK4b,True,482416,120604,746,373,373,HfEnetJ7uBSmZWCjBNxdvv9HEC5nsW4wDV7wu6WnhWan,29856,299352,-269496,618
2022-01-24 08:25:47-05:00,10615,25NUDrsdLhS3fcARLiTMbbmZHvvzvzPj9xAdoN8sJBN3,8baNRGHfYRcLdhbHNuH72ofAWM9UojqhTMLnbBayzGnW,True,1447125,361781,2246,1123,1123,HfEnetJ7uBSmZWCjBNxdvv9HEC5nsW4wDV7wu6WnhWan,89868,914127,-824259,621
2022-01-24 08:36:40-05:00,10616,4SQQdHTJUDv8taPXQRvEVJpUu91iCWQsv9su8tfehaQG,33CJXj1pmmatAofRvgt5in9E6SLEuy7tq4jqSwnUWP2A,True,83082024,20770506,129984,64992,64992,HfEnetJ7uBSmZWCjBNxdvv9HEC5nsW4wDV7wu6WnhWan,5199399,95815874,-90616475,625
2022-01-24 08:38:10-05:00,10617,4Enpw9W2mWGnNYagYQ8WW29RLSs4R5YX4qXCsVqMFeHn,9QwbJmm9QDKXyc4ZViq74BfS35zzewEceXQNnFCgczXu,True,140029650,35007412,216758,108379,108379,HfEnetJ7uBSmZWCjBNxdvv9HEC5nsW4wDV7wu6WnhWan,8670335,56362069,-47691734,619
2022-01-24 08:38:10-05:00,10618,B5CTBTggmGFvGFSunjbB4C9tLKcYcULehmEiEXRihY2J,FX3ebF8P89rZBWfR74PDWUzxnLuDkUDgGcPYCBD5sMUG,True,8659962,2164990,13440,6720,6720,HfEnetJ7uBSmZWCjBNxdvv9HEC5nsW4wDV7wu6WnhWan,537601,5393018,-4855417,620
2022-01-24 08:39:02-05:00,10619,5NVD6QvomTAD35yNxSFZw4DhF2hCtV8drkbnGhBVtK5y,3JzkyPnREvoFZLL9JZuuDEnee3nuKcrqY3xLuXsmHwRo,True,123163,30790,192,96,96,HfEnetJ7uBSmZWCjBNxdvv9HEC5nsW4wDV7wu6WnhWan,7706,135065,-127359,625
2022-01-24 08:41:19-05:00,10620,F9s8a7Cpiw5dw3a2aNFMofqwyDWNXvDLnSdJzoj1gRiV,GpKsQKJD79KBRWdCTkyi4zX7NaoCWsLUjrKxAwJB6o6s,True,61557,15389,96,48,48,HfEnetJ7uBSmZWCjBNxdvv9HEC5nsW4wDV7wu6WnhWan,3846,44372,-40526,624
2022-01-24 08:42:51-05:00,10621,A1VornXbzK5rFgsy9D4qThcPnYVP8AB9RRzWsV1h6L17,9M4dQgz1zWrtKHqZMt9w7PbM9CvmyjhY5ZZ6jjajMzqm,True,1680181,420045,2594,1297,1297,3zqXX6kzhkbW3d4TwD2CNjMRwxTbREXySekvq37kfCNk,103770,790670,-686900,617
2022-01-24 08:42:51-05:00,10622,4vW2Q76fdGmfhU2Tx3R2XQkGcQUi6hSM9ixvK5RWvurJ,w8cGbqVpVr6WHSRJFXv469RMgRB3ty3TGpkVXRs7K7H,True,3335908,833977,4982,2491,2491,3zqXX6kzhkbW3d4TwD2CNjMRwxTbREXySekvq37kfCNk,199319,1460840,-1261521,597
2022-01-24 08:42:51-05:00,10623,56488NdcUy6Hi6X5SLs2GFtW5pG4u5wJpH7vHdxTCx4z,tGgXjJeVr3W2m3T2NXPCqpBEd6HJKE2cRsgCyiDZQy4,True,2423422,605855,3790,1895,1895,3zqXX6kzhkbW3d4TwD2CNjMRwxTbREXySekvq37kfCNk,151605,1737287,-1585682,625
2022-01-24 08:42:51-05:00,10624,2fCreQCCB6cWjyE1eddSBY89YniYavEfEo2QWKS9MWMT,HkpLJPjXUUbWmJ4pJDFHkGfU6NqEow1iRKiJeD428WWp,True,19986513,4996628,30667,15333,15334,3zqXX6kzhkbW3d4TwD2CNjMRwxTbREXySekvq37kfCNk,1226718,8434705,-7207987,613
2022-01-24 08:42:51-05:00,10625,J6jBKPDR6R5cLMqLufw3zoVfheNYs1KF7C4Ft2dakXeA,6wTTLK675Ym6toJRp7tYaUZzisWfgGjSp3X3yJ31xiKt,True,2507203,626800,3804,1902,1902,3zqXX6kzhkbW3d4TwD2CNjMRwxTbREXySekvq37kfCNk,152169,1375882,-1223713,606
2022-01-24 08:42:51-05:00,10626,B9WJfmrYEkVH3L1UWz4qqWpaexHydymbzvEfwNVtB9BV,6mQb4yzGq8jE1NbweKCKSbevnnYVhHYxyc6Gz2a5kJLn,True,11501997,2875499,17640,8820,8820,3zqXX6kzhkbW3d4TwD2CNjMRwxTbREXySekvq37kfCNk,705636,5132765,-4427129,613
2022-01-24 08:42:51-05:00,10627,DDsY5V3F9wnEGBoQFCEf1hvEYuKUaJdysbc7TxhNqe9G,5oBCGzvy8odB8MCxCUvPDqYCnTyteZ4Yy1JDroroygbi,True,2522072,630518,3764,1882,1882,3zqXX6kzhkbW3d4TwD2CNjMRwxTbREXySekvq37kfCNk,150574,1189459,-1038885,597
2022-01-24 08:42:51-05:00,10628,2JXP6KUwPSmCrXT2uQRqSoCwH8RLYWwmqYsj3zXtv9xF,4qcFVgugXsHVQzFRP2he9CVzvv47xqgokJjigee8oPpP,True,85191369,21297842,131797,65898,65899,3zqXX6kzhkbW3d4TwD2CNjMRwxTbREXySekvq37kfCNk,5271890,36020012,-30748122,618
2022-01-24 09:00:09-05:00,10629,6fqbSyhh3PPdgRcLraHb7Jahj9s1oHHeX3SsjNSsGa6t,GpRUow48TYgttdYfsygbgjYQcmHyYjWETUDjDVphEgwq,True,684452883,171113220,1069354,534677,534677,HfEnetJ7uBSmZWCjBNxdvv9HEC5nsW4wDV7wu6WnhWan,42774170,410907028,-368132858,624
2022-01-24 09:00:50-05:00,10630,FS5xx53Bo65G21gJLta7LEEiS132VJM1kGpUzuqyfzoy,2kbTLjdBBA9K1coxKmwmYbjq2heSnuNg4Nh2EfVNYgwj,True,1613421,403354,2494,1247,1247,3zqXX6kzhkbW3d4TwD2CNjMRwxTbREXySekvq37kfCNk,99792,988333,-888541,618
2022-01-24 09:00:50-05:00,10631,GKKRAsYGdcf47eFThG4KwhNv7egeHRuc2wmTh4kqpego,4ippJxgnqCtdtGzCkdZoYwv68fiXNSqQcgrnaHdXZDUa,True,14197615,3549403,22131,11065,11066,3zqXX6kzhkbW3d4TwD2CNjMRwxTbREXySekvq37kfCNk,885273,10565724,-9680451,623
2022-01-24 09:00:51-05:00,10632,4HDEN1Thxm9RbdE8pXnLP4QksVdXfp7Fa9nAnMRzr7oR,8gD3DbF6VhPTCgk3A4G7iA4f3DPH598Hj7TRJ2FebMCq,True,203318,50829,316,158,158,HfEnetJ7uBSmZWCjBNxdvv9HEC5nsW4wDV7wu6WnhWan,12663,234782,-222119,622
2022-01-24 09:00:51-05:00,10633,SCtptafLHdkTiYC3e9sv853xNnusHLpoMPxTc1zUVC8,2HF9ggN6EbkYGz3Ajj7tB8m5YF3Yj77Vy96DMFSz5C7j,True,730844,182711,1141,570,571,3zqXX6kzhkbW3d4TwD2CNjMRwxTbREXySekvq37kfCNk,45675,816231,-770556,624
2022-01-24 09:00:51-05:00,10634,6b7Ro2myM4HcUDqyyW9NEqTWPz8BWpH4eNFSQQci37So,7r7j7rSsa6YZcTuRPfs3KP44MVqUA4Q5NeJGmx84wbHq,True,66234,16558,103,51,52,3zqXX6kzhkbW3d4TwD2CNjMRwxTbREXySekvq37kfCNk,4125,81640,-77515,622
2022-01-24 09:00:51-05:00,10635,9hB3EPuj4SrSrpAzHvExDb6mzh2vNGGVbj7qqfRjeao4,9725jRXGPRUuo1dijvv8mwzvSu1ed4y5hi9FAQNwb8dG,True,2675038,668759,4168,2084,2084,3zqXX6kzhkbW3d4TwD2CNjMRwxTbREXySekvq37kfCNk,166723,3192882,-3026159,623
2022-01-24 09:01:00-05:00,10636,HRN438yBJSX72GV4E3JYLKpwQcnZXgAoB2VkmgXzEKDE,4jEn7ssEM8ZUjAyaKogEb3uyMmbZJ1a7WGCPNgh1Xfty,True,141796,35449,221,110,111,3zqXX6kzhkbW3d4TwD2CNjMRwxTbREXySekvq37kfCNk,8851,147376,-138525,624
2022-01-24 09:01:00-05:00,10637,6kscNwPWgKoW7MHRkB4ajxWF3DXLmXjmx9KjDnzikhfs,D49nf79UmrALDKnAa5kf94nZUffzJW7anLm4hVrFG2b4,True,4513643,1128410,7045,3522,3523,3zqXX6kzhkbW3d4TwD2CNjMRwxTbREXySekvq37kfCNk,281821,5059019,-4777198,624
2022-01-24 09:01:00-05:00,10638,FkZhhccPu4gveq1JHW6euEKoS7SC2VBgVPy1B99x9tim,2f5UVLjutRnnVyCD64tPo5XCwhzAEoXU6YCmgNRH6uyk,True,10905,2726,16,8,8,3zqXX6kzhkbW3d4TwD2CNjMRwxTbREXySekvq37kfCNk,675,12797,-12122,618
2022-01-24 09:01:00-05:00,10639,4ULhASByyNafHdp8HFAu8F7JWU8vZY73gmk11wWGpBH7,5GWVtW86nA33hveEygKzjCqeMkRNb8J6RsGrbzVad8nJ,True,89086030,22271507,130440,65220,65220,3zqXX6kzhkbW3d4TwD2CNjMRwxTbREXySekvq37kfCNk,5217608,55248432,-50030824,585
2022-01-24 09:01:00-05:00,10640,8kJu5aqVSmW8FSZR9h6F75ftn9V2U9uMLBEKeqRaC855,FhVHByujkvwwtjTVpZ4mqSUqoMoBgeLUc5H7rbz3FgAt,True,639469,159867,965,482,483,3zqXX6kzhkbW3d4TwD2CNjMRwxTbREXySekvq37kfCNk,38629,703792,-665163,604
2022-01-24 09:01:00-05:00,10641,8eTH6eJyyVeMno3UQkffeBg32xofKsQfkhLhXdtaf87s,BCFC7CPXrQPsUfJb2eYSht8GhaApWHpc49AeCXqaYq13,True,1619018,404754,2444,1222,1222,3zqXX6kzhkbW3d4TwD2CNjMRwxTbREXySekvq37kfCNk,97767,930195,-832428,603
2022-01-24 09:01:00-05:00,10642,A4tDE948CPFPh1UwHb8sXryfKktbxZ8BCkqXgA5DJHA8,3zXeKMrsEpCe5fQumLNzCgpxcG1kLJFEAtJuqxLsC6ZG,True,626852,156713,945,472,473,3zqXX6kzhkbW3d4TwD2CNjMRwxTbREXySekvq37kfCNk,37815,575700,-537885,603
2022-01-24 09:01:00-05:00,10643,FsMiJiJZibohKoV5QRisWCjzuFd86xSxFb4m73AQmu93,7p3TSKBaG9SV2YNDnhutQKacPKpTTmgsEfzmK51t6sYb,True,1511066,377766,2336,1168,1168,3zqXX6kzhkbW3d4TwD2CNjMRwxTbREXySekvq37kfCNk,93469,1169274,-1075805,618
2022-01-24 09:01:01-05:00,10644,FgQrRo4eGQAonSsFfQgnp8trGGqGZCLeGX6yvJnMnTjd,8KhemHLBY6nGmo3xMDedW2wnCSxQq6LwbTExif4sUSxx,True,9927038,2481759,14207,7103,7104,3zqXX6kzhkbW3d4TwD2CNjMRwxTbREXySekvq37kfCNk,568289,4831738,-4263449,572
2022-01-24 09:01:01-05:00,10645,B2hN3Lt5pFbUyfEUc5s48hkxUJ5rr2SeFxgdGdQ8pDD2,7bZJCCud253j9g411HQUDXUAADcwd5yJWznoTChBdB2H,True,43981102,10995275,67078,33539,33539,3zqXX6kzhkbW3d4TwD2CNjMRwxTbREXySekvq37kfCNk,2683148,21531291,-18848143,610
2022-01-24 09:01:01-05:00,10646,HoJ3Re4BmCYKMJx2RUYtoHfg8ncEy3iFqvWJDGKqfMBV,2qg4FMcurNDVRzXYKwpzEYapxFECnAyU2oGmxQCSf3hf,True,129553,32388,201,100,101,3zqXX6kzhkbW3d4TwD2CNjMRwxTbREXySekvq37kfCNk,8077,160838,-152761,623
2022-01-24 09:01:01-05:00,10647,72L76qDRMK3M7X52zuuB9GVyvFFLDBZwFMpVjWjghXzA,4m2ZVuemUctu1edv4YJVAcjXzKwpbCmBujzoUmLDeA7h,True,2564513,641128,3984,1992,1992,3zqXX6kzhkbW3d4TwD2CNjMRwxTbREXySekvq37kfCNk,159382,1480006,-1320624,621
2022-01-24 09:01:01-05:00,10648,Dcitj55ABpkgXvpnPCssy8GgKF46xd1GLaRMyPWoW6G8,62znTXs74bywWfcXptJkvwYuuTxgen8bhYaCnG8Z7y2B,True,181058656,45264664,261038,130519,130519,3zqXX6kzhkbW3d4TwD2CNjMRwxTbREXySekvq37kfCNk,10441558,107668828,-97227270,576
2022-01-24 09:01:01-05:00,10649,9WJBnVi84E926j7xEd566WzrZJkPJWRgmEnYj9vyjuad,4dLaFS5F7TGyLdwuJLMGkz3bSL53aHzd9ZfpNmhHxXeF,True,111007,27751,159,79,80,3zqXX6kzhkbW3d4TwD2CNjMRwxTbREXySekvq37kfCNk,6373,111792,-105419,574
2022-01-24 09:01:01-05:00,10650,3VdSA9CED9f5swRwHX2U15U7J6Muaq8VPnCNy9CaGDHe,2YYstfnfdYic5NWmEbcUEHpccNUVd1EhuCkExvMsoMk8,True,36297,9074,56,28,28,3zqXX6kzhkbW3d4TwD2CNjMRwxTbREXySekvq37kfCNk,2254,39993,-37739,620
2022-01-24 09:01:01-05:00,10651,CxLFMBDFkoMvpK9YUf7WtCq6hn7k3QACAuetAnGjU6KA,2gE52a1GWQnS6ifV6eVtKQyr13LXP5Jdt3yG9SjGPJPF,True,8781072,2195268,12551,6275,6276,3zqXX6kzhkbW3d4TwD2CNjMRwxTbREXySekvq37kfCNk,502070,5085012,-4582942,571
2022-01-24 09:01:01-05:00,10652,BgN75npBkPws5uiFE9RAujmPuZyAv2MQUPmfmJ1YCCij,78UFLNDn782TY2P4F5kRkMRC2s3gw8ak7sRQZRWNq82D,True,1737300,434325,2610,1305,1305,3zqXX6kzhkbW3d4TwD2CNjMRwxTbREXySekvq37kfCNk,104404,900665,-796261,600
2022-01-24 09:01:01-05:00,10653,FnAT8HKGgisYfeAbxKU2gSbCp8KbZHULRpaJX1NVijHy,2u637Crc2QzfSJmCnRNqeib3aZQVn4NGncpgM3Ph6jvm,True,248138,62034,382,191,191,3zqXX6kzhkbW3d4TwD2CNjMRwxTbREXySekvq37kfCNk,15289,192092,-176803,616
2022-01-24 09:01:01-05:00,10654,4uygLJDk9DFCifJ56YwMrEsvd3oQNq8tYSLnMCyWorS6,GimL4uKGvg3FFmFQSWzAcjstv3Vmk5NMgDGMKTuXYVpB,True,3753165,938291,5677,2838,2839,3zqXX6kzhkbW3d4TwD2CNjMRwxTbREXySekvq37kfCNk,227084,3303356,-3076272,605
2022-01-24 09:01:02-05:00,10655,D9VKhnfLLCrntDGFYSfoxFaY76VnHmYZ1ZbyFXdKdibz,2hRCRH2pMDyQGYcXHa8Y6BZo6FbcGZf5VJC1v8Bp6tGa,True,665400,166350,1013,506,507,3zqXX6kzhkbW3d4TwD2CNjMRwxTbREXySekvq37kfCNk,40550,555906,-515356,609
2022-01-24 09:01:02-05:00,10656,CpxZ136k95cVjGqkJnNpDZKUgrJrfg8HrFDZPL6BgsK4,Fo7HtcrneUTsnGqygsxPQ63G5rayYodYT65xP6B6HusH,True,11269314,2817328,17329,8664,8665,3zqXX6kzhkbW3d4TwD2CNjMRwxTbREXySekvq37kfCNk,693190,5345329,-4652139,615
2022-01-24 09:01:02-05:00,10657,H3394S5wdbwXB4scjGAY8NsXxCdGy1Xebct18s42FM1K,Hz84L1EquzhCvBJP75ScKug46hYGdNMVNH16AdG4y5D8,True,340000,85000,526,263,263,3zqXX6kzhkbW3d4TwD2CNjMRwxTbREXySekvq37kfCNk,21049,290557,-269508,619
2022-01-24 09:01:02-05:00,10658,6mCEvqP1YwHZNUT9orECs4tE3YzfD2Hfa5FTt9TLo8DH,ApWyeUDzPp6TBczuStvXxEAivhVVJrqC1rodNTNKNFR3,True,2322018,580504,3221,1610,1611,HfEnetJ7uBSmZWCjBNxdvv9HEC5nsW4wDV7wu6WnhWan,128850,1521776,-1392926,554
2022-01-24 09:01:05-05:00,10659,6VBYUiLyQXvvsDmq1vh1oJ5VeA89tGgxtkgFfofc372m,35pyoeRA4duKX7njdYny3KffM2xaxuWUZGRUMQJ5iAiu,True,18237988,4559497,28534,14267,14267,3zqXX6kzhkbW3d4TwD2CNjMRwxTbREXySekvq37kfCNk,1141370,19739465,-18598095,625
2022-01-24 09:01:07-05:00,10660,33CE2t84MhG7SMsphhZaxvwFVRbK5wcUMUdEw8UBhoq8,DjNko7SbbK9nQT4K5oBWKiSiXiYS9Rv1k5vT3PNiMyaf,True,576942,144235,899,449,450,3zqXX6kzhkbW3d4TwD2CNjMRwxTbREXySekvq37kfCNk,35960,459484,-423524,623
2022-01-24 09:01:07-05:00,10661,7FB6X8YgiDn7YK9bZZmcFyzhuvVLVWPCfBbenwMXhx5,2EaDCpL9MpAKuiC2bvUCGRfvqYvgVXGFHXt35QdNakfG,True,578632,144658,899,449,450,3zqXX6kzhkbW3d4TwD2CNjMRwxTbREXySekvq37kfCNk,35990,248930,-212940,621
2022-01-24 09:02:05-05:00,10662,CcfycMNGUqZLA6EEqtDdftSbQhTL11SYn3LxQqJ23Xgh,Ce7NW9CpB9qGYLf8XUDW49ERutoxtjZSjs54xrzF1fYN,True,256128,64032,400,200,200,3zqXX6kzhkbW3d4TwD2CNjMRwxTbREXySekvq37kfCNk,16029,295467,-279438,625
2022-01-24 09:06:16-05:00,10663,8trFFwvXKKMwMx952ugCZmqyw29e1HxEKBuQmFn8ZwTf,FsD7gCvHXM3QchQiDcd292ksy5afZMWApneNTat5ndeS,True,10248104,2562026,15880,7940,7940,3zqXX6kzhkbW3d4TwD2CNjMRwxTbREXySekvq37kfCNk,635207,4567710,-3932503,619
2022-01-24 09:08:00-05:00,10664,9otCHuzKcxUCC4EgPJkio8Df5gXWB6DtZQnZvWtPfsh6,8cNPdP8rA9sBpcKpmCNcp4W2AYonYdFNoyVmboT6y1Bb,True,47531489,11882872,73706,36853,36853,HfEnetJ7uBSmZWCjBNxdvv9HEC5nsW4wDV7wu6WnhWan,2948250,23051813,-20103563,620
2022-01-24 09:08:00-05:00,10665,cG5VSSaBpjNdRLMQT7dmotpcWRTfdmJZYdWsrzNzRTE,5RESxV6aZenjAdaqw1jxoYSGttpLrNuZiRJy2WeLAVJv,True,14300365,3575091,22083,11041,11042,HfEnetJ7uBSmZWCjBNxdvv9HEC5nsW4wDV7wu6WnhWan,883333,11047155,-10163822,617
2022-01-24 09:08:00-05:00,10666,4MSyrHopFkuaCEEvLAUV9cJfVre6cLAx5sJF5LEMSCTX,6HhLHoswuDKrcixShWCDcquW6PgmbS5FidEnkM3bwuJQ,True,371763,92940,580,290,290,3zqXX6kzhkbW3d4TwD2CNjMRwxTbREXySekvq37kfCNk,23206,201136,-177930,624
2022-01-24 09:08:01-05:00,10667,AUH6YGBV8tDVX1E1WTo92Mubfx1DGsqfGeyUBqxo4fSr,33QZgMwmW32WuvmxD8XNbmF9ea88bLe3YTtNwHV73Wwu,True,1510287,377571,2357,1178,1179,3zqXX6kzhkbW3d4TwD2CNjMRwxTbREXySekvq37kfCNk,94288,1188662,-1094374,624
2022-01-24 09:08:01-05:00,10668,CK1SjmBjrW7m1QVZbVZsVZgwEcxw8BTkckkzrZDrDdxW,M6vnBg1TPRhLu7sghkxtf5TkSLw5JhgoDmbGoyEYgR9,True,301767,75441,469,234,235,3zqXX6kzhkbW3d4TwD2CNjMRwxTbREXySekvq37kfCNk,18767,347081,-328314,621
2022-01-24 09:08:12-05:00,10669,8jyD7TX1Ht3jVpTtSsec2YM7PAFq9kgop6xoRTFLEFUA,A4YQqSqtcz1MLrr5qQAGyNC564GbVJ1P3nD8hFz8XXMa,True,3763513,940878,5882,2941,2941,HfEnetJ7uBSmZWCjBNxdvv9HEC5nsW4wDV7wu6WnhWan,235288,4570956,-4335668,625
2022-01-24 09:08:23-05:00,10670,BWJeoypk8ctbsFZ5jqc5ajV9qutjCknk4hRxEQobHwVi,GEAiFZAhBe1DnjXCDttq1oqVAUZ2uwRx7E5bhwRZtGJX,True,4747503,1186875,7366,3683,3683,HfEnetJ7uBSmZWCjBNxdvv9HEC5nsW4wDV7wu6WnhWan,294645,3703042,-3408397,620
2022-01-24 09:08:23-05:00,10671,EitU96ThqHErybDn2j1NY6JHkqV1R3mWM1uWH7wYKr1T,2p9eYbLyBqXrhHtRKp1jJb7VGjCmb4LkA6kzqLr1ijet,True,842895,210723,1317,658,659,HfEnetJ7uBSmZWCjBNxdvv9HEC5nsW4wDV7wu6WnhWan,52682,623514,-570832,625
2022-01-24 09:08:23-05:00,10672,4Eh2J8pz6nSz2E2BaPSMbDNhEovGA4QRmNtzAJPw9ZRi,CrHeEQC5KpQFLGhz2EpLYWgk7kWsqLPvEfLsSQvUxv61,True,5095266,1273816,7880,3940,3940,3zqXX6kzhkbW3d4TwD2CNjMRwxTbREXySekvq37kfCNk,315208,4118917,-3803709,618
2022-01-24 09:08:26-05:00,10673,HSF97F9d5EPgx4kGYuG4AfwHnh6bovzyTneYUouszBQp,Bh8fR6QoGS1ykk27256kFb2gjCVbQtu8Nu4Ls7GEKSAs,True,3227208623,806802155,5011468,2505734,2505734,HfEnetJ7uBSmZWCjBNxdvv9HEC5nsW4wDV7wu6WnhWan,200458732,2598411841,-2397953109,621
2022-01-24 09:08:29-05:00,10674,3gdApRPkUGEqmLvTYf4WQJCnmTVmiEU2wCQG26QMpqKf,HpP2yxq3KfYByT4q4p2mLaELnPdW6kmEY9EqZaBZuUNR,True,179677,44919,276,138,138,3zqXX6kzhkbW3d4TwD2CNjMRwxTbREXySekvq37kfCNk,11074,206777,-195703,616
2022-01-24 09:08:29-05:00,10675,HUe9LgGBjMeNxGyeCtmXr2XbWVFhHXrvgc2XSqCwN11D,7Z1nR9GgezBXsDX5wW3BBarfMRMZV28rX6MeLRuWtycG,True,2743668,685917,4240,2120,2120,3zqXX6kzhkbW3d4TwD2CNjMRwxTbREXySekvq37kfCNk,169630,3056763,-2887133,618
2022-01-24 09:08:30-05:00,10676,A36aouot1oFLUtswuBUM4EVcis9chKaSJu53MRoPDjab,33U9gpq1RRFMGWDrWa3ezXXkwgBewdAS6QGgGVPtGvqb,True,1945264,486316,3039,1519,1520,3zqXX6kzhkbW3d4TwD2CNjMRwxTbREXySekvq37kfCNk,121575,1506779,-1385204,624
2022-01-24 09:08:30-05:00,10677,AWvHDdb2ikqV8wc7qQ8azbvNTZdixMNxhQjhQdhayYtR,9EpgEPBb1nog6aQeFdMXfSRiLSnzGQFQ39mbLdCxgYTv,True,249205,62301,389,194,195,HfEnetJ7uBSmZWCjBNxdvv9HEC5nsW4wDV7wu6WnhWan,15593,186862,-171269,625
2022-01-24 09:08:31-05:00,10678,DakevNrDK5fAUGkLdrWHrsLZm8hEZBqkzUiwJouaDPPY,73nFhK7cygPgwKveXrdXcQVte8n1z3iBe4nmUVTGfFmv,True,10661534,2665383,16439,8219,8220,3zqXX6kzhkbW3d4TwD2CNjMRwxTbREXySekvq37kfCNk,657584,8765091,-8107507,616
2022-01-24 09:08:31-05:00,10679,2jDRvE3pQNjWy1NRFa4tzB3KmU5UkbUCHw8sQRFujo66,C4zNi2szDrEEh4coTF3WRUghfP4ZwAVVSYTLWfkejQRu,True,1382091,345522,2158,1079,1079,3zqXX6kzhkbW3d4TwD2CNjMRwxTbREXySekvq37kfCNk,86337,1272040,-1185703,624
2022-01-24 09:08:33-05:00,10680,2YPm4Ex9mNHX4CuNAUjkrXgoLFaZs6r1X6asYYUnvPyj,BatsG1UFq8ryYuFFcdnDyFWFPUV5P6w2VQpRup5oUey5,True,186617,46654,291,145,146,3zqXX6kzhkbW3d4TwD2CNjMRwxTbREXySekvq37kfCNk,11649,215777,-204128,624
2022-01-24 09:08:33-05:00,10681,GqFbV89UYbQ6aEW1bSvGnnsDtTPQfHPTHzisXPhLnaTC,6X7j3nqmugRyVVw83uSzgiPaemEscc8VdsnPEKDz4fg2,True,126139,31534,197,98,99,3zqXX6kzhkbW3d4TwD2CNjMRwxTbREXySekvq37kfCNk,7882,151022,-143140,624
2022-01-24 09:08:34-05:00,10682,DWMxC7PyBcue9RaoZLEEM233PyHeGqMAWqapnw8qM4N2,AVW5hLdQEQut1DqYzKXP8hBQFBx1Df697xkFSu4JR1U7,True,343900,85975,537,268,269,HfEnetJ7uBSmZWCjBNxdvv9HEC5nsW4wDV7wu6WnhWan,21509,102552,-81043,625
2022-01-24 09:08:37-05:00,10683,zLTuMVfVswjMkhyvjaXnvjcKXv5xNk3iSWSjRGpVqXf,J3D8NHUJCiSjvFYfJ5Es4YDhF1KcPZWRUmCQ5L92t8eB,True,2299251,574812,3565,1782,1783,3zqXX6kzhkbW3d4TwD2CNjMRwxTbREXySekvq37kfCNk,142619,1014717,-872098,620
2022-01-24 09:08:37-05:00,10684,EgpRPHPAC2cPBiar3SUD5PGZnzbCXBzUpa4KVTF5q9XY,2zf7NkfWagBWWts9RgacdRgkSzgJaChpFW5mMZczXa18,True,136682398,34170599,213393,106696,106697,3zqXX6kzhkbW3d4TwD2CNjMRwxTbREXySekvq37kfCNk,8535725,151090031,-142554306,624
2022-01-24 09:08:54-05:00,10685,BZn1DDE568UHeL2Qniv9EDT1yAAWvPJcTtSw4K4GQx44,CCaroU4YwKvYgibMsRPdEBxeDbzcNC4s5ZthxrhywSm5,True,311067,77766,486,243,243,HfEnetJ7uBSmZWCjBNxdvv9HEC5nsW4wDV7wu6WnhWan,19466,356487,-337021,625
2022-01-24 09:09:01-05:00,10686,BmLG3dPSnL9hL2okZcNVsHgzuWYCrWLdXW8z5Jd2gyvF,HXwhov5Re9b8D4XHULcVSdgBNfbtZ7KMhMRqSTcQTbno,True,404017,101004,632,316,316,3zqXX6kzhkbW3d4TwD2CNjMRwxTbREXySekvq37kfCNk,25288,486165,-460877,625
2022-01-24 09:09:05-05:00,10687,HdRgh9niYSd3YKCxzGdusYFquiVoFTP2mEGEzJJL5Nii,78C68Gbb1jYFQmYNCHHjL52keEKMXtGukmBwT7ahon4B,True,23517210,5879301,36670,18335,18335,3zqXX6kzhkbW3d4TwD2CNjMRwxTbREXySekvq37kfCNk,1466837,23417367,-21950530,623
2022-01-24 09:09:07-05:00,10688,APbpwRCB9tfma8yoi8upe633XZBtNwc5zVxXVjLwhg8s,BBwryuZZ8msiSFNmGkh13Wgg1PoSutY2Ftgz8odcxPm4,True,1424830,356207,2210,1105,1105,3zqXX6kzhkbW3d4TwD2CNjMRwxTbREXySekvq37kfCNk,88411,1591598,-1503187,620
2022-01-24 09:09:07-05:00,10689,9cRx2sGeqENLrNkvzLSnuD161JshSav6pNg9c7pYLi8f,13ryjUoWLejTLDQKh1m69VFD31onMx8yhzCKhqbeU6s6,True,722436,180609,1118,559,559,3zqXX6kzhkbW3d4TwD2CNjMRwxTbREXySekvq37kfCNk,44757,842639,-797882,619
2022-01-24 09:09:10-05:00,10690,75NA5QiXEHG4caSB9BpafGZPA9eT9S6MhKTFM6eHjz8H,FmoxAVw2zdG6qbyaXKy6gsvi1XY8ZVbSgUNbjsp9EpVd,True,318370,79592,497,248,249,3zqXX6kzhkbW3d4TwD2CNjMRwxTbREXySekvq37kfCNk,19880,351977,-332097,624
2022-01-24 09:09:26-05:00,10691,AgokoeqypXXfMsjAyBXPRrJFGeP7B7D6SXvnGUTwMdap,53zBz3fTZisWQH1v6NHyhCdpLXx5NaPNp7uW9KPXLDan,True,8072475,2018118,12461,6230,6231,3zqXX6kzhkbW3d4TwD2CNjMRwxTbREXySekvq37kfCNk,498458,5079430,-4580972,617
2022-01-24 09:09:40-05:00,10692,57Vsw8jXaaoLriYEkvPAVyq66r4a4zMfLWbDaTBMjFzC,7AVDWUTHa6729UkXgCXASphSmrLvXYGAA9ygTMSqvwvY,True,152411,38102,236,118,118,3zqXX6kzhkbW3d4TwD2CNjMRwxTbREXySekvq37kfCNk,9450,181926,-172476,620
2022-01-24 09:09:40-05:00,10693,51VhgthsxrRRr2PT5gLnDfL1A3soqwCxA1UzH9vRUGTh,4QCcd7hfsydQ63LH7Lqsp8oVXw7HuKamzQf8VMH6Lgu2,True,239097,59774,372,186,186,HfEnetJ7uBSmZWCjBNxdvv9HEC5nsW4wDV7wu6WnhWan,14885,275453,-260568,622
2022-01-24 09:09:41-05:00,10694,JDg1bbHkYeznDUtSBLhagRJ45aSzeSF5V8iDRJCay9wL,8n7ic28zq5PjJtRcM7Fcy5vLW2YVXw4EWMK6UAt2zh3V,True,3476259,869064,5431,2715,2716,3zqXX6kzhkbW3d4TwD2CNjMRwxTbREXySekvq37kfCNk,217270,4004752,-3787482,625
2022-01-24 09:09:41-05:00,10695,CxePQ6ZEn2NCLYgGegSeFX1PyBuczP9j5v131VQSPh1c,9gPk7qTRb5JHqBXRKp3uZfhA2VjQAJDQHTzYXGLUdAUC,True,277979,69494,433,216,217,3zqXX6kzhkbW3d4TwD2CNjMRwxTbREXySekvq37kfCNk,17350,320523,-303173,624
2022-01-24 09:09:46-05:00,10696,yWK6vFZq58uYYiHscQTPSBqTDrWEW1SVbqe8NszoTEN,6H1zT5ifGaMKjdvZmptuDYf4Vou7tntdZQPVzQ4hWyjg,True,3782610,945652,5919,2959,2960,3zqXX6kzhkbW3d4TwD2CNjMRwxTbREXySekvq37kfCNk,236774,2682532,-2445758,625
2022-01-24 09:10:10-05:00,10697,46TNhGwBVzedW8xSb9UY94HNeSom9iGiZzAjrKHiRM2G,7JVTiqNYeKHbyzRkKtvSEpqLPKykZso8cGUr3sX1j7QF,True,1032231,258057,1613,806,807,3zqXX6kzhkbW3d4TwD2CNjMRwxTbREXySekvq37kfCNk,64546,770176,-705630,625
2022-01-24 09:10:20-05:00,10698,8xvLGVeDmhVYQhN2ZpWkVG9jCrukRsNQ4926a4TMiZqa,9ciBySSjvADwp47WkETiFWZKVTFL8Hf1XvK7aSxhcgQS,True,134060,33515,209,104,105,HfEnetJ7uBSmZWCjBNxdvv9HEC5nsW4wDV7wu6WnhWan,8363,120644,-112281,623
2022-01-24 09:11:09-05:00,10699,3EgUBHBeKWegibDcCsTGaGehnwHYvpMbcPaT1UTbwQ49,Hxd4dsnLD8uHnG7KR7GVmKXBcpN1egMUvoTccPvBcaYA,True,5097120,1274280,7912,3956,3956,3zqXX6kzhkbW3d4TwD2CNjMRwxTbREXySekvq37kfCNk,316492,6073618,-5757126,620
2022-01-24 09:11:09-05:00,10700,Fs8MQLaMyr1Q96HsZivKLY7Kjdeu2ZoB2n3VTZ15KbSn,DREfCs5CTVNUUF8H3hD8CWvtxztiYxoLYh8HUWDecMyZ,True,4816653,1204163,7481,3740,3741,HfEnetJ7uBSmZWCjBNxdvv9HEC5nsW4wDV7wu6WnhWan,299275,5746007,-5446732,621
2022-01-24 09:11:09-05:00,10701,7A1v7bFDJwxM7XomePFyRh58SMHxrNSkM3fJygd8pQUN,DL9jCFHaM8BXJ5KE1YJHXNCbXgSdRgt18MHhAgC6TNmg,True,372125,93031,581,290,291,HfEnetJ7uBSmZWCjBNxdvv9HEC5nsW4wDV7wu6WnhWan,23248,412356,-389108,624
2022-01-24 09:11:10-05:00,10702,6kZoofhL5S3U8aQU2VW2TDRZdiBYo1e1o8AUSbSttsAy,4zUpycP3EDmXrC1qjmnHuymGVoBjXQT6yAkvKGW9Gext,True,134996720,33749180,209847,104923,104924,3zqXX6kzhkbW3d4TwD2CNjMRwxTbREXySekvq37kfCNk,8393907,42047134,-33653227,621
2022-01-24 09:11:10-05:00,10703,Gk4mpwDEggypoPjyrZcFDbHT8WBwspC5AbQ5uDgaQufL,GTDi3mKTcw1NfwbYx8s8YCkzqbaJUM8YUwYifNr9sjgH,True,27778118,6944529,43042,21521,21521,3zqXX6kzhkbW3d4TwD2CNjMRwxTbREXySekvq37kfCNk,1721709,21325433,-19603724,619
2022-01-24 09:11:10-05:00,10704,52hhBAuVyifMNFKGQmSitc8smiEgscXQMzVuZj55j7E5,6B5DBJx9NLytR3fkrYqe5W5ek4rUWsR4nPsRTvRfRwzC,True,5130282,1282570,7969,3984,3985,3zqXX6kzhkbW3d4TwD2CNjMRwxTbREXySekvq37kfCNk,318779,6118199,-5799420,621
2022-01-24 09:11:10-05:00,10705,9XHC2Ycm9f56cDYxRPVKYiYWGKA4y7Utpv3e9gpMsZq3,HpqAdpkzWqoJUNqmHEnn4PZwSB6C6jt8FJZQtZtFqXWA,True,1370205,342551,2128,1064,1064,3zqXX6kzhkbW3d4TwD2CNjMRwxTbREXySekvq37kfCNk,85156,1530352,-1445196,621
2022-01-24 09:11:29-05:00,10706,7EtGovzHsbD8cKGqq4R5rvKBbncR4Kc7CDkTjof2QBMf,8ShjeNWM2vcvUF9yYztYCHUQfcGsyg2A1LyWiPbQDDvq,True,29739,7434,46,23,23,3zqXX6kzhkbW3d4TwD2CNjMRwxTbREXySekvq37kfCNk,1844,35458,-33614,620
2022-01-24 09:11:30-05:00,10707,HfwGSiwGiyDFaTS2usYRp82zSmPPQqZukbw2d1BuFs5w,ArtgZbmA33k8Y3EfR6oMJiqT72MUrVBQqifPBdcnrzea,True,92070,23017,143,71,72,3zqXX6kzhkbW3d4TwD2CNjMRwxTbREXySekvq37kfCNk,5731,68775,-63044,622
2022-01-24 09:11:30-05:00,10708,68qWTKE41JPQMbF7zwqoELSVn2XbjcUMA4UTfER4fcz6,HrDYnhxX1Gm72Kq9H9k44xUfxqELLkC2yoEkkR3LEEHM,True,94127971,23531992,146129,73064,73065,3zqXX6kzhkbW3d4TwD2CNjMRwxTbREXySekvq37kfCNk,5845192,66033866,-60188674,620
2022-01-24 09:11:30-05:00,10709,3PPCwAjj8GNphb3cRs7kP1QVghEUX6gWUH3M4JarQsTD,28UR4WKAziiJmPwas5E5JrY3WaUrR2NkYYXCKuxPHTMR,True,41148544,10287136,64120,32060,32060,HfEnetJ7uBSmZWCjBNxdvv9HEC5nsW4wDV7wu6WnhWan,2564834,45881815,-43316981,623
2022-01-24 09:11:30-05:00,10710,8d4LtUwpkNSKRUdFbxhbeeaVc8hABhwjUExt3QgEVQbz,BieULGWXC1yEtuK9y27SMo9ApNDo6jLjxs5egr1Ebsda,True,763442,190860,1186,593,593,HfEnetJ7uBSmZWCjBNxdvv9HEC5nsW4wDV7wu6WnhWan,47468,935505,-888037,621
2022-01-24 09:11:34-05:00,10711,8T4WK27RvWVGqPuNqY6whk1fmU4vd5qaUQPZG1GJ79bh,DvSz7knS8N3K7L6JhQf1s4mJSyxB8uJXNQXtyjJn8QRL,True,665140,166284,1036,518,518,3zqXX6kzhkbW3d4TwD2CNjMRwxTbREXySekvq37kfCNk,41470,622811,-581341,623
2022-01-24 09:11:34-05:00,10712,6VJcr3VAEcEZaHEpt48QL8QxHKABufVp8n2JSEVTLh9U,8naR6kiySKj3vai9dCetdgCnCHgf2oyLjGqKTJ3Lz64Y,True,17459230,4364807,27229,13614,13615,3zqXX6kzhkbW3d4TwD2CNjMRwxTbREXySekvq37kfCNk,1089198,16083760,-14994562,623
2022-01-24 09:11:34-05:00,10713,GYgxUfZ19oSyHuovGRA6gBJT32goSxCrKR8hQQdBsrRG,2r8c6SU74hRq7xEmYBJ92WoSB6v6XCAXR3JcDznfCxkN,True,155993446,38998361,244100,122050,122050,3zqXX6kzhkbW3d4TwD2CNjMRwxTbREXySekvq37kfCNk,9764000,138538130,-128774130,625
2022-01-24 09:11:45-05:00,10714,m7gf1jAYXBZjRZEY9w4MjPfhzLwgDKaXyaCVhRD6C5E,Aa2aTZnpPux1i5K2MT4i1TsVM8vR7qR7rZGijQW4zpwd,True,779445573,194861392,1216869,608434,608435,HfEnetJ7uBSmZWCjBNxdvv9HEC5nsW4wDV7wu6WnhWan,48674786,388960922,-340286136,624
2022-01-24 09:11:45-05:00,10715,HpDwBPWZHfLzJUvTTABTA6qddyLLJiVTfqBx5gUktSUb,BqXLpaAeTNfNSeevfdazNqTgqEXj6Edgp8txWvCoxEz6,True,4691709,1172927,7276,3638,3638,3zqXX6kzhkbW3d4TwD2CNjMRwxTbREXySekvq37kfCNk,291078,4890388,-4599310,620
2022-01-24 09:11:51-05:00,10716,HabA6MLjygaKE6i9Sad4c6B8rnyobMYbtFext51rCmHj,516FG8YJxZmnGfvzWiV3TcwSF7UDdwWefjZkmi3R2SPX,True,24018490,6004622,37558,18779,18779,HfEnetJ7uBSmZWCjBNxdvv9HEC5nsW4wDV7wu6WnhWan,1502359,16227436,-14725077,625
2022-01-24 09:11:51-05:00,10717,6uZobpBuFcQeYgZ4dApFi6iy4DB9GLHP1AAsQcCj6212,SGGFiPjjhscwroiWMqY4jTAHFw8eakpsEv35wNoHUPY,True,2836305,709076,4424,2212,2212,3zqXX6kzhkbW3d4TwD2CNjMRwxTbREXySekvq37kfCNk,176975,1308477,-1131502,623
2022-01-24 09:11:57-05:00,10718,FuoFPNTdYVDkSHaBac6UC1aNJXafSNTvFJuBCdrgQQrH,ApBS1Fx83tcECMzDV6wEzEzEdg4e2hgj3djtjRUoSKK5,True,15878964,3969740,24768,12384,12384,3zqXX6kzhkbW3d4TwD2CNjMRwxTbREXySekvq37kfCNk,990732,12547550,-11556818,623
2022-01-24 09:11:57-05:00,10719,9gY3X17t7jarkWhnSEHPR51U9nVv8Dv99NqpCi3ewuPf,4Z6TdTW1d4JFRZqZyWA9X7upKhJwVPSfTQjFp14M59uv,True,20264817,5066203,31707,15853,15854,3zqXX6kzhkbW3d4TwD2CNjMRwxTbREXySekvq37kfCNk,1268299,23718503,-22450204,625
2022-01-24 09:12:08-05:00,10720,8WHDaiE6LqFFmCVMnPeLEQ99R6ft8b74UfmP9BqzjcE8,CGmoDGsdnjo3zMNrW78n2xxQr1aDPAiBYiXbyciLXYMu,True,15865020,3966254,24715,12357,12358,HfEnetJ7uBSmZWCjBNxdvv9HEC5nsW4wDV7wu6WnhWan,988628,10950386,-9961758,623
2022-01-24 09:12:09-05:00,10721,H1Z83zVoskNuBvYao1FjdLfETfhPpQFQUkniJfGxbaNz,EVqbBRV6Zy1tPLRevxpAykp8Mvv6tDZVTc4RmCKw4Gq1,True,19754493,4938623,30836,15418,15418,3zqXX6kzhkbW3d4TwD2CNjMRwxTbREXySekvq37kfCNk,1233440,16519227,-15285787,624
2022-01-24 09:12:38-05:00,10722,8HWpccoTmPZ9MsrxtvQ5BV5y8a8WBAB1Sxx2WAiYKRLH,9chtr2Nqg77CCCnjC5JqENmUBNxpDHVH6BG3wojn9gHQ,True,171450,42862,265,132,133,3zqXX6kzhkbW3d4TwD2CNjMRwxTbREXySekvq37kfCNk,10623,207557,-196934,619
2022-01-24 09:12:38-05:00,10723,FwTGq3BeMLyRFRa5r4E6nySLgoLNcNdqJsCQxA2i6uh6,88w6ti3WSriyu2FvNjVfrLpGyU5PUvaiJyqrAGPM8TKp,True,147521,36880,228,114,114,3zqXX6kzhkbW3d4TwD2CNjMRwxTbREXySekvq37kfCNk,9146,176229,-167083,619
2022-01-24 09:13:16-05:00,10724,3FF2rhr1RuT7UR7MmmGtrhfYbh6kbc5UXq51KmqFLZnq,AEmSYLt1dQ8suLugC4Lcw4kF3dG9GYcEfX54hEAKfmv5,True,568964,142241,889,444,445,3zqXX6kzhkbW3d4TwD2CNjMRwxTbREXySekvq37kfCNk,35596,357357,-321761,625
2022-01-24 09:20:43-05:00,10725,5gcF5a6vf5iHAnhKHhcfceXicrefXZ9L7PzqjjrzRm48,5VE1AGgChUAW2iR4iKiznUCqtu87q8R2cdWeSuFYXjYo,True,19113936,4778484,29772,14886,14886,HfEnetJ7uBSmZWCjBNxdvv9HEC5nsW4wDV7wu6WnhWan,1190908,8712387,-7521479,623
2022-01-24 09:21:18-05:00,10726,2mfcg17QocKKvDcqDH88TwxHRiS8dAQiJAGoAh1brns9,8aQLELBgaA9eXsxSciMjxWv8B1hpbUPfLwqVjEnasZbe,True,5606851,1401712,8669,4334,4335,HfEnetJ7uBSmZWCjBNxdvv9HEC5nsW4wDV7wu6WnhWan,346762,2757374,-2410612,618
2022-01-24 09:21:18-05:00,10727,GNkEoVMpNAgfyDBZ986MR9BEVc485xpLuZWwSCyZk5zJ,AT2eiaMyZNHZGqgTdie8QjLWCTrWSdkRmQxU2vZNgtDs,True,2016603,504150,3118,1559,1559,3zqXX6kzhkbW3d4TwD2CNjMRwxTbREXySekvq37kfCNk,124751,851504,-726753,618
2022-01-24 09:21:18-05:00,10728,9Ft21UZ66egkMCtZprBPc72WF1aj2fQwLs6XJWPXUbUV,6DGSgHegc23W5MQ6hqSsSSdwNvRqU3piR9GBoZ6fU23f,True,27512561,6878140,43000,21500,21500,HfEnetJ7uBSmZWCjBNxdvv9HEC5nsW4wDV7wu6WnhWan,1720022,13853610,-12133588,625
2022-01-24 09:21:54-05:00,10729,2aK454FrEuA6JQZo2hLUabd4E6wyQtVuJWw2rWz2pGVy,3dJvhEh7kykf8hCCWQRarh2s5ybJUAzbaPdDUmX4XokW,True,41291085,10322771,64356,32178,32178,HfEnetJ7uBSmZWCjBNxdvv9HEC5nsW4wDV7wu6WnhWan,2574258,13832553,-11258295,623
2022-01-24 09:22:41-05:00,10730,8abFwhhZyq3xkvjp4NWDBt7qAPXBbzBxksUk8SAUeVkN,A9u4dhWZbBwthC4WXQg1Dfp3wHYXr67SGs5na1EQ1k3r,True,3444353,861087,5349,2674,2675,3zqXX6kzhkbW3d4TwD2CNjMRwxTbREXySekvq37kfCNk,213960,1345900,-1131940,621
2022-01-24 09:22:41-05:00,10731,GqPZDwm3EWGMiVy7BY6qHM4Vzt2B9vW3Zs1CLScrtjAD,63h2HEdkmc54a8txd4LZ69TUBLR6VphxBoXLx6hjCLg4,True,301601526,75400381,471566,235783,235783,3zqXX6kzhkbW3d4TwD2CNjMRwxTbREXySekvq37kfCNk,18862665,97244943,-78382278,625
2022-01-24 09:24:00-05:00,10732,CLVUzXSNsQnX7n5cvxMuTjyMSjy1pNpPnWejFaeuonvb,BXZzBujr8DAUcGJcHQBaz1ZSwkATAHg3NX3bLnrjQpLh,True,6667898,1666974,10354,5177,5177,HfEnetJ7uBSmZWCjBNxdvv9HEC5nsW4wDV7wu6WnhWan,414172,2259919,-1845747,621
2022-01-24 09:24:00-05:00,10733,CYQr97qwLjGnmEy6vVgs3eL7omwG6UfFbhTv7gBty5z9,DJJ9UqSZUTgyt2yWAkUnGFDuox3xYFQUuorLa7qPdM88,True,9206601,2301650,14183,7091,7092,HfEnetJ7uBSmZWCjBNxdvv9HEC5nsW4wDV7wu6WnhWan,567333,4014465,-3447132,616
2022-01-24 09:24:00-05:00,10734,F6wpqqx576XRuYo8y6XPLYphojrQtK4VvdY79Jk6My5N,38VbNLaQzLFcVqHuSR9zn9UX3Yv9SCVy1mrwmxX9PpVQ,True,24338254,6084563,37578,18789,18789,HfEnetJ7uBSmZWCjBNxdvv9HEC5nsW4wDV7wu6WnhWan,1503121,7324096,-5820975,617
2022-01-24 09:24:02-05:00,10735,H3x9b27yHVdCxvtDf7mmJxkNeubcmQMwfAkLTYADPWNv,HGVCCz23rWx78vrTB2wvm2aesbLZuYFhhNuznGiSSAyA,True,114519903,28629975,177978,88989,88989,HfEnetJ7uBSmZWCjBNxdvv9HEC5nsW4wDV7wu6WnhWan,7119138,51062457,-43943319,621
2022-01-24 09:25:10-05:00,10736,FKQ26ZKSqbYwjUvaddC3h1b5envEXnUvHYinpB1pdqRd,RsEv5qrmgppBATzCDLgh2W91m6hi1bBaUBgdYCQuVGv,True,797503927,199375981,1231678,615839,615839,3zqXX6kzhkbW3d4TwD2CNjMRwxTbREXySekvq37kfCNk,49267131,307178204,-257911073,617
2022-01-24 09:25:10-05:00,10737,H1oYXGZTagwv48FdDe6RNkjNaesedqLKyXxTmPc5k4Fp,Am3rx6XrkrZ4MdeZDyZUv1YW2fBujcz4dLjVCnRQHKZa,True,62800090,15700022,97583,48791,48792,HfEnetJ7uBSmZWCjBNxdvv9HEC5nsW4wDV7wu6WnhWan,3903353,22823870,-18920517,621
2022-01-24 09:26:10-05:00,10738,EToREv5PrDmMUqRH43RdhooZMpmzXdic79KSoBatakPp,4ZTacQQnxq89V64pELPFkmvwJgkVY7m29g2sXfnn3mPD,True,7861408,1965352,12234,6117,6117,HfEnetJ7uBSmZWCjBNxdvv9HEC5nsW4wDV7wu6WnhWan,489379,2792553,-2303174,622
2022-01-24 09:26:10-05:00,10739,7aM6r3HXMKzhj1hoDWjjkVCVy2y1rhDx2QV8Sdgr9DoM,4yBtGoYqo6dX4T3NMVbgMN3731hEnugL1dsR1A5vXF8f,True,7629380,1907345,11930,5965,5965,3zqXX6kzhkbW3d4TwD2CNjMRwxTbREXySekvq37kfCNk,477227,3590611,-3113384,625
2022-01-24 09:26:10-05:00,10740,49hagnoMSB3ozBBMaTgeZ2nwEbKKS3NZWUuPShMBUwp9,6ivAhvY6bUr98jqBp4ye1w8Vz8NesEubqKDSn1jeqxmr,True,13957760,3489440,21841,10920,10921,3zqXX6kzhkbW3d4TwD2CNjMRwxTbREXySekvq37kfCNk,873652,5043577,-4169925,625
2022-01-24 10:12:50-05:00,10741,BgNgALwBEuiumVgiXRmBZRnyFrr9QTDy2maHzsNwNHGf,ag35Ec2uFtqkarizCxFyhM2SPBuUwfmLRhAdFEWFCNa,True,943887,235971,1433,716,717,HfEnetJ7uBSmZWCjBNxdvv9HEC5nsW4wDV7wu6WnhWan,57350,538251,-480901,607
2022-01-24 10:13:14-05:00,10742,7Dm3syN4P2mbBLFKyHTrtnSWY4hadGXiKB9EekTdT68S,HF97QS1dqarPMWgNmtcoaq6z3rpJnzAAAfc1PP4FwRhV,True,957953,239488,1464,732,732,3zqXX6kzhkbW3d4TwD2CNjMRwxTbREXySekvq37kfCNk,58584,383834,-325250,611
2022-01-25 13:33:04-05:00,10743,GJmom1dyridk7QkcvxYr1jUeQr6sT5yMnmQ6LJEqSq22,6tSYWuTpo57phZVwLZ4jEAod4w4dKfAwRVitjzGKXq9y,True,652496062537,163124015632,1013561142,506780571,506780571,HfEnetJ7uBSmZWCjBNxdvv9HEC5nsW4wDV7wu6WnhWan,40542445700,9079012319,31463433381,621
2022-01-25 13:52:45-05:00,10744,96StvqZyFUPtyMr4o9s7K4V29RSNyRpVi76vNwxG5rUf,GZKXFSFq4aGiTaqovtxqNCCVGkAFNXPh4Hep1ZMwdZ8g,False,7363,7363,0,0,0,HfEnetJ7uBSmZWCjBNxdvv9HEC5nsW4wDV7wu6WnhWan,0,19546,-21909,0
2022-01-25 14:22:54-05:00,10745,B4Uc39nKzz9wBRQsCkMR4A7RwTJ8rSuwpR6EQn2AesRb,H49bGZgatRZVpj6QufZRVgYrQtH7LpdbiqKBs23151m,False,8936,8936,0,0,0,HfEnetJ7uBSmZWCjBNxdvv9HEC5nsW4wDV7wu6WnhWan,0,22481,-24446,0
2022-01-26 08:47:59-05:00,10746,4Siq98BDakELWP5BzVoEN5tcg1ywRxTYs1aUcfW8spCt,2EBXLTVz1Gk9gS5JcVqCKAP5PatFGw1Vnww65Moz3SUn,True,24389095065,6097273765,37969761,18984880,18984881,HfEnetJ7uBSmZWCjBNxdvv9HEC5nsW4wDV7wu6WnhWan,1518790452,3872330621,-2353540169,622
2022-01-26 09:05:51-05:00,10747,4Siq98BDakELWP5BzVoEN5tcg1ywRxTYs1aUcfW8spCt,2EBXLTVz1Gk9gS5JcVqCKAP5PatFGw1Vnww65Moz3SUn,True,18611965841,4652991459,29023257,14511628,14511629,HfEnetJ7uBSmZWCjBNxdvv9HEC5nsW4wDV7wu6WnhWan,1160930291,3249565584,-2088635293,623
2022-01-26 14:03:01-05:00,10748,4Siq98BDakELWP5BzVoEN5tcg1ywRxTYs1aUcfW8spCt,2EBXLTVz1Gk9gS5JcVqCKAP5PatFGw1Vnww65Moz3SUn,True,14210389508,3552597375,22105100,11052550,11052550,HfEnetJ7uBSmZWCjBNxdvv9HEC5nsW4wDV7wu6WnhWan,884204020,2703989306,-1819785286,622
2022-01-26 14:06:31-05:00,10749,4Siq98BDakELWP5BzVoEN5tcg1ywRxTYs1aUcfW8spCt,2EBXLTVz1Gk9gS5JcVqCKAP5PatFGw1Vnww65Moz3SUn,True,10844123766,2711030940,16894182,8447091,8447091,HfEnetJ7uBSmZWCjBNxdvv9HEC5nsW4wDV7wu6WnhWan,675767287,2228014487,-1552247200,623
2022-01-26 14:07:13-05:00,10750,5wRQzyabqtB45KPmnsEBRJQkYDjnoWoPeSLkGx4qS5oh,8DrFp1BLznHCQX1isSkwzUEv9YLKuvcxvtjBLJfjNdpR,True,633776744429,158444186105,964041968,482020984,482020984,3zqXX6kzhkbW3d4TwD2CNjMRwxTbREXySekvq37kfCNk,38561678731,106704553277,-68142874546,608
2022-01-26 14:08:24-05:00,10751,CBL2NbekJrXvBiAcoj4fzQ4PfLDwTntW7Zt4nruHFYEw,59EvfgYTdKkfjUJz5LddLUAqbEdLaihcMzjcrTZsyzyS,True,628615,157153,965,482,483,3zqXX6kzhkbW3d4TwD2CNjMRwxTbREXySekvq37kfCNk,38605,112140,-73535,614
2022-01-26 14:08:50-05:00,10752,2Cjv6suZGsbRtv4TNSYksWKwMEKEf8vGQhGPbVVM1BMP,BHakHWmqzwqzq7i3a7VmXySPMMit58aQn7z4fqorcBHD,True,1205286,301321,1883,941,942,3zqXX6kzhkbW3d4TwD2CNjMRwxTbREXySekvq37kfCNk,75355,215640,-140285,625
2022-01-26 14:08:56-05:00,10753,7SBSVWCWENfJpg3Rd61kHjvj7rf5RchHeWChE42jdfk2,GNgZk4pw4cyetbovfqLtjdD5eEJTvJmrNbk572XnBeeN,True,4372628,1093157,6802,3401,3401,HfEnetJ7uBSmZWCjBNxdvv9HEC5nsW4wDV7wu6WnhWan,272091,787435,-515344,622
2022-01-26 14:08:59-05:00,10754,4Siq98BDakELWP5BzVoEN5tcg1ywRxTYs1aUcfW8spCt,2EBXLTVz1Gk9gS5JcVqCKAP5PatFGw1Vnww65Moz3SUn,True,8278131109,2069532776,12845870,6422935,6422935,HfEnetJ7uBSmZWCjBNxdvv9HEC5nsW4wDV7wu6WnhWan,513834822,1823670272,-1309835450,620
2022-01-26 16:47:54-05:00,10755,Br1j5Ftafei7ysu5SmqVZSoRe4uS4qCPeKSPHg55pyiE,G8fc7QvXjfkgBFvAVUgJFQS3VaF1biL9rktBExGa87Ks,True,42497384,10624346,65971,32985,32986,HfEnetJ7uBSmZWCjBNxdvv9HEC5nsW4wDV7wu6WnhWan,2638848,9891464,-7252616,620
2022-01-26 16:57:43-05:00,10756,6b7Ro2myM4HcUDqyyW9NEqTWPz8BWpH4eNFSQQci37So,7r7j7rSsa6YZcTuRPfs3KP44MVqUA4Q5NeJGmx84wbHq,True,49094,12273,70,35,35,HfEnetJ7uBSmZWCjBNxdvv9HEC5nsW4wDV7wu6WnhWan,2811,61530,-58719,572
2022-01-26 17:00:19-05:00,10757,9psSuFHBGqCvcgNMc7aTMhKMMFwBDmW7v5Wkn22KtTHj,7zi9LSfuEhXccQXSRukRRwgQUaiQVVgfsGaRYLP2JvwB,True,586688636,146672159,912292,456146,456146,HfEnetJ7uBSmZWCjBNxdvv9HEC5nsW4wDV7wu6WnhWan,36491694,240736725,-204245031,621
2022-01-26 17:00:19-05:00,10758,4ytoBUwuhAL4YYSCa6AgwrpeVF4eeU8H9NfDxMPZKxPo,Pby2szzsxDrXt4gnbmmaMccXxctZALr8miRtKhGKjsD,True,1973387,493346,3076,1538,1538,HfEnetJ7uBSmZWCjBNxdvv9HEC5nsW4wDV7wu6WnhWan,123053,1246192,-1123139,623
2022-01-26 20:36:46-05:00,10759,Br1j5Ftafei7ysu5SmqVZSoRe4uS4qCPeKSPHg55pyiE,G8fc7QvXjfkgBFvAVUgJFQS3VaF1biL9rktBExGa87Ks,True,31221037,7805259,47589,23794,23795,HfEnetJ7uBSmZWCjBNxdvv9HEC5nsW4wDV7wu6WnhWan,1903597,7995080,-6091483,609
2022-01-26 20:36:46-05:00,10760,Dv1BABsN7amhjmGBpMQsnMkRLx7MuCVwsnuyTQeZ6uum,BCjscxVo1h16teND6KKiAUy1ftNGTMy1vEEEyAW4ttVG,True,3260658,815164,4931,2465,2466,HfEnetJ7uBSmZWCjBNxdvv9HEC5nsW4wDV7wu6WnhWan,197261,1243691,-1046430,604
2022-01-26 20:39:35-05:00,10761,GXfjQr2ihTfLRys1DMetVGocd1sU97KdoCJ6x4HxdW1U,9GHvjJJXjbVz5D3RBfP3njcdRRXnFsXZ68jFa2LiGwsy,True,38697915,9674478,60503,30251,30252,HfEnetJ7uBSmZWCjBNxdvv9HEC5nsW4wDV7wu6WnhWan,2420157,23605054,-21184897,625
2022-01-26 20:39:46-05:00,10762,CCP5P6U4xBjea3snWgwBb5rtaounEAsNHpWzTUeNtVf9,GE2Bxc837ybP7sNR487U4bVbx68qyX2HtwPBLfEd4BDj,True,151631990,37907997,236403,118201,118202,HfEnetJ7uBSmZWCjBNxdvv9HEC5nsW4wDV7wu6WnhWan,9456148,62619616,-53163468,623
2022-01-26 20:39:46-05:00,10763,BHpLpoGQ27T6Q4CT8H4dzqS8KF8Vj5rqmqfcodoBzpgR,Akn3tG2hQBfBVtNYCeXchfzfcsyCuSpkGpFoMLEKwcBF,True,2445361,611340,3808,1904,1904,HfEnetJ7uBSmZWCjBNxdvv9HEC5nsW4wDV7wu6WnhWan,152336,1560454,-1408118,622
2022-01-26 20:44:24-05:00,10764,E5biUzKn2s5frKseCmfWriWjrYMGVtmLrhR9nYhAkVvR,BDHzqefisuGoMGcpML8t6KAC7rcErvhLcfV8KQC7oHAH,True,9534524,2383631,14690,7345,7345,HfEnetJ7uBSmZWCjBNxdvv9HEC5nsW4wDV7wu6WnhWan,587616,4559115,-3971499,616
2022-01-26 20:52:23-05:00,10765,GXSysysoV8Z4xBrQsaKUsSrpoWeTTUsbFmgfZDaQu4ZM,6FJyraiLgG3tb9B7pi4YFsJNtRVBNaghnm1ajzneVv7b,True,243629754,60907438,376128,188064,188064,HfEnetJ7uBSmZWCjBNxdvv9HEC5nsW4wDV7wu6WnhWan,15045145,106482564,-91437419,617
2022-01-26 20:52:55-05:00,10766,9aQrdyfAvcBbBj7iKQB17eAS4zBqymdd3kzkTkuRhdLU,BDHhukMF5rALuSwCxaw8g73m2MN4oX1D4e7uNmx3SiVt,True,34255980,8563995,53322,26661,26661,3zqXX6kzhkbW3d4TwD2CNjMRwxTbREXySekvq37kfCNk,2132906,14562848,-12429942,622
2022-01-26 20:53:08-05:00,10767,9psSuFHBGqCvcgNMc7aTMhKMMFwBDmW7v5Wkn22KtTHj,7zi9LSfuEhXccQXSRukRRwgQUaiQVVgfsGaRYLP2JvwB,True,431530134,107882533,673992,336996,336996,3zqXX6kzhkbW3d4TwD2CNjMRwxTbREXySekvq37kfCNk,26959696,188634103,-161674407,624
2022-01-26 20:53:12-05:00,10768,4ytoBUwuhAL4YYSCa6AgwrpeVF4eeU8H9NfDxMPZKxPo,Pby2szzsxDrXt4gnbmmaMccXxctZALr8miRtKhGKjsD,True,1450908,362727,2259,1129,1130,3zqXX6kzhkbW3d4TwD2CNjMRwxTbREXySekvq37kfCNk,90396,961885,-871489,623
2022-01-26 20:54:25-05:00,10769,EF6H6aW1p3qcAtiLFU9rbFYfsKfD683meHXDw8hLdaZK,8vfJbpnK7SQcjpEBCzZJRW8JosNbsmTeJ2YXZCbM225c,True,7769998,1942499,12134,6067,6067,HfEnetJ7uBSmZWCjBNxdvv9HEC5nsW4wDV7wu6WnhWan,485370,4825158,-4339788,624
2022-01-26 20:56:10-05:00,10770,6b7Ro2myM4HcUDqyyW9NEqTWPz8BWpH4eNFSQQci37So,7r7j7rSsa6YZcTuRPfs3KP44MVqUA4Q5NeJGmx84wbHq,True,36365,9091,56,28,28,HfEnetJ7uBSmZWCjBNxdvv9HEC5nsW4wDV7wu6WnhWan,2255,39708,-37453,620
2022-01-26 20:56:58-05:00,10771,Dv1BABsN7amhjmGBpMQsnMkRLx7MuCVwsnuyTQeZ6uum,BCjscxVo1h16teND6KKiAUy1ftNGTMy1vEEEyAW4ttVG,True,2403146,600786,3749,1874,1875,HfEnetJ7uBSmZWCjBNxdvv9HEC5nsW4wDV7wu6WnhWan,149982,977153,-827171,624
2022-01-26 20:57:02-05:00,10772,HGAFdundf5voDqeh9g7d6Q9mgMf8eEg898QMRBqwPZ6C,deanBuZXWBHEe2TGfP37S9aMBEnEgmZoyRJjAvruzfA,True,456405,114100,712,356,356,3zqXX6kzhkbW3d4TwD2CNjMRwxTbREXySekvq37kfCNk,28506,481794,-453288,624
2022-01-26 20:57:24-05:00,10773,Br1j5Ftafei7ysu5SmqVZSoRe4uS4qCPeKSPHg55pyiE,G8fc7QvXjfkgBFvAVUgJFQS3VaF1biL9rktBExGa87Ks,True,22998273,5749568,35962,17981,17981,HfEnetJ7uBSmZWCjBNxdvv9HEC5nsW4wDV7wu6WnhWan,1438503,6424632,-4986129,625
2022-01-26 20:59:00-05:00,10774,46TNhGwBVzedW8xSb9UY94HNeSom9iGiZzAjrKHiRM2G,7JVTiqNYeKHbyzRkKtvSEpqLPKykZso8cGUr3sX1j7QF,True,762164,190540,1170,585,585,HfEnetJ7uBSmZWCjBNxdvv9HEC5nsW4wDV7wu6WnhWan,46822,588056,-541234,614
2022-01-26 20:59:00-05:00,10775,GXfjQr2ihTfLRys1DMetVGocd1sU97KdoCJ6x4HxdW1U,9GHvjJJXjbVz5D3RBfP3njcdRRXnFsXZ68jFa2LiGwsy,True,28392073,7098018,43207,21603,21604,3zqXX6kzhkbW3d4TwD2CNjMRwxTbREXySekvq37kfCNk,1728290,18248349,-16520059,608
2022-01-26 20:59:00-05:00,10776,BHpLpoGQ27T6Q4CT8H4dzqS8KF8Vj5rqmqfcodoBzpgR,Akn3tG2hQBfBVtNYCeXchfzfcsyCuSpkGpFoMLEKwcBF,True,1795431,448857,2748,1374,1374,HfEnetJ7uBSmZWCjBNxdvv9HEC5nsW4wDV7wu6WnhWan,109938,1204617,-1094679,612
2022-01-26 20:59:00-05:00,10777,CCP5P6U4xBjea3snWgwBb5rtaounEAsNHpWzTUeNtVf9,GE2Bxc837ybP7sNR487U4bVbx68qyX2HtwPBLfEd4BDj,True,111331146,27832786,170672,85336,85336,HfEnetJ7uBSmZWCjBNxdvv9HEC5nsW4wDV7wu6WnhWan,6826898,49092636,-42265738,613
2022-01-26 20:59:05-05:00,10778,E5biUzKn2s5frKseCmfWriWjrYMGVtmLrhR9nYhAkVvR,BDHzqefisuGoMGcpML8t6KAC7rcErvhLcfV8KQC7oHAH,True,7016366,1754091,10959,5479,5480,HfEnetJ7uBSmZWCjBNxdvv9HEC5nsW4wDV7wu6WnhWan,438399,3551552,-3113153,624
2022-01-26 21:10:50-05:00,10779,6b7Ro2myM4HcUDqyyW9NEqTWPz8BWpH4eNFSQQci37So,7r7j7rSsa6YZcTuRPfs3KP44MVqUA4Q5NeJGmx84wbHq,True,26736,6684,41,20,21,HfEnetJ7uBSmZWCjBNxdvv9HEC5nsW4wDV7wu6WnhWan,1654,30283,-28629,618
2022-01-26 21:11:56-05:00,10780,9Ngb4UJjvSm9zbTN4RYRFWBzTPVWQh7C2hFiDvwPsDBd,EamTKaoTYJo9RUMQC7MjS1HJrVPYipR2cv6nYpgBLnPr,True,159073533,39768382,247483,123741,123742,3zqXX6kzhkbW3d4TwD2CNjMRwxTbREXySekvq37kfCNk,9899334,75634705,-65735371,622
2022-01-26 22:47:25-05:00,10781,GXSysysoV8Z4xBrQsaKUsSrpoWeTTUsbFmgfZDaQu4ZM,6FJyraiLgG3tb9B7pi4YFsJNtRVBNaghnm1ajzneVv7b,True,179330014,44832503,279547,139773,139774,2BPYaeCXY4BCFSGFSfiGtqmhzJ4fkhYLxGjqFvLCB6hG,11181906,83153034,-71971128,623
2022-01-26 22:47:47-05:00,10782,HGAFdundf5voDqeh9g7d6Q9mgMf8eEg898QMRBqwPZ6C,deanBuZXWBHEe2TGfP37S9aMBEnEgmZoyRJjAvruzfA,True,335716,83928,525,262,263,2BPYaeCXY4BCFSGFSfiGtqmhzJ4fkhYLxGjqFvLCB6hG,21008,367566,-346558,625
2022-01-26 22:49:05-05:00,10783,2r64Rnbu3ZjmJTHHUxxV9TWWGzwpAepA4ySbtKivBXCj,6RRzx6KLkMiFK9JSuznrSJGiPgkHwatBSskudHqbfKJ5,True,141105572,35276392,220386,110193,110193,2BPYaeCXY4BCFSGFSfiGtqmhzJ4fkhYLxGjqFvLCB6hG,8815449,93220200,-84404751,624
2022-01-26 22:50:55-05:00,10784,BH36ueAULprzjj6WabTgvivEcrx3VdDn8DTxSoro8Zym,6yydJKEmtZjUwURrs9gQ7EGkB86nK28ZDJQqNMgbPosA,True,87203144,21800786,136360,68180,68180,HfEnetJ7uBSmZWCjBNxdvv9HEC5nsW4wDV7wu6WnhWan,5454430,47384331,-41929901,625
2022-01-26 22:53:39-05:00,10785,BCGTaPQxGEMjD7xUxwfwmVVYJ9CEGH33yJRi3QjwyiLE,JBct1cZ9a959UKwABBEefwxZnGTAAGLzyUdXrXqGGCZd,True,38138339,9534584,58935,29467,29468,2BPYaeCXY4BCFSGFSfiGtqmhzJ4fkhYLxGjqFvLCB6hG,2357407,8669068,-6311661,618
2022-01-27 14:38:43-05:00,10786,9aQrdyfAvcBbBj7iKQB17eAS4zBqymdd3kzkTkuRhdLU,BDHhukMF5rALuSwCxaw8g73m2MN4oX1D4e7uNmx3SiVt,True,25218375,6304593,39392,19696,19696,HfEnetJ7uBSmZWCjBNxdvv9HEC5nsW4wDV7wu6WnhWan,1575701,11371783,-9796082,624
2022-01-27 14:39:49-05:00,10787,9psSuFHBGqCvcgNMc7aTMhKMMFwBDmW7v5Wkn22KtTHj,7zi9LSfuEhXccQXSRukRRwgQUaiQVVgfsGaRYLP2JvwB,True,317593935,79398483,496258,248129,248129,2BPYaeCXY4BCFSGFSfiGtqmhzJ4fkhYLxGjqFvLCB6hG,19850353,147162215,-127311862,625
2022-01-27 14:40:02-05:00,10788,4ytoBUwuhAL4YYSCa6AgwrpeVF4eeU8H9NfDxMPZKxPo,Pby2szzsxDrXt4gnbmmaMccXxctZALr8miRtKhGKjsD,True,1068121,267030,1669,834,835,2BPYaeCXY4BCFSGFSfiGtqmhzJ4fkhYLxGjqFvLCB6hG,66794,740471,-673677,625
2022-01-27 14:40:13-05:00,10789,442usWu6XpJZvU25bqXeynRrQ15jAzWwU9DWMgHpTn3Q,CtvADKp39bjJf3cPKWNL3wxnhq273fVM4fC5DmEcg5cC,True,814345124,203586281,1273994,636997,636997,3zqXX6kzhkbW3d4TwD2CNjMRwxTbREXySekvq37kfCNk,50959788,161704564,-110744776,625
2022-01-27 14:55:23-05:00,10790,Dv1BABsN7amhjmGBpMQsnMkRLx7MuCVwsnuyTQeZ6uum,BCjscxVo1h16teND6KKiAUy1ftNGTMy1vEEEyAW4ttVG,True,1768858,442214,2764,1382,1382,HfEnetJ7uBSmZWCjBNxdvv9HEC5nsW4wDV7wu6WnhWan,110592,764473,-653881,625
2022-01-27 14:55:58-05:00,10791,Br1j5Ftafei7ysu5SmqVZSoRe4uS4qCPeKSPHg55pyiE,G8fc7QvXjfkgBFvAVUgJFQS3VaF1biL9rktBExGa87Ks,True,16916915,4229228,26256,13128,13128,2BPYaeCXY4BCFSGFSfiGtqmhzJ4fkhYLxGjqFvLCB6hG,1050267,5121660,-4071393,620
2022-01-24 04:43:43-05:00,9768,CEtpqFD4BbeiNfaXyLLYEapY2mWgE26H5q6H34tWwRuD,BVqRyqwGFPzSkk1H2finiyfaL3LScbEiQGk3mihirxqs,True,213498,53374,331,165,166,3zqXX6kzhkbW3d4TwD2CNjMRwxTbREXySekvq37kfCNk,13251,235613,-222362,620
2022-01-24 04:43:43-05:00,9769,HpRYrL8HzCPaBJTLFgZmYg2aXBnBQUpf1mikVkzkY56z,8DzHRd8qWcEjnX6cefwYtgRGpQJUaw9QPjyfAsN7j33r,True,2957098,739274,4582,2291,2291,3zqXX6kzhkbW3d4TwD2CNjMRwxTbREXySekvq37kfCNk,183286,3232371,-3049085,619
2022-01-24 04:43:43-05:00,9770,6kt64nJRnYaWMi9GbpZaUuhbToAVRd7FUMTGASAAJrve,2Sdxv9ZtogNcVbJwBPxKmVjwAiKyX5GHEfnRmFcydQ1G,True,33739625,8434906,52777,26388,26389,HfEnetJ7uBSmZWCjBNxdvv9HEC5nsW4wDV7wu6WnhWan,2111085,33936543,-31825458,625
2022-01-24 04:43:43-05:00,9771,5zCfNUARbvDrkdkf8rKNnf6D7HXn7Wz6D61jQGTGpw3N,6T76MLTxS5vnRuodEgADt3iXMx8WUFLQzoyKh7f2uPFy,True,524773019,131193254,813691,406845,406846,3zqXX6kzhkbW3d4TwD2CNjMRwxTbREXySekvq37kfCNk,32547656,329948205,-297400549,620
2022-01-24 04:43:43-05:00,9772,EmXaq1sxmAZUiwYW6LXpKtKFZXu5MzQ3sK4MEAojDK1h,HuAsa5G2wJi8Ah9stxEmggwcB5zW1QjBsP3Ndgke7r8X,True,388062,97015,601,300,301,3zqXX6kzhkbW3d4TwD2CNjMRwxTbREXySekvq37kfCNk,24066,433930,-409864,620
2022-01-24 04:43:43-05:00,9773,4cNmhgaMic1xBiaDJ6phrQuXmm8WfF1qjyYMqZcKG4c9,43vgfXiLTtcs1bkrcDar2iz9M6RMbGqbA6BMkBHdh7T4,True,272427,68106,425,212,213,HfEnetJ7uBSmZWCjBNxdvv9HEC5nsW4wDV7wu6WnhWan,17022,306614,-289592,624
2022-01-24 04:43:43-05:00,9774,6aW9dhnTNerVd1MPv5GrcYqgjVPE9LsNCGYSJSrNdgS8,8kmJu2UxTk2T37sqxDSrf6pDWhJZRxfRdJB7DLeoWddJ,True,9599866,2399966,14920,7460,7460,HfEnetJ7uBSmZWCjBNxdvv9HEC5nsW4wDV7wu6WnhWan,596808,10230834,-9634026,621
2022-01-24 04:43:43-05:00,9775,8YMEydGnQH9W5AEXFGquFkb1bcf3PcxiMvYBSMPXKJyQ,3CmWH8eYtkmHNisqMmMBLff6C6z6ZcSj38KoQ34DPUE7,True,227497,56874,355,177,178,HfEnetJ7uBSmZWCjBNxdvv9HEC5nsW4wDV7wu6WnhWan,14205,237546,-223341,624
2022-01-24 04:43:43-05:00,9776,Gfe4UgUGqvzcehSbETrWwLRAcqzFnkTrs6vJx8h6kTxi,7exMQ8sLti4Pmb2ZQtZhyuWRuQ6pq7XSXL9sCcWTqCvF,True,23566035,5891508,36703,18351,18352,HfEnetJ7uBSmZWCjBNxdvv9HEC5nsW4wDV7wu6WnhWan,1468124,25927876,-24459752,622
2022-01-24 04:44:06-05:00,9777,2DHhfXSzcuSwsKfAYLMuWuD17w84mCwNer9fcBNLTpSc,89BVfDycKjdSkQzFVqCXd5c16DntdND7WsqoZtCafYFH,True,13907021,3476755,21762,10881,10881,3zqXX6kzhkbW3d4TwD2CNjMRwxTbREXySekvq37kfCNk,870519,15117722,-14247203,625
2022-01-24 04:44:06-05:00,9778,4qWzk4JP2gEsTP252Y4SJrjSmfRBxDfE4ZdbPmwavfb2,CAgDhCNVyy61FG2YPMnm9zxgY56s2UqPhvssH5G1LjXP,True,30999213,7749803,48510,24255,24255,HfEnetJ7uBSmZWCjBNxdvv9HEC5nsW4wDV7wu6WnhWan,1940407,31034932,-29094525,625
2022-01-24 04:44:08-05:00,9779,45AiuRBbmupfwYXqsWwKHtmEWN8XNJDUSHwHL3b6PvHc,CfvwVkxYPP3jqK2dpAvSRFA1513E9ti84mEpYgtkzFUt,True,494144,123536,773,386,387,HfEnetJ7uBSmZWCjBNxdvv9HEC5nsW4wDV7wu6WnhWan,30931,534096,-503165,625
2022-01-24 04:44:48-05:00,9780,EAtQUZAkQxwJF779DwPcWHZ455FzYX8mzm1uV5LBnhPB,8h8t6GW1Y7xMBfWpfyFfUVBP4apMbJVNg7igZUYZLsyr,True,2312264,578066,3537,1768,1769,HfEnetJ7uBSmZWCjBNxdvv9HEC5nsW4wDV7wu6WnhWan,141513,1207320,-1065807,612
2022-01-24 04:44:48-05:00,9781,EXP61AETWHw3kHSjrJH1jQBt6cXR9Zebz34Cueb3KAzg,2JT9GrgdUKjuQQtXvZqevbjFquUQBMYDoADmBjDKWXj3,True,9387790,2346947,14435,7217,7218,HfEnetJ7uBSmZWCjBNxdvv9HEC5nsW4wDV7wu6WnhWan,577425,6389989,-5812564,615
2022-01-24 04:44:48-05:00,9782,4ne6vC7qdxQYHJCsaeFAKZrKdFt2SwXGHQ3jrMHqt4DL,Cf1dLHY2WXH9rXbRKq5TT8THbdo9SdNUZq4rYhRCF9z,True,378634,94658,565,282,283,3zqXX6kzhkbW3d4TwD2CNjMRwxTbREXySekvq37kfCNk,22630,264040,-241410,597
2022-01-24 04:46:33-05:00,9783,AECUZGm5DjFvbLZEUYhepSPg1Wa7hBjxF9e7ZRBzRPhm,Ar7e1iLKAqa54QiQnXifvnETixDZT1T8KL5YWJA8Ykv1,True,351947,87986,550,275,275,HfEnetJ7uBSmZWCjBNxdvv9HEC5nsW4wDV7wu6WnhWan,22010,392871,-370861,625
2022-01-24 04:46:33-05:00,9784,CygwJ5Z1ZP6xfjN1ZGH7yw8b2oYvf6JTpenXx7A5yFdt,59VKgJtBCTb3Pji7BWtqttisBYVVCnWtyEn5Eba5r52Y,True,5049151,1262287,7900,3950,3950,3zqXX6kzhkbW3d4TwD2CNjMRwxTbREXySekvq37kfCNk,316001,5277156,-4961155,625
2022-01-24 04:47:11-05:00,9785,7afnF1MkAootZGWc7zsMVLpBuve83hGmvAHkfmwgsq5A,HKdJE8bReznq1Qxqd5iZ4nWQGCk62Vo5TpkRD51bpbGp,True,298334,74583,466,233,233,HfEnetJ7uBSmZWCjBNxdvv9HEC5nsW4wDV7wu6WnhWan,18667,333616,-314949,625
2022-01-24 04:47:12-05:00,9786,73Wkg27usHy8knWENTmb9zbikugYh93JvBB2bF855vZ2,J9WaUA7r8ct4ZG8o8ATZjvHUPuCYqY42aTsr9xveW5BX,True,304125489,76031372,475777,237888,237889,HfEnetJ7uBSmZWCjBNxdvv9HEC5nsW4wDV7wu6WnhWan,19031080,418037973,-399006893,625
2022-01-24 04:47:15-05:00,9787,2AAWghW6BUAFBtF3R6hB9uoqMc5oUDkU8FTd2JrXKema,798cfEUZ2YhXwNTNjXMS4Z2J8gAHaK4zZwpMkq2HzWWM,True,1560265288,390066322,2441741,1220870,1220871,3zqXX6kzhkbW3d4TwD2CNjMRwxTbREXySekvq37kfCNk,97669655,1186963437,-1089293782,625
2022-01-24 04:47:32-05:00,9788,8GhXRNmsEgFgKPhGNNgEPUywVzW3bE7uZRWys2P1yNeJ,Bvi5vD5fhRFNdVhEXsSv9vkJzyQzgEswFHBxowkUEgF,True,2505686,626421,3920,1960,1960,3zqXX6kzhkbW3d4TwD2CNjMRwxTbREXySekvq37kfCNk,156834,2776415,-2619581,625
2022-01-24 04:48:17-05:00,9789,HxhVxMpFpKzeuC6Z6CpsuUhPHdHUzvpMNYJ8LpQ3NYCp,8KyiipC39iU15zVErVvj6hdhbv89STsexrB8dVw3RcLs,True,304326,76081,475,237,238,3zqXX6kzhkbW3d4TwD2CNjMRwxTbREXySekvq37kfCNk,19034,340909,-321875,625
2022-01-24 04:48:28-05:00,9790,9WRDBHzD4aNHw5qvrhc6nqXCBLA5D7YYP8TvSrLksXd6,GwxWNmv9XDkqQsx7DfCMccFjVik8asPnFU9gtnb4UVx,True,224772,56193,351,175,176,HfEnetJ7uBSmZWCjBNxdvv9HEC5nsW4wDV7wu6WnhWan,14065,251477,-237412,625
2022-01-24 04:49:21-05:00,9791,Frobc1KZTVcsyfwyKwSpHJobxmiJBomzHhGCLdrzdAz8,HziyKP9uxWCuXddtbRzWMczHNdgyQB5UXQZj4MnMm14,True,1853798,463449,2868,1434,1434,3zqXX6kzhkbW3d4TwD2CNjMRwxTbREXySekvq37kfCNk,114758,1130110,-1015352,619
2022-01-24 04:49:21-05:00,9792,5acohGZShYQVNGZEfy7pTyX7E8MzqRDwByhFL1H53UNv,4Z454ZseKbWGEtdrE9eotbDZ7o9VHhooMYriTfSFHiGt,True,144515734,36128932,225433,112716,112717,3zqXX6kzhkbW3d4TwD2CNjMRwxTbREXySekvq37kfCNk,9017331,49316745,-40299414,623
2022-01-24 04:49:32-05:00,9793,HZJyrD4eqM4nKnyRh2JAs1sC2TaJxFhNPixBdK7PLMuS,Hycz71z4tEsKUogJnefT2GN3MPCLdTJdv9B6T82Ngw2u,True,1250111,312527,1956,978,978,3zqXX6kzhkbW3d4TwD2CNjMRwxTbREXySekvq37kfCNk,78253,1408804,-1330551,625
2022-01-24 04:50:02-05:00,9794,3R2wxFQwjCqUwwxJmp9tNrT6osYFpB5gczq2QYik6QYm,7At5Ej3ZsynfWr56FYrd4P4Y6UtD8FHA4gCFB8TaAyaG,True,290533,72633,454,227,227,HfEnetJ7uBSmZWCjBNxdvv9HEC5nsW4wDV7wu6WnhWan,18183,325154,-306971,625
2022-01-24 04:50:23-05:00,9795,oTq8BsGLNc2ddcdR7ELnCXgzf4KvtA7REmfbFKo56FT,4PgxGgi2UaB753PFyELQCrJy7phAkYsW4e39J9wGWrcM,True,18245233,4561308,28542,14271,14271,3zqXX6kzhkbW3d4TwD2CNjMRwxTbREXySekvq37kfCNk,1141699,32896466,-31754767,625
2022-01-24 04:50:36-05:00,9796,68F35fonSGS1P6LMYmAmeoM8kC6Z78NabMqYLeCZr9GJ,8apmWSZdS8s1ScoNVj4AvSJsbQCj1drU3HL74khuANT2,True,308835,77208,483,241,242,3zqXX6kzhkbW3d4TwD2CNjMRwxTbREXySekvq37kfCNk,19327,345277,-325950,625
2022-01-24 04:50:51-05:00,9797,AzLdwyd8Q4V3iMaSwWgvWwQ9nCs7X7YV2YKpd6CH33nP,BYjeXF5YkcJy3mNMbvfHzXTtyjkc4U53hM5tvfERUH8y,True,288642,72160,451,225,226,3zqXX6kzhkbW3d4TwD2CNjMRwxTbREXySekvq37kfCNk,18065,322491,-304426,625
2022-01-24 04:51:37-05:00,9798,HdRgh9niYSd3YKCxzGdusYFquiVoFTP2mEGEzJJL5Nii,78C68Gbb1jYFQmYNCHHjL52keEKMXtGukmBwT7ahon4B,True,58927728,14731931,92093,46046,46047,HfEnetJ7uBSmZWCjBNxdvv9HEC5nsW4wDV7wu6WnhWan,3683738,52531218,-48847480,625
2022-01-24 04:53:16-05:00,9799,6TvTxJWSPeyaTVm8PmarVDzxhbTqnkyoabQTgihXyGMj,62ngTMHaRDFjpvzasDgfmgyJ5T6jS9PmYgy97HCkyQS4,True,8207208,2051802,12831,6415,6416,3zqXX6kzhkbW3d4TwD2CNjMRwxTbREXySekvq37kfCNk,513277,2011071,-1497794,625
2022-01-24 04:53:27-05:00,9800,EAUFD16wab8qRMJ4H6updHGt4xFqgRCDeRHVCsLCTSTL,8vkfYSyCyBY9g4TZrp52jUcQj6udy9xAaA4fioRE2RXx,True,173994111,43498527,272164,136082,136082,HfEnetJ7uBSmZWCjBNxdvv9HEC5nsW4wDV7wu6WnhWan,10886584,113623107,-102736523,625
2022-01-24 04:53:39-05:00,9801,G8nRLTWTT5aD7q7TcSa2mw7p12GUuHDVq5ev4vyXbdKi,3DmQyungZMK4T1a1PgXh5shBskwP69tTLmZPh7HZ76vh,True,424255,106063,663,331,332,3zqXX6kzhkbW3d4TwD2CNjMRwxTbREXySekvq37kfCNk,26543,474225,-447682,625
2022-01-24 04:54:13-05:00,9802,8VQ21PFXdHBNmiZiF18LyGvsRSpr13vkyktfembNCe3m,5exbVC7vaGFeHEGAx7epYfMaU932QafqzfhFm5FKAq2H,True,262561,65640,410,205,205,3zqXX6kzhkbW3d4TwD2CNjMRwxTbREXySekvq37kfCNk,16415,293521,-277106,625
2022-01-24 04:54:43-05:00,9803,Dqnxcekm1QfxGQ2FSJ6SjFiwmaQRWEjW9WTJQG4AjEpE,9JiMtjm5AJqngosRg787FiN8NyuBPuAPD2jYpRQkAc1d,True,378060,94515,591,295,296,HfEnetJ7uBSmZWCjBNxdvv9HEC5nsW4wDV7wu6WnhWan,23666,422869,-399203,625
2022-01-24 04:55:47-05:00,9804,69byqtDPmgEY1NqKBCR95CEPVHRUxgbNW9Y4P4HjQ7ND,E47T4q4zMGzNL6vDxgWdLn3EQbW3WfVryr8Jsymy1hAL,True,479145,119786,749,374,375,3zqXX6kzhkbW3d4TwD2CNjMRwxTbREXySekvq37kfCNk,29986,490373,-460387,625
2022-01-24 04:56:53-05:00,9805,6X5por58mMECmNZQEWpo8M8aA1eHJqr5LNeV9vC7GW5e,DPB2C5UB2Ls1kNzbs1GP33junQvhUyFJWP75RoYjqByn,True,15466770,3866692,24186,12093,12093,3zqXX6kzhkbW3d4TwD2CNjMRwxTbREXySekvq37kfCNk,967455,27094691,-26127236,625
2022-01-24 04:59:30-05:00,9806,JCagxpXPs6wVRUWbNBPCZ4uLCkZsachnofN7SZEEwGwB,5uGj1TBCkc7FV4ffdBJg31yLcCxkQLxRExjcinnJUow9,True,434956719,108739178,680004,340002,340002,3zqXX6kzhkbW3d4TwD2CNjMRwxTbREXySekvq37kfCNk,27200182,397723915,-370523733,625
2022-01-24 05:00:08-05:00,9807,9QZvB1Gqhk5PKt3MoJMjZL3FaU2bTbTDcVw3nF316zh7,DGJWGr9RCWkzdWn21mWG7NyUN8uuvSQbA53HojFJe1rH,True,3735521,933880,5780,2890,2890,3zqXX6kzhkbW3d4TwD2CNjMRwxTbREXySekvq37kfCNk,231200,4030963,-3799763,618
2022-01-24 05:00:08-05:00,9808,2ZX5NexeuZq25mAfBFDrwd44UfKhWgzmSwdhWFmo48c7,CpNnhSqg7EHn9g84gHoo831sVrAe5SkwNaEZAash4CXs,True,1964163,491040,3064,1532,1532,HfEnetJ7uBSmZWCjBNxdvv9HEC5nsW4wDV7wu6WnhWan,122593,2212604,-2090011,624
2022-01-24 05:00:08-05:00,9809,CM95f7KjJuAf1xVTWhu3wrp6BfMz116FbgkxBhcRNs4k,EG55wkH5NcoasfBUYhD5D2dc2uvo11dZ3uTu5wgs4gf2,True,507208,126802,791,395,396,HfEnetJ7uBSmZWCjBNxdvv9HEC5nsW4wDV7wu6WnhWan,31657,544820,-513163,624
2022-01-24 05:00:08-05:00,9810,8XcMucCQpWfNtbdCYnKuabk91NQ9wfYp7byk496CwU9n,DLrApDfWcyMqufEFZm9PvddsMoiediT58X8e8pxpnzrk,True,475845,118961,742,371,371,HfEnetJ7uBSmZWCjBNxdvv9HEC5nsW4wDV7wu6WnhWan,29693,513547,-483854,624
2022-01-24 05:00:08-05:00,9811,Go3ne58krEsFsZ5yu9EBT7od15VCYmtbs1KhumRMTiXS,HCvwQ7HjmmeDXrguZQPrAbJjcCJzHqVZK2JMSFkFDWfe,True,99448,24862,155,77,78,HfEnetJ7uBSmZWCjBNxdvv9HEC5nsW4wDV7wu6WnhWan,6209,115542,-109333,624
2022-01-24 05:00:08-05:00,9812,Bbd196A866Y9rQWQFt4YGg2R6Jqj7WQGXWPDmrNtPcKf,5gmWk1KwLoRHnhkjxps4Ad6aVk4ZpcfC3McZCWDVCUbu,True,278260,69565,434,217,217,HfEnetJ7uBSmZWCjBNxdvv9HEC5nsW4wDV7wu6WnhWan,17390,322480,-305090,624
2022-01-24 05:00:08-05:00,9813,AiLCB8xw3k5FXdJE1T42PLFhHrz1bLTKpNekR61a915N,HB7CNWxLipWAc6MPGq9wV4TT7AYjiELA5T3onYeVqBbU,True,5832592,1458148,9026,4513,4513,3zqXX6kzhkbW3d4TwD2CNjMRwxTbREXySekvq37kfCNk,361066,6578411,-6217345,619
2022-01-24 05:00:08-05:00,9814,ANXYsUNpZ34dBt7cp6HEE7oi2pTKsbj7B5TeFHKPbHBU,2pqeP4fuMREosHcfWUecEBssp1GM4isihNjn7ALUD51d,True,353025,88256,546,273,273,3zqXX6kzhkbW3d4TwD2CNjMRwxTbREXySekvq37kfCNk,21850,394746,-372896,618
2022-01-24 05:00:08-05:00,9815,AnqmmhzVDCNq4dE4VvYkPDGB9nMXr4ykqvUhwxhR21pd,CcMeofCvvrDaBzgAGzoPwRt5eQmzdB1z2Y6UiwGqhFbG,True,3341540,835385,5219,2609,2610,HfEnetJ7uBSmZWCjBNxdvv9HEC5nsW4wDV7wu6WnhWan,208790,4558628,-4349838,624
2022-01-24 05:00:08-05:00,9816,3oCun4gm3k8sXxVxiYM8okGi8iCXH9LvDkHf9PBQWYXR,E1np1dZ7jUm811ddvy1jQerBwGSYb5BbZWnUHeotvrfH,True,895668,223917,1393,696,697,HfEnetJ7uBSmZWCjBNxdvv9HEC5nsW4wDV7wu6WnhWan,55725,439155,-383430,622
2022-01-24 05:00:09-05:00,9817,GM22yjVoBCzgBcVTT5EcgRhVWiXVV82kSj1dPCbegKWj,CDDy8JmJMwJyx1YAvEPpj8AYxCpngRovf3wWfVzao5Rc,True,171542,42885,267,133,134,HfEnetJ7uBSmZWCjBNxdvv9HEC5nsW4wDV7wu6WnhWan,10693,106247,-95554,623
2022-01-24 05:00:26-05:00,9818,4HDEN1Thxm9RbdE8pXnLP4QksVdXfp7Fa9nAnMRzr7oR,8gD3DbF6VhPTCgk3A4G7iA4f3DPH598Hj7TRJ2FebMCq,True,374555,93638,581,290,291,HfEnetJ7uBSmZWCjBNxdvv9HEC5nsW4wDV7wu6WnhWan,23273,405047,-381774,621
2022-01-24 05:00:26-05:00,9819,4pmhvxJcmebxtqN6RwVb9UbEtxpFXpuVN67Q74W6YAg3,B9fk51SEQmLbMDpQJV15f9gyCZhvEBWRXeLMnnmMqvfg,False,901,901,45,2,43,HfEnetJ7uBSmZWCjBNxdvv9HEC5nsW4wDV7wu6WnhWan,45,977,-932,499
2022-01-24 05:00:26-05:00,9820,CyWBZ1xJ9LahUnPesbXLZ4Rr5UyWAHgVFYwfrnhyrkNL,2Lpk87Xth8ZL5J9BfzmMpEE3x76FDrrrmdKiCNkSVip2,True,1332856,333213,2081,1040,1041,3zqXX6kzhkbW3d4TwD2CNjMRwxTbREXySekvq37kfCNk,83256,1091383,-1008127,624
2022-01-24 05:00:26-05:00,9821,9hB3EPuj4SrSrpAzHvExDb6mzh2vNGGVbj7qqfRjeao4,9725jRXGPRUuo1dijvv8mwzvSu1ed4y5hi9FAQNwb8dG,True,4927983,1231995,7659,3829,3830,HfEnetJ7uBSmZWCjBNxdvv9HEC5nsW4wDV7wu6WnhWan,306394,5513866,-5207472,621
2022-01-24 05:00:26-05:00,9822,D6qMab7uevXTa89ssv4BRyHwrw3FYpNimAmX2VH2uf4B,8ZauZ5dAp7kyawkPdxi4mqfempFHubJebfBenQdDektD,True,158660,39665,246,123,123,HfEnetJ7uBSmZWCjBNxdvv9HEC5nsW4wDV7wu6WnhWan,9840,184401,-174561,620
2022-01-24 05:00:26-05:00,9823,6b7Ro2myM4HcUDqyyW9NEqTWPz8BWpH4eNFSQQci37So,7r7j7rSsa6YZcTuRPfs3KP44MVqUA4Q5NeJGmx84wbHq,True,122015,30503,189,94,95,HfEnetJ7uBSmZWCjBNxdvv9HEC5nsW4wDV7wu6WnhWan,7594,141127,-133533,622
2022-01-24 05:00:26-05:00,9824,4eba4qAmwfqmihaYvTWFU9hm4VYrKvNhNywHNyimQJNK,G1DyxJcNQD8u4KGfnwxttyrJMfse1FBAsofioEMdTS9U,True,1800417,450104,2789,1394,1395,3zqXX6kzhkbW3d4TwD2CNjMRwxTbREXySekvq37kfCNk,111577,2027487,-1915910,619
2022-01-24 05:00:27-05:00,9825,DjbEch16uzdDtujFUeqxjquTTS3JXzEys8e9ogUv3aTy,6N8eKb3kfcbJEUZKZERiFiUR4hubB635D8Sotiji2TU8,True,34925824,8731456,54222,27111,27111,HfEnetJ7uBSmZWCjBNxdvv9HEC5nsW4wDV7wu6WnhWan,2168906,35315109,-33146203,621
2022-01-24 05:00:28-05:00,9826,SCtptafLHdkTiYC3e9sv853xNnusHLpoMPxTc1zUVC8,2HF9ggN6EbkYGz3Ajj7tB8m5YF3Yj77Vy96DMFSz5C7j,True,1346365,336591,2095,1047,1048,HfEnetJ7uBSmZWCjBNxdvv9HEC5nsW4wDV7wu6WnhWan,83824,1406609,-1322785,622
2022-01-24 05:01:23-05:00,9827,HoJ3Re4BmCYKMJx2RUYtoHfg8ncEy3iFqvWJDGKqfMBV,2qg4FMcurNDVRzXYKwpzEYapxFECnAyU2oGmxQCSf3hf,True,238685,59671,371,185,186,HfEnetJ7uBSmZWCjBNxdvv9HEC5nsW4wDV7wu6WnhWan,14848,278051,-263203,622
2022-01-24 05:01:23-05:00,9828,2niazdR63iWLyZ3ABWZVAnJiEjVyDyLGo4jZ6wh3j2Zz,4RvU5UtyE5CqMStPciiCTdhYCdaUUfdKSYS5nkATs1qn,True,2058470,514617,3186,1593,1593,3zqXX6kzhkbW3d4TwD2CNjMRwxTbREXySekvq37kfCNk,127460,1071637,-944177,619
2022-01-24 05:01:23-05:00,9829,GHn96Ev7UmKJWqch3H3wzXpRT7qLg5FBuSBJAATVED1f,BXBSUddfz9MThXqk4517M7YVRDGdTm4pC6G4ipT69TMV,True,1640835,410208,2550,1275,1275,HfEnetJ7uBSmZWCjBNxdvv9HEC5nsW4wDV7wu6WnhWan,102011,851281,-749270,621
2022-01-24 05:01:23-05:00,9830,6k9unyyhVTrGhAhBrFjgumRfBtKFRBrVaeWtYB56LgEg,3n9VYUH53fxmwFwdYKT9xAZYDzjodhMsJ5iGAoJTqCt4,True,2058657,514664,3202,1601,1601,3zqXX6kzhkbW3d4TwD2CNjMRwxTbREXySekvq37kfCNk,128087,1072076,-943989,622
2022-01-24 05:01:23-05:00,9831,GQviUdocJ1s4FsVDDexanvo5yQWRZgwwkGJBCg7TMtJC,HAX4VAKgQpKtm1149iRgtzvUaUkiXWcA1bJ9ERu6tXkd,True,2033325,508331,3140,1570,1570,3zqXX6kzhkbW3d4TwD2CNjMRwxTbREXySekvq37kfCNk,125607,1057386,-931779,617
2022-01-24 05:01:51-05:00,9832,CK1SjmBjrW7m1QVZbVZsVZgwEcxw8BTkckkzrZDrDdxW,M6vnBg1TPRhLu7sghkxtf5TkSLw5JhgoDmbGoyEYgR9,True,556167,139041,870,435,435,HfEnetJ7uBSmZWCjBNxdvv9HEC5nsW4wDV7wu6WnhWan,34813,598785,-563972,625
2022-01-24 05:01:51-05:00,9833,HRN438yBJSX72GV4E3JYLKpwQcnZXgAoB2VkmgXzEKDE,4jEn7ssEM8ZUjAyaKogEb3uyMmbZJ1a7WGCPNgh1Xfty,True,261116,65279,404,202,202,3zqXX6kzhkbW3d4TwD2CNjMRwxTbREXySekvq37kfCNk,16168,253399,-237231,619
2022-01-24 05:01:52-05:00,9834,6kscNwPWgKoW7MHRkB4ajxWF3DXLmXjmx9KjDnzikhfs,D49nf79UmrALDKnAa5kf94nZUffzJW7anLm4hVrFG2b4,True,8311824,2077956,12942,6471,6471,HfEnetJ7uBSmZWCjBNxdvv9HEC5nsW4wDV7wu6WnhWan,517718,8722941,-8205223,622
2022-01-24 05:01:52-05:00,9835,6VBYUiLyQXvvsDmq1vh1oJ5VeA89tGgxtkgFfofc372m,35pyoeRA4duKX7njdYny3KffM2xaxuWUZGRUMQJ5iAiu,True,33590016,8397504,52441,26220,26221,HfEnetJ7uBSmZWCjBNxdvv9HEC5nsW4wDV7wu6WnhWan,2097642,33993951,-31896309,624
2022-01-24 05:02:18-05:00,9836,CcfycMNGUqZLA6EEqtDdftSbQhTL11SYn3LxQqJ23Xgh,Ce7NW9CpB9qGYLf8XUDW49ERutoxtjZSjs54xrzF1fYN,True,471456,117864,730,365,365,3zqXX6kzhkbW3d4TwD2CNjMRwxTbREXySekvq37kfCNk,29233,509891,-480658,620
2022-01-24 05:02:18-05:00,9837,DakevNrDK5fAUGkLdrWHrsLZm8hEZBqkzUiwJouaDPPY,73nFhK7cygPgwKveXrdXcQVte8n1z3iBe4nmUVTGfFmv,True,19658606,4914651,30676,15338,15338,HfEnetJ7uBSmZWCjBNxdvv9HEC5nsW4wDV7wu6WnhWan,1227054,14935615,-13708561,624
2022-01-24 05:02:18-05:00,9838,3gdApRPkUGEqmLvTYf4WQJCnmTVmiEU2wCQG26QMpqKf,HpP2yxq3KfYByT4q4p2mLaELnPdW6kmEY9EqZaBZuUNR,True,331301,82825,516,258,258,HfEnetJ7uBSmZWCjBNxdvv9HEC5nsW4wDV7wu6WnhWan,20668,356704,-336036,623
2022-01-24 05:02:49-05:00,9839,DWMxC7PyBcue9RaoZLEEM233PyHeGqMAWqapnw8qM4N2,AVW5hLdQEQut1DqYzKXP8hBQFBx1Df697xkFSu4JR1U7,True,633590,158397,987,493,494,HfEnetJ7uBSmZWCjBNxdvv9HEC5nsW4wDV7wu6WnhWan,39492,161354,-121862,623
2022-01-24 05:02:49-05:00,9840,HUe9LgGBjMeNxGyeCtmXr2XbWVFhHXrvgc2XSqCwN11D,7Z1nR9GgezBXsDX5wW3BBarfMRMZV28rX6MeLRuWtycG,True,5054845,1263711,7825,3912,3913,3zqXX6kzhkbW3d4TwD2CNjMRwxTbREXySekvq37kfCNk,313004,5268466,-4955462,619
2022-01-24 05:02:49-05:00,9841,9cRx2sGeqENLrNkvzLSnuD161JshSav6pNg9c7pYLi8f,13ryjUoWLejTLDQKh1m69VFD31onMx8yhzCKhqbeU6s6,True,1332305,333076,2082,1041,1041,HfEnetJ7uBSmZWCjBNxdvv9HEC5nsW4wDV7wu6WnhWan,83298,1453775,-1370477,625
2022-01-24 05:02:49-05:00,9842,GqFbV89UYbQ6aEW1bSvGnnsDtTPQfHPTHzisXPhLnaTC,6X7j3nqmugRyVVw83uSzgiPaemEscc8VdsnPEKDz4fg2,True,232391,58097,361,180,181,HfEnetJ7uBSmZWCjBNxdvv9HEC5nsW4wDV7wu6WnhWan,14475,260795,-246320,622
2022-01-24 05:02:49-05:00,9843,BmLG3dPSnL9hL2okZcNVsHgzuWYCrWLdXW8z5Jd2gyvF,HXwhov5Re9b8D4XHULcVSdgBNfbtZ7KMhMRqSTcQTbno,True,744525,186131,1163,581,582,HfEnetJ7uBSmZWCjBNxdvv9HEC5nsW4wDV7wu6WnhWan,46537,839596,-793059,625
2022-01-24 05:02:49-05:00,9844,DiPSJvnnEwg1En7HJfEsKrUbBgtUf4KzGMyMCZDQSYgp,s8UVC6vPBofuXUS6RW1aQmZ8C35PrC5r4A6ugmvzLGB,True,1607,401,2,1,1,HfEnetJ7uBSmZWCjBNxdvv9HEC5nsW4wDV7wu6WnhWan,100,1461,-1361,622
2022-01-24 05:02:49-05:00,9845,2YPm4Ex9mNHX4CuNAUjkrXgoLFaZs6r1X6asYYUnvPyj,BatsG1UFq8ryYuFFcdnDyFWFPUV5P6w2VQpRup5oUey5,True,343817,85954,535,267,268,3zqXX6kzhkbW3d4TwD2CNjMRwxTbREXySekvq37kfCNk,21406,372242,-350836,622
2022-01-24 05:02:56-05:00,9846,APbpwRCB9tfma8yoi8upe633XZBtNwc5zVxXVjLwhg8s,BBwryuZZ8msiSFNmGkh13Wgg1PoSutY2Ftgz8odcxPm4,True,2627491,656872,4110,2055,2055,3zqXX6kzhkbW3d4TwD2CNjMRwxTbREXySekvq37kfCNk,164400,2742267,-2577867,625
2022-01-24 05:03:56-05:00,9847,C1CsbgQFvEvSXzuVHTr39tQHr3drDhjxeYiotd8eNocF,4rAaTCAMj5VpgNVKiYizabH7cMLhEA12seu2QXQNTyV3,True,1587038,396758,2481,1240,1241,HfEnetJ7uBSmZWCjBNxdvv9HEC5nsW4wDV7wu6WnhWan,99246,747529,-648283,625
2022-01-24 05:06:53-05:00,9848,7ayTm4uC5VbtMt9w6g9tFban4fYVwbqCzJZpiFMjmBiB,BvidnEZHHtXVhtgv4qFKThEaFZsFmyAuDVqZQwMppjSg,True,886250260,221562565,1386438,693219,693219,3zqXX6kzhkbW3d4TwD2CNjMRwxTbREXySekvq37kfCNk,55457539,623200591,-567743052,625
2022-01-24 05:07:05-05:00,9849,BZn1DDE568UHeL2Qniv9EDT1yAAWvPJcTtSw4K4GQx44,CCaroU4YwKvYgibMsRPdEBxeDbzcNC4s5ZthxrhywSm5,True,572149,143037,879,439,440,3zqXX6kzhkbW3d4TwD2CNjMRwxTbREXySekvq37kfCNk,35198,615201,-580003,615
2022-01-24 05:07:05-05:00,9850,75NA5QiXEHG4caSB9BpafGZPA9eT9S6MhKTFM6eHjz8H,FmoxAVw2zdG6qbyaXKy6gsvi1XY8ZVbSgUNbjsp9EpVd,True,586077,146519,906,453,453,3zqXX6kzhkbW3d4TwD2CNjMRwxTbREXySekvq37kfCNk,36275,606580,-570305,618
2022-01-24 05:07:06-05:00,9851,CxePQ6ZEn2NCLYgGegSeFX1PyBuczP9j5v131VQSPh1c,9gPk7qTRb5JHqBXRKp3uZfhA2VjQAJDQHTzYXGLUdAUC,True,512171,128042,798,399,399,HfEnetJ7uBSmZWCjBNxdvv9HEC5nsW4wDV7wu6WnhWan,31933,552916,-520983,623
2022-01-24 05:07:06-05:00,9852,6fqbSyhh3PPdgRcLraHb7Jahj9s1oHHeX3SsjNSsGa6t,GpRUow48TYgttdYfsygbgjYQcmHyYjWETUDjDVphEgwq,True,1260211902,315052975,1968057,984028,984029,HfEnetJ7uBSmZWCjBNxdvv9HEC5nsW4wDV7wu6WnhWan,78722293,689746184,-611023891,624
2022-01-24 05:07:06-05:00,9853,57Vsw8jXaaoLriYEkvPAVyq66r4a4zMfLWbDaTBMjFzC,7AVDWUTHa6729UkXgCXASphSmrLvXYGAA9ygTMSqvwvY,True,280793,70198,435,217,218,HfEnetJ7uBSmZWCjBNxdvv9HEC5nsW4wDV7wu6WnhWan,17429,314207,-296778,620
2022-01-24 05:07:06-05:00,9854,yWK6vFZq58uYYiHscQTPSBqTDrWEW1SVbqe8NszoTEN,6H1zT5ifGaMKjdvZmptuDYf4Vou7tntdZQPVzQ4hWyjg,True,6969303,1742325,10879,5439,5440,3zqXX6kzhkbW3d4TwD2CNjMRwxTbREXySekvq37kfCNk,435197,4538542,-4103345,624
2022-01-24 05:07:06-05:00,9855,JDg1bbHkYeznDUtSBLhagRJ45aSzeSF5V8iDRJCay9wL,8n7ic28zq5PjJtRcM7Fcy5vLW2YVXw4EWMK6UAt2zh3V,True,6404481,1601120,9984,4992,4992,HfEnetJ7uBSmZWCjBNxdvv9HEC5nsW4wDV7wu6WnhWan,399377,6908208,-6508831,623
2022-01-24 05:07:11-05:00,9856,51VhgthsxrRRr2PT5gLnDfL1A3soqwCxA1UzH9vRUGTh,4QCcd7hfsydQ63LH7Lqsp8oVXw7HuKamzQf8VMH6Lgu2,True,440500,110125,685,342,343,3zqXX6kzhkbW3d4TwD2CNjMRwxTbREXySekvq37kfCNk,27406,475195,-447789,622
2022-01-24 05:07:20-05:00,9857,Gk4mpwDEggypoPjyrZcFDbHT8WBwspC5AbQ5uDgaQufL,GTDi3mKTcw1NfwbYx8s8YCkzqbaJUM8YUwYifNr9sjgH,True,51221237,12805309,80038,40019,40019,3zqXX6kzhkbW3d4TwD2CNjMRwxTbREXySekvq37kfCNk,3201547,36214611,-33013064,625
2022-01-24 05:07:29-05:00,9858,FuoFPNTdYVDkSHaBac6UC1aNJXafSNTvFJuBCdrgQQrH,ApBS1Fx83tcECMzDV6wEzEzEdg4e2hgj3djtjRUoSKK5,True,29304986,7326245,45826,22913,22913,3zqXX6kzhkbW3d4TwD2CNjMRwxTbREXySekvq37kfCNk,1833072,21302788,-19469716,625
2022-01-24 05:07:33-05:00,9859,BJaaH1SK1pF2kZQzmYpLFfDtm52CR9a5rd39RAPtLe8q,HUsT5FVxaisdnCvG1BQxX6zffjfL2Rwx5mMo5y8SDV7e,True,383908,95976,599,299,300,3zqXX6kzhkbW3d4TwD2CNjMRwxTbREXySekvq37kfCNk,23979,262504,-238525,624
2022-01-24 05:07:37-05:00,9860,52hhBAuVyifMNFKGQmSitc8smiEgscXQMzVuZj55j7E5,6B5DBJx9NLytR3fkrYqe5W5ek4rUWsR4nPsRTvRfRwzC,True,9457939,2364484,14764,7382,7382,HfEnetJ7uBSmZWCjBNxdvv9HEC5nsW4wDV7wu6WnhWan,590585,10563219,-9972634,624
2022-01-24 05:09:28-05:00,9861,28JujYG1mbpYSjF7LNqXpup17TXb45VJHhhnFMVXtft2,DAqyVExAtmsovPGrkpkFDxm6T7pKWLztfh9iPjTNDqrd,True,2531698,632924,3897,1948,1949,HfEnetJ7uBSmZWCjBNxdvv9HEC5nsW4wDV7wu6WnhWan,155889,1339458,-1183569,615
2022-01-24 05:09:29-05:00,9862,3Xbsek5MsEGoWr3G9yhuohREr26B2vSQcjqXdspTFHta,2rPxkUiMo9wGDq8EvAiwY3ngRpKmL223cBWWNTYoBmFp,True,765548,191387,1178,589,589,3zqXX6kzhkbW3d4TwD2CNjMRwxTbREXySekvq37kfCNk,47124,522626,-475502,615
2022-01-24 05:09:30-05:00,9863,G3vArDs7nb18se4xMZ68oMHmTAsYP63x8dfY57jAogwp,EY7J8Hw8jWbryw11CYdPVUSdAoDGGNEfacqghVnJn3JK,True,5919435,1479858,9136,4568,4568,3zqXX6kzhkbW3d4TwD2CNjMRwxTbREXySekvq37kfCNk,365441,3129441,-2764000,617
2022-01-24 05:09:32-05:00,9864,98pwBGgiSDuwuas6WYW2hc9qUxfULwvNE34aixaxbxXY,BLrjKxekjThtJ9rKtQxs1Y4rZ225EE2Q16VkP9TkThyV,True,1600596,400149,2456,1228,1228,3zqXX6kzhkbW3d4TwD2CNjMRwxTbREXySekvq37kfCNk,98255,845724,-747469,613
2022-01-24 05:10:27-05:00,9865,Fs8MQLaMyr1Q96HsZivKLY7Kjdeu2ZoB2n3VTZ15KbSn,DREfCs5CTVNUUF8H3hD8CWvtxztiYxoLYh8HUWDecMyZ,True,8868471,2217117,13644,6822,6822,3zqXX6kzhkbW3d4TwD2CNjMRwxTbREXySekvq37kfCNk,545796,9923333,-9377537,615
2022-01-24 05:10:28-05:00,9866,7A1v7bFDJwxM7XomePFyRh58SMHxrNSkM3fJygd8pQUN,DL9jCFHaM8BXJ5KE1YJHXNCbXgSdRgt18MHhAgC6TNmg,True,685161,171290,1060,530,530,HfEnetJ7uBSmZWCjBNxdvv9HEC5nsW4wDV7wu6WnhWan,42430,710570,-668140,619
2022-01-24 05:10:28-05:00,9867,6kZoofhL5S3U8aQU2VW2TDRZdiBYo1e1o8AUSbSttsAy,4zUpycP3EDmXrC1qjmnHuymGVoBjXQT6yAkvKGW9Gext,True,248555053,62138763,382548,191274,191274,3zqXX6kzhkbW3d4TwD2CNjMRwxTbREXySekvq37kfCNk,15301944,66567594,-51265650,615
2022-01-24 05:10:29-05:00,9868,8xQ3tsWVUe75EG1HmocULJ3kh52utveoFMEPotTGrKno,i3SKW3ywrwYucX9ySEx1C4zaUKGnzLerP3V38437NyV,True,216255,54063,334,167,167,3zqXX6kzhkbW3d4TwD2CNjMRwxTbREXySekvq37kfCNk,13381,256723,-243342,618
2022-01-24 05:10:29-05:00,9869,9XHC2Ycm9f56cDYxRPVKYiYWGKA4y7Utpv3e9gpMsZq3,HpqAdpkzWqoJUNqmHEnn4PZwSB6C6jt8FJZQtZtFqXWA,True,2522831,630707,3882,1941,1941,3zqXX6kzhkbW3d4TwD2CNjMRwxTbREXySekvq37kfCNk,155281,2637601,-2482320,615
2022-01-24 05:10:29-05:00,9870,3EgUBHBeKWegibDcCsTGaGehnwHYvpMbcPaT1UTbwQ49,Hxd4dsnLD8uHnG7KR7GVmKXBcpN1egMUvoTccPvBcaYA,True,9384816,2346204,14477,7238,7239,3zqXX6kzhkbW3d4TwD2CNjMRwxTbREXySekvq37kfCNk,579112,10490727,-9911615,617
2022-01-24 05:10:29-05:00,9871,68qWTKE41JPQMbF7zwqoELSVn2XbjcUMA4UTfER4fcz6,HrDYnhxX1Gm72Kq9H9k44xUfxqELLkC2yoEkkR3LEEHM,True,173437038,43359259,269295,134647,134648,3zqXX6kzhkbW3d4TwD2CNjMRwxTbREXySekvq37kfCNk,10771828,111674582,-100902754,621
2022-01-24 05:10:29-05:00,9872,HfwGSiwGiyDFaTS2usYRp82zSmPPQqZukbw2d1BuFs5w,ArtgZbmA33k8Y3EfR6oMJiqT72MUrVBQqifPBdcnrzea,True,169645,42411,265,132,133,HfEnetJ7uBSmZWCjBNxdvv9HEC5nsW4wDV7wu6WnhWan,10608,116719,-106111,625
2022-01-24 05:10:32-05:00,9873,7EtGovzHsbD8cKGqq4R5rvKBbncR4Kc7CDkTjof2QBMf,8ShjeNWM2vcvUF9yYztYCHUQfcGsyg2A1LyWiPbQDDvq,True,54794,13698,84,42,42,3zqXX6kzhkbW3d4TwD2CNjMRwxTbREXySekvq37kfCNk,3398,61226,-57828,620
2022-01-24 05:10:52-05:00,9874,52pCCDDTo6uQhENab7rCsqS5ZihDDBmMSTQdCj8QLoea,GZh4ev3p6RrDRo98WfQQ7ZzzMBbqWF9gj9WbicU7YWD4,True,77263617,19315904,120652,60326,60326,HfEnetJ7uBSmZWCjBNxdvv9HEC5nsW4wDV7wu6WnhWan,4826116,27562499,-22736383,624
2022-01-24 05:11:01-05:00,9875,7dmoK7QPki7R66SPQST4veUgVfnJbVToxxBPZveECiwK,4vh4REBDm5zBDmcjRCD9zNsny1HGneu7B2co4dSJNLL6,True,2292573,573142,3574,1787,1787,HfEnetJ7uBSmZWCjBNxdvv9HEC5nsW4wDV7wu6WnhWan,142963,2235859,-2092896,623
2022-01-24 05:12:38-05:00,9876,7FB6X8YgiDn7YK9bZZmcFyzhuvVLVWPCfBbenwMXhx5,2EaDCpL9MpAKuiC2bvUCGRfvqYvgVXGFHXt35QdNakfG,True,1450186,362546,2257,1128,1129,HfEnetJ7uBSmZWCjBNxdvv9HEC5nsW4wDV7wu6WnhWan,90280,516408,-426128,622
2022-01-24 05:12:38-05:00,9877,33CE2t84MhG7SMsphhZaxvwFVRbK5wcUMUdEw8UBhoq8,DjNko7SbbK9nQT4K5oBWKiSiXiYS9Rv1k5vT3PNiMyaf,True,1445949,361487,2256,1128,1128,HfEnetJ7uBSmZWCjBNxdvv9HEC5nsW4wDV7wu6WnhWan,90257,1015777,-925520,624
2022-01-24 05:12:38-05:00,9878,8Xt3qHjZG3zLxozgM5vPHMVxp8eYFMg89kaVW7vdHKoA,2i8riSsQpfADD9LUVpiBJBfX5qjVAgmZegzfKx6RG9dW,True,54837624,13709405,85665,42832,42833,HfEnetJ7uBSmZWCjBNxdvv9HEC5nsW4wDV7wu6WnhWan,3426611,25635829,-22209218,624
2022-01-24 05:12:51-05:00,9879,3PPCwAjj8GNphb3cRs7kP1QVghEUX6gWUH3M4JarQsTD,28UR4WKAziiJmPwas5E5JrY3WaUrR2NkYYXCKuxPHTMR,True,75652639,18913159,115436,57718,57718,HfEnetJ7uBSmZWCjBNxdvv9HEC5nsW4wDV7wu6WnhWan,4617475,79125545,-74508070,610
2022-01-24 05:12:51-05:00,9880,8HWpccoTmPZ9MsrxtvQ5BV5y8a8WBAB1Sxx2WAiYKRLH,9chtr2Nqg77CCCnjC5JqENmUBNxpDHVH6BG3wojn9gHQ,True,315720,78930,486,243,243,HfEnetJ7uBSmZWCjBNxdvv9HEC5nsW4wDV7wu6WnhWan,19472,358651,-339179,616
2022-01-24 05:12:51-05:00,9881,BjCNaM7YbE9SjFi7tzi4677zg1fKXGJwtecz2GWwWuhd,6rNsSrKZezQrLb2whToNjnizpnurDXrobHqfEK3QqU1M,True,265794151,66448537,415511,207755,207756,3zqXX6kzhkbW3d4TwD2CNjMRwxTbREXySekvq37kfCNk,16620466,148633379,-132012913,625
2022-01-24 05:12:51-05:00,9882,FwTGq3BeMLyRFRa5r4E6nySLgoLNcNdqJsCQxA2i6uh6,88w6ti3WSriyu2FvNjVfrLpGyU5PUvaiJyqrAGPM8TKp,True,271654,67913,418,209,209,HfEnetJ7uBSmZWCjBNxdvv9HEC5nsW4wDV7wu6WnhWan,16758,304395,-287637,616
2022-01-24 05:12:51-05:00,9883,8d4LtUwpkNSKRUdFbxhbeeaVc8hABhwjUExt3QgEVQbz,BieULGWXC1yEtuK9y27SMo9ApNDo6jLjxs5egr1Ebsda,True,1403606,350901,2138,1069,1069,HfEnetJ7uBSmZWCjBNxdvv9HEC5nsW4wDV7wu6WnhWan,85540,1617892,-1532352,609
2022-01-24 05:12:56-05:00,9884,FS5xx53Bo65G21gJLta7LEEiS132VJM1kGpUzuqyfzoy,2kbTLjdBBA9K1coxKmwmYbjq2heSnuNg4Nh2EfVNYgwj,True,2970297,742574,4587,2293,2294,3zqXX6kzhkbW3d4TwD2CNjMRwxTbREXySekvq37kfCNk,183489,1661119,-1477630,617
2022-01-24 05:12:56-05:00,9885,C21232Uu2r4AmbR3mzrEKF5ZHoFDZbCmy88x8u6cLyZV,8sppny1HRFKX6LuqT6KDn1x9wS7z61K9V5akSuAimxgS,True,646499180,161624795,1006468,503234,503234,3zqXX6kzhkbW3d4TwD2CNjMRwxTbREXySekvq37kfCNk,40258752,184786799,-144528047,622
2022-01-24 05:12:58-05:00,9886,BJUNK2orMVx6mYsD9pnQzmsEh95ZF2NWPm9KJ1ZM67Qn,FpxLa3DwWrspYvHVsScSDcscHB2eBHGxRrQ4gVvn4VW,True,1278017692,319504423,1968906,984453,984453,3zqXX6kzhkbW3d4TwD2CNjMRwxTbREXySekvq37kfCNk,78756273,345270373,-266514100,616
2022-01-24 05:12:59-05:00,9887,4WSiQCTqMvpSYvrbenQGFoV6fuDALSWMwZZ9MgP82fwb,6Y5GdgKErVfXrabSTi89X7xCEsZnoqDqwFD4hZ3FVtfN,True,7455211,1863802,11667,5833,5834,3zqXX6kzhkbW3d4TwD2CNjMRwxTbREXySekvq37kfCNk,466688,5002894,-4536206,625
2022-01-24 05:13:58-05:00,9888,HabA6MLjygaKE6i9Sad4c6B8rnyobMYbtFext51rCmHj,516FG8YJxZmnGfvzWiV3TcwSF7UDdwWefjZkmi3R2SPX,True,44263488,11065871,69181,34590,34591,HfEnetJ7uBSmZWCjBNxdvv9HEC5nsW4wDV7wu6WnhWan,2767275,27381198,-24613923,625
2022-01-24 05:14:00-05:00,9889,243SAnGxchCVB1LQAUF4SsozR86yDwEdg2QQpbWGsMYe,5u8sNkb2oEQjUXJAB3yGStmv3Uwz16gBgExBo5myVK4b,True,654433,163608,1020,510,510,HfEnetJ7uBSmZWCjBNxdvv9HEC5nsW4wDV7wu6WnhWan,40823,388938,-348115,623
2022-01-24 05:14:02-05:00,9890,25NUDrsdLhS3fcARLiTMbbmZHvvzvzPj9xAdoN8sJBN3,8baNRGHfYRcLdhbHNuH72ofAWM9UojqhTMLnbBayzGnW,True,1963134,490783,3069,1534,1535,3zqXX6kzhkbW3d4TwD2CNjMRwxTbREXySekvq37kfCNk,122776,1188152,-1065376,625
2022-01-24 05:14:53-05:00,9891,3JrhHRs4UkkuMoCrQAaAGKZQrWoU72zWArnDGxKFESzH,8yREVE3kMYB7UAwtUDnTDK3egXTuTsN4igtJ5yeHYkCP,True,25249422,6312355,39494,19747,19747,HfEnetJ7uBSmZWCjBNxdvv9HEC5nsW4wDV7wu6WnhWan,1579763,12021097,-10441334,625
2022-01-24 05:14:54-05:00,9892,DXEJNyHSCbGZezXHy2xQaSzd37dwJs4dMTgt5VF5UZAG,7fCYM9DWrAX7vgZ11CwQMNd5NU8FB1yrbctxHaPYshpB,True,2917725,729431,4507,2253,2254,HfEnetJ7uBSmZWCjBNxdvv9HEC5nsW4wDV7wu6WnhWan,180310,1266707,-1086397,617
2022-01-24 05:15:25-05:00,9893,4oop1mjCh1Ao9NoWAUacAGc75GxiRTXr8KJ3NtzZ7btf,BfntjUunXBhnrKmocQ7pZr3wwxruRGudMyWQYC2MUhei,True,883976,220994,1381,690,691,3zqXX6kzhkbW3d4TwD2CNjMRwxTbREXySekvq37kfCNk,55272,973153,-917881,625
2022-01-24 05:15:33-05:00,9894,23FjS7S6hwPkaBsziThnqwAqy3dZvDYvNLdCKfxp7Jr4,CpGixAiKhjCWJ8tD8hWxuSUeU7mQeoZU5TVdqsAEMvLQ,True,20111832,5027958,31454,15727,15727,3zqXX6kzhkbW3d4TwD2CNjMRwxTbREXySekvq37kfCNk,1258172,32399081,-31140909,625
2022-01-24 05:15:35-05:00,9895,64Diz8zzEv1jDWnBQPTHPpXwaWf7vjM19RyJmkPy1viQ,G8wkGHRHMtT3mvXBkH3zgsKNs8wbpdiPUS17y4cozhkZ,True,145362775,36340692,226597,113298,113299,3zqXX6kzhkbW3d4TwD2CNjMRwxTbREXySekvq37kfCNk,9063901,54211829,-45147928,623
2022-01-24 05:15:39-05:00,9896,4vW2Q76fdGmfhU2Tx3R2XQkGcQUi6hSM9ixvK5RWvurJ,w8cGbqVpVr6WHSRJFXv469RMgRB3ty3TGpkVXRs7K7H,True,6162891,1540722,9631,4815,4816,HfEnetJ7uBSmZWCjBNxdvv9HEC5nsW4wDV7wu6WnhWan,385247,2395558,-2010311,625
2022-01-24 05:15:39-05:00,9897,AoPQqPjLPi8fZiLkhMGLRj6oD5k2asrvJtCkpW19DvGr,H5Sgmf1VuY13iHjPuLJ2q9wtSdkXG1AQsEv2eq6zzm8Y,True,34119334,8529833,53268,26634,26634,HfEnetJ7uBSmZWCjBNxdvv9HEC5nsW4wDV7wu6WnhWan,2130737,10193237,-8062500,624
2022-01-24 05:15:39-05:00,9898,DDsY5V3F9wnEGBoQFCEf1hvEYuKUaJdysbc7TxhNqe9G,5oBCGzvy8odB8MCxCUvPDqYCnTyteZ4Yy1JDroroygbi,True,4659380,1164845,7277,3638,3639,HfEnetJ7uBSmZWCjBNxdvv9HEC5nsW4wDV7wu6WnhWan,291094,1962302,-1671208,624
2022-01-24 05:18:12-05:00,9899,J6jBKPDR6R5cLMqLufw3zoVfheNYs1KF7C4Ft2dakXeA,6wTTLK675Ym6toJRp7tYaUZzisWfgGjSp3X3yJ31xiKt,True,4628555,1157138,7236,3618,3618,HfEnetJ7uBSmZWCjBNxdvv9HEC5nsW4wDV7wu6WnhWan,289451,2293631,-2004180,625
2022-01-24 05:18:28-05:00,9900,EBpxGcrs4eWAbBU5rEjFxbr24MjUstZQRMV9jK4q8kMp,EYVd6pztEuz8PC7rUnJ1AjVZ81WWpynyn2qEKtveqrHG,True,374581,93645,585,292,293,3zqXX6kzhkbW3d4TwD2CNjMRwxTbREXySekvq37kfCNk,23432,419508,-396076,625
2022-01-24 05:19:50-05:00,9901,A1VornXbzK5rFgsy9D4qThcPnYVP8AB9RRzWsV1h6L17,9M4dQgz1zWrtKHqZMt9w7PbM9CvmyjhY5ZZ6jjajMzqm,True,3098397,774599,4831,2415,2416,3zqXX6kzhkbW3d4TwD2CNjMRwxTbREXySekvq37kfCNk,193256,1302997,-1109741,623
2022-01-24 05:19:50-05:00,9902,B9WJfmrYEkVH3L1UWz4qqWpaexHydymbzvEfwNVtB9BV,6mQb4yzGq8jE1NbweKCKSbevnnYVhHYxyc6Gz2a5kJLn,True,21210666,5302666,32949,16474,16475,3zqXX6kzhkbW3d4TwD2CNjMRwxTbREXySekvq37kfCNk,1317975,8425734,-7107759,621
2022-01-24 05:19:50-05:00,9903,4Enpw9W2mWGnNYagYQ8WW29RLSs4R5YX4qXCsVqMFeHn,9QwbJmm9QDKXyc4ZViq74BfS35zzewEceXQNnFCgczXu,True,189910696,47477674,295407,147703,147704,3zqXX6kzhkbW3d4TwD2CNjMRwxTbREXySekvq37kfCNk,11816287,72199736,-60383449,622
2022-01-24 05:20:29-05:00,9904,A36aouot1oFLUtswuBUM4EVcis9chKaSJu53MRoPDjab,33U9gpq1RRFMGWDrWa3ezXXkwgBewdAS6QGgGVPtGvqb,True,6610340,1652585,10343,5171,5172,HfEnetJ7uBSmZWCjBNxdvv9HEC5nsW4wDV7wu6WnhWan,413723,4329285,-3915562,625
2022-01-24 05:21:49-05:00,9905,GBpe8E33cNkFmMUuP3WjhDBBuQz7MHaDkpCJjGFaFkvu,3QYFKkgzZ1PKKAxCh4hMhgqrupoCcfRVkjuJZRWVZo3H,True,2983462,745865,4595,2297,2298,HfEnetJ7uBSmZWCjBNxdvv9HEC5nsW4wDV7wu6WnhWan,183830,1840504,-1656674,616
2022-01-24 05:22:19-05:00,9906,5y8ZSWUnrm4B3emh7vLQKTh89vHtCvXqUhk7fJBA52is,Bu1AoKU2QQWpGH54ZzugvvACB3E1d3VvymnegNmTgHqg,True,5990609,1497652,9284,4642,4642,HfEnetJ7uBSmZWCjBNxdvv9HEC5nsW4wDV7wu6WnhWan,371387,6768564,-6397177,619
2022-01-24 05:22:21-05:00,9907,A4Q7Vrc9M3GtEXNUSiVBFkansyf5sKBtSeVT92WFacqv,EWLNfsTKqzkd7KAhnrPRre4Dyk6exb3H9wSbrJuyWprg,True,5448373,1362093,8409,4204,4205,HfEnetJ7uBSmZWCjBNxdvv9HEC5nsW4wDV7wu6WnhWan,336377,6172145,-5835768,617
2022-01-24 05:22:21-05:00,9908,2jDRvE3pQNjWy1NRFa4tzB3KmU5UkbUCHw8sQRFujo66,C4zNi2szDrEEh4coTF3WRUghfP4ZwAVVSYTLWfkejQRu,True,3466157,866539,5413,2706,2707,3zqXX6kzhkbW3d4TwD2CNjMRwxTbREXySekvq37kfCNk,216558,2837012,-2620454,624
2022-01-24 05:22:21-05:00,9909,ymyzGH4Qc7HH5PbKpVphCbsQgLLXyGkPcXamQJuNj5C,8oTLHaV2XzbKXNWRuUjCfHjUn61Pw93LYK14m9q2VDpZ,True,11323,2830,17,8,9,HfEnetJ7uBSmZWCjBNxdvv9HEC5nsW4wDV7wu6WnhWan,700,12150,-11450,618
2022-01-24 05:22:21-05:00,9910,HukFwJRwbT4R5P1YBDg61HphUfBHLiiawpvwf7C8VYzR,ATQqXSEQcZJL1hjfbQZ2ihUuRbxG6fJppJhv7ycWEhPd,True,427111234,106777808,653249,326624,326625,3zqXX6kzhkbW3d4TwD2CNjMRwxTbREXySekvq37kfCNk,26129992,371283126,-345153134,611
2022-01-24 05:22:21-05:00,9911,2EkjFzKuqQaT9iLsf4qHnXM6rnbj7ftEyzzRsWx6D347,9NpHNbrRJF3U8Ub4KraPHhhZpyZk9Teo836dJSktJMEV,True,1893572,473393,2925,1462,1463,3zqXX6kzhkbW3d4TwD2CNjMRwxTbREXySekvq37kfCNk,117020,1337188,-1220168,617
2022-01-24 05:22:21-05:00,9912,FYdUiU3rPpbYKWnEpekQQsocSJKjXmscohi4v6DYqix7,daPyq9YdunQJhhLoW5ifhJ7UFPTtRZhGs4JwE1nqZhN,True,215191,53797,332,166,166,3zqXX6kzhkbW3d4TwD2CNjMRwxTbREXySekvq37kfCNk,13317,248986,-235669,618
2022-01-24 05:22:21-05:00,9913,As81koHnSP9quoXuUVNHp3VR3Qaks8HLa4sFgJDocYiF,AMVm8dXia5s974VgZSbeE6uPDgyXDHZFyJ2W1J1CWvKW,True,5989045,1497261,9315,4657,4658,3zqXX6kzhkbW3d4TwD2CNjMRwxTbREXySekvq37kfCNk,372616,6771357,-6398741,622
2022-01-24 05:22:21-05:00,9914,92vHa65f4WpuqzSCMESDMPxZ2yfLxXJMMPYLof75EiN,3QZvcV1wL2ZYnw9yY9sbhiCP3dYYHeUZB7gcqtSutuLK,True,135861031,33965257,211931,105965,105966,HfEnetJ7uBSmZWCjBNxdvv9HEC5nsW4wDV7wu6WnhWan,8477266,87753190,-79275924,623
2022-01-24 05:22:21-05:00,9915,2ZSfbqxhiCTDrDPeRhoWayTZHNmW7ajVXBCxpFS4eGBF,3ZmWsPdQD7qfSMGKQSNhmBtuH7S6qMFRc8oEmBcHXEiR,True,213808,53452,331,165,166,3zqXX6kzhkbW3d4TwD2CNjMRwxTbREXySekvq37kfCNk,13242,247420,-234178,619
2022-01-24 05:22:21-05:00,9916,CJpe9bNHxS63QMaGJhmnr4u7eTo6e5GApZQZyPtXLAkk,EMVL4sDfVXwGEoGEYwLp8D6itfy3eu4FZBAj1kMz6uXa,True,5714626,1428656,8923,4461,4462,3zqXX6kzhkbW3d4TwD2CNjMRwxTbREXySekvq37kfCNk,356922,6466999,-6110077,624
2022-01-24 05:22:21-05:00,9917,3sGCWcgPY7TzRCkFR1uuY8KcUzVRbdTyFYxh7V1csNMX,CcRFNnG2uhyLwhNAbX4U49jkMeC11kJtVhhyqDWdDK5r,True,6087405,1521851,9422,4711,4711,3zqXX6kzhkbW3d4TwD2CNjMRwxTbREXySekvq37kfCNk,376893,6902506,-6525613,619
2022-01-24 05:22:22-05:00,9918,BLJgLzizx2yLgd12pVBAHTMqn9J5JA3JHCF8PnLnPyUk,HhDmwMysBFWhXnd3mrV31w75WBRKBS8wJSiEMZgqdUSp,True,841393,210348,1315,657,658,HfEnetJ7uBSmZWCjBNxdvv9HEC5nsW4wDV7wu6WnhWan,52625,994940,-942315,625
2022-01-24 05:22:22-05:00,9919,9Hz4p7gcfDbXBJp8KzhaBBPh9i7xe9kun7zLfDtqPe6c,2bJ43Lep6kp6WY7Ct56oiscKnAbdtC265G5yRvRPFThU,True,781916,195479,1206,603,603,HfEnetJ7uBSmZWCjBNxdvv9HEC5nsW4wDV7wu6WnhWan,48260,611584,-563324,617
2022-01-24 05:22:22-05:00,9920,FdYFnEYtFQKcZPmzUqnvNLzozxdR1emtkmvnYcMgYykS,7arWNJQf2cWxerjhLgQh9CJxwTat1efnr5KmhuD7Qnv4,True,166404,41601,258,129,129,3zqXX6kzhkbW3d4TwD2CNjMRwxTbREXySekvq37kfCNk,10350,192725,-182375,621
2022-01-24 05:22:36-05:00,9921,U3vvMQ4X4aKzVYfhMw1V1p58HRqaLnuXozqmmefYeD9,7JA94MArkNCFRhBq8f5a32DgMF6aPdFsoC5HvXDQ6NuR,True,258497,64624,404,202,202,3zqXX6kzhkbW3d4TwD2CNjMRwxTbREXySekvq37kfCNk,16169,331940,-315771,625
2022-01-24 05:22:36-05:00,9922,AvpYg74EBhwAXE8rcdGkpwmbBMRyVidF6zMRSFtWAVC6,4WgpqTp4r9wMpMptYMNbvCaP2faBnVr6FdShCAobetpL,True,212091,53022,331,165,166,3zqXX6kzhkbW3d4TwD2CNjMRwxTbREXySekvq37kfCNk,13265,245587,-232322,625
2022-01-24 05:22:55-05:00,9923,BrHRMouGRz3LBNzd9anfdYMhWfg8yUPHL4PqJ8WdEDFS,4uzoLa3mC2VYHAPBoHLX4gTjPTC28rPf2fvEGtJWPYc,True,27072,6768,40,20,20,HfEnetJ7uBSmZWCjBNxdvv9HEC5nsW4wDV7wu6WnhWan,1634,46662,-45028,603
2022-01-24 05:22:55-05:00,9924,EPWsutEpgpcz776maq552k8QhDKdmkSfAED5E3jgpTdY,CCwGZYDvqoHEBBtSSieAJgy5e3k4jYrpjyDffypwnWxu,True,8880261,2220065,13885,6942,6943,3zqXX6kzhkbW3d4TwD2CNjMRwxTbREXySekvq37kfCNk,555416,9942653,-9387237,625
2022-01-24 05:22:56-05:00,9925,9gY3X17t7jarkWhnSEHPR51U9nVv8Dv99NqpCi3ewuPf,4Z6TdTW1d4JFRZqZyWA9X7upKhJwVPSfTQjFp14M59uv,True,50600667,12650166,78583,39291,39292,HfEnetJ7uBSmZWCjBNxdvv9HEC5nsW4wDV7wu6WnhWan,3143348,53792920,-50649572,621
2022-01-24 05:22:56-05:00,9926,4SX2pj4eHRwFMtyDCrMZ8ZT6ASAMi7yfZWZnccw5dGn8,Ads49ZqvTmPHxfzNYm4oJb4HBYhwS6vXQbarqmpUi5VZ,True,173860,43465,267,133,134,HfEnetJ7uBSmZWCjBNxdvv9HEC5nsW4wDV7wu6WnhWan,10692,201859,-191167,614
2022-01-24 05:22:56-05:00,9927,Aop82qT6CwZbomif4QowqP3VaSHKB1837B2yNKqw4tER,65BVa4jrCx9etU5eXBAXT2PVnwVot2HLWGYyNXbVJDFk,True,2933434,733358,4436,2218,2218,HfEnetJ7uBSmZWCjBNxdvv9HEC5nsW4wDV7wu6WnhWan,177445,3325274,-3147829,604
2022-01-24 05:22:56-05:00,9928,DMgD2KCEhTGFLUZ5GnfNcwfiiwKYbyVpoWiN6knMkCAf,5KU2vgBkPTNVHsSULjgX7ZkZS56U3Dy3xqLTxL5sUZJ3,True,1170968,292742,1805,902,903,HfEnetJ7uBSmZWCjBNxdvv9HEC5nsW4wDV7wu6WnhWan,72227,1656852,-1584625,616
2022-01-24 05:22:56-05:00,9929,8ARSFh2vPjz7M1pjNqFRsRrHFGwVsUNnD7kLbqhmMrZR,9TGsutLwHv259Le8zfZ75FM4eLZffi6itgWBgYqeKkAy,True,1428749,357187,2158,1079,1079,HfEnetJ7uBSmZWCjBNxdvv9HEC5nsW4wDV7wu6WnhWan,86359,1647352,-1560993,604
2022-01-24 05:22:56-05:00,9930,B4Uc39nKzz9wBRQsCkMR4A7RwTJ8rSuwpR6EQn2AesRb,H49bGZgatRZVpj6QufZRVgYrQtH7LpdbiqKBs23151m,True,21247,5311,33,16,17,3zqXX6kzhkbW3d4TwD2CNjMRwxTbREXySekvq37kfCNk,1329,39421,-38092,625
2022-01-24 05:22:56-05:00,9931,FF8rqfM9PTEjYiVFy8jS81weDRwdaYooux2uSa2LexrJ,JBk1JghH1gged1YpDbkczFXP9ka5ivYSkaYoVbbXD4kg,True,154017,38504,235,117,118,HfEnetJ7uBSmZWCjBNxdvv9HEC5nsW4wDV7wu6WnhWan,9419,189839,-180420,611
2022-01-24 05:22:56-05:00,9932,5V5gFVMYSwGYfHFecRoHg8G22Rg4bXfVK2FSRTMhPQty,73raXd5MvixmDvJRnVjRL7yQaHZGFRiC9aBxL9ysiRvy,True,23596496,5899124,35725,17862,17863,HfEnetJ7uBSmZWCjBNxdvv9HEC5nsW4wDV7wu6WnhWan,1429018,14742618,-13313600,605
2022-01-24 05:22:56-05:00,9933,9kYkFDNE3qD6s73fn8kJowgqbDZoDSw22XaUJ7rTD43D,E8zJz8pT2c9aZsxe4kLMNs4bY7skt38SU5wK5JTqbGr6,True,3274157,818539,5032,2516,2516,HfEnetJ7uBSmZWCjBNxdvv9HEC5nsW4wDV7wu6WnhWan,201305,3802525,-3601220,614
2022-01-24 05:22:56-05:00,9934,73PpLzJmAimmqtjGpRcYHua8t6wx3gYiiXFvQxnSDMJV,CRCpLcS8LNKX22co94spJBXEes9Fnh5rYBvbVEte4JXA,True,25071313,6267828,39006,19503,19503,3zqXX6kzhkbW3d4TwD2CNjMRwxTbREXySekvq37kfCNk,1560240,26084924,-24524684,622
2022-01-24 05:22:56-05:00,9935,43wwd6zLB8yKfXEu7rtbeDFhKBuxFR66MnyhTKW3zqa3,A9t6AMvVNenwWymz3QMtdUuuGYjjTPLaA9bhRjTzNY9h,True,3328184,832046,5199,2599,2600,HfEnetJ7uBSmZWCjBNxdvv9HEC5nsW4wDV7wu6WnhWan,207972,3855136,-3647164,624
2022-01-24 05:22:56-05:00,9936,2FEbsetZMkRqLjSC8GBbgecKgX5T1T1fci2sLQux29p8,H722Fcd6DkTFRZxqQWbPDufBfXEgmFfhiEpQZWhxwYv1,True,3967,991,6,3,3,HfEnetJ7uBSmZWCjBNxdvv9HEC5nsW4wDV7wu6WnhWan,246,4320,-4074,620
2022-01-24 05:22:56-05:00,9937,7EvJoetxJVTgpJXqE1VC3fZN1CQ5xdWdv29yCiDuH9gU,6RTEusjGEHNDdMj75qkpzYHjHZ3R2XN5xvptCwkRJz5j,True,239110,59777,368,184,184,HfEnetJ7uBSmZWCjBNxdvv9HEC5nsW4wDV7wu6WnhWan,14722,277639,-262917,615
2022-01-24 05:22:56-05:00,9938,BJV5jbowrbELXfDvfMovaQy4PiRf12pLYHimW9bgzW5X,6WXrWso5FvLx7RMCFBzrbzh5qevKkk2LJAihUfWXxXzB,True,17773,4443,27,13,14,HfEnetJ7uBSmZWCjBNxdvv9HEC5nsW4wDV7wu6WnhWan,1100,30822,-29722,618
2022-01-24 05:22:56-05:00,9939,6Z6y2QLJUZ5s6zdjanJcKprTAotx8tqr9DRNqqycMeS4,JCYwt8MHVaBb14GB2qAvDWwYVMaL7VTxyNEt7Eo5Zy8x,True,174954,43738,270,135,135,3zqXX6kzhkbW3d4TwD2CNjMRwxTbREXySekvq37kfCNk,10811,202650,-191839,617
2022-01-24 05:22:56-05:00,9940,9BMHbUs4d3qX49fnroHv2FTPDs4yoDFrvDMqf8p9U4pE,2yL7zwMr7qVG5Sdwkf7z6ppnNqt1ASppBbmxwYjfFY6Z,True,3315892,828973,5117,2558,2559,HfEnetJ7uBSmZWCjBNxdvv9HEC5nsW4wDV7wu6WnhWan,204708,3850816,-3646108,617
2022-01-24 05:22:56-05:00,9941,FV9CBGGTbppLnBKh79f2LzD1diTiS5g6u89FcpZHZmnK,Fe7mtmCUziFqbbYTvrhAcAq1Ub7YLfTJRtQ1hG7GzJD1,True,4469,1117,6,3,3,HfEnetJ7uBSmZWCjBNxdvv9HEC5nsW4wDV7wu6WnhWan,275,4855,-4580,615
2022-01-24 05:22:56-05:00,9942,EBnMKbaJEjNXjt14hxssR8wd3Ua37McPQxUZnKxxbgtd,FAALK2LRFhg98ezHEBFrgrzxTg66eZpmo7ctKDEck8q5,True,375373,93843,582,291,291,3zqXX6kzhkbW3d4TwD2CNjMRwxTbREXySekvq37kfCNk,23287,398691,-375404,620
2022-01-24 05:22:56-05:00,9943,3NhNdphQiKwgHTmTJc4qVhp3aWjqnwMTYbRW1y9CZrZg,BNpP1sKPAr7Dk1ymSrupge9KGMVpk4LfjTjawgi9YaC5,True,1250844,312711,1937,968,969,3zqXX6kzhkbW3d4TwD2CNjMRwxTbREXySekvq37kfCNk,77497,1416821,-1339324,619
2022-01-24 05:22:56-05:00,9944,9rgrRAMcGSarfz8xXckw1LjkemMwwjzJLApPjpfY2XZ3,BRtNdDDtCiNDYDERZTBCefUiYvjShucRX1hxEBLyeggT,True,168601,42150,263,131,132,HfEnetJ7uBSmZWCjBNxdvv9HEC5nsW4wDV7wu6WnhWan,10524,195418,-184894,624
2022-01-24 05:22:58-05:00,9945,HGJoZvLakWfSDFwuvShNBc4kCf7nP7VqzyM3mELpbFEf,12Qn5jin7QvsBngXqYAv4UstyG3b6nRf1jsLp9Dp8G7k,True,13316,3329,20,10,10,HfEnetJ7uBSmZWCjBNxdvv9HEC5nsW4wDV7wu6WnhWan,824,15766,-14942,618
2022-01-24 05:22:58-05:00,9946,3tQBuHwr3V8AZu8Yqhg1UfmnFoxzkUq9UeGeLm41UHy4,9cESwduiHBgrxZK1hN1eAFwnyfxw3FEHezTa8Ue5Kpye,True,17168673,4292168,26479,13239,13240,3zqXX6kzhkbW3d4TwD2CNjMRwxTbREXySekvq37kfCNk,1059170,13444120,-12384950,616
2022-01-24 05:22:59-05:00,9947,95urWGJ4HN1bTarbDi8Dpj4K4ms7dovs8gwaYdaSLC6e,2THhqxjhXjp2Zui9ML2MzAbGN4dsfa3dkdqzC8LYhnbQ,True,312590,78147,488,244,244,HfEnetJ7uBSmZWCjBNxdvv9HEC5nsW4wDV7wu6WnhWan,19535,351119,-331584,624
2022-01-24 05:23:42-05:00,9948,8xvLGVeDmhVYQhN2ZpWkVG9jCrukRsNQ4926a4TMiZqa,9ciBySSjvADwp47WkETiFWZKVTFL8Hf1XvK7aSxhcgQS,True,454810,113702,695,347,348,HfEnetJ7uBSmZWCjBNxdvv9HEC5nsW4wDV7wu6WnhWan,27815,351548,-323733,611
2022-01-24 05:23:42-05:00,9949,AWvHDdb2ikqV8wc7qQ8azbvNTZdixMNxhQjhQdhayYtR,9EpgEPBb1nog6aQeFdMXfSRiLSnzGQFQ39mbLdCxgYTv,True,844368,211092,1278,639,639,HfEnetJ7uBSmZWCjBNxdvv9HEC5nsW4wDV7wu6WnhWan,51126,535655,-484529,605
2022-01-24 05:23:42-05:00,9950,78EeyPYzQjrmW6z9VGhRci6ihMUZb5rtpXo3GAxugf55,9AgZ45TMxaqwWGVWSgnEkvio3s6fXtHjAVRVCA7Zgsd2,True,1013806,253451,1575,787,788,HfEnetJ7uBSmZWCjBNxdvv9HEC5nsW4wDV7wu6WnhWan,63035,655503,-592468,621
2022-01-24 05:23:42-05:00,9951,HpDwBPWZHfLzJUvTTABTA6qddyLLJiVTfqBx5gUktSUb,BqXLpaAeTNfNSeevfdazNqTgqEXj6Edgp8txWvCoxEz6,True,15938459,3984614,24505,12252,12253,HfEnetJ7uBSmZWCjBNxdvv9HEC5nsW4wDV7wu6WnhWan,980223,14405896,-13425673,615
2022-01-24 05:23:42-05:00,9952,CbhrZUdan1axNDFUrX1ZuEohfNMEGrszKSkk6pppVQuw,DHEAjJNtuEePezYAv77thWabbVxxqQpfuiC6moRSrpG1,True,1689192,422298,2634,1317,1317,HfEnetJ7uBSmZWCjBNxdvv9HEC5nsW4wDV7wu6WnhWan,105387,1623199,-1517812,623
2022-01-24 05:23:42-05:00,9953,3ogBPSRcKfmwzgumVDHBkXLi1eCsEFG2xzSJgD4LQDNy,7TXyqWgJqfe71MSWFA2n7ufZbUdzf7JJoWej8FNNtMXo,True,384535,96133,601,300,301,HfEnetJ7uBSmZWCjBNxdvv9HEC5nsW4wDV7wu6WnhWan,24064,280740,-256676,625
2022-01-24 05:23:42-05:00,9954,95yx3SCWcW9Cp8oSEDV68kGXRKWGyNdYUtNb5UnWMGBD,7PncaFWqW2iKR6EUKf78EW6LLZr7ZWU5b2d2rP22fsU3,True,4987379,1246844,7764,3882,3882,HfEnetJ7uBSmZWCjBNxdvv9HEC5nsW4wDV7wu6WnhWan,310598,3760735,-3450137,622
2022-01-24 05:23:42-05:00,9955,5eMLdQ4gYA5iqvTXSNdGvctHp7s5VpyFuwtJKqx6chBc,Ckxc5K39nkBNXBTmFTM8J48R7wGqNm3vHKZu4G5baumZ,True,5981297,1495324,9246,4623,4623,3zqXX6kzhkbW3d4TwD2CNjMRwxTbREXySekvq37kfCNk,369849,4067751,-3697902,618
2022-01-24 05:23:42-05:00,9956,7hTjPRQSYAoWHhtpsVz2oKK5SAuFJd8dPHShKgKJq8dy,6DcHcrtcXR88d8e2KahhAiWTeRznNfF8oXLHmh5wE7wz,True,17443240,4360810,27185,13592,13593,HfEnetJ7uBSmZWCjBNxdvv9HEC5nsW4wDV7wu6WnhWan,1087424,12693125,-11605701,623
2022-01-24 05:23:42-05:00,9957,Bsr6kx1B6BSEd5UnJ7Z61M49iUb3bFrDVhiEtMVtPDF2,3CFd1pUJAJPA9fobwn4Jj2mRju1CWmoop4Mh4znypNWT,True,534388,133597,834,417,417,HfEnetJ7uBSmZWCjBNxdvv9HEC5nsW4wDV7wu6WnhWan,33378,383248,-349870,624
2022-01-24 05:23:42-05:00,9958,zLTuMVfVswjMkhyvjaXnvjcKXv5xNk3iSWSjRGpVqXf,J3D8NHUJCiSjvFYfJ5Es4YDhF1KcPZWRUmCQ5L92t8eB,True,7796896,1949224,11916,5958,5958,HfEnetJ7uBSmZWCjBNxdvv9HEC5nsW4wDV7wu6WnhWan,476657,2702771,-2226114,611
2022-01-24 05:23:42-05:00,9959,GYgxUfZ19oSyHuovGRA6gBJT32goSxCrKR8hQQdBsrRG,2r8c6SU74hRq7xEmYBJ92WoSB6v6XCAXR3JcDznfCxkN,True,529369060,132342265,811246,405623,405623,HfEnetJ7uBSmZWCjBNxdvv9HEC5nsW4wDV7wu6WnhWan,32449879,403022153,-370572274,612
2022-01-24 05:23:42-05:00,9960,9UKMqQgFYdJb5vXVqPhA8CAMRY1eifgWivANiKQqj3yb,DpE3uNQUZbyYnqjpfHWqp9CHqPBs2uTQLRM6AtzF6Por,True,6057942,1514485,9414,4707,4707,HfEnetJ7uBSmZWCjBNxdvv9HEC5nsW4wDV7wu6WnhWan,376577,2534749,-2158172,621
2022-01-24 05:23:42-05:00,9961,6VJcr3VAEcEZaHEpt48QL8QxHKABufVp8n2JSEVTLh9U,8naR6kiySKj3vai9dCetdgCnCHgf2oyLjGqKTJ3Lz64Y,True,59252872,14813218,90910,45455,45455,3zqXX6kzhkbW3d4TwD2CNjMRwxTbREXySekvq37kfCNk,3636422,46952723,-43316301,613
2022-01-24 05:23:42-05:00,9962,JDeYjCLpfnzcfxDFgHf4aBcHsajwdR14GUaKAA9euzVf,EJbvKoyMZcoCx4vWa61uMbW2vr6mUhrgEuECdteVBuZZ,True,142085,35521,221,110,111,3zqXX6kzhkbW3d4TwD2CNjMRwxTbREXySekvq37kfCNk,8840,140476,-131636,622
2022-01-24 05:23:44-05:00,9963,CYkojG4q1SnizNs59qsYTEBU1c11XC8nteMhxRbwhCBq,A9MsPy3aeMzdQUWXK6qmWLiZfKREiBrSVaJAKp2nEcSt,True,410261,102565,634,317,317,3zqXX6kzhkbW3d4TwD2CNjMRwxTbREXySekvq37kfCNk,25376,297347,-271971,618
2022-01-24 05:23:46-05:00,9964,G5NLYTLxDZfJFKsJdMeWS8Ez95ZFwR5AX4hKhnfVJvoE,AwrC3pKhTeEDr1HCTWoKWjadteZccvqcisbC7vxTjn7w,True,9772743,2443185,15208,7604,7604,3zqXX6kzhkbW3d4TwD2CNjMRwxTbREXySekvq37kfCNk,608333,9350381,-8742048,622
2022-01-24 05:23:47-05:00,9965,5gcF5a6vf5iHAnhKHhcfceXicrefXZ9L7PzqjjrzRm48,5VE1AGgChUAW2iR4iKiznUCqtu87q8R2cdWeSuFYXjYo,True,35214376,8803594,54864,27432,27432,HfEnetJ7uBSmZWCjBNxdvv9HEC5nsW4wDV7wu6WnhWan,2194562,14331983,-12137421,623
2022-01-24 05:23:48-05:00,9966,2JXP6KUwPSmCrXT2uQRqSoCwH8RLYWwmqYsj3zXtv9xF,4qcFVgugXsHVQzFRP2he9CVzvv47xqgokJjigee8oPpP,True,156721894,39180473,237969,118984,118985,3zqXX6kzhkbW3d4TwD2CNjMRwxTbREXySekvq37kfCNk,9518765,58910537,-49391772,607
2022-01-24 05:23:49-05:00,9967,2mfcg17QocKKvDcqDH88TwxHRiS8dAQiJAGoAh1brns9,8aQLELBgaA9eXsxSciMjxWv8B1hpbUPfLwqVjEnasZbe,True,10339656,2584914,16174,8087,8087,HfEnetJ7uBSmZWCjBNxdvv9HEC5nsW4wDV7wu6WnhWan,646972,4560576,-3913604,625
2022-01-24 05:23:49-05:00,9968,8trFFwvXKKMwMx952ugCZmqyw29e1HxEKBuQmFn8ZwTf,FsD7gCvHXM3QchQiDcd292ksy5afZMWApneNTat5ndeS,True,18868656,4717164,29149,14574,14575,HfEnetJ7uBSmZWCjBNxdvv9HEC5nsW4wDV7wu6WnhWan,1165996,7507291,-6341295,617
2022-01-24 05:23:49-05:00,9969,D58t4uTjFumsUeYFaKnpV8BRTEQEqKXBreFTdwGrott7,67p6kHDfVqQijfcwugvZK59c3aRRH9x3eHxruqH8WEqF,True,2802355,700587,4363,2181,2182,3zqXX6kzhkbW3d4TwD2CNjMRwxTbREXySekvq37kfCNk,174557,1535075,-1360518,622
2022-01-24 05:23:50-05:00,9970,GNkEoVMpNAgfyDBZ986MR9BEVc485xpLuZWwSCyZk5zJ,AT2eiaMyZNHZGqgTdie8QjLWCTrWSdkRmQxU2vZNgtDs,True,3718838,929709,5818,2909,2909,3zqXX6kzhkbW3d4TwD2CNjMRwxTbREXySekvq37kfCNk,232726,1390962,-1158236,625
2022-01-24 05:23:52-05:00,9971,2pMGfXreJV4ZGoQtRyvhdE8TFccLhkguLb7JsjGnyr7p,7FVhyNsmwmSKF8H73YfLmx6ASLw9G13r3LXDnRqKjWKL,True,6788966,1697241,10609,5304,5305,HfEnetJ7uBSmZWCjBNxdvv9HEC5nsW4wDV7wu6WnhWan,424362,7697053,-7272691,625
2022-01-24 05:23:59-05:00,9972,D64rDiWT3YG28fCgXCmbNjYa2JakZbpKQ1D2XuLChUfV,8WmMWq8cTsGQym5pUbHm9dPCpJugBeWUMVERYFGLxWHj,True,651176,162794,1018,509,509,3zqXX6kzhkbW3d4TwD2CNjMRwxTbREXySekvq37kfCNk,40737,446550,-405813,625
2022-01-24 05:24:21-05:00,9973,46TNhGwBVzedW8xSb9UY94HNeSom9iGiZzAjrKHiRM2G,7JVTiqNYeKHbyzRkKtvSEpqLPKykZso8cGUr3sX1j7QF,True,1400420,350104,2186,1093,1093,HfEnetJ7uBSmZWCjBNxdvv9HEC5nsW4wDV7wu6WnhWan,87444,1004168,-916724,624
2022-01-24 05:29:54-05:00,9974,C1tcxAjMzZaFVcF2ke2nSyiCjcLBwsz5yKXShy5MB14h,GYkrJj2zHVZuzPC45MbuevYkRJHdeL4Sqj9SWqZfUdiE,True,11172769,2793192,17475,8737,8738,3zqXX6kzhkbW3d4TwD2CNjMRwxTbREXySekvq37kfCNk,699014,12462969,-11763955,625
2022-01-24 05:29:55-05:00,9975,E8iuHK2DErFnMAYfWmNoix4jVb4WDG8Sc41hBycLUxbd,77Zoru23JmnK5EJ8eURonQoEpJcLP4edabjD8MR8NKdX,True,3311721,827930,5182,2591,2591,HfEnetJ7uBSmZWCjBNxdvv9HEC5nsW4wDV7wu6WnhWan,207287,3839687,-3632400,625
2022-01-24 05:36:04-05:00,9976,Fani89KviVFZek4si6YZ3apVuM2kSqVUijDnLBqtvJEH,EpC29dECx1cLC69bj2ncG3jFp7obPaxbH7F6mju27cwL,True,399666,99916,611,305,306,HfEnetJ7uBSmZWCjBNxdvv9HEC5nsW4wDV7wu6WnhWan,24455,178356,-153901,611
2022-01-24 05:36:04-05:00,9977,ATS5VRAN1aPKBiATDcUs5yd6yVuTmWqrqqRFNdfz6DZT,7VKq4rZLEtY2dhDFZMTQMvCYyJa1ASM9RHobUaYhHWAe,True,6023597,1505899,9203,4601,4602,3zqXX6kzhkbW3d4TwD2CNjMRwxTbREXySekvq37kfCNk,368157,3884879,-3516722,611
2022-01-24 05:36:04-05:00,9978,6mCEvqP1YwHZNUT9orECs4tE3YzfD2Hfa5FTt9TLo8DH,ApWyeUDzPp6TBczuStvXxEAivhVVJrqC1rodNTNKNFR3,True,5866099,1466524,9160,4580,4580,3zqXX6kzhkbW3d4TwD2CNjMRwxTbREXySekvq37kfCNk,366404,3306084,-2939680,624
2022-01-24 05:36:08-05:00,9979,7CSCMFa9W52tBDVUbXbc3woAy3GByeA1wPJdp3MgznPa,3447ptuVFu6G8B6N63RmS8mRv4n9PfHneypHLvbeaGLn,True,566985,141745,887,443,444,HfEnetJ7uBSmZWCjBNxdvv9HEC5nsW4wDV7wu6WnhWan,35492,555576,-520084,625
2022-01-24 05:36:11-05:00,9980,3MEiFqy4F9nBW8gHxvGjv7norSBHwxhbzzNKngPk1RHq,2tcsJ4NUJegcEfHNwWPh979yKjKmq568CpNm5iWGbuoR,False,440963,440963,21971,1098,20873,3zqXX6kzhkbW3d4TwD2CNjMRwxTbREXySekvq37kfCNk,21971,317501,-295530,498
2022-01-24 05:36:12-05:00,9981,6kqKSyVVF4xxUbsvBCkY1kt4XcKzb98eSaqNw5fxSLtw,4T9DKFUmkcPG7mM3CKzW3m81LqqpU7oFTv35Pha4zHNe,True,30168944,7542236,47150,23575,23575,HfEnetJ7uBSmZWCjBNxdvv9HEC5nsW4wDV7wu6WnhWan,1886031,22323755,-20437724,625
2022-01-24 05:36:12-05:00,9982,6NJFN855M3Q3RLTDNo57gTgAmwPD6G2E3WvMb1m5eNCN,3YpqNnonsvXaRT4nCC3G5FZx1jjVtbDPc36LiR6WK5jR,True,1382257,345564,2145,1072,1073,HfEnetJ7uBSmZWCjBNxdvv9HEC5nsW4wDV7wu6WnhWan,85805,1353705,-1267900,620
2022-01-24 05:36:12-05:00,9983,F1G1Yb2jhT1hULYuNM9QMuNNA6vHZ2Wg4LhFGWsJmr78,2oF52s77UVwjbZMLmxyNsGRZ36RHqSJiV5VL7FzoWgyB,True,47235578,11808894,73324,36662,36662,HfEnetJ7uBSmZWCjBNxdvv9HEC5nsW4wDV7wu6WnhWan,2932967,23935931,-21002964,620
2022-01-24 05:36:13-05:00,9984,HHHj6EinpgAJeZkDXfsvCo3UXnmAdiAZNvPSUfVPc5Sg,3gx9c31MDtJtByxkUuWcqf1oARnZTjpx3QtxsM1Xb6Gp,True,13656438,3414109,21092,10546,10546,3zqXX6kzhkbW3d4TwD2CNjMRwxTbREXySekvq37kfCNk,843684,9250892,-8407208,617
2022-01-24 05:36:31-05:00,9985,DWTaeNeq5x83cBvKUz2jZfXDz5z4F5wbSZLNv7smnjvd,9pQGArZnJV4Fu8tBVEfknmmfmrRv5RKV2u58BJBuhzpF,True,1698931,424732,2655,1327,1328,HfEnetJ7uBSmZWCjBNxdvv9HEC5nsW4wDV7wu6WnhWan,106229,1222995,-1116766,625
2022-01-24 05:36:55-05:00,9986,GufVttJatW8NLeztT1NRQSLZpQNRk45kaG41p3QcWhx7,GTJUsWoWRyeafYJVhx2aRo8NE94U5UrBjaehmJ4PRUhn,True,509166,127291,789,394,395,HfEnetJ7uBSmZWCjBNxdvv9HEC5nsW4wDV7wu6WnhWan,31565,324038,-292473,619
2022-01-24 05:36:55-05:00,9987,Frobc1KZTVcsyfwyKwSpHJobxmiJBomzHhGCLdrzdAz8,HziyKP9uxWCuXddtbRzWMczHNdgyQB5UXQZj4MnMm14,True,1364747,341186,2123,1061,1062,3zqXX6kzhkbW3d4TwD2CNjMRwxTbREXySekvq37kfCNk,84959,872077,-787118,622
2022-01-24 05:36:56-05:00,9988,8swGZMrPrLAxZd7MxTbkCL13k3DmAJUw41jCp6Xo6awW,3fKnX7yTNXAT4uMmXVdTy47ALJT8h8YSD3WiBb4BGuzH,True,4218484,1054621,6559,3279,3280,HfEnetJ7uBSmZWCjBNxdvv9HEC5nsW4wDV7wu6WnhWan,262374,3409528,-3147154,621
2022-01-24 05:36:56-05:00,9989,6pUtYz474QrpATEZnfb3iFbTKYA65pNyKAo4TQZAjtqe,8dipRUXvxJiDLdHEtCPkso4vErbVwshHQiRfvSngBS9J,True,6424748377,1606187093,9933228,4966614,4966614,HfEnetJ7uBSmZWCjBNxdvv9HEC5nsW4wDV7wu6WnhWan,397329140,2681497148,-2284168008,618
2022-01-24 05:36:57-05:00,9990,8GdYhwX26GRmVfGFCbJ3MJrH1UdneN2FNRUexhLsqprN,DpUTHSVucDPyCWoLCdpm8EFRZFiKL88tmnSiWG2TRpS8,True,191441,47860,299,149,150,HfEnetJ7uBSmZWCjBNxdvv9HEC5nsW4wDV7wu6WnhWan,11963,220930,-208967,624
2022-01-24 05:36:57-05:00,9991,4KMzwWHPeW51cxu4nMpbqCaqo96dMqaHWyRCGQktfQfd,F7q4GNYcbnZa8dJ4qovQwjmxpKpdEmdxQMXRPb9nQupa,True,17399956,4349989,26751,13375,13376,HfEnetJ7uBSmZWCjBNxdvv9HEC5nsW4wDV7wu6WnhWan,1070043,6588128,-5518085,614
2022-01-24 05:36:57-05:00,9992,2aK454FrEuA6JQZo2hLUabd4E6wyQtVuJWw2rWz2pGVy,3dJvhEh7kykf8hCCWQRarh2s5ybJUAzbaPdDUmX4XokW,True,75984464,18996116,116858,58429,58429,HfEnetJ7uBSmZWCjBNxdvv9HEC5nsW4wDV7wu6WnhWan,4674342,22110780,-17436438,615
2022-01-24 05:36:57-05:00,9993,GcjcaWoMUcGkLaJBx3svxtzwGNn5SLcFrwaLqnpadUZY,Ep9sDjTMMasVjKdshsE88uk3mWYkKuMTVRooVJWvCq9F,True,3245152,811288,5045,2522,2523,3zqXX6kzhkbW3d4TwD2CNjMRwxTbREXySekvq37kfCNk,201816,3761281,-3559465,621
2022-01-24 05:36:57-05:00,9994,HZSJVNb6g4o52N7pAJCLkGjur8evF5Ex1sAx7uUxUDdm,8LQHKhXStrwcd6f4AxaTVcrGdYpGjQz8vWf5JXsAzcsp,True,245403,61350,381,190,191,3zqXX6kzhkbW3d4TwD2CNjMRwxTbREXySekvq37kfCNk,15253,284832,-269579,621
2022-01-24 05:36:57-05:00,9995,9Ft21UZ66egkMCtZprBPc72WF1aj2fQwLs6XJWPXUbUV,6DGSgHegc23W5MQ6hqSsSSdwNvRqU3piR9GBoZ6fU23f,True,50612641,12653160,77743,38871,38872,HfEnetJ7uBSmZWCjBNxdvv9HEC5nsW4wDV7wu6WnhWan,3109757,22979047,-19869290,614
2022-01-24 05:36:58-05:00,9996,9T6bCVf7AshQP1NNbsF3eCdbChKbcfrFUPFWUXRijY5M,4ZFq3kdwaUhiotXCXzDFjVCAP3udzGsx5CicgLLXd4PR,True,119842655,29960663,186377,93188,93189,3zqXX6kzhkbW3d4TwD2CNjMRwxTbREXySekvq37kfCNk,7455098,78383918,-70928820,622
2022-01-24 05:36:58-05:00,9997,28YQqynu5oRud5xEcsDvAaGhJhgpiVJSTNeMwkrbpbyv,9zYqRWiRatbohCdBfV3PrAxp8v1kwgbvV9ta4RJRRp68,True,8695541,2173885,13506,6753,6753,HfEnetJ7uBSmZWCjBNxdvv9HEC5nsW4wDV7wu6WnhWan,540249,9742762,-9202513,621
2022-01-24 05:36:58-05:00,9998,4eaXYcx5ayhTq9TmmQFgLDjy6p3z93txUN97v8PTSh1J,J3vgUnjDUy5ngrmrs6FwpZTexxJNxXM1UjsHvsgw9g9y,True,213470,53367,332,166,166,HfEnetJ7uBSmZWCjBNxdvv9HEC5nsW4wDV7wu6WnhWan,13281,247277,-233996,622
2022-01-24 05:36:58-05:00,9999,Hqzz5RdbkkmMPCVdxF3Q3sLuh7XVJHEwAP6zpz7pCwTj,TNwXSETgrJGM9S5zbBY3mMWKbPFskbKjPAhBrWFNfuK,True,190788,47697,296,148,148,3zqXX6kzhkbW3d4TwD2CNjMRwxTbREXySekvq37kfCNk,11841,220429,-208588,620
2022-01-24 05:36:58-05:00,10000,9wsQcvpqPp8c9q42RntWDNbqNCnmJeW4GMG2AtKAHkBu,EMqRbzGvXTU1LtmoSw9uSrpTX2L4tpJQAMJJJ4duvzf5,True,30293904,7573476,47261,23630,23631,HfEnetJ7uBSmZWCjBNxdvv9HEC5nsW4wDV7wu6WnhWan,1890442,19842310,-17951868,624
2022-01-24 05:36:58-05:00,10001,5iRLEmB6qBHqkJBPyyubnd9f1TpRr4EY8BTxuHUREeLB,GkY73KL6HJ4ycdggFtYWALBgmTRZVCx66P2ZJ7E8ENwC,True,182088,45522,280,140,140,HfEnetJ7uBSmZWCjBNxdvv9HEC5nsW4wDV7wu6WnhWan,11220,211242,-200022,616
2022-01-24 05:36:58-05:00,10002,BMawc4jLJMER4ryGcwdm27H3MU8JQCiSfwb9onVfYDpr,5ciaGDuaB3rBKvV7MphT2eMkCUxBzWZc7zYXQM7vbQ46,True,1253910,313477,1929,964,965,HfEnetJ7uBSmZWCjBNxdvv9HEC5nsW4wDV7wu6WnhWan,77173,1413431,-1336258,615
2022-01-24 05:36:58-05:00,10003,BYvjENe16Ta77PqGV7JKEWrsqCTfkMGYwTSG5gXneDvd,EvxAXgvhPC6QkNurbK7vWyTApGo8J2R4EgMAknkHVU3d,True,2536,634,3,1,2,HfEnetJ7uBSmZWCjBNxdvv9HEC5nsW4wDV7wu6WnhWan,156,3654,-3498,615
2022-01-24 05:36:58-05:00,10004,446VESPwhh16pG3VcpgraT83MoqWy87qgU36mKZC8BsW,SmUPkPpnnRfSH3tcKUnbpK6HHNJtLfvMiUWk9eUwkNy,True,8814878,2203719,13570,6785,6785,HfEnetJ7uBSmZWCjBNxdvv9HEC5nsW4wDV7wu6WnhWan,542826,9885029,-9342203,615
2022-01-24 05:36:58-05:00,10005,8xjstKJD2RopRxxRP8JbMYRmpBKgSZivMFRXXRZ5syPh,HUfevkvBsm5SDpxnZ4NBD8Re7LvqBQLrx5UWXCeYTBgK,True,315956,78989,489,244,245,HfEnetJ7uBSmZWCjBNxdvv9HEC5nsW4wDV7wu6WnhWan,19569,355226,-335657,619
2022-01-24 05:36:58-05:00,10006,Bt37YbHvD2M8zcGmanksKy8MCi4Qzto7hEnGRJyNvWyg,4WGRnDhpoY4zJi74iJyALasETpJNJMCJtf9aWJUVrHQv,True,272272074,68068018,419805,209902,209903,3zqXX6kzhkbW3d4TwD2CNjMRwxTbREXySekvq37kfCNk,16792233,178092104,-161299871,616
2022-01-24 05:36:58-05:00,10007,GwYr2DmtMVLWxVz6kVSXR6rvxL4x3DXtvNC7taswSWHN,2otMHa7JT1twPSSN6XF9fqGkKrEK8nnuMFZG1TtAgFQk,True,1455,363,2,1,1,3zqXX6kzhkbW3d4TwD2CNjMRwxTbREXySekvq37kfCNk,90,1660,-1570,618
2022-01-24 05:36:58-05:00,10008,43EtYHdVkdBxHTtFR3QWVgvCKj1SqsAf7xLY2yphsv1x,8WJbP4mVJWYuN1dVzHpRg7YR2nBELB4Krkq8Zch8sp4g,True,260873,65218,401,200,201,3zqXX6kzhkbW3d4TwD2CNjMRwxTbREXySekvq37kfCNk,16062,282332,-266270,615
2022-01-24 05:36:58-05:00,10009,96StvqZyFUPtyMr4o9s7K4V29RSNyRpVi76vNwxG5rUf,GZKXFSFq4aGiTaqovtxqNCCVGkAFNXPh4Hep1ZMwdZ8g,True,18936,4734,29,14,15,3zqXX6kzhkbW3d4TwD2CNjMRwxTbREXySekvq37kfCNk,1171,34273,-33102,618
2022-01-24 05:36:58-05:00,10010,6sK2PQyTvStxT9qigrFaPmf9GSe4X4wLb4ig7izrzwaB,6iyTuXdnBiLrKPCat7ajRnUq2245L9bbJrHAvsnyFx8e,True,1455,363,2,1,1,3zqXX6kzhkbW3d4TwD2CNjMRwxTbREXySekvq37kfCNk,90,1661,-1571,618
2022-01-24 05:36:58-05:00,10011,GqPZDwm3EWGMiVy7BY6qHM4Vzt2B9vW3Zs1CLScrtjAD,63h2HEdkmc54a8txd4LZ69TUBLR6VphxBoXLx6hjCLg4,True,555458356,138864589,864805,432402,432403,HfEnetJ7uBSmZWCjBNxdvv9HEC5nsW4wDV7wu6WnhWan,34592211,154649196,-120056985,622
2022-01-24 05:36:58-05:00,10012,DD1a8rMoUCwmEiLKRN43VpdqL8Qgfr5yi92ejQxDVRMo,3vMJVNAuyRhM9jkaEZARhwbR6MerR5UmcgoZ9c5bs1VS,True,3902889,975722,6022,3011,3011,3zqXX6kzhkbW3d4TwD2CNjMRwxTbREXySekvq37kfCNk,240897,4528550,-4287653,617
2022-01-24 05:36:58-05:00,10013,4nhdidD6SASYzwZ7mUnWKyP4xyWXhdBe2gp5F4qDtLrL,HLk6YPhVidsn3i8HfoASvoim1ztxb4bi8JnioiyvorpV,True,1198121,299530,1844,922,922,HfEnetJ7uBSmZWCjBNxdvv9HEC5nsW4wDV7wu6WnhWan,73779,1353209,-1279430,615
2022-01-24 05:37:02-05:00,10014,HpRYrL8HzCPaBJTLFgZmYg2aXBnBQUpf1mikVkzkY56z,8DzHRd8qWcEjnX6cefwYtgRGpQJUaw9QPjyfAsN7j33r,True,2176175,544043,3373,1686,1687,3zqXX6kzhkbW3d4TwD2CNjMRwxTbREXySekvq37kfCNk,134925,2463389,-2328464,620
2022-01-24 05:37:02-05:00,10015,Fw2e6jxKVeFcJSe9MyVhSz3dUdJQLs3XULHrT1mtMU9U,591U5bexgLRJXygtK5fpCRXcZEq89KgewFTdfPkti8bY,True,25242154,6310538,38923,19461,19462,HfEnetJ7uBSmZWCjBNxdvv9HEC5nsW4wDV7wu6WnhWan,1556956,26310620,-24753664,616
2022-01-24 05:37:02-05:00,10016,4yhW5mBsFVNgQ5QQc2Yg65guctPsTSXcERbzmYM6rdnL,5uJnMZ6DWA9bMSvHvS5zomwtt1sv7YCWq3GDJh77YC3q,True,209819,52454,323,161,162,3zqXX6kzhkbW3d4TwD2CNjMRwxTbREXySekvq37kfCNk,12958,244038,-231080,617
2022-01-24 05:37:03-05:00,10017,6Bq55LtGCEeGqh4JrFLCmmGc2iJfTTBJixivqH78aGSE,DSNrCgWJeNe2P9tAQu5FvCueTzNKDKds7wzuwTQSMRG,True,5634,1408,8,4,4,3zqXX6kzhkbW3d4TwD2CNjMRwxTbREXySekvq37kfCNk,349,6081,-5732,619
2022-01-24 05:37:03-05:00,10018,6aW9dhnTNerVd1MPv5GrcYqgjVPE9LsNCGYSJSrNdgS8,8kmJu2UxTk2T37sqxDSrf6pDWhJZRxfRdJB7DLeoWddJ,True,7064773,1766193,10996,5498,5498,HfEnetJ7uBSmZWCjBNxdvv9HEC5nsW4wDV7wu6WnhWan,439844,7800493,-7360649,622
2022-01-24 05:37:03-05:00,10019,EmXaq1sxmAZUiwYW6LXpKtKFZXu5MzQ3sK4MEAojDK1h,HuAsa5G2wJi8Ah9stxEmggwcB5zW1QjBsP3Ndgke7r8X,True,285585,71396,443,221,222,3zqXX6kzhkbW3d4TwD2CNjMRwxTbREXySekvq37kfCNk,17724,330585,-312861,620
2022-01-24 05:37:04-05:00,10020,8nXbrdjjaHB73CRPRenGEQj73wbtEFGDwXsehRGMhsap,43pvdcJ6f27wz94D6ZboKwRJYbyvYCrjsJhYsvk7LJCM,True,52874,13218,82,41,41,HfEnetJ7uBSmZWCjBNxdvv9HEC5nsW4wDV7wu6WnhWan,3283,40873,-37590,620
2022-01-24 05:37:04-05:00,10021,5zCfNUARbvDrkdkf8rKNnf6D7HXn7Wz6D61jQGTGpw3N,6T76MLTxS5vnRuodEgADt3iXMx8WUFLQzoyKh7f2uPFy,True,385959757,96489939,593395,296697,296698,3zqXX6kzhkbW3d4TwD2CNjMRwxTbREXySekvq37kfCNk,23735830,254409779,-230673949,614
2022-01-24 05:37:04-05:00,10022,Gfe4UgUGqvzcehSbETrWwLRAcqzFnkTrs6vJx8h6kTxi,7exMQ8sLti4Pmb2ZQtZhyuWRuQ6pq7XSXL9sCcWTqCvF,True,17332197,4333049,26802,13401,13401,3zqXX6kzhkbW3d4TwD2CNjMRwxTbREXySekvq37kfCNk,1072111,19759266,-18687155,618
2022-01-24 05:37:07-05:00,10023,45AiuRBbmupfwYXqsWwKHtmEWN8XNJDUSHwHL3b6PvHc,CfvwVkxYPP3jqK2dpAvSRFA1513E9ti84mEpYgtkzFUt,True,363427,90856,565,282,283,HfEnetJ7uBSmZWCjBNxdvv9HEC5nsW4wDV7wu6WnhWan,22621,407177,-384556,622
2022-01-24 05:37:07-05:00,10024,5FgPU7KpsDnx4Xc1UdQoLPR7MDd5cBkJXW2Q8ctopMZR,9GWzAZFVfTY8WjTYvDAE2YcAjgeKiDXgToK76KBZF7Rv,True,281819,70454,432,216,216,72FwbpFGoLEazJEdpqNtPNefsadUrimUqma9wSoy4qiS,17303,316751,-299448,613
2022-01-24 05:37:07-05:00,10025,CEtpqFD4BbeiNfaXyLLYEapY2mWgE26H5q6H34tWwRuD,BVqRyqwGFPzSkk1H2finiyfaL3LScbEiQGk3mihirxqs,True,157011,39252,241,120,121,HfEnetJ7uBSmZWCjBNxdvv9HEC5nsW4wDV7wu6WnhWan,9654,179540,-169886,614
2022-01-24 05:37:07-05:00,10026,8YMEydGnQH9W5AEXFGquFkb1bcf3PcxiMvYBSMPXKJyQ,3CmWH8eYtkmHNisqMmMBLff6C6z6ZcSj38KoQ34DPUE7,True,167308,41827,259,129,130,3zqXX6kzhkbW3d4TwD2CNjMRwxTbREXySekvq37kfCNk,10372,181194,-170822,619
2022-01-24 05:37:07-05:00,10027,6kt64nJRnYaWMi9GbpZaUuhbToAVRd7FUMTGASAAJrve,2Sdxv9ZtogNcVbJwBPxKmVjwAiKyX5GHEfnRmFcydQ1G,True,24812792,6203198,38551,19275,19276,3zqXX6kzhkbW3d4TwD2CNjMRwxTbREXySekvq37kfCNk,1542071,25903111,-24361040,621
2022-01-24 05:37:07-05:00,10028,4qWzk4JP2gEsTP252Y4SJrjSmfRBxDfE4ZdbPmwavfb2,CAgDhCNVyy61FG2YPMnm9zxgY56s2UqPhvssH5G1LjXP,True,22798880,5699720,35475,17737,17738,HfEnetJ7uBSmZWCjBNxdvv9HEC5nsW4wDV7wu6WnhWan,1419030,23690470,-22271440,622
2022-01-24 05:37:07-05:00,10029,4cNmhgaMic1xBiaDJ6phrQuXmm8WfF1qjyYMqZcKG4c9,43vgfXiLTtcs1bkrcDar2iz9M6RMbGqbA6BMkBHdh7T4,True,200351,50087,310,155,155,HfEnetJ7uBSmZWCjBNxdvv9HEC5nsW4wDV7wu6WnhWan,12431,233597,-221166,620
2022-01-24 05:37:09-05:00,10030,CygwJ5Z1ZP6xfjN1ZGH7yw8b2oYvf6JTpenXx7A5yFdt,59VKgJtBCTb3Pji7BWtqttisBYVVCnWtyEn5Eba5r52Y,True,3714311,928577,5797,2898,2899,3zqXX6kzhkbW3d4TwD2CNjMRwxTbREXySekvq37kfCNk,231909,4025330,-3793421,624
2022-01-24 05:37:09-05:00,10031,2DHhfXSzcuSwsKfAYLMuWuD17w84mCwNer9fcBNLTpSc,89BVfDycKjdSkQzFVqCXd5c16DntdND7WsqoZtCafYFH,True,10228134,2557033,15915,7957,7958,HfEnetJ7uBSmZWCjBNxdvv9HEC5nsW4wDV7wu6WnhWan,636604,11524142,-10887538,622
2022-01-24 05:37:09-05:00,10032,AECUZGm5DjFvbLZEUYhepSPg1Wa7hBjxF9e7ZRBzRPhm,Ar7e1iLKAqa54QiQnXifvnETixDZT1T8KL5YWJA8Ykv1,True,258904,64726,403,201,202,3zqXX6kzhkbW3d4TwD2CNjMRwxTbREXySekvq37kfCNk,16150,299354,-283204,623
2022-01-24 05:37:10-05:00,10033,7afnF1MkAootZGWc7zsMVLpBuve83hGmvAHkfmwgsq5A,HKdJE8bReznq1Qxqd5iZ4nWQGCk62Vo5TpkRD51bpbGp,True,219497,54874,343,171,172,3zqXX6kzhkbW3d4TwD2CNjMRwxTbREXySekvq37kfCNk,13732,254199,-240467,625
2022-01-24 05:37:11-05:00,10034,73Wkg27usHy8knWENTmb9zbikugYh93JvBB2bF855vZ2,J9WaUA7r8ct4ZG8o8ATZjvHUPuCYqY42aTsr9xveW5BX,True,223759562,55939890,350037,175018,175019,3zqXX6kzhkbW3d4TwD2CNjMRwxTbREXySekvq37kfCNk,14001516,317592991,-303591475,625
2022-01-24 05:37:22-05:00,10035,5inuJkWfHc2MtCqy2toH5VR4VzT43A7t2wTagA2ft91B,6kXdkHMTcY1PodfiSdMGX7X4KqvcTJWMf5amCskLPCXy,True,7069406,1767351,11030,5515,5515,HfEnetJ7uBSmZWCjBNxdvv9HEC5nsW4wDV7wu6WnhWan,441212,4652871,-4211659,624
2022-01-24 05:37:22-05:00,10036,DDuXUcRDez68Tx651sVKxjubhTdNHkuarbeDEKFp5HRs,DNWcrd23zaT7LuXHuhPVqqAvLVpEzoqebr4sho45CphT,True,611210,152802,940,470,470,HfEnetJ7uBSmZWCjBNxdvv9HEC5nsW4wDV7wu6WnhWan,37628,276693,-239065,615
2022-01-24 05:37:26-05:00,10037,DY6k3Dkwe18iLneaT8Xo3VpJWB6V4jWwQQjoDvEzdg2j,3GGV7S9FpRQGbARBXkvGFVqLrmw8JvYAcpnR1aKVUY2f,True,224654,56163,347,173,174,3zqXX6kzhkbW3d4TwD2CNjMRwxTbREXySekvq37kfCNk,13905,221442,-207537,618
2022-01-24 05:37:26-05:00,10038,4rwzdgkP7REWtQxRf9ftWKYXs1QoZQQBo6YQvNJYjZBY,4EmBTVv6MbdPC6WqTNrSABrP9aTZPrDSPxy9a2KbVgqu,True,1981511630,495377907,3036721,1518360,1518361,HfEnetJ7uBSmZWCjBNxdvv9HEC5nsW4wDV7wu6WnhWan,121468851,865348722,-743879871,613
2022-01-24 05:37:26-05:00,10039,DkvR2xUPMyXWGGkUSmDSfhp7RtvMkfbT1ThKCS3TwrXd,F7jYV6TtT1LZ5XCNn1zkbUfNMo4gGcQUczAQy1jLHpaW,True,11037934,2759483,16848,8424,8424,3zqXX6kzhkbW3d4TwD2CNjMRwxTbREXySekvq37kfCNk,673946,8813812,-8139866,610
2022-01-24 05:37:27-05:00,10040,9WRDBHzD4aNHw5qvrhc6nqXCBLA5D7YYP8TvSrLksXd6,GwxWNmv9XDkqQsx7DfCMccFjVik8asPnFU9gtnb4UVx,True,165303,41325,256,128,128,3zqXX6kzhkbW3d4TwD2CNjMRwxTbREXySekvq37kfCNk,10276,191612,-181336,621
2022-01-24 05:37:28-05:00,10041,HxhVxMpFpKzeuC6Z6CpsuUhPHdHUzvpMNYJ8LpQ3NYCp,8KyiipC39iU15zVErVvj6hdhbv89STsexrB8dVw3RcLs,True,223802,55950,347,173,174,3zqXX6kzhkbW3d4TwD2CNjMRwxTbREXySekvq37kfCNk,13897,259748,-245851,620
2022-01-24 05:37:28-05:00,10042,8GhXRNmsEgFgKPhGNNgEPUywVzW3bE7uZRWys2P1yNeJ,Bvi5vD5fhRFNdVhEXsSv9vkJzyQzgEswFHBxowkUEgF,True,1842563,460640,2860,1430,1430,3zqXX6kzhkbW3d4TwD2CNjMRwxTbREXySekvq37kfCNk,114406,2115795,-2001389,620
2022-01-24 05:37:28-05:00,10043,2AAWghW6BUAFBtF3R6hB9uoqMc5oUDkU8FTd2JrXKema,798cfEUZ2YhXwNTNjXMS4Z2J8gAHaK4zZwpMkq2HzWWM,True,1147301904,286825476,1780150,890075,890075,3zqXX6kzhkbW3d4TwD2CNjMRwxTbREXySekvq37kfCNk,71206030,911107240,-839901210,620
2022-01-24 05:37:28-05:00,10044,HZJyrD4eqM4nKnyRh2JAs1sC2TaJxFhNPixBdK7PLMuS,Hycz71z4tEsKUogJnefT2GN3MPCLdTJdv9B6T82Ngw2u,True,919438,229859,1431,715,716,3zqXX6kzhkbW3d4TwD2CNjMRwxTbREXySekvq37kfCNk,57250,1073311,-1016061,622
2022-01-24 05:37:29-05:00,10045,GGcsY84pkqUn2xySuLYrUUg8gWMBWgfHaQ7rK42NoZaH,4EyjJvctL9WBQiauD2Eaf2Hus8htYzHxP5GR2HsUfuks,True,58019215,14504803,90032,45016,45016,3zqXX6kzhkbW3d4TwD2CNjMRwxTbREXySekvq37kfCNk,3601309,31654057,-28052748,620
2022-01-24 05:37:29-05:00,10046,oTq8BsGLNc2ddcdR7ELnCXgzf4KvtA7REmfbFKo56FT,4PgxGgi2UaB753PFyELQCrJy7phAkYsW4e39J9wGWrcM,True,13421019,3355254,20927,10463,10464,3zqXX6kzhkbW3d4TwD2CNjMRwxTbREXySekvq37kfCNk,837094,24916084,-24078990,623
2022-01-24 05:37:29-05:00,10047,3R2wxFQwjCqUwwxJmp9tNrT6osYFpB5gczq2QYik6QYm,7At5Ej3ZsynfWr56FYrd4P4Y6UtD8FHA4gCFB8TaAyaG,True,213696,53424,332,166,166,HfEnetJ7uBSmZWCjBNxdvv9HEC5nsW4wDV7wu6WnhWan,13316,247749,-234433,623
2022-01-24 05:37:29-05:00,10048,68F35fonSGS1P6LMYmAmeoM8kC6Z78NabMqYLeCZr9GJ,8apmWSZdS8s1ScoNVj4AvSJsbQCj1drU3HL74khuANT2,True,227185,56796,354,177,177,3zqXX6kzhkbW3d4TwD2CNjMRwxTbREXySekvq37kfCNk,14180,263086,-248906,624
2022-01-24 05:37:30-05:00,10049,AzLdwyd8Q4V3iMaSwWgvWwQ9nCs7X7YV2YKpd6CH33nP,BYjeXF5YkcJy3mNMbvfHzXTtyjkc4U53hM5tvfERUH8y,True,212352,53088,331,165,166,3zqXX6kzhkbW3d4TwD2CNjMRwxTbREXySekvq37kfCNk,13276,245727,-232451,625
2022-01-24 05:37:31-05:00,10050,9WJBnVi84E926j7xEd566WzrZJkPJWRgmEnYj9vyjuad,4dLaFS5F7TGyLdwuJLMGkz3bSL53aHzd9ZfpNmhHxXeF,True,278546,69636,435,217,218,HfEnetJ7uBSmZWCjBNxdvv9HEC5nsW4wDV7wu6WnhWan,17419,251876,-234457,625
2022-01-24 05:37:32-05:00,10051,J3ggP7ZxL8HRh3CBp5iYG2WgjLyNSAWYT46uC9VYDLCz,2FqTRiRPiLvdAH2BS5vroVntpsSXvTJEn5UHWmtKHzh9,True,533116,133279,826,413,413,HfEnetJ7uBSmZWCjBNxdvv9HEC5nsW4wDV7wu6WnhWan,33071,352983,-319912,620
2022-01-24 05:37:32-05:00,10052,Dcitj55ABpkgXvpnPCssy8GgKF46xd1GLaRMyPWoW6G8,62znTXs74bywWfcXptJkvwYuuTxgen8bhYaCnG8Z7y2B,True,454269450,113567362,710866,355433,355433,3zqXX6kzhkbW3d4TwD2CNjMRwxTbREXySekvq37kfCNk,28434645,233771186,-205336541,625
2022-01-24 05:37:34-05:00,10053,6rpuf35EHPrQ3LVPUcdfRTh3igu9wvRcfvoA6uSMNmYq,B1aor5NFukbUeT5tzi9oXgRGxcRoojff8sfbwzmwywBq,True,4796959,1199239,7397,3698,3699,3zqXX6kzhkbW3d4TwD2CNjMRwxTbREXySekvq37kfCNk,295901,2752274,-2456373,616
2022-01-24 05:37:35-05:00,10054,8T4WK27RvWVGqPuNqY6whk1fmU4vd5qaUQPZG1GJ79bh,DvSz7knS8N3K7L6JhQf1s4mJSyxB8uJXNQXtyjJn8QRL,True,1662271,415566,2582,1291,1291,HfEnetJ7uBSmZWCjBNxdvv9HEC5nsW4wDV7wu6WnhWan,103297,1395626,-1292329,621
2022-01-24 05:37:35-05:00,10055,CxLFMBDFkoMvpK9YUf7WtCq6hn7k3QACAuetAnGjU6KA,2gE52a1GWQnS6ifV6eVtKQyr13LXP5Jdt3yG9SjGPJPF,True,22012100,5503025,33981,16990,16991,HfEnetJ7uBSmZWCjBNxdvv9HEC5nsW4wDV7wu6WnhWan,1359246,11024723,-9665477,617
2022-01-24 05:37:35-05:00,10056,8otVEtwXkAdnt5XmBzL8hmzAgRcaDDxiuqpRxY6ZhR24,7333dFedtBjo3yhbp2bU1XbAfdDeBvvCd9QKitYVUU7v,True,197302694,49325673,307770,153885,153885,3zqXX6kzhkbW3d4TwD2CNjMRwxTbREXySekvq37kfCNk,12310837,55043092,-42732255,623
2022-01-24 05:37:36-05:00,10057,BgnsCfJ54ReunUtwPJLzkW4PWnqpBDWGNYxsW5PvDrbK,KpMqEkQ9dKMgCevsEK895wHd3fCLRPSzDmJSv3tKU4u,True,263072542,65768135,410914,205457,205457,3zqXX6kzhkbW3d4TwD2CNjMRwxTbREXySekvq37kfCNk,16436585,192808836,-176372251,624
2022-01-24 05:37:36-05:00,10058,FgQrRo4eGQAonSsFfQgnp8trGGqGZCLeGX6yvJnMnTjd,8KhemHLBY6nGmo3xMDedW2wnCSxQq6LwbTExif4sUSxx,True,24882920,6220730,38400,19200,19200,3zqXX6kzhkbW3d4TwD2CNjMRwxTbREXySekvq37kfCNk,1536037,10289723,-8753686,617
2022-01-24 05:37:36-05:00,10059,8E3K7vCHJ2xjdFofPRGLbMxrkm8UYEi926QmXPAFwsqe,4qHUDA1c43Dg4qi1ZPKqmpGYiEMUZ6r4UuzB5ftHCEhW,True,25718613,6429653,40028,20014,20014,HfEnetJ7uBSmZWCjBNxdvv9HEC5nsW4wDV7wu6WnhWan,1601130,23454587,-21853457,622
2022-01-24 05:37:43-05:00,10060,5acohGZShYQVNGZEfy7pTyX7E8MzqRDwByhFL1H53UNv,4Z454ZseKbWGEtdrE9eotbDZ7o9VHhooMYriTfSFHiGt,True,106321744,26580435,165602,82801,82801,3zqXX6kzhkbW3d4TwD2CNjMRwxTbREXySekvq37kfCNk,6624081,38914022,-32289941,623
2022-01-24 05:37:43-05:00,10061,CYQr97qwLjGnmEy6vVgs3eL7omwG6UfFbhTv7gBty5z9,DJJ9UqSZUTgyt2yWAkUnGFDuox3xYFQUuorLa7qPdM88,True,16964170,4241042,26231,13115,13116,3zqXX6kzhkbW3d4TwD2CNjMRwxTbREXySekvq37kfCNk,1049253,6580593,-5531340,618
2022-01-24 05:37:43-05:00,10062,CLVUzXSNsQnX7n5cvxMuTjyMSjy1pNpPnWejFaeuonvb,BXZzBujr8DAUcGJcHQBaz1ZSwkATAHg3NX3bLnrjQpLh,True,12286323,3071580,19167,9583,9584,HfEnetJ7uBSmZWCjBNxdvv9HEC5nsW4wDV7wu6WnhWan,766683,3615719,-2849036,624
2022-01-24 05:37:43-05:00,10063,H3x9b27yHVdCxvtDf7mmJxkNeubcmQMwfAkLTYADPWNv,HGVCCz23rWx78vrTB2wvm2aesbLZuYFhhNuznGiSSAyA,True,211012976,52753244,329297,164648,164649,HfEnetJ7uBSmZWCjBNxdvv9HEC5nsW4wDV7wu6WnhWan,13171890,83869497,-70697607,624
2022-01-24 05:37:45-05:00,10064,F6wpqqx576XRuYo8y6XPLYphojrQtK4VvdY79Jk6My5N,38VbNLaQzLFcVqHuSR9zn9UX3Yv9SCVy1mrwmxX9PpVQ,True,44845458,11211364,69423,34711,34712,HfEnetJ7uBSmZWCjBNxdvv9HEC5nsW4wDV7wu6WnhWan,2776942,11547813,-8770871,619
2022-01-24 05:38:00-05:00,10065,6TvTxJWSPeyaTVm8PmarVDzxhbTqnkyoabQTgihXyGMj,62ngTMHaRDFjpvzasDgfmgyJ5T6jS9PmYgy97HCkyQS4,True,6035983,1508995,9377,4688,4689,3zqXX6kzhkbW3d4TwD2CNjMRwxTbREXySekvq37kfCNk,375102,1617872,-1242770,621
2022-01-24 05:38:00-05:00,10066,EAUFD16wab8qRMJ4H6updHGt4xFqgRCDeRHVCsLCTSTL,8vkfYSyCyBY9g4TZrp52jUcQj6udy9xAaA4fioRE2RXx,True,127969144,31992286,199061,99530,99531,3zqXX6kzhkbW3d4TwD2CNjMRwxTbREXySekvq37kfCNk,7962445,87541672,-79579227,622
2022-01-24 05:38:01-05:00,10067,Cv5oVktxmqbU1SxraxH67NEWMKnjgA18R832Fhe9h74a,Cs7xBD4BDiohyopnaYDDChUtR9vmx7uwot6Qp9beQLzt,True,16212608,4053151,25311,12655,12656,3zqXX6kzhkbW3d4TwD2CNjMRwxTbREXySekvq37kfCNk,1012445,6575322,-5562877,624
2022-01-24 05:38:01-05:00,10068,HdRgh9niYSd3YKCxzGdusYFquiVoFTP2mEGEzJJL5Nii,78C68Gbb1jYFQmYNCHHjL52keEKMXtGukmBwT7ahon4B,True,43359970,10839992,67834,33917,33917,HfEnetJ7uBSmZWCjBNxdvv9HEC5nsW4wDV7wu6WnhWan,2713366,40184859,-37471493,625
2022-01-24 05:38:01-05:00,10069,G8nRLTWTT5aD7q7TcSa2mw7p12GUuHDVq5ev4vyXbdKi,3DmQyungZMK4T1a1PgXh5shBskwP69tTLmZPh7HZ76vh,True,312043,78010,485,242,243,HfEnetJ7uBSmZWCjBNxdvv9HEC5nsW4wDV7wu6WnhWan,19425,361337,-341912,622
2022-01-24 05:38:01-05:00,10070,Dqnxcekm1QfxGQ2FSJ6SjFiwmaQRWEjW9WTJQG4AjEpE,9JiMtjm5AJqngosRg787FiN8NyuBPuAPD2jYpRQkAc1d,True,278145,69536,435,217,218,HfEnetJ7uBSmZWCjBNxdvv9HEC5nsW4wDV7wu6WnhWan,17403,322206,-304803,625
2022-01-24 05:38:02-05:00,10071,8VQ21PFXdHBNmiZiF18LyGvsRSpr13vkyktfembNCe3m,5exbVC7vaGFeHEGAx7epYfMaU932QafqzfhFm5FKAq2H,True,193151,48287,301,150,151,3zqXX6kzhkbW3d4TwD2CNjMRwxTbREXySekvq37kfCNk,12046,223647,-211601,623
2022-01-24 05:38:06-05:00,10072,EToREv5PrDmMUqRH43RdhooZMpmzXdic79KSoBatakPp,4ZTacQQnxq89V64pELPFkmvwJgkVY7m29g2sXfnn3mPD,True,14468402,3617100,22279,11139,11140,3zqXX6kzhkbW3d4TwD2CNjMRwxTbREXySekvq37kfCNk,891171,4493126,-3601955,615
2022-01-24 05:38:07-05:00,10073,49hagnoMSB3ozBBMaTgeZ2nwEbKKS3NZWUuPShMBUwp9,6ivAhvY6bUr98jqBp4ye1w8Vz8NesEubqKDSn1jeqxmr,True,25688316,6422079,39681,19840,19841,3zqXX6kzhkbW3d4TwD2CNjMRwxTbREXySekvq37kfCNk,1587256,8125906,-6538650,617
2022-01-24 05:38:07-05:00,10074,H1oYXGZTagwv48FdDe6RNkjNaesedqLKyXxTmPc5k4Fp,Am3rx6XrkrZ4MdeZDyZUv1YW2fBujcz4dLjVCnRQHKZa,True,115499886,28874971,175887,87943,87944,HfEnetJ7uBSmZWCjBNxdvv9HEC5nsW4wDV7wu6WnhWan,7035498,36816176,-29780678,609
2022-01-24 05:38:08-05:00,10075,7aM6r3HXMKzhj1hoDWjjkVCVy2y1rhDx2QV8Sdgr9DoM,4yBtGoYqo6dX4T3NMVbgMN3731hEnugL1dsR1A5vXF8f,True,14041295,3510323,21680,10840,10840,HfEnetJ7uBSmZWCjBNxdvv9HEC5nsW4wDV7wu6WnhWan,867220,5924158,-5056938,617
2022-01-24 05:38:08-05:00,10076,3idUQDMPAN9f6F6BipHAYFZyhG5JADey1y7JcFYx5BRh,D6UMk8WsSRahs4nGyi9DLt2HyZQy4wAywDwL31sL8BVj,True,2368904,592226,3670,1835,1835,HfEnetJ7uBSmZWCjBNxdvv9HEC5nsW4wDV7wu6WnhWan,146803,990888,-844085,619
2022-01-24 05:38:08-05:00,10077,5gN3624v6n1zQ1BKtZi1e9ZLpbCa4MEfhgHySFB81Qfm,UXT3oB5ud18rBsygsfxwA93kQYdSNbbzTCjt4gtU2jP,True,20426024,5106506,31717,15858,15859,HfEnetJ7uBSmZWCjBNxdvv9HEC5nsW4wDV7wu6WnhWan,1268695,6468213,-5199518,621
2022-01-24 05:38:08-05:00,10078,71DcjZY2Fd1Jg9YkDXUH5usC9QcHeQqSxoEk7tH3fhzo,3o4iDHXNpNVAHaHzVirbcNevP6YfoP2EqddBNoSRU4hn,True,16588166,4147041,25853,12926,12927,3zqXX6kzhkbW3d4TwD2CNjMRwxTbREXySekvq37kfCNk,1034144,6680378,-5646234,623
2022-01-24 05:38:11-05:00,10079,6X5por58mMECmNZQEWpo8M8aA1eHJqr5LNeV9vC7GW5e,DPB2C5UB2Ls1kNzbs1GP33junQvhUyFJWP75RoYjqByn,True,11356398,2839099,17210,8605,8605,3zqXX6kzhkbW3d4TwD2CNjMRwxTbREXySekvq37kfCNk,688424,20527538,-19839114,606
2022-01-24 05:38:11-05:00,10080,69byqtDPmgEY1NqKBCR95CEPVHRUxgbNW9Y4P4HjQ7ND,E47T4q4zMGzNL6vDxgWdLn3EQbW3WfVryr8Jsymy1hAL,True,351754,87938,532,266,266,3zqXX6kzhkbW3d4TwD2CNjMRwxTbREXySekvq37kfCNk,21287,374183,-352896,605
2022-01-24 05:38:12-05:00,10081,4HDEN1Thxm9RbdE8pXnLP4QksVdXfp7Fa9nAnMRzr7oR,8gD3DbF6VhPTCgk3A4G7iA4f3DPH598Hj7TRJ2FebMCq,True,275288,68822,426,213,213,HfEnetJ7uBSmZWCjBNxdvv9HEC5nsW4wDV7wu6WnhWan,17063,309024,-291961,619
2022-01-24 05:38:12-05:00,10082,2ZX5NexeuZq25mAfBFDrwd44UfKhWgzmSwdhWFmo48c7,CpNnhSqg7EHn9g84gHoo831sVrAe5SkwNaEZAash4CXs,True,1442507,360626,2222,1111,1111,HfEnetJ7uBSmZWCjBNxdvv9HEC5nsW4wDV7wu6WnhWan,88913,1687039,-1598126,616
2022-01-24 05:38:12-05:00,10083,HGAFdundf5voDqeh9g7d6Q9mgMf8eEg898QMRBqwPZ6C,deanBuZXWBHEe2TGfP37S9aMBEnEgmZoyRJjAvruzfA,True,614305,153576,951,475,476,3zqXX6kzhkbW3d4TwD2CNjMRwxTbREXySekvq37kfCNk,38076,636694,-598618,619
2022-01-24 05:38:12-05:00,10084,AiLCB8xw3k5FXdJE1T42PLFhHrz1bLTKpNekR61a915N,HB7CNWxLipWAc6MPGq9wV4TT7AYjiELA5T3onYeVqBbU,True,4283531,1070882,6528,3264,3264,3zqXX6kzhkbW3d4TwD2CNjMRwxTbREXySekvq37kfCNk,261127,5015050,-4753923,609
2022-01-24 05:38:12-05:00,10085,GM22yjVoBCzgBcVTT5EcgRhVWiXVV82kSj1dPCbegKWj,CDDy8JmJMwJyx1YAvEPpj8AYxCpngRovf3wWfVzao5Rc,True,125984,31496,193,96,97,HfEnetJ7uBSmZWCjBNxdvv9HEC5nsW4wDV7wu6WnhWan,7753,82093,-74340,615
2022-01-24 05:38:12-05:00,10086,SCtptafLHdkTiYC3e9sv853xNnusHLpoMPxTc1zUVC8,2HF9ggN6EbkYGz3Ajj7tB8m5YF3Yj77Vy96DMFSz5C7j,True,989542,247385,1537,768,769,HfEnetJ7uBSmZWCjBNxdvv9HEC5nsW4wDV7wu6WnhWan,61497,1073819,-1012322,621
2022-01-24 05:38:13-05:00,10087,ANXYsUNpZ34dBt7cp6HEE7oi2pTKsbj7B5TeFHKPbHBU,2pqeP4fuMREosHcfWUecEBssp1GM4isihNjn7ALUD51d,True,259251,64812,394,197,197,HfEnetJ7uBSmZWCjBNxdvv9HEC5nsW4wDV7wu6WnhWan,15786,300977,-285191,608
2022-01-24 05:38:13-05:00,10088,Go3ne58krEsFsZ5yu9EBT7od15VCYmtbs1KhumRMTiXS,HCvwQ7HjmmeDXrguZQPrAbJjcCJzHqVZK2JMSFkFDWfe,True,73031,18257,112,56,56,HfEnetJ7uBSmZWCjBNxdvv9HEC5nsW4wDV7wu6WnhWan,4499,88055,-83556,616
2022-01-24 05:38:13-05:00,10089,8XcMucCQpWfNtbdCYnKuabk91NQ9wfYp7byk496CwU9n,DLrApDfWcyMqufEFZm9PvddsMoiediT58X8e8pxpnzrk,True,349446,87361,537,268,269,HfEnetJ7uBSmZWCjBNxdvv9HEC5nsW4wDV7wu6WnhWan,21513,391843,-370330,615
2022-01-24 05:38:13-05:00,10090,9hB3EPuj4SrSrpAzHvExDb6mzh2vNGGVbj7qqfRjeao4,9725jRXGPRUuo1dijvv8mwzvSu1ed4y5hi9FAQNwb8dG,True,3621712,905428,5611,2805,2806,HfEnetJ7uBSmZWCjBNxdvv9HEC5nsW4wDV7wu6WnhWan,224459,4204341,-3979882,619
2022-01-24 05:38:13-05:00,10091,3oCun4gm3k8sXxVxiYM8okGi8iCXH9LvDkHf9PBQWYXR,E1np1dZ7jUm811ddvy1jQerBwGSYb5BbZWnUHeotvrfH,True,657751,164437,1008,504,504,3zqXX6kzhkbW3d4TwD2CNjMRwxTbREXySekvq37kfCNk,40332,341905,-301573,613
2022-01-24 05:38:13-05:00,10092,4eba4qAmwfqmihaYvTWFU9hm4VYrKvNhNywHNyimQJNK,G1DyxJcNQD8u4KGfnwxttyrJMfse1FBAsofioEMdTS9U,True,1323176,330794,2041,1020,1021,HfEnetJ7uBSmZWCjBNxdvv9HEC5nsW4wDV7wu6WnhWan,81651,1545721,-1464070,617
2022-01-24 05:38:13-05:00,10093,DjbEch16uzdDtujFUeqxjquTTS3JXzEys8e9ogUv3aTy,6N8eKb3kfcbJEUZKZERiFiUR4hubB635D8Sotiji2TU8,True,25652470,6413117,39319,19659,19660,3zqXX6kzhkbW3d4TwD2CNjMRwxTbREXySekvq37kfCNk,1572786,26974357,-25401571,613
2022-01-24 05:38:14-05:00,10094,Bbd196A866Y9rQWQFt4YGg2R6Jqj7WQGXWPDmrNtPcKf,5gmWk1KwLoRHnhkjxps4Ad6aVk4ZpcfC3McZCWDVCUbu,True,204221,51055,312,156,156,HfEnetJ7uBSmZWCjBNxdvv9HEC5nsW4wDV7wu6WnhWan,12482,245774,-233292,611
2022-01-24 05:38:14-05:00,10095,AnqmmhzVDCNq4dE4VvYkPDGB9nMXr4ykqvUhwxhR21pd,CcMeofCvvrDaBzgAGzoPwRt5eQmzdB1z2Y6UiwGqhFbG,True,2452438,613109,3746,1873,1873,3zqXX6kzhkbW3d4TwD2CNjMRwxTbREXySekvq37kfCNk,149854,3465951,-3316097,611
2022-01-24 05:38:14-05:00,10096,D6qMab7uevXTa89ssv4BRyHwrw3FYpNimAmX2VH2uf4B,8ZauZ5dAp7kyawkPdxi4mqfempFHubJebfBenQdDektD,True,116533,29133,178,89,89,3zqXX6kzhkbW3d4TwD2CNjMRwxTbREXySekvq37kfCNk,7132,140515,-133383,612
2022-01-24 05:38:14-05:00,10097,6b7Ro2myM4HcUDqyyW9NEqTWPz8BWpH4eNFSQQci37So,7r7j7rSsa6YZcTuRPfs3KP44MVqUA4Q5NeJGmx84wbHq,True,89618,22404,137,68,69,3zqXX6kzhkbW3d4TwD2CNjMRwxTbREXySekvq37kfCNk,5511,107556,-102045,614
2022-01-24 05:38:14-05:00,10098,DBhvfqBC6si4wSJRkB2S89CKxK27rUyzxWNghK2ghaN8,3SHC2Q839Dms5LSofDgDkAixqZaA9FvZUk3yrKYLERxS,True,114784240,28696060,175892,87946,87946,HfEnetJ7uBSmZWCjBNxdvv9HEC5nsW4wDV7wu6WnhWan,7035689,92231249,-85195560,612
2022-01-24 05:38:14-05:00,10099,9QZvB1Gqhk5PKt3MoJMjZL3FaU2bTbTDcVw3nF316zh7,DGJWGr9RCWkzdWn21mWG7NyUN8uuvSQbA53HojFJe1rH,True,2741589,685397,4134,2067,2067,HfEnetJ7uBSmZWCjBNxdvv9HEC5nsW4wDV7wu6WnhWan,165368,3075244,-2909876,603
2022-01-24 05:38:15-05:00,10100,A4tDE948CPFPh1UwHb8sXryfKktbxZ8BCkqXgA5DJHA8,3zXeKMrsEpCe5fQumLNzCgpxcG1kLJFEAtJuqxLsC6ZG,True,1568244,392061,2429,1214,1215,HfEnetJ7uBSmZWCjBNxdvv9HEC5nsW4wDV7wu6WnhWan,97168,1289776,-1192608,619
2022-01-24 05:38:15-05:00,10101,8eTH6eJyyVeMno3UQkffeBg32xofKsQfkhLhXdtaf87s,BCFC7CPXrQPsUfJb2eYSht8GhaApWHpc49AeCXqaYq13,True,4050417,1012604,6261,3130,3131,HfEnetJ7uBSmZWCjBNxdvv9HEC5nsW4wDV7wu6WnhWan,250467,2010873,-1760406,618
2022-01-24 05:38:15-05:00,10102,CM95f7KjJuAf1xVTWhu3wrp6BfMz116FbgkxBhcRNs4k,EG55wkH5NcoasfBUYhD5D2dc2uvo11dZ3uTu5wgs4gf2,True,372253,93063,567,283,284,HfEnetJ7uBSmZWCjBNxdvv9HEC5nsW4wDV7wu6WnhWan,22713,415739,-393026,610
2022-01-24 05:38:15-05:00,10103,B2hN3Lt5pFbUyfEUc5s48hkxUJ5rr2SeFxgdGdQ8pDD2,7bZJCCud253j9g411HQUDXUAADcwd5yJWznoTChBdB2H,True,110028170,27507042,171201,85600,85601,HfEnetJ7uBSmZWCjBNxdvv9HEC5nsW4wDV7wu6WnhWan,6848060,45746561,-38898501,622
2022-01-24 05:38:15-05:00,10104,4uygLJDk9DFCifJ56YwMrEsvd3oQNq8tYSLnMCyWorS6,GimL4uKGvg3FFmFQSWzAcjstv3Vmk5NMgDGMKTuXYVpB,True,9389698,2347424,14564,7282,7282,HfEnetJ7uBSmZWCjBNxdvv9HEC5nsW4wDV7wu6WnhWan,582574,7381146,-6798572,620
2022-01-24 05:38:15-05:00,10105,8kJu5aqVSmW8FSZR9h6F75ftn9V2U9uMLBEKeqRaC855,FhVHByujkvwwtjTVpZ4mqSUqoMoBgeLUc5H7rbz3FgAt,True,1599789,399947,2492,1246,1246,HfEnetJ7uBSmZWCjBNxdvv9HEC5nsW4wDV7wu6WnhWan,99712,1592376,-1492664,623
2022-01-24 05:38:15-05:00,10106,HwosLQgDY1xtHQRQ4hzroPQHFWssPzTj5vRkP37FcviB,HKTNEYNXrephNkH7apbobK4mcQXcNayQA4W1NgM6sLr8,True,830875,207718,1293,646,647,HfEnetJ7uBSmZWCjBNxdvv9HEC5nsW4wDV7wu6WnhWan,51724,534429,-482705,622
2022-01-24 05:38:16-05:00,10107,BgN75npBkPws5uiFE9RAujmPuZyAv2MQUPmfmJ1YCCij,78UFLNDn782TY2P4F5kRkMRC2s3gw8ak7sRQZRWNq82D,True,4346389,1086597,6722,3361,3361,HfEnetJ7uBSmZWCjBNxdvv9HEC5nsW4wDV7wu6WnhWan,268905,1927985,-1659080,618
2022-01-24 05:38:16-05:00,10108,76gdRvg74fv6A9vA8ukNPqWKkmKY6KLAAKBGvbNE2AXC,5n88nkWZiCtWyWPrgfJozgkxtU9HMSggrxHkLoTQp1QR,False,890,890,44,2,42,3zqXX6kzhkbW3d4TwD2CNjMRwxTbREXySekvq37kfCNk,44,1010,-966,494
2022-01-24 05:38:16-05:00,10109,HoJ3Re4BmCYKMJx2RUYtoHfg8ncEy3iFqvWJDGKqfMBV,2qg4FMcurNDVRzXYKwpzEYapxFECnAyU2oGmxQCSf3hf,True,175441,43860,272,136,136,3zqXX6kzhkbW3d4TwD2CNjMRwxTbREXySekvq37kfCNk,10904,211880,-200976,621
2022-01-24 05:38:16-05:00,10110,HRN438yBJSX72GV4E3JYLKpwQcnZXgAoB2VkmgXzEKDE,4jEn7ssEM8ZUjAyaKogEb3uyMmbZJ1a7WGCPNgh1Xfty,True,192012,48003,298,149,149,3zqXX6kzhkbW3d4TwD2CNjMRwxTbREXySekvq37kfCNk,11939,193688,-181749,621
2022-01-24 05:38:33-05:00,10111,4ne6vC7qdxQYHJCsaeFAKZrKdFt2SwXGHQ3jrMHqt4DL,Cf1dLHY2WXH9rXbRKq5TT8THbdo9SdNUZq4rYhRCF9z,True,279672,69918,436,218,218,HfEnetJ7uBSmZWCjBNxdvv9HEC5nsW4wDV7wu6WnhWan,17457,202819,-185362,624
2022-01-24 05:38:45-05:00,10112,72L76qDRMK3M7X52zuuB9GVyvFFLDBZwFMpVjWjghXzA,4m2ZVuemUctu1edv4YJVAcjXzKwpbCmBujzoUmLDeA7h,True,6409697,1602424,9995,4997,4998,HfEnetJ7uBSmZWCjBNxdvv9HEC5nsW4wDV7wu6WnhWan,399827,3199333,-2799506,623
2022-01-24 05:38:45-05:00,10113,D9VKhnfLLCrntDGFYSfoxFaY76VnHmYZ1ZbyFXdKdibz,2hRCRH2pMDyQGYcXHa8Y6BZo6FbcGZf5VJC1v8Bp6tGa,True,1663119,415779,2567,1283,1284,HfEnetJ7uBSmZWCjBNxdvv9HEC5nsW4wDV7wu6WnhWan,102692,1238391,-1135699,617
2022-01-24 05:38:45-05:00,10114,CpxZ136k95cVjGqkJnNpDZKUgrJrfg8HrFDZPL6BgsK4,Fo7HtcrneUTsnGqygsxPQ63G5rayYodYT65xP6B6HusH,True,28166734,7041683,43761,21880,21881,HfEnetJ7uBSmZWCjBNxdvv9HEC5nsW4wDV7wu6WnhWan,1750476,11323351,-9572875,621
2022-01-24 05:38:46-05:00,10115,FnAT8HKGgisYfeAbxKU2gSbCp8KbZHULRpaJX1NVijHy,2u637Crc2QzfSJmCnRNqeib3aZQVn4NGncpgM3Ph6jvm,True,620201,155050,964,482,482,HfEnetJ7uBSmZWCjBNxdvv9HEC5nsW4wDV7wu6WnhWan,38567,425626,-387059,621
2022-01-24 05:38:50-05:00,10116,EYNh72buYHmKWRSqF8omcFHRbqKWV76iXB2vrjHgQMck,Efm7bH2DFg5Y5M39jq3uDcoDHUa95zmey8n7Ld72jG84,True,27802012,6950503,42715,21357,21358,HfEnetJ7uBSmZWCjBNxdvv9HEC5nsW4wDV7wu6WnhWan,1708608,12660695,-10952087,614
2022-01-24 05:38:50-05:00,10117,JCagxpXPs6wVRUWbNBPCZ4uLCkZsachnofN7SZEEwGwB,5uGj1TBCkc7FV4ffdBJg31yLcCxkQLxRExjcinnJUow9,True,319882938,79970734,496862,248431,248431,HfEnetJ7uBSmZWCjBNxdvv9HEC5nsW4wDV7wu6WnhWan,19874505,304103619,-284229114,621
2022-01-24 05:38:50-05:00,10118,9E97vZ6evPgg1Ao8KwvjjZhBFW6dXZrrJENk1HvZ3SU,D7U38PB8BXLwUVKbRNv9po7VcFdnn7Y4tWY9xpRiNJsT,True,3192152,798037,4862,2431,2431,HfEnetJ7uBSmZWCjBNxdvv9HEC5nsW4wDV7wu6WnhWan,194491,1475287,-1280796,609
2022-01-24 05:38:51-05:00,10119,GKKRAsYGdcf47eFThG4KwhNv7egeHRuc2wmTh4kqpego,4ippJxgnqCtdtGzCkdZoYwv68fiXNSqQcgrnaHdXZDUa,True,26128516,6532127,40459,20229,20230,3zqXX6kzhkbW3d4TwD2CNjMRwxTbREXySekvq37kfCNk,1618384,17939720,-16321336,619
2022-01-24 05:38:52-05:00,10120,6uZobpBuFcQeYgZ4dApFi6iy4DB9GLHP1AAsQcCj6212,SGGFiPjjhscwroiWMqY4jTAHFw8eakpsEv35wNoHUPY,True,5226935,1306733,8173,4086,4087,HfEnetJ7uBSmZWCjBNxdvv9HEC5nsW4wDV7wu6WnhWan,326955,2153888,-1826933,625
2022-01-24 05:39:04-05:00,10121,CyWBZ1xJ9LahUnPesbXLZ4Rr5UyWAHgVFYwfrnhyrkNL,2Lpk87Xth8ZL5J9BfzmMpEE3x76FDrrrmdKiCNkSVip2,True,978899,244723,1510,755,755,3zqXX6kzhkbW3d4TwD2CNjMRwxTbREXySekvq37kfCNk,60431,837275,-776844,617
2022-01-24 05:39:04-05:00,10122,2YPm4Ex9mNHX4CuNAUjkrXgoLFaZs6r1X6asYYUnvPyj,BatsG1UFq8ryYuFFcdnDyFWFPUV5P6w2VQpRup5oUey5,True,252710,63177,392,196,196,HfEnetJ7uBSmZWCjBNxdvv9HEC5nsW4wDV7wu6WnhWan,15718,283999,-268281,621
2022-01-24 05:39:04-05:00,10123,GqFbV89UYbQ6aEW1bSvGnnsDtTPQfHPTHzisXPhLnaTC,6X7j3nqmugRyVVw83uSzgiPaemEscc8VdsnPEKDz4fg2,True,170811,42702,265,132,133,3zqXX6kzhkbW3d4TwD2CNjMRwxTbREXySekvq37kfCNk,10631,198856,-188225,622
2022-01-24 05:39:04-05:00,10124,CcfycMNGUqZLA6EEqtDdftSbQhTL11SYn3LxQqJ23Xgh,Ce7NW9CpB9qGYLf8XUDW49ERutoxtjZSjs54xrzF1fYN,True,346241,86560,528,264,264,HfEnetJ7uBSmZWCjBNxdvv9HEC5nsW4wDV7wu6WnhWan,21152,388997,-367845,610
2022-01-24 05:39:04-05:00,10125,DWMxC7PyBcue9RaoZLEEM233PyHeGqMAWqapnw8qM4N2,AVW5hLdQEQut1DqYzKXP8hBQFBx1Df697xkFSu4JR1U7,True,465697,116424,725,362,363,3zqXX6kzhkbW3d4TwD2CNjMRwxTbREXySekvq37kfCNk,29009,129902,-100893,622
2022-01-24 05:39:04-05:00,10126,CK1SjmBjrW7m1QVZbVZsVZgwEcxw8BTkckkzrZDrDdxW,M6vnBg1TPRhLu7sghkxtf5TkSLw5JhgoDmbGoyEYgR9,True,408144,102036,624,312,312,3zqXX6kzhkbW3d4TwD2CNjMRwxTbREXySekvq37kfCNk,24961,456924,-431963,611
2022-01-24 05:39:04-05:00,10127,6VBYUiLyQXvvsDmq1vh1oJ5VeA89tGgxtkgFfofc372m,35pyoeRA4duKX7njdYny3KffM2xaxuWUZGRUMQJ5iAiu,True,24650026,6162506,37567,18783,18784,HfEnetJ7uBSmZWCjBNxdvv9HEC5nsW4wDV7wu6WnhWan,1502715,25967451,-24464736,609
2022-01-24 05:39:04-05:00,10128,HUe9LgGBjMeNxGyeCtmXr2XbWVFhHXrvgc2XSqCwN11D,7Z1nR9GgezBXsDX5wW3BBarfMRMZV28rX6MeLRuWtycG,True,3715370,928842,5735,2867,2868,HfEnetJ7uBSmZWCjBNxdvv9HEC5nsW4wDV7wu6WnhWan,229415,4021777,-3792362,617
2022-01-24 05:39:04-05:00,10129,DakevNrDK5fAUGkLdrWHrsLZm8hEZBqkzUiwJouaDPPY,73nFhK7cygPgwKveXrdXcQVte8n1z3iBe4nmUVTGfFmv,True,14437438,3609359,22246,11123,11123,HfEnetJ7uBSmZWCjBNxdvv9HEC5nsW4wDV7wu6WnhWan,889861,11477805,-10587944,616
2022-01-24 05:39:06-05:00,10130,9cRx2sGeqENLrNkvzLSnuD161JshSav6pNg9c7pYLi8f,13ryjUoWLejTLDQKh1m69VFD31onMx8yhzCKhqbeU6s6,True,979259,244814,1531,765,766,HfEnetJ7uBSmZWCjBNxdvv9HEC5nsW4wDV7wu6WnhWan,61246,1109075,-1047829,625
2022-01-24 05:39:06-05:00,10131,3gdApRPkUGEqmLvTYf4WQJCnmTVmiEU2wCQG26QMpqKf,HpP2yxq3KfYByT4q4p2mLaELnPdW6kmEY9EqZaBZuUNR,True,243310,60827,374,187,187,HfEnetJ7uBSmZWCjBNxdvv9HEC5nsW4wDV7wu6WnhWan,14986,272180,-257194,615
2022-01-24 05:39:07-05:00,10132,6kscNwPWgKoW7MHRkB4ajxWF3DXLmXjmx9KjDnzikhfs,D49nf79UmrALDKnAa5kf94nZUffzJW7anLm4hVrFG2b4,True,6099620,1524905,9263,4631,4632,3zqXX6kzhkbW3d4TwD2CNjMRwxTbREXySekvq37kfCNk,370528,6658695,-6288167,607
2022-01-24 05:39:07-05:00,10133,BmLG3dPSnL9hL2okZcNVsHgzuWYCrWLdXW8z5Jd2gyvF,HXwhov5Re9b8D4XHULcVSdgBNfbtZ7KMhMRqSTcQTbno,True,547169,136792,853,426,427,HfEnetJ7uBSmZWCjBNxdvv9HEC5nsW4wDV7wu6WnhWan,34149,640170,-606021,624
2022-01-24 05:39:12-05:00,10134,AUH6YGBV8tDVX1E1WTo92Mubfx1DGsqfGeyUBqxo4fSr,33QZgMwmW32WuvmxD8XNbmF9ea88bLe3YTtNwHV73Wwu,True,3776045,944011,5881,2940,2941,HfEnetJ7uBSmZWCjBNxdvv9HEC5nsW4wDV7wu6WnhWan,235274,2633230,-2397956,623
2022-01-24 05:39:12-05:00,10135,cG5VSSaBpjNdRLMQT7dmotpcWRTfdmJZYdWsrzNzRTE,5RESxV6aZenjAdaqw1jxoYSGttpLrNuZiRJy2WeLAVJv,True,35753701,8938425,55502,27751,27751,HfEnetJ7uBSmZWCjBNxdvv9HEC5nsW4wDV7wu6WnhWan,2220101,24455337,-22235236,620
2022-01-24 05:39:12-05:00,10136,9otCHuzKcxUCC4EgPJkio8Df5gXWB6DtZQnZvWtPfsh6,8cNPdP8rA9sBpcKpmCNcp4W2AYonYdFNoyVmboT6y1Bb,True,118834639,29708659,184274,92137,92137,3zqXX6kzhkbW3d4TwD2CNjMRwxTbREXySekvq37kfCNk,7370969,48854229,-41483260,620
2022-01-24 05:39:12-05:00,10137,APbpwRCB9tfma8yoi8upe633XZBtNwc5zVxXVjLwhg8s,BBwryuZZ8msiSFNmGkh13Wgg1PoSutY2Ftgz8odcxPm4,True,1930968,482742,3015,1507,1508,3zqXX6kzhkbW3d4TwD2CNjMRwxTbREXySekvq37kfCNk,120639,2093692,-1973053,624
2022-01-24 05:39:36-05:00,10138,EDCJpkYBNcvKbqWmFwtnbeGYEiE6iACp4aQHgX5FXnNq,AubiccN4FqTZszcX3kJQQWc1JuDgDQG6XEN3TsTm55Zs,True,237993251,59498312,366311,183155,183156,HfEnetJ7uBSmZWCjBNxdvv9HEC5nsW4wDV7wu6WnhWan,14652474,61401885,-46749411,615
2022-01-24 05:39:37-05:00,10139,C33hfnDHzVwKXxr6AwFAXhd1vJYrPKhtqc75Qpjm19Zt,2WYBMSyrHQEYZqxEtxBMe2xn7eioJEGsudqdCmGvssGh,True,3022146,755536,4721,2360,2361,3zqXX6kzhkbW3d4TwD2CNjMRwxTbREXySekvq37kfCNk,188877,1178689,-989812,624
2022-01-24 05:39:37-05:00,10140,CcV2aMbd36MCH9wKTJPH1wyEUgErHBbT3gBWedPFeMgh,4nT6pkWKa6P8LmVX9Cur45xqJaqe3YnRFqjeFzUY9eMa,True,112743808,28185952,176011,88005,88006,3zqXX6kzhkbW3d4TwD2CNjMRwxTbREXySekvq37kfCNk,7040458,29431650,-22391192,624
2022-01-24 05:39:37-05:00,10141,56488NdcUy6Hi6X5SLs2GFtW5pG4u5wJpH7vHdxTCx4z,tGgXjJeVr3W2m3T2NXPCqpBEd6HJKE2cRsgCyiDZQy4,True,3287397,821848,5137,2568,2569,3zqXX6kzhkbW3d4TwD2CNjMRwxTbREXySekvq37kfCNk,205488,2263558,-2058070,625
2022-01-24 05:40:03-05:00,10142,4Eh2J8pz6nSz2E2BaPSMbDNhEovGA4QRmNtzAJPw9ZRi,CrHeEQC5KpQFLGhz2EpLYWgk7kWsqLPvEfLsSQvUxv61,True,12731809,3182952,19591,9795,9796,HfEnetJ7uBSmZWCjBNxdvv9HEC5nsW4wDV7wu6WnhWan,783645,9145665,-8362020,615
2022-01-24 05:40:03-05:00,10143,3VdSA9CED9f5swRwHX2U15U7J6Muaq8VPnCNy9CaGDHe,2YYstfnfdYic5NWmEbcUEHpccNUVd1EhuCkExvMsoMk8,True,90504,22626,139,69,70,HfEnetJ7uBSmZWCjBNxdvv9HEC5nsW4wDV7wu6WnhWan,5585,90566,-84981,617
2022-01-24 05:40:04-05:00,10144,FsMiJiJZibohKoV5QRisWCjzuFd86xSxFb4m73AQmu93,7p3TSKBaG9SV2YNDnhutQKacPKpTTmgsEfzmK51t6sYb,True,3767733,941933,5819,2909,2910,3zqXX6kzhkbW3d4TwD2CNjMRwxTbREXySekvq37kfCNk,232765,2596866,-2364101,617
2022-01-24 05:40:04-05:00,10145,H3394S5wdbwXB4scjGAY8NsXxCdGy1Xebct18s42FM1K,Hz84L1EquzhCvBJP75ScKug46hYGdNMVNH16AdG4y5D8,True,847788,211947,1306,653,653,3zqXX6kzhkbW3d4TwD2CNjMRwxTbREXySekvq37kfCNk,52263,649228,-596965,616
2022-01-24 05:40:04-05:00,10146,4MSyrHopFkuaCEEvLAUV9cJfVre6cLAx5sJF5LEMSCTX,6HhLHoswuDKrcixShWCDcquW6PgmbS5FidEnkM3bwuJQ,True,928167,232041,1451,725,726,HfEnetJ7uBSmZWCjBNxdvv9HEC5nsW4wDV7wu6WnhWan,58050,432851,-374801,625
2022-01-24 05:40:38-05:00,10147,AWvHDdb2ikqV8wc7qQ8azbvNTZdixMNxhQjhQdhayYtR,9EpgEPBb1nog6aQeFdMXfSRiLSnzGQFQ39mbLdCxgYTv,True,622037,155509,965,482,483,HfEnetJ7uBSmZWCjBNxdvv9HEC5nsW4wDV7wu6WnhWan,38609,413245,-374636,620
2022-01-24 05:40:38-05:00,10148,EitU96ThqHErybDn2j1NY6JHkqV1R3mWM1uWH7wYKr1T,2p9eYbLyBqXrhHtRKp1jJb7VGjCmb4LkA6kzqLr1ijet,True,2103230,525807,3241,1620,1621,HfEnetJ7uBSmZWCjBNxdvv9HEC5nsW4wDV7wu6WnhWan,129659,1377476,-1247817,616
2022-01-24 05:40:40-05:00,10149,A36aouot1oFLUtswuBUM4EVcis9chKaSJu53MRoPDjab,33U9gpq1RRFMGWDrWa3ezXXkwgBewdAS6QGgGVPtGvqb,True,4855548,1213887,7529,3764,3765,3zqXX6kzhkbW3d4TwD2CNjMRwxTbREXySekvq37kfCNk,301173,3340055,-3038882,620
2022-01-24 05:41:19-05:00,10150,3ogBPSRcKfmwzgumVDHBkXLi1eCsEFG2xzSJgD4LQDNy,7TXyqWgJqfe71MSWFA2n7ufZbUdzf7JJoWej8FNNtMXo,True,282482,70620,438,219,219,HfEnetJ7uBSmZWCjBNxdvv9HEC5nsW4wDV7wu6WnhWan,17543,215971,-198428,621
2022-01-24 05:41:19-05:00,10151,95yx3SCWcW9Cp8oSEDV68kGXRKWGyNdYUtNb5UnWMGBD,7PncaFWqW2iKR6EUKf78EW6LLZr7ZWU5b2d2rP22fsU3,True,3663756,915939,5651,2825,2826,HfEnetJ7uBSmZWCjBNxdvv9HEC5nsW4wDV7wu6WnhWan,226055,2890440,-2664385,617
2022-01-24 05:41:19-05:00,10152,5eMLdQ4gYA5iqvTXSNdGvctHp7s5VpyFuwtJKqx6chBc,Ckxc5K39nkBNXBTmFTM8J48R7wGqNm3vHKZu4G5baumZ,True,4393893,1098473,6713,3356,3357,HfEnetJ7uBSmZWCjBNxdvv9HEC5nsW4wDV7wu6WnhWan,268523,3134032,-2865509,611
2022-01-24 05:41:19-05:00,10153,CYkojG4q1SnizNs59qsYTEBU1c11XC8nteMhxRbwhCBq,A9MsPy3aeMzdQUWXK6qmWLiZfKREiBrSVaJAKp2nEcSt,True,301399,75349,461,230,231,HfEnetJ7uBSmZWCjBNxdvv9HEC5nsW4wDV7wu6WnhWan,18445,228721,-210276,611
2022-01-24 05:41:19-05:00,10154,8xvLGVeDmhVYQhN2ZpWkVG9jCrukRsNQ4926a4TMiZqa,9ciBySSjvADwp47WkETiFWZKVTFL8Hf1XvK7aSxhcgQS,True,334105,83526,502,251,251,HfEnetJ7uBSmZWCjBNxdvv9HEC5nsW4wDV7wu6WnhWan,20117,269921,-249804,602
2022-01-24 05:41:19-05:00,10155,zLTuMVfVswjMkhyvjaXnvjcKXv5xNk3iSWSjRGpVqXf,J3D8NHUJCiSjvFYfJ5Es4YDhF1KcPZWRUmCQ5L92t8eB,True,5727654,1431913,8618,4309,4309,3zqXX6kzhkbW3d4TwD2CNjMRwxTbREXySekvq37kfCNk,344723,2134330,-1789607,601
2022-01-24 05:41:19-05:00,10156,78EeyPYzQjrmW6z9VGhRci6ihMUZb5rtpXo3GAxugf55,9AgZ45TMxaqwWGVWSgnEkvio3s6fXtHjAVRVCA7Zgsd2,True,744745,186186,1146,573,573,HfEnetJ7uBSmZWCjBNxdvv9HEC5nsW4wDV7wu6WnhWan,45850,505812,-459962,615
2022-01-24 05:41:19-05:00,10157,JDeYjCLpfnzcfxDFgHf4aBcHsajwdR14GUaKAA9euzVf,EJbvKoyMZcoCx4vWa61uMbW2vr6mUhrgEuECdteVBuZZ,True,104384,26096,160,80,80,HfEnetJ7uBSmZWCjBNxdvv9HEC5nsW4wDV7wu6WnhWan,6439,107347,-100908,616
2022-01-24 05:41:19-05:00,10158,H1Z83zVoskNuBvYao1FjdLfETfhPpQFQUkniJfGxbaNz,EVqbBRV6Zy1tPLRevxpAykp8Mvv6tDZVTc4RmCKw4Gq1,True,36397437,9099359,56089,28044,28045,HfEnetJ7uBSmZWCjBNxdvv9HEC5nsW4wDV7wu6WnhWan,2243560,28139853,-25896293,616
2022-01-24 05:41:19-05:00,10159,CbhrZUdan1axNDFUrX1ZuEohfNMEGrszKSkk6pppVQuw,DHEAjJNtuEePezYAv77thWabbVxxqQpfuiC6moRSrpG1,True,1240884,310221,1918,959,959,HfEnetJ7uBSmZWCjBNxdvv9HEC5nsW4wDV7wu6WnhWan,76743,1241113,-1164370,618
2022-01-24 05:41:19-05:00,10160,7hTjPRQSYAoWHhtpsVz2oKK5SAuFJd8dPHShKgKJq8dy,6DcHcrtcXR88d8e2KahhAiWTeRznNfF8oXLHmh5wE7wz,True,12813875,3203468,19792,9896,9896,HfEnetJ7uBSmZWCjBNxdvv9HEC5nsW4wDV7wu6WnhWan,791684,9764534,-8972850,617
2022-01-24 05:41:19-05:00,10161,GYgxUfZ19oSyHuovGRA6gBJT32goSxCrKR8hQQdBsrRG,2r8c6SU74hRq7xEmYBJ92WoSB6v6XCAXR3JcDznfCxkN,True,388897519,97224379,587733,293866,293867,HfEnetJ7uBSmZWCjBNxdvv9HEC5nsW4wDV7wu6WnhWan,23509357,309585827,-286076470,604
2022-01-24 05:41:19-05:00,10162,G5NLYTLxDZfJFKsJdMeWS8Ez95ZFwR5AX4hKhnfVJvoE,AwrC3pKhTeEDr1HCTWoKWjadteZccvqcisbC7vxTjn7w,True,7179247,1794811,11070,5535,5535,3zqXX6kzhkbW3d4TwD2CNjMRwxTbREXySekvq37kfCNk,442814,7149669,-6706855,616
2022-01-24 05:41:20-05:00,10163,HpDwBPWZHfLzJUvTTABTA6qddyLLJiVTfqBx5gUktSUb,BqXLpaAeTNfNSeevfdazNqTgqEXj6Edgp8txWvCoxEz6,True,11707934,2926983,17745,8872,8873,3zqXX6kzhkbW3d4TwD2CNjMRwxTbREXySekvq37kfCNk,709807,11024992,-10315185,606
2022-01-24 05:41:20-05:00,10164,6VJcr3VAEcEZaHEpt48QL8QxHKABufVp8n2JSEVTLh9U,8naR6kiySKj3vai9dCetdgCnCHgf2oyLjGqKTJ3Lz64Y,True,43528184,10882046,65851,32925,32926,HfEnetJ7uBSmZWCjBNxdvv9HEC5nsW4wDV7wu6WnhWan,2634042,36032968,-33398926,605
2022-01-24 05:41:21-05:00,10165,9UKMqQgFYdJb5vXVqPhA8CAMRY1eifgWivANiKQqj3yb,DpE3uNQUZbyYnqjpfHWqp9CHqPBs2uTQLRM6AtzF6Por,True,4450223,1112555,6848,3424,3424,3zqXX6kzhkbW3d4TwD2CNjMRwxTbREXySekvq37kfCNk,273929,1985795,-1711866,615
2022-01-24 05:41:21-05:00,10166,Bsr6kx1B6BSEd5UnJ7Z61M49iUb3bFrDVhiEtMVtPDF2,3CFd1pUJAJPA9fobwn4Jj2mRju1CWmoop4Mh4znypNWT,True,392545,98136,607,303,304,3zqXX6kzhkbW3d4TwD2CNjMRwxTbREXySekvq37kfCNk,24298,294947,-270649,618
2022-01-24 05:42:29-05:00,10167,DXEJNyHSCbGZezXHy2xQaSzd37dwJs4dMTgt5VF5UZAG,7fCYM9DWrAX7vgZ11CwQMNd5NU8FB1yrbctxHaPYshpB,True,2133841,533460,3033,1516,1517,HfEnetJ7uBSmZWCjBNxdvv9HEC5nsW4wDV7wu6WnhWan,121350,990602,-869252,568
2022-01-24 05:42:29-05:00,10168,4WSiQCTqMvpSYvrbenQGFoV6fuDALSWMwZZ9MgP82fwb,6Y5GdgKErVfXrabSTi89X7xCEsZnoqDqwFD4hZ3FVtfN,True,5442962,1360740,7664,3832,3832,3zqXX6kzhkbW3d4TwD2CNjMRwxTbREXySekvq37kfCNk,306574,3857178,-3550604,563
2022-01-24 05:42:29-05:00,10169,J1sBDjpdBZcsSBS5eg95SSRjRqmQUR9cXJCsLJu8yCUt,F5wRpD2senMkGbL8Uquqo8W9x5NQDDa268dHuVFAZCww,False,219143,219143,10653,532,10121,3zqXX6kzhkbW3d4TwD2CNjMRwxTbREXySekvq37kfCNk,10653,152915,-142262,486
2022-01-24 05:42:29-05:00,10170,6fqbSyhh3PPdgRcLraHb7Jahj9s1oHHeX3SsjNSsGa6t,GpRUow48TYgttdYfsygbgjYQcmHyYjWETUDjDVphEgwq,True,923842766,230960690,1385951,692975,692976,3zqXX6kzhkbW3d4TwD2CNjMRwxTbREXySekvq37kfCNk,55438075,535034101,-479596026,600
2022-01-24 05:42:29-05:00,10171,C1CsbgQFvEvSXzuVHTr39tQHr3drDhjxeYiotd8eNocF,4rAaTCAMj5VpgNVKiYizabH7cMLhEA12seu2QXQNTyV3,True,1158894,289723,1634,817,817,HfEnetJ7uBSmZWCjBNxdvv9HEC5nsW4wDV7wu6WnhWan,65379,582980,-517601,564
2022-01-24 05:42:29-05:00,10172,DkKumyFA6dGw77wcwd16nWzTEC9McvmasAbmGfQXLkB7,9u6QyrruYFjhyLV5AXYUKkrBggzrxXfNH57smUAap5Ro,True,2738008,684502,3663,1831,1832,HfEnetJ7uBSmZWCjBNxdvv9HEC5nsW4wDV7wu6WnhWan,146538,1447074,-1300536,535
2022-01-24 05:42:29-05:00,10173,8Xt3qHjZG3zLxozgM5vPHMVxp8eYFMg89kaVW7vdHKoA,2i8riSsQpfADD9LUVpiBJBfX5qjVAgmZegzfKx6RG9dW,True,40190605,10047651,60083,30041,30042,3zqXX6kzhkbW3d4TwD2CNjMRwxTbREXySekvq37kfCNk,2403332,19997893,-17594561,597
2022-01-24 05:42:29-05:00,10174,HmspGdpobjC5Vbmo3FcKdw4RLPN7wJKxv3uKqDjVhLee,3YEX8TzdyJyuHo76Kw76imVCJjzrC9m188YuRKvwwSwD,True,19453698,4863424,26078,13039,13039,HfEnetJ7uBSmZWCjBNxdvv9HEC5nsW4wDV7wu6WnhWan,1043123,7979450,-6936327,536
2022-01-24 05:42:29-05:00,10175,FS5xx53Bo65G21gJLta7LEEiS132VJM1kGpUzuqyfzoy,2kbTLjdBBA9K1coxKmwmYbjq2heSnuNg4Nh2EfVNYgwj,True,2181000,545250,3304,1652,1652,HfEnetJ7uBSmZWCjBNxdvv9HEC5nsW4wDV7wu6WnhWan,132179,1287126,-1154947,606
2022-01-24 05:42:29-05:00,10176,DDsY5V3F9wnEGBoQFCEf1hvEYuKUaJdysbc7TxhNqe9G,5oBCGzvy8odB8MCxCUvPDqYCnTyteZ4Yy1JDroroygbi,True,3410164,852541,4986,2493,2493,HfEnetJ7uBSmZWCjBNxdvv9HEC5nsW4wDV7wu6WnhWan,199446,1537224,-1337778,584
2022-01-24 05:42:29-05:00,10177,BJUNK2orMVx6mYsD9pnQzmsEh95ZF2NWPm9KJ1ZM67Qn,FpxLa3DwWrspYvHVsScSDcscHB2eBHGxRrQ4gVvn4VW,True,932955935,233238983,1280750,640375,640375,3zqXX6kzhkbW3d4TwD2CNjMRwxTbREXySekvq37kfCNk,51230033,276698679,-225468646,549
2022-01-24 05:42:29-05:00,10178,AoPQqPjLPi8fZiLkhMGLRj6oD5k2asrvJtCkpW19DvGr,H5Sgmf1VuY13iHjPuLJ2q9wtSdkXG1AQsEv2eq6zzm8Y,True,24970852,6242713,36470,18235,18235,HfEnetJ7uBSmZWCjBNxdvv9HEC5nsW4wDV7wu6WnhWan,1458820,8124364,-6665544,584
2022-01-24 05:42:29-05:00,10179,8abFwhhZyq3xkvjp4NWDBt7qAPXBbzBxksUk8SAUeVkN,A9u4dhWZbBwthC4WXQg1Dfp3wHYXr67SGs5na1EQ1k3r,True,4674700,1168674,7193,3596,3597,HfEnetJ7uBSmZWCjBNxdvv9HEC5nsW4wDV7wu6WnhWan,287732,1726620,-1438888,615
2022-01-24 05:42:29-05:00,10180,8trFFwvXKKMwMx952ugCZmqyw29e1HxEKBuQmFn8ZwTf,FsD7gCvHXM3QchQiDcd292ksy5afZMWApneNTat5ndeS,True,13867832,3466958,21329,10664,10665,HfEnetJ7uBSmZWCjBNxdvv9HEC5nsW4wDV7wu6WnhWan,853187,5892825,-5039638,615
2022-01-24 05:42:29-05:00,10181,C21232Uu2r4AmbR3mzrEKF5ZHoFDZbCmy88x8u6cLyZV,8sppny1HRFKX6LuqT6KDn1x9wS7z61K9V5akSuAimxgS,True,471908517,117977129,657160,328580,328580,HfEnetJ7uBSmZWCjBNxdvv9HEC5nsW4wDV7wu6WnhWan,26286416,147654988,-121368572,557
2022-01-24 05:42:29-05:00,10182,J6jBKPDR6R5cLMqLufw3zoVfheNYs1KF7C4Ft2dakXeA,6wTTLK675Ym6toJRp7tYaUZzisWfgGjSp3X3yJ31xiKt,True,3389884,847471,5017,2508,2509,3zqXX6kzhkbW3d4TwD2CNjMRwxTbREXySekvq37kfCNk,200682,1785351,-1584669,592
2022-01-24 05:42:30-05:00,10183,5gcF5a6vf5iHAnhKHhcfceXicrefXZ9L7PzqjjrzRm48,5VE1AGgChUAW2iR4iKiznUCqtu87q8R2cdWeSuFYXjYo,True,25880776,6470194,40242,20121,20121,HfEnetJ7uBSmZWCjBNxdvv9HEC5nsW4wDV7wu6WnhWan,1609692,11242786,-9633094,621
2022-01-24 05:42:30-05:00,10184,4vW2Q76fdGmfhU2Tx3R2XQkGcQUi6hSM9ixvK5RWvurJ,w8cGbqVpVr6WHSRJFXv469RMgRB3ty3TGpkVXRs7K7H,True,4510332,1127583,6594,3297,3297,3zqXX6kzhkbW3d4TwD2CNjMRwxTbREXySekvq37kfCNk,263779,1883351,-1619572,584
2022-01-24 05:42:30-05:00,10185,B9WJfmrYEkVH3L1UWz4qqWpaexHydymbzvEfwNVtB9BV,6mQb4yzGq8jE1NbweKCKSbevnnYVhHYxyc6Gz2a5kJLn,True,15551344,3887836,23209,11604,11605,3zqXX6kzhkbW3d4TwD2CNjMRwxTbREXySekvq37kfCNk,928370,6615854,-5687484,596
2022-01-24 05:42:30-05:00,10186,A1VornXbzK5rFgsy9D4qThcPnYVP8AB9RRzWsV1h6L17,9M4dQgz1zWrtKHqZMt9w7PbM9CvmyjhY5ZZ6jjajMzqm,True,2271695,567923,3408,1704,1704,3zqXX6kzhkbW3d4TwD2CNjMRwxTbREXySekvq37kfCNk,136322,1020732,-884410,600
2022-01-24 05:42:30-05:00,10187,2JXP6KUwPSmCrXT2uQRqSoCwH8RLYWwmqYsj3zXtv9xF,4qcFVgugXsHVQzFRP2he9CVzvv47xqgokJjigee8oPpP,True,115183069,28795767,173061,86530,86531,3zqXX6kzhkbW3d4TwD2CNjMRwxTbREXySekvq37kfCNk,6922444,46325048,-39402604,600
2022-01-24 05:42:31-05:00,10188,GNkEoVMpNAgfyDBZ986MR9BEVc485xpLuZWwSCyZk5zJ,AT2eiaMyZNHZGqgTdie8QjLWCTrWSdkRmQxU2vZNgtDs,True,2733160,683290,4273,2136,2137,3zqXX6kzhkbW3d4TwD2CNjMRwxTbREXySekvq37kfCNk,170939,1095586,-924647,625
2022-01-24 05:42:31-05:00,10189,2mfcg17QocKKvDcqDH88TwxHRiS8dAQiJAGoAh1brns9,8aQLELBgaA9eXsxSciMjxWv8B1hpbUPfLwqVjEnasZbe,True,7599122,1899780,11879,5939,5940,3zqXX6kzhkbW3d4TwD2CNjMRwxTbREXySekvq37kfCNk,475178,3566004,-3090826,625
2022-01-24 05:43:10-05:00,10190,Fani89KviVFZek4si6YZ3apVuM2kSqVUijDnLBqtvJEH,EpC29dECx1cLC69bj2ncG3jFp7obPaxbH7F6mju27cwL,True,294177,73544,456,228,228,HfEnetJ7uBSmZWCjBNxdvv9HEC5nsW4wDV7wu6WnhWan,18271,139271,-121000,621
2022-01-24 05:43:10-05:00,10191,D64rDiWT3YG28fCgXCmbNjYa2JakZbpKQ1D2XuLChUfV,8WmMWq8cTsGQym5pUbHm9dPCpJugBeWUMVERYFGLxWHj,True,478536,119634,746,373,373,HfEnetJ7uBSmZWCjBNxdvv9HEC5nsW4wDV7wu6WnhWan,29873,344079,-314206,624
2022-01-24 05:43:10-05:00,10192,ATS5VRAN1aPKBiATDcUs5yd6yVuTmWqrqqRFNdfz6DZT,7VKq4rZLEtY2dhDFZMTQMvCYyJa1ASM9RHobUaYhHWAe,True,4433710,1108427,6874,3437,3437,HfEnetJ7uBSmZWCjBNxdvv9HEC5nsW4wDV7wu6WnhWan,274966,2996499,-2721533,620
2022-01-24 05:43:30-05:00,10193,9Ft21UZ66egkMCtZprBPc72WF1aj2fQwLs6XJWPXUbUV,6DGSgHegc23W5MQ6hqSsSSdwNvRqU3piR9GBoZ6fU23f,True,37243269,9310817,57895,28947,28948,HfEnetJ7uBSmZWCjBNxdvv9HEC5nsW4wDV7wu6WnhWan,2315802,17934029,-15618227,621
2022-01-24 05:43:30-05:00,10194,2aK454FrEuA6JQZo2hLUabd4E6wyQtVuJWw2rWz2pGVy,3dJvhEh7kykf8hCCWQRarh2s5ybJUAzbaPdDUmX4XokW,True,55912932,13978233,87051,43525,43526,3zqXX6kzhkbW3d4TwD2CNjMRwxTbREXySekvq37kfCNk,3482068,17634906,-14152838,622
2022-01-24 05:43:41-05:00,10195,HELPNUwAqTX7gfHS4cnJnqXFM6Rb156tYcpsitKR9iDu,3RdfgDvLvsdZG5Cf6hKiKMQMqfidyxHzjYvUx1FZpeHQ,True,2399293,599823,3730,1865,1865,HfEnetJ7uBSmZWCjBNxdvv9HEC5nsW4wDV7wu6WnhWan,149224,2760382,-2611158,621
2022-01-24 05:43:46-05:00,10196,EXP61AETWHw3kHSjrJH1jQBt6cXR9Zebz34Cueb3KAzg,2JT9GrgdUKjuQQtXvZqevbjFquUQBMYDoADmBjDKWXj3,True,6911686,1727921,10656,5328,5328,HfEnetJ7uBSmZWCjBNxdvv9HEC5nsW4wDV7wu6WnhWan,426274,4914857,-4488583,616
2022-01-24 05:43:46-05:00,10197,EAtQUZAkQxwJF779DwPcWHZ455FzYX8mzm1uV5LBnhPB,8h8t6GW1Y7xMBfWpfyFfUVBP4apMbJVNg7igZUYZLsyr,True,1702384,425596,2607,1303,1304,3zqXX6kzhkbW3d4TwD2CNjMRwxTbREXySekvq37kfCNk,104301,935471,-831170,612
2022-01-24 05:43:54-05:00,10198,GQviUdocJ1s4FsVDDexanvo5yQWRZgwwkGJBCg7TMtJC,HAX4VAKgQpKtm1149iRgtzvUaUkiXWcA1bJ9ERu6tXkd,True,1496068,374017,2338,1169,1169,HfEnetJ7uBSmZWCjBNxdvv9HEC5nsW4wDV7wu6WnhWan,93541,821302,-727761,625
2022-01-24 05:43:57-05:00,10199,GqPZDwm3EWGMiVy7BY6qHM4Vzt2B9vW3Zs1CLScrtjAD,63h2HEdkmc54a8txd4LZ69TUBLR6VphxBoXLx6hjCLg4,True,408226075,102056518,633992,316996,316996,3zqXX6kzhkbW3d4TwD2CNjMRwxTbREXySekvq37kfCNk,25359714,123775060,-98415346,621
2022-01-24 05:43:59-05:00,10200,2niazdR63iWLyZ3ABWZVAnJiEjVyDyLGo4jZ6wh3j2Zz,4RvU5UtyE5CqMStPciiCTdhYCdaUUfdKSYS5nkATs1qn,True,1513608,378402,2350,1175,1175,3zqXX6kzhkbW3d4TwD2CNjMRwxTbREXySekvq37kfCNk,94029,832408,-738379,621
2022-01-24 05:43:59-05:00,10201,GHn96Ev7UmKJWqch3H3wzXpRT7qLg5FBuSBJAATVED1f,BXBSUddfz9MThXqk4517M7YVRDGdTm4pC6G4ipT69TMV,True,1206518,301629,1883,941,942,HfEnetJ7uBSmZWCjBNxdvv9HEC5nsW4wDV7wu6WnhWan,75352,661414,-586062,624
2022-01-24 05:43:59-05:00,10202,6k9unyyhVTrGhAhBrFjgumRfBtKFRBrVaeWtYB56LgEg,3n9VYUH53fxmwFwdYKT9xAZYDzjodhMsJ5iGAoJTqCt4,True,1513745,378436,2365,1182,1183,HfEnetJ7uBSmZWCjBNxdvv9HEC5nsW4wDV7wu6WnhWan,94637,832878,-738241,625
2022-01-24 05:44:00-05:00,10203,F1G1Yb2jhT1hULYuNM9QMuNNA6vHZ2Wg4LhFGWsJmr78,2oF52s77UVwjbZMLmxyNsGRZ36RHqSJiV5VL7FzoWgyB,True,34733185,8683296,54153,27076,27077,3zqXX6kzhkbW3d4TwD2CNjMRwxTbREXySekvq37kfCNk,2166144,18611907,-16445763,623
2022-01-24 05:44:00-05:00,10204,F6wpqqx576XRuYo8y6XPLYphojrQtK4VvdY79Jk6My5N,38VbNLaQzLFcVqHuSR9zn9UX3Yv9SCVy1mrwmxX9PpVQ,True,32990815,8247703,51606,25803,25803,HfEnetJ7uBSmZWCjBNxdvv9HEC5nsW4wDV7wu6WnhWan,2064240,9285705,-7221465,625
2022-01-24 05:44:00-05:00,10205,CYQr97qwLjGnmEy6vVgs3eL7omwG6UfFbhTv7gBty5z9,DJJ9UqSZUTgyt2yWAkUnGFDuox3xYFQUuorLa7qPdM88,True,12479656,3119914,19488,9744,9744,HfEnetJ7uBSmZWCjBNxdvv9HEC5nsW4wDV7wu6WnhWan,779550,5171533,-4391983,624
2022-01-24 05:44:19-05:00,10206,7ayTm4uC5VbtMt9w6g9tFban4fYVwbqCzJZpiFMjmBiB,BvidnEZHHtXVhtgv4qFKThEaFZsFmyAuDVqZQwMppjSg,True,651185036,162796259,1014211,507105,507106,HfEnetJ7uBSmZWCjBNxdvv9HEC5nsW4wDV7wu6WnhWan,40568442,479899906,-439331464,622
2022-01-24 05:44:31-05:00,10207,3Xbsek5MsEGoWr3G9yhuohREr26B2vSQcjqXdspTFHta,2rPxkUiMo9wGDq8EvAiwY3ngRpKmL223cBWWNTYoBmFp,True,563127,140781,872,436,436,HfEnetJ7uBSmZWCjBNxdvv9HEC5nsW4wDV7wu6WnhWan,34912,402573,-367661,619
2022-01-24 05:44:31-05:00,10208,98pwBGgiSDuwuas6WYW2hc9qUxfULwvNE34aixaxbxXY,BLrjKxekjThtJ9rKtQxs1Y4rZ225EE2Q16VkP9TkThyV,True,1177378,294344,1818,909,909,HfEnetJ7uBSmZWCjBNxdvv9HEC5nsW4wDV7wu6WnhWan,72730,656402,-583672,617
2022-01-24 05:44:32-05:00,10209,28JujYG1mbpYSjF7LNqXpup17TXb45VJHhhnFMVXtft2,DAqyVExAtmsovPGrkpkFDxm6T7pKWLztfh9iPjTNDqrd,True,1862284,465571,2887,1443,1444,HfEnetJ7uBSmZWCjBNxdvv9HEC5nsW4wDV7wu6WnhWan,115502,1039670,-924168,620
2022-01-24 05:44:32-05:00,10210,G3vArDs7nb18se4xMZ68oMHmTAsYP63x8dfY57jAogwp,EY7J8Hw8jWbryw11CYdPVUSdAoDGGNEfacqghVnJn3JK,True,4354260,1088565,6774,3387,3387,HfEnetJ7uBSmZWCjBNxdvv9HEC5nsW4wDV7wu6WnhWan,270988,2429307,-2158319,622
2022-01-24 05:44:32-05:00,10211,EDSf2w1UyGvbgMuxyoXL58ifR1dviZinnLBYnFmgjcNG,DFenkzbL9SUjs9cSCaHJ1eXK75mHfk3GSPRFs8TSzrFV,True,17177838,4294459,26800,13400,13400,HfEnetJ7uBSmZWCjBNxdvv9HEC5nsW4wDV7wu6WnhWan,1072030,10573005,-9500975,624
2022-01-24 05:44:54-05:00,10212,7FB6X8YgiDn7YK9bZZmcFyzhuvVLVWPCfBbenwMXhx5,2EaDCpL9MpAKuiC2bvUCGRfvqYvgVXGFHXt35QdNakfG,True,1066176,266544,1663,831,832,HfEnetJ7uBSmZWCjBNxdvv9HEC5nsW4wDV7wu6WnhWan,66559,407620,-341061,624
2022-01-24 05:44:57-05:00,10213,33CE2t84MhG7SMsphhZaxvwFVRbK5wcUMUdEw8UBhoq8,DjNko7SbbK9nQT4K5oBWKiSiXiYS9Rv1k5vT3PNiMyaf,True,1062388,265597,1648,824,824,HfEnetJ7uBSmZWCjBNxdvv9HEC5nsW4wDV7wu6WnhWan,65927,782142,-716215,620
2022-01-24 05:46:03-05:00,10214,AgokoeqypXXfMsjAyBXPRrJFGeP7B7D6SXvnGUTwMdap,53zBz3fTZisWQH1v6NHyhCdpLXx5NaPNp7uW9KPXLDan,True,14881738,3720434,23224,11612,11612,HfEnetJ7uBSmZWCjBNxdvv9HEC5nsW4wDV7wu6WnhWan,928988,8542250,-7613262,624
2022-01-24 05:46:12-05:00,10215,2jDRvE3pQNjWy1NRFa4tzB3KmU5UkbUCHw8sQRFujo66,C4zNi2szDrEEh4coTF3WRUghfP4ZwAVVSYTLWfkejQRu,True,2547254,636813,3969,1984,1985,HfEnetJ7uBSmZWCjBNxdvv9HEC5nsW4wDV7wu6WnhWan,158781,2176488,-2017707,623
2022-01-24 05:46:12-05:00,10216,4KMzwWHPeW51cxu4nMpbqCaqo96dMqaHWyRCGQktfQfd,F7q4GNYcbnZa8dJ4qovQwjmxpKpdEmdxQMXRPb9nQupa,True,12804181,3201044,19937,9968,9969,HfEnetJ7uBSmZWCjBNxdvv9HEC5nsW4wDV7wu6WnhWan,797506,5181861,-4384355,622
2022-01-24 05:46:22-05:00,10217,H1oYXGZTagwv48FdDe6RNkjNaesedqLKyXxTmPc5k4Fp,Am3rx6XrkrZ4MdeZDyZUv1YW2fBujcz4dLjVCnRQHKZa,True,85087882,21271970,133064,66532,66532,HfEnetJ7uBSmZWCjBNxdvv9HEC5nsW4wDV7wu6WnhWan,5322578,29195340,-23872762,625
2022-01-24 05:46:22-05:00,10218,H3x9b27yHVdCxvtDf7mmJxkNeubcmQMwfAkLTYADPWNv,HGVCCz23rWx78vrTB2wvm2aesbLZuYFhhNuznGiSSAyA,True,154992845,38748211,239392,119696,119696,HfEnetJ7uBSmZWCjBNxdvv9HEC5nsW4wDV7wu6WnhWan,9575706,65866578,-56290872,617
2022-01-24 05:46:22-05:00,10219,CLVUzXSNsQnX7n5cvxMuTjyMSjy1pNpPnWejFaeuonvb,BXZzBujr8DAUcGJcHQBaz1ZSwkATAHg3NX3bLnrjQpLh,True,9024410,2256102,13929,6964,6965,HfEnetJ7uBSmZWCjBNxdvv9HEC5nsW4wDV7wu6WnhWan,557183,2884296,-2327113,617
2022-01-24 05:48:38-05:00,10220,4ne6vC7qdxQYHJCsaeFAKZrKdFt2SwXGHQ3jrMHqt4DL,Cf1dLHY2WXH9rXbRKq5TT8THbdo9SdNUZq4rYhRCF9z,True,205533,51383,320,160,160,HfEnetJ7uBSmZWCjBNxdvv9HEC5nsW4wDV7wu6WnhWan,12800,156043,-143243,622
2022-01-24 05:50:15-05:00,10221,EXP61AETWHw3kHSjrJH1jQBt6cXR9Zebz34Cueb3KAzg,2JT9GrgdUKjuQQtXvZqevbjFquUQBMYDoADmBjDKWXj3,True,5083184,1270796,7875,3937,3938,HfEnetJ7uBSmZWCjBNxdvv9HEC5nsW4wDV7wu6WnhWan,315037,3782058,-3467021,619
2022-01-24 05:50:15-05:00,10222,EAtQUZAkQxwJF779DwPcWHZ455FzYX8mzm1uV5LBnhPB,8h8t6GW1Y7xMBfWpfyFfUVBP4apMbJVNg7igZUYZLsyr,True,1252015,313003,1923,961,962,HfEnetJ7uBSmZWCjBNxdvv9HEC5nsW4wDV7wu6WnhWan,76921,725072,-648151,614
2022-01-24 05:50:16-05:00,10223,4SQQdHTJUDv8taPXQRvEVJpUu91iCWQsv9su8tfehaQG,33CJXj1pmmatAofRvgt5in9E6SLEuy7tq4jqSwnUWP2A,True,153161109,38290277,238144,119072,119072,3zqXX6kzhkbW3d4TwD2CNjMRwxTbREXySekvq37kfCNk,9525776,165160655,-155634879,621
2022-01-24 05:50:32-05:00,10224,GQviUdocJ1s4FsVDDexanvo5yQWRZgwwkGJBCg7TMtJC,HAX4VAKgQpKtm1149iRgtzvUaUkiXWcA1bJ9ERu6tXkd,True,1099596,274899,1718,859,859,HfEnetJ7uBSmZWCjBNxdvv9HEC5nsW4wDV7wu6WnhWan,68748,637024,-568276,625
2022-01-24 05:50:32-05:00,10225,2niazdR63iWLyZ3ABWZVAnJiEjVyDyLGo4jZ6wh3j2Zz,4RvU5UtyE5CqMStPciiCTdhYCdaUUfdKSYS5nkATs1qn,True,1113194,278298,1741,870,871,3zqXX6kzhkbW3d4TwD2CNjMRwxTbREXySekvq37kfCNk,69667,645464,-575797,625
2022-01-24 05:50:38-05:00,10226,GHn96Ev7UmKJWqch3H3wzXpRT7qLg5FBuSBJAATVED1f,BXBSUddfz9MThXqk4517M7YVRDGdTm4pC6G4ipT69TMV,True,886228,221557,1370,685,685,HfEnetJ7uBSmZWCjBNxdvv9HEC5nsW4wDV7wu6WnhWan,54808,513016,-458208,618
2022-01-24 05:50:38-05:00,10227,6k9unyyhVTrGhAhBrFjgumRfBtKFRBrVaeWtYB56LgEg,3n9VYUH53fxmwFwdYKT9xAZYDzjodhMsJ5iGAoJTqCt4,True,1111897,277974,1721,860,861,HfEnetJ7uBSmZWCjBNxdvv9HEC5nsW4wDV7wu6WnhWan,68860,645954,-577094,619
2022-01-24 05:50:39-05:00,10228,GBpe8E33cNkFmMUuP3WjhDBBuQz7MHaDkpCJjGFaFkvu,3QYFKkgzZ1PKKAxCh4hMhgqrupoCcfRVkjuJZRWVZo3H,True,2195522,548880,3429,1714,1715,HfEnetJ7uBSmZWCjBNxdvv9HEC5nsW4wDV7wu6WnhWan,137160,1421742,-1284582,624
2022-01-24 05:50:52-05:00,10229,5NVD6QvomTAD35yNxSFZw4DhF2hCtV8drkbnGhBVtK5y,3JzkyPnREvoFZLL9JZuuDEnee3nuKcrqY3xLuXsmHwRo,True,227144,56786,355,177,178,HfEnetJ7uBSmZWCjBNxdvv9HEC5nsW4wDV7wu6WnhWan,14213,232436,-218223,625
2022-01-24 05:50:56-05:00,10230,7ayTm4uC5VbtMt9w6g9tFban4fYVwbqCzJZpiFMjmBiB,BvidnEZHHtXVhtgv4qFKThEaFZsFmyAuDVqZQwMppjSg,True,478637873,119659468,745083,372541,372542,HfEnetJ7uBSmZWCjBNxdvv9HEC5nsW4wDV7wu6WnhWan,29803327,369064809,-339261482,622
2022-01-24 05:50:59-05:00,10231,F9s8a7Cpiw5dw3a2aNFMofqwyDWNXvDLnSdJzoj1gRiV,GpKsQKJD79KBRWdCTkyi4zX7NaoCWsLUjrKxAwJB6o6s,True,113487,28371,176,88,88,3zqXX6kzhkbW3d4TwD2CNjMRwxTbREXySekvq37kfCNk,7064,75053,-67989,622
2022-01-24 05:51:08-05:00,10232,64Diz8zzEv1jDWnBQPTHPpXwaWf7vjM19RyJmkPy1viQ,G8wkGHRHMtT3mvXBkH3zgsKNs8wbpdiPUS17y4cozhkZ,True,106787413,26696852,165065,82532,82533,3zqXX6kzhkbW3d4TwD2CNjMRwxTbREXySekvq37kfCNk,6602634,42698417,-36095783,618
2022-01-24 05:51:09-05:00,10233,3Xbsek5MsEGoWr3G9yhuohREr26B2vSQcjqXdspTFHta,2rPxkUiMo9wGDq8EvAiwY3ngRpKmL223cBWWNTYoBmFp,True,413883,103470,639,319,320,HfEnetJ7uBSmZWCjBNxdvv9HEC5nsW4wDV7wu6WnhWan,25577,309787,-284210,617
2022-01-24 05:51:09-05:00,10234,28JujYG1mbpYSjF7LNqXpup17TXb45VJHhhnFMVXtft2,DAqyVExAtmsovPGrkpkFDxm6T7pKWLztfh9iPjTNDqrd,True,1368727,342181,2115,1057,1058,HfEnetJ7uBSmZWCjBNxdvv9HEC5nsW4wDV7wu6WnhWan,84629,805742,-721113,618
2022-01-24 05:51:09-05:00,10235,98pwBGgiSDuwuas6WYW2hc9qUxfULwvNE34aixaxbxXY,BLrjKxekjThtJ9rKtQxs1Y4rZ225EE2Q16VkP9TkThyV,True,865341,216335,1330,665,665,HfEnetJ7uBSmZWCjBNxdvv9HEC5nsW4wDV7wu6WnhWan,53219,508667,-455448,615
2022-01-24 05:51:10-05:00,10236,EDSf2w1UyGvbgMuxyoXL58ifR1dviZinnLBYnFmgjcNG,DFenkzbL9SUjs9cSCaHJ1eXK75mHfk3GSPRFs8TSzrFV,True,12625245,3156311,19677,9838,9839,HfEnetJ7uBSmZWCjBNxdvv9HEC5nsW4wDV7wu6WnhWan,787096,8170970,-7383874,623
2022-01-24 05:51:10-05:00,10237,BgNgALwBEuiumVgiXRmBZRnyFrr9QTDy2maHzsNwNHGf,ag35Ec2uFtqkarizCxFyhM2SPBuUwfmLRhAdFEWFCNa,True,1279732,319933,2000,1000,1000,3zqXX6kzhkbW3d4TwD2CNjMRwxTbREXySekvq37kfCNk,80001,699985,-619984,625
2022-01-24 05:51:10-05:00,10238,G3vArDs7nb18se4xMZ68oMHmTAsYP63x8dfY57jAogwp,EY7J8Hw8jWbryw11CYdPVUSdAoDGGNEfacqghVnJn3JK,True,3200259,800064,4969,2484,2485,3zqXX6kzhkbW3d4TwD2CNjMRwxTbREXySekvq37kfCNk,198778,1882954,-1684176,621
2022-01-24 05:51:10-05:00,10239,7dmoK7QPki7R66SPQST4veUgVfnJbVToxxBPZveECiwK,4vh4REBDm5zBDmcjRCD9zNsny1HGneu7B2co4dSJNLL6,True,1685407,421351,2634,1317,1317,HfEnetJ7uBSmZWCjBNxdvv9HEC5nsW4wDV7wu6WnhWan,105365,1709064,-1603699,625
2022-01-24 05:51:17-05:00,10240,3FF2rhr1RuT7UR7MmmGtrhfYbh6kbc5UXq51KmqFLZnq,AEmSYLt1dQ8suLugC4Lcw4kF3dG9GYcEfX54hEAKfmv5,True,1047966,261991,1630,815,815,3zqXX6kzhkbW3d4TwD2CNjMRwxTbREXySekvq37kfCNk,65234,600776,-535542,622
