ts,record_id,user_authority,user,partial,base_asset_value,base_asset_value_closed,liquidation_fee,fee_to_liquidator,fee_to_insurance_fund,liquidator,total_collateral,collateral,unrealized_pnl,margin_ratio
2022-01-22 01:27:30-05:00,7169,FV9CBGGTbppLnBKh79f2LzD1diTiS5g6u89FcpZHZmnK,Fe7mtmCUziFqbbYTvrhAcAq1Ub7YLfTJRtQ1hG7GzJD1,True,172501,43125,251,125,126,4BnQKPLuE3DMTtxp8MjUBytgnhvxqq3ZTqZHTVZo4JJh,10079,123078,-112999,584
2022-01-22 01:27:30-05:00,7170,DGAQzgZhS2yioeZmG3cbacM3hdz4F1aZn1PWRwgiFukc,48KUtJaNCPNxkLXJBtWAdDxY4b9vZzLgbGxTNdwMqmjz,True,16562960,4140740,22654,11327,11327,72FwbpFGoLEazJEdpqNtPNefsadUrimUqma9wSoy4qiS,906199,13287555,-12381356,547
2022-01-22 01:27:30-05:00,7171,8CQ8wTkDHxhDjxtARpqi1NvwhgvifEgmmsaZi53L6rDM,6BgagW5MLhH3tXKPVyN6ZDotT1TkcZ2bb3kNBKLY3cKm,True,4834967,1208741,6786,3393,3393,72FwbpFGoLEazJEdpqNtPNefsadUrimUqma9wSoy4qiS,271467,3919541,-3648074,561
2022-01-22 01:27:30-05:00,7172,96StvqZyFUPtyMr4o9s7K4V29RSNyRpVi76vNwxG5rUf,GZKXFSFq4aGiTaqovtxqNCCVGkAFNXPh4Hep1ZMwdZ8g,True,732102,183025,1083,541,542,HfEnetJ7uBSmZWCjBNxdvv9HEC5nsW4wDV7wu6WnhWan,43346,953810,-910464,592
2022-01-22 01:27:30-05:00,7173,CCi9urfx5bFFMazAAVz1WtJzJotHA8E1i8RrtgMP97Fp,2DFvm5fZj29qvqoLmbReUaisd9qBTNUfuE7HgmmHUc7w,True,2499821,624955,3242,1621,1621,4BnQKPLuE3DMTtxp8MjUBytgnhvxqq3ZTqZHTVZo4JJh,129681,2342776,-2213095,518
2022-01-22 01:27:30-05:00,7174,BjyZWwz1ARSfmPkHXHBzehq5NsH4DRJiu4zFMkqsKu6A,7WUCSZ9SnKDsbomDRZ7CKsHfHJFwboKJwFFdaGkBURBS,True,153772348,38443087,193406,96703,96703,4BnQKPLuE3DMTtxp8MjUBytgnhvxqq3ZTqZHTVZo4JJh,7736267,107092361,-99356094,503
2022-01-22 01:27:30-05:00,7175,5SskSWkRPP5BNaqvHkJCbTAgHPUkHEwFh5pFr4t8PoBr,EqdX8Sdm9LCfdrzVKzisKaFcP2YEdSRNZYmev5RWjGqb,False,123341,123341,6083,304,5779,72FwbpFGoLEazJEdpqNtPNefsadUrimUqma9wSoy4qiS,6083,62226,-56143,493
2022-01-22 01:27:30-05:00,7176,FS5xx53Bo65G21gJLta7LEEiS132VJM1kGpUzuqyfzoy,2kbTLjdBBA9K1coxKmwmYbjq2heSnuNg4Nh2EfVNYgwj,True,24627216,6156803,33858,16929,16929,3zqXX6kzhkbW3d4TwD2CNjMRwxTbREXySekvq37kfCNk,1354324,10048850,-8694526,549
2022-01-22 01:27:30-05:00,7177,duKo8riX1qpX1K1qpgwZniMtUeWqu2eYgchTu5n7Rbu,9vAVwfVtdsaZMbeZvoymjHqwASeuM38gfEJkbTVwDqya,False,2109229,2109229,99557,4977,94580,72FwbpFGoLEazJEdpqNtPNefsadUrimUqma9wSoy4qiS,99557,1537734,-1438177,472
2022-01-22 01:27:30-05:00,7178,GWkVXmZNQdcdWNNu8dvRqct4aMhLoDNqijrTvxbfEdKN,6LKRNbJv2XkyjJQKCFAqFRPzvANrRBSTmu8doRWqTicU,False,3415895,3415895,160531,8026,152505,4BnQKPLuE3DMTtxp8MjUBytgnhvxqq3ZTqZHTVZo4JJh,160531,1603945,-1443414,469
2022-01-22 01:27:30-05:00,7179,8hpAXzimCw2bTwLXoRFAbqNW8qoj5VV3JDYCuJwqHpHm,DkfsL2M7oRBX6grAfy15C4urwL6ToMJ7TWJEFAGhWjYX,False,291189,291189,14278,713,13565,4BnQKPLuE3DMTtxp8MjUBytgnhvxqq3ZTqZHTVZo4JJh,14278,145023,-130745,490
2022-01-22 01:27:30-05:00,7180,D2L7ST8iGsRfZ4zj2pdfKTptbojQ4cDtHKQ8ngcFVQwA,7cNrHGWJ6FGGazfGaCePs8XyaK6bwVLrYFCUJQi9w2Wc,True,2130,532,2,1,1,4BnQKPLuE3DMTtxp8MjUBytgnhvxqq3ZTqZHTVZo4JJh,108,1585,-1477,507
2022-01-22 01:27:30-05:00,7181,8MGEQ1KEMv9WSgVifjN7CQ7tDbJBJbWgGYu71dTDKEPQ,mQY2X9KYVXf9JmGY8XwMK4G8odM4HmWkgEmYYqKnkvF,True,5452571,1363142,7766,3883,3883,4BnQKPLuE3DMTtxp8MjUBytgnhvxqq3ZTqZHTVZo4JJh,310651,4676814,-4366163,569
2022-01-22 01:27:30-05:00,7182,46TNhGwBVzedW8xSb9UY94HNeSom9iGiZzAjrKHiRM2G,7JVTiqNYeKHbyzRkKtvSEpqLPKykZso8cGUr3sX1j7QF,True,8688223,2172055,12280,6140,6140,72FwbpFGoLEazJEdpqNtPNefsadUrimUqma9wSoy4qiS,491215,4822168,-4330953,565
2022-01-22 01:27:30-05:00,7183,2F45BX9mRmtNCHPejKFknN5aNgGvR4vVLFjMaY1a7dR8,ALdSutsvEFRUEQGGBbi31QywTL1pdXSDWrNJzvNTaoXL,True,789681,197420,1000,500,500,4BnQKPLuE3DMTtxp8MjUBytgnhvxqq3ZTqZHTVZo4JJh,40028,642214,-602186,506
2022-01-22 01:27:30-05:00,7184,ymyzGH4Qc7HH5PbKpVphCbsQgLLXyGkPcXamQJuNj5C,8oTLHaV2XzbKXNWRuUjCfHjUn61Pw93LYK14m9q2VDpZ,True,436003,109000,628,314,314,72FwbpFGoLEazJEdpqNtPNefsadUrimUqma9wSoy4qiS,25153,307881,-282728,576
2022-01-22 01:27:31-05:00,7185,AATMHH4e4B6SL9bThnXGktzWuqWkPdx3JbRXk8HwkbPW,6F3u2yLx7P9gtpAAXASx7uF8xNyVBgJiKosMKUrgpicA,True,7882555,1970638,10060,5030,5030,4BnQKPLuE3DMTtxp8MjUBytgnhvxqq3ZTqZHTVZo4JJh,402404,5915515,-5513111,510
2022-01-22 01:27:31-05:00,7186,5XrU9QLKHL8m66mpfcsqvndBBeQ9t8vA7zhNdB1yAi9s,3FDocKqsT3aUigiW2P7MESU8anAYqg1D9domHCDsxCB1,True,210700584,52675146,264028,132014,132014,72FwbpFGoLEazJEdpqNtPNefsadUrimUqma9wSoy4qiS,10561126,56986627,-46425501,501
2022-01-22 01:27:31-05:00,7187,WMUVFELv3C3KdMKJ5ZL4rG7o1YrV1qTP6Mmp2S5Rp8S,7UNzS3zDqT1oeq9a7eJGU8cgf8eUzEAZubSBQvNmK6uJ,False,571434,571434,28478,1423,27055,4BnQKPLuE3DMTtxp8MjUBytgnhvxqq3ZTqZHTVZo4JJh,28478,273761,-245283,498
2022-01-22 01:27:31-05:00,7188,C2Dmfw4G8KKzFq38aRH2pLCRngnGZDvUUN3fHDMjFkoG,7kzJk3BTNvY3hGFNj7nDy9L5CAYus6eNiCAxWH8dSioX,False,11684,11684,581,29,552,72FwbpFGoLEazJEdpqNtPNefsadUrimUqma9wSoy4qiS,581,11497,-10916,497
2022-01-22 01:27:31-05:00,7189,9zpPiboHF5HW7NfCx7hYdmJGwUomVMTiUFc4Um5KrDi3,8q3eBpuwV6dMNkib9N8XQAq2tBUcjSANRe5SXpd4dFhZ,True,258577,64644,327,163,164,4BnQKPLuE3DMTtxp8MjUBytgnhvxqq3ZTqZHTVZo4JJh,13083,167869,-154786,505
2022-01-22 01:27:31-05:00,7190,BvoctLT1kkt7sM4C2H26hSKXcjAgreYRTj7rkGt5SPJ2,EFKKd4Upox5TzBSAT96oxfeKBVEfDeE8yxnG3qoMJVGY,True,6056242,1514060,8517,4258,4259,3zqXX6kzhkbW3d4TwD2CNjMRwxTbREXySekvq37kfCNk,340705,4908914,-4568209,562
2022-01-22 01:27:31-05:00,7191,DMgD2KCEhTGFLUZ5GnfNcwfiiwKYbyVpoWiN6knMkCAf,5KU2vgBkPTNVHsSULjgX7ZkZS56U3Dy3xqLTxL5sUZJ3,True,45216146,11304036,66620,33310,33310,3zqXX6kzhkbW3d4TwD2CNjMRwxTbREXySekvq37kfCNk,2664838,44440450,-41775612,589
2022-01-22 01:27:31-05:00,7192,HqYn1PU7foJ9daTJMbd19LjTqWR2vQ1XqMEmffM2kCFA,8o6U7rDTtzSvywjzENEZSDYxCf7XK85rueCYVM4vZjY1,False,17217505,17217505,850242,42512,807730,72FwbpFGoLEazJEdpqNtPNefsadUrimUqma9wSoy4qiS,850242,15872120,-15021878,493
2022-01-22 01:27:31-05:00,7193,6xbPoFjPYUcSejbTk5iiTZRWyZkicfkSzM1Fhbj3w9L5,7xTAbaXwhxxVY3TM88TLakPPwPyL4zT4TsVvtUvniVec,False,122254773,122254773,5481670,274083,5207587,HfEnetJ7uBSmZWCjBNxdvv9HEC5nsW4wDV7wu6WnhWan,5481670,42206980,-36725310,448
2022-01-22 01:27:31-05:00,7194,3g1debT8Z2efQPuMNSDPUNZzDqarBG2acErsZ4HP7QGA,42wDHagxr5Nno3mUx6kyYGDjwR98aedRbh3ByB468agB,False,795,795,26,1,25,72FwbpFGoLEazJEdpqNtPNefsadUrimUqma9wSoy4qiS,26,582,-556,327
2022-01-22 01:27:31-05:00,7195,BJaaH1SK1pF2kZQzmYpLFfDtm52CR9a5rd39RAPtLe8q,HUsT5FVxaisdnCvG1BQxX6zffjfL2Rwx5mMo5y8SDV7e,True,4339473,1084867,5999,2999,3000,72FwbpFGoLEazJEdpqNtPNefsadUrimUqma9wSoy4qiS,239961,2132026,-1892065,552
2022-01-22 01:27:31-05:00,7196,Go3ne58krEsFsZ5yu9EBT7od15VCYmtbs1KhumRMTiXS,HCvwQ7HjmmeDXrguZQPrAbJjcCJzHqVZK2JMSFkFDWfe,True,2835725,708931,4412,2206,2206,HfEnetJ7uBSmZWCjBNxdvv9HEC5nsW4wDV7wu6WnhWan,176482,2283920,-2107438,622
2022-01-22 01:27:32-05:00,7197,5yPGvUz6JWKjkViGwTCpygJii1rP2xv5yx146ULtBiYq,FMnHUCQWTf1UHu5qVFqUAsWh8aba9EQYTEoiXy55totD,True,153937363,38484340,224465,112232,112233,3zqXX6kzhkbW3d4TwD2CNjMRwxTbREXySekvq37kfCNk,8978630,61210358,-52231728,583
2022-01-22 01:27:32-05:00,7198,DAku12iueL13vRoTpKLyqdGaLQ2rWF6REe8Dr8soFvNs,H2vVH3LxkhGe6x6Mdwy67BYwTKNQM6XayKx7mhrwyfJM,False,14039,14039,689,34,655,3zqXX6kzhkbW3d4TwD2CNjMRwxTbREXySekvq37kfCNk,689,12025,-11336,490
2022-01-22 01:27:33-05:00,7199,6nJyqvFKprwaVCE1gAa2P4RHKc6Pa6XFSJymx654zZ9K,4e7iJmdwzAPxp1Zi8Azo38YyPQdPKqqY4VLJyQ5rpdYP,True,78952,19738,109,54,55,3zqXX6kzhkbW3d4TwD2CNjMRwxTbREXySekvq37kfCNk,4374,68321,-63947,554
2022-01-22 01:27:33-05:00,7200,FF8rqfM9PTEjYiVFy8jS81weDRwdaYooux2uSa2LexrJ,JBk1JghH1gged1YpDbkczFXP9ka5ivYSkaYoVbbXD4kg,True,5947185,1486796,8708,4354,4354,HfEnetJ7uBSmZWCjBNxdvv9HEC5nsW4wDV7wu6WnhWan,348326,4958924,-4610598,585
2022-01-22 01:27:33-05:00,7201,2WG1vzMHrYu1UdNjWccbzigwXaC3BcPqSmDTgHnEgSjz,26MRaqCvaK37n8YKepmVS76zSsqKj9CefJQSQFts5yno,True,325963747,81490936,439743,219871,219872,3zqXX6kzhkbW3d4TwD2CNjMRwxTbREXySekvq37kfCNk,17589746,277160527,-259570781,539
2022-01-22 01:27:33-05:00,7202,6xikA6d7sjCBnSfqkFwrL4nPrtQUNWdRhXB7i1AccnxC,G8t7u2R9qjRfdTdULs74v3nVrTM2WeKvc4dK4FFAvuG1,False,1178960,1178960,57587,2879,54708,3zqXX6kzhkbW3d4TwD2CNjMRwxTbREXySekvq37kfCNk,57587,599926,-542339,488
2022-01-22 01:27:33-05:00,7203,BPsM1um9ZJf7eNoVMsQCRSwgARMuLCGGSDxf9tZeNeEy,BpzDdXfxVygiSYSmsHV6uPxQMeTFtrURMCCqhswQjd5X,True,38222,9555,55,27,28,3zqXX6kzhkbW3d4TwD2CNjMRwxTbREXySekvq37kfCNk,2202,27403,-25201,576
2022-01-22 01:27:33-05:00,7204,7g4NJBHwDTRm58GqX7Tz1JzqwbAhF6EWJUQH3SoDxSf7,82Ypv7STZeSCBPf3HckWdyatELpvaDaWxFXhD5dNSML4,False,733,733,36,1,35,4BnQKPLuE3DMTtxp8MjUBytgnhvxqq3ZTqZHTVZo4JJh,36,550,-514,491
2022-01-22 01:27:36-05:00,7205,69byqtDPmgEY1NqKBCR95CEPVHRUxgbNW9Y4P4HjQ7ND,E47T4q4zMGzNL6vDxgWdLn3EQbW3WfVryr8Jsymy1hAL,True,13657338,3414334,21344,10672,10672,72FwbpFGoLEazJEdpqNtPNefsadUrimUqma9wSoy4qiS,853781,9441573,-8587792,625
2022-01-22 01:27:36-05:00,7206,BTouoY9doTYwX8wAa6QcZHzJjfZfEAtiLYR2JHKd5V8Z,H4ByqCdZy7AMx7VJZEwQwQmZLVA8vHg55C7ypwZwv67u,False,666978774,666978774,33069200,1653460,31415740,3zqXX6kzhkbW3d4TwD2CNjMRwxTbREXySekvq37kfCNk,33069200,326381275,-293312075,495
2022-01-22 01:27:38-05:00,7207,6dr65yANjSMmfBeKAuSxG3i16S9vMgF1CQ3zDyzh55Pn,EhrE5QpnshD41S4zPEBy2A5q2Gs2mwUrbHGo6WnT9zDP,False,10531,10531,521,26,495,3zqXX6kzhkbW3d4TwD2CNjMRwxTbREXySekvq37kfCNk,521,9022,-8501,494
2022-01-22 01:27:38-05:00,7208,Ck946unSEhqFVgSURskkU3J1yd2TqWbk3nYuZRTzohLb,6mbR3HfdmSK9deU7L64vDti4p9bVZkZgQsBCtPrD9BV,False,495168227,495168227,24700296,1235014,23465282,HfEnetJ7uBSmZWCjBNxdvv9HEC5nsW4wDV7wu6WnhWan,24700296,122261004,-97560708,498
2022-01-22 01:27:41-05:00,7209,woTXSsDkL9TQNxc3zwxSPagVijX7PE24bgKjvxexRwQ,A5M5EEPfDgvAxGLhpNgfn8AzPmyXxmPVgkEKnyoVzsz6,True,449988,112496,596,298,298,3zqXX6kzhkbW3d4TwD2CNjMRwxTbREXySekvq37kfCNk,23867,426073,-402206,530
2022-01-22 01:27:43-05:00,7210,E1CShgy7M9998q9jyzpnHZxHJR6z5hvnshUJt37kVPtG,96f1nYW4S9APCJS3TXTGSb9UcJDdxJuoBR3pLYqcNz2b,True,5601856,1400464,8134,4067,4067,3zqXX6kzhkbW3d4TwD2CNjMRwxTbREXySekvq37kfCNk,325396,4225561,-3900165,580
2022-01-22 01:27:44-05:00,7211,7E3Zc3g1eJ7ueosPPoHDSkhuHvBVfN41eXcJXWeffozU,CGA8dcsZjfLqSYijYmssZwd9TXAsvSafNVT6JvUajGdu,True,100839270,25209817,136881,68440,68441,72FwbpFGoLEazJEdpqNtPNefsadUrimUqma9wSoy4qiS,5475262,90872769,-85397507,542
2022-01-22 01:27:44-05:00,7212,EFHg5FatMRRSZnKJPJF9e1iw2cjPJRmwTTZYtkHno9DP,84LnLKhZDJgWFnbBYnYjqWkjymemXfidecPFwnUAvuFj,False,67829932,67829932,3371773,168588,3203185,HfEnetJ7uBSmZWCjBNxdvv9HEC5nsW4wDV7wu6WnhWan,3371773,44488003,-41116230,497
2022-01-22 01:27:44-05:00,7213,DdAPWdHnb7ocaYtcwwwYnppsH39sZpmzMyANeoJbCV7s,3BVmC39L8dEypPN1BZhsf9bx9Ge2sXCZR8Y6RH4eBNMJ,True,33338995,8334748,45011,22505,22506,4BnQKPLuE3DMTtxp8MjUBytgnhvxqq3ZTqZHTVZo4JJh,1800443,37694704,-35894261,540
2022-01-22 01:27:44-05:00,7214,B4Uc39nKzz9wBRQsCkMR4A7RwTJ8rSuwpR6EQn2AesRb,H49bGZgatRZVpj6QufZRVgYrQtH7LpdbiqKBs23151m,True,820258,205064,1201,600,601,3zqXX6kzhkbW3d4TwD2CNjMRwxTbREXySekvq37kfCNk,48045,1100891,-1052846,585
2022-01-22 01:27:45-05:00,7215,EAUFD16wab8qRMJ4H6updHGt4xFqgRCDeRHVCsLCTSTL,8vkfYSyCyBY9g4TZrp52jUcQj6udy9xAaA4fioRE2RXx,True,4954649385,1238662346,7653060,3826530,3826530,4BnQKPLuE3DMTtxp8MjUBytgnhvxqq3ZTqZHTVZo4JJh,306122401,1902405272,-1596282871,617
2022-01-22 01:27:46-05:00,7216,3EmGvYu72cR4Ta3wLA5HKZBEqgfChCyiRanwj5hGLJXc,6NEWPFaKi5uLsrj4n6RM1DBhQTcGFE9TwYeJ12pC7yyp,True,1257,314,1,0,1,HfEnetJ7uBSmZWCjBNxdvv9HEC5nsW4wDV7wu6WnhWan,72,940,-868,572
2022-01-22 01:27:46-05:00,7217,D6qMab7uevXTa89ssv4BRyHwrw3FYpNimAmX2VH2uf4B,8ZauZ5dAp7kyawkPdxi4mqfempFHubJebfBenQdDektD,True,4526350,1131587,7049,3524,3525,4BnQKPLuE3DMTtxp8MjUBytgnhvxqq3ZTqZHTVZo4JJh,281962,3645143,-3363181,622
2022-01-22 01:27:46-05:00,7218,HoJ3Re4BmCYKMJx2RUYtoHfg8ncEy3iFqvWJDGKqfMBV,2qg4FMcurNDVRzXYKwpzEYapxFECnAyU2oGmxQCSf3hf,True,6814433,1703608,10587,5293,5294,4BnQKPLuE3DMTtxp8MjUBytgnhvxqq3ZTqZHTVZo4JJh,423485,5492114,-5068629,621
2022-01-22 01:27:46-05:00,7219,84SgzR8J6DeqPJ1uXphP1BHMotYGKh3kS4owMMj9x58x,CL7Jkwe3NK4qaAVK2QjuftXnQ5YLqDT9qYeeEi7kJXrV,True,11948142765,2987035691,15323328,7661664,7661664,3zqXX6kzhkbW3d4TwD2CNjMRwxTbREXySekvq37kfCNk,612933136,10392178591,-9779245455,512
2022-01-22 01:27:46-05:00,7220,HVZkXeDR3mc8oB9qFFwCK4RXpPojdcHk9tRGep6xtKGK,Bh3py7awPejWqeTMxtAgF7mPotL2Asxf8YrYJykq9nBt,True,208891,52222,292,146,146,72FwbpFGoLEazJEdpqNtPNefsadUrimUqma9wSoy4qiS,11703,159605,-147902,560
2022-01-22 01:27:46-05:00,7221,6gFbxvPafnpqZjWW94MMmL8mGp2FHZGqoJC5fWqgwNxS,C6WcDycp3Ff3xYmb81i8JbD39Xv1o5G2AdtPs1FdXtr4,False,72438914,72438914,3357515,167875,3189640,3zqXX6kzhkbW3d4TwD2CNjMRwxTbREXySekvq37kfCNk,3357515,32276249,-28918734,463
2022-01-22 01:27:46-05:00,7222,51yPLtXTgL9oLKs1cCf5TjL54Ld5vuVxat2NNtwZVsZG,7UjtM7Z1tiXEQMMiorQyncgi9SKu3v46DhVdgXbWqSiF,True,11230706,2807676,15078,7539,7539,HfEnetJ7uBSmZWCjBNxdvv9HEC5nsW4wDV7wu6WnhWan,603146,14471515,-13868369,537
2022-01-22 01:27:47-05:00,7223,BXMMFy2k9b2hVBEG6RyXAq3qqXxJ7EY2xhyPZqtLvBiU,KpoZwr4ZFTHJgebbf4tcjT9iKvpC1EF8Aw4uaVPxXNd,True,2052696,513174,2803,1401,1402,72FwbpFGoLEazJEdpqNtPNefsadUrimUqma9wSoy4qiS,112135,727342,-615207,546
2022-01-22 01:27:47-05:00,7224,3HUAjpBLM9XnT5W8p7asjjh1s8GDBzHL55AbsvBPsZ2e,6g6azPhma25H5q8HEATFAcXKg7UokmzPXzXDBr7QKbTL,True,4575600,1143900,5884,2942,2942,72FwbpFGoLEazJEdpqNtPNefsadUrimUqma9wSoy4qiS,235373,3731441,-3496068,514
2022-01-22 01:27:47-05:00,7225,921FBgLS3A1wA77uWitsnTvW737Q2jY7tzvgWtWLXNC7,E4eJ9H7cqP9zNpMH5xRBTAp9yaBCBihuJBNd6pqzteDG,False,4611,4611,215,10,205,HfEnetJ7uBSmZWCjBNxdvv9HEC5nsW4wDV7wu6WnhWan,215,3050,-2835,466
2022-01-22 01:27:48-05:00,7226,9k5YHTFCHczFg6KAZXf2ostkFLH7WdVAxiA9zCGRprg3,2b52r1TA8dkJsnuMuM9cNfGxKEynd42WjQUuzcQTRcD9,False,2006,2006,95,4,91,72FwbpFGoLEazJEdpqNtPNefsadUrimUqma9wSoy4qiS,95,1501,-1406,473
2022-01-22 01:27:48-05:00,7227,5PVUmELKMD7mf2vbXbiXXsiZW2myGmZuMe757raBAj8Y,5eikdsebvyBh27aPz9t9KPswYWd8X4Cbk2TSiif6vn36,False,296680670,296680670,14841320,742066,14099254,4BnQKPLuE3DMTtxp8MjUBytgnhvxqq3ZTqZHTVZo4JJh,14841320,264869775,-250028455,500
2022-01-22 01:27:58-05:00,7228,GM22yjVoBCzgBcVTT5EcgRhVWiXVV82kSj1dPCbegKWj,CDDy8JmJMwJyx1YAvEPpj8AYxCpngRovf3wWfVzao5Rc,True,4888805,1222201,7637,3818,3819,72FwbpFGoLEazJEdpqNtPNefsadUrimUqma9wSoy4qiS,305498,1740603,-1435105,624
2022-01-22 01:27:58-05:00,7229,7dmoK7QPki7R66SPQST4veUgVfnJbVToxxBPZveECiwK,4vh4REBDm5zBDmcjRCD9zNsny1HGneu7B2co4dSJNLL6,True,26136448,6534111,40854,20427,20427,72FwbpFGoLEazJEdpqNtPNefsadUrimUqma9wSoy4qiS,1634188,19302841,-17668653,625
2022-01-22 01:27:59-05:00,7230,DiPSJvnnEwg1En7HJfEsKrUbBgtUf4KzGMyMCZDQSYgp,s8UVC6vPBofuXUS6RW1aQmZ8C35PrC5r4A6ugmvzLGB,True,45939,11484,71,35,36,72FwbpFGoLEazJEdpqNtPNefsadUrimUqma9wSoy4qiS,2857,27082,-24225,621
2022-01-22 01:28:13-05:00,7231,3oCun4gm3k8sXxVxiYM8okGi8iCXH9LvDkHf9PBQWYXR,E1np1dZ7jUm811ddvy1jQerBwGSYb5BbZWnUHeotvrfH,True,25525850,6381462,39868,19934,19934,4BnQKPLuE3DMTtxp8MjUBytgnhvxqq3ZTqZHTVZo4JJh,1594743,6353904,-4759161,624
2022-01-22 01:30:26-05:00,7232,EDSf2w1UyGvbgMuxyoXL58ifR1dviZinnLBYnFmgjcNG,DFenkzbL9SUjs9cSCaHJ1eXK75mHfk3GSPRFs8TSzrFV,True,366917226,91729306,565014,282507,282507,4BnQKPLuE3DMTtxp8MjUBytgnhvxqq3ZTqZHTVZo4JJh,22600597,127582236,-104981639,615
2022-01-22 01:30:57-05:00,7233,4ne6vC7qdxQYHJCsaeFAKZrKdFt2SwXGHQ3jrMHqt4DL,Cf1dLHY2WXH9rXbRKq5TT8THbdo9SdNUZq4rYhRCF9z,True,5946743,1486685,9211,4605,4606,4BnQKPLuE3DMTtxp8MjUBytgnhvxqq3ZTqZHTVZo4JJh,368467,2679595,-2311128,619
2022-01-22 01:40:58-05:00,7234,F9s8a7Cpiw5dw3a2aNFMofqwyDWNXvDLnSdJzoj1gRiV,GpKsQKJD79KBRWdCTkyi4zX7NaoCWsLUjrKxAwJB6o6s,True,951374,237843,1473,736,737,3zqXX6kzhkbW3d4TwD2CNjMRwxTbREXySekvq37kfCNk,58947,467073,-408126,619
2022-01-22 01:40:59-05:00,7235,5NVD6QvomTAD35yNxSFZw4DhF2hCtV8drkbnGhBVtK5y,3JzkyPnREvoFZLL9JZuuDEnee3nuKcrqY3xLuXsmHwRo,True,1903164,475791,2945,1472,1473,HfEnetJ7uBSmZWCjBNxdvv9HEC5nsW4wDV7wu6WnhWan,117825,1551099,-1433274,619
2022-01-22 01:41:00-05:00,7236,GjQQ2fQ7mrGjWZwjVYFUKp9NM1LmfkhEo675ovU5SPa8,ECgVUMRY5nB4MALs5drDyipF7YohCPuJpj2UegCs7HMn,True,719873,179968,1109,554,555,3uL2NSR2ZdDqCiKfzA5SwwpddAnit22DBJo6uvvz1rRs,44382,529144,-484762,616
2022-01-22 01:41:01-05:00,7237,3FF2rhr1RuT7UR7MmmGtrhfYbh6kbc5UXq51KmqFLZnq,AEmSYLt1dQ8suLugC4Lcw4kF3dG9GYcEfX54hEAKfmv5,True,8799438,2199859,13757,6878,6879,4BnQKPLuE3DMTtxp8MjUBytgnhvxqq3ZTqZHTVZo4JJh,550301,3613741,-3063440,625
2022-01-22 01:42:08-05:00,7238,2pKygdXJnjZBFfrZgDasmHQQgw8LgycmBBRuaoCU72cz,DXsomQ5yWw2ceZMbaCVsSaE4hKm9W6Gy785JG75Aaz18,True,7919059,1979764,12333,6166,6167,3zqXX6kzhkbW3d4TwD2CNjMRwxTbREXySekvq37kfCNk,493349,3250642,-2757293,622
2022-01-22 01:42:12-05:00,7239,GxFxvEUdWofneMmVvhCSScH9V6Zia5WJ2J9q6CpPnaq3,ATLykiHDii3Lw53MoZXwqu1FbBNPJbVNVGe2SoQMjVmY,True,144821,36205,225,112,113,3zqXX6kzhkbW3d4TwD2CNjMRwxTbREXySekvq37kfCNk,9015,117840,-108825,622
2022-01-22 01:43:53-05:00,7240,442usWu6XpJZvU25bqXeynRrQ15jAzWwU9DWMgHpTn3Q,CtvADKp39bjJf3cPKWNL3wxnhq273fVM4fC5DmEcg5cC,True,2463122047,615780511,3767625,1883812,1883813,HfEnetJ7uBSmZWCjBNxdvv9HEC5nsW4wDV7wu6WnhWan,150705026,919001146,-768296120,611
2022-01-22 01:44:37-05:00,7241,CmvNNpdGVDGujBadaMmgKc8xgFfyV6G9PNEjD8zEND6L,EzmfinKBZ8TXoSugyTqdEdHWrHdTdpHQtc1TApfaNfDR,True,3956965413,989241353,6171611,3085805,3085806,3zqXX6kzhkbW3d4TwD2CNjMRwxTbREXySekvq37kfCNk,246864479,2621422361,-2374557882,623
2022-01-22 01:44:39-05:00,7242,2r64Rnbu3ZjmJTHHUxxV9TWWGzwpAepA4ySbtKivBXCj,6RRzx6KLkMiFK9JSuznrSJGiPgkHwatBSskudHqbfKJ5,True,645451865,161362965,1007005,503502,503503,HfEnetJ7uBSmZWCjBNxdvv9HEC5nsW4wDV7wu6WnhWan,40280202,345110784,-304830582,624
2022-01-22 01:44:43-05:00,7243,8JtUn4uue4WzrySwnDQ74qzzWaKsoo11MbMvRh1ePDJN,8iahKConWg6fyZrkoze5eeujyNHA26AybYBpHwUr76Cu,True,99061606,24765401,150413,75206,75207,3zqXX6kzhkbW3d4TwD2CNjMRwxTbREXySekvq37kfCNk,6016526,50662800,-44646274,607
2022-01-22 01:50:51-05:00,7244,6qDAr9rGtFMeiTx9KfAeu3WBqiZzRzEtMfipFaZ2gQiJ,MGfCsHXhA5C6S28qKoQjeZmn28dehGUJ4MLSaic7CfB,False,2298548115,2298548115,106317966,5315898,101002068,HfEnetJ7uBSmZWCjBNxdvv9HEC5nsW4wDV7wu6WnhWan,106317966,620404996,-514087030,462
2022-01-22 01:50:51-05:00,7245,Gbxc51WERLLeCtiHv7rDvE52aqF541RoQWG5n5aqErq6,4ngBoHbfXijLMqGKxFMNht9sbmxy2g5eqBmn8QsBmbx1,True,44171001,11042749,65125,32562,32563,HfEnetJ7uBSmZWCjBNxdvv9HEC5nsW4wDV7wu6WnhWan,2605000,14790778,-12185778,589
2022-01-22 01:50:52-05:00,7246,8ZBphuKHLmv5jNURAunz6pFb3zyyCePKoToEXefPhDYC,GiQaHVaAxgf6jrUquKHjext6AXk3Vo5KKejhb3iGoc8H,False,173289969,173289969,8581181,429059,8152122,3zqXX6kzhkbW3d4TwD2CNjMRwxTbREXySekvq37kfCNk,8581181,60293758,-51712577,495
2022-01-22 01:50:52-05:00,7247,6pXjgzpAPSjchUHoPqsZduviYV95SBHNk5CRCNjGAJZw,26Zjv9SkvUmwQAQT9Ls6k1wdKECrkhBrDUDrntpHfPEu,True,434609586,108652396,567333,283666,283667,3zqXX6kzhkbW3d4TwD2CNjMRwxTbREXySekvq37kfCNk,22693346,98023760,-75330414,522
2022-01-22 01:55:21-05:00,7248,AvwHizRhHUSahmvSg4jmTUErc7vAFSmkRAEsiKhXfW1m,3UrWYx8y9N5o9GYneSe6zyyHRTZzxwvcipQfHHYh7tEs,True,86087,21521,130,65,65,3zqXX6kzhkbW3d4TwD2CNjMRwxTbREXySekvq37kfCNk,5201,60005,-54804,604
2022-01-22 01:55:21-05:00,7249,3c4tj9J8QwB3exFchWei43nBh5xsYRZxEUfayi3JvYgm,Fyw1TEEDKhLFo16qxDsttsAwSkrfzpDe8Dmm3atEeXyN,True,13448184,3362046,20004,10002,10002,3zqXX6kzhkbW3d4TwD2CNjMRwxTbREXySekvq37kfCNk,800195,9497330,-8697135,595
2022-01-22 01:55:21-05:00,7250,2sPD4f4d3CCeFSwSC5vAGS3YoTsTGypYKfDeoJczebop,HWCRpcq2sXqJL7Vi8MtipQDwGSViE73bUxS36ETmvnP2,True,5995062,1498765,8953,4476,4477,4BnQKPLuE3DMTtxp8MjUBytgnhvxqq3ZTqZHTVZo4JJh,358153,2562527,-2204374,597
2022-01-22 01:55:21-05:00,7251,4xn9vTtLZyNtCbBLLpcXUMWU8AnnZCov9rJaY6rew16T,5UNWdFw2CP44qS8oc4uPt8zxw6zFg8oXz8SUCedZLLEC,True,1060695,265173,1467,733,734,3zqXX6kzhkbW3d4TwD2CNjMRwxTbREXySekvq37kfCNk,58697,497709,-439012,553
2022-01-22 01:55:21-05:00,7252,4hZG7dM716SxDagiFGwt1gSC99B2QK1emGLV9TJmmuR8,7vjfUWySkyx4Z5qAaRr2VWnVvxHHNsvPj1PirGNSjM6,True,8402100298,2100525074,11224770,5612385,5612385,3zqXX6kzhkbW3d4TwD2CNjMRwxTbREXySekvq37kfCNk,448990832,3932633508,-3483642676,534
2022-01-22 01:55:21-05:00,7253,GBpe8E33cNkFmMUuP3WjhDBBuQz7MHaDkpCJjGFaFkvu,3QYFKkgzZ1PKKAxCh4hMhgqrupoCcfRVkjuJZRWVZo3H,True,24984984,6246245,36544,18272,18272,HfEnetJ7uBSmZWCjBNxdvv9HEC5nsW4wDV7wu6WnhWan,1461767,11238474,-9776707,585
2022-01-22 01:55:22-05:00,7254,D7XummfEc3NTK4qMvZegV3FrYuqc8mNgnQu3ujwemZtg,HHiRcecqzW7sGFTio7Ph6TYv3dGt64KWv4DEKgKm84fQ,True,249441,62360,331,165,166,3zqXX6kzhkbW3d4TwD2CNjMRwxTbREXySekvq37kfCNk,13268,207410,-194142,531
2022-01-22 01:55:22-05:00,7255,HELPNUwAqTX7gfHS4cnJnqXFM6Rb156tYcpsitKR9iDu,3RdfgDvLvsdZG5Cf6hKiKMQMqfidyxHzjYvUx1FZpeHQ,True,14726190,3681547,22015,11007,11008,4BnQKPLuE3DMTtxp8MjUBytgnhvxqq3ZTqZHTVZo4JJh,880602,14306361,-13425759,597
2022-01-22 01:55:22-05:00,7256,4SQQdHTJUDv8taPXQRvEVJpUu91iCWQsv9su8tfehaQG,33CJXj1pmmatAofRvgt5in9E6SLEuy7tq4jqSwnUWP2A,True,943109108,235777277,1456623,728311,728312,3zqXX6kzhkbW3d4TwD2CNjMRwxTbREXySekvq37kfCNk,58264945,850092121,-791827176,617
2022-01-22 01:55:23-05:00,7257,C1rjefgArnN3nBn5Wu3yXij2wAyGWFtWdjGNLR9vpjmj,GsLCESLzYGZ1brEh8RJrZttE7hxcpSq7iUqdhwJhnDVB,True,5544057,1386014,7972,3986,3986,3zqXX6kzhkbW3d4TwD2CNjMRwxTbREXySekvq37kfCNk,318917,3760012,-3441095,575
2022-01-22 01:55:24-05:00,7258,72woixtGAuGazCMfsYfYBYLP7FuRj8Fwz9fynFo4MCE4,5237BmWkKf58PBeTUEiu3Ld5uKXEe8wcrJRmCnUoWWku,True,31068265,7767066,39637,19818,19819,4BnQKPLuE3DMTtxp8MjUBytgnhvxqq3ZTqZHTVZo4JJh,1585481,15247191,-13661710,510
2022-01-22 01:55:26-05:00,7259,DC4UVUDFWL3gVtgkX9hPtFgtxaA8DH5p94i4k9U3wyWv,3HCWqVvQQfRgSKitsTjGTduJ82ointZUSNtj13uea4kD,True,58484621,14621155,86603,43301,43302,3zqXX6kzhkbW3d4TwD2CNjMRwxTbREXySekvq37kfCNk,3464158,39753849,-36289691,592
2022-01-22 01:55:26-05:00,7260,FV3G5EsSmyiLAAoREhgDXwvzbxoyDeq4Mwfj4jK5fJ7U,5nhzbJmm5JAwGDpTZoenkM1u3XtMY4uN7Qsm3vFGtRJE,True,2752831,688207,3923,1961,1962,3zqXX6kzhkbW3d4TwD2CNjMRwxTbREXySekvq37kfCNk,156942,1210919,-1053977,570
2022-01-22 01:55:32-05:00,7261,DvuRmJkfn6FQczUKgYeaSCqwy2NTMunuAKNrnmxMvnzS,7LpWTX9dgBtW75kfEoB5WuNsDwEdw5s8CYSHh3J4qagM,True,2828952,707238,4025,2012,2013,3zqXX6kzhkbW3d4TwD2CNjMRwxTbREXySekvq37kfCNk,161033,2375038,-2214005,569
2022-01-22 01:56:46-05:00,7262,FuoFPNTdYVDkSHaBac6UC1aNJXafSNTvFJuBCdrgQQrH,ApBS1Fx83tcECMzDV6wEzEzEdg4e2hgj3djtjRUoSKK5,True,134246534,33561632,208214,104107,104107,3zqXX6kzhkbW3d4TwD2CNjMRwxTbREXySekvq37kfCNk,8328574,79617747,-71289173,620
2022-01-22 01:57:30-05:00,7263,2pKygdXJnjZBFfrZgDasmHQQgw8LgycmBBRuaoCU72cz,DXsomQ5yWw2ceZMbaCVsSaE4hKm9W6Gy785JG75Aaz18,True,5822158,1455539,9096,4548,4548,3zqXX6kzhkbW3d4TwD2CNjMRwxTbREXySekvq37kfCNk,363879,2548988,-2185109,624
2022-01-22 01:57:30-05:00,7264,GjQQ2fQ7mrGjWZwjVYFUKp9NM1LmfkhEo675ovU5SPa8,ECgVUMRY5nB4MALs5drDyipF7YohCPuJpj2UegCs7HMn,True,529033,132258,810,405,405,3zqXX6kzhkbW3d4TwD2CNjMRwxTbREXySekvq37kfCNk,32401,406845,-374444,612
2022-01-22 01:57:31-05:00,7265,3FF2rhr1RuT7UR7MmmGtrhfYbh6kbc5UXq51KmqFLZnq,AEmSYLt1dQ8suLugC4Lcw4kF3dG9GYcEfX54hEAKfmv5,True,6466691,1616672,10091,5045,5046,3zqXX6kzhkbW3d4TwD2CNjMRwxTbREXySekvq37kfCNk,403656,2834126,-2430470,624
2022-01-22 01:57:33-05:00,7266,5NVD6QvomTAD35yNxSFZw4DhF2hCtV8drkbnGhBVtK5y,3JzkyPnREvoFZLL9JZuuDEnee3nuKcrqY3xLuXsmHwRo,True,1398631,349657,2153,1076,1077,3zqXX6kzhkbW3d4TwD2CNjMRwxTbREXySekvq37kfCNk,86138,1189836,-1103698,615
2022-01-22 01:57:33-05:00,7267,GxFxvEUdWofneMmVvhCSScH9V6Zia5WJ2J9q6CpPnaq3,ATLykiHDii3Lw53MoZXwqu1FbBNPJbVNVGe2SoQMjVmY,True,106474,26618,166,83,83,3zqXX6kzhkbW3d4TwD2CNjMRwxTbREXySekvq37kfCNk,6648,90410,-83762,624
2022-01-22 01:57:33-05:00,7268,F9s8a7Cpiw5dw3a2aNFMofqwyDWNXvDLnSdJzoj1gRiV,GpKsQKJD79KBRWdCTkyi4zX7NaoCWsLUjrKxAwJB6o6s,True,699163,174790,1077,538,539,3zqXX6kzhkbW3d4TwD2CNjMRwxTbREXySekvq37kfCNk,43106,363569,-320463,616
2022-01-22 01:57:34-05:00,7269,8WHDaiE6LqFFmCVMnPeLEQ99R6ft8b74UfmP9BqzjcE8,CGmoDGsdnjo3zMNrW78n2xxQr1aDPAiBYiXbyciLXYMu,True,53819950,13454986,84088,42044,42044,3zqXX6kzhkbW3d4TwD2CNjMRwxTbREXySekvq37kfCNk,3363533,31168805,-27805272,624
2022-01-22 01:58:33-05:00,7270,BCGTaPQxGEMjD7xUxwfwmVVYJ9CEGH33yJRi3QjwyiLE,JBct1cZ9a959UKwABBEefwxZnGTAAGLzyUdXrXqGGCZd,True,215810526,53952631,289430,144715,144715,3zqXX6kzhkbW3d4TwD2CNjMRwxTbREXySekvq37kfCNk,11577231,120805133,-109227902,536
2022-01-22 01:58:37-05:00,7271,9aQrdyfAvcBbBj7iKQB17eAS4zBqymdd3kzkTkuRhdLU,BDHhukMF5rALuSwCxaw8g73m2MN4oX1D4e7uNmx3SiVt,True,117000139,29250034,178297,89148,89149,4BnQKPLuE3DMTtxp8MjUBytgnhvxqq3ZTqZHTVZo4JJh,7131919,37681405,-30549486,609
2022-01-22 01:58:37-05:00,7272,Br1j5Ftafei7ysu5SmqVZSoRe4uS4qCPeKSPHg55pyiE,G8fc7QvXjfkgBFvAVUgJFQS3VaF1biL9rktBExGa87Ks,True,310362646,77590660,474983,237491,237492,HfEnetJ7uBSmZWCjBNxdvv9HEC5nsW4wDV7wu6WnhWan,18999347,194578944,-175579597,612
2022-01-22 01:58:37-05:00,7273,EF6H6aW1p3qcAtiLFU9rbFYfsKfD683meHXDw8hLdaZK,8vfJbpnK7SQcjpEBCzZJRW8JosNbsmTeJ2YXZCbM225c,True,26203579,6550894,39887,19943,19944,4BnQKPLuE3DMTtxp8MjUBytgnhvxqq3ZTqZHTVZo4JJh,1595509,13664775,-12069266,608
2022-01-22 02:00:16-05:00,7274,9psSuFHBGqCvcgNMc7aTMhKMMFwBDmW7v5Wkn22KtTHj,7zi9LSfuEhXccQXSRukRRwgQUaiQVVgfsGaRYLP2JvwB,True,1468803602,367200900,2160837,1080418,1080419,3zqXX6kzhkbW3d4TwD2CNjMRwxTbREXySekvq37kfCNk,86433501,492309232,-405875731,588
2022-01-22 02:00:16-05:00,7275,4ytoBUwuhAL4YYSCa6AgwrpeVF4eeU8H9NfDxMPZKxPo,Pby2szzsxDrXt4gnbmmaMccXxctZALr8miRtKhGKjsD,True,4941018,1235254,7284,3642,3642,HfEnetJ7uBSmZWCjBNxdvv9HEC5nsW4wDV7wu6WnhWan,291382,2690268,-2398886,589
2022-01-22 02:01:08-05:00,7276,442usWu6XpJZvU25bqXeynRrQ15jAzWwU9DWMgHpTn3Q,CtvADKp39bjJf3cPKWNL3wxnhq273fVM4fC5DmEcg5cC,True,1807756521,451939130,2679640,1339820,1339820,3zqXX6kzhkbW3d4TwD2CNjMRwxTbREXySekvq37kfCNk,107185624,723111033,-615925409,592
2022-01-22 02:01:08-05:00,7277,Dv1BABsN7amhjmGBpMQsnMkRLx7MuCVwsnuyTQeZ6uum,BCjscxVo1h16teND6KKiAUy1ftNGTMy1vEEEyAW4ttVG,True,8200445,2050111,12325,6162,6163,4BnQKPLuE3DMTtxp8MjUBytgnhvxqq3ZTqZHTVZo4JJh,493018,2501958,-2008940,601
2022-01-22 02:01:15-05:00,7278,CCP5P6U4xBjea3snWgwBb5rtaounEAsNHpWzTUeNtVf9,GE2Bxc837ybP7sNR487U4bVbx68qyX2HtwPBLfEd4BDj,True,380510157,95127539,572773,286386,286387,4BnQKPLuE3DMTtxp8MjUBytgnhvxqq3ZTqZHTVZo4JJh,22910951,127833361,-104922410,602
2022-01-22 02:01:15-05:00,7279,E5biUzKn2s5frKseCmfWriWjrYMGVtmLrhR9nYhAkVvR,BDHzqefisuGoMGcpML8t6KAC7rcErvhLcfV8KQC7oHAH,True,24006217,6001554,37429,18714,18715,3zqXX6kzhkbW3d4TwD2CNjMRwxTbREXySekvq37kfCNk,1497170,9505185,-8008015,623
2022-01-22 02:01:15-05:00,7280,GXfjQr2ihTfLRys1DMetVGocd1sU97KdoCJ6x4HxdW1U,9GHvjJJXjbVz5D3RBfP3njcdRRXnFsXZ68jFa2LiGwsy,True,97040636,24260159,145558,72779,72779,HfEnetJ7uBSmZWCjBNxdvv9HEC5nsW4wDV7wu6WnhWan,5822323,50725487,-44903164,599
2022-01-22 02:01:17-05:00,7281,BCGTaPQxGEMjD7xUxwfwmVVYJ9CEGH33yJRi3QjwyiLE,JBct1cZ9a959UKwABBEefwxZnGTAAGLzyUdXrXqGGCZd,True,160324760,40081189,242863,121431,121432,3zqXX6kzhkbW3d4TwD2CNjMRwxTbREXySekvq37kfCNk,9714535,93169236,-83454701,605
2022-01-22 02:01:17-05:00,7282,BH36ueAULprzjj6WabTgvivEcrx3VdDn8DTxSoro8Zym,6yydJKEmtZjUwURrs9gQ7EGkB86nK28ZDJQqNMgbPosA,True,396800930,99200232,617013,308506,308507,HfEnetJ7uBSmZWCjBNxdvv9HEC5nsW4wDV7wu6WnhWan,24680540,172038615,-147358075,621
2022-01-22 02:01:17-05:00,7283,BHpLpoGQ27T6Q4CT8H4dzqS8KF8Vj5rqmqfcodoBzpgR,Akn3tG2hQBfBVtNYCeXchfzfcsyCuSpkGpFoMLEKwcBF,True,6136531,1534132,9232,4616,4616,3zqXX6kzhkbW3d4TwD2CNjMRwxTbREXySekvq37kfCNk,369311,3366942,-2997631,601
2022-01-22 02:01:22-05:00,7284,46TNhGwBVzedW8xSb9UY94HNeSom9iGiZzAjrKHiRM2G,7JVTiqNYeKHbyzRkKtvSEpqLPKykZso8cGUr3sX1j7QF,True,6433192,1608298,9824,4912,4912,4BnQKPLuE3DMTtxp8MjUBytgnhvxqq3ZTqZHTVZo4JJh,392969,3724162,-3331193,610
2022-01-22 02:07:15-05:00,7285,3662SX3YSARYupcxpgtTvUAPUsU7aJKsGxvpkNC1AV1A,HkAb86jdGHbz6VxrtbA81jPvjhiNHhbe82NBPFxnwzE5,True,41967566,10491891,64899,32449,32450,HfEnetJ7uBSmZWCjBNxdvv9HEC5nsW4wDV7wu6WnhWan,2595988,9028422,-6432434,618
2022-01-22 02:07:17-05:00,7286,Dn916KSmX3HqxT53hrxrbCrV3tdRMCPdaoiRLqetMrth,ATCXRiXgnjRRUbSTPBvtBXMENCqsViexSZbZ6aDaXXWA,True,50015078,12503768,75956,37978,37978,3zqXX6kzhkbW3d4TwD2CNjMRwxTbREXySekvq37kfCNk,3038268,14871315,-11833047,607
2022-01-22 02:07:19-05:00,7287,BjCNaM7YbE9SjFi7tzi4677zg1fKXGJwtecz2GWwWuhd,6rNsSrKZezQrLb2whToNjnizpnurDXrobHqfEK3QqU1M,True,3028701578,757175394,4698678,2349339,2349339,3zqXX6kzhkbW3d4TwD2CNjMRwxTbREXySekvq37kfCNk,187947144,1132532704,-944585560,620
2022-01-22 02:07:22-05:00,7288,DRVtEzZs9u9ysrcANZLEjrvbuuGqYn77v2h4cDFKuNUx,Fv9qiMZhuSBL2cs9AWUYbDLQjB46W2ZwrhxaNXtPLDpC,True,5416346,1354086,8435,4217,4218,3zqXX6kzhkbW3d4TwD2CNjMRwxTbREXySekvq37kfCNk,337412,1744126,-1406714,622
2022-01-22 02:07:22-05:00,7289,EXP61AETWHw3kHSjrJH1jQBt6cXR9Zebz34Cueb3KAzg,2JT9GrgdUKjuQQtXvZqevbjFquUQBMYDoADmBjDKWXj3,True,147385999,36846499,230606,115303,115303,3zqXX6kzhkbW3d4TwD2CNjMRwxTbREXySekvq37kfCNk,9224277,64278816,-55054539,625
2022-01-22 02:07:30-05:00,7290,6pXjgzpAPSjchUHoPqsZduviYV95SBHNk5CRCNjGAJZw,26Zjv9SkvUmwQAQT9Ls6k1wdKECrkhBrDUDrntpHfPEu,True,324479566,81119891,506766,253383,253383,4BnQKPLuE3DMTtxp8MjUBytgnhvxqq3ZTqZHTVZo4JJh,20270654,78249503,-57978849,624
2022-01-22 02:08:17-05:00,7291,7tDiadLeMrob7yD6R5SDskYn41tnQZVPjEc6W2vv6irK,AHZidccE9ERBcipuRQ2iGM9kHRpTnty7UNuYTFurvXB7,True,150457398,37614349,229439,114719,114720,HfEnetJ7uBSmZWCjBNxdvv9HEC5nsW4wDV7wu6WnhWan,9177589,48607292,-39429703,609
2022-01-22 02:08:17-05:00,7292,GHn96Ev7UmKJWqch3H3wzXpRT7qLg5FBuSBJAATVED1f,BXBSUddfz9MThXqk4517M7YVRDGdTm4pC6G4ipT69TMV,True,25655561,6413890,38859,19429,19430,3zqXX6kzhkbW3d4TwD2CNjMRwxTbREXySekvq37kfCNk,1554368,7730807,-6176439,605
2022-01-22 02:08:19-05:00,7293,98pwBGgiSDuwuas6WYW2hc9qUxfULwvNE34aixaxbxXY,BLrjKxekjThtJ9rKtQxs1Y4rZ225EE2Q16VkP9TkThyV,True,25100251,6275062,39116,19558,19558,3zqXX6kzhkbW3d4TwD2CNjMRwxTbREXySekvq37kfCNk,1564655,7736504,-6171849,623
2022-01-22 02:11:15-05:00,7294,woTXSsDkL9TQNxc3zwxSPagVijX7PE24bgKjvxexRwQ,A5M5EEPfDgvAxGLhpNgfn8AzPmyXxmPVgkEKnyoVzsz6,True,335330,83832,522,261,261,4BnQKPLuE3DMTtxp8MjUBytgnhvxqq3ZTqZHTVZo4JJh,20899,324718,-303819,623
2022-01-22 02:11:29-05:00,7295,GXSysysoV8Z4xBrQsaKUsSrpoWeTTUsbFmgfZDaQu4ZM,6FJyraiLgG3tb9B7pi4YFsJNtRVBNaghnm1ajzneVv7b,True,610373587,152593396,900417,450208,450209,3zqXX6kzhkbW3d4TwD2CNjMRwxTbREXySekvq37kfCNk,36016688,219853955,-183837267,590
2022-01-22 02:11:34-05:00,7296,ARB1q7bNcQ7grwFEZC6nk9Pfrrg7yZ2WK8zVqq5CEE8F,53e8mUYrWzQnCm9XQyp18CL9owyPqJcYyxZANYhRypPx,True,63633798,15908449,94674,47337,47337,HfEnetJ7uBSmZWCjBNxdvv9HEC5nsW4wDV7wu6WnhWan,3786988,29331190,-25544202,595
2022-01-22 02:11:34-05:00,7297,9aQrdyfAvcBbBj7iKQB17eAS4zBqymdd3kzkTkuRhdLU,BDHhukMF5rALuSwCxaw8g73m2MN4oX1D4e7uNmx3SiVt,True,85944025,21486006,128487,64243,64244,3zqXX6kzhkbW3d4TwD2CNjMRwxTbREXySekvq37kfCNk,5139515,29857969,-24718454,598
2022-01-22 02:11:34-05:00,7298,9psSuFHBGqCvcgNMc7aTMhKMMFwBDmW7v5Wkn22KtTHj,7zi9LSfuEhXccQXSRukRRwgQUaiQVVgfsGaRYLP2JvwB,True,1083447240,270861810,1652930,826465,826465,3zqXX6kzhkbW3d4TwD2CNjMRwxTbREXySekvq37kfCNk,66117202,388720753,-322603551,610
2022-01-22 02:11:35-05:00,7299,4ytoBUwuhAL4YYSCa6AgwrpeVF4eeU8H9NfDxMPZKxPo,Pby2szzsxDrXt4gnbmmaMccXxctZALr8miRtKhGKjsD,True,3644529,911132,5571,2785,2786,4BnQKPLuE3DMTtxp8MjUBytgnhvxqq3ZTqZHTVZo4JJh,222863,2083264,-1860401,611
2022-01-22 02:11:59-05:00,7300,Dv1BABsN7amhjmGBpMQsnMkRLx7MuCVwsnuyTQeZ6uum,BCjscxVo1h16teND6KKiAUy1ftNGTMy1vEEEyAW4ttVG,True,6048197,1512049,9463,4731,4732,HfEnetJ7uBSmZWCjBNxdvv9HEC5nsW4wDV7wu6WnhWan,378556,1987400,-1608844,625
2022-01-22 02:12:03-05:00,7301,442usWu6XpJZvU25bqXeynRrQ15jAzWwU9DWMgHpTn3Q,CtvADKp39bjJf3cPKWNL3wxnhq273fVM4fC5DmEcg5cC,True,1333302232,333325558,2049770,1024885,1024885,3uL2NSR2ZdDqCiKfzA5SwwpddAnit22DBJo6uvvz1rRs,81990825,566515876,-484525051,614
2022-01-22 02:15:47-05:00,7302,Bbd196A866Y9rQWQFt4YGg2R6Jqj7WQGXWPDmrNtPcKf,5gmWk1KwLoRHnhkjxps4Ad6aVk4ZpcfC3McZCWDVCUbu,True,7926973,1981743,12354,6177,6177,72FwbpFGoLEazJEdpqNtPNefsadUrimUqma9wSoy4qiS,494190,6379014,-5884824,623
2022-01-22 02:15:50-05:00,7303,H6fVnghBUSJRKp2mxSG7Fq2Lr4dE3YMS7yM1XTrxoe3Z,JjgtLi79grUZXofhWukB1yNXZkXFMUX5jm9HcXNDsB6,True,715299,178824,1116,558,558,3zqXX6kzhkbW3d4TwD2CNjMRwxTbREXySekvq37kfCNk,44654,455516,-410862,624
2022-01-22 02:15:51-05:00,7304,6b7Ro2myM4HcUDqyyW9NEqTWPz8BWpH4eNFSQQci37So,7r7j7rSsa6YZcTuRPfs3KP44MVqUA4Q5NeJGmx84wbHq,True,3478539,869634,5421,2710,2711,3zqXX6kzhkbW3d4TwD2CNjMRwxTbREXySekvq37kfCNk,216860,2788777,-2571917,623
2022-01-22 02:16:36-05:00,7305,3Xbsek5MsEGoWr3G9yhuohREr26B2vSQcjqXdspTFHta,2rPxkUiMo9wGDq8EvAiwY3ngRpKmL223cBWWNTYoBmFp,True,11948182,2987045,17861,8930,8931,3zqXX6kzhkbW3d4TwD2CNjMRwxTbREXySekvq37kfCNk,714457,5294884,-4580427,597
2022-01-22 02:16:36-05:00,7306,5hJereyPSCNUrGW7TdYXHKjhXMWTbGZzc2GF9MWksLJE,AUE3NpqaeamHGBKUVuKnUhnBb4Lzt7xWU1FHMu1Hq5dC,True,101451348,25362837,149660,74830,74830,3zqXX6kzhkbW3d4TwD2CNjMRwxTbREXySekvq37kfCNk,5986400,46656091,-40669691,590
2022-01-22 02:17:42-05:00,7307,7CSCMFa9W52tBDVUbXbc3woAy3GByeA1wPJdp3MgznPa,3447ptuVFu6G8B6N63RmS8mRv4n9PfHneypHLvbeaGLn,True,4765939,1191483,7238,3619,3619,HfEnetJ7uBSmZWCjBNxdvv9HEC5nsW4wDV7wu6WnhWan,289557,3667317,-3377760,607
2022-01-22 02:17:42-05:00,7308,Ayx8dFsVzUBb9b7QKxw7YHJuhptdSitBXFEczXTaxe85,EvU1VLChnowi6ccSPeJRSk65njrqZfYouAN7SHePxsxf,False,720,720,21,1,20,4BnQKPLuE3DMTtxp8MjUBytgnhvxqq3ZTqZHTVZo4JJh,21,638,-617,291
2022-01-22 02:17:42-05:00,7309,7W6ih2ZGXaE6tvuQFUPCvc7NvEJHy7UffgoVX3ZPdLXt,6uQCkeMjEXHBQxE2HD33RM1zyTsSko1fYZA1mWUggJ5B,False,791,791,21,1,20,HfEnetJ7uBSmZWCjBNxdvv9HEC5nsW4wDV7wu6WnhWan,21,622,-601,265
2022-01-22 02:17:44-05:00,7310,AHm7zF4rpaxaayBLn5QDHgJSp8KAr647s4cNvQ9wLgd7,FDM33WngED24pukBvSDpPAzinW6afVAeGReum5nyLRiC,False,19077,19077,767,38,729,4BnQKPLuE3DMTtxp8MjUBytgnhvxqq3ZTqZHTVZo4JJh,767,17061,-16294,402
2022-01-22 02:17:44-05:00,7311,EsRMkRaxhpF8roFS5CwMvTsbxLzJgpFsmQ1oHrn6jzmY,2Mxw76BgfopX5eGwFwzBZ2xGUSsTTCeJkGr36v6V8Fck,False,7329968,7329968,300301,15015,285286,HfEnetJ7uBSmZWCjBNxdvv9HEC5nsW4wDV7wu6WnhWan,300301,6023590,-5723289,409
2022-01-22 02:17:45-05:00,7312,62PLFKZ9cmzY2ZSA7G3co7zUygnbGSFWBtUpqBUirmqF,4jRR2v8kpf5HzN1voCqw655QC9nBAyh7kLGkux2vHRZT,False,5574522,5574522,257327,12866,244461,4BnQKPLuE3DMTtxp8MjUBytgnhvxqq3ZTqZHTVZo4JJh,257327,4553182,-4295855,461
2022-01-22 02:17:45-05:00,7313,BdHvHM3DBBmhaxVgUG76s7ksZamWJgwRHVvQkcUdncUM,EPV6oEXcEaumegnLYUm8KZxa7MhAzV4yURyJfBTK8ZjC,False,6268310,6268310,302945,15147,287798,HfEnetJ7uBSmZWCjBNxdvv9HEC5nsW4wDV7wu6WnhWan,302945,8098455,-7795510,483
2022-01-22 02:17:45-05:00,7314,5JFrEg61m6doRepvNFG1CH482oCfKtBPoq4mCvHYZH5T,CU6PGkQPezqAssYsApxCsitKuGjdwskbuVrRuhqmVqU6,False,5953285,5953285,270396,13519,256877,HfEnetJ7uBSmZWCjBNxdvv9HEC5nsW4wDV7wu6WnhWan,270396,4859802,-4589406,454
2022-01-22 02:17:45-05:00,7315,E5DXwW9rZdBRQPC6qu2zoh48xxnrLRXsZS2fZQ6Z3rC2,6X8YPwJinjCanbNpg3hQrd3hXYzCQR1cuLZFgAWiWvUM,False,4772708,4772708,210386,10519,199867,HfEnetJ7uBSmZWCjBNxdvv9HEC5nsW4wDV7wu6WnhWan,210386,3900887,-3690501,440
2022-01-22 02:17:45-05:00,7316,3PNJKoeTLt4KTHtkjK3JZooKfQMFjca5wFkfR6R9bmaq,HufTdMLqaenWqQE8SCnii5RAuWKigNLAdedAPP3zftMh,False,14214,14214,696,34,662,HfEnetJ7uBSmZWCjBNxdvv9HEC5nsW4wDV7wu6WnhWan,696,11125,-10429,489
2022-01-22 02:17:45-05:00,7317,o2aCmkxsxSiyUX8soTEjwUCbJeXmCZsEaf8CWwxDT5n,3pvS2bTsUuiQyqZp5rdnTpq4cqWGgtv4E5rN9HsBxpRt,False,740,740,26,1,25,3zqXX6kzhkbW3d4TwD2CNjMRwxTbREXySekvq37kfCNk,26,450,-424,351
2022-01-22 02:17:45-05:00,7318,ymyzGH4Qc7HH5PbKpVphCbsQgLLXyGkPcXamQJuNj5C,8oTLHaV2XzbKXNWRuUjCfHjUn61Pw93LYK14m9q2VDpZ,True,319001,79750,405,202,203,HfEnetJ7uBSmZWCjBNxdvv9HEC5nsW4wDV7wu6WnhWan,16225,236274,-220049,508
2022-01-22 02:17:45-05:00,7319,M69XSefqeum2arinvHEqmA3L2XHWNFN17p4msRhRZXf,2vK15yYUANLSbAoiBfgJ9VLyqsmtEpd2iNytQjms8GaQ,False,6283232,6283232,307011,15350,291661,HfEnetJ7uBSmZWCjBNxdvv9HEC5nsW4wDV7wu6WnhWan,307011,6671450,-6364439,488
2022-01-22 02:17:45-05:00,7320,9kYkFDNE3qD6s73fn8kJowgqbDZoDSw22XaUJ7rTD43D,E8zJz8pT2c9aZsxe4kLMNs4bY7skt38SU5wK5JTqbGr6,True,92502001,23125500,119657,59828,59829,HfEnetJ7uBSmZWCjBNxdvv9HEC5nsW4wDV7wu6WnhWan,4786312,75071704,-70285392,517
2022-01-22 02:17:45-05:00,7321,6Y1UoGwrKyKsScZQm9ng1rNrXXykKT82V7kUopc43kAy,8YtWQTTKymCESbPMWCP9TMehbMU25zJMtxt9grqrpbD4,False,879038,879038,36689,1834,34855,HfEnetJ7uBSmZWCjBNxdvv9HEC5nsW4wDV7wu6WnhWan,36689,1184740,-1148051,417
2022-01-22 02:17:45-05:00,7322,HGAFdundf5voDqeh9g7d6Q9mgMf8eEg898QMRBqwPZ6C,deanBuZXWBHEe2TGfP37S9aMBEnEgmZoyRJjAvruzfA,True,3791129,947781,5081,2540,2541,HfEnetJ7uBSmZWCjBNxdvv9HEC5nsW4wDV7wu6WnhWan,203260,3227086,-3023826,536
2022-01-22 02:17:45-05:00,7323,EmXaq1sxmAZUiwYW6LXpKtKFZXu5MzQ3sK4MEAojDK1h,HuAsa5G2wJi8Ah9stxEmggwcB5zW1QjBsP3Ndgke7r8X,True,8079016,2019754,11092,5546,5546,HfEnetJ7uBSmZWCjBNxdvv9HEC5nsW4wDV7wu6WnhWan,443719,6533945,-6090226,549
2022-01-22 02:17:45-05:00,7324,EwGnQsfyNv3bQSj8gqF2ZAa4YE2MfJybKqb3xEodFUkW,3LurEajwp3CzBPbaJSJSHAgD8CgecwvWJ95fdUKMkGiU,False,5664116,5664116,227940,11397,216543,HfEnetJ7uBSmZWCjBNxdvv9HEC5nsW4wDV7wu6WnhWan,227940,4657160,-4429220,402
2022-01-22 02:17:45-05:00,7325,2tYCtJ377Jt8noUwmnjK3YwDsfsP7K7UcjQ1cMXqgNR9,2CJjxgqjzZjtoKG1zTTEkqcmf2x6EZCJBWe2ypj7niw5,False,5436377,5436377,267004,13350,253654,HfEnetJ7uBSmZWCjBNxdvv9HEC5nsW4wDV7wu6WnhWan,267004,4414493,-4147489,491
2022-01-22 02:17:45-05:00,7326,3R2wxFQwjCqUwwxJmp9tNrT6osYFpB5gczq2QYik6QYm,7At5Ej3ZsynfWr56FYrd4P4Y6UtD8FHA4gCFB8TaAyaG,True,6053236,1513309,8450,4225,4225,HfEnetJ7uBSmZWCjBNxdvv9HEC5nsW4wDV7wu6WnhWan,338004,4894966,-4556962,558
2022-01-22 02:17:46-05:00,7327,5ek257JwzV27kFiv9zdpVVyTz7HyuZicsJyUMFSeXnX,8rpHQHBTkq5a8Qts1nyfbnFwjQjkLcmjgTKKbC8KjrBf,False,14219,14219,700,35,665,4BnQKPLuE3DMTtxp8MjUBytgnhvxqq3ZTqZHTVZo4JJh,700,11124,-10424,492
2022-01-22 02:17:46-05:00,7328,7QDEq3mN94qSZ45XXdyBhvWnRDi6HypHaG3YTDLwtuB3,HgS8Nd3xmmJ5UiqybdGXxHLQxRkkvR1S9QwZn8gRg2fu,False,5598519,5598519,232925,11646,221279,4BnQKPLuE3DMTtxp8MjUBytgnhvxqq3ZTqZHTVZo4JJh,232925,4599944,-4367019,416
2022-01-22 02:17:46-05:00,7329,CyWBZ1xJ9LahUnPesbXLZ4Rr5UyWAHgVFYwfrnhyrkNL,2Lpk87Xth8ZL5J9BfzmMpEE3x76FDrrrmdKiCNkSVip2,True,8224012,2056001,11736,5868,5868,4BnQKPLuE3DMTtxp8MjUBytgnhvxqq3ZTqZHTVZo4JJh,469470,5398535,-4929065,570
2022-01-22 02:17:46-05:00,7330,DiPSJvnnEwg1En7HJfEsKrUbBgtUf4KzGMyMCZDQSYgp,s8UVC6vPBofuXUS6RW1aQmZ8C35PrC5r4A6ugmvzLGB,True,33631,8407,48,24,24,DddJ7EWCmYEEZETCBNgAUSg81Ls6fZtiAaY5ekJ5sXx1,1931,20925,-18994,574
2022-01-22 02:17:47-05:00,7331,4yhW5mBsFVNgQ5QQc2Yg65guctPsTSXcERbzmYM6rdnL,5uJnMZ6DWA9bMSvHvS5zomwtt1sv7YCWq3GDJh77YC3q,True,5935631,1483907,7848,3924,3924,4BnQKPLuE3DMTtxp8MjUBytgnhvxqq3ZTqZHTVZo4JJh,313932,4817302,-4503370,528
2022-01-22 02:17:47-05:00,7332,HdRgh9niYSd3YKCxzGdusYFquiVoFTP2mEGEzJJL5Nii,78C68Gbb1jYFQmYNCHHjL52keEKMXtGukmBwT7ahon4B,True,664646022,166161505,860550,430275,430275,3uL2NSR2ZdDqCiKfzA5SwwpddAnit22DBJo6uvvz1rRs,34422030,446285616,-411863586,517
2022-01-22 02:17:47-05:00,7333,U3vvMQ4X4aKzVYfhMw1V1p58HRqaLnuXozqmmefYeD9,7JA94MArkNCFRhBq8f5a32DgMF6aPdFsoC5HvXDQ6NuR,True,7284225,1821056,9379,4689,4690,3uL2NSR2ZdDqCiKfzA5SwwpddAnit22DBJo6uvvz1rRs,375182,6687740,-6312558,515
2022-01-22 02:17:47-05:00,7334,51yPLtXTgL9oLKs1cCf5TjL54Ld5vuVxat2NNtwZVsZG,7UjtM7Z1tiXEQMMiorQyncgi9SKu3v46DhVdgXbWqSiF,False,8221228,8221228,378575,18928,359647,4BnQKPLuE3DMTtxp8MjUBytgnhvxqq3ZTqZHTVZo4JJh,378575,10981657,-10603082,460
2022-01-22 02:17:47-05:00,7335,HGJoZvLakWfSDFwuvShNBc4kCf7nP7VqzyM3mELpbFEf,12Qn5jin7QvsBngXqYAv4UstyG3b6nRf1jsLp9Dp8G7k,True,376145,94036,487,243,244,4BnQKPLuE3DMTtxp8MjUBytgnhvxqq3ZTqZHTVZo4JJh,19487,312217,-292730,518
2022-01-22 02:17:47-05:00,7336,Ecpu1wBKxKGUMxb7kP483xkoZ9HZZ4PM3kT9uj6nUAKg,CCVmomGHRFbCwbFUwv5q9Gfa3pV2CFypg9JAF86TiBcZ,False,5592201,5592201,265950,13297,252653,4BnQKPLuE3DMTtxp8MjUBytgnhvxqq3ZTqZHTVZo4JJh,265950,4564618,-4298668,475
2022-01-22 02:17:52-05:00,7337,4iPTUqUGM6D2smveHEgEbJF6SSsaUyFtvzv7MarNhTGV,8DgAH2dgCZGjV2gm2MzqvkgLwDhSLnq98Nwm5B5JRYJ2,False,6370058,6370058,291078,14553,276525,4BnQKPLuE3DMTtxp8MjUBytgnhvxqq3ZTqZHTVZo4JJh,291078,5198263,-4907185,456
2022-01-22 02:17:52-05:00,7338,ANXYsUNpZ34dBt7cp6HEE7oi2pTKsbj7B5TeFHKPbHBU,2pqeP4fuMREosHcfWUecEBssp1GM4isihNjn7ALUD51d,True,7365145,1841286,10483,5241,5242,HfEnetJ7uBSmZWCjBNxdvv9HEC5nsW4wDV7wu6WnhWan,419334,5944813,-5525479,569
2022-01-22 02:17:52-05:00,7339,57Vsw8jXaaoLriYEkvPAVyq66r4a4zMfLWbDaTBMjFzC,7AVDWUTHa6729UkXgCXASphSmrLvXYGAA9ygTMSqvwvY,True,5889523,1472380,9060,4530,4530,72FwbpFGoLEazJEdpqNtPNefsadUrimUqma9wSoy4qiS,362412,4729149,-4366737,615
2022-01-22 02:17:52-05:00,7340,84SgzR8J6DeqPJ1uXphP1BHMotYGKh3kS4owMMj9x58x,CL7Jkwe3NK4qaAVK2QjuftXnQ5YLqDT9qYeeEi7kJXrV,False,8746382332,8746382332,374699019,18734950,355964069,4BnQKPLuE3DMTtxp8MjUBytgnhvxqq3ZTqZHTVZo4JJh,374699019,7925794377,-7551095358,428
2022-01-22 02:17:52-05:00,7341,8CQ8wTkDHxhDjxtARpqi1NvwhgvifEgmmsaZi53L6rDM,6BgagW5MLhH3tXKPVyN6ZDotT1TkcZ2bb3kNBKLY3cKm,False,3534937,3534937,170083,8504,161579,4BnQKPLuE3DMTtxp8MjUBytgnhvxqq3ZTqZHTVZo4JJh,170083,2997429,-2827346,481
2022-01-22 02:17:52-05:00,7342,FS5xx53Bo65G21gJLta7LEEiS132VJM1kGpUzuqyfzoy,2kbTLjdBBA9K1coxKmwmYbjq2heSnuNg4Nh2EfVNYgwj,True,18253126,4563281,27252,13626,13626,HfEnetJ7uBSmZWCjBNxdvv9HEC5nsW4wDV7wu6WnhWan,1090089,7828276,-6738187,597
2022-01-22 02:17:52-05:00,7343,EmGW2aAG69ssWqCtbfDocRaM2u3TJsczn2HHP9jdmRvD,aypkDKsp9uqAB4F6mwvm5LofpsrFBuZT2MMWtE2eHdB,False,14864,14864,620,31,589,3zqXX6kzhkbW3d4TwD2CNjMRwxTbREXySekvq37kfCNk,620,12517,-11897,417
2022-01-22 02:17:52-05:00,7344,9Hz4p7gcfDbXBJp8KzhaBBPh9i7xe9kun7zLfDtqPe6c,2bJ43Lep6kp6WY7Ct56oiscKnAbdtC265G5yRvRPFThU,True,22014684,5503671,27878,13939,13939,4BnQKPLuE3DMTtxp8MjUBytgnhvxqq3ZTqZHTVZo4JJh,1115153,10951528,-9836375,506
2022-01-22 02:17:52-05:00,7345,9BMHbUs4d3qX49fnroHv2FTPDs4yoDFrvDMqf8p9U4pE,2yL7zwMr7qVG5Sdwkf7z6ppnNqt1ASppBbmxwYjfFY6Z,True,93613776,23403444,119800,59900,59900,72FwbpFGoLEazJEdpqNtPNefsadUrimUqma9wSoy4qiS,4792032,76016626,-71224594,511
2022-01-22 02:17:52-05:00,7346,2fyVBNx9V7YT3HXP5BWgteS3X94Hc9Qw8mEXdv9F5P4T,EHmTcchLaxfd77oJqDMh5ebw8DXG9b5my7rnyoBwPGcp,False,90017686,90017686,4450702,222535,4228167,DddJ7EWCmYEEZETCBNgAUSg81Ls6fZtiAaY5ekJ5sXx1,4450702,73802080,-69351378,494
2022-01-22 02:17:52-05:00,7347,B9ip43CcQ8cARn5NKT7ARev1LtTwBsMyFzQcRNxKZppH,HkL4QXHHX3PTYiWHw3wKDFujnD5K7DBi58MFRrEGkHyo,False,5587418,5587418,253402,12670,240732,72FwbpFGoLEazJEdpqNtPNefsadUrimUqma9wSoy4qiS,253402,4565488,-4312086,453
2022-01-22 02:17:52-05:00,7348,CEtpqFD4BbeiNfaXyLLYEapY2mWgE26H5q6H34tWwRuD,BVqRyqwGFPzSkk1H2finiyfaL3LScbEiQGk3mihirxqs,True,4441498,1110374,5782,2891,2891,4BnQKPLuE3DMTtxp8MjUBytgnhvxqq3ZTqZHTVZo4JJh,231300,3529574,-3298274,520
2022-01-22 02:17:52-05:00,7349,GRTpRhhDdiecBjFaeKKr4rpP4gZWTrcd2jtdxAiuYDhF,EVyXAd6kJVQmQZRwpmNkbLv7fn4kaYyqLb2EzarGWRS,False,7899561,7899561,363086,18154,344932,3zqXX6kzhkbW3d4TwD2CNjMRwxTbREXySekvq37kfCNk,363086,6438690,-6075604,459
2022-01-22 02:17:52-05:00,7350,9vcKW1GfrDZ3KLPh2pEVFF8ZyKqD1pJW1hiE8H98Av7S,C6Ki27mo4sCHu6u8UnR1p7WSgsTjFQxGGR9Lk9n5Rhjq,False,64373,64373,3046,152,2894,3uL2NSR2ZdDqCiKfzA5SwwpddAnit22DBJo6uvvz1rRs,3046,55810,-52764,473
2022-01-22 02:17:52-05:00,7351,FL1C5wMXApaNzez9LFMAiFYVFiLSRQxgZ3GfPrscdvRB,2FkYGYyTzbTFjJBiggre23H7TvqHjzBTdyrzQ5VNGqht,False,917817,917817,42412,2120,40292,72FwbpFGoLEazJEdpqNtPNefsadUrimUqma9wSoy4qiS,42412,249842,-207430,462
2022-01-22 02:17:52-05:00,7352,D58t4uTjFumsUeYFaKnpV8BRTEQEqKXBreFTdwGrott7,67p6kHDfVqQijfcwugvZK59c3aRRH9x3eHxruqH8WEqF,True,17334083,4333520,26503,13251,13252,3uL2NSR2ZdDqCiKfzA5SwwpddAnit22DBJo6uvvz1rRs,1060143,7115736,-6055593,611
2022-01-22 02:17:52-05:00,7353,HPDN6Ro6gPgYbNgnv7yhFCpyY3uYzT18epFxRFNZ985w,3Jop74A52E7gYLXJRUAoPBzSZ6mmP2gmaCg7eG6eQHu5,False,25580616,25580616,1244150,62207,1181943,3zqXX6kzhkbW3d4TwD2CNjMRwxTbREXySekvq37kfCNk,1244150,13676674,-12432524,486
2022-01-22 02:17:52-05:00,7354,CagSUfZLwXuCdypC4KzU6FSNdmCj9dKDroPcNeaRtsyt,yxw5d1ztZuEUY2QjL7eLpr72QJAj5rJd6ERvg91cy1m,False,37488,37488,1874,93,1781,4BnQKPLuE3DMTtxp8MjUBytgnhvxqq3ZTqZHTVZo4JJh,1874,27783,-25909,499
2022-01-22 02:17:52-05:00,7355,ES1MDwRUa3hoToPKQiiZkzMYe9PDVnAQwMrEvZrzvnc1,C4wBG3xTDkmDQneB28xYnf1aBNEeq7UB8oR7NuEfLkFg,False,633583,633583,25264,1263,24001,4BnQKPLuE3DMTtxp8MjUBytgnhvxqq3ZTqZHTVZo4JJh,25264,436923,-411659,398
2022-01-22 02:17:52-05:00,7356,DdYgcyV1T2CDYiQVr4VL9Ym8RdKm93a7SKy8HxuyaoMW,GPdAeqeXb1UJ56AttcwwY1CyFhRyfptDC4BAX2Tc8MpE,False,12181,12181,581,29,552,72FwbpFGoLEazJEdpqNtPNefsadUrimUqma9wSoy4qiS,581,10955,-10374,476
2022-01-22 02:17:52-05:00,7357,woTXSsDkL9TQNxc3zwxSPagVijX7PE24bgKjvxexRwQ,A5M5EEPfDgvAxGLhpNgfn8AzPmyXxmPVgkEKnyoVzsz6,True,246100,61525,374,187,187,72FwbpFGoLEazJEdpqNtPNefsadUrimUqma9wSoy4qiS,14979,248243,-233264,608
2022-01-22 02:17:52-05:00,7358,CYv2hNAzvRak1LBSayFxMJEXoAQdMEZHnNpQLZ5G5RVo,HkvTQbtKxWv2E5z6MsViv1LS4jm8T286fiY1C7n6ZZ9C,False,195620376,195620376,7755922,387796,7368126,4BnQKPLuE3DMTtxp8MjUBytgnhvxqq3ZTqZHTVZo4JJh,7755922,182303218,-174547296,396
2022-01-22 02:17:52-05:00,7359,8nXbrdjjaHB73CRPRenGEQj73wbtEFGDwXsehRGMhsap,43pvdcJ6f27wz94D6ZboKwRJYbyvYCrjsJhYsvk7LJCM,True,1494604,373651,1971,985,986,3zqXX6kzhkbW3d4TwD2CNjMRwxTbREXySekvq37kfCNk,78876,726052,-647176,527
2022-01-22 02:17:52-05:00,7360,2DHhfXSzcuSwsKfAYLMuWuD17w84mCwNer9fcBNLTpSc,89BVfDycKjdSkQzFVqCXd5c16DntdND7WsqoZtCafYFH,True,289322313,72330578,390065,195032,195033,HfEnetJ7uBSmZWCjBNxdvv9HEC5nsW4wDV7wu6WnhWan,15602606,226229793,-210627187,539
2022-01-22 02:17:52-05:00,7361,D2L7ST8iGsRfZ4zj2pdfKTptbojQ4cDtHKQ8ngcFVQwA,7cNrHGWJ6FGGazfGaCePs8XyaK6bwVLrYFCUJQi9w2Wc,False,1558,1558,65,3,62,72FwbpFGoLEazJEdpqNtPNefsadUrimUqma9wSoy4qiS,65,1214,-1149,417
2022-01-22 02:17:52-05:00,7362,7aBHHP6sEWg6s7H3BADdx8YiwHTRV4jNTWLNMy1xfv7,484eWXa2zXsNeuaGRE2w9do4SL3fG1PjNs8Ra9bGciK3,False,5414591,5414591,228355,11417,216938,3zqXX6kzhkbW3d4TwD2CNjMRwxTbREXySekvq37kfCNk,228355,4443757,-4215402,421
2022-01-22 02:17:52-05:00,7363,9zpPiboHF5HW7NfCx7hYdmJGwUomVMTiUFc4Um5KrDi3,8q3eBpuwV6dMNkib9N8XQAq2tBUcjSANRe5SXpd4dFhZ,False,189046,189046,7692,384,7308,72FwbpFGoLEazJEdpqNtPNefsadUrimUqma9wSoy4qiS,7692,128669,-120977,406
2022-01-22 02:17:52-05:00,7364,CvZssqscu2dm35mwcE3zg9zedavbRjVJjWD59Py5ExUK,7pXaoR6aHKYofCmg1eHipygNYDteEaf8rbbS8BDYGQK6,False,16208,16208,728,36,692,72FwbpFGoLEazJEdpqNtPNefsadUrimUqma9wSoy4qiS,728,11643,-10915,449
2022-01-22 02:17:52-05:00,7365,Gs3WP18hbzNpbBgiU39e6tfkggfCKRyNqPqJQcthuHFD,4XAY25YUma6gUdG2GdbXeivum3t21g93ZagfWGTZYkWZ,True,805603,201400,1140,570,570,DddJ7EWCmYEEZETCBNgAUSg81Ls6fZtiAaY5ekJ5sXx1,45631,592102,-546471,566
2022-01-22 02:17:52-05:00,7366,AvpYg74EBhwAXE8rcdGkpwmbBMRyVidF6zMRSFtWAVC6,4WgpqTp4r9wMpMptYMNbvCaP2faBnVr6FdShCAobetpL,True,5972100,1493025,7582,3791,3791,4BnQKPLuE3DMTtxp8MjUBytgnhvxqq3ZTqZHTVZo4JJh,303296,4853431,-4550135,507
2022-01-22 02:17:52-05:00,7367,AiLCB8xw3k5FXdJE1T42PLFhHrz1bLTKpNekR61a915N,HB7CNWxLipWAc6MPGq9wV4TT7AYjiELA5T3onYeVqBbU,True,121594137,30398534,169855,84927,84928,4BnQKPLuE3DMTtxp8MjUBytgnhvxqq3ZTqZHTVZo4JJh,6794225,99178474,-92384249,558
2022-01-22 02:17:52-05:00,7368,33fBsmAi7CdYxccnzMoGsdyCoAWmatJbrEEdUXZzUWft,EyEcNqLYXC2Aaecbun5VEeAGKSPok97PeD4sf6rBVkuj,False,6215184,6215184,269458,13472,255986,4BnQKPLuE3DMTtxp8MjUBytgnhvxqq3ZTqZHTVZo4JJh,269458,5083731,-4814273,433
2022-01-22 02:17:52-05:00,7369,FLQcLhAsRBKnLcSYkK94Za6NhGudrCGhGGxFTdDhVC6L,7vr92sRGp6DopaDv3wJr7gw4BFmxY74K8kFheKyxZdLX,False,12045,12045,584,29,555,3zqXX6kzhkbW3d4TwD2CNjMRwxTbREXySekvq37kfCNk,584,7430,-6846,484
2022-01-22 02:17:52-05:00,7370,2vRdBUakRbsdKAUbcDzE5YqNWx3DCc8XuLewhwM39UqK,2hcQX5ZsQBPzb9HPEp94H8k9rjj7cew6VEU8RbVKXLX9,False,7463590,7463590,340914,17045,323869,72FwbpFGoLEazJEdpqNtPNefsadUrimUqma9wSoy4qiS,340914,6087601,-5746687,456
2022-01-22 02:17:52-05:00,7371,6tFQaTqqffino9kwMZTL2xVNBG8k9VREFhXqVi2si3A3,3w3wGxBbS4bmXeqmvd595SAWFeXekVpnH4UdbeEs8Sx5,False,100889,100889,3996,199,3797,4BnQKPLuE3DMTtxp8MjUBytgnhvxqq3ZTqZHTVZo4JJh,3996,72201,-68205,396
2022-01-22 02:17:52-05:00,7372,BrHRMouGRz3LBNzd9anfdYMhWfg8yUPHL4PqJ8WdEDFS,4uzoLa3mC2VYHAPBoHLX4gTjPTC28rPf2fvEGtJWPYc,True,1410299,352574,1786,893,893,3zqXX6kzhkbW3d4TwD2CNjMRwxTbREXySekvq37kfCNk,71472,1811234,-1739762,506
2022-01-22 02:17:52-05:00,7373,DLx1pUQCp78RRLAaKfuLUdQaf3ovhD7dpDTWpNRWFw9W,3dT1vccCWmkcqAfyQ6YPrXXz5SW8RnEPvUeH5QewZnXJ,False,4560750,4560750,199069,9953,189116,4BnQKPLuE3DMTtxp8MjUBytgnhvxqq3ZTqZHTVZo4JJh,199069,3735279,-3536210,436
2022-01-22 02:17:53-05:00,7374,D6qMab7uevXTa89ssv4BRyHwrw3FYpNimAmX2VH2uf4B,8ZauZ5dAp7kyawkPdxi4mqfempFHubJebfBenQdDektD,True,3310152,827538,4680,2340,2340,3zqXX6kzhkbW3d4TwD2CNjMRwxTbREXySekvq37kfCNk,187203,2794201,-2606998,565
2022-01-22 02:17:53-05:00,7375,2ZSfbqxhiCTDrDPeRhoWayTZHNmW7ajVXBCxpFS4eGBF,3ZmWsPdQD7qfSMGKQSNhmBtuH7S6qMFRc8oEmBcHXEiR,True,6019460,1504865,7605,3802,3803,HfEnetJ7uBSmZWCjBNxdvv9HEC5nsW4wDV7wu6WnhWan,304237,4891604,-4587367,505
2022-01-22 02:17:53-05:00,7376,pgzvXpnUYiY7hLrfjmwScqLd8oj9vYcXpFvpm4y4JvG,GdqdQgoyBAFuXdbvoZyDhB3jyqJzVo4nkGh7EPFxkBF2,False,48824,48824,2181,109,2072,3zqXX6kzhkbW3d4TwD2CNjMRwxTbREXySekvq37kfCNk,2181,67404,-65223,446
2022-01-22 02:17:53-05:00,7377,CgQB5KmWNz21q9mPfFBve8Ksbqdsdr8jNfwkrxmNZPLN,2dtPpz7Ck4hhBQq8DUywp4Bq21Jk1enHLe8AgXa8ARZu,False,26699204,26699204,1285329,64266,1221063,HfEnetJ7uBSmZWCjBNxdvv9HEC5nsW4wDV7wu6WnhWan,1285329,20281643,-18996314,481
2022-01-22 02:17:53-05:00,7378,9VSpd4vToJrnQhmJ595Ua7GhmhutYRgd6rCk3pL4yNxr,7axwFe8aQVPYLNgM9rdUwnFf6vW69Jsw2XpKNjYRDn6N,False,7814971,7814971,372351,18617,353734,4BnQKPLuE3DMTtxp8MjUBytgnhvxqq3ZTqZHTVZo4JJh,372351,5606783,-5234432,476
2022-01-22 02:17:53-05:00,7379,4uDqrACGzns1HRKSezhDgFShygnc21GjzmDRvGaQWrD3,GMa3SrgxvtGZzcDXbwLhaiNSsCYNsz82Sm99YgWxx3PX,False,5700400,5700400,264898,13244,251654,72FwbpFGoLEazJEdpqNtPNefsadUrimUqma9wSoy4qiS,264898,4653662,-4388764,464
2022-01-22 02:17:53-05:00,7380,9hB3EPuj4SrSrpAzHvExDb6mzh2vNGGVbj7qqfRjeao4,9725jRXGPRUuo1dijvv8mwzvSu1ed4y5hi9FAQNwb8dG,True,102813063,25703265,145383,72691,72692,HfEnetJ7uBSmZWCjBNxdvv9HEC5nsW4wDV7wu6WnhWan,5815357,82984114,-77168757,565
2022-01-22 02:17:53-05:00,7381,FdYFnEYtFQKcZPmzUqnvNLzozxdR1emtkmvnYcMgYykS,7arWNJQf2cWxerjhLgQh9CJxwTat1efnr5KmhuD7Qnv4,True,4684839,1171209,5901,2950,2951,DddJ7EWCmYEEZETCBNgAUSg81Ls6fZtiAaY5ekJ5sXx1,236077,3809128,-3573051,503
2022-01-22 02:17:53-05:00,7382,8NdcaYUC1X5CP7FMDip78uqtqmCt8GcZdCzLRTYTihmb,9Ei1K9bXWXSXcBfeX5exPSXGCAu62WSKzvnnd4wHvyVh,False,3026,3026,122,6,116,3zqXX6kzhkbW3d4TwD2CNjMRwxTbREXySekvq37kfCNk,122,2453,-2331,403
2022-01-22 02:17:53-05:00,7383,J4krKPBBTMVLZRgrSeYJAMyHQs2FkNm5TXk7nQWwDB43,ASmLbfNbhTD2HHeV7qzAqiHjUx5a8Traj8oPDwbkMdFg,False,654868,654868,29630,1481,28149,4BnQKPLuE3DMTtxp8MjUBytgnhvxqq3ZTqZHTVZo4JJh,29630,477056,-447426,452
2022-01-22 02:17:53-05:00,7384,HtHNRFaoM14udMSVez69Hhn5g7JGiuAcv5kXZJfxjcXr,6P9mmacCVwJ5EDaAAFqxeSXz1aYBepUaVsLRVTcW7iMq,False,4921512,4921512,237715,11885,225830,DddJ7EWCmYEEZETCBNgAUSg81Ls6fZtiAaY5ekJ5sXx1,237715,3999888,-3762173,483
2022-01-22 02:17:53-05:00,7385,HxhVxMpFpKzeuC6Z6CpsuUhPHdHUzvpMNYJ8LpQ3NYCp,8KyiipC39iU15zVErVvj6hdhbv89STsexrB8dVw3RcLs,True,6334499,1583624,8562,4281,4281,HfEnetJ7uBSmZWCjBNxdvv9HEC5nsW4wDV7wu6WnhWan,342505,5127798,-4785293,540
2022-01-22 02:17:53-05:00,7386,6nJyqvFKprwaVCE1gAa2P4RHKc6Pa6XFSJymx654zZ9K,4e7iJmdwzAPxp1Zi8Azo38YyPQdPKqqY4VLJyQ5rpdYP,False,57722,57722,2719,135,2584,3zqXX6kzhkbW3d4TwD2CNjMRwxTbREXySekvq37kfCNk,2719,52172,-49453,471
2022-01-22 02:17:53-05:00,7387,Ht2oWgWWVsA4u5fwp8o8dwgUjoGSRDF2gAwQPDXCwKfZ,8pYWhoNFpmDYuawZub9rd5qkSsAJuPGeJwoa23YyVVym,False,1246883,1246883,52087,2604,49483,3zqXX6kzhkbW3d4TwD2CNjMRwxTbREXySekvq37kfCNk,52087,1216354,-1164267,417
2022-01-22 02:17:53-05:00,7388,DD1a8rMoUCwmEiLKRN43VpdqL8Qgfr5yi92ejQxDVRMo,3vMJVNAuyRhM9jkaEZARhwbR6MerR5UmcgoZ9c5bs1VS,True,110325774,27581443,145788,72894,72894,HfEnetJ7uBSmZWCjBNxdvv9HEC5nsW4wDV7wu6WnhWan,5831556,89432032,-83600476,528
2022-01-22 02:17:53-05:00,7389,7sehUeigZkhQjrNdRDaja2VdFWu7x9vWc1dYQSXz7qR8,DvRnmtGNS2Z7QoM4N5AqUdB7Xd6stwPhJUL3kk4kH2Ex,False,6647073,6647073,288533,14426,274107,3zqXX6kzhkbW3d4TwD2CNjMRwxTbREXySekvq37kfCNk,288533,5438791,-5150258,434
2022-01-22 02:17:53-05:00,7390,Ckqos6cdncPKj13DnCmDVZsZTqp6eS7277CRrT9WhcEr,AtUV8m7VQJvZq7GLCAHMf3jV7iamKEPnWVZHWuuVZQp1,False,28769,28769,1368,68,1300,3zqXX6kzhkbW3d4TwD2CNjMRwxTbREXySekvq37kfCNk,1368,29485,-28117,475
2022-01-22 02:17:53-05:00,7391,3qnPsgqW11AcDEmyjmJquPcPLyE3EdJQuVLJ5kinDrd3,86rZadBB7emKio76aFTahpbrFtxd9tqZ4Mxgzaavq2xU,True,3662,915,4,2,2,3zqXX6kzhkbW3d4TwD2CNjMRwxTbREXySekvq37kfCNk,189,2954,-2765,516
2022-01-22 02:17:53-05:00,7392,5XrU9QLKHL8m66mpfcsqvndBBeQ9t8vA7zhNdB1yAi9s,3FDocKqsT3aUigiW2P7MESU8anAYqg1D9domHCDsxCB1,False,154040977,154040977,6168406,308420,5859986,HfEnetJ7uBSmZWCjBNxdvv9HEC5nsW4wDV7wu6WnhWan,6168406,44972397,-38803991,400
2022-01-22 02:17:53-05:00,7393,B2sFHhYMf3wE6BZAYQbst77ZPoY3Muf9ubPPcWHxSont,5BPmqYokg5b2fyqp2tnFHqXtLocrErvix3YCuwAqUvno,False,5761666,5761666,268032,13401,254631,3zqXX6kzhkbW3d4TwD2CNjMRwxTbREXySekvq37kfCNk,268032,4694589,-4426557,465
2022-01-22 02:17:53-05:00,7394,BYvjENe16Ta77PqGV7JKEWrsqCTfkMGYwTSG5gXneDvd,EvxAXgvhPC6QkNurbK7vWyTApGo8J2R4EgMAknkHVU3d,True,71654,17913,91,45,46,3uL2NSR2ZdDqCiKfzA5SwwpddAnit22DBJo6uvvz1rRs,3670,74711,-71041,512
2022-01-22 02:17:53-05:00,7395,9dvxqJqDhhFW6tMHquhdWCvYcEkSj5XPXd818mnDRKRA,F7yFNuLDaS73XGVyAKMhMYCYbZehKmC8uEG68rZqdFL3,False,4867327,4867327,211899,10594,201305,3zqXX6kzhkbW3d4TwD2CNjMRwxTbREXySekvq37kfCNk,211899,3984327,-3772428,435
2022-01-22 02:17:53-05:00,7396,B4Uc39nKzz9wBRQsCkMR4A7RwTJ8rSuwpR6EQn2AesRb,H49bGZgatRZVpj6QufZRVgYrQtH7LpdbiqKBs23151m,True,599789,149947,771,385,386,3zqXX6kzhkbW3d4TwD2CNjMRwxTbREXySekvq37kfCNk,30878,835919,-805041,514
2022-01-22 02:17:53-05:00,7397,JCagxpXPs6wVRUWbNBPCZ4uLCkZsachnofN7SZEEwGwB,5uGj1TBCkc7FV4ffdBJg31yLcCxkQLxRExjcinnJUow9,True,2667748237,666937058,3763153,1881576,1881577,72FwbpFGoLEazJEdpqNtPNefsadUrimUqma9wSoy4qiS,150526128,2008251360,-1857725232,564
2022-01-22 02:17:53-05:00,7398,H2ZziGps3c5QuRdyeianD1UHYj5eujj8cnYNYQhCiV3E,2HmbZcWsei6SPZ9J85ngNHBJUP5RRaJTqhZRp2TvmjAM,False,6000851,6000851,287992,14399,273593,3zqXX6kzhkbW3d4TwD2CNjMRwxTbREXySekvq37kfCNk,287992,4891692,-4603700,479
2022-01-22 02:17:53-05:00,7399,Fs8MQLaMyr1Q96HsZivKLY7Kjdeu2ZoB2n3VTZ15KbSn,DREfCs5CTVNUUF8H3hD8CWvtxztiYxoLYh8HUWDecMyZ,True,186161271,46540317,284374,142187,142187,4BnQKPLuE3DMTtxp8MjUBytgnhvxqq3ZTqZHTVZo4JJh,11374989,149219006,-137844017,611
2022-01-22 02:17:53-05:00,7400,FYdUiU3rPpbYKWnEpekQQsocSJKjXmscohi4v6DYqix7,daPyq9YdunQJhhLoW5ifhJ7UFPTtRZhGs4JwE1nqZhN,True,6058090,1514522,7677,3838,3839,HfEnetJ7uBSmZWCjBNxdvv9HEC5nsW4wDV7wu6WnhWan,307081,4923851,-4616770,506
2022-01-22 02:17:53-05:00,7401,C9beggursF9WdLyzunVSoz2Bw6kAxoQpUifPHbo4ybvw,3R7KdKBK7FoudsNXUeRuC2AGVFusMhmTYXSGdnA88pJT,False,851518189,851518189,40679526,2033976,38645550,4BnQKPLuE3DMTtxp8MjUBytgnhvxqq3ZTqZHTVZo4JJh,40679526,420922736,-380243210,477
2022-01-22 02:17:53-05:00,7402,2AAWghW6BUAFBtF3R6hB9uoqMc5oUDkU8FTd2JrXKema,798cfEUZ2YhXwNTNjXMS4Z2J8gAHaK4zZwpMkq2HzWWM,True,32389329472,8097332368,41758438,20879219,20879219,4BnQKPLuE3DMTtxp8MjUBytgnhvxqq3ZTqZHTVZo4JJh,1670337536,16274057949,-14603720413,515
2022-01-22 02:17:53-05:00,7403,6SqJHnwgDCdUdUercq1UushY4tKpbJPKTapGM3ub7Sgm,8MQCsx2SzMUCBWkbriEgkP2ooWC6MDRJvT23xLYEYHTe,False,2788709,2788709,124719,6235,118484,72FwbpFGoLEazJEdpqNtPNefsadUrimUqma9wSoy4qiS,124719,2398004,-2273285,447
2022-01-22 02:17:53-05:00,7404,B35LX2SGUTp8KzzNgqA6PHEfF3gTpvb67TTmK23aVLgm,HBSe4EdWZyBp88VDbesyGTdkL5HqNGXeo5eD7wLVpTFm,False,3035243,3035243,118663,5933,112730,HfEnetJ7uBSmZWCjBNxdvv9HEC5nsW4wDV7wu6WnhWan,118663,2499335,-2380672,390
2022-01-22 02:17:53-05:00,7405,3C2MZQKh9x4zNTCMbhhvoafGaFMwUooqfy9MCgPyXs6E,AHjgWKpYPWe6ketjDHDKFBFsKQiRJ41jnkuo39MVYxZo,False,4902698,4902698,240221,12011,228210,4BnQKPLuE3DMTtxp8MjUBytgnhvxqq3ZTqZHTVZo4JJh,240221,4827368,-4587147,489
2022-01-22 02:17:53-05:00,7406,BvoctLT1kkt7sM4C2H26hSKXcjAgreYRTj7rkGt5SPJ2,EFKKd4Upox5TzBSAT96oxfeKBVEfDeE8yxnG3qoMJVGY,False,4424282,4424282,210143,10507,199636,4BnQKPLuE3DMTtxp8MjUBytgnhvxqq3ZTqZHTVZo4JJh,210143,3754201,-3544058,474
2022-01-22 02:17:53-05:00,7407,BEpTAoTBPSNi7axppx2AC8frxWHptPBxtNPentBa9dHA,8uBZccwMQQcibm59CkwrQyhfrw3aLm6VX2bKjpEoEMrm,False,5395515,5395515,242335,12116,230219,4BnQKPLuE3DMTtxp8MjUBytgnhvxqq3ZTqZHTVZo4JJh,242335,4404335,-4162000,449
2022-01-22 02:17:53-05:00,7408,GcjcaWoMUcGkLaJBx3svxtzwGNn5SLcFrwaLqnpadUZY,Ep9sDjTMMasVjKdshsE88uk3mWYkKuMTVRooVJWvCq9F,True,91606671,22901667,119815,59907,59908,4BnQKPLuE3DMTtxp8MjUBytgnhvxqq3ZTqZHTVZo4JJh,4792624,74297973,-69505349,523
2022-01-22 02:17:53-05:00,7409,5RvNKzSeJ1fvqsKpcQu25evEZGmKjyEDgwsMZkykoT3P,BRqSGfE4XHXu4HrinwetWumfVTmr82iuF6Y5oSV6eMiK,False,3374,3374,136,6,130,4BnQKPLuE3DMTtxp8MjUBytgnhvxqq3ZTqZHTVZo4JJh,136,2348,-2212,403
2022-01-22 02:17:53-05:00,7410,BAczoNDnbwj5AJX5LwzynzYab7ji7VbhRy9edA9Prax,34sbkUKnMetUNyMs6BhiWut85d5UZtBWnPtwx8jEpJNA,False,29888,29888,1174,58,1116,72FwbpFGoLEazJEdpqNtPNefsadUrimUqma9wSoy4qiS,1174,24739,-23565,392
2022-01-22 02:17:53-05:00,7411,69byqtDPmgEY1NqKBCR95CEPVHRUxgbNW9Y4P4HjQ7ND,E47T4q4zMGzNL6vDxgWdLn3EQbW3WfVryr8Jsymy1hAL,True,9977324,2494331,13935,6967,6968,3zqXX6kzhkbW3d4TwD2CNjMRwxTbREXySekvq37kfCNk,557408,7263935,-6706527,558
2022-01-22 02:17:53-05:00,7412,3MEiFqy4F9nBW8gHxvGjv7norSBHwxhbzzNKngPk1RHq,2tcsJ4NUJegcEfHNwWPh979yKjKmq568CpNm5iWGbuoR,True,2029385,507345,3107,1553,1554,3zqXX6kzhkbW3d4TwD2CNjMRwxTbREXySekvq37kfCNk,124286,1198415,-1074129,612
2022-01-22 02:17:53-05:00,7413,Go3ne58krEsFsZ5yu9EBT7od15VCYmtbs1KhumRMTiXS,HCvwQ7HjmmeDXrguZQPrAbJjcCJzHqVZK2JMSFkFDWfe,True,2071609,517902,2873,1436,1437,3zqXX6kzhkbW3d4TwD2CNjMRwxTbREXySekvq37kfCNk,114944,1750708,-1635764,554
2022-01-22 02:17:53-05:00,7414,DdAPWdHnb7ocaYtcwwwYnppsH39sZpmzMyANeoJbCV7s,3BVmC39L8dEypPN1BZhsf9bx9Ge2sXCZR8Y6RH4eBNMJ,False,24359769,24359769,1088129,54406,1033723,3uL2NSR2ZdDqCiKfzA5SwwpddAnit22DBJo6uvvz1rRs,1088129,28653321,-27565192,446
2022-01-22 02:17:53-05:00,7415,BLJgLzizx2yLgd12pVBAHTMqn9J5JA3JHCF8PnLnPyUk,HhDmwMysBFWhXnd3mrV31w75WBRKBS8wJSiEMZgqdUSp,True,23669965,5917491,29741,14870,14871,HfEnetJ7uBSmZWCjBNxdvv9HEC5nsW4wDV7wu6WnhWan,1189659,19752342,-18562683,502
2022-01-22 02:17:53-05:00,7416,6BQVtmNsxihi4PcA7MurtguTwa6SmbmKyP14RHyjVZkf,7ZFv5ms4HzVKiw7KgE8RUoKxW9rB6JUD7ujZxMx4DwnM,False,76769,76769,3822,191,3631,3zqXX6kzhkbW3d4TwD2CNjMRwxTbREXySekvq37kfCNk,3822,53750,-49928,497
2022-01-22 02:17:53-05:00,7417,FtF3PVw8YNJseWPMcA2GEuQZ6nni1mq5kYPa2LrSzfkW,4yr1TM2dXrBvLNMpSaoryuGU2P8D3WG1ZCkvVzWFiQRH,True,8672729368,2168182340,12417375,6208687,6208688,3zqXX6kzhkbW3d4TwD2CNjMRwxTbREXySekvq37kfCNk,496695030,3228009382,-2731314352,572
2022-01-22 02:17:53-05:00,7418,Hqzz5RdbkkmMPCVdxF3Q3sLuh7XVJHEwAP6zpz7pCwTj,TNwXSETgrJGM9S5zbBY3mMWKbPFskbKjPAhBrWFNfuK,True,5385428,1346357,7198,3599,3599,HfEnetJ7uBSmZWCjBNxdvv9HEC5nsW4wDV7wu6WnhWan,287950,4358387,-4070437,534
2022-01-22 02:17:53-05:00,7419,67Z7ZGhNu5xxEh9BYKWcXp9m1T4tFiE1o1M16hCzUWQA,CT7YKWixz7BhTbvg5F6M5HCyPGnHoFLNFuDV9GhoLTo3,False,75183,75183,3492,174,3318,3zqXX6kzhkbW3d4TwD2CNjMRwxTbREXySekvq37kfCNk,3492,74342,-70850,464
2022-01-22 02:17:53-05:00,7420,A3E9T7xYkPeNiWKdvhNTYiD5j7k2Xecpe318eFqVro4m,2QJk8iVJEy2QZmbFHnR7RBJsi7NpXWFFkEmweWtKKHfE,False,44986066,44986066,1848421,92421,1756000,3zqXX6kzhkbW3d4TwD2CNjMRwxTbREXySekvq37kfCNk,1848421,41023208,-39174787,410
2022-01-22 02:17:53-05:00,7421,5sN3cfz4hZjwy2HkAStKWeL8wHhdbkW8F7USzwCzmggh,Fme7U7QY92biAsV3RR2Fj7rJPnpdcov13mmFhVDFuyYG,False,16562647,16562647,816185,40809,775376,HfEnetJ7uBSmZWCjBNxdvv9HEC5nsW4wDV7wu6WnhWan,816185,12631573,-11815388,492
2022-01-22 02:17:53-05:00,7422,BXMMFy2k9b2hVBEG6RyXAq3qqXxJ7EY2xhyPZqtLvBiU,KpoZwr4ZFTHJgebbf4tcjT9iKvpC1EF8Aw4uaVPxXNd,False,1500265,1500265,68670,3433,65237,3zqXX6kzhkbW3d4TwD2CNjMRwxTbREXySekvq37kfCNk,68670,569333,-500663,457
2022-01-22 02:17:53-05:00,7423,3EgUBHBeKWegibDcCsTGaGehnwHYvpMbcPaT1UTbwQ49,Hxd4dsnLD8uHnG7KR7GVmKXBcpN1egMUvoTccPvBcaYA,True,196845609,49211402,299718,149859,149859,3zqXX6kzhkbW3d4TwD2CNjMRwxTbREXySekvq37kfCNk,11988730,157801269,-145812539,609
2022-01-22 02:17:53-05:00,7424,CRaKcudjkQiSw5YPVjTLVdXvJskeGiHSYtq5ZcMPJhgQ,AgqTg3b3bAcaBmRidhNC4Uf9ZwNbeH52RQEqumWyuUs7,False,20045,20045,933,46,887,3zqXX6kzhkbW3d4TwD2CNjMRwxTbREXySekvq37kfCNk,933,20575,-19642,465
2022-01-22 02:17:53-05:00,7425,2FrqGFZjbiNykJyo9BZ5S9FguQJPJiTi681rJJsQ5dta,3QUncYP92NKrfpaTvuF9iQg11PXKgZAgEngwh6BbnCCj,False,18995,18995,743,37,706,3zqXX6kzhkbW3d4TwD2CNjMRwxTbREXySekvq37kfCNk,743,14780,-14037,391
2022-01-22 02:17:53-05:00,7426,9UyQC8vc6zJJaSdnjvTAzgmcsw4fC3xFBBiCC1w9Sbjx,3ppBfboe6FPmt7f6WrivspMUoAznZKWQMeh3rCgw7vjQ,False,206193,206193,8596,429,8167,3zqXX6kzhkbW3d4TwD2CNjMRwxTbREXySekvq37kfCNk,8596,140638,-132042,416
2022-01-22 02:17:53-05:00,7427,DGAQzgZhS2yioeZmG3cbacM3hdz4F1aZn1PWRwgiFukc,48KUtJaNCPNxkLXJBtWAdDxY4b9vZzLgbGxTNdwMqmjz,False,12098861,12098861,548849,27442,521407,3uL2NSR2ZdDqCiKfzA5SwwpddAnit22DBJo6uvvz1rRs,548849,10158229,-9609380,453
2022-01-22 02:17:53-05:00,7428,BJV5jbowrbELXfDvfMovaQy4PiRf12pLYHimW9bgzW5X,6WXrWso5FvLx7RMCFBzrbzh5qevKkk2LJAihUfWXxXzB,True,501284,125321,638,319,319,3zqXX6kzhkbW3d4TwD2CNjMRwxTbREXySekvq37kfCNk,25548,648654,-623106,509
2022-01-22 02:17:53-05:00,7429,6oroGB3mvzK3tDfiB9X2NJuL3x476pxhgRnt7VxqhdLo,2SoK8tKkLn2ppKURpTVazKsCEis4uahkHMsac1m85J4r,False,41475,41475,1944,97,1847,3zqXX6kzhkbW3d4TwD2CNjMRwxTbREXySekvq37kfCNk,1944,55602,-53658,468
2022-01-22 02:17:55-05:00,7430,4FgDZBsdPTL7Q9Nrw8fgxFuRk1YBv3ETbRS5Hx5ZJTVT,8jDJz1EcGDts6c6eFowYRBWrVjLJabhLRaai6p5KqP2D,False,5006735,5006735,213715,10685,203030,3zqXX6kzhkbW3d4TwD2CNjMRwxTbREXySekvq37kfCNk,213715,4109979,-3896264,426
2022-01-22 02:17:55-05:00,7431,6Bq55LtGCEeGqh4JrFLCmmGc2iJfTTBJixivqH78aGSE,DSNrCgWJeNe2P9tAQu5FvCueTzNKDKds7wzuwTQSMRG,True,159093,39773,206,103,103,3zqXX6kzhkbW3d4TwD2CNjMRwxTbREXySekvq37kfCNk,8245,118140,-109895,518
2022-01-22 02:17:55-05:00,7432,H6fVnghBUSJRKp2mxSG7Fq2Lr4dE3YMS7yM1XTrxoe3Z,JjgtLi79grUZXofhWukB1yNXZkXFMUX5jm9HcXNDsB6,True,523018,130754,752,376,376,3zqXX6kzhkbW3d4TwD2CNjMRwxTbREXySekvq37kfCNk,30081,351685,-321604,575
2022-01-22 02:17:55-05:00,7433,ApAgbKGyEYXRonGM33w56ZxHQNAGSd9ji4K3zAGN2yA8,FZAhAUDtEaNsFmh4fP8uXNjoHneNkpZ2wQCfEeU4RYRM,False,2338116,2338116,106906,5345,101561,3zqXX6kzhkbW3d4TwD2CNjMRwxTbREXySekvq37kfCNk,106906,1696275,-1589369,457
2022-01-22 02:17:55-05:00,7434,5FeoHTpVt8u6m52SUq8P8Pe8LqHJLweZWA5eY8H8dswU,HUPUcjwBMVa6SZXjPqSTXtgnTEbmy9pX7nY4zVzzPYDA,False,7559614,7559614,341040,17052,323988,72FwbpFGoLEazJEdpqNtPNefsadUrimUqma9wSoy4qiS,341040,6187326,-5846286,451
2022-01-22 02:17:55-05:00,7435,9U25LWBU67c9S6L9F4qmjpTkaHqjFgxyuTCqQ7Zqj62g,ESyDCGZWamnabH3NNvus52X6Z9YAmt3y8oB8zYLmhfX3,False,238815818,238815818,10741708,537085,10204623,3zqXX6kzhkbW3d4TwD2CNjMRwxTbREXySekvq37kfCNk,10741708,96443887,-85702179,449
2022-01-22 02:17:55-05:00,7436,8Ttfg27wadhtnXPGoYFcawMaRJ2EXAqmmcQhbyjYrwQL,DXmDDubD8DoX7ZaRtQLFoZtvVmYKB61ht3w9QZPW3nKD,False,11017327,11017327,502307,25115,477192,72FwbpFGoLEazJEdpqNtPNefsadUrimUqma9wSoy4qiS,502307,9002635,-8500328,455
2022-01-22 02:17:55-05:00,7437,4mB2DVbQVqVk535v98Cj8SPNg1tTc3DFyY2Q7VBbY645,HXo255k3RgsTGsc4hiP6ZTXUspBTqJ37duQa5eK7tqp3,True,29502127,7375531,38537,19268,19269,3zqXX6kzhkbW3d4TwD2CNjMRwxTbREXySekvq37kfCNk,1541480,19291809,-17750329,522
2022-01-22 02:17:55-05:00,7438,4SX2pj4eHRwFMtyDCrMZ8ZT6ASAMi7yfZWZnccw5dGn8,Ads49ZqvTmPHxfzNYm4oJb4HBYhwS6vXQbarqmpUi5VZ,True,4903980,1225995,6196,3098,3098,3zqXX6kzhkbW3d4TwD2CNjMRwxTbREXySekvq37kfCNk,247840,3986483,-3738643,505
2022-01-22 02:17:55-05:00,7439,9PREuyML3TWUx7PnbAvMYhbQnDnorb9ng2vBSerAZCsr,G8Lzjw7xpKFTmbsWtRXR79sDvekwK1gqvQthZ5DxNEQJ,False,5155120,5155120,226160,11308,214852,3zqXX6kzhkbW3d4TwD2CNjMRwxTbREXySekvq37kfCNk,226160,4215068,-3988908,438
2022-01-22 02:17:55-05:00,7440,J1wNRFhQYLnTcbU8tnCFNYNo7sWaxAXhybEyR1YxsUba,G7m6N7Ew4dqTTVbYpLgQbzZdjzNNzsy3KwFhGJPYMBCn,False,6147819,6147819,243999,12199,231800,72FwbpFGoLEazJEdpqNtPNefsadUrimUqma9wSoy4qiS,243999,5046544,-4802545,396
2022-01-22 02:17:55-05:00,7441,brCL9pzP6q4b6rKgAH1AJbMoqffBWyXLX8oAnZDoi77,Dx4G5UP9jTb47JQypWJnv48mPTzhJvqPD1BtBtDT7TJF,False,186976,186976,8639,431,8208,72FwbpFGoLEazJEdpqNtPNefsadUrimUqma9wSoy4qiS,8639,84463,-75824,462
2022-01-22 02:17:55-05:00,7442,Cu5b14TQN3N2HoboxGMDxXf3tMCsz4QZDi6JEMAExE2o,BCgKRk4XKtFv35ss9ThFqYXpzdQMHwNwQNa4EzLcwoGj,False,7412523,7412523,328448,16422,312026,3zqXX6kzhkbW3d4TwD2CNjMRwxTbREXySekvq37kfCNk,328448,6053032,-5724584,443
2022-01-22 02:17:55-05:00,7443,HZJyrD4eqM4nKnyRh2JAs1sC2TaJxFhNPixBdK7PLMuS,Hycz71z4tEsKUogJnefT2GN3MPCLdTJdv9B6T82Ngw2u,True,26002331,6500582,35382,17691,17691,3zqXX6kzhkbW3d4TwD2CNjMRwxTbREXySekvq37kfCNk,1415307,21239571,-19824264,544
2022-01-22 02:17:55-05:00,7444,96StvqZyFUPtyMr4o9s7K4V29RSNyRpVi76vNwxG5rUf,GZKXFSFq4aGiTaqovtxqNCCVGkAFNXPh4Hep1ZMwdZ8g,True,534771,133692,686,343,343,4BnQKPLuE3DMTtxp8MjUBytgnhvxqq3ZTqZHTVZo4JJh,27456,724612,-697156,513
2022-01-22 02:17:55-05:00,7445,52hhBAuVyifMNFKGQmSitc8smiEgscXQMzVuZj55j7E5,6B5DBJx9NLytR3fkrYqe5W5ek4rUWsR4nPsRTvRfRwzC,True,198121245,49530311,299629,149814,149815,3zqXX6kzhkbW3d4TwD2CNjMRwxTbREXySekvq37kfCNk,11985177,158904051,-146918874,604
2022-01-22 02:17:55-05:00,7446,HoJ3Re4BmCYKMJx2RUYtoHfg8ncEy3iFqvWJDGKqfMBV,2qg4FMcurNDVRzXYKwpzEYapxFECnAyU2oGmxQCSf3hf,True,4979122,1244780,6913,3456,3457,3zqXX6kzhkbW3d4TwD2CNjMRwxTbREXySekvq37kfCNk,276529,4209705,-3933176,555
2022-01-22 02:17:55-05:00,7447,2ijaXzGryTmRqqjnHpPrdJfR3gokGhTfeYfHQVMydrtq,569ktfvZ3BSQ9yTRmgNDhRcPBPfWmKoW8FMpLkwiBnVB,False,6975717,6975717,333245,16662,316583,3zqXX6kzhkbW3d4TwD2CNjMRwxTbREXySekvq37kfCNk,333245,5687134,-5353889,477
2022-01-22 02:17:55-05:00,7448,E1CShgy7M9998q9jyzpnHZxHJR6z5hvnshUJt37kVPtG,96f1nYW4S9APCJS3TXTGSb9UcJDdxJuoBR3pLYqcNz2b,False,4092685,4092685,204720,10236,194484,3zqXX6kzhkbW3d4TwD2CNjMRwxTbREXySekvq37kfCNk,204720,3238552,-3033832,500
2022-01-22 02:17:55-05:00,7449,FV9CBGGTbppLnBKh79f2LzD1diTiS5g6u89FcpZHZmnK,Fe7mtmCUziFqbbYTvrhAcAq1Ub7YLfTJRtQ1hG7GzJD1,True,126005,31501,158,79,79,3zqXX6kzhkbW3d4TwD2CNjMRwxTbREXySekvq37kfCNk,6339,94460,-88121,503
2022-01-22 02:17:55-05:00,7450,2WG1vzMHrYu1UdNjWccbzigwXaC3BcPqSmDTgHnEgSjz,26MRaqCvaK37n8YKepmVS76zSsqKj9CefJQSQFts5yno,False,238109148,238109148,10563203,528160,10035043,4BnQKPLuE3DMTtxp8MjUBytgnhvxqq3ZTqZHTVZo4JJh,10563203,211606377,-201043174,443
2022-01-22 02:17:55-05:00,7451,3Lv2XpiD4KBUHq7Zx6u3zNhpXoySodXHH8o8f5yaaPxG,H6TN4rhpBXkEH3mZnymYNcKfmnxRH2uzfwzeLH2q6ahP,False,4295,4295,166,8,158,3zqXX6kzhkbW3d4TwD2CNjMRwxTbREXySekvq37kfCNk,166,3449,-3283,386
2022-01-22 02:17:55-05:00,7452,3YnVYS7agSrGNeJXh9GXLHQJRSHYWKGe9gWwKese1X4B,CnV77x6ehrba1eUeqiAMc5yKug8opZxbd4tnDu2jw1Ae,False,5948258,5948258,265735,13286,252449,3zqXX6kzhkbW3d4TwD2CNjMRwxTbREXySekvq37kfCNk,265735,4860186,-4594451,446
2022-01-22 02:17:55-05:00,7453,HXnDgvqsDggo4JYq7JW7iPcXvfs9q6qt9aPV9qArNdZZ,Ho33vrWReuJYuyST6GooRYG3tdRxBe9NrKoknajUbEcR,False,8054610,8054610,369842,18492,351350,3zqXX6kzhkbW3d4TwD2CNjMRwxTbREXySekvq37kfCNk,369842,6566770,-6196928,459
2022-01-22 02:17:55-05:00,7454,8aeFnGu1MWr1zicKmmYHhpnyt1TqdeYBtNrqUpMNHwWQ,4Zki9YB787eExNToiBkNRhne5QqJUvPHWmvG33g2xXf2,False,3849374,3849374,177449,8872,168577,72FwbpFGoLEazJEdpqNtPNefsadUrimUqma9wSoy4qiS,177449,3146801,-2969352,460
2022-01-22 02:17:55-05:00,7455,BjyZWwz1ARSfmPkHXHBzehq5NsH4DRJiu4zFMkqsKu6A,7WUCSZ9SnKDsbomDRZ7CKsHfHJFwboKJwFFdaGkBURBS,False,112321845,112321845,4430184,221509,4208675,3zqXX6kzhkbW3d4TwD2CNjMRwxTbREXySekvq37kfCNk,4430184,81954962,-77524778,394
2022-01-22 02:17:55-05:00,7456,43wwd6zLB8yKfXEu7rtbeDFhKBuxFR66MnyhTKW3zqa3,A9t6AMvVNenwWymz3QMtdUuuGYjjTPLaA9bhRjTzNY9h,True,93872785,23468196,122047,61023,61024,3zqXX6kzhkbW3d4TwD2CNjMRwxTbREXySekvq37kfCNk,4881899,76163509,-71281610,520
2022-01-22 02:17:56-05:00,7457,DZ39kEQZn3qA98LxtGmKU6yhWDuiH6Qjqi52VNrvWzRw,D3XS2JoLKi8KiKrWpq9YegcH7uLQ5n8xdpymMMf8jUrR,False,3731748,3731748,161256,8062,153194,3zqXX6kzhkbW3d4TwD2CNjMRwxTbREXySekvq37kfCNk,161256,3176966,-3015710,432
2022-01-22 02:17:56-05:00,7458,Bbd196A866Y9rQWQFt4YGg2R6Jqj7WQGXWPDmrNtPcKf,5gmWk1KwLoRHnhkjxps4Ad6aVk4ZpcfC3McZCWDVCUbu,True,5795754,1448938,8309,4154,4155,3zqXX6kzhkbW3d4TwD2CNjMRwxTbREXySekvq37kfCNk,332360,4895456,-4563096,573
2022-01-22 02:17:56-05:00,7459,GM22yjVoBCzgBcVTT5EcgRhVWiXVV82kSj1dPCbegKWj,CDDy8JmJMwJyx1YAvEPpj8AYxCpngRovf3wWfVzao5Rc,True,3572978,893244,5022,2511,2511,4BnQKPLuE3DMTtxp8MjUBytgnhvxqq3ZTqZHTVZo4JJh,200887,1370843,-1169956,562
2022-01-22 02:17:56-05:00,7460,BFs34P4fwk5wYXr8dQGiVNLACM64sebEfJAaFXd86aMV,H6MpEFEHgdsBZuGSpfKznAaUaCPuEwsgLjcNCPm3kzmQ,False,3230942,3230942,157614,7880,149734,3zqXX6kzhkbW3d4TwD2CNjMRwxTbREXySekvq37kfCNk,157614,2740984,-2583370,487
2022-01-22 02:17:56-05:00,7461,AATMHH4e4B6SL9bThnXGktzWuqWkPdx3JbRXk8HwkbPW,6F3u2yLx7P9gtpAAXASx7uF8xNyVBgJiKosMKUrgpicA,False,5757691,5757691,232723,11636,221087,3zqXX6kzhkbW3d4TwD2CNjMRwxTbREXySekvq37kfCNk,232723,4521784,-4289061,404
2022-01-22 02:17:56-05:00,7462,GqAS41YJssg9aaEp3hs3sG98APCsXhiQBQszXaSjZ2bN,2wodJ3AhrXdE1T4oVL95KvoBND7PubG5Wd5GWiLCMZJU,False,4398094,4398094,218446,10922,207524,3zqXX6kzhkbW3d4TwD2CNjMRwxTbREXySekvq37kfCNk,218446,5681969,-5463523,496
2022-01-22 02:17:56-05:00,7463,5rW9kqXB9feGSKSvSMNJF1FCsBYV3vGmTmc8MvzaZ3pi,7AjnjcfPJevW5521hXw4VtgRCfHSsAqyzyArukKfNcHo,False,254633,254633,12419,620,11799,3zqXX6kzhkbW3d4TwD2CNjMRwxTbREXySekvq37kfCNk,12419,231311,-218892,487
2022-01-22 02:17:56-05:00,7464,8VQ21PFXdHBNmiZiF18LyGvsRSpr13vkyktfembNCe3m,5exbVC7vaGFeHEGAx7epYfMaU932QafqzfhFm5FKAq2H,True,5465548,1366387,7520,3760,3760,3zqXX6kzhkbW3d4TwD2CNjMRwxTbREXySekvq37kfCNk,300823,4418445,-4117622,550
2022-01-22 02:17:56-05:00,7465,BJaaH1SK1pF2kZQzmYpLFfDtm52CR9a5rd39RAPtLe8q,HUsT5FVxaisdnCvG1BQxX6zffjfL2Rwx5mMo5y8SDV7e,True,3214005,803501,4724,2362,2362,3zqXX6kzhkbW3d4TwD2CNjMRwxTbREXySekvq37kfCNk,188975,1648627,-1459652,587
2022-01-22 02:17:58-05:00,7466,6Z6y2QLJUZ5s6zdjanJcKprTAotx8tqr9DRNqqycMeS4,JCYwt8MHVaBb14GB2qAvDWwYVMaL7VTxyNEt7Eo5Zy8x,True,4934625,1233656,6250,3125,3125,4BnQKPLuE3DMTtxp8MjUBytgnhvxqq3ZTqZHTVZo4JJh,250002,3999766,-3749764,506
2022-01-22 02:18:00-05:00,7467,9WRDBHzD4aNHw5qvrhc6nqXCBLA5D7YYP8TvSrLksXd6,GwxWNmv9XDkqQsx7DfCMccFjVik8asPnFU9gtnb4UVx,True,4674574,1168643,6295,3147,3148,HfEnetJ7uBSmZWCjBNxdvv9HEC5nsW4wDV7wu6WnhWan,251806,3784469,-3532663,538
2022-01-22 02:18:00-05:00,7468,FF8rqfM9PTEjYiVFy8jS81weDRwdaYooux2uSa2LexrJ,JBk1JghH1gged1YpDbkczFXP9ka5ivYSkaYoVbbXD4kg,True,4344110,1086027,5481,2740,2741,72FwbpFGoLEazJEdpqNtPNefsadUrimUqma9wSoy4qiS,219268,3793497,-3574229,504
2022-01-22 02:18:00-05:00,7469,8GdYhwX26GRmVfGFCbJ3MJrH1UdneN2FNRUexhLsqprN,DpUTHSVucDPyCWoLCdpm8EFRZFiKL88tmnSiWG2TRpS8,True,5403463,1350865,6948,3474,3474,DddJ7EWCmYEEZETCBNgAUSg81Ls6fZtiAaY5ekJ5sXx1,277926,4354784,-4076858,514
2022-01-22 02:18:00-05:00,7470,9rgrRAMcGSarfz8xXckw1LjkemMwwjzJLApPjpfY2XZ3,BRtNdDDtCiNDYDERZTBCefUiYvjShucRX1hxEBLyeggT,True,4755421,1188855,6126,3063,3063,72FwbpFGoLEazJEdpqNtPNefsadUrimUqma9wSoy4qiS,245063,3859140,-3614077,515
2022-01-22 02:18:00-05:00,7471,AzLdwyd8Q4V3iMaSwWgvWwQ9nCs7X7YV2YKpd6CH33nP,BYjeXF5YkcJy3mNMbvfHzXTtyjkc4U53hM5tvfERUH8y,True,6005218,1501304,8237,4118,4119,3zqXX6kzhkbW3d4TwD2CNjMRwxTbREXySekvq37kfCNk,329498,4855750,-4526252,548
2022-01-22 02:18:01-05:00,7472,CS2Wbk1Sd1aix7kSiQhHW2Q4q63DcZFvqsio5NTUeDiH,7dFYg3VuTG9Scg1J42ouZ4wnSnXqVB8LDfwamYnH1XWK,False,30687480,30687480,1405541,70277,1335264,3zqXX6kzhkbW3d4TwD2CNjMRwxTbREXySekvq37kfCNk,1405541,28013535,-26607994,458
2022-01-22 02:18:01-05:00,7473,E8ifvhmyJGBGVQomo3AnZw2UcaLHcpGsTtuoCid8voU3,FMQUWTbTAfSLfrc6GTrz4DM2ZSgoxF3KtqGn8AyjVtsf,False,163722,163722,6597,329,6268,3zqXX6kzhkbW3d4TwD2CNjMRwxTbREXySekvq37kfCNk,6597,116170,-109573,402
2022-01-22 02:18:01-05:00,7474,68F35fonSGS1P6LMYmAmeoM8kC6Z78NabMqYLeCZr9GJ,8apmWSZdS8s1ScoNVj4AvSJsbQCj1drU3HL74khuANT2,True,6424673,1606168,8780,4390,4390,3zqXX6kzhkbW3d4TwD2CNjMRwxTbREXySekvq37kfCNk,351222,5198814,-4847592,546
2022-01-22 02:18:01-05:00,7475,DMgD2KCEhTGFLUZ5GnfNcwfiiwKYbyVpoWiN6knMkCAf,5KU2vgBkPTNVHsSULjgX7ZkZS56U3Dy3xqLTxL5sUZJ3,True,33027474,8256868,42065,21032,21033,3zqXX6kzhkbW3d4TwD2CNjMRwxTbREXySekvq37kfCNk,1682631,33899007,-32216376,509
2022-01-22 02:18:01-05:00,7476,2F45BX9mRmtNCHPejKFknN5aNgGvR4vVLFjMaY1a7dR8,ALdSutsvEFRUEQGGBbi31QywTL1pdXSDWrNJzvNTaoXL,False,576808,576808,23035,1151,21884,HfEnetJ7uBSmZWCjBNxdvv9HEC5nsW4wDV7wu6WnhWan,23035,490129,-467094,399
2022-01-22 02:18:01-05:00,7477,7EvJoetxJVTgpJXqE1VC3fZN1CQ5xdWdv29yCiDuH9gU,6RTEusjGEHNDdMj75qkpzYHjHZ3R2XN5xvptCwkRJz5j,True,6744134,1686033,8525,4262,4263,3zqXX6kzhkbW3d4TwD2CNjMRwxTbREXySekvq37kfCNk,341021,5483189,-5142168,505
2022-01-22 02:18:01-05:00,7478,2jPxG5FL6D6XEJsRszJ9cmQ54AWSpZyPFSbn3DpWBSuM,3toQou4UVNvyWYvMvkuv379RVEF2aN2TzCpKKBUqeQV6,False,4470863,4470863,222712,11135,211577,3uL2NSR2ZdDqCiKfzA5SwwpddAnit22DBJo6uvvz1rRs,222712,3545352,-3322640,498
2022-01-22 02:18:01-05:00,7479,5q7BsF2SxXYB6VcZcuwQr2WKqcTRWZupUsZqDB3pvZbS,D83ENcsAJmiGyzCTL8dr5y8DEC9kE7T6SKPCnNLxBaMd,False,2574489,2574489,111108,5555,105553,3zqXX6kzhkbW3d4TwD2CNjMRwxTbREXySekvq37kfCNk,111108,1624219,-1513111,431
2022-01-22 02:18:01-05:00,7480,6fqbSyhh3PPdgRcLraHb7Jahj9s1oHHeX3SsjNSsGa6t,GpRUow48TYgttdYfsygbgjYQcmHyYjWETUDjDVphEgwq,True,10416663696,2604165923,13687656,6843828,6843828,3zqXX6kzhkbW3d4TwD2CNjMRwxTbREXySekvq37kfCNk,547506266,4146067790,-3598561524,525
2022-01-22 02:18:01-05:00,7481,FKQVm9RsteDe7dQmwx4NGYhz3Wrvwh7TCp9rFbTgAomx,Dbwox8eRCdmH5KXyi5sBaqWzhxtaVPo1teWXJ2kRFT1f,False,15975043,15975043,787709,39385,748324,3uL2NSR2ZdDqCiKfzA5SwwpddAnit22DBJo6uvvz1rRs,787709,20039253,-19251544,493
2022-01-22 02:18:01-05:00,7482,CCi9urfx5bFFMazAAVz1WtJzJotHA8E1i8RrtgMP97Fp,2DFvm5fZj29qvqoLmbReUaisd9qBTNUfuE7HgmmHUc7w,False,1825724,1825724,75586,3779,71807,3zqXX6kzhkbW3d4TwD2CNjMRwxTbREXySekvq37kfCNk,75586,1784550,-1708964,414
2022-01-22 02:18:01-05:00,7483,4cKgCTttVp8pzJnp43PP7uLLUXNcU7YGPJ3cCGHaUFe7,BBQqjwTpVEgpDzMk4wDDH8rCjaSxCRPWVhtFxERSujTD,False,936300,936300,43974,2198,41776,3uL2NSR2ZdDqCiKfzA5SwwpddAnit22DBJo6uvvz1rRs,43974,746768,-702794,469
2022-01-22 02:18:01-05:00,7484,FwTGq3BeMLyRFRa5r4E6nySLgoLNcNdqJsCQxA2i6uh6,88w6ti3WSriyu2FvNjVfrLpGyU5PUvaiJyqrAGPM8TKp,True,5709461,1427365,8905,4452,4453,4BnQKPLuE3DMTtxp8MjUBytgnhvxqq3ZTqZHTVZo4JJh,356218,4578362,-4222144,623
2022-01-22 02:18:02-05:00,7485,3HUAjpBLM9XnT5W8p7asjjh1s8GDBzHL55AbsvBPsZ2e,6g6azPhma25H5q8HEATFAcXKg7UokmzPXzXDBr7QKbTL,False,3343559,3343559,138215,6910,131305,HfEnetJ7uBSmZWCjBNxdvv9HEC5nsW4wDV7wu6WnhWan,138215,2848408,-2710193,413
2022-01-22 02:18:02-05:00,7486,HVZkXeDR3mc8oB9qFFwCK4RXpPojdcHk9tRGep6xtKGK,Bh3py7awPejWqeTMxtAgF7mPotL2Asxf8YrYJykq9nBt,False,152644,152644,7243,362,6881,3zqXX6kzhkbW3d4TwD2CNjMRwxTbREXySekvq37kfCNk,7243,122196,-114953,474
2022-01-22 02:18:02-05:00,7487,4eba4qAmwfqmihaYvTWFU9hm4VYrKvNhNywHNyimQJNK,G1DyxJcNQD8u4KGfnwxttyrJMfse1FBAsofioEMdTS9U,True,37524159,9381039,52527,26263,26264,HfEnetJ7uBSmZWCjBNxdvv9HEC5nsW4wDV7wu6WnhWan,2101111,30570286,-28469175,559
2022-01-22 02:18:02-05:00,7488,4cNmhgaMic1xBiaDJ6phrQuXmm8WfF1qjyYMqZcKG4c9,43vgfXiLTtcs1bkrcDar2iz9M6RMbGqbA6BMkBHdh7T4,True,5661516,1415379,7592,3796,3796,3zqXX6kzhkbW3d4TwD2CNjMRwxTbREXySekvq37kfCNk,303713,4622257,-4318544,536
2022-01-22 02:18:03-05:00,7489,E8iuHK2DErFnMAYfWmNoix4jVb4WDG8Sc41hBycLUxbd,77Zoru23JmnK5EJ8eURonQoEpJcLP4edabjD8MR8NKdX,True,93404416,23351104,120358,60179,60179,3zqXX6kzhkbW3d4TwD2CNjMRwxTbREXySekvq37kfCNk,4814335,75824967,-71010632,515
2022-01-22 02:18:03-05:00,7490,8xQ3tsWVUe75EG1HmocULJ3kh52utveoFMEPotTGrKno,i3SKW3ywrwYucX9ySEx1C4zaUKGnzLerP3V38437NyV,True,3320214,830052,4657,2328,2329,4BnQKPLuE3DMTtxp8MjUBytgnhvxqq3ZTqZHTVZo4JJh,186311,2987005,-2800694,561
2022-01-22 02:18:03-05:00,7491,3oCun4gm3k8sXxVxiYM8okGi8iCXH9LvDkHf9PBQWYXR,E1np1dZ7jUm811ddvy1jQerBwGSYb5BbZWnUHeotvrfH,True,18653199,4663299,26155,13077,13078,72FwbpFGoLEazJEdpqNtPNefsadUrimUqma9wSoy4qiS,1046204,5106770,-4060566,560
2022-01-22 02:18:03-05:00,7492,GqFbV89UYbQ6aEW1bSvGnnsDtTPQfHPTHzisXPhLnaTC,6X7j3nqmugRyVVw83uSzgiPaemEscc8VdsnPEKDz4fg2,True,4856845,1214211,6896,3448,3448,72FwbpFGoLEazJEdpqNtPNefsadUrimUqma9wSoy4qiS,275873,3919737,-3643864,568
2022-01-22 02:18:03-05:00,7493,2hirR46fpyHEg1Fv9vAzYgnoNRBWaky7LoFGVof4DnpK,DXTEHauVDdz4Mjjj6sJHPUh6TnzU6ob6Nj63To2vCNPW,False,52130870,52130870,2407460,120373,2287087,3zqXX6kzhkbW3d4TwD2CNjMRwxTbREXySekvq37kfCNk,2407460,21808701,-19401241,461
2022-01-22 02:18:04-05:00,7494,2FEbsetZMkRqLjSC8GBbgecKgX5T1T1fci2sLQux29p8,H722Fcd6DkTFRZxqQWbPDufBfXEgmFfhiEpQZWhxwYv1,True,111853,27963,140,70,70,4BnQKPLuE3DMTtxp8MjUBytgnhvxqq3ZTqZHTVZo4JJh,5637,84032,-78395,503
2022-01-22 02:18:04-05:00,7495,G8nRLTWTT5aD7q7TcSa2mw7p12GUuHDVq5ev4vyXbdKi,3DmQyungZMK4T1a1PgXh5shBskwP69tTLmZPh7HZ76vh,True,8828635,2207158,12146,6073,6073,4BnQKPLuE3DMTtxp8MjUBytgnhvxqq3ZTqZHTVZo4JJh,485862,7140731,-6654869,550
2022-01-22 02:18:04-05:00,7496,2s9VGesQYbKr3LwuraMEa9sXbXz7f8299HPPAHgSaUdp,8uMS2GDsbmygjbRnc2gjwNkXKogmJX1i8nchmqt8ixCe,False,1037045884,1037045884,51751773,2587588,49164185,3zqXX6kzhkbW3d4TwD2CNjMRwxTbREXySekvq37kfCNk,51751773,837930704,-786178931,499
2022-01-22 02:18:04-05:00,7497,4eaXYcx5ayhTq9TmmQFgLDjy6p3z93txUN97v8PTSh1J,J3vgUnjDUy5ngrmrs6FwpZTexxJNxXM1UjsHvsgw9g9y,True,6023935,1505983,7882,3941,3941,4BnQKPLuE3DMTtxp8MjUBytgnhvxqq3ZTqZHTVZo4JJh,315313,4885868,-4570555,523
2022-01-22 02:18:04-05:00,7498,4pmhvxJcmebxtqN6RwVb9UbEtxpFXpuVN67Q74W6YAg3,B9fk51SEQmLbMDpQJV15f9gyCZhvEBWRXeLMnnmMqvfg,True,14065,3516,19,9,10,3zqXX6kzhkbW3d4TwD2CNjMRwxTbREXySekvq37kfCNk,789,11063,-10274,560
2022-01-22 02:18:04-05:00,7499,7E3Zc3g1eJ7ueosPPoHDSkhuHvBVfN41eXcJXWeffozU,CGA8dcsZjfLqSYijYmssZwd9TXAsvSafNVT6JvUajGdu,False,73654543,73654543,3294431,164721,3129710,4BnQKPLuE3DMTtxp8MjUBytgnhvxqq3ZTqZHTVZo4JJh,3294431,69317613,-66023182,447
2022-01-22 02:18:04-05:00,7500,7g9QK2NcF8gtToPAD6t3A2D7HxSQ39tjqmKkqqKWeJ6p,Gked479UxktYMAQm9z7YSzzqKLg81BnGwJdgmCnkRmQD,False,5501772,5501772,254872,12743,242129,4BnQKPLuE3DMTtxp8MjUBytgnhvxqq3ZTqZHTVZo4JJh,254872,4493204,-4238332,463
2022-01-22 02:18:05-05:00,7501,8MGEQ1KEMv9WSgVifjN7CQ7tDbJBJbWgGYu71dTDKEPQ,mQY2X9KYVXf9JmGY8XwMK4G8odM4HmWkgEmYYqKnkvF,False,3981867,3981867,191591,9579,182012,3zqXX6kzhkbW3d4TwD2CNjMRwxTbREXySekvq37kfCNk,191591,3573777,-3382186,481
2022-01-22 02:18:05-05:00,7502,2MVzj6GMPLGdpPasfioLbpzaut7TxbYm6ErfvGMv1geh,VypP2h4SUux1AYkcJheULXNYwy2WbofwSZf5CxGygTW,False,5696352,5696352,263580,13179,250401,3zqXX6kzhkbW3d4TwD2CNjMRwxTbREXySekvq37kfCNk,263580,4652419,-4388839,462
2022-01-22 02:18:05-05:00,7503,Dqnxcekm1QfxGQ2FSJ6SjFiwmaQRWEjW9WTJQG4AjEpE,9JiMtjm5AJqngosRg787FiN8NyuBPuAPD2jYpRQkAc1d,True,7868865,1967216,10799,5399,5400,3zqXX6kzhkbW3d4TwD2CNjMRwxTbREXySekvq37kfCNk,431971,6365426,-5933455,548
2022-01-22 02:18:05-05:00,7504,D96xbqPtmwTFYGi4tBUt2hiadLBuuKDgdBx9U2Uhuag4,CxCRjQVzLzFGLfZ5CCW9yCErbNacSEZqoKEetQd7gGbZ,False,4520744,4520744,190977,9548,181429,HfEnetJ7uBSmZWCjBNxdvv9HEC5nsW4wDV7wu6WnhWan,190977,3703539,-3512562,422
2022-01-22 02:18:06-05:00,7505,Dng7By2saPu5TVxcvXidBe71ggBo8tiHkAXPi4kKL1tk,75ufEJmHbLHffphL7tvAXhGyftKLr1z2PXXoB2GGY5fG,True,79995767,19998941,124920,62460,62460,HfEnetJ7uBSmZWCjBNxdvv9HEC5nsW4wDV7wu6WnhWan,4996824,22521488,-17524664,624
2022-01-22 02:18:06-05:00,7506,5yPGvUz6JWKjkViGwTCpygJii1rP2xv5yx146ULtBiYq,FMnHUCQWTf1UHu5qVFqUAsWh8aba9EQYTEoiXy55totD,False,112418399,112418399,5614165,280708,5333457,4BnQKPLuE3DMTtxp8MjUBytgnhvxqq3ZTqZHTVZo4JJh,5614165,47822823,-42208658,499
2022-01-22 02:18:06-05:00,7507,bNhTXZZUjCoZJUXUc3UHvwTVteMQbpjfK1dD2gazFRH,BzYUpBjMfZoJARiHaFrBsJoC4Dvh6PPA4WvrHx1WReHv,False,8511322,8511322,349418,17470,331948,3zqXX6kzhkbW3d4TwD2CNjMRwxTbREXySekvq37kfCNk,349418,6982838,-6633420,410
2022-01-22 02:18:06-05:00,7508,5iRLEmB6qBHqkJBPyyubnd9f1TpRr4EY8BTxuHUREeLB,GkY73KL6HJ4ycdggFtYWALBgmTRZVCx66P2ZJ7E8ENwC,True,5141389,1285347,6694,3347,3347,4BnQKPLuE3DMTtxp8MjUBytgnhvxqq3ZTqZHTVZo4JJh,267782,4173467,-3905685,520
2022-01-22 02:18:06-05:00,7509,3KAV1uTsuQrckk6oyGiAqsASaL4vTyYyEgha2moxhaCF,DCEHTaJTSfyE6hUh3gEdZpqhaezNb61JSPqjzo3nMUGS,False,5752661,5752661,262642,13132,249510,3zqXX6kzhkbW3d4TwD2CNjMRwxTbREXySekvq37kfCNk,262642,4705055,-4442413,456
2022-01-22 02:18:06-05:00,7510,9qucsGVWi5n6PQbjn7NCSU9M5Yu6D54puaiNY1p17noS,ExwHfJAHaHrAVVaLXZ8SSMxAXaMgxUvRbdCK2Cri1eq8,False,3691817,3691817,168882,8444,160438,4BnQKPLuE3DMTtxp8MjUBytgnhvxqq3ZTqZHTVZo4JJh,168882,3010377,-2841495,457
2022-01-22 02:18:06-05:00,7511,EAUFD16wab8qRMJ4H6updHGt4xFqgRCDeRHVCsLCTSTL,8vkfYSyCyBY9g4TZrp52jUcQj6udy9xAaA4fioRE2RXx,True,3619270821,904817705,4959001,2479500,2479501,3zqXX6kzhkbW3d4TwD2CNjMRwxTbREXySekvq37kfCNk,198360054,1492530517,-1294170463,548
2022-01-22 02:18:06-05:00,7512,EL9JxeMvWWLTdVC5QrZzSSgApEwv1nDhZc6yNmH9G8ad,EqSQLSFx1eKkTYAdv5XhekttqVh7TappXAHuv9EedCXq,True,2425,606,3,1,2,4BnQKPLuE3DMTtxp8MjUBytgnhvxqq3ZTqZHTVZo4JJh,124,1923,-1799,511
2022-01-22 02:18:06-05:00,7513,7afnF1MkAootZGWc7zsMVLpBuve83hGmvAHkfmwgsq5A,HKdJE8bReznq1Qxqd5iZ4nWQGCk62Vo5TpkRD51bpbGp,True,6201450,1550362,8318,4159,4159,4BnQKPLuE3DMTtxp8MjUBytgnhvxqq3ZTqZHTVZo4JJh,332727,5021679,-4688952,536
2022-01-22 02:18:06-05:00,7514,2ZX5NexeuZq25mAfBFDrwd44UfKhWgzmSwdhWFmo48c7,CpNnhSqg7EHn9g84gHoo831sVrAe5SkwNaEZAash4CXs,True,40898305,10224576,56421,28210,28211,3zqXX6kzhkbW3d4TwD2CNjMRwxTbREXySekvq37kfCNk,2256849,33351272,-31094423,551
2022-01-22 02:18:07-05:00,7515,HZSJVNb6g4o52N7pAJCLkGjur8evF5Ex1sAx7uUxUDdm,8LQHKhXStrwcd6f4AxaTVcrGdYpGjQz8vWf5JXsAzcsp,True,6924420,1731105,8909,4454,4455,HfEnetJ7uBSmZWCjBNxdvv9HEC5nsW4wDV7wu6WnhWan,356372,5625014,-5268642,514
2022-01-22 02:18:07-05:00,7516,BPsM1um9ZJf7eNoVMsQCRSwgARMuLCGGSDxf9tZeNeEy,BpzDdXfxVygiSYSmsHV6uPxQMeTFtrURMCCqhswQjd5X,False,27912,27912,1366,68,1298,3zqXX6kzhkbW3d4TwD2CNjMRwxTbREXySekvq37kfCNk,1366,21023,-19657,489
2022-01-22 02:18:07-05:00,7517,7EtGovzHsbD8cKGqq4R5rvKBbncR4Kc7CDkTjof2QBMf,8ShjeNWM2vcvUF9yYztYCHUQfcGsyg2A1LyWiPbQDDvq,True,1148859,287214,1776,888,888,4BnQKPLuE3DMTtxp8MjUBytgnhvxqq3ZTqZHTVZo4JJh,71041,921980,-850939,618
2022-01-22 02:18:08-05:00,7518,AECUZGm5DjFvbLZEUYhepSPg1Wa7hBjxF9e7ZRBzRPhm,Ar7e1iLKAqa54QiQnXifvnETixDZT1T8KL5YWJA8Ykv1,True,7314796,1828699,9976,4988,4988,3zqXX6kzhkbW3d4TwD2CNjMRwxTbREXySekvq37kfCNk,399059,5919623,-5520564,545
2022-01-22 02:18:08-05:00,7519,6b7Ro2myM4HcUDqyyW9NEqTWPz8BWpH4eNFSQQci37So,7r7j7rSsa6YZcTuRPfs3KP44MVqUA4Q5NeJGmx84wbHq,True,2542866,635716,3635,1817,1818,4BnQKPLuE3DMTtxp8MjUBytgnhvxqq3ZTqZHTVZo4JJh,145400,2140378,-1994978,571
2022-01-22 02:18:10-05:00,7520,H3x9b27yHVdCxvtDf7mmJxkNeubcmQMwfAkLTYADPWNv,HGVCCz23rWx78vrTB2wvm2aesbLZuYFhhNuznGiSSAyA,True,518166641,129541660,810857,405428,405429,4BnQKPLuE3DMTtxp8MjUBytgnhvxqq3ZTqZHTVZo4JJh,32434289,182012386,-149578097,625
2022-01-22 02:18:18-05:00,7521,3EmGvYu72cR4Ta3wLA5HKZBEqgfChCyiRanwj5hGLJXc,6NEWPFaKi5uLsrj4n6RM1DBhQTcGFE9TwYeJ12pC7yyp,True,925,231,1,0,1,4BnQKPLuE3DMTtxp8MjUBytgnhvxqq3ZTqZHTVZo4JJh,53,723,-670,572
2022-01-22 02:22:33-05:00,7522,CLVUzXSNsQnX7n5cvxMuTjyMSjy1pNpPnWejFaeuonvb,BXZzBujr8DAUcGJcHQBaz1ZSwkATAHg3NX3bLnrjQpLh,True,30156775,7539193,47084,23542,23542,HfEnetJ7uBSmZWCjBNxdvv9HEC5nsW4wDV7wu6WnhWan,1883360,7602941,-5719581,624
2022-01-22 02:24:05-05:00,7523,2r64Rnbu3ZjmJTHHUxxV9TWWGzwpAepA4ySbtKivBXCj,6RRzx6KLkMiFK9JSuznrSJGiPgkHwatBSskudHqbfKJ5,True,474211888,118552971,728107,364053,364054,3zqXX6kzhkbW3d4TwD2CNjMRwxTbREXySekvq37kfCNk,29124301,267628375,-238504074,614
2022-01-22 02:26:33-05:00,7524,8WHDaiE6LqFFmCVMnPeLEQ99R6ft8b74UfmP9BqzjcE8,CGmoDGsdnjo3zMNrW78n2xxQr1aDPAiBYiXbyciLXYMu,True,39548100,9887023,61217,30608,30609,HfEnetJ7uBSmZWCjBNxdvv9HEC5nsW4wDV7wu6WnhWan,2448718,24119572,-21670854,619
2022-01-22 02:27:46-05:00,7525,FuoFPNTdYVDkSHaBac6UC1aNJXafSNTvFJuBCdrgQQrH,ApBS1Fx83tcECMzDV6wEzEzEdg4e2hgj3djtjRUoSKK5,True,98800907,24700226,154208,77104,77104,3zqXX6kzhkbW3d4TwD2CNjMRwxTbREXySekvq37kfCNk,6168323,61519310,-55350987,624
2022-01-22 02:27:46-05:00,7526,GXfjQr2ihTfLRys1DMetVGocd1sU97KdoCJ6x4HxdW1U,9GHvjJJXjbVz5D3RBfP3njcdRRXnFsXZ68jFa2LiGwsy,True,71508418,17877104,110117,55058,55059,HfEnetJ7uBSmZWCjBNxdvv9HEC5nsW4wDV7wu6WnhWan,4404706,39354346,-34949640,615
2022-01-22 02:27:46-05:00,7527,H1Z83zVoskNuBvYao1FjdLfETfhPpQFQUkniJfGxbaNz,EVqbBRV6Zy1tPLRevxpAykp8Mvv6tDZVTc4RmCKw4Gq1,True,90586642,22646659,139532,69766,69766,HfEnetJ7uBSmZWCjBNxdvv9HEC5nsW4wDV7wu6WnhWan,5581318,62653145,-57071827,616
2022-01-22 02:27:47-05:00,7528,BHpLpoGQ27T6Q4CT8H4dzqS8KF8Vj5rqmqfcodoBzpgR,Akn3tG2hQBfBVtNYCeXchfzfcsyCuSpkGpFoMLEKwcBF,True,4521997,1130499,6991,3495,3496,HfEnetJ7uBSmZWCjBNxdvv9HEC5nsW4wDV7wu6WnhWan,279677,2608304,-2328627,618
2022-01-22 02:27:47-05:00,7529,CCP5P6U4xBjea3snWgwBb5rtaounEAsNHpWzTUeNtVf9,GE2Bxc837ybP7sNR487U4bVbx68qyX2HtwPBLfEd4BDj,True,280392166,70098041,433693,216846,216847,3zqXX6kzhkbW3d4TwD2CNjMRwxTbREXySekvq37kfCNk,17347726,101032767,-83685041,618
2022-01-22 02:27:50-05:00,7530,EF6H6aW1p3qcAtiLFU9rbFYfsKfD683meHXDw8hLdaZK,8vfJbpnK7SQcjpEBCzZJRW8JosNbsmTeJ2YXZCbM225c,True,19308720,4827179,30194,15097,15097,3zqXX6kzhkbW3d4TwD2CNjMRwxTbREXySekvq37kfCNk,1207796,10603723,-9395927,625
2022-01-22 02:33:24-05:00,7531,E5biUzKn2s5frKseCmfWriWjrYMGVtmLrhR9nYhAkVvR,BDHzqefisuGoMGcpML8t6KAC7rcErvhLcfV8KQC7oHAH,True,17617947,4404486,26825,13412,13413,3zqXX6kzhkbW3d4TwD2CNjMRwxTbREXySekvq37kfCNk,1073025,7465765,-6392740,609
2022-01-22 02:36:45-05:00,7532,ARB1q7bNcQ7grwFEZC6nk9Pfrrg7yZ2WK8zVqq5CEE8F,53e8mUYrWzQnCm9XQyp18CL9owyPqJcYyxZANYhRypPx,True,46908510,11727127,71886,35943,35943,HfEnetJ7uBSmZWCjBNxdvv9HEC5nsW4wDV7wu6WnhWan,2875475,22850552,-19975077,612
2022-01-22 02:36:45-05:00,7533,GXSysysoV8Z4xBrQsaKUsSrpoWeTTUsbFmgfZDaQu4ZM,6FJyraiLgG3tb9B7pi4YFsJNtRVBNaghnm1ajzneVv7b,True,449943205,112485801,681982,340991,340991,4BnQKPLuE3DMTtxp8MjUBytgnhvxqq3ZTqZHTVZo4JJh,27279285,173001552,-145722267,606
2022-01-22 02:36:45-05:00,7534,9aQrdyfAvcBbBj7iKQB17eAS4zBqymdd3kzkTkuRhdLU,BDHhukMF5rALuSwCxaw8g73m2MN4oX1D4e7uNmx3SiVt,True,63353733,15838433,97668,48834,48834,3zqXX6kzhkbW3d4TwD2CNjMRwxTbREXySekvq37kfCNk,3906742,23550013,-19643271,616
2022-01-22 02:40:03-05:00,7535,DDuXUcRDez68Tx651sVKxjubhTdNHkuarbeDEKFp5HRs,DNWcrd23zaT7LuXHuhPVqqAvLVpEzoqebr4sho45CphT,True,2054443,513610,3165,1582,1583,4BnQKPLuE3DMTtxp8MjUBytgnhvxqq3ZTqZHTVZo4JJh,126617,759450,-632833,616
2022-01-22 02:40:03-05:00,7536,JDeYjCLpfnzcfxDFgHf4aBcHsajwdR14GUaKAA9euzVf,EJbvKoyMZcoCx4vWa61uMbW2vr6mUhrgEuECdteVBuZZ,True,473771,118442,663,331,332,4BnQKPLuE3DMTtxp8MjUBytgnhvxqq3ZTqZHTVZo4JJh,26549,417861,-391312,560
2022-01-22 02:40:03-05:00,7537,9UKMqQgFYdJb5vXVqPhA8CAMRY1eifgWivANiKQqj3yb,DpE3uNQUZbyYnqjpfHWqp9CHqPBs2uTQLRM6AtzF6Por,True,20199509,5049877,28313,14156,14157,HfEnetJ7uBSmZWCjBNxdvv9HEC5nsW4wDV7wu6WnhWan,1132552,6899943,-5767391,560
2022-01-22 02:40:03-05:00,7538,Fani89KviVFZek4si6YZ3apVuM2kSqVUijDnLBqtvJEH,EpC29dECx1cLC69bj2ncG3jFp7obPaxbH7F6mju27cwL,True,1337146,334286,1973,986,987,3zqXX6kzhkbW3d4TwD2CNjMRwxTbREXySekvq37kfCNk,78936,491325,-412389,590
2022-01-22 02:40:03-05:00,7539,6VJcr3VAEcEZaHEpt48QL8QxHKABufVp8n2JSEVTLh9U,8naR6kiySKj3vai9dCetdgCnCHgf2oyLjGqKTJ3Lz64Y,True,197562142,49390535,281126,140563,140563,3zqXX6kzhkbW3d4TwD2CNjMRwxTbREXySekvq37kfCNk,11245075,137843619,-126598544,569
2022-01-22 02:40:03-05:00,7540,DY6k3Dkwe18iLneaT8Xo3VpJWB6V4jWwQQjoDvEzdg2j,3GGV7S9FpRQGbARBXkvGFVqLrmw8JvYAcpnR1aKVUY2f,True,755102,188775,1169,584,585,3zqXX6kzhkbW3d4TwD2CNjMRwxTbREXySekvq37kfCNk,46764,657582,-610818,619
2022-01-22 02:40:03-05:00,7541,Bsr6kx1B6BSEd5UnJ7Z61M49iUb3bFrDVhiEtMVtPDF2,3CFd1pUJAJPA9fobwn4Jj2mRju1CWmoop4Mh4znypNWT,True,1781728,445432,2580,1290,1290,4BnQKPLuE3DMTtxp8MjUBytgnhvxqq3ZTqZHTVZo4JJh,103200,1116153,-1012953,579
2022-01-22 02:40:03-05:00,7542,CYkojG4q1SnizNs59qsYTEBU1c11XC8nteMhxRbwhCBq,A9MsPy3aeMzdQUWXK6qmWLiZfKREiBrSVaJAKp2nEcSt,True,1367950,341987,1890,945,945,3zqXX6kzhkbW3d4TwD2CNjMRwxTbREXySekvq37kfCNk,75614,863841,-788227,552
2022-01-22 02:40:03-05:00,7543,8swGZMrPrLAxZd7MxTbkCL13k3DmAJUw41jCp6Xo6awW,3fKnX7yTNXAT4uMmXVdTy47ALJT8h8YSD3WiBb4BGuzH,True,14149468,3537367,21583,10791,10792,4BnQKPLuE3DMTtxp8MjUBytgnhvxqq3ZTqZHTVZo4JJh,863321,9992856,-9129535,610
2022-01-22 02:40:03-05:00,7544,78EeyPYzQjrmW6z9VGhRci6ihMUZb5rtpXo3GAxugf55,9AgZ45TMxaqwWGVWSgnEkvio3s6fXtHjAVRVCA7Zgsd2,True,3380154,845038,4705,2352,2353,4BnQKPLuE3DMTtxp8MjUBytgnhvxqq3ZTqZHTVZo4JJh,188239,1884693,-1696454,556
2022-01-22 02:40:03-05:00,7545,GufVttJatW8NLeztT1NRQSLZpQNRk45kaG41p3QcWhx7,GTJUsWoWRyeafYJVhx2aRo8NE94U5UrBjaehmJ4PRUhn,True,1707823,426955,2583,1291,1292,4BnQKPLuE3DMTtxp8MjUBytgnhvxqq3ZTqZHTVZo4JJh,103328,929066,-825738,605
2022-01-22 02:40:04-05:00,7546,7hTjPRQSYAoWHhtpsVz2oKK5SAuFJd8dPHShKgKJq8dy,6DcHcrtcXR88d8e2KahhAiWTeRznNfF8oXLHmh5wE7wz,True,58157242,14539310,80758,40379,40379,4BnQKPLuE3DMTtxp8MjUBytgnhvxqq3ZTqZHTVZo4JJh,3230341,36881373,-33651032,555
2022-01-22 02:40:04-05:00,7547,HHHj6EinpgAJeZkDXfsvCo3UXnmAdiAZNvPSUfVPc5Sg,3gx9c31MDtJtByxkUuWcqf1oARnZTjpx3QtxsM1Xb6Gp,True,45746581,11436645,68494,34247,34247,4BnQKPLuE3DMTtxp8MjUBytgnhvxqq3ZTqZHTVZo4JJh,2739784,26724785,-23985001,598
2022-01-22 02:40:04-05:00,7548,AWvHDdb2ikqV8wc7qQ8azbvNTZdixMNxhQjhQdhayYtR,9EpgEPBb1nog6aQeFdMXfSRiLSnzGQFQ39mbLdCxgYTv,True,2815198,703799,3985,1992,1993,4BnQKPLuE3DMTtxp8MjUBytgnhvxqq3ZTqZHTVZo4JJh,159439,1544203,-1384764,566
2022-01-22 02:40:04-05:00,7549,DWTaeNeq5x83cBvKUz2jZfXDz5z4F5wbSZLNv7smnjvd,9pQGArZnJV4Fu8tBVEfknmmfmrRv5RKV2u58BJBuhzpF,True,5693003,1423250,8591,4295,4296,4BnQKPLuE3DMTtxp8MjUBytgnhvxqq3ZTqZHTVZo4JJh,343679,3549654,-3205975,603
2022-01-22 02:40:04-05:00,7550,6kqKSyVVF4xxUbsvBCkY1kt4XcKzb98eSaqNw5fxSLtw,4T9DKFUmkcPG7mM3CKzW3m81LqqpU7oFTv35Pha4zHNe,True,101057881,25264470,152210,76105,76105,4BnQKPLuE3DMTtxp8MjUBytgnhvxqq3ZTqZHTVZo4JJh,6088434,64970451,-58882017,602
2022-01-22 02:40:04-05:00,7551,5eMLdQ4gYA5iqvTXSNdGvctHp7s5VpyFuwtJKqx6chBc,Ckxc5K39nkBNXBTmFTM8J48R7wGqNm3vHKZu4G5baumZ,True,19941923,4985480,28517,14258,14259,4BnQKPLuE3DMTtxp8MjUBytgnhvxqq3ZTqZHTVZo4JJh,1140719,11789750,-10649031,572
2022-01-22 02:40:07-05:00,7552,6NJFN855M3Q3RLTDNo57gTgAmwPD6G2E3WvMb1m5eNCN,3YpqNnonsvXaRT4nCC3G5FZx1jjVtbDPc36LiR6WK5jR,True,4630267,1157566,6932,3466,3466,3zqXX6kzhkbW3d4TwD2CNjMRwxTbREXySekvq37kfCNk,277287,4022810,-3745523,598
2022-01-22 02:40:07-05:00,7553,DkvR2xUPMyXWGGkUSmDSfhp7RtvMkfbT1ThKCS3TwrXd,F7jYV6TtT1LZ5XCNn1zkbUfNMo4gGcQUczAQy1jLHpaW,True,37142176,9285544,57443,28721,28722,3zqXX6kzhkbW3d4TwD2CNjMRwxTbREXySekvq37kfCNk,2297746,25766576,-23468830,618
2022-01-22 02:40:08-05:00,7554,D64rDiWT3YG28fCgXCmbNjYa2JakZbpKQ1D2XuLChUfV,8WmMWq8cTsGQym5pUbHm9dPCpJugBeWUMVERYFGLxWHj,True,2175023,543755,3207,1603,1604,3zqXX6kzhkbW3d4TwD2CNjMRwxTbREXySekvq37kfCNk,128284,1293853,-1165569,589
2022-01-22 02:41:27-05:00,7555,J3ggP7ZxL8HRh3CBp5iYG2WgjLyNSAWYT46uC9VYDLCz,2FqTRiRPiLvdAH2BS5vroVntpsSXvTJEn5UHWmtKHzh9,True,1794135,448533,2797,1398,1399,HfEnetJ7uBSmZWCjBNxdvv9HEC5nsW4wDV7wu6WnhWan,111893,1013739,-901846,623
2022-01-22 02:41:27-05:00,7556,gMjmD7WioyUdQdwNqE5fobLcxPwoJv5rAvLmJaf8Jjw,5n77euFjVJiwKrnbYq1KpcENW1mzBZj2BuDGyzazrkJ8,True,14012642,3503159,21923,10961,10962,3zqXX6kzhkbW3d4TwD2CNjMRwxTbREXySekvq37kfCNk,876946,5746782,-4869836,625
2022-01-22 02:41:36-05:00,7557,HwosLQgDY1xtHQRQ4hzroPQHFWssPzTj5vRkP37FcviB,HKTNEYNXrephNkH7apbobK4mcQXcNayQA4W1NgM6sLr8,True,3761249,940312,5258,2629,2629,3zqXX6kzhkbW3d4TwD2CNjMRwxTbREXySekvq37kfCNk,210326,1984460,-1774134,559
2022-01-22 02:44:15-05:00,7558,Hy3kzXneDN6FUkiZctU1vWe97BYvj6yZ7QvQzehfWmNr,EhXgQg8BTniANV525RpY76z7Hrh6DuqrMChjqEoXfVJe,True,17758591,4439646,27721,13860,13861,HfEnetJ7uBSmZWCjBNxdvv9HEC5nsW4wDV7wu6WnhWan,1108873,7391376,-6282503,624
2022-01-22 02:44:45-05:00,7559,8T4WK27RvWVGqPuNqY6whk1fmU4vd5qaUQPZG1GJ79bh,DvSz7knS8N3K7L6JhQf1s4mJSyxB8uJXNQXtyjJn8QRL,True,5578900,1394723,8296,4148,4148,3zqXX6kzhkbW3d4TwD2CNjMRwxTbREXySekvq37kfCNk,331874,4090928,-3759054,594
2022-01-22 02:44:49-05:00,7560,GKKRAsYGdcf47eFThG4KwhNv7egeHRuc2wmTh4kqpego,4ippJxgnqCtdtGzCkdZoYwv68fiXNSqQcgrnaHdXZDUa,True,87251263,21812814,130186,65093,65093,3zqXX6kzhkbW3d4TwD2CNjMRwxTbREXySekvq37kfCNk,5207462,52118240,-46910778,596
2022-01-22 02:48:22-05:00,7561,BCGTaPQxGEMjD7xUxwfwmVVYJ9CEGH33yJRi3QjwyiLE,JBct1cZ9a959UKwABBEefwxZnGTAAGLzyUdXrXqGGCZd,True,117959929,29489981,179700,89850,89850,4BnQKPLuE3DMTtxp8MjUBytgnhvxqq3ZTqZHTVZo4JJh,7188030,72063057,-64875027,609
2022-01-22 02:50:31-05:00,7562,4ytoBUwuhAL4YYSCa6AgwrpeVF4eeU8H9NfDxMPZKxPo,Pby2szzsxDrXt4gnbmmaMccXxctZALr8miRtKhGKjsD,True,2675242,668810,3978,1989,1989,3zqXX6kzhkbW3d4TwD2CNjMRwxTbREXySekvq37kfCNk,159137,1612594,-1453457,594
2022-01-22 02:50:31-05:00,7563,9psSuFHBGqCvcgNMc7aTMhKMMFwBDmW7v5Wkn22KtTHj,7zi9LSfuEhXccQXSRukRRwgQUaiQVVgfsGaRYLP2JvwB,True,795297385,198824346,1179405,589702,589703,4BnQKPLuE3DMTtxp8MjUBytgnhvxqq3ZTqZHTVZo4JJh,47176227,306439971,-259263744,593
2022-01-22 02:51:04-05:00,7564,Dv1BABsN7amhjmGBpMQsnMkRLx7MuCVwsnuyTQeZ6uum,BCjscxVo1h16teND6KKiAUy1ftNGTMy1vEEEyAW4ttVG,True,4439617,1109904,6814,3407,3407,3zqXX6kzhkbW3d4TwD2CNjMRwxTbREXySekvq37kfCNk,272562,1575727,-1303165,613
2022-01-22 02:51:04-05:00,7565,442usWu6XpJZvU25bqXeynRrQ15jAzWwU9DWMgHpTn3Q,CtvADKp39bjJf3cPKWNL3wxnhq273fVM4fC5DmEcg5cC,True,978750096,244687524,1467861,733930,733931,HfEnetJ7uBSmZWCjBNxdvv9HEC5nsW4wDV7wu6WnhWan,58714477,443371570,-384657093,599
2022-01-22 02:51:54-05:00,7566,7iUx7JBwqUvPVPeCqMEXQdLccZJmaFYm1DUQiu3ouHa3,3EVZzhRmJnX9ZiBZZo9tenDtMogAyuA1yf2cKzvUWiuu,True,52574700,13143673,81887,40943,40944,HfEnetJ7uBSmZWCjBNxdvv9HEC5nsW4wDV7wu6WnhWan,3275517,18393554,-15118037,623
2022-01-22 02:52:14-05:00,7567,HEFpdWLZaiQnjftmXgxs6RNzhH72YiMjortxPkKekkvb,5Q8mmxBgVTijNGrWsnoA3VMArLHZEX5MkaigYXHpgXHE,True,43099545,10774886,66849,33424,33425,3zqXX6kzhkbW3d4TwD2CNjMRwxTbREXySekvq37kfCNk,2673996,14535993,-11861997,620
2022-01-22 02:52:14-05:00,7568,BhiAaiZu7fF8ndggJrLyiFVCRq526cNBw7VaeascEmNL,4en8MipPi7vq15NGhpPMQfptNdEyhp2j7fpgxBBtjyfz,True,41853425,10463355,65134,32567,32567,HfEnetJ7uBSmZWCjBNxdvv9HEC5nsW4wDV7wu6WnhWan,2605365,14637209,-12031844,622
2022-01-22 02:53:37-05:00,7569,BH36ueAULprzjj6WabTgvivEcrx3VdDn8DTxSoro8Zym,6yydJKEmtZjUwURrs9gQ7EGkB86nK28ZDJQqNMgbPosA,True,291874402,72968600,453776,226888,226888,4BnQKPLuE3DMTtxp8MjUBytgnhvxqq3ZTqZHTVZo4JJh,18151047,134397534,-116246487,621
2022-01-22 02:54:10-05:00,7570,DGbj8tnqECzM9FG8j225Ap7A4Fdm3J1Ksm32JBFG7igv,Cd3D2UVwoSZLygM2e3UQppQANsokpmx5CNBs1C5zueay,True,47555554,11888888,74064,37032,37032,3zqXX6kzhkbW3d4TwD2CNjMRwxTbREXySekvq37kfCNk,2962569,14349115,-11386546,622
2022-01-22 02:54:29-05:00,7571,BHpLpoGQ27T6Q4CT8H4dzqS8KF8Vj5rqmqfcodoBzpgR,Akn3tG2hQBfBVtNYCeXchfzfcsyCuSpkGpFoMLEKwcBF,True,3321730,830432,5072,2536,2536,4BnQKPLuE3DMTtxp8MjUBytgnhvxqq3ZTqZHTVZo4JJh,202918,2019157,-1816239,610
2022-01-22 02:54:30-05:00,7572,GXfjQr2ihTfLRys1DMetVGocd1sU97KdoCJ6x4HxdW1U,9GHvjJJXjbVz5D3RBfP3njcdRRXnFsXZ68jFa2LiGwsy,True,52527971,13131992,79781,39890,39891,HfEnetJ7uBSmZWCjBNxdvv9HEC5nsW4wDV7wu6WnhWan,3191246,30506936,-27315690,607
2022-01-22 02:54:35-05:00,7573,CCP5P6U4xBjea3snWgwBb5rtaounEAsNHpWzTUeNtVf9,GE2Bxc837ybP7sNR487U4bVbx68qyX2HtwPBLfEd4BDj,True,205970011,51492502,314747,157373,157374,3zqXX6kzhkbW3d4TwD2CNjMRwxTbREXySekvq37kfCNk,12589919,79679365,-67089446,611
2022-01-22 02:58:47-05:00,7574,FgQrRo4eGQAonSsFfQgnp8trGGqGZCLeGX6yvJnMnTjd,8KhemHLBY6nGmo3xMDedW2wnCSxQq6LwbTExif4sUSxx,True,83705131,20926282,128880,64440,64440,HfEnetJ7uBSmZWCjBNxdvv9HEC5nsW4wDV7wu6WnhWan,5155202,27757161,-22601959,615
2022-01-22 02:58:48-05:00,7575,BgnsCfJ54ReunUtwPJLzkW4PWnqpBDWGNYxsW5PvDrbK,KpMqEkQ9dKMgCevsEK895wHd3fCLRPSzDmJSv3tKU4u,True,884743053,221185763,1375465,687732,687733,3zqXX6kzhkbW3d4TwD2CNjMRwxTbREXySekvq37kfCNk,55018600,558974334,-503955734,621
2022-01-22 02:58:49-05:00,7576,8E3K7vCHJ2xjdFofPRGLbMxrkm8UYEi926QmXPAFwsqe,4qHUDA1c43Dg4qi1ZPKqmpGYiEMUZ6r4UuzB5ftHCEhW,True,86508268,21627067,134525,67262,67263,HfEnetJ7uBSmZWCjBNxdvv9HEC5nsW4wDV7wu6WnhWan,5381017,69222241,-63841224,622
2022-01-22 02:58:49-05:00,7577,9WJBnVi84E926j7xEd566WzrZJkPJWRgmEnYj9vyjuad,4dLaFS5F7TGyLdwuJLMGkz3bSL53aHzd9ZfpNmhHxXeF,True,935959,233989,1437,718,719,3zqXX6kzhkbW3d4TwD2CNjMRwxTbREXySekvq37kfCNk,57500,742874,-685374,614
2022-01-22 02:58:52-05:00,7578,CxLFMBDFkoMvpK9YUf7WtCq6hn7k3QACAuetAnGjU6KA,2gE52a1GWQnS6ifV6eVtKQyr13LXP5Jdt3yG9SjGPJPF,True,74036685,18509171,113797,56898,56899,4BnQKPLuE3DMTtxp8MjUBytgnhvxqq3ZTqZHTVZo4JJh,4551919,30631025,-26079106,614
2022-01-22 02:59:10-05:00,7579,2SNV9Q6vzQP5XxxqSrwXpQdRvk45FPiqLXmhNZzbLt1k,6dLG3ojK5Unm1mBh9aDZfryvoT2a6cSuWA8CxXy3oi7n,True,84249873,21062466,129213,64606,64607,3zqXX6kzhkbW3d4TwD2CNjMRwxTbREXySekvq37kfCNk,5168556,54403565,-49235009,613
2022-01-22 02:59:24-05:00,7580,DGbj8tnqECzM9FG8j225Ap7A4Fdm3J1Ksm32JBFG7igv,Cd3D2UVwoSZLygM2e3UQppQANsokpmx5CNBs1C5zueay,False,33860800,33860800,1082639,54131,1028508,3zqXX6kzhkbW3d4TwD2CNjMRwxTbREXySekvq37kfCNk,1082639,11428459,-10345820,319
2022-01-22 02:59:27-05:00,7581,Gbxc51WERLLeCtiHv7rDvE52aqF541RoQWG5n5aqErq6,4ngBoHbfXijLMqGKxFMNht9sbmxy2g5eqBmn8QsBmbx1,False,31944658,31944658,1332051,66602,1265449,3zqXX6kzhkbW3d4TwD2CNjMRwxTbREXySekvq37kfCNk,1332051,11655017,-10322966,416
2022-01-22 02:59:27-05:00,7582,46TNhGwBVzedW8xSb9UY94HNeSom9iGiZzAjrKHiRM2G,7JVTiqNYeKHbyzRkKtvSEpqLPKykZso8cGUr3sX1j7QF,True,4737634,1184408,7397,3698,3699,HfEnetJ7uBSmZWCjBNxdvv9HEC5nsW4wDV7wu6WnhWan,295885,2881542,-2585657,624
2022-01-22 02:59:28-05:00,7583,HEFpdWLZaiQnjftmXgxs6RNzhH72YiMjortxPkKekkvb,5Q8mmxBgVTijNGrWsnoA3VMArLHZEX5MkaigYXHpgXHE,True,31286868,7821716,39233,19616,19617,3zqXX6kzhkbW3d4TwD2CNjMRwxTbREXySekvq37kfCNk,1569356,11503674,-9934318,501
2022-01-22 02:59:28-05:00,7584,7iUx7JBwqUvPVPeCqMEXQdLccZJmaFYm1DUQiu3ouHa3,3EVZzhRmJnX9ZiBZZo9tenDtMogAyuA1yf2cKzvUWiuu,True,38321416,9580353,52100,26050,26050,HfEnetJ7uBSmZWCjBNxdvv9HEC5nsW4wDV7wu6WnhWan,2084019,14532208,-12448189,543
2022-01-22 02:59:28-05:00,7585,FiF5uS2uDYV3T1fvobU1rVhPEY9NVvwnQWBaTVUq8yQJ,7DBpkkcW6SgF6t63hZPf71KC5LwNrehsXh262NeQuBq1,False,956214956,956214956,23307905,1165395,22142510,3zqXX6kzhkbW3d4TwD2CNjMRwxTbREXySekvq37kfCNk,23307905,218212849,-194904944,243
2022-01-22 02:59:30-05:00,7586,4Sm9RWqrph72ZcWwCXSbjQ3gVJjfackrXZEKFSNJUSUx,CmMVCamDJCSVgPE8rAbpkniShrvUHUY8UtbVnPLoQQPF,False,2407383494,2407383494,72973338,3648666,69324672,3zqXX6kzhkbW3d4TwD2CNjMRwxTbREXySekvq37kfCNk,72973338,865589844,-792616506,303
2022-01-22 02:59:30-05:00,7587,4oQ7WAj5pkhBkH8YTNAcLqL3NY3ykM1UGjjSu3suLfSn,GjU66qT6JJnHseZMNgQitLJdzsNaqFtQsqzucPPw9SeT,False,168041196,168041196,8036031,401801,7634230,4BnQKPLuE3DMTtxp8MjUBytgnhvxqq3ZTqZHTVZo4JJh,8036031,37494835,-29458804,478
2022-01-22 02:59:32-05:00,7588,DRVtEzZs9u9ysrcANZLEjrvbuuGqYn77v2h4cDFKuNUx,Fv9qiMZhuSBL2cs9AWUYbDLQjB46W2ZwrhxaNXtPLDpC,False,3912184,3912184,178901,8945,169956,3uL2NSR2ZdDqCiKfzA5SwwpddAnit22DBJo6uvvz1rRs,178901,1384015,-1205114,457
2022-01-22 02:59:35-05:00,7589,3662SX3YSARYupcxpgtTvUAPUsU7aJKsGxvpkNC1AV1A,HkAb86jdGHbz6VxrtbA81jPvjhiNHhbe82NBPFxnwzE5,False,29650306,29650306,705720,35286,670434,3zqXX6kzhkbW3d4TwD2CNjMRwxTbREXySekvq37kfCNk,705720,7355447,-6649727,238
2022-01-22 02:59:38-05:00,7590,6pXjgzpAPSjchUHoPqsZduviYV95SBHNk5CRCNjGAJZw,26Zjv9SkvUmwQAQT9Ls6k1wdKECrkhBrDUDrntpHfPEu,False,230002576,230002576,6406789,320339,6086450,3zqXX6kzhkbW3d4TwD2CNjMRwxTbREXySekvq37kfCNk,6406789,63249941,-56843152,278
2022-01-22 02:59:38-05:00,7591,Dn916KSmX3HqxT53hrxrbCrV3tdRMCPdaoiRLqetMrth,ATCXRiXgnjRRUbSTPBvtBXMENCqsViexSZbZ6aDaXXWA,False,35416519,35416519,867521,43376,824145,3zqXX6kzhkbW3d4TwD2CNjMRwxTbREXySekvq37kfCNk,867521,11837147,-10969626,244
2022-01-22 02:59:38-05:00,7592,5BJnMHFSiQjHRGFJDW1jnqCfkHHYWnQzmmccy9eA4jNj,9517JGYsPmvgPUM9pFRD2vipHmdgE578F7jA7Qq6jorm,True,216822822,54205705,323599,161799,161800,3zqXX6kzhkbW3d4TwD2CNjMRwxTbREXySekvq37kfCNk,12943977,64878355,-51934378,596
2022-01-22 02:59:38-05:00,7593,Dng7By2saPu5TVxcvXidBe71ggBo8tiHkAXPi4kKL1tk,75ufEJmHbLHffphL7tvAXhGyftKLr1z2PXXoB2GGY5fG,True,58200421,14550105,76887,38443,38444,72FwbpFGoLEazJEdpqNtPNefsadUrimUqma9wSoy4qiS,3075499,18015461,-14939962,528
2022-01-22 02:59:38-05:00,7594,BhiAaiZu7fF8ndggJrLyiFVCRq526cNBw7VaeascEmNL,4en8MipPi7vq15NGhpPMQfptNdEyhp2j7fpgxBBtjyfz,True,30517847,7629460,41700,20850,20850,3zqXX6kzhkbW3d4TwD2CNjMRwxTbREXySekvq37kfCNk,1668008,11564147,-9896139,546
2022-01-22 02:59:38-05:00,7595,BH36ueAULprzjj6WabTgvivEcrx3VdDn8DTxSoro8Zym,6yydJKEmtZjUwURrs9gQ7EGkB86nK28ZDJQqNMgbPosA,True,212178024,53044505,274237,137118,137119,3zqXX6kzhkbW3d4TwD2CNjMRwxTbREXySekvq37kfCNk,10969493,104883047,-93913554,516
2022-01-22 02:59:39-05:00,7596,BjCNaM7YbE9SjFi7tzi4677zg1fKXGJwtecz2GWwWuhd,6rNsSrKZezQrLb2whToNjnizpnurDXrobHqfEK3QqU1M,True,2223335054,555833762,3376433,1688216,1688217,3zqXX6kzhkbW3d4TwD2CNjMRwxTbREXySekvq37kfCNk,135057336,891750692,-756693356,607
2022-01-22 02:59:42-05:00,7597,2r64Rnbu3ZjmJTHHUxxV9TWWGzwpAepA4ySbtKivBXCj,6RRzx6KLkMiFK9JSuznrSJGiPgkHwatBSskudHqbfKJ5,True,348755476,87188869,537318,268659,268659,4BnQKPLuE3DMTtxp8MjUBytgnhvxqq3ZTqZHTVZo4JJh,21492753,207276544,-185783791,616
2022-01-22 02:59:43-05:00,7598,8WHDaiE6LqFFmCVMnPeLEQ99R6ft8b74UfmP9BqzjcE8,CGmoDGsdnjo3zMNrW78n2xxQr1aDPAiBYiXbyciLXYMu,True,29092827,7273206,45481,22740,22741,HfEnetJ7uBSmZWCjBNxdvv9HEC5nsW4wDV7wu6WnhWan,1819251,18640664,-16821413,625
2022-01-22 03:00:17-05:00,7599,6pUtYz474QrpATEZnfb3iFbTKYA65pNyKAo4TQZAjtqe,8dipRUXvxJiDLdHEtCPkso4vErbVwshHQiRfvSngBS9J,True,21517654199,5379413548,33348567,16674283,16674284,3zqXX6kzhkbW3d4TwD2CNjMRwxTbREXySekvq37kfCNk,1333942708,7327485987,-5993543279,619
2022-01-22 03:00:17-05:00,7600,FtF3PVw8YNJseWPMcA2GEuQZ6nni1mq5kYPa2LrSzfkW,4yr1TM2dXrBvLNMpSaoryuGU2P8D3WG1ZCkvVzWFiQRH,True,6422151659,1605537913,9930803,4965401,4965402,3zqXX6kzhkbW3d4TwD2CNjMRwxTbREXySekvq37kfCNk,397232141,2528404297,-2131172156,618
2022-01-22 03:00:31-05:00,7601,5Rxuqgs4CaSKbfDXqBMFXkLTQ9dxrUjThXzoy3ouYVtK,BgvbKru66ebrGUcFFymGTmsaQv6GgcGMybiWaXqzBtwX,False,12603,12603,628,31,597,3zqXX6kzhkbW3d4TwD2CNjMRwxTbREXySekvq37kfCNk,628,11317,-10689,498
2022-01-22 03:00:31-05:00,7602,399591e8XgY52yCMorCQ2WL6dQZTC485ZooHtmGuirhZ,JCiXAooFmKmEPQ2S7C8iSk6CLcTyrPEe1SsPSLyUGySe,True,65254,16313,101,50,51,3zqXX6kzhkbW3d4TwD2CNjMRwxTbREXySekvq37kfCNk,4056,57187,-53131,621
2022-01-22 03:00:31-05:00,7603,HEFpdWLZaiQnjftmXgxs6RNzhH72YiMjortxPkKekkvb,5Q8mmxBgVTijNGrWsnoA3VMArLHZEX5MkaigYXHpgXHE,True,23429539,5857384,36498,18249,18249,3zqXX6kzhkbW3d4TwD2CNjMRwxTbREXySekvq37kfCNk,1459944,8946314,-7486370,623
2022-01-22 03:00:50-05:00,7604,A4tDE948CPFPh1UwHb8sXryfKktbxZ8BCkqXgA5DJHA8,3zXeKMrsEpCe5fQumLNzCgpxcG1kLJFEAtJuqxLsC6ZG,True,5281419,1320354,8250,4125,4125,3zqXX6kzhkbW3d4TwD2CNjMRwxTbREXySekvq37kfCNk,330022,3774243,-3444221,624
2022-01-22 03:00:53-05:00,7605,4uygLJDk9DFCifJ56YwMrEsvd3oQNq8tYSLnMCyWorS6,GimL4uKGvg3FFmFQSWzAcjstv3Vmk5NMgDGMKTuXYVpB,True,31622089,7905522,49421,24710,24711,3zqXX6kzhkbW3d4TwD2CNjMRwxTbREXySekvq37kfCNk,1976859,21517472,-19540613,625
2022-01-22 03:00:53-05:00,7606,BgN75npBkPws5uiFE9RAujmPuZyAv2MQUPmfmJ1YCCij,78UFLNDn782TY2P4F5kRkMRC2s3gw8ak7sRQZRWNq82D,True,14637556,3659389,22716,11358,11358,4BnQKPLuE3DMTtxp8MjUBytgnhvxqq3ZTqZHTVZo4JJh,908674,5251319,-4342645,620
2022-01-22 03:00:55-05:00,7607,BH36ueAULprzjj6WabTgvivEcrx3VdDn8DTxSoro8Zym,6yydJKEmtZjUwURrs9gQ7EGkB86nK28ZDJQqNMgbPosA,True,158605257,39651313,247973,123986,123987,3zqXX6kzhkbW3d4TwD2CNjMRwxTbREXySekvq37kfCNk,9918952,80882885,-70963933,625
2022-01-22 03:00:57-05:00,7608,Dng7By2saPu5TVxcvXidBe71ggBo8tiHkAXPi4kKL1tk,75ufEJmHbLHffphL7tvAXhGyftKLr1z2PXXoB2GGY5fG,True,43336657,10834164,65566,32783,32783,3zqXX6kzhkbW3d4TwD2CNjMRwxTbREXySekvq37kfCNk,2622647,14141311,-11518664,605
2022-01-22 03:00:58-05:00,7609,2rLWe1XADCU93guPU6WgSW6x56gYNfif9bm11V93mJnv,BEGhQRm3fgSHeBtk2DYrXEBPKPRvS3sHyTNopmoBJxMs,True,18230207258,4557551814,25515230,12757615,12757615,3zqXX6kzhkbW3d4TwD2CNjMRwxTbREXySekvq37kfCNk,1020609225,7879191290,-6858582065,559
2022-01-22 03:01:06-05:00,7610,5BJnMHFSiQjHRGFJDW1jnqCfkHHYWnQzmmccy9eA4jNj,9517JGYsPmvgPUM9pFRD2vipHmdgE578F7jA7Qq6jorm,True,160387090,40096772,249074,124537,124537,3zqXX6kzhkbW3d4TwD2CNjMRwxTbREXySekvq37kfCNk,9962990,51144727,-41181737,621
2022-01-22 03:02:16-05:00,7611,8JtUn4uue4WzrySwnDQ74qzzWaKsoo11MbMvRh1ePDJN,8iahKConWg6fyZrkoze5eeujyNHA26AybYBpHwUr76Cu,True,73211036,18302759,114375,57187,57188,3zqXX6kzhkbW3d4TwD2CNjMRwxTbREXySekvq37kfCNk,4575005,39145045,-34570040,624
2022-01-22 03:02:38-05:00,7612,7feC64HZfQpniey2iXsMMgQXnfcunJus74DiKDeKaEUw,GstsCxAiBBEUrXNkvZZ9Sg4vNK916PsKe2Mx6e4M6dU7,True,185716,46428,278,139,139,3zqXX6kzhkbW3d4TwD2CNjMRwxTbREXySekvq37kfCNk,11139,125754,-114615,599
2022-01-22 03:02:38-05:00,7613,CmvNNpdGVDGujBadaMmgKc8xgFfyV6G9PNEjD8zEND6L,EzmfinKBZ8TXoSugyTqdEdHWrHdTdpHQtc1TApfaNfDR,True,2915290742,728822685,4500800,2250400,2250400,3zqXX6kzhkbW3d4TwD2CNjMRwxTbREXySekvq37kfCNk,180032038,2013672644,-1833640606,617
2022-01-22 03:02:38-05:00,7614,72woixtGAuGazCMfsYfYBYLP7FuRj8Fwz9fynFo4MCE4,5237BmWkKf58PBeTUEiu3Ld5uKXEe8wcrJRmCnUoWWku,True,23205568,5801392,34618,17309,17309,3zqXX6kzhkbW3d4TwD2CNjMRwxTbREXySekvq37kfCNk,1384729,11726659,-10341930,596
2022-01-22 03:02:38-05:00,7615,D7XummfEc3NTK4qMvZegV3FrYuqc8mNgnQu3ujwemZtg,HHiRcecqzW7sGFTio7Ph6TYv3dGt64KWv4DEKgKm84fQ,True,186307,46576,290,145,145,3zqXX6kzhkbW3d4TwD2CNjMRwxTbREXySekvq37kfCNk,11638,158019,-146381,624
2022-01-22 03:08:34-05:00,7616,4hZG7dM716SxDagiFGwt1gSC99B2QK1emGLV9TJmmuR8,7vjfUWySkyx4Z5qAaRr2VWnVvxHHNsvPj1PirGNSjM6,True,6274129070,1568532267,9815097,4907548,4907549,HfEnetJ7uBSmZWCjBNxdvv9HEC5nsW4wDV7wu6WnhWan,392603881,3033941478,-2641337597,625
2022-01-22 03:09:28-05:00,7617,3JrhHRs4UkkuMoCrQAaAGKZQrWoU72zWArnDGxKFESzH,8yREVE3kMYB7UAwtUDnTDK3egXTuTsN4igtJ5yeHYkCP,True,84534366,21133590,131931,65965,65966,HfEnetJ7uBSmZWCjBNxdvv9HEC5nsW4wDV7wu6WnhWan,5277250,33543011,-28265761,624
2022-01-22 03:12:05-05:00,7618,25NUDrsdLhS3fcARLiTMbbmZHvvzvzPj9xAdoN8sJBN3,8baNRGHfYRcLdhbHNuH72ofAWM9UojqhTMLnbBayzGnW,True,8900513,2225128,13104,6552,6552,HfEnetJ7uBSmZWCjBNxdvv9HEC5nsW4wDV7wu6WnhWan,524197,4385779,-3861582,588
2022-01-22 03:12:05-05:00,7619,4Enpw9W2mWGnNYagYQ8WW29RLSs4R5YX4qXCsVqMFeHn,9QwbJmm9QDKXyc4ZViq74BfS35zzewEceXQNnFCgczXu,True,862510151,215627537,1291388,645694,645694,HfEnetJ7uBSmZWCjBNxdvv9HEC5nsW4wDV7wu6WnhWan,51655543,243825585,-192170042,598
2022-01-22 03:13:09-05:00,7620,9yDHiv4vGbQWYby3dAMCdVnwiYgXBV1jV6WCzKYUPiUs,FPyemR1VdBnhxW2V7j7EkQyhzW894bCb3f6wRUMSn6jB,True,481064521,120266130,738546,369273,369273,4BnQKPLuE3DMTtxp8MjUBytgnhvxqq3ZTqZHTVZo4JJh,29541865,122041423,-92499558,614
2022-01-22 03:13:10-05:00,7621,2MbNCikBC3fdwqJKfMK1FjPg7wT3xWMXmN88XuikJ8r9,5eG6U5x63YYMpE7iwwu1TPcZapvQMyKczvtnFfST1BH3,True,15835,3958,24,12,12,HfEnetJ7uBSmZWCjBNxdvv9HEC5nsW4wDV7wu6WnhWan,973,7780,-6807,614
2022-01-22 03:13:12-05:00,7622,DYqdjjx7PHxaHWTv6QC98aYZPDopJsTwfzaydLHGPn2,3EjvG9CUHmfRFhkq7kec31dKjjqiqEDxZAjgLeDNDQWu,True,25034403,6258600,38675,19337,19338,3zqXX6kzhkbW3d4TwD2CNjMRwxTbREXySekvq37kfCNk,1547014,7761037,-6214023,617
2022-01-22 03:13:23-05:00,7623,B5CTBTggmGFvGFSunjbB4C9tLKcYcULehmEiEXRihY2J,FX3ebF8P89rZBWfR74PDWUzxnLuDkUDgGcPYCBD5sMUG,True,53468068,13367016,80949,40474,40475,HfEnetJ7uBSmZWCjBNxdvv9HEC5nsW4wDV7wu6WnhWan,3237977,25707928,-22469951,605
2022-01-22 03:13:26-05:00,7624,BgNgALwBEuiumVgiXRmBZRnyFrr9QTDy2maHzsNwNHGf,ag35Ec2uFtqkarizCxFyhM2SPBuUwfmLRhAdFEWFCNa,True,5814711,1453677,8849,4424,4425,3uL2NSR2ZdDqCiKfzA5SwwpddAnit22DBJo6uvvz1rRs,353992,2544649,-2190657,608
2022-01-22 03:13:27-05:00,7625,7Dm3syN4P2mbBLFKyHTrtnSWY4hadGXiKB9EekTdT68S,HF97QS1dqarPMWgNmtcoaq6z3rpJnzAAAfc1PP4FwRhV,True,5915749,1478937,9225,4612,4613,4BnQKPLuE3DMTtxp8MjUBytgnhvxqq3ZTqZHTVZo4JJh,369012,1663114,-1294102,623
2022-01-22 03:13:41-05:00,7626,4xn9vTtLZyNtCbBLLpcXUMWU8AnnZCov9rJaY6rew16T,5UNWdFw2CP44qS8oc4uPt8zxw6zFg8oXz8SUCedZLLEC,True,789963,197490,1235,617,618,HfEnetJ7uBSmZWCjBNxdvv9HEC5nsW4wDV7wu6WnhWan,49436,384255,-334819,625
2022-01-22 03:14:05-05:00,7627,243SAnGxchCVB1LQAUF4SsozR86yDwEdg2QQpbWGsMYe,5u8sNkb2oEQjUXJAB3yGStmv3Uwz16gBgExBo5myVK4b,True,2193485,548371,3423,1711,1712,HfEnetJ7uBSmZWCjBNxdvv9HEC5nsW4wDV7wu6WnhWan,136941,1111993,-975052,624
2022-01-22 03:16:42-05:00,7628,E5biUzKn2s5frKseCmfWriWjrYMGVtmLrhR9nYhAkVvR,BDHzqefisuGoMGcpML8t6KAC7rcErvhLcfV8KQC7oHAH,True,12957645,3239411,19651,9825,9826,4BnQKPLuE3DMTtxp8MjUBytgnhvxqq3ZTqZHTVZo4JJh,786072,5836451,-5050379,606
2022-01-22 03:16:51-05:00,7629,56488NdcUy6Hi6X5SLs2GFtW5pG4u5wJpH7vHdxTCx4z,tGgXjJeVr3W2m3T2NXPCqpBEd6HJKE2cRsgCyiDZQy4,True,5976786,1494196,9345,4672,4673,3zqXX6kzhkbW3d4TwD2CNjMRwxTbREXySekvq37kfCNk,373829,3900083,-3526254,625
2022-01-22 03:17:23-05:00,7630,EDSf2w1UyGvbgMuxyoXL58ifR1dviZinnLBYnFmgjcNG,DFenkzbL9SUjs9cSCaHJ1eXK75mHfk3GSPRFs8TSzrFV,True,269605382,67401345,407529,203764,203765,3zqXX6kzhkbW3d4TwD2CNjMRwxTbREXySekvq37kfCNk,16301176,100622598,-84321422,604
2022-01-22 03:17:23-05:00,7631,GBpe8E33cNkFmMUuP3WjhDBBuQz7MHaDkpCJjGFaFkvu,3QYFKkgzZ1PKKAxCh4hMhgqrupoCcfRVkjuJZRWVZo3H,True,18489264,4622316,28435,14217,14218,HfEnetJ7uBSmZWCjBNxdvv9HEC5nsW4wDV7wu6WnhWan,1137428,8719441,-7582013,615
2022-01-22 03:17:24-05:00,7632,FV3G5EsSmyiLAAoREhgDXwvzbxoyDeq4Mwfj4jK5fJ7U,5nhzbJmm5JAwGDpTZoenkM1u3XtMY4uN7Qsm3vFGtRJE,True,2044505,511126,3177,1588,1589,3zqXX6kzhkbW3d4TwD2CNjMRwxTbREXySekvq37kfCNk,127098,937701,-810603,621
2022-01-22 03:17:24-05:00,7633,4ne6vC7qdxQYHJCsaeFAKZrKdFt2SwXGHQ3jrMHqt4DL,Cf1dLHY2WXH9rXbRKq5TT8THbdo9SdNUZq4rYhRCF9z,True,4375604,1093901,6808,3404,3404,3zqXX6kzhkbW3d4TwD2CNjMRwxTbREXySekvq37kfCNk,272338,2090140,-1817802,622
2022-01-22 03:17:24-05:00,7634,DvuRmJkfn6FQczUKgYeaSCqwy2NTMunuAKNrnmxMvnzS,7LpWTX9dgBtW75kfEoB5WuNsDwEdw5s8CYSHh3J4qagM,True,2101039,525259,3259,1629,1630,3zqXX6kzhkbW3d4TwD2CNjMRwxTbREXySekvq37kfCNk,130371,1811551,-1681180,620
2022-01-22 03:17:31-05:00,7635,C1rjefgArnN3nBn5Wu3yXij2wAyGWFtWdjGNLR9vpjmj,GsLCESLzYGZ1brEh8RJrZttE7hxcpSq7iUqdhwJhnDVB,True,4115218,1028804,6410,3205,3205,3zqXX6kzhkbW3d4TwD2CNjMRwxTbREXySekvq37kfCNk,256435,2880083,-2623648,623
2022-01-22 03:17:35-05:00,7636,DC4UVUDFWL3gVtgkX9hPtFgtxaA8DH5p94i4k9U3wyWv,3HCWqVvQQfRgSKitsTjGTduJ82ointZUSNtj13uea4kD,True,43276815,10819203,66690,33345,33345,4BnQKPLuE3DMTtxp8MjUBytgnhvxqq3ZTqZHTVZo4JJh,2667632,30471617,-27803985,616
2022-01-22 03:17:39-05:00,7637,HELPNUwAqTX7gfHS4cnJnqXFM6Rb156tYcpsitKR9iDu,3RdfgDvLvsdZG5Cf6hKiKMQMqfidyxHzjYvUx1FZpeHQ,True,10896562,2724140,16986,8493,8493,4BnQKPLuE3DMTtxp8MjUBytgnhvxqq3ZTqZHTVZo4JJh,679468,10896874,-10217406,623
2022-01-22 03:17:39-05:00,7638,3c4tj9J8QwB3exFchWei43nBh5xsYRZxEUfayi3JvYgm,Fyw1TEEDKhLFo16qxDsttsAwSkrfzpDe8Dmm3atEeXyN,True,9948305,2487076,15350,7675,7675,3zqXX6kzhkbW3d4TwD2CNjMRwxTbREXySekvq37kfCNk,614021,7274710,-6660689,617
2022-01-22 03:17:40-05:00,7639,2sPD4f4d3CCeFSwSC5vAGS3YoTsTGypYKfDeoJczebop,HWCRpcq2sXqJL7Vi8MtipQDwGSViE73bUxS36ETmvnP2,True,4434852,1108713,6878,3439,3439,3zqXX6kzhkbW3d4TwD2CNjMRwxTbREXySekvq37kfCNk,275123,1989850,-1714727,620
2022-01-22 03:17:40-05:00,7640,7dmoK7QPki7R66SPQST4veUgVfnJbVToxxBPZveECiwK,4vh4REBDm5zBDmcjRCD9zNsny1HGneu7B2co4dSJNLL6,True,19252825,4813205,29917,14958,14959,3zqXX6kzhkbW3d4TwD2CNjMRwxTbREXySekvq37kfCNk,1196710,14797720,-13601010,621
2022-01-22 03:17:43-05:00,7641,EXP61AETWHw3kHSjrJH1jQBt6cXR9Zebz34Cueb3KAzg,2JT9GrgdUKjuQQtXvZqevbjFquUQBMYDoADmBjDKWXj3,True,108262071,27065517,168301,84150,84151,4BnQKPLuE3DMTtxp8MjUBytgnhvxqq3ZTqZHTVZo4JJh,6732071,50300863,-43568792,621
2022-01-22 03:17:44-05:00,7642,EAtQUZAkQxwJF779DwPcWHZ455FzYX8mzm1uV5LBnhPB,8h8t6GW1Y7xMBfWpfyFfUVBP4apMbJVNg7igZUYZLsyr,True,26665719,6666429,41062,20531,20531,3zqXX6kzhkbW3d4TwD2CNjMRwxTbREXySekvq37kfCNk,1642509,8719290,-7076781,615
2022-01-22 03:17:54-05:00,7643,AvwHizRhHUSahmvSg4jmTUErc7vAFSmkRAEsiKhXfW1m,3UrWYx8y9N5o9GYneSe6zyyHRTZzxwvcipQfHHYh7tEs,True,63649,15912,99,49,50,HfEnetJ7uBSmZWCjBNxdvv9HEC5nsW4wDV7wu6WnhWan,3973,45994,-42021,624
2022-01-22 03:18:24-05:00,7644,4SQQdHTJUDv8taPXQRvEVJpUu91iCWQsv9su8tfehaQG,33CJXj1pmmatAofRvgt5in9E6SLEuy7tq4jqSwnUWP2A,True,695307189,173826797,1069893,534946,534947,4BnQKPLuE3DMTtxp8MjUBytgnhvxqq3ZTqZHTVZo4JJh,42795741,648709763,-605914022,615
2022-01-22 03:18:33-05:00,7645,GjQQ2fQ7mrGjWZwjVYFUKp9NM1LmfkhEo675ovU5SPa8,ECgVUMRY5nB4MALs5drDyipF7YohCPuJpj2UegCs7HMn,True,390704,97676,610,305,305,3zqXX6kzhkbW3d4TwD2CNjMRwxTbREXySekvq37kfCNk,24403,311308,-286905,624
2022-01-22 03:19:06-05:00,7646,5NVD6QvomTAD35yNxSFZw4DhF2hCtV8drkbnGhBVtK5y,3JzkyPnREvoFZLL9JZuuDEnee3nuKcrqY3xLuXsmHwRo,True,1032349,258087,1610,805,805,3zqXX6kzhkbW3d4TwD2CNjMRwxTbREXySekvq37kfCNk,64406,908806,-844400,623
2022-01-22 03:19:08-05:00,7647,F9s8a7Cpiw5dw3a2aNFMofqwyDWNXvDLnSdJzoj1gRiV,GpKsQKJD79KBRWdCTkyi4zX7NaoCWsLUjrKxAwJB6o6s,True,516062,129015,806,403,403,4BnQKPLuE3DMTtxp8MjUBytgnhvxqq3ZTqZHTVZo4JJh,32241,280900,-248659,624
2022-01-22 03:22:19-05:00,7648,GQviUdocJ1s4FsVDDexanvo5yQWRZgwwkGJBCg7TMtJC,HAX4VAKgQpKtm1149iRgtzvUaUkiXWcA1bJ9ERu6tXkd,True,23416734,5854183,36311,18155,18156,DddJ7EWCmYEEZETCBNgAUSg81Ls6fZtiAaY5ekJ5sXx1,1452442,7653208,-6200766,620
2022-01-22 03:22:48-05:00,7649,2pKygdXJnjZBFfrZgDasmHQQgw8LgycmBBRuaoCU72cz,DXsomQ5yWw2ceZMbaCVsSaE4hKm9W6Gy785JG75Aaz18,True,4291309,1072827,6679,3339,3340,3zqXX6kzhkbW3d4TwD2CNjMRwxTbREXySekvq37kfCNk,267173,1981316,-1714143,622
2022-01-22 03:22:49-05:00,7650,GxFxvEUdWofneMmVvhCSScH9V6Zia5WJ2J9q6CpPnaq3,ATLykiHDii3Lw53MoZXwqu1FbBNPJbVNVGe2SoQMjVmY,True,78478,19619,122,61,61,3zqXX6kzhkbW3d4TwD2CNjMRwxTbREXySekvq37kfCNk,4880,69080,-64200,621
2022-01-22 03:22:50-05:00,7651,3FF2rhr1RuT7UR7MmmGtrhfYbh6kbc5UXq51KmqFLZnq,AEmSYLt1dQ8suLugC4Lcw4kF3dG9GYcEfX54hEAKfmv5,True,4766372,1191593,7406,3703,3703,4BnQKPLuE3DMTtxp8MjUBytgnhvxqq3ZTqZHTVZo4JJh,296257,2202758,-1906501,621
2022-01-22 03:23:01-05:00,7652,72woixtGAuGazCMfsYfYBYLP7FuRj8Fwz9fynFo4MCE4,5237BmWkKf58PBeTUEiu3Ld5uKXEe8wcrJRmCnUoWWku,True,17125440,4281360,26784,13392,13392,3zqXX6kzhkbW3d4TwD2CNjMRwxTbREXySekvq37kfCNk,1071375,9106568,-8035193,625
2022-01-22 03:23:13-05:00,7653,25NUDrsdLhS3fcARLiTMbbmZHvvzvzPj9xAdoN8sJBN3,8baNRGHfYRcLdhbHNuH72ofAWM9UojqhTMLnbBayzGnW,True,6574822,1643705,10263,5131,5132,3zqXX6kzhkbW3d4TwD2CNjMRwxTbREXySekvq37kfCNk,410530,3407282,-2996752,624
2022-01-22 03:23:34-05:00,7654,8JtUn4uue4WzrySwnDQ74qzzWaKsoo11MbMvRh1ePDJN,8iahKConWg6fyZrkoze5eeujyNHA26AybYBpHwUr76Cu,True,53658618,13414654,80274,40137,40137,HfEnetJ7uBSmZWCjBNxdvv9HEC5nsW4wDV7wu6WnhWan,3210971,30388252,-27177281,598
2022-01-22 03:23:35-05:00,7655,CmvNNpdGVDGujBadaMmgKc8xgFfyV6G9PNEjD8zEND6L,EzmfinKBZ8TXoSugyTqdEdHWrHdTdpHQtc1TApfaNfDR,True,2143533034,535883258,3314905,1657452,1657453,4BnQKPLuE3DMTtxp8MjUBytgnhvxqq3ZTqZHTVZo4JJh,132596215,1550922762,-1418326547,618
2022-01-22 03:24:20-05:00,7656,D7XummfEc3NTK4qMvZegV3FrYuqc8mNgnQu3ujwemZtg,HHiRcecqzW7sGFTio7Ph6TYv3dGt64KWv4DEKgKm84fQ,True,136870,34217,212,106,106,3zqXX6kzhkbW3d4TwD2CNjMRwxTbREXySekvq37kfCNk,8487,121135,-112648,620
2022-01-22 03:24:20-05:00,7657,4hZG7dM716SxDagiFGwt1gSC99B2QK1emGLV9TJmmuR8,7vjfUWySkyx4Z5qAaRr2VWnVvxHHNsvPj1PirGNSjM6,True,4611170023,1152792505,7209050,3604525,3604525,3zqXX6kzhkbW3d4TwD2CNjMRwxTbREXySekvq37kfCNk,288362004,2364442892,-2076080888,625
2022-01-22 03:25:07-05:00,7658,GjQQ2fQ7mrGjWZwjVYFUKp9NM1LmfkhEo675ovU5SPa8,ECgVUMRY5nB4MALs5drDyipF7YohCPuJpj2UegCs7HMn,True,286107,71526,421,210,211,4BnQKPLuE3DMTtxp8MjUBytgnhvxqq3ZTqZHTVZo4JJh,16872,238972,-222100,589
2022-01-22 03:25:07-05:00,7659,GBpe8E33cNkFmMUuP3WjhDBBuQz7MHaDkpCJjGFaFkvu,3QYFKkgzZ1PKKAxCh4hMhgqrupoCcfRVkjuJZRWVZo3H,True,13571981,3392995,20350,10175,10175,4BnQKPLuE3DMTtxp8MjUBytgnhvxqq3ZTqZHTVZo4JJh,814026,6795508,-5981482,599
2022-01-22 03:25:07-05:00,7660,DvuRmJkfn6FQczUKgYeaSCqwy2NTMunuAKNrnmxMvnzS,7LpWTX9dgBtW75kfEoB5WuNsDwEdw5s8CYSHh3J4qagM,True,1526405,381601,1943,971,972,4BnQKPLuE3DMTtxp8MjUBytgnhvxqq3ZTqZHTVZo4JJh,77737,1387998,-1310261,509
2022-01-22 03:25:07-05:00,7661,GxFxvEUdWofneMmVvhCSScH9V6Zia5WJ2J9q6CpPnaq3,ATLykiHDii3Lw53MoZXwqu1FbBNPJbVNVGe2SoQMjVmY,True,57583,14395,87,43,44,3zqXX6kzhkbW3d4TwD2CNjMRwxTbREXySekvq37kfCNk,3482,52909,-49427,604
2022-01-22 03:25:07-05:00,7662,7feC64HZfQpniey2iXsMMgQXnfcunJus74DiKDeKaEUw,GstsCxAiBBEUrXNkvZZ9Sg4vNK916PsKe2Mx6e4M6dU7,True,135839,33959,185,92,93,DddJ7EWCmYEEZETCBNgAUSg81Ls6fZtiAaY5ekJ5sXx1,7412,96824,-89412,545
2022-01-22 03:25:07-05:00,7663,6uZobpBuFcQeYgZ4dApFi6iy4DB9GLHP1AAsQcCj6212,SGGFiPjjhscwroiWMqY4jTAHFw8eakpsEv35wNoHUPY,True,23815988,5953995,37071,18535,18536,3zqXX6kzhkbW3d4TwD2CNjMRwxTbREXySekvq37kfCNk,1482876,7391763,-5908887,622
2022-01-22 03:25:09-05:00,7664,C1rjefgArnN3nBn5Wu3yXij2wAyGWFtWdjGNLR9vpjmj,GsLCESLzYGZ1brEh8RJrZttE7hxcpSq7iUqdhwJhnDVB,True,2991372,747843,3874,1937,1937,3zqXX6kzhkbW3d4TwD2CNjMRwxTbREXySekvq37kfCNk,154983,2217762,-2062779,518
2022-01-22 03:25:09-05:00,7665,DC4UVUDFWL3gVtgkX9hPtFgtxaA8DH5p94i4k9U3wyWv,3HCWqVvQQfRgSKitsTjGTduJ82ointZUSNtj13uea4kD,True,31556299,7889074,42490,21245,21245,3zqXX6kzhkbW3d4TwD2CNjMRwxTbREXySekvq37kfCNk,1699629,23453968,-21754339,538
2022-01-22 03:25:09-05:00,7666,FV3G5EsSmyiLAAoREhgDXwvzbxoyDeq4Mwfj4jK5fJ7U,5nhzbJmm5JAwGDpTZoenkM1u3XtMY4uN7Qsm3vFGtRJE,True,1485331,371332,1896,948,948,3zqXX6kzhkbW3d4TwD2CNjMRwxTbREXySekvq37kfCNk,75873,731874,-656001,510
2022-01-22 03:25:09-05:00,7667,3FF2rhr1RuT7UR7MmmGtrhfYbh6kbc5UXq51KmqFLZnq,AEmSYLt1dQ8suLugC4Lcw4kF3dG9GYcEfX54hEAKfmv5,True,3497249,874312,5283,2641,2642,3zqXX6kzhkbW3d4TwD2CNjMRwxTbREXySekvq37kfCNk,211321,1718728,-1507407,604
2022-01-22 03:25:09-05:00,7668,4xn9vTtLZyNtCbBLLpcXUMWU8AnnZCov9rJaY6rew16T,5UNWdFw2CP44qS8oc4uPt8zxw6zFg8oXz8SUCedZLLEC,False,572147,572147,27875,1393,26482,3zqXX6kzhkbW3d4TwD2CNjMRwxTbREXySekvq37kfCNk,27875,299316,-271441,487
2022-01-22 03:25:09-05:00,7669,F9s8a7Cpiw5dw3a2aNFMofqwyDWNXvDLnSdJzoj1gRiV,GpKsQKJD79KBRWdCTkyi4zX7NaoCWsLUjrKxAwJB6o6s,True,378115,94528,562,281,281,3zqXX6kzhkbW3d4TwD2CNjMRwxTbREXySekvq37kfCNk,22503,217930,-195427,595
2022-01-22 03:25:09-05:00,7670,8JtUn4uue4WzrySwnDQ74qzzWaKsoo11MbMvRh1ePDJN,8iahKConWg6fyZrkoze5eeujyNHA26AybYBpHwUr76Cu,True,39538508,9884627,60631,30315,30316,3zqXX6kzhkbW3d4TwD2CNjMRwxTbREXySekvq37kfCNk,2425241,23513710,-21088469,613
2022-01-22 03:25:10-05:00,7671,HELPNUwAqTX7gfHS4cnJnqXFM6Rb156tYcpsitKR9iDu,3RdfgDvLvsdZG5Cf6hKiKMQMqfidyxHzjYvUx1FZpeHQ,True,7945465,1986366,10888,5444,5444,3zqXX6kzhkbW3d4TwD2CNjMRwxTbREXySekvq37kfCNk,435525,8325540,-7890015,548
2022-01-22 03:25:10-05:00,7672,Br1j5Ftafei7ysu5SmqVZSoRe4uS4qCPeKSPHg55pyiE,G8fc7QvXjfkgBFvAVUgJFQS3VaF1biL9rktBExGa87Ks,True,228553295,57138322,349059,174529,174530,3zqXX6kzhkbW3d4TwD2CNjMRwxTbREXySekvq37kfCNk,13962375,149866228,-135903853,610
2022-01-22 03:25:10-05:00,7673,5NVD6QvomTAD35yNxSFZw4DhF2hCtV8drkbnGhBVtK5y,3JzkyPnREvoFZLL9JZuuDEnee3nuKcrqY3xLuXsmHwRo,True,756391,189097,1123,561,562,3zqXX6kzhkbW3d4TwD2CNjMRwxTbREXySekvq37kfCNk,44925,696097,-651172,593
2022-01-22 03:25:10-05:00,7674,AvwHizRhHUSahmvSg4jmTUErc7vAFSmkRAEsiKhXfW1m,3UrWYx8y9N5o9GYneSe6zyyHRTZzxwvcipQfHHYh7tEs,True,46437,11609,64,32,32,3zqXX6kzhkbW3d4TwD2CNjMRwxTbREXySekvq37kfCNk,2574,35390,-32816,554
2022-01-22 03:25:13-05:00,7675,72woixtGAuGazCMfsYfYBYLP7FuRj8Fwz9fynFo4MCE4,5237BmWkKf58PBeTUEiu3Ld5uKXEe8wcrJRmCnUoWWku,True,12572451,3143112,19324,9662,9662,3uL2NSR2ZdDqCiKfzA5SwwpddAnit22DBJo6uvvz1rRs,772962,7070992,-6298030,614
2022-01-22 03:25:13-05:00,7676,4SQQdHTJUDv8taPXQRvEVJpUu91iCWQsv9su8tfehaQG,33CJXj1pmmatAofRvgt5in9E6SLEuy7tq4jqSwnUWP2A,True,508876233,127219058,728042,364021,364021,3zqXX6kzhkbW3d4TwD2CNjMRwxTbREXySekvq37kfCNk,29121689,496171961,-467050272,572
2022-01-22 03:25:13-05:00,7677,3c4tj9J8QwB3exFchWei43nBh5xsYRZxEUfayi3JvYgm,Fyw1TEEDKhLFo16qxDsttsAwSkrfzpDe8Dmm3atEeXyN,True,7253893,1813473,9783,4891,4892,3zqXX6kzhkbW3d4TwD2CNjMRwxTbREXySekvq37kfCNk,391335,5594190,-5202855,539
2022-01-22 03:25:17-05:00,7678,2sPD4f4d3CCeFSwSC5vAGS3YoTsTGypYKfDeoJczebop,HWCRpcq2sXqJL7Vi8MtipQDwGSViE73bUxS36ETmvnP2,True,3233710,808427,4395,2197,2198,3zqXX6kzhkbW3d4TwD2CNjMRwxTbREXySekvq37kfCNk,175816,1554291,-1378475,543
2022-01-22 03:25:20-05:00,7679,2pKygdXJnjZBFfrZgDasmHQQgw8LgycmBBRuaoCU72cz,DXsomQ5yWw2ceZMbaCVsSaE4hKm9W6Gy785JG75Aaz18,True,3148616,787154,4765,2382,2383,3zqXX6kzhkbW3d4TwD2CNjMRwxTbREXySekvq37kfCNk,190628,1546102,-1355474,605
2022-01-22 03:25:27-05:00,7680,2niazdR63iWLyZ3ABWZVAnJiEjVyDyLGo4jZ6wh3j2Zz,4RvU5UtyE5CqMStPciiCTdhYCdaUUfdKSYS5nkATs1qn,True,23721564,5930391,36980,18490,18490,4BnQKPLuE3DMTtxp8MjUBytgnhvxqq3ZTqZHTVZo4JJh,1479211,7750147,-6270936,623
2022-01-22 03:25:27-05:00,7681,6k9unyyhVTrGhAhBrFjgumRfBtKFRBrVaeWtYB56LgEg,3n9VYUH53fxmwFwdYKT9xAZYDzjodhMsJ5iGAoJTqCt4,True,23723702,5930925,37033,18516,18517,3zqXX6kzhkbW3d4TwD2CNjMRwxTbREXySekvq37kfCNk,1481329,7750127,-6268798,624
2022-01-22 03:25:48-05:00,7682,GHn96Ev7UmKJWqch3H3wzXpRT7qLg5FBuSBJAATVED1f,BXBSUddfz9MThXqk4517M7YVRDGdTm4pC6G4ipT69TMV,True,18884972,4721243,29039,14519,14520,3zqXX6kzhkbW3d4TwD2CNjMRwxTbREXySekvq37kfCNk,1161576,6150617,-4989041,615
2022-01-22 03:25:50-05:00,7683,7tDiadLeMrob7yD6R5SDskYn41tnQZVPjEc6W2vv6irK,AHZidccE9ERBcipuRQ2iGM9kHRpTnty7UNuYTFurvXB7,True,110674899,27668724,169905,84952,84953,3zqXX6kzhkbW3d4TwD2CNjMRwxTbREXySekvq37kfCNk,6796225,38537092,-31740867,614
2022-01-22 03:26:04-05:00,7684,CmvNNpdGVDGujBadaMmgKc8xgFfyV6G9PNEjD8zEND6L,EzmfinKBZ8TXoSugyTqdEdHWrHdTdpHQtc1TApfaNfDR,True,1574555419,393638854,2404673,1202336,1202337,3zqXX6kzhkbW3d4TwD2CNjMRwxTbREXySekvq37kfCNk,96186953,1193115936,-1096928983,610
2022-01-22 03:26:04-05:00,7685,D7XummfEc3NTK4qMvZegV3FrYuqc8mNgnQu3ujwemZtg,HHiRcecqzW7sGFTio7Ph6TYv3dGt64KWv4DEKgKm84fQ,True,100614,25153,155,77,78,3zqXX6kzhkbW3d4TwD2CNjMRwxTbREXySekvq37kfCNk,6236,92762,-86526,619
2022-01-22 03:26:21-05:00,7686,DvuRmJkfn6FQczUKgYeaSCqwy2NTMunuAKNrnmxMvnzS,7LpWTX9dgBtW75kfEoB5WuNsDwEdw5s8CYSHh3J4qagM,True,1137497,284374,1712,856,856,HfEnetJ7uBSmZWCjBNxdvv9HEC5nsW4wDV7wu6WnhWan,68487,1058491,-990004,602
2022-01-22 03:26:23-05:00,7687,C1rjefgArnN3nBn5Wu3yXij2wAyGWFtWdjGNLR9vpjmj,GsLCESLzYGZ1brEh8RJrZttE7hxcpSq7iUqdhwJhnDVB,True,2229208,557302,3419,1709,1710,3zqXX6kzhkbW3d4TwD2CNjMRwxTbREXySekvq37kfCNk,136788,1698194,-1561406,613
2022-01-22 03:26:23-05:00,7688,4hZG7dM716SxDagiFGwt1gSC99B2QK1emGLV9TJmmuR8,7vjfUWySkyx4Z5qAaRr2VWnVvxHHNsvPj1PirGNSjM6,True,3379461473,844865368,5055922,2527961,2527961,HfEnetJ7uBSmZWCjBNxdvv9HEC5nsW4wDV7wu6WnhWan,202236909,1838576127,-1636339218,598
2022-01-22 03:26:24-05:00,7689,7dmoK7QPki7R66SPQST4veUgVfnJbVToxxBPZveECiwK,4vh4REBDm5zBDmcjRCD9zNsny1HGneu7B2co4dSJNLL6,True,14135548,3533886,21568,10784,10784,3zqXX6kzhkbW3d4TwD2CNjMRwxTbREXySekvq37kfCNk,862721,11367556,-10504835,610
2022-01-22 03:26:25-05:00,7690,FV3G5EsSmyiLAAoREhgDXwvzbxoyDeq4Mwfj4jK5fJ7U,5nhzbJmm5JAwGDpTZoenkM1u3XtMY4uN7Qsm3vFGtRJE,True,1106770,276692,1668,834,834,4BnQKPLuE3DMTtxp8MjUBytgnhvxqq3ZTqZHTVZo4JJh,66748,565979,-499231,603
2022-01-22 03:26:28-05:00,7691,5hJereyPSCNUrGW7TdYXHKjhXMWTbGZzc2GF9MWksLJE,AUE3NpqaeamHGBKUVuKnUhnBb4Lzt7xWU1FHMu1Hq5dC,True,74879946,18719986,115979,57989,57990,4BnQKPLuE3DMTtxp8MjUBytgnhvxqq3ZTqZHTVZo4JJh,4639167,36350223,-31711056,619
2022-01-22 03:26:28-05:00,7692,98pwBGgiSDuwuas6WYW2hc9qUxfULwvNE34aixaxbxXY,BLrjKxekjThtJ9rKtQxs1Y4rZ225EE2Q16VkP9TkThyV,True,18438055,4609513,28527,14263,14264,4BnQKPLuE3DMTtxp8MjUBytgnhvxqq3ZTqZHTVZo4JJh,1141111,6157145,-5016034,618
2022-01-22 03:32:14-05:00,7693,3Xbsek5MsEGoWr3G9yhuohREr26B2vSQcjqXdspTFHta,2rPxkUiMo9wGDq8EvAiwY3ngRpKmL223cBWWNTYoBmFp,True,8782234,2195558,12974,6487,6487,HfEnetJ7uBSmZWCjBNxdvv9HEC5nsW4wDV7wu6WnhWan,518987,4133214,-3614227,590
2022-01-22 03:33:50-05:00,7694,4Enpw9W2mWGnNYagYQ8WW29RLSs4R5YX4qXCsVqMFeHn,9QwbJmm9QDKXyc4ZViq74BfS35zzewEceXQNnFCgczXu,True,635344275,158836068,970645,485322,485323,3zqXX6kzhkbW3d4TwD2CNjMRwxTbREXySekvq37kfCNk,38825816,194505942,-155680126,611
2022-01-22 03:43:06-05:00,7695,8trkirSQNdMmAcJdeswxs5cPjH8dD6U4eJtWiAdMsrDB,HaSzpQ45x2MipfN17U6jGBxX8tXboomVDhXNSrnEfLDr,True,148687,37171,232,116,116,HfEnetJ7uBSmZWCjBNxdvv9HEC5nsW4wDV7wu6WnhWan,9305,106745,-97440,625
2022-01-22 03:50:30-05:00,7696,7Dm3syN4P2mbBLFKyHTrtnSWY4hadGXiKB9EekTdT68S,HF97QS1dqarPMWgNmtcoaq6z3rpJnzAAAfc1PP4FwRhV,True,4348676,1087169,6791,3395,3396,HfEnetJ7uBSmZWCjBNxdvv9HEC5nsW4wDV7wu6WnhWan,271651,1330365,-1058714,624
2022-01-22 03:50:30-05:00,7697,BgNgALwBEuiumVgiXRmBZRnyFrr9QTDy2maHzsNwNHGf,ag35Ec2uFtqkarizCxFyhM2SPBuUwfmLRhAdFEWFCNa,True,4274402,1068600,6462,3231,3231,HfEnetJ7uBSmZWCjBNxdvv9HEC5nsW4wDV7wu6WnhWan,258511,1988138,-1729627,604
2022-01-22 03:51:10-05:00,7698,3JrhHRs4UkkuMoCrQAaAGKZQrWoU72zWArnDGxKFESzH,8yREVE3kMYB7UAwtUDnTDK3egXTuTsN4igtJ5yeHYkCP,True,62144076,15536019,97215,48607,48608,3zqXX6kzhkbW3d4TwD2CNjMRwxTbREXySekvq37kfCNk,3888619,26344715,-22456096,625
2022-01-22 03:52:14-05:00,7699,B5CTBTggmGFvGFSunjbB4C9tLKcYcULehmEiEXRihY2J,FX3ebF8P89rZBWfR74PDWUzxnLuDkUDgGcPYCBD5sMUG,True,39343590,9835897,59989,29994,29995,3zqXX6kzhkbW3d4TwD2CNjMRwxTbREXySekvq37kfCNk,2399566,20009538,-17609972,609
2022-01-22 03:52:14-05:00,7700,HwosLQgDY1xtHQRQ4hzroPQHFWssPzTj5vRkP37FcviB,HKTNEYNXrephNkH7apbobK4mcQXcNayQA4W1NgM6sLr8,True,2792093,698023,4354,2177,2177,3zqXX6kzhkbW3d4TwD2CNjMRwxTbREXySekvq37kfCNk,174189,1533635,-1359446,623
2022-01-22 03:52:43-05:00,7701,243SAnGxchCVB1LQAUF4SsozR86yDwEdg2QQpbWGsMYe,5u8sNkb2oEQjUXJAB3yGStmv3Uwz16gBgExBo5myVK4b,True,1612134,403033,2513,1256,1257,3zqXX6kzhkbW3d4TwD2CNjMRwxTbREXySekvq37kfCNk,100538,864808,-764270,623
2022-01-22 03:55:36-05:00,7702,4Enpw9W2mWGnNYagYQ8WW29RLSs4R5YX4qXCsVqMFeHn,9QwbJmm9QDKXyc4ZViq74BfS35zzewEceXQNnFCgczXu,True,467486949,116871737,720847,360423,360424,3zqXX6kzhkbW3d4TwD2CNjMRwxTbREXySekvq37kfCNk,28833913,154623213,-125789300,616
2022-01-22 03:55:36-05:00,7703,25NUDrsdLhS3fcARLiTMbbmZHvvzvzPj9xAdoN8sJBN3,8baNRGHfYRcLdhbHNuH72ofAWM9UojqhTMLnbBayzGnW,True,4823744,1205936,7322,3661,3661,3zqXX6kzhkbW3d4TwD2CNjMRwxTbREXySekvq37kfCNk,292894,2647833,-2354939,607
2022-01-22 03:57:45-05:00,7704,ARB1q7bNcQ7grwFEZC6nk9Pfrrg7yZ2WK8zVqq5CEE8F,53e8mUYrWzQnCm9XQyp18CL9owyPqJcYyxZANYhRypPx,True,34512757,8628189,53085,26542,26543,3zqXX6kzhkbW3d4TwD2CNjMRwxTbREXySekvq37kfCNk,2123435,17773417,-15649982,615
2022-01-22 03:57:46-05:00,7705,9aQrdyfAvcBbBj7iKQB17eAS4zBqymdd3kzkTkuRhdLU,BDHhukMF5rALuSwCxaw8g73m2MN4oX1D4e7uNmx3SiVt,True,46613174,11653293,72284,36142,36142,3zqXX6kzhkbW3d4TwD2CNjMRwxTbREXySekvq37kfCNk,2891378,18526038,-15634660,620
2022-01-22 03:57:49-05:00,7706,EF6H6aW1p3qcAtiLFU9rbFYfsKfD683meHXDw8hLdaZK,8vfJbpnK7SQcjpEBCzZJRW8JosNbsmTeJ2YXZCbM225c,True,14182384,3545596,21823,10911,10912,HfEnetJ7uBSmZWCjBNxdvv9HEC5nsW4wDV7wu6WnhWan,872941,8219051,-7346110,615
2022-01-22 03:57:50-05:00,7707,GXSysysoV8Z4xBrQsaKUsSrpoWeTTUsbFmgfZDaQu4ZM,6FJyraiLgG3tb9B7pi4YFsJNtRVBNaghnm1ajzneVv7b,True,331048908,82762227,501955,250977,250978,3zqXX6kzhkbW3d4TwD2CNjMRwxTbREXySekvq37kfCNk,20078224,135782509,-115704285,606
2022-01-22 03:59:53-05:00,7708,2r64Rnbu3ZjmJTHHUxxV9TWWGzwpAepA4ySbtKivBXCj,6RRzx6KLkMiFK9JSuznrSJGiPgkHwatBSskudHqbfKJ5,True,256887695,64221923,401106,200553,200553,HfEnetJ7uBSmZWCjBNxdvv9HEC5nsW4wDV7wu6WnhWan,16044242,160062275,-144018033,624
2022-01-22 04:06:01-05:00,7709,HELPNUwAqTX7gfHS4cnJnqXFM6Rb156tYcpsitKR9iDu,3RdfgDvLvsdZG5Cf6hKiKMQMqfidyxHzjYvUx1FZpeHQ,True,5910977,1477744,9216,4608,4608,HfEnetJ7uBSmZWCjBNxdvv9HEC5nsW4wDV7wu6WnhWan,368649,6334285,-5965636,623
2022-01-22 04:06:01-05:00,7710,2sPD4f4d3CCeFSwSC5vAGS3YoTsTGypYKfDeoJczebop,HWCRpcq2sXqJL7Vi8MtipQDwGSViE73bUxS36ETmvnP2,True,2405742,601435,3716,1858,1858,3zqXX6kzhkbW3d4TwD2CNjMRwxTbREXySekvq37kfCNk,148679,1202077,-1053398,618
2022-01-22 04:06:03-05:00,7711,DC4UVUDFWL3gVtgkX9hPtFgtxaA8DH5p94i4k9U3wyWv,3HCWqVvQQfRgSKitsTjGTduJ82ointZUSNtj13uea4kD,True,23476056,5869014,35868,17934,17934,HfEnetJ7uBSmZWCjBNxdvv9HEC5nsW4wDV7wu6WnhWan,1434730,17941674,-16506944,611
2022-01-22 04:06:07-05:00,7712,3c4tj9J8QwB3exFchWei43nBh5xsYRZxEUfayi3JvYgm,Fyw1TEEDKhLFo16qxDsttsAwSkrfzpDe8Dmm3atEeXyN,True,5396579,1349144,8263,4131,4132,3zqXX6kzhkbW3d4TwD2CNjMRwxTbREXySekvq37kfCNk,330530,4276514,-3945984,612
2022-01-22 04:10:59-05:00,7713,AUH6YGBV8tDVX1E1WTo92Mubfx1DGsqfGeyUBqxo4fSr,33QZgMwmW32WuvmxD8XNbmF9ea88bLe3YTtNwHV73Wwu,True,12711982,3177995,19774,9887,9887,3uL2NSR2ZdDqCiKfzA5SwwpddAnit22DBJo6uvvz1rRs,790996,7591862,-6800866,622
2022-01-22 04:10:59-05:00,7714,8kJu5aqVSmW8FSZR9h6F75ftn9V2U9uMLBEKeqRaC855,FhVHByujkvwwtjTVpZ4mqSUqoMoBgeLUc5H7rbz3FgAt,True,5375384,1343846,8186,4093,4093,3uL2NSR2ZdDqCiKfzA5SwwpddAnit22DBJo6uvvz1rRs,327479,4725756,-4398277,609
2022-01-22 04:10:59-05:00,7715,D9VKhnfLLCrntDGFYSfoxFaY76VnHmYZ1ZbyFXdKdibz,2hRCRH2pMDyQGYcXHa8Y6BZo6FbcGZf5VJC1v8Bp6tGa,True,5593488,1398372,8533,4266,4267,3uL2NSR2ZdDqCiKfzA5SwwpddAnit22DBJo6uvvz1rRs,341347,3593490,-3252143,610
2022-01-22 04:10:59-05:00,7716,FnAT8HKGgisYfeAbxKU2gSbCp8KbZHULRpaJX1NVijHy,2u637Crc2QzfSJmCnRNqeib3aZQVn4NGncpgM3Ph6jvm,True,2085896,521474,3207,1603,1604,3uL2NSR2ZdDqCiKfzA5SwwpddAnit22DBJo6uvvz1rRs,128313,1225844,-1097531,615
2022-01-22 04:10:59-05:00,7717,9KD2AifD5wFD4QkHYuawXbJgLWHrfj2QPF3fT8jhGVA5,Ga9gAqmkuHbqrr31sUFPqa1xa5WNxLWJWGPUaMxQqLdj,True,59225,14806,91,45,46,3uL2NSR2ZdDqCiKfzA5SwwpddAnit22DBJo6uvvz1rRs,3667,52649,-48982,619
2022-01-22 04:11:03-05:00,7718,72L76qDRMK3M7X52zuuB9GVyvFFLDBZwFMpVjWjghXzA,4m2ZVuemUctu1edv4YJVAcjXzKwpbCmBujzoUmLDeA7h,True,21557312,5389328,33247,16623,16624,3zqXX6kzhkbW3d4TwD2CNjMRwxTbREXySekvq37kfCNk,1329891,8878116,-7548225,616
2022-01-22 04:11:03-05:00,7719,B2hN3Lt5pFbUyfEUc5s48hkxUJ5rr2SeFxgdGdQ8pDD2,7bZJCCud253j9g411HQUDXUAADcwd5yJWznoTChBdB2H,True,369659128,92414782,557191,278595,278596,3zqXX6kzhkbW3d4TwD2CNjMRwxTbREXySekvq37kfCNk,22287663,123287111,-100999448,602
2022-01-22 04:11:03-05:00,7720,CpxZ136k95cVjGqkJnNpDZKUgrJrfg8HrFDZPL6BgsK4,Fo7HtcrneUTsnGqygsxPQ63G5rayYodYT65xP6B6HusH,True,94725869,23681467,145062,72531,72531,3zqXX6kzhkbW3d4TwD2CNjMRwxTbREXySekvq37kfCNk,5802499,30350914,-24548415,612
2022-01-22 04:11:03-05:00,7721,8eTH6eJyyVeMno3UQkffeBg32xofKsQfkhLhXdtaf87s,BCFC7CPXrQPsUfJb2eYSht8GhaApWHpc49AeCXqaYq13,True,13608771,3402192,20474,10237,10237,3zqXX6kzhkbW3d4TwD2CNjMRwxTbREXySekvq37kfCNk,818981,5575237,-4756256,601
2022-01-22 04:11:03-05:00,7722,6N4PNbueNmkCECF8ojw5R6wGtxComzgGED179GiJaLjQ,AL8eRDEo8yCvD4n4kvruEuZzXBXrJrEiBt9SQwCcDPYd,True,281701946,70425486,423451,211725,211726,3zqXX6kzhkbW3d4TwD2CNjMRwxTbREXySekvq37kfCNk,16938074,113333055,-96394981,601
2022-01-22 04:11:03-05:00,7723,cG5VSSaBpjNdRLMQT7dmotpcWRTfdmJZYdWsrzNzRTE,5RESxV6aZenjAdaqw1jxoYSGttpLrNuZiRJy2WeLAVJv,True,120351107,30087776,186008,93004,93004,3zqXX6kzhkbW3d4TwD2CNjMRwxTbREXySekvq37kfCNk,7440352,70359964,-62919612,618
2022-01-22 04:11:03-05:00,7724,BRK2EePsnQq54oaD2Ua4cxxKhdgVS2Kx57JKXCrBkeg7,7yskmLp2oA9qN38G7NBqVGggzs4ZoQ63HD4EnMVweMyY,True,597983494,149495873,933319,466659,466660,3zqXX6kzhkbW3d4TwD2CNjMRwxTbREXySekvq37kfCNk,37332797,239561928,-202229131,624
2022-01-22 04:11:49-05:00,7725,FsMiJiJZibohKoV5QRisWCjzuFd86xSxFb4m73AQmu93,7p3TSKBaG9SV2YNDnhutQKacPKpTTmgsEfzmK51t6sYb,True,12696129,3174032,19796,9898,9898,3zqXX6kzhkbW3d4TwD2CNjMRwxTbREXySekvq37kfCNk,791871,7475322,-6683451,623
2022-01-22 04:11:49-05:00,7726,H3394S5wdbwXB4scjGAY8NsXxCdGy1Xebct18s42FM1K,Hz84L1EquzhCvBJP75ScKug46hYGdNMVNH16AdG4y5D8,True,2856794,714198,4451,2225,2226,3zqXX6kzhkbW3d4TwD2CNjMRwxTbREXySekvq37kfCNk,178057,1887382,-1709325,623
2022-01-22 04:11:52-05:00,7727,36ByQojnxEckWdQTjqHfxKqCx9yjqWQsPsZyqaN72UWR,AZoirtS1fjX61agRM64tqThVinnJTh3BWgiHyNHPTgZP,True,36142,9035,56,28,28,HfEnetJ7uBSmZWCjBNxdvv9HEC5nsW4wDV7wu6WnhWan,2258,31548,-29290,624
2022-01-22 04:13:04-05:00,7728,A36aouot1oFLUtswuBUM4EVcis9chKaSJu53MRoPDjab,33U9gpq1RRFMGWDrWa3ezXXkwgBewdAS6QGgGVPtGvqb,True,16371755,4092938,25604,12802,12802,3zqXX6kzhkbW3d4TwD2CNjMRwxTbREXySekvq37kfCNk,1024165,9602641,-8578476,625
2022-01-22 04:13:07-05:00,7729,3VdSA9CED9f5swRwHX2U15U7J6Muaq8VPnCNy9CaGDHe,2YYstfnfdYic5NWmEbcUEHpccNUVd1EhuCkExvMsoMk8,True,304728,76182,472,236,236,3zqXX6kzhkbW3d4TwD2CNjMRwxTbREXySekvq37kfCNk,18880,268763,-249883,619
2022-01-22 04:13:09-05:00,7730,EitU96ThqHErybDn2j1NY6JHkqV1R3mWM1uWH7wYKr1T,2p9eYbLyBqXrhHtRKp1jJb7VGjCmb4LkA6kzqLr1ijet,True,7091596,1772899,11081,5540,5541,3zqXX6kzhkbW3d4TwD2CNjMRwxTbREXySekvq37kfCNk,443273,3942620,-3499347,625
2022-01-22 04:13:09-05:00,7731,4MSyrHopFkuaCEEvLAUV9cJfVre6cLAx5sJF5LEMSCTX,6HhLHoswuDKrcixShWCDcquW6PgmbS5FidEnkM3bwuJQ,True,3125170,781292,4862,2431,2431,3zqXX6kzhkbW3d4TwD2CNjMRwxTbREXySekvq37kfCNk,194500,1187341,-992841,622
2022-01-22 04:13:21-05:00,7732,7ptPfZnqDCvTWotn8wPGyzERTJYLBgk47j7qf8Ciq941,AfAGcFqFFPi6LCQXydgsPWidN35c7NbhBa7RLEaDQQCu,False,1088778,1088778,54348,2717,51631,3zqXX6kzhkbW3d4TwD2CNjMRwxTbREXySekvq37kfCNk,54348,541545,-487197,499
2022-01-22 04:14:28-05:00,7733,H1Z83zVoskNuBvYao1FjdLfETfhPpQFQUkniJfGxbaNz,EVqbBRV6Zy1tPLRevxpAykp8Mvv6tDZVTc4RmCKw4Gq1,True,66633962,16658490,102179,51089,51090,HfEnetJ7uBSmZWCjBNxdvv9HEC5nsW4wDV7wu6WnhWan,4087176,48197308,-44110132,613
2022-01-22 04:15:15-05:00,7734,8T4WK27RvWVGqPuNqY6whk1fmU4vd5qaUQPZG1GJ79bh,DvSz7knS8N3K7L6JhQf1s4mJSyxB8uJXNQXtyjJn8QRL,True,4122132,1030532,6429,3214,3215,3zqXX6kzhkbW3d4TwD2CNjMRwxTbREXySekvq37kfCNk,257187,3138527,-2881340,623
2022-01-22 04:15:15-05:00,7735,5kwvkEtRFFD84j4ntVgxkacadgJaFvQ9JLhJqzLR7Y3G,GpMMkTv9T7y8DTiizuoJUsWvnSk3GSxADjRMGyYpryxm,True,1428088,357022,2234,1117,1117,3zqXX6kzhkbW3d4TwD2CNjMRwxTbREXySekvq37kfCNk,89382,814567,-725185,625
2022-01-22 04:19:39-05:00,7736,BgNgALwBEuiumVgiXRmBZRnyFrr9QTDy2maHzsNwNHGf,ag35Ec2uFtqkarizCxFyhM2SPBuUwfmLRhAdFEWFCNa,True,3151643,787910,4793,2396,2397,3zqXX6kzhkbW3d4TwD2CNjMRwxTbREXySekvq37kfCNk,191737,1543117,-1351380,608
2022-01-22 04:20:14-05:00,7737,7Dm3syN4P2mbBLFKyHTrtnSWY4hadGXiKB9EekTdT68S,HF97QS1dqarPMWgNmtcoaq6z3rpJnzAAAfc1PP4FwRhV,True,3196400,799100,4837,2418,2419,HfEnetJ7uBSmZWCjBNxdvv9HEC5nsW4wDV7wu6WnhWan,193493,1052637,-859144,605
2022-01-22 04:21:24-05:00,7738,25NUDrsdLhS3fcARLiTMbbmZHvvzvzPj9xAdoN8sJBN3,8baNRGHfYRcLdhbHNuH72ofAWM9UojqhTMLnbBayzGnW,True,3560539,890134,5532,2766,2766,4BnQKPLuE3DMTtxp8MjUBytgnhvxqq3ZTqZHTVZo4JJh,221284,2044758,-1823474,621
2022-01-22 04:21:24-05:00,7739,B5CTBTggmGFvGFSunjbB4C9tLKcYcULehmEiEXRihY2J,FX3ebF8P89rZBWfR74PDWUzxnLuDkUDgGcPYCBD5sMUG,True,29020082,7255020,45221,22610,22611,HfEnetJ7uBSmZWCjBNxdvv9HEC5nsW4wDV7wu6WnhWan,1808873,15503989,-13695116,623
2022-01-22 04:21:24-05:00,7740,243SAnGxchCVB1LQAUF4SsozR86yDwEdg2QQpbWGsMYe,5u8sNkb2oEQjUXJAB3yGStmv3Uwz16gBgExBo5myVK4b,True,1186945,296736,1838,919,919,3uL2NSR2ZdDqCiKfzA5SwwpddAnit22DBJo6uvvz1rRs,73530,668889,-595359,619
2022-01-22 04:22:47-05:00,7741,4Enpw9W2mWGnNYagYQ8WW29RLSs4R5YX4qXCsVqMFeHn,9QwbJmm9QDKXyc4ZViq74BfS35zzewEceXQNnFCgczXu,True,344643009,86160752,536514,268257,268257,HfEnetJ7uBSmZWCjBNxdvv9HEC5nsW4wDV7wu6WnhWan,21460573,121779179,-100318606,622
2022-01-22 04:24:36-05:00,7742,BJaaH1SK1pF2kZQzmYpLFfDtm52CR9a5rd39RAPtLe8q,HUsT5FVxaisdnCvG1BQxX6zffjfL2Rwx5mMo5y8SDV7e,True,2379519,594878,3679,1839,1840,HfEnetJ7uBSmZWCjBNxdvv9HEC5nsW4wDV7wu6WnhWan,147165,1272892,-1125727,618
2022-01-22 04:28:49-05:00,7743,3XZLp6JyrQYnufa1obczXqmK6cNR29ZMW1FdCYbWNTCP,8kUTi1Prio14m9LjCj6Mari6pXwJTYkE1mp21LMn235p,False,62553,62553,3094,154,2940,3zqXX6kzhkbW3d4TwD2CNjMRwxTbREXySekvq37kfCNk,3094,28776,-25682,494
2022-01-22 04:29:32-05:00,7744,AvwHizRhHUSahmvSg4jmTUErc7vAFSmkRAEsiKhXfW1m,3UrWYx8y9N5o9GYneSe6zyyHRTZzxwvcipQfHHYh7tEs,True,34518,8629,53,26,27,4BnQKPLuE3DMTtxp8MjUBytgnhvxqq3ZTqZHTVZo4JJh,2155,27078,-24923,624
2022-01-22 04:30:21-05:00,7745,4SQQdHTJUDv8taPXQRvEVJpUu91iCWQsv9su8tfehaQG,33CJXj1pmmatAofRvgt5in9E6SLEuy7tq4jqSwnUWP2A,True,377037009,94259252,581741,290870,290871,HfEnetJ7uBSmZWCjBNxdvv9HEC5nsW4wDV7wu6WnhWan,23269672,378183430,-354913758,617
2022-01-22 04:31:04-05:00,7746,FtF3PVw8YNJseWPMcA2GEuQZ6nni1mq5kYPa2LrSzfkW,4yr1TM2dXrBvLNMpSaoryuGU2P8D3WG1ZCkvVzWFiQRH,True,4735387508,1183846875,7398900,3699450,3699450,HfEnetJ7uBSmZWCjBNxdvv9HEC5nsW4wDV7wu6WnhWan,295956038,1975723309,-1679767271,624
2022-01-22 04:33:48-05:00,7747,GxFxvEUdWofneMmVvhCSScH9V6Zia5WJ2J9q6CpPnaq3,ATLykiHDii3Lw53MoZXwqu1FbBNPJbVNVGe2SoQMjVmY,True,42479,10619,65,32,33,4BnQKPLuE3DMTtxp8MjUBytgnhvxqq3ZTqZHTVZo4JJh,2629,40410,-37781,618
2022-01-22 04:33:48-05:00,7748,7feC64HZfQpniey2iXsMMgQXnfcunJus74DiKDeKaEUw,GstsCxAiBBEUrXNkvZZ9Sg4vNK916PsKe2Mx6e4M6dU7,True,100945,25236,154,77,77,HfEnetJ7uBSmZWCjBNxdvv9HEC5nsW4wDV7wu6WnhWan,6168,74164,-67996,611
2022-01-22 04:33:48-05:00,7749,5NVD6QvomTAD35yNxSFZw4DhF2hCtV8drkbnGhBVtK5y,3JzkyPnREvoFZLL9JZuuDEnee3nuKcrqY3xLuXsmHwRo,True,557991,139497,843,421,422,4BnQKPLuE3DMTtxp8MjUBytgnhvxqq3ZTqZHTVZo4JJh,33751,531435,-497684,604
2022-01-22 04:33:48-05:00,7750,2pKygdXJnjZBFfrZgDasmHQQgw8LgycmBBRuaoCU72cz,DXsomQ5yWw2ceZMbaCVsSaE4hKm9W6Gy785JG75Aaz18,True,2322774,580693,3601,1800,1801,4BnQKPLuE3DMTtxp8MjUBytgnhvxqq3ZTqZHTVZo4JJh,144058,1199352,-1055294,620
2022-01-22 04:33:48-05:00,7751,GjQQ2fQ7mrGjWZwjVYFUKp9NM1LmfkhEo675ovU5SPa8,ECgVUMRY5nB4MALs5drDyipF7YohCPuJpj2UegCs7HMn,True,211060,52765,316,158,158,HfEnetJ7uBSmZWCjBNxdvv9HEC5nsW4wDV7wu6WnhWan,12647,182744,-170097,599
2022-01-22 04:33:50-05:00,7752,F9s8a7Cpiw5dw3a2aNFMofqwyDWNXvDLnSdJzoj1gRiV,GpKsQKJD79KBRWdCTkyi4zX7NaoCWsLUjrKxAwJB6o6s,True,278935,69733,422,211,211,HfEnetJ7uBSmZWCjBNxdvv9HEC5nsW4wDV7wu6WnhWan,16915,168138,-151223,606
2022-01-22 04:33:50-05:00,7753,3FF2rhr1RuT7UR7MmmGtrhfYbh6kbc5UXq51KmqFLZnq,AEmSYLt1dQ8suLugC4Lcw4kF3dG9GYcEfX54hEAKfmv5,True,2579913,644978,3988,1994,1994,3zqXX6kzhkbW3d4TwD2CNjMRwxTbREXySekvq37kfCNk,159552,1333132,-1173580,618
2022-01-22 04:34:33-05:00,7754,8JtUn4uue4WzrySwnDQ74qzzWaKsoo11MbMvRh1ePDJN,8iahKConWg6fyZrkoze5eeujyNHA26AybYBpHwUr76Cu,True,29074556,7268639,43653,21826,21827,HfEnetJ7uBSmZWCjBNxdvv9HEC5nsW4wDV7wu6WnhWan,1746142,18141848,-16395706,600
2022-01-22 04:34:35-05:00,7755,72woixtGAuGazCMfsYfYBYLP7FuRj8Fwz9fynFo4MCE4,5237BmWkKf58PBeTUEiu3Ld5uKXEe8wcrJRmCnUoWWku,True,9245136,2311284,13924,6962,6962,4BnQKPLuE3DMTtxp8MjUBytgnhvxqq3ZTqZHTVZo4JJh,556989,5464718,-4907729,602
2022-01-22 04:35:13-05:00,7756,DvuRmJkfn6FQczUKgYeaSCqwy2NTMunuAKNrnmxMvnzS,7LpWTX9dgBtW75kfEoB5WuNsDwEdw5s8CYSHh3J4qagM,True,839291,209822,1295,647,648,3zqXX6kzhkbW3d4TwD2CNjMRwxTbREXySekvq37kfCNk,51810,808146,-756336,617
2022-01-22 04:35:15-05:00,7757,4hZG7dM716SxDagiFGwt1gSC99B2QK1emGLV9TJmmuR8,7vjfUWySkyx4Z5qAaRr2VWnVvxHHNsvPj1PirGNSjM6,True,2493772234,623443058,3824726,1912363,1912363,3zqXX6kzhkbW3d4TwD2CNjMRwxTbREXySekvq37kfCNk,152989055,1421268936,-1268279881,613
2022-01-22 04:35:15-05:00,7758,FV3G5EsSmyiLAAoREhgDXwvzbxoyDeq4Mwfj4jK5fJ7U,5nhzbJmm5JAwGDpTZoenkM1u3XtMY4uN7Qsm3vFGtRJE,True,816642,204160,1263,631,632,3zqXX6kzhkbW3d4TwD2CNjMRwxTbREXySekvq37kfCNk,50542,438402,-387860,618
2022-01-22 04:35:15-05:00,7759,D7XummfEc3NTK4qMvZegV3FrYuqc8mNgnQu3ujwemZtg,HHiRcecqzW7sGFTio7Ph6TYv3dGt64KWv4DEKgKm84fQ,True,73997,18499,112,56,56,4BnQKPLuE3DMTtxp8MjUBytgnhvxqq3ZTqZHTVZo4JJh,4518,70878,-66360,610
2022-01-22 04:35:17-05:00,7760,CmvNNpdGVDGujBadaMmgKc8xgFfyV6G9PNEjD8zEND6L,EzmfinKBZ8TXoSugyTqdEdHWrHdTdpHQtc1TApfaNfDR,True,1158002682,289500670,1732610,866305,866305,3zqXX6kzhkbW3d4TwD2CNjMRwxTbREXySekvq37kfCNk,69304421,914964987,-845660566,598
2022-01-22 01:18:29-05:00,6737,zLTuMVfVswjMkhyvjaXnvjcKXv5xNk3iSWSjRGpVqXf,J3D8NHUJCiSjvFYfJ5Es4YDhF1KcPZWRUmCQ5L92t8eB,True,26189945,6547486,40852,20426,20426,3zqXX6kzhkbW3d4TwD2CNjMRwxTbREXySekvq37kfCNk,1634098,7121695,-5487597,623
2022-01-22 01:18:37-05:00,6738,8xvLGVeDmhVYQhN2ZpWkVG9jCrukRsNQ4926a4TMiZqa,9ciBySSjvADwp47WkETiFWZKVTFL8Hf1XvK7aSxhcgQS,True,1527713,381928,2383,1191,1192,DddJ7EWCmYEEZETCBNgAUSg81Ls6fZtiAaY5ekJ5sXx1,95330,1028189,-932859,624
2022-01-22 01:20:32-05:00,6739,2AAWghW6BUAFBtF3R6hB9uoqMc5oUDkU8FTd2JrXKema,798cfEUZ2YhXwNTNjXMS4Z2J8gAHaK4zZwpMkq2HzWWM,True,60427204135,15106801033,92809271,46404635,46404636,4BnQKPLuE3DMTtxp8MjUBytgnhvxqq3ZTqZHTVZo4JJh,3712370859,26742020708,-23029649849,614
2022-01-22 01:20:32-05:00,6740,Ht2oWgWWVsA4u5fwp8o8dwgUjoGSRDF2gAwQPDXCwKfZ,8pYWhoNFpmDYuawZub9rd5qkSsAJuPGeJwoa23YyVVym,True,2328123,582030,3279,1639,1640,DddJ7EWCmYEEZETCBNgAUSg81Ls6fZtiAaY5ekJ5sXx1,131183,2089544,-1958361,563
2022-01-22 01:20:32-05:00,6741,5JShzaRBGGeGTPfweCcNaxvkb6A1deQcAcFcxWz8WbW4,F5JEUUaTHnsxeH6jnvyHgXjuMHdjjnygu6aXHk3qLFqh,False,42449033,42449033,1918992,95949,1823043,HfEnetJ7uBSmZWCjBNxdvv9HEC5nsW4wDV7wu6WnhWan,1918992,34462429,-32543437,452
2022-01-22 01:20:34-05:00,6742,87R8o8xLjHw2GpunYkm7pX7uJ8hjM4B1y4Qm7aQf6Yh4,48aSVPQoFYdncF5NtJ114urbdTzVjTgYLgPzMfpJbZB3,True,2748748,687187,3532,1766,1766,DddJ7EWCmYEEZETCBNgAUSg81Ls6fZtiAaY5ekJ5sXx1,141314,3664479,-3523165,514
2022-01-22 01:20:35-05:00,6743,pgzvXpnUYiY7hLrfjmwScqLd8oj9vYcXpFvpm4y4JvG,GdqdQgoyBAFuXdbvoZyDhB3jyqJzVo4nkGh7EPFxkBF2,True,91159,22789,132,66,66,DddJ7EWCmYEEZETCBNgAUSg81Ls6fZtiAaY5ekJ5sXx1,5283,116868,-111585,579
2022-01-22 01:20:38-05:00,6744,AaMCg49sJwNtdB5wHACg15TYAzzJXy8xtG4zuVXhKiVE,HbDYqDa9bewGPvsiaHRM9HmEvh1scPaUaGvqog66gYir,False,9447685,9447685,415710,20785,394925,DddJ7EWCmYEEZETCBNgAUSg81Ls6fZtiAaY5ekJ5sXx1,415710,4314629,-3898919,440
2022-01-22 01:20:38-05:00,6745,BzSJ77zKaqtBk2cEL1XqFL97zTXXMRHmxtkgtXwCc3C,2g4KXTwy2MPSRQ2khNp1o1rn7CradEr9H4ySYKDoSWN9,False,471180,471180,21823,1091,20732,DddJ7EWCmYEEZETCBNgAUSg81Ls6fZtiAaY5ekJ5sXx1,21823,642699,-620876,463
2022-01-22 01:20:41-05:00,6746,7T5Z5qX5petKARUrhAuB7xaWJPTKrcQTx9n63cM85Pvz,Hw2gx2SBkEj2SA4RE2hWETJNYmLUBqSZirAaRpuvMgH1,True,892458,223114,1178,589,589,DddJ7EWCmYEEZETCBNgAUSg81Ls6fZtiAaY5ekJ5sXx1,47137,558118,-510981,528
2022-01-22 01:20:41-05:00,6747,3qnPsgqW11AcDEmyjmJquPcPLyE3EdJQuVLJ5kinDrd3,86rZadBB7emKio76aFTahpbrFtxd9tqZ4Mxgzaavq2xU,True,6837,1709,10,5,5,4BnQKPLuE3DMTtxp8MjUBytgnhvxqq3ZTqZHTVZo4JJh,422,5006,-4584,617
2022-01-22 01:20:41-05:00,6748,6gFbxvPafnpqZjWW94MMmL8mGp2FHZGqoJC5fWqgwNxS,C6WcDycp3Ff3xYmb81i8JbD39Xv1o5G2AdtPs1FdXtr4,True,98935034,24733758,131278,65639,65639,DddJ7EWCmYEEZETCBNgAUSg81Ls6fZtiAaY5ekJ5sXx1,5251155,41459518,-36208363,530
2022-01-22 01:20:41-05:00,6749,4cKgCTttVp8pzJnp43PP7uLLUXNcU7YGPJ3cCGHaUFe7,BBQqjwTpVEgpDzMk4wDDH8rCjaSxCRPWVhtFxERSujTD,True,1749986,437496,2616,1308,1308,DddJ7EWCmYEEZETCBNgAUSg81Ls6fZtiAaY5ekJ5sXx1,104653,1268607,-1163954,598
2022-01-22 01:20:41-05:00,6750,4mB2DVbQVqVk535v98Cj8SPNg1tTc3DFyY2Q7VBbY645,HXo255k3RgsTGsc4hiP6ZTXUspBTqJ37duQa5eK7tqp3,True,54956522,13739130,68907,34453,34454,DddJ7EWCmYEEZETCBNgAUSg81Ls6fZtiAaY5ekJ5sXx1,2756297,32484620,-29728323,501
2022-01-22 01:20:42-05:00,6751,8627qmFevGS1LSDyCgoJjbURcf8CjVFCcxE7U9mWVP5f,3sgQuNcZuGV59Q9apxSBQcV1XAa6og6xa8FLpumvN7iZ,False,2314,2314,101,5,96,4BnQKPLuE3DMTtxp8MjUBytgnhvxqq3ZTqZHTVZo4JJh,101,1618,-1517,436
2022-01-22 01:20:42-05:00,6752,6osqTNxgZv1Y1EjnVR7D1G4cywof1CrWswj87tAnktWV,Fah93R9W7SFuajFif4AbXDdxouWA5rrLz29vzVRGsMxv,True,536972,134243,708,354,354,4BnQKPLuE3DMTtxp8MjUBytgnhvxqq3ZTqZHTVZo4JJh,28329,673947,-645618,527
2022-01-22 01:20:42-05:00,6753,Gs3WP18hbzNpbBgiU39e6tfkggfCKRyNqPqJQcthuHFD,4XAY25YUma6gUdG2GdbXeivum3t21g93ZagfWGTZYkWZ,True,1093996,273498,1565,782,783,DddJ7EWCmYEEZETCBNgAUSg81Ls6fZtiAaY5ekJ5sXx1,62636,771401,-708765,572
2022-01-22 01:20:42-05:00,6754,HSZrdquqBs1gWQGSBcLGs4aa4ox27rLHh6KKmdHrgrVs,DywbuaDt997DQA1GT9GsLL8ML73CxQgHwMLw2MyG8m7M,True,682514,170628,906,453,453,4BnQKPLuE3DMTtxp8MjUBytgnhvxqq3ZTqZHTVZo4JJh,36259,241670,-205411,531
2022-01-22 01:20:42-05:00,6755,8hpAXzimCw2bTwLXoRFAbqNW8qoj5VV3JDYCuJwqHpHm,DkfsL2M7oRBX6grAfy15C4urwL6ToMJ7TWJEFAGhWjYX,True,397485,99371,543,271,272,DddJ7EWCmYEEZETCBNgAUSg81Ls6fZtiAaY5ekJ5sXx1,21746,186838,-165092,547
2022-01-22 01:20:42-05:00,6756,AATMHH4e4B6SL9bThnXGktzWuqWkPdx3JbRXk8HwkbPW,6F3u2yLx7P9gtpAAXASx7uF8xNyVBgJiKosMKUrgpicA,True,10760047,2690011,15125,7562,7563,4BnQKPLuE3DMTtxp8MjUBytgnhvxqq3ZTqZHTVZo4JJh,605010,7705846,-7100836,562
2022-01-22 01:20:42-05:00,6757,5sN3cfz4hZjwy2HkAStKWeL8wHhdbkW8F7USzwCzmggh,Fme7U7QY92biAsV3RR2Fj7rJPnpdcov13mmFhVDFuyYG,True,30950367,7737591,47208,23604,23604,DddJ7EWCmYEEZETCBNgAUSg81Ls6fZtiAaY5ekJ5sXx1,1888329,21387771,-19499442,610
2022-01-22 01:20:42-05:00,6758,6xikA6d7sjCBnSfqkFwrL4nPrtQUNWdRhXB7i1AccnxC,G8t7u2R9qjRfdTdULs74v3nVrTM2WeKvc4dK4FFAvuG1,True,1609376,402344,2196,1098,1098,4BnQKPLuE3DMTtxp8MjUBytgnhvxqq3ZTqZHTVZo4JJh,87855,773544,-685689,545
2022-01-22 01:20:42-05:00,6759,3EmGvYu72cR4Ta3wLA5HKZBEqgfChCyiRanwj5hGLJXc,6NEWPFaKi5uLsrj4n6RM1DBhQTcGFE9TwYeJ12pC7yyp,True,1716,429,2,1,1,4BnQKPLuE3DMTtxp8MjUBytgnhvxqq3ZTqZHTVZo4JJh,104,1221,-1117,606
2022-01-22 01:20:42-05:00,6760,LNX7AwwiGpuaXA4J86d1xqqtF6kD7qbCusssSZqtpKd,45a5FGVssw2NoGipB7NRN4XDLPob4GHNxSM9fqgsTpqA,True,37148166,9287041,51320,25660,25660,DddJ7EWCmYEEZETCBNgAUSg81Ls6fZtiAaY5ekJ5sXx1,2052833,16464058,-14411225,552
2022-01-22 01:20:42-05:00,6761,FL1C5wMXApaNzez9LFMAiFYVFiLSRQxgZ3GfPrscdvRB,2FkYGYyTzbTFjJBiggre23H7TvqHjzBTdyrzQ5VNGqht,True,1713631,428407,2526,1263,1263,4BnQKPLuE3DMTtxp8MjUBytgnhvxqq3ZTqZHTVZo4JJh,101078,387881,-286803,589
2022-01-22 01:20:42-05:00,6762,2RZPBo8Z2BgZmsASo14ySTSwqqgqmfVEjPkiAwQ1VTgf,BRS5cYtEoPRoSvTAiQaT1svWRdLJWVfy8LUb4SCudCjS,False,228522,228522,11075,553,10522,DddJ7EWCmYEEZETCBNgAUSg81Ls6fZtiAaY5ekJ5sXx1,11075,161905,-150830,484
2022-01-22 01:20:42-05:00,6763,CRaKcudjkQiSw5YPVjTLVdXvJskeGiHSYtq5ZcMPJhgQ,AgqTg3b3bAcaBmRidhNC4Uf9ZwNbeH52RQEqumWyuUs7,True,37457,9364,55,27,28,DddJ7EWCmYEEZETCBNgAUSg81Ls6fZtiAaY5ekJ5sXx1,2225,35318,-33093,594
2022-01-22 01:20:42-05:00,6764,2FrqGFZjbiNykJyo9BZ5S9FguQJPJiTi681rJJsQ5dta,3QUncYP92NKrfpaTvuF9iQg11PXKgZAgEngwh6BbnCCj,True,35495,8873,49,24,25,DddJ7EWCmYEEZETCBNgAUSg81Ls6fZtiAaY5ekJ5sXx1,1962,25185,-23223,552
2022-01-22 01:20:42-05:00,6765,HdRgh9niYSd3YKCxzGdusYFquiVoFTP2mEGEzJJL5Nii,78C68Gbb1jYFQmYNCHHjL52keEKMXtGukmBwT7ahon4B,True,910483042,227620760,1361864,680932,680932,DddJ7EWCmYEEZETCBNgAUSg81Ls6fZtiAaY5ekJ5sXx1,54474582,579324159,-524849577,598
2022-01-22 01:20:42-05:00,6766,2jPxG5FL6D6XEJsRszJ9cmQ54AWSpZyPFSbn3DpWBSuM,3toQou4UVNvyWYvMvkuv379RVEF2aN2TzCpKKBUqeQV6,True,8355142,2088785,12809,6404,6405,DddJ7EWCmYEEZETCBNgAUSg81Ls6fZtiAaY5ekJ5sXx1,512365,6012335,-5499970,613
2022-01-22 01:20:42-05:00,6767,duKo8riX1qpX1K1qpgwZniMtUeWqu2eYgchTu5n7Rbu,9vAVwfVtdsaZMbeZvoymjHqwASeuM38gfEJkbTVwDqya,True,2879154,719788,3838,1919,1919,DddJ7EWCmYEEZETCBNgAUSg81Ls6fZtiAaY5ekJ5sXx1,153532,2004250,-1850718,533
2022-01-22 01:20:42-05:00,6768,3y34hmyz6rsVnpp7d6a9s2Xw9GdezLU1H44HfieG6SGG,9DCz2eyYsrk1Hd5zsSVBhKTV9QD6beym5zB5fH3aA4hE,False,48144043,48144043,2173656,108682,2064974,4BnQKPLuE3DMTtxp8MjUBytgnhvxqq3ZTqZHTVZo4JJh,2173656,54441016,-52267360,451
2022-01-22 01:20:42-05:00,6769,7W6ih2ZGXaE6tvuQFUPCvc7NvEJHy7UffgoVX3ZPdLXt,6uQCkeMjEXHBQxE2HD33RM1zyTsSko1fYZA1mWUggJ5B,True,1107,276,1,0,1,4BnQKPLuE3DMTtxp8MjUBytgnhvxqq3ZTqZHTVZo4JJh,62,808,-746,560
2022-01-22 01:20:42-05:00,6770,96DzqyUxsB1FKWrhLdTdjDcokuus6rbx83gLsghqPPwt,74CWb7SVoSy3ADysEzFEeMiS2fxHJ9gdUF9pzM3E52Gj,False,904,904,44,2,42,4BnQKPLuE3DMTtxp8MjUBytgnhvxqq3ZTqZHTVZo4JJh,44,640,-596,486
2022-01-22 01:20:42-05:00,6771,HkRKcvAWLM5sCDL6a5DvYsH55bg5BnZnyP9WwX7wLUDF,GXtDJS8BCoZKnvviGaUb2QfKs2LQQZPMa9564tf5Jq8Y,True,65603026,16400756,87007,43503,43504,4BnQKPLuE3DMTtxp8MjUBytgnhvxqq3ZTqZHTVZo4JJh,3480314,31021625,-27541311,530
2022-01-22 01:20:42-05:00,6772,ioPHEVyheRnHYomVS7PmP6Coyhjk6LCs7hMD5Mq9Ngv,DYTpFmZ4yXVghKwkaovgCdpv3jfWkjtXRzxsZjKJfXNN,True,1035,258,1,0,1,4BnQKPLuE3DMTtxp8MjUBytgnhvxqq3ZTqZHTVZo4JJh,56,740,-684,541
2022-01-22 01:20:42-05:00,6773,EmGW2aAG69ssWqCtbfDocRaM2u3TJsczn2HHP9jdmRvD,aypkDKsp9uqAB4F6mwvm5LofpsrFBuZT2MMWtE2eHdB,True,27750,6937,38,19,19,DddJ7EWCmYEEZETCBNgAUSg81Ls6fZtiAaY5ekJ5sXx1,1559,21377,-19818,561
2022-01-22 01:20:42-05:00,6774,KoCscQ9Q8TZHhmya5KaXBrwUEMTdCkEMRtrhvtgEmiZ,6aZ5AFMFoqf1X64RwAt1J4Yrx4WGGe2JMiEjqnQ2gEtk,False,21997,21997,1024,51,973,DddJ7EWCmYEEZETCBNgAUSg81Ls6fZtiAaY5ekJ5sXx1,1024,10709,-9685,465
2022-01-22 01:20:42-05:00,6775,2p2fGXdKrmxjomLSnyaNg84J82cBBBNympZ6qQc8UZgU,HKAM8bazuLMUY6yapZJqYsgaWkTBqKHyMs1hSfpYsZGi,True,34885958,8721489,46295,23147,23148,DddJ7EWCmYEEZETCBNgAUSg81Ls6fZtiAaY5ekJ5sXx1,1851807,29152179,-27300372,530
2022-01-22 01:20:42-05:00,6776,AVon82fTHT5KeqJkdoG4KkbGoVF3ocK4rqz52umUeEBy,LdgtwakPuhGZCh47WNERa6op7z2YtouJFv4mhFLtVgs,False,5943503,5943503,288901,14445,274456,4BnQKPLuE3DMTtxp8MjUBytgnhvxqq3ZTqZHTVZo4JJh,288901,6090812,-5801911,486
2022-01-22 01:20:43-05:00,6777,EHJXCJ4ZxPY7F1CeDQkXxVCLyTBXAY2ouWMJfKic9EcK,3yxXBa3sJhUhK9auop8niypnuWiasge5waVTM1zzuhU7,False,51483893,51483893,2385450,119272,2266178,4BnQKPLuE3DMTtxp8MjUBytgnhvxqq3ZTqZHTVZo4JJh,2385450,23029078,-20643628,463
2022-01-22 01:20:43-05:00,6778,ER1VE2PfigGjHax2VP41mrKYE3GN1yxUkYU2E122Jf2Z,Gwp6htnGRGqPsnZcrMQTZVGiAHKqsUSao2XfcahwajVx,False,13585,13585,618,30,588,DddJ7EWCmYEEZETCBNgAUSg81Ls6fZtiAaY5ekJ5sXx1,618,9353,-8735,454
2022-01-22 01:20:43-05:00,6779,BZxJ6CtrVoiU86DMMieMeDFLNWtMpHGTvZfM7nyay6o4,6CRxRR8bisRLHFJBFWjyumYuy7j4C4PkjYH1K8gXhdWD,True,424749,106185,633,316,317,DddJ7EWCmYEEZETCBNgAUSg81Ls6fZtiAaY5ekJ5sXx1,25333,206413,-181080,596
2022-01-22 01:20:43-05:00,6780,7jvKp6onXyWgwsFrFWj4hYTXJsYYD6ot5mn6rPFuJriy,J7N6HiozevJVTiY9hDEUs2ud5BwT5QSE7wnMBS1w5ie2,True,3540289,885072,4956,2478,2478,DddJ7EWCmYEEZETCBNgAUSg81Ls6fZtiAaY5ekJ5sXx1,198244,2679337,-2481093,559
2022-01-22 01:20:43-05:00,6781,D58t4uTjFumsUeYFaKnpV8BRTEQEqKXBreFTdwGrott7,67p6kHDfVqQijfcwugvZK59c3aRRH9x3eHxruqH8WEqF,True,23411537,5852884,33200,16600,16600,4BnQKPLuE3DMTtxp8MjUBytgnhvxqq3ZTqZHTVZo4JJh,1328017,9102703,-7774686,567
2022-01-22 01:20:43-05:00,6782,9jdfc9GFTecsdRuTjWFGX13niKKmeBxRgtv5j86uhSnU,HLWMShobjSkaLyXrNjgwVaUGVtbtdUSnr1XjqpXn1bLR,False,13663,13663,641,32,609,DddJ7EWCmYEEZETCBNgAUSg81Ls6fZtiAaY5ekJ5sXx1,641,10469,-9828,469
2022-01-22 01:20:43-05:00,6783,C1CsbgQFvEvSXzuVHTr39tQHr3drDhjxeYiotd8eNocF,4rAaTCAMj5VpgNVKiYizabH7cMLhEA12seu2QXQNTyV3,True,7155014,1788753,10375,5187,5188,3zqXX6kzhkbW3d4TwD2CNjMRwxTbREXySekvq37kfCNk,415039,2679612,-2264573,580
2022-01-22 01:20:43-05:00,6784,EFHg5FatMRRSZnKJPJF9e1iw2cjPJRmwTTZYtkHno9DP,84LnLKhZDJgWFnbBYnYjqWkjymemXfidecPFwnUAvuFj,True,92606045,23151511,128112,64056,64056,DddJ7EWCmYEEZETCBNgAUSg81Ls6fZtiAaY5ekJ5sXx1,5124487,57779858,-52655371,553
2022-01-22 01:20:43-05:00,6785,DiPSJvnnEwg1En7HJfEsKrUbBgtUf4KzGMyMCZDQSYgp,s8UVC6vPBofuXUS6RW1aQmZ8C35PrC5r4A6ugmvzLGB,True,83655,20913,105,52,53,4BnQKPLuE3DMTtxp8MjUBytgnhvxqq3ZTqZHTVZo4JJh,4237,45312,-41075,506
2022-01-22 01:20:43-05:00,6786,ZoNjrSjYh4NJLW38LUPcf7jtEBxdaaM7T1zp795qjHE,FZx6v8cU25NwEosbKJ2n141o9uFAWURZB7NeCeX1trEn,False,65690,65690,3250,162,3088,DddJ7EWCmYEEZETCBNgAUSg81Ls6fZtiAaY5ekJ5sXx1,3250,35563,-32313,494
2022-01-22 01:20:44-05:00,6787,GM22yjVoBCzgBcVTT5EcgRhVWiXVV82kSj1dPCbegKWj,CDDy8JmJMwJyx1YAvEPpj8AYxCpngRovf3wWfVzao5Rc,True,8902738,2225684,11311,5655,5656,DddJ7EWCmYEEZETCBNgAUSg81Ls6fZtiAaY5ekJ5sXx1,452474,2792236,-2339762,508
2022-01-22 01:20:44-05:00,6788,GqAS41YJssg9aaEp3hs3sG98APCsXhiQBQszXaSjZ2bN,2wodJ3AhrXdE1T4oVL95KvoBND7PubG5Wd5GWiLCMZJU,True,8219009,2054752,12583,6291,6292,4BnQKPLuE3DMTtxp8MjUBytgnhvxqq3ZTqZHTVZo4JJh,503332,9816078,-9312746,612
2022-01-22 01:20:44-05:00,6789,Sapmbypb7FUXhKQEdjyH2AUDgh8QWQ1mu6SSHm7673N,7AGij8bP7Kq3iARJ41duwggPrDfuXDoKwRSKV9SG8nk2,True,12056741,3014185,16088,8044,8044,4BnQKPLuE3DMTtxp8MjUBytgnhvxqq3ZTqZHTVZo4JJh,643535,4009252,-3365717,533
2022-01-22 01:20:44-05:00,6790,Ckqos6cdncPKj13DnCmDVZsZTqp6eS7277CRrT9WhcEr,AtUV8m7VQJvZq7GLCAHMf3jV7iamKEPnWVZHWuuVZQp1,True,53713,13428,79,39,40,4BnQKPLuE3DMTtxp8MjUBytgnhvxqq3ZTqZHTVZo4JJh,3197,50612,-47415,595
2022-01-22 01:20:44-05:00,6791,6nJyqvFKprwaVCE1gAa2P4RHKc6Pa6XFSJymx654zZ9K,4e7iJmdwzAPxp1Zi8Azo38YyPQdPKqqY4VLJyQ5rpdYP,True,107773,26943,160,80,80,DddJ7EWCmYEEZETCBNgAUSg81Ls6fZtiAaY5ekJ5sXx1,6412,89170,-82758,594
2022-01-22 01:20:44-05:00,6792,5PVUmELKMD7mf2vbXbiXXsiZW2myGmZuMe757raBAj8Y,5eikdsebvyBh27aPz9t9KPswYWd8X4Cbk2TSiif6vn36,True,405186395,101296598,565396,282698,282698,DddJ7EWCmYEEZETCBNgAUSg81Ls6fZtiAaY5ekJ5sXx1,22615843,346372043,-323756200,558
2022-01-22 01:20:44-05:00,6793,9VSpd4vToJrnQhmJ595Ua7GhmhutYRgd6rCk3pL4yNxr,7axwFe8aQVPYLNgM9rdUwnFf6vW69Jsw2XpKNjYRDn6N,True,14591105,3647776,21745,10872,10873,4BnQKPLuE3DMTtxp8MjUBytgnhvxqq3ZTqZHTVZo4JJh,869814,9477637,-8607823,596
2022-01-22 01:20:44-05:00,6794,Grw2snBvSDMa7ev2nWZo81WoLfyavmXXxCV1ugHGk5Xe,AF1WVCQcBmXCnWbDx2s62vU99zW1AdhNoqbWvdrbiQVm,False,723240,723240,33611,1680,31931,4BnQKPLuE3DMTtxp8MjUBytgnhvxqq3ZTqZHTVZo4JJh,33611,492841,-459230,464
2022-01-22 01:20:44-05:00,6795,HGAFdundf5voDqeh9g7d6Q9mgMf8eEg898QMRBqwPZ6C,deanBuZXWBHEe2TGfP37S9aMBEnEgmZoyRJjAvruzfA,True,7025205,1756300,10006,5003,5003,DddJ7EWCmYEEZETCBNgAUSg81Ls6fZtiAaY5ekJ5sXx1,400272,5490532,-5090260,569
2022-01-22 01:20:44-05:00,6796,8trkirSQNdMmAcJdeswxs5cPjH8dD6U4eJtWiAdMsrDB,HaSzpQ45x2MipfN17U6jGBxX8tXboomVDhXNSrnEfLDr,True,201266,50315,301,150,151,4BnQKPLuE3DMTtxp8MjUBytgnhvxqq3ZTqZHTVZo4JJh,12057,138955,-126898,599
2022-01-22 01:20:44-05:00,6797,GgBCXShHpprQGxz83aEykieANhQPw9wHE65AFuSJBiWZ,JAoJ6sM7B3d2kQ5yTXAuoUDpvBX1qkb5uq1T8a1ra2zC,False,3758339,3758339,175155,8757,166398,4BnQKPLuE3DMTtxp8MjUBytgnhvxqq3ZTqZHTVZo4JJh,175155,1159751,-984596,466
2022-01-22 01:20:44-05:00,6798,Frobc1KZTVcsyfwyKwSpHJobxmiJBomzHhGCLdrzdAz8,HziyKP9uxWCuXddtbRzWMczHNdgyQB5UXQZj4MnMm14,True,20969529,5242381,27900,13950,13950,4BnQKPLuE3DMTtxp8MjUBytgnhvxqq3ZTqZHTVZo4JJh,1116016,8805515,-7689499,532
2022-01-22 01:20:44-05:00,6799,ES1MDwRUa3hoToPKQiiZkzMYe9PDVnAQwMrEvZrzvnc1,C4wBG3xTDkmDQneB28xYnf1aBNEeq7UB8oR7NuEfLkFg,True,1182909,295727,1632,816,816,4BnQKPLuE3DMTtxp8MjUBytgnhvxqq3ZTqZHTVZo4JJh,65308,740602,-675294,552
2022-01-22 01:20:44-05:00,6800,44iCXTAbcJMVscvvJQfTuVqj88V9QDgwXJDmVk7YcFBS,Dz3doggGiqe6rpazVjeA2j3XpRFmqesx7CRKsPAGKEVf,False,2645,2645,127,6,121,4BnQKPLuE3DMTtxp8MjUBytgnhvxqq3ZTqZHTVZo4JJh,127,1872,-1745,480
2022-01-22 01:20:44-05:00,6801,AA6QgBaH9F8QfPT9xjztv9uELcADPxwUuXofkBV8dYg4,FCMXozSstTNA74FVCJ5hpYvNJamjutnoakHoBVnzwcWj,False,1240,1240,58,2,56,4BnQKPLuE3DMTtxp8MjUBytgnhvxqq3ZTqZHTVZo4JJh,58,940,-882,467
2022-01-22 01:20:44-05:00,6802,5RvNKzSeJ1fvqsKpcQu25evEZGmKjyEDgwsMZkykoT3P,BRqSGfE4XHXu4HrinwetWumfVTmr82iuF6Y5oSV6eMiK,True,6304,1576,8,4,4,4BnQKPLuE3DMTtxp8MjUBytgnhvxqq3ZTqZHTVZo4JJh,351,3974,-3623,556
2022-01-22 01:20:44-05:00,6803,BrHRMouGRz3LBNzd9anfdYMhWfg8yUPHL4PqJ8WdEDFS,4uzoLa3mC2VYHAPBoHLX4gTjPTC28rPf2fvEGtJWPYc,True,2633118,658279,4035,2017,2018,DddJ7EWCmYEEZETCBNgAUSg81Ls6fZtiAaY5ekJ5sXx1,161432,3128417,-2966985,613
2022-01-22 01:20:44-05:00,6804,Mcbzp1LhZwpfmXTv1pqe9D1jCKHw443j9QKp6tUpzgM,8uforSMAKEih5jHfHp3gCqCvaugtCmhzVfVHA63Akz7F,False,93078,93078,4432,221,4211,DddJ7EWCmYEEZETCBNgAUSg81Ls6fZtiAaY5ekJ5sXx1,4432,78576,-74144,476
2022-01-22 01:20:44-05:00,6805,2s9VGesQYbKr3LwuraMEa9sXbXz7f8299HPPAHgSaUdp,8uMS2GDsbmygjbRnc2gjwNkXKogmJX1i8nchmqt8ixCe,True,1938100397,484525099,2974860,1487430,1487430,DddJ7EWCmYEEZETCBNgAUSg81Ls6fZtiAaY5ekJ5sXx1,118994403,1422075046,-1303080643,613
2022-01-22 01:20:44-05:00,6806,C9beggursF9WdLyzunVSoz2Bw6kAxoQpUifPHbo4ybvw,3R7KdKBK7FoudsNXUeRuC2AGVFusMhmTYXSGdnA88pJT,True,1589770025,397442506,2370676,1185338,1185338,DddJ7EWCmYEEZETCBNgAUSg81Ls6fZtiAaY5ekJ5sXx1,94827059,694795490,-599968431,596
2022-01-22 01:20:44-05:00,6807,5hUZ9uQFcYnjAQVVaGLJWdKyg7y1XMpoo8osQ9DeY7Xd,BdYiKWsjuzJLcHh3814mJ4xQ9JxoQKKcr7AHZ7Vxoavq,False,1893,1893,93,4,89,DddJ7EWCmYEEZETCBNgAUSg81Ls6fZtiAaY5ekJ5sXx1,93,1375,-1282,491
2022-01-22 01:20:44-05:00,6808,3axqGcX5yuJ2vGxRjtNguefXUvSQHDQmn2zskhyCuQkf,EYrZo9zZDaHqFdc1fam63W3jvqqmbU67wzp6yFcppwsL,False,1254720,1254720,60577,3028,57549,DddJ7EWCmYEEZETCBNgAUSg81Ls6fZtiAaY5ekJ5sXx1,60577,1508643,-1448066,482
2022-01-22 01:20:44-05:00,6809,DZSNYptWi3UbyYo4heSHfJFmCWjUNk1iDb75nJfPCPWp,D6dtmxaPmcRSWSRgb1wX4G2eMgeEw2oweCW8YJTHxuDc,True,10160,2540,15,7,8,DddJ7EWCmYEEZETCBNgAUSg81Ls6fZtiAaY5ekJ5sXx1,604,7109,-6505,594
2022-01-22 01:20:44-05:00,6810,AA9zFZTXqBR8Mw1fwEH59edzBiswoGasRNWsi6aLeysB,4VeitxYqqtRxyfdSVpshdJ3EDcgksRVnaHvAqWxTeujH,True,73070,18267,99,49,50,DddJ7EWCmYEEZETCBNgAUSg81Ls6fZtiAaY5ekJ5sXx1,3972,39596,-35624,543
2022-01-22 01:20:44-05:00,6811,BAczoNDnbwj5AJX5LwzynzYab7ji7VbhRy9edA9Prax,34sbkUKnMetUNyMs6BhiWut85d5UZtBWnPtwx8jEpJNA,True,55841,13960,77,38,39,4BnQKPLuE3DMTtxp8MjUBytgnhvxqq3ZTqZHTVZo4JJh,3086,42269,-39183,552
2022-01-22 01:20:44-05:00,6812,EhANPABkSw9x9WnsDEi8pCg67iQTX2UGTTUpyjADTwdN,4FKLi98hyg9ZjM4MY6ctJsv7B6vPUnTYWdhrnNoYsztX,False,467339,467339,20877,1043,19834,DddJ7EWCmYEEZETCBNgAUSg81Ls6fZtiAaY5ekJ5sXx1,20877,394347,-373470,446
2022-01-22 01:20:44-05:00,6813,2fk7wZ4M5ZqaQ5ZeLuh6uivNhtiRkCsCe8T44JBFahn3,HgtXtbcJzNLsrh9asZbcgiYVRhiPpYAyp2BpSq9VKEsW,False,6803924,6803924,328030,16401,311629,4BnQKPLuE3DMTtxp8MjUBytgnhvxqq3ZTqZHTVZo4JJh,328030,4448399,-4120369,482
2022-01-22 01:20:44-05:00,6814,8W9NJfM6cqCsvR1FC8Ab8YZPSQF7bz7inxJZxWnF7GsX,3exfPuVcTnPxs8GwCtS3ruKUGveYymwGV7RXQssPiizJ,False,18337125,18337125,816056,40802,775254,DddJ7EWCmYEEZETCBNgAUSg81Ls6fZtiAaY5ekJ5sXx1,816056,21444458,-20628402,445
2022-01-22 01:20:44-05:00,6815,3onLoSaH9BskwjFu4nbEFykBsDaFgKgWVHPqdSUjHraw,D3YAuBorbpirBJmvhxQvFJbQPRycWyyymjsvm8GDetv3,True,34026605,8506651,45462,22731,22731,4BnQKPLuE3DMTtxp8MjUBytgnhvxqq3ZTqZHTVZo4JJh,1818513,31562941,-29744428,534
2022-01-22 01:20:44-05:00,6816,5nauZoaxftcYR591YH4v52myeJLnXtY4okdttL9qSdkg,7x3G299D3bC7EwUQojhTXUv29BG4NGzrLbgS4mEyqG5r,True,19871927,4967981,27203,13601,13602,4BnQKPLuE3DMTtxp8MjUBytgnhvxqq3ZTqZHTVZo4JJh,1088139,9369991,-8281852,547
2022-01-22 01:20:44-05:00,6817,3Lv2XpiD4KBUHq7Zx6u3zNhpXoySodXHH8o8f5yaaPxG,H6TN4rhpBXkEH3mZnymYNcKfmnxRH2uzfwzeLH2q6ahP,True,8024,2006,11,5,6,4BnQKPLuE3DMTtxp8MjUBytgnhvxqq3ZTqZHTVZo4JJh,440,5886,-5446,548
2022-01-22 01:20:44-05:00,6818,AHm7zF4rpaxaayBLn5QDHgJSp8KAr647s4cNvQ9wLgd7,FDM33WngED24pukBvSDpPAzinW6afVAeGReum5nyLRiC,True,35588,8897,48,24,24,DddJ7EWCmYEEZETCBNgAUSg81Ls6fZtiAaY5ekJ5sXx1,1953,29243,-27290,548
2022-01-22 01:20:44-05:00,6819,E1CShgy7M9998q9jyzpnHZxHJR6z5hvnshUJt37kVPtG,96f1nYW4S9APCJS3TXTGSb9UcJDdxJuoBR3pLYqcNz2b,True,7647391,1911847,11771,5885,5886,4BnQKPLuE3DMTtxp8MjUBytgnhvxqq3ZTqZHTVZo4JJh,470855,5492822,-5021967,615
2022-01-22 01:20:44-05:00,6820,DqBDL1BcCT99qqNXJeTbzP8pt6123zKKUrsX5DfPZPPW,FNaFupygF8timeWhwZkwDZ4YnsfGXA3pHqjzedda7RxN,True,1044961,261240,1348,674,674,4BnQKPLuE3DMTtxp8MjUBytgnhvxqq3ZTqZHTVZo4JJh,53947,285864,-231917,516
2022-01-22 01:20:44-05:00,6821,6Bq55LtGCEeGqh4JrFLCmmGc2iJfTTBJixivqH78aGSE,DSNrCgWJeNe2P9tAQu5FvCueTzNKDKds7wzuwTQSMRG,True,297263,74315,463,231,232,4BnQKPLuE3DMTtxp8MjUBytgnhvxqq3ZTqZHTVZo4JJh,18537,199470,-180933,623
2022-01-22 01:20:44-05:00,6822,7E3Zc3g1eJ7ueosPPoHDSkhuHvBVfN41eXcJXWeffozU,CGA8dcsZjfLqSYijYmssZwd9TXAsvSafNVT6JvUajGdu,True,137660670,34415167,202089,101044,101045,DddJ7EWCmYEEZETCBNgAUSg81Ls6fZtiAaY5ekJ5sXx1,8083584,118738278,-110654694,587
2022-01-22 01:20:44-05:00,6823,69byqtDPmgEY1NqKBCR95CEPVHRUxgbNW9Y4P4HjQ7ND,E47T4q4zMGzNL6vDxgWdLn3EQbW3WfVryr8Jsymy1hAL,True,24855083,6213770,31375,15687,15688,DddJ7EWCmYEEZETCBNgAUSg81Ls6fZtiAaY5ekJ5sXx1,1255008,15946801,-14691793,504
2022-01-22 01:20:45-05:00,6824,6BPPDj3BVgBPD3agd8b4B12d9Gvp4bFPXRWjzbtsmtRF,8VZnAwXPyKK2AHoMTZxKXthAiFMrL6b5EXAGqsAMTdhm,True,1358,339,1,0,1,72FwbpFGoLEazJEdpqNtPNefsadUrimUqma9wSoy4qiS,72,953,-881,530
2022-01-22 01:20:45-05:00,6825,9YEzjb49Awvedv9yNc6LG54SkGBug2RYiJwiUV13mGsS,3H8w5WCD187NWWoZMNUCzUDdxTgqrRJLga8gDzUVXBgZ,False,51146,51146,2393,119,2274,4BnQKPLuE3DMTtxp8MjUBytgnhvxqq3ZTqZHTVZo4JJh,2393,47960,-45567,467
2022-01-22 01:20:45-05:00,6826,Cb4zhnvig11U4GcC4kqKrnDicGgPhUpfDQB1U7hP3nPa,DiRAMrKqaevGXeXg38KnhaYBERj8tNKU7oWFJvhS32kw,False,9397,9397,421,21,400,DddJ7EWCmYEEZETCBNgAUSg81Ls6fZtiAaY5ekJ5sXx1,421,6063,-5642,448
2022-01-22 01:20:45-05:00,6827,DdYgcyV1T2CDYiQVr4VL9Ym8RdKm93a7SKy8HxuyaoMW,GPdAeqeXb1UJ56AttcwwY1CyFhRyfptDC4BAX2Tc8MpE,True,22739,5684,33,16,17,DddJ7EWCmYEEZETCBNgAUSg81Ls6fZtiAaY5ekJ5sXx1,1353,18707,-17354,595
2022-01-22 01:20:45-05:00,6828,5yPGvUz6JWKjkViGwTCpygJii1rP2xv5yx146ULtBiYq,FMnHUCQWTf1UHu5qVFqUAsWh8aba9EQYTEoiXy55totD,True,210110903,52527725,323703,161851,161852,DddJ7EWCmYEEZETCBNgAUSg81Ls6fZtiAaY5ekJ5sXx1,12948148,77728796,-64780648,616
2022-01-22 01:20:45-05:00,6829,7tJwRNiNqDcbKrejrHCKXBtUTpmTq2SxeYbcfiut1Bet,7BDLXMT32bq5VQy3KcVjfSCkVY84Wy6WfEHr6GMHEHQm,False,8459721892,8459721892,391318725,19565936,371752789,DddJ7EWCmYEEZETCBNgAUSg81Ls6fZtiAaY5ekJ5sXx1,391318725,5380466173,-4989147448,462
2022-01-22 01:20:45-05:00,6830,6WNPf4rFCX74PuyvdmzRFqbxWhguuxTQqBSdnaTVBd5D,9N7a9aiHGQsxFMgVbmWoCF9w95d12xyT7XFAwpHGkTLA,False,70195,70195,3127,156,2971,4BnQKPLuE3DMTtxp8MjUBytgnhvxqq3ZTqZHTVZo4JJh,3127,38064,-34937,445
2022-01-22 01:20:45-05:00,6831,C3k34T2x8fW171coEG9YvoUePvxtHmrQMjVsX1Cb5ZbU,4mh5Tp4Jjh5X3GDERpSMAFgsfYJvysRdd1Nu5oJQ1Dhw,False,1065,1065,52,2,50,DddJ7EWCmYEEZETCBNgAUSg81Ls6fZtiAaY5ekJ5sXx1,52,743,-691,488
2022-01-22 01:20:45-05:00,6832,DAku12iueL13vRoTpKLyqdGaLQ2rWF6REe8Dr8soFvNs,H2vVH3LxkhGe6x6Mdwy67BYwTKNQM6XayKx7mhrwyfJM,True,19149,4787,25,12,13,DddJ7EWCmYEEZETCBNgAUSg81Ls6fZtiAaY5ekJ5sXx1,1037,15720,-14683,541
2022-01-22 01:20:45-05:00,6833,Cs2YxkuqBK1kjoYZbUZdUcxapPbv8oC75trwGgWoCPfG,2PgHQM1GhHykE4bQ1ggueAw2Zs1BFUW5hxvMvr8DojKM,False,3277115,3277115,141387,7069,134318,3zqXX6kzhkbW3d4TwD2CNjMRwxTbREXySekvq37kfCNk,141387,2877314,-2735927,431
2022-01-22 01:20:45-05:00,6834,67Z7ZGhNu5xxEh9BYKWcXp9m1T4tFiE1o1M16hCzUWQA,CT7YKWixz7BhTbvg5F6M5HCyPGnHoFLNFuDV9GhoLTo3,True,140383,35095,206,103,103,4BnQKPLuE3DMTtxp8MjUBytgnhvxqq3ZTqZHTVZo4JJh,8262,127489,-119227,588
2022-01-22 01:20:45-05:00,6835,Avok5yeEYbNXwtBCqqb2y3WRnGgoXeuGKCtUBYxf3N7U,Byms3hWr4yaf3TYW8HALsNvhFhMgLYwvdpiKqJqegyVY,True,2829163,707290,3722,1861,1861,DddJ7EWCmYEEZETCBNgAUSg81Ls6fZtiAaY5ekJ5sXx1,148885,2556826,-2407941,526
2022-01-22 01:20:45-05:00,6836,5rW9kqXB9feGSKSvSMNJF1FCsBYV3vGmTmc8MvzaZ3pi,7AjnjcfPJevW5521hXw4VtgRCfHSsAqyzyArukKfNcHo,True,475490,118872,717,358,359,DddJ7EWCmYEEZETCBNgAUSg81Ls6fZtiAaY5ekJ5sXx1,28702,395031,-366329,603
2022-01-22 01:20:45-05:00,6837,6CeKxTJvFqhyNEyzySiBBKEwYVMe7j3A6nkMes4BW6o2,DzDR9XvwY1z7ygQ8YrCXrwDGHSf67JZF8BzUnuFE2fxQ,True,187902,46975,251,125,126,4BnQKPLuE3DMTtxp8MjUBytgnhvxqq3ZTqZHTVZo4JJh,10072,122778,-112706,536
2022-01-22 01:20:45-05:00,6838,FLMmm1T383a2eWS45cBbMXKCWFqgmiBAB662R4fhA78N,B8dRmhYvTJzZWZYthEchwKTKkBWHrqkFzBJAUMvG5eQE,False,22908036,22908036,1054959,52747,1002212,4BnQKPLuE3DMTtxp8MjUBytgnhvxqq3ZTqZHTVZo4JJh,1054959,15067363,-14012404,460
2022-01-22 01:20:45-05:00,6839,54grbLQHZsNK4qTyXb8kXAU12Af9QUNFMujuzLLHHHef,3Ua1LDmZfPxvpaCp45RJ5xn3ovNuMxyWGrxnLcsK2ko3,False,92259630,92259630,3994009,199700,3794309,HfEnetJ7uBSmZWCjBNxdvv9HEC5nsW4wDV7wu6WnhWan,3994009,61908946,-57914937,432
2022-01-22 01:20:45-05:00,6840,H1LftKtj94Zs6PG2A7gJt9rPurBkXkTy2hbbArQwAehi,8bANmhgdnPYa3PqdPnk5BA2xhvqJmPyaMF77mrBePJ13,True,1646,411,2,1,1,4BnQKPLuE3DMTtxp8MjUBytgnhvxqq3ZTqZHTVZo4JJh,98,1944,-1846,595
2022-01-22 01:20:45-05:00,6841,6tWqNUhr9XZVB1sc33W8VEo7gbptDtnKzGVvMZ4Xh68n,8NdrSzU8Tc6Ng2o1RWKfXyZb7i8jm6waYTBomq24F8wZ,False,152860,152860,6824,341,6483,DddJ7EWCmYEEZETCBNgAUSg81Ls6fZtiAaY5ekJ5sXx1,6824,58378,-51554,446
2022-01-22 01:20:46-05:00,6842,BmDwvPUjxBakng8ARj7cfjgYJUYCJhLeVnRYXcLDMy4G,8YVEshruc7LMMPf7vrPK9x5eLQGwe7py6bhZoxb9yfkz,False,17139160,17139160,812128,40606,771522,72FwbpFGoLEazJEdpqNtPNefsadUrimUqma9wSoy4qiS,812128,5991550,-5179422,473
2022-01-22 01:20:46-05:00,6843,J4krKPBBTMVLZRgrSeYJAMyHQs2FkNm5TXk7nQWwDB43,ASmLbfNbhTD2HHeV7qzAqiHjUx5a8Traj8oPDwbkMdFg,True,1221762,305440,1763,881,882,72FwbpFGoLEazJEdpqNtPNefsadUrimUqma9wSoy4qiS,70525,808392,-737867,577
2022-01-22 01:20:46-05:00,6844,C7a8BtMjuLXkzxZBC4Wk2gjkGBmucLmDjokf9pyA1Mu6,GxwYNWwYTtFMUxuZvNC5qrEYuJzYiEURQVuBxssfCJzr,False,71467,71467,3384,169,3215,72FwbpFGoLEazJEdpqNtPNefsadUrimUqma9wSoy4qiS,3384,38829,-35445,473
2022-01-22 01:20:46-05:00,6845,J1CrDBB5Bk55z9ByXQavcHwRMTGpgVdndjWxRQthEvXQ,F9mDV56ds2RodotLvXfHdkMp4mhrBtFMse8iMYWUnSvw,False,26806861,26806861,1214251,60712,1153539,4BnQKPLuE3DMTtxp8MjUBytgnhvxqq3ZTqZHTVZo4JJh,1214251,25027399,-23813148,452
2022-01-22 01:20:46-05:00,6846,CK3ocyWzXQkJJZQmM6bBK4Nv6Rh3UEufjY6DvNU6gJZy,C924o4GY3p2BHLeAbFbe9SEysXqCUyD8sFu2d4NzkAV7,False,303361,303361,13394,669,12725,4BnQKPLuE3DMTtxp8MjUBytgnhvxqq3ZTqZHTVZo4JJh,13394,198565,-185171,441
2022-01-22 01:20:46-05:00,6847,8dE8PJp7BEYbmSrpMhvxh2Ro9KUiKoEFs3Mi7Xh18Cgz,CfiSeqS4D8EcG882PSLNXhwm5KJH7F1KGo5nSz13tGP8,False,3245423,3245423,145491,7274,138217,4BnQKPLuE3DMTtxp8MjUBytgnhvxqq3ZTqZHTVZo4JJh,145491,1117978,-972487,448
2022-01-22 01:20:46-05:00,6848,EgU9hX6VK7YXeCgCHVaJAMekCcyZa2MVWdKra5pN7Gwv,7y8Ad9XY34bqREvheXHT2tr8Jy11D6X3pu7yLVtjU4QV,False,425667,425667,21162,1058,20104,DddJ7EWCmYEEZETCBNgAUSg81Ls6fZtiAaY5ekJ5sXx1,21162,343042,-321880,497
2022-01-22 01:20:46-05:00,6849,2hirR46fpyHEg1Fv9vAzYgnoNRBWaky7LoFGVof4DnpK,DXTEHauVDdz4Mjjj6sJHPUh6TnzU6ob6Nj63To2vCNPW,True,97357601,24339400,143134,71567,71567,DddJ7EWCmYEEZETCBNgAUSg81Ls6fZtiAaY5ekJ5sXx1,5725360,35535742,-29810382,588
2022-01-22 01:20:46-05:00,6850,H458vCw7tnmFmPgmmg1HaMmN35mqfnMSugKxddMgSWfX,E25tbasspnw8yTYh7q2VLG7DSvDH7M8N19eQwAtgQtfV,False,3756019,3756019,173092,8654,164438,DddJ7EWCmYEEZETCBNgAUSg81Ls6fZtiAaY5ekJ5sXx1,173092,1160007,-986915,460
2022-01-22 01:20:46-05:00,6851,9TL17gjvWFdhSJkpXgfnX7fKF9c2hfw59k3g8WUqm8Cb,7TyxFBKG4z5Xv3js3n1gbEWWj1M9KBF7dEmFxjCPGidC,False,8614232,8614232,382121,19106,363015,4BnQKPLuE3DMTtxp8MjUBytgnhvxqq3ZTqZHTVZo4JJh,382121,5277814,-4895693,443
2022-01-22 01:20:46-05:00,6852,4j19AEcDwhtAZrnoDc4epNPmEL1jPpVUMeg7RmQ72Qkb,84WB42AAGbczVE9txZPwXrx4FD5jP87r8QdDzEABTm5G,False,3067953764,3067953764,141714311,7085715,134628596,72FwbpFGoLEazJEdpqNtPNefsadUrimUqma9wSoy4qiS,141714311,2716765008,-2575050697,461
2022-01-22 01:20:46-05:00,6853,3njiRuSRMXRzKmamyiR72Hc38PU8UDDmWdfPhgxmGxEW,5WoF3gkgygyNNbwxWgVfqGWkExcDixuzgJQQjXEZQ6J5,True,10949369,2737342,14864,7432,7432,DddJ7EWCmYEEZETCBNgAUSg81Ls6fZtiAaY5ekJ5sXx1,594561,11469295,-10874734,543
2022-01-22 01:20:46-05:00,6854,6kbTnDL9xhi1YvPLtFvRmk8aE1HWsxNAEALcQ9kdCJQW,3Z1kmT8dUJJTUqbrCWGSBqV12GHhzcs3ZGKwaXP8gpGW,False,623400398,623400398,28248099,1412404,26835695,72FwbpFGoLEazJEdpqNtPNefsadUrimUqma9wSoy4qiS,28248099,263611762,-235363663,453
2022-01-22 01:20:46-05:00,6855,Buioe5v3DyFwD9nquW5XdYeVYbSABCyg79eUHEvtvfaW,7T9gi7prCcZJkYJMSB5Ef6Bu4pAuBw4XLvumSFnqKDSi,False,30392,30392,1477,73,1404,DddJ7EWCmYEEZETCBNgAUSg81Ls6fZtiAaY5ekJ5sXx1,1477,26703,-25226,485
2022-01-22 01:20:46-05:00,6856,4kbcrzH6o2LvLUCNphyL52i8uGzVD8wcUNEqoQ14z3VG,5Q1atmEBs2AqaDZsiZFG5stHzj1fE6ZvypgfkEc9LYqE,True,7655340,1913835,10058,5029,5029,DddJ7EWCmYEEZETCBNgAUSg81Ls6fZtiAaY5ekJ5sXx1,402349,6755542,-6353193,525
2022-01-22 01:20:46-05:00,6857,BjyZWwz1ARSfmPkHXHBzehq5NsH4DRJiu4zFMkqsKu6A,7WUCSZ9SnKDsbomDRZ7CKsHfHJFwboKJwFFdaGkBURBS,True,209676596,52419149,287727,143863,143864,72FwbpFGoLEazJEdpqNtPNefsadUrimUqma9wSoy4qiS,11509093,139336389,-127827296,548
2022-01-22 01:20:46-05:00,6858,6dr65yANjSMmfBeKAuSxG3i16S9vMgF1CQ3zDyzh55Pn,EhrE5QpnshD41S4zPEBy2A5q2Gs2mwUrbHGo6WnT9zDP,True,14360,3590,19,9,10,DddJ7EWCmYEEZETCBNgAUSg81Ls6fZtiAaY5ekJ5sXx1,779,11794,-11015,542
2022-01-22 01:20:46-05:00,6859,BTouoY9doTYwX8wAa6QcZHzJjfZfEAtiLYR2JHKd5V8Z,H4ByqCdZy7AMx7VJZEwQwQmZLVA8vHg55C7ypwZwv67u,True,909471622,227367905,1235747,617873,617874,DddJ7EWCmYEEZETCBNgAUSg81Ls6fZtiAaY5ekJ5sXx1,49429890,420334616,-370904726,543
2022-01-22 01:20:46-05:00,6860,DH6W3oB22rPJj7PPrey3Rgtn8Tz8kFKQjftajzUFBeKK,5gNsQSAUq8yFVt3FtU854NfuvFQaaCDC6oAqKA6hoZ3F,False,2378535,2378535,104158,5207,98951,DddJ7EWCmYEEZETCBNgAUSg81Ls6fZtiAaY5ekJ5sXx1,104158,1529536,-1425378,437
2022-01-22 01:20:46-05:00,6861,6d6HN8LWikwW2HYdy3BABWuxKHt1sgv4DcneACR133sE,4eKvzmfFvX96XbujKBhUauAvWP4yQYwZH3pd7gXzbCvJ,True,71686,17921,92,46,46,DddJ7EWCmYEEZETCBNgAUSg81Ls6fZtiAaY5ekJ5sXx1,3711,38937,-35226,517
2022-01-22 01:20:46-05:00,6862,99NHcwD1iaf5FXM3UNb91SjNiiT3HwyQFQMhkGd5ASts,8syAydy52vSQQLzsLXW24BFw4VPeK66Vp3BmAbnHfgod,False,2306348,2306348,106953,5347,101606,DddJ7EWCmYEEZETCBNgAUSg81Ls6fZtiAaY5ekJ5sXx1,106953,1703181,-1596228,463
2022-01-22 01:20:46-05:00,6863,961Wz2gAzstN9CQjgoe22Htq41zJsYbn8T2pAJqUVo4G,66vPnY7rg7HS9VchM2H33BBqkZK53RDMbrQwj6gSMCdR,True,727859500,181964875,921414,460707,460707,DddJ7EWCmYEEZETCBNgAUSg81Ls6fZtiAaY5ekJ5sXx1,36856599,237159344,-200302745,506
2022-01-22 01:20:46-05:00,6864,2iG781tfP9H77hcFimqp5X9KB9QsbVkQVS9q7emJAJXX,5XDdJMfPSs8WwZZgEtv22RQXEbg748ia4gGfZCy1n4jy,False,694933,694933,30224,1511,28713,4BnQKPLuE3DMTtxp8MjUBytgnhvxqq3ZTqZHTVZo4JJh,30224,269069,-238845,434
2022-01-22 01:20:46-05:00,6865,CvZssqscu2dm35mwcE3zg9zedavbRjVJjWD59Py5ExUK,7pXaoR6aHKYofCmg1eHipygNYDteEaf8rbbS8BDYGQK6,True,30228,7557,43,21,22,4BnQKPLuE3DMTtxp8MjUBytgnhvxqq3ZTqZHTVZo4JJh,1736,19724,-17988,574
2022-01-22 01:20:46-05:00,6866,HVZkXeDR3mc8oB9qFFwCK4RXpPojdcHk9tRGep6xtKGK,Bh3py7awPejWqeTMxtAgF7mPotL2Asxf8YrYJykq9nBt,True,284977,71244,424,212,212,4BnQKPLuE3DMTtxp8MjUBytgnhvxqq3ZTqZHTVZo4JJh,16969,207715,-190746,595
2022-01-22 01:20:46-05:00,6867,J41kECimnpqjpS8nhNF8tAyGJFKoUr2FGKBsRbM4ae6P,CXGbaRB9isy46bFZ23HTDF1ULrLC3zfmuZwMkJYq8cjC,False,580587388,580587388,28329287,1416464,26912823,72FwbpFGoLEazJEdpqNtPNefsadUrimUqma9wSoy4qiS,28329287,171204754,-142875467,487
2022-01-22 01:20:46-05:00,6868,7dmoK7QPki7R66SPQST4veUgVfnJbVToxxBPZveECiwK,4vh4REBDm5zBDmcjRCD9zNsny1HGneu7B2co4dSJNLL6,True,35226873,8806717,49176,24588,24588,DddJ7EWCmYEEZETCBNgAUSg81Ls6fZtiAaY5ekJ5sXx1,1967072,25146980,-23179908,558
2022-01-22 01:20:46-05:00,6869,3JzquEXUqphLYNmaVQLUTyrD6mJKXDcSSu9m39YCYvHf,Dk8mswH5HnCUmTEFvX4xHhUPk2m8VmgZW344BiNqg819,False,221702943,221702943,10720441,536022,10184419,DddJ7EWCmYEEZETCBNgAUSg81Ls6fZtiAaY5ekJ5sXx1,10720441,138593121,-127872680,483
2022-01-22 01:20:46-05:00,6870,Ar5QB4VBcUyzSCG23z2QNAbrWY55NbHCr1MNN6P2GAmh,BusFGTiDrJmxzwGUxWz9b3SFF3eseqtgh2DRHqyAwyVe,False,21539,21539,936,46,890,DddJ7EWCmYEEZETCBNgAUSg81Ls6fZtiAaY5ekJ5sXx1,936,15838,-14902,434
2022-01-22 01:20:46-05:00,6871,E1wp3bmkcY3eiEYyGYwhTCsr7BZ7RfPa5DJTZFupcFwj,452hVdYkD5SDDrA6hv6DLPFvyS8PvR2P6DPNScGxWTsW,False,37523,37523,1638,81,1557,DddJ7EWCmYEEZETCBNgAUSg81Ls6fZtiAaY5ekJ5sXx1,1638,27538,-25900,436
2022-01-22 01:20:46-05:00,6872,6fqbSyhh3PPdgRcLraHb7Jahj9s1oHHeX3SsjNSsGa6t,GpRUow48TYgttdYfsygbgjYQcmHyYjWETUDjDVphEgwq,True,14269837238,3567459308,21565885,10782942,10782943,72FwbpFGoLEazJEdpqNtPNefsadUrimUqma9wSoy4qiS,862635417,5278078079,-4415442662,604
2022-01-22 01:20:46-05:00,6873,7g4NJBHwDTRm58GqX7Tz1JzqwbAhF6EWJUQH3SoDxSf7,82Ypv7STZeSCBPf3HckWdyatELpvaDaWxFXhD5dNSML4,True,1000,250,1,0,1,4BnQKPLuE3DMTtxp8MjUBytgnhvxqq3ZTqZHTVZo4JJh,54,716,-662,540
2022-01-22 01:20:46-05:00,6874,2NHv3c4ufYGo3xNr6KXymAZJdpfURrNiCKbXZ7s82Vwo,E4NYpYgHTvSG6LqH2bBV9Q1XJ6pAzCp9FLSKMzJmYRrQ,False,1203935,1203935,52851,2642,50209,72FwbpFGoLEazJEdpqNtPNefsadUrimUqma9wSoy4qiS,52851,1032366,-979515,438
2022-01-22 01:20:46-05:00,6875,DZay4ADcfoFainzjooJ9To7sb4Dn4iEoMs8tnYVrdwN1,AV8ndys1dnL31GKm5tEJLk74y4L9DuP6gC8ZvUtuVxfM,False,44809763,44809763,2051021,102551,1948470,72FwbpFGoLEazJEdpqNtPNefsadUrimUqma9wSoy4qiS,2051021,42451616,-40400595,457
2022-01-22 01:20:46-05:00,6876,2bikYf33ZxxDmvkMNjWDGGqEpbYJPvWv5At3hzyeLEQK,5FtirUBjRAZ3k5arFFVwKz42ixWzhkEBLkaK9PraRZ78,True,6290,1572,8,4,4,72FwbpFGoLEazJEdpqNtPNefsadUrimUqma9wSoy4qiS,329,3967,-3638,523
2022-01-22 01:20:46-05:00,6877,2PzBAkdXkrwH9VuoMALumQz86qkW7sSBQtCrHw14JUp3,D5vwWAMHVooobG2sCWv9EwtJrAFZG6cwKH4dfmA98tbt,False,121013,121013,5200,260,4940,DddJ7EWCmYEEZETCBNgAUSg81Ls6fZtiAaY5ekJ5sXx1,5200,87129,-81929,429
2022-01-22 01:20:46-05:00,6878,9LZ3rShLfzErXsGkh4dYfAm58GNPWhK6ohDy5RrLJhc,41tLyuvuJ5M7YctkSASD2R7RGGetD7FmKaZUdkTdgXgt,True,62127,15531,79,39,40,4BnQKPLuE3DMTtxp8MjUBytgnhvxqq3ZTqZHTVZo4JJh,3186,33717,-30531,512
2022-01-22 01:20:46-05:00,6879,HutRztBianNUgm9sJDWKUQBmoVyy8y7CfnNk4hHjSkEW,EtVfvPyiy5bizbCZxR19TNUgETf3QcmziBvMtc6o5zjr,False,11477559,11477559,500133,25006,475127,72FwbpFGoLEazJEdpqNtPNefsadUrimUqma9wSoy4qiS,500133,14122833,-13622700,435
2022-01-22 01:20:46-05:00,6880,Hc2e1tBoiCVKrbD7GvV5i8jgpcd219DoKJwokHvZQumE,xREhnQUqoWUi5HUxkehdh9qw7g89CgkrYemD9ZJYLaJ,True,7695,1923,9,4,5,4BnQKPLuE3DMTtxp8MjUBytgnhvxqq3ZTqZHTVZo4JJh,390,5480,-5090,506
2022-01-22 01:20:46-05:00,6881,CgQB5KmWNz21q9mPfFBve8Ksbqdsdr8jNfwkrxmNZPLN,2dtPpz7Ck4hhBQq8DUywp4Bq21Jk1enHLe8AgXa8ARZu,True,49783603,12445900,73363,36681,36682,72FwbpFGoLEazJEdpqNtPNefsadUrimUqma9wSoy4qiS,2934520,34387317,-31452797,589
2022-01-22 01:20:46-05:00,6882,6AHFxqjtpMsrCJ9E4ofrq4DVbaZSpDqyVMp6bznPqMg9,F3EauaowTvSs4NZ1EpUVonpNMmpMijcWHNi1AiKFZVxY,False,14694480,14694480,689796,34489,655307,72FwbpFGoLEazJEdpqNtPNefsadUrimUqma9wSoy4qiS,689796,5459123,-4769327,469
2022-01-22 01:20:46-05:00,6883,FEKYaAbNo9UF62dkkV8JbV9HvHYsiBLmvQp561HEXWx6,2Bcc55F83cWDvW4X2QQMfgpZQZWMVZsMD3W98KNL8GqK,True,60785672,15196418,78980,39490,39490,DddJ7EWCmYEEZETCBNgAUSg81Ls6fZtiAaY5ekJ5sXx1,3159212,54862393,-51703181,519
2022-01-22 01:20:46-05:00,6884,GH6Q9E1jZPTTp46aDd57UNZPNS2D6PBSwyLL3EHSjGn2,2XvwZXNsrPWx4EfPvhTP933bzCC3SJHDQ8xARfrXdVY9,True,847254,211813,1116,558,558,DddJ7EWCmYEEZETCBNgAUSg81Ls6fZtiAaY5ekJ5sXx1,44671,1053658,-1008987,527
2022-01-22 01:20:46-05:00,6885,7uHMFnppZKtV7nAySv8UGcoGTSQ98RVz1GP47dsFWpYr,FmS9WPYVTT8i4agyidApdLnoHAUMfdRFPnAVJQUwfWr5,True,73646700,18411675,99163,49581,49582,DddJ7EWCmYEEZETCBNgAUSg81Ls6fZtiAaY5ekJ5sXx1,3966535,28760802,-24794267,538
2022-01-22 01:20:46-05:00,6886,3tmdrjoBp8JsjUxZ87Fqjwsfmow5pjYjRyuYdvtjwK2D,uhC85HiGrbC8fBsU227msvkzEDAcY2EDAJcYoBR31Qg,False,5031067,5031067,219438,10971,208467,DddJ7EWCmYEEZETCBNgAUSg81Ls6fZtiAaY5ekJ5sXx1,219438,4807561,-4588123,436
2022-01-22 01:20:46-05:00,6887,6h5DgBXbebbFDYCqknQuEx7NFsHVmts1Rqgo3SeZmdyx,AzatTx5LLzbRWFi25TQGExAsuw5Le2JpH8MsUwZBsprC,True,116872102,29218025,146977,73488,73489,72FwbpFGoLEazJEdpqNtPNefsadUrimUqma9wSoy4qiS,5879107,38742005,-32862898,503
2022-01-22 01:20:46-05:00,6888,2VaLosQwagCVayTVjPGYW5FuiCWGFebMr34XzCa87Mjm,ARaeUMgGi3rHmtdYD9ShwzNnLRLvabEjcUqq8P1md7tW,False,3650236,3650236,157150,7857,149293,4BnQKPLuE3DMTtxp8MjUBytgnhvxqq3ZTqZHTVZo4JJh,157150,3196180,-3039030,430
2022-01-22 01:20:46-05:00,6889,9UyQC8vc6zJJaSdnjvTAzgmcsw4fC3xFBBiCC1w9Sbjx,3ppBfboe6FPmt7f6WrivspMUoAznZKWQMeh3rCgw7vjQ,True,384787,96196,536,268,268,4BnQKPLuE3DMTtxp8MjUBytgnhvxqq3ZTqZHTVZo4JJh,21453,237967,-216514,557
2022-01-22 01:20:46-05:00,6890,9gYrMXAGmGSV4VFjXzYP5WwH2aFpB1TxA6CqpYsosKLv,Dh8aH6RK48wu4fkT9xKw5XL7itxnPDuw3SDwPwvL5sva,True,1139,284,1,0,1,72FwbpFGoLEazJEdpqNtPNefsadUrimUqma9wSoy4qiS,60,810,-750,526
2022-01-22 01:20:46-05:00,6891,woTXSsDkL9TQNxc3zwxSPagVijX7PE24bgKjvxexRwQ,A5M5EEPfDgvAxGLhpNgfn8AzPmyXxmPVgkEKnyoVzsz6,True,608732,152182,780,390,390,4BnQKPLuE3DMTtxp8MjUBytgnhvxqq3ZTqZHTVZo4JJh,31209,558732,-527523,512
2022-01-22 01:20:46-05:00,6892,9zpPiboHF5HW7NfCx7hYdmJGwUomVMTiUFc4Um5KrDi3,8q3eBpuwV6dMNkib9N8XQAq2tBUcjSANRe5SXpd4dFhZ,True,352492,88123,483,241,242,DddJ7EWCmYEEZETCBNgAUSg81Ls6fZtiAaY5ekJ5sXx1,19358,218015,-198657,549
2022-01-22 01:20:46-05:00,6893,A3E9T7xYkPeNiWKdvhNTYiD5j7k2Xecpe318eFqVro4m,2QJk8iVJEy2QZmbFHnR7RBJsi7NpXWFFkEmweWtKKHfE,True,83950313,20987578,116314,58157,58157,72FwbpFGoLEazJEdpqNtPNefsadUrimUqma9wSoy4qiS,4652571,70321334,-65668763,554
2022-01-22 01:20:46-05:00,6894,921FBgLS3A1wA77uWitsnTvW737Q2jY7tzvgWtWLXNC7,E4eJ9H7cqP9zNpMH5xRBTAp9yaBCBihuJBNd6pqzteDG,True,6289,1572,8,4,4,DddJ7EWCmYEEZETCBNgAUSg81Ls6fZtiAaY5ekJ5sXx1,329,3966,-3637,523
2022-01-22 01:20:46-05:00,6895,9ebpuMtXee3DSx4qWiEYEtTT1gK5FqCY2H5yQVWWtTts,9b71dTsTYD1bx6KsjFs5h6d3Jj4T9eX3nqmS7RQj3HS5,False,17444606,17444606,746915,37345,709570,DddJ7EWCmYEEZETCBNgAUSg81Ls6fZtiAaY5ekJ5sXx1,746915,12183587,-11436672,428
2022-01-22 01:20:46-05:00,6896,FV9CBGGTbppLnBKh79f2LzD1diTiS5g6u89FcpZHZmnK,Fe7mtmCUziFqbbYTvrhAcAq1Ub7YLfTJRtQ1hG7GzJD1,True,235151,58787,357,178,179,DddJ7EWCmYEEZETCBNgAUSg81Ls6fZtiAaY5ekJ5sXx1,14299,159813,-145514,608
2022-01-22 01:20:46-05:00,6897,C2Dmfw4G8KKzFq38aRH2pLCRngnGZDvUUN3fHDMjFkoG,7kzJk3BTNvY3hGFNj7nDy9L5CAYus6eNiCAxWH8dSioX,True,15927,3981,21,10,11,DddJ7EWCmYEEZETCBNgAUSg81Ls6fZtiAaY5ekJ5sXx1,864,15068,-14204,542
2022-01-22 01:20:46-05:00,6898,U3vvMQ4X4aKzVYfhMw1V1p58HRqaLnuXozqmmefYeD9,7JA94MArkNCFRhBq8f5a32DgMF6aPdFsoC5HvXDQ6NuR,True,13571973,3392993,20510,10255,10255,4BnQKPLuE3DMTtxp8MjUBytgnhvxqq3ZTqZHTVZo4JJh,820408,11420484,-10600076,604
2022-01-22 01:20:46-05:00,6899,GABCjRvhnVZwwR9aZLhkTfaH9xdp2hJK7J6h4kD5VzkC,JabV7oy3dp6jshtccn89ybinAuaf9dHVmKuiEjXDPT9,False,2695569,2695569,117830,5891,111939,4BnQKPLuE3DMTtxp8MjUBytgnhvxqq3ZTqZHTVZo4JJh,117830,1950919,-1833089,437
2022-01-22 01:20:46-05:00,6900,24X28Jdpnxsm2L1SdqSMhRtEuqvou95nHVHFXrnsvMBn,7gRi4quFb53FxbQrACq2SHmAyi1iftkcFjxn4imaC6n5,False,1236762,1236762,56354,2817,53537,4BnQKPLuE3DMTtxp8MjUBytgnhvxqq3ZTqZHTVZo4JJh,56354,382642,-326288,455
2022-01-22 01:20:49-05:00,6901,BYvjENe16Ta77PqGV7JKEWrsqCTfkMGYwTSG5gXneDvd,EvxAXgvhPC6QkNurbK7vWyTApGo8J2R4EgMAknkHVU3d,True,133608,33402,202,101,101,4BnQKPLuE3DMTtxp8MjUBytgnhvxqq3ZTqZHTVZo4JJh,8107,128175,-120068,606
2022-01-22 01:20:49-05:00,6902,GZZ8WePhKCrJLhXXvRD21rp79pFiaJeGykVsyeKAYe9W,6P1C9RDFQoFqZ5eFo59UwVnNrnyAWaNnACNQMqR3uJhs,False,66381694,66381694,3107407,155370,2952037,DddJ7EWCmYEEZETCBNgAUSg81Ls6fZtiAaY5ekJ5sXx1,3107407,23927387,-20819980,468
2022-01-22 01:20:49-05:00,6903,DXCbqHqSGrq8dG6CmA5JwKXQTidVBSqE8vCxHxNBcF2z,6z5Ghi47Miuie5Tn72rLp4uBf1EALB8wPsmzrtb1DwZS,False,3772372,3772372,187603,9380,178223,DddJ7EWCmYEEZETCBNgAUSg81Ls6fZtiAaY5ekJ5sXx1,187603,1158165,-970562,497
2022-01-22 01:20:49-05:00,6904,7nByfyoLmMrzzVHsjxL2FRF72tfW3KiRT27BRGUp4PhP,36SF6NBnUc5wK41yfGCnujpCaCwExR3iRXJQx1WNakyM,False,1853472,1853472,84726,4236,80490,72FwbpFGoLEazJEdpqNtPNefsadUrimUqma9wSoy4qiS,84726,774127,-689401,457
2022-01-22 01:20:49-05:00,6905,2BH44k4TYoQSqsSs5EASqJhxpH17Fr8Ahxbg2MAkWa72,HwvvVWpqfN7NDsVYdxbCSbqxSrLCThwnJiZQHh2w2zJb,False,836,836,39,1,38,DddJ7EWCmYEEZETCBNgAUSg81Ls6fZtiAaY5ekJ5sXx1,39,589,-550,466
2022-01-22 01:20:49-05:00,6906,Ehw3RgdbzyAHHddgSv7F6f3WtYhyBtRg2ropQaWGgwcL,GGw3xDe5jKd5UNB9bPLqp2xzw2SKz7CMg358Fy7UypDL,True,719690695,179922673,948288,474144,474144,DddJ7EWCmYEEZETCBNgAUSg81Ls6fZtiAaY5ekJ5sXx1,37931547,359100162,-321168615,527
2022-01-22 01:20:49-05:00,6907,6xbPoFjPYUcSejbTk5iiTZRWyZkicfkSzM1Fhbj3w9L5,7xTAbaXwhxxVY3TM88TLakPPwPyL4zT4TsVvtUvniVec,True,166653713,41663428,210696,105348,105348,DddJ7EWCmYEEZETCBNgAUSg81Ls6fZtiAaY5ekJ5sXx1,8427878,53747261,-45319383,505
2022-01-22 01:20:49-05:00,6908,FpqCxvTkSiwDwD5qEt6hXJxzFDLFLAQ8VevK8zwRqYun,A3p6YQisCJKpNkF7vkjZRbEfbnUt7vTZdR2zPBUSdTkk,True,17612482,4403120,23425,11712,11713,DddJ7EWCmYEEZETCBNgAUSg81Ls6fZtiAaY5ekJ5sXx1,937014,11517028,-10580014,532
2022-01-22 01:20:49-05:00,6909,GGGyesjbt7h2XHHp9u8vpiWGugFwEbrtYaKrNQSDhQd7,8tydo1ZjGHmPBSqU33tywB3f9szdsHk1ckGFe4Ay5pgs,True,2165828,541457,2939,1469,1470,DddJ7EWCmYEEZETCBNgAUSg81Ls6fZtiAaY5ekJ5sXx1,117569,2444986,-2327417,542
2022-01-22 01:20:49-05:00,6910,FLTW9fwjWqGPm5PiE3C9LFzwZxtDh8c2MnEoRq8W7MfQ,GKsfzKBP2QkmoEWvTaUN1h4nqrT3kAcwYRC9WxW9bB3h,True,529176,132294,682,341,341,DddJ7EWCmYEEZETCBNgAUSg81Ls6fZtiAaY5ekJ5sXx1,27300,333246,-305946,515
2022-01-22 01:20:49-05:00,6911,D2L7ST8iGsRfZ4zj2pdfKTptbojQ4cDtHKQ8ngcFVQwA,7cNrHGWJ6FGGazfGaCePs8XyaK6bwVLrYFCUJQi9w2Wc,True,2903,725,4,2,2,DddJ7EWCmYEEZETCBNgAUSg81Ls6fZtiAaY5ekJ5sXx1,160,2064,-1904,551
2022-01-22 01:20:49-05:00,6912,BXMMFy2k9b2hVBEG6RyXAq3qqXxJ7EY2xhyPZqtLvBiU,KpoZwr4ZFTHJgebbf4tcjT9iKvpC1EF8Aw4uaVPxXNd,True,2799650,699912,4081,2040,2041,72FwbpFGoLEazJEdpqNtPNefsadUrimUqma9wSoy4qiS,163258,920810,-757552,583
2022-01-22 01:20:49-05:00,6913,2QStaRnbSnDhA891Lb1bxjVeMYpJUpNdqaVkw3rqU45V,DakRWPnttPoRcjY5V7WLwiwBx39BapCo9Atog8dL17Ku,True,97156,24289,129,64,65,72FwbpFGoLEazJEdpqNtPNefsadUrimUqma9wSoy4qiS,5198,58387,-53189,535
2022-01-22 01:20:50-05:00,6914,GaEpNGa8jnwSRvjzzEMYkZe1pKcr2eiZtePrqFxpABjB,5CFZHuyWbJv14zPdX5dSQDREgHrCb4vsFvB6hLiEe3Ji,False,7093,7093,311,15,296,DddJ7EWCmYEEZETCBNgAUSg81Ls6fZtiAaY5ekJ5sXx1,311,5064,-4753,438
2022-01-22 01:20:50-05:00,6915,BLJgLzizx2yLgd12pVBAHTMqn9J5JA3JHCF8PnLnPyUk,HhDmwMysBFWhXnd3mrV31w75WBRKBS8wJSiEMZgqdUSp,True,44167977,11041994,66862,33431,33431,DddJ7EWCmYEEZETCBNgAUSg81Ls6fZtiAaY5ekJ5sXx1,2674506,33586729,-30912223,605
2022-01-22 01:20:50-05:00,6916,HhwiZPKZBGa16oVi739s4qtMDMTwzWXc7iwNfX63t2UP,5AnbMbAFKy85yHt5y2M5S38nNkA1vT4ejY5NjGbRNUqn,True,59400,14850,76,38,38,4BnQKPLuE3DMTtxp8MjUBytgnhvxqq3ZTqZHTVZo4JJh,3069,56545,-53476,516
2022-01-22 01:20:50-05:00,6917,EuvK7bsc3hbxqeJjJkLELCvS7kruCMAGDctn5u7Q7BnP,Dv4XTdwnp6Sv5zxkSwRwsdSzxApDtBr4A13x4vvzTVjm,False,2237082,2237082,109887,5494,104393,DddJ7EWCmYEEZETCBNgAUSg81Ls6fZtiAaY5ekJ5sXx1,109887,1627048,-1517161,491
2022-01-22 01:20:50-05:00,6918,DJiXXW7sjNsAAxWupDKBUsFhXSgPoerVYaAtJqqNgVbn,2MsqvNuJw1xQhJ3UnXt9i7oNHDuZpR9w7iE1WQcGqt5m,True,6289,1572,8,4,4,DddJ7EWCmYEEZETCBNgAUSg81Ls6fZtiAaY5ekJ5sXx1,330,3968,-3638,524
2022-01-22 01:20:50-05:00,6919,FX5sizQGZcDCaETDyJ3HbLxFwhu4t9bX6YyQM7cVEo9Z,6EqnCsv1JPjz6JX1yLNcf74rmkuhAUx6Sf35QMYGuuF6,False,10196085,10196085,441276,22063,419213,DddJ7EWCmYEEZETCBNgAUSg81Ls6fZtiAaY5ekJ5sXx1,441276,7171452,-6730176,432
2022-01-22 01:20:50-05:00,6920,EEcTbsFTUEifcdbPyjBLkS943daEx1RpR8F3uZxKRZbT,8V3JzDQ1VWYQLas8fxUsWJZZHe4gEmn74RehtUwLw3k5,False,229871,229871,11242,562,10680,DddJ7EWCmYEEZETCBNgAUSg81Ls6fZtiAaY5ekJ5sXx1,11242,184265,-173023,489
2022-01-22 01:20:50-05:00,6921,HPDN6Ro6gPgYbNgnv7yhFCpyY3uYzT18epFxRFNZ985w,3Jop74A52E7gYLXJRUAoPBzSZ6mmP2gmaCg7eG6eQHu5,True,47679542,11919884,70495,35247,35248,DddJ7EWCmYEEZETCBNgAUSg81Ls6fZtiAaY5ekJ5sXx1,2819816,22719127,-19899311,591
2022-01-22 01:20:50-05:00,6922,CagSUfZLwXuCdypC4KzU6FSNdmCj9dKDroPcNeaRtsyt,yxw5d1ztZuEUY2QjL7eLpr72QJAj5rJd6ERvg91cy1m,True,69895,17473,104,52,52,DddJ7EWCmYEEZETCBNgAUSg81Ls6fZtiAaY5ekJ5sXx1,4190,46998,-42808,599
2022-01-22 01:20:50-05:00,6923,5SskSWkRPP5BNaqvHkJCbTAgHPUkHEwFh5pFr4t8PoBr,EqdX8Sdm9LCfdrzVKzisKaFcP2YEdSRNZYmev5RWjGqb,True,168132,42033,226,113,113,DddJ7EWCmYEEZETCBNgAUSg81Ls6fZtiAaY5ekJ5sXx1,9067,80246,-71179,539
2022-01-22 01:20:50-05:00,6924,51yPLtXTgL9oLKs1cCf5TjL54Ld5vuVxat2NNtwZVsZG,7UjtM7Z1tiXEQMMiorQyncgi9SKu3v46DhVdgXbWqSiF,True,15317387,3829346,22063,11031,11032,DddJ7EWCmYEEZETCBNgAUSg81Ls6fZtiAaY5ekJ5sXx1,882544,19030582,-18148038,576
2022-01-22 01:20:50-05:00,6925,5rZTX6W9vTLL7uYzw8KWwY4zttCSQQTubfRn27QG7tBU,3Cdy8QmuBh7WvRxz18qAs1XVUU97ppqCyTS54huxGn2c,False,10481,10481,493,24,469,DddJ7EWCmYEEZETCBNgAUSg81Ls6fZtiAaY5ekJ5sXx1,493,7435,-6942,470
2022-01-22 01:20:50-05:00,6926,9fTuwsgtFHkUNTTeRR1DWYTno8bbdvNLvqjxLymzbnTe,DacYn36aCNRJmYKiP697yGJTPZDK1nCq7Q1Y7KiXW7Jq,False,132828545,132828545,6402955,320147,6082808,DddJ7EWCmYEEZETCBNgAUSg81Ls6fZtiAaY5ekJ5sXx1,6402955,57792296,-51389341,482
2022-01-22 01:20:50-05:00,6927,FKQVm9RsteDe7dQmwx4NGYhz3Wrvwh7TCp9rFbTgAomx,Dbwox8eRCdmH5KXyi5sBaqWzhxtaVPo1teWXJ2kRFT1f,True,29816323,7454080,44830,22415,22415,DddJ7EWCmYEEZETCBNgAUSg81Ls6fZtiAaY5ekJ5sXx1,1793203,34601883,-32808680,601
2022-01-22 01:20:50-05:00,6928,4UGy8TajoMVzJNVVgyG5HHGseVNd6StrpA4XptQdm5Ej,9iRZ44dq3w9kMceCkbzwYQAPv6Wxnk2yKV8WDo7QXHfu,False,1238616,1238616,60049,3002,57047,DddJ7EWCmYEEZETCBNgAUSg81Ls6fZtiAaY5ekJ5sXx1,60049,1071321,-1011272,484
2022-01-22 01:20:50-05:00,6929,AxjhBwz3yoP6bEtH1shjztXfMQwhTXyku2fk6oPYStef,6yB7A8yhvugS5fVnU7nYjJvU9KJWEQvT66TMCFTzWiP8,False,4445391,4445391,202553,10127,192426,DddJ7EWCmYEEZETCBNgAUSg81Ls6fZtiAaY5ekJ5sXx1,202553,2084654,-1882101,455
2022-01-22 01:20:50-05:00,6930,8pjAmnuqsXh8eP7XWphZmeCKYPGc8J2ux6u9VEGjjkPp,Bv67SHZoVqFhDZ7QRQLTUi1NR9zUPD9T7uw1zmoAuuTh,False,1000090,1000090,48494,2424,46070,DddJ7EWCmYEEZETCBNgAUSg81Ls6fZtiAaY5ekJ5sXx1,48494,946654,-898160,484
2022-01-22 01:20:50-05:00,6931,CEbGTNX6WpaoKp4RBGSn9LzYM6yAYyeiMrgVYgJxA4zb,AiXUcGAFFm4tc7vKBscSNjZawV5YJqbv7D1KpxD3Zufg,False,851212,851212,40337,2016,38321,DddJ7EWCmYEEZETCBNgAUSg81Ls6fZtiAaY5ekJ5sXx1,40337,745754,-705417,473
2022-01-22 01:20:50-05:00,6932,8nXbrdjjaHB73CRPRenGEQj73wbtEFGDwXsehRGMhsap,43pvdcJ6f27wz94D6ZboKwRJYbyvYCrjsJhYsvk7LJCM,True,2786696,696674,4286,2143,2143,4BnQKPLuE3DMTtxp8MjUBytgnhvxqq3ZTqZHTVZo4JJh,171469,1192378,-1020909,615
2022-01-22 01:20:50-05:00,6933,BPRoaqrDs8vhqv2T7d9qV2oPU33pi1K1LUaotM7yuD2i,6qo8uQGAEwBfYQR36v6nRiqA2xGV6SjJAsXsdzy5bqNH,True,44474187,11118546,57676,28838,28838,DddJ7EWCmYEEZETCBNgAUSg81Ls6fZtiAaY5ekJ5sXx1,2307040,33860532,-31553492,518
2022-01-22 01:20:50-05:00,6934,2FEbsetZMkRqLjSC8GBbgecKgX5T1T1fci2sLQux29p8,H722Fcd6DkTFRZxqQWbPDufBfXEgmFfhiEpQZWhxwYv1,True,208766,52191,317,158,159,DddJ7EWCmYEEZETCBNgAUSg81Ls6fZtiAaY5ekJ5sXx1,12681,142127,-129446,607
2022-01-22 01:20:50-05:00,6935,DiB9SeCFXjioNGPJM3GuZ3FCG9KBZhHK27zCSN5b6gkq,GtK8UtKDQy9jgtTXvam4jja9N7c4EFuDQr4TKHgNyhXT,False,188649,188649,9083,454,8629,DddJ7EWCmYEEZETCBNgAUSg81Ls6fZtiAaY5ekJ5sXx1,9083,143594,-134511,481
2022-01-22 01:20:50-05:00,6936,Fd2HrzBAr4JobRPARZwpQHHVoSCEoog32A6tKMWAC1sK,BYappsar5sQf8VLem4wrLuTtrDFH9y8pEx1aMxfuU4Pq,True,1292272,323068,1731,865,866,DddJ7EWCmYEEZETCBNgAUSg81Ls6fZtiAaY5ekJ5sXx1,69270,1035860,-966590,536
2022-01-22 01:20:50-05:00,6937,Ayx8dFsVzUBb9b7QKxw7YHJuhptdSitBXFEczXTaxe85,EvU1VLChnowi6ccSPeJRSk65njrqZfYouAN7SHePxsxf,True,1005,251,1,0,1,DddJ7EWCmYEEZETCBNgAUSg81Ls6fZtiAaY5ekJ5sXx1,56,832,-776,557
2022-01-22 01:20:50-05:00,6938,D3mXrJzhHf8qRaoCKLschUxAFoijFCFuT6bmNZH4W7Cj,9E3Xtqw7TncXWnbhAbFJMtuNmP6WS3ooGuptzyzw7UpA,False,2695,2695,122,6,116,DddJ7EWCmYEEZETCBNgAUSg81Ls6fZtiAaY5ekJ5sXx1,122,2399,-2277,452
2022-01-22 01:20:51-05:00,6939,CP2qcTSw1Y5J7jZiEgbtsvJoigRbJ4m9oHGQS8Fiai2x,7Zd1uX1thbuGkp9H4r1t8aLTu9W8MxvUBNjji2FNJa8E,False,2337962,2337962,101911,5095,96816,3zqXX6kzhkbW3d4TwD2CNjMRwxTbREXySekvq37kfCNk,101911,1649200,-1547289,435
2022-01-22 01:20:51-05:00,6940,5XrU9QLKHL8m66mpfcsqvndBBeQ9t8vA7zhNdB1yAi9s,3FDocKqsT3aUigiW2P7MESU8anAYqg1D9domHCDsxCB1,True,287212594,71803148,391538,195769,195769,DddJ7EWCmYEEZETCBNgAUSg81Ls6fZtiAaY5ekJ5sXx1,15661526,71282742,-55621216,545
2022-01-22 01:20:51-05:00,6941,6BQVtmNsxihi4PcA7MurtguTwa6SmbmKyP14RHyjVZkf,7ZFv5ms4HzVKiw7KgE8RUoKxW9rB6JUD7ujZxMx4DwnM,True,143249,35812,215,107,108,DddJ7EWCmYEEZETCBNgAUSg81Ls6fZtiAaY5ekJ5sXx1,8633,90620,-81987,602
2022-01-22 01:20:51-05:00,6942,75ycx5sUFBxDhY1uwuPCW22s2C6BydkJTje7q7zEQFGT,FpEgrVFRubjGK4DRjTqdVbxSECURpn16zfpoC31NbwnN,False,296746,296746,13257,662,12595,DddJ7EWCmYEEZETCBNgAUSg81Ls6fZtiAaY5ekJ5sXx1,13257,251001,-237744,446
2022-01-22 01:20:51-05:00,6943,4wYJCHSQDev9kD8UVUEy3gEm9owvBCmXLX8QfTAXSyfd,4AUFhPprSux7rN1DVv6KXKxAGVAevx2DwCEUCpx2BAaw,False,991828,991828,47857,2392,45465,DddJ7EWCmYEEZETCBNgAUSg81Ls6fZtiAaY5ekJ5sXx1,47857,637904,-590047,482
2022-01-22 01:20:51-05:00,6944,CAkknoa9UFPMEZ1KWSfqtmnL7ArVNV3HRETLwecuuXP,4cHJYv3dxA6qjcuxUkGRuL7STWobGPKtoHFD4ACUbiWq,False,487842,487842,22409,1120,21289,DddJ7EWCmYEEZETCBNgAUSg81Ls6fZtiAaY5ekJ5sXx1,22409,342566,-320157,459
2022-01-22 01:20:51-05:00,6945,9Hz4p7gcfDbXBJp8KzhaBBPh9i7xe9kun7zLfDtqPe6c,2bJ43Lep6kp6WY7Ct56oiscKnAbdtC265G5yRvRPFThU,True,41044968,10261242,61903,30951,30952,3zqXX6kzhkbW3d4TwD2CNjMRwxTbREXySekvq37kfCNk,2476123,18055215,-15579092,603
2022-01-22 01:20:51-05:00,6946,Es6UDmhJTnRsCUCFBtSfc4KYhFBPAVtBuX2EN2DS3FsH,J5gi9V4pQq4ke9tun4pf4oJPVtVPfYUKRX1RArAJMVLv,False,116901245,116901245,5824839,291241,5533598,DddJ7EWCmYEEZETCBNgAUSg81Ls6fZtiAaY5ekJ5sXx1,5824839,36832374,-31007535,498
2022-01-22 01:20:51-05:00,6947,4FazDUgfQ3AKoFcnWHr8E9Ht8jLA3tkxf75yrGZVHdmF,HzRMH6mbgEKydRCnnMvSsKgTEVNQi6nuzoR1xutYFdzg,True,2633,658,3,1,2,DddJ7EWCmYEEZETCBNgAUSg81Ls6fZtiAaY5ekJ5sXx1,135,2854,-2719,512
2022-01-22 01:20:51-05:00,6948,8BMDSWFtzq9fu1ubVGtSFw8fEaMg1uvJiECuJnN8e1pd,FwkETAXL296CirvQ2AJuSHHtdKsxkZkmXSwZVVHXVDhA,False,6063284,6063284,275974,13798,262176,DddJ7EWCmYEEZETCBNgAUSg81Ls6fZtiAaY5ekJ5sXx1,275974,4235489,-3959515,455
2022-01-22 01:20:51-05:00,6949,BZwH7dXogZ1qX5RWqAyiMi8f99fGmebwM56C3QkWRqDd,3avt3UeuxPZj65bCYKotbqAyr5L2ycfkbQp9Z75xqAkN,False,4329,4329,185,9,176,DddJ7EWCmYEEZETCBNgAUSg81Ls6fZtiAaY5ekJ5sXx1,185,3050,-2865,427
2022-01-22 01:20:51-05:00,6950,E8ifvhmyJGBGVQomo3AnZw2UcaLHcpGsTtuoCid8voU3,FMQUWTbTAfSLfrc6GTrz4DM2ZSgoxF3KtqGn8AyjVtsf,True,305533,76383,419,209,210,DddJ7EWCmYEEZETCBNgAUSg81Ls6fZtiAaY5ekJ5sXx1,16797,197117,-180320,549
2022-01-22 01:20:51-05:00,6951,C4dbwF9mioaBkZnyBFvFs6Cqd362VuGPBGPbTY9CAnAk,CcUqBfu1hbWm5VVxbtF2Xm6HUz4CLFzuDsjUi6KtnZQg,False,76372,76372,3674,183,3491,DddJ7EWCmYEEZETCBNgAUSg81Ls6fZtiAaY5ekJ5sXx1,3674,41342,-37668,481
2022-01-22 01:20:51-05:00,6952,6tFQaTqqffino9kwMZTL2xVNBG8k9VREFhXqVi2si3A3,3w3wGxBbS4bmXeqmvd595SAWFeXekVpnH4UdbeEs8Sx5,True,188106,47026,254,127,127,DddJ7EWCmYEEZETCBNgAUSg81Ls6fZtiAaY5ekJ5sXx1,10173,122675,-112502,540
2022-01-22 01:20:51-05:00,6953,6u6bPgAmK8ufACrQV99A1Y5nhGkue3KEUHmQQkcNkxwP,7636yXT5w4DcVpc7LJdN46aiggzSq6U2GXHXL5kyy9F3,True,5089071,1272267,6768,3384,3384,DddJ7EWCmYEEZETCBNgAUSg81Ls6fZtiAaY5ekJ5sXx1,270720,4087922,-3817202,531
2022-01-22 01:20:51-05:00,6954,AM5fwZR9BUW8AFkhdGWXW4PHd2cy8ora63kDf2z2eknw,E7ru6hg4MchnRG5zcr5YazwX8Snt55r5Xq9zCHCGaYZT,True,41003,10250,54,27,27,4BnQKPLuE3DMTtxp8MjUBytgnhvxqq3ZTqZHTVZo4JJh,2185,32453,-30268,532
2022-01-22 01:20:51-05:00,6955,EeUACm9TkjHKES5U7Yj1oPhYmcp7R3tvesGBiP8txEzq,3qkmm4aS6EDirEDejmbm5PDw2jpYkC7zKqrMkmgeE5BA,False,10763,10763,487,24,463,DddJ7EWCmYEEZETCBNgAUSg81Ls6fZtiAaY5ekJ5sXx1,487,6874,-6387,452
2022-01-22 01:20:51-05:00,6956,A7HnmwpMzu9yYuvURa1Zct5JUoFujFybc6Ympjciuz99,E41s3xNbU4haxQQjR8nXZwTpJCoLiJ2BJSncHDfc6HzS,False,25893137,25893137,1174420,58721,1115699,DddJ7EWCmYEEZETCBNgAUSg81Ls6fZtiAaY5ekJ5sXx1,1174420,15322686,-14148266,453
2022-01-22 01:20:51-05:00,6957,BJV5jbowrbELXfDvfMovaQy4PiRf12pLYHimW9bgzW5X,6WXrWso5FvLx7RMCFBzrbzh5qevKkk2LJAihUfWXxXzB,True,935422,233855,1425,712,713,DddJ7EWCmYEEZETCBNgAUSg81Ls6fZtiAaY5ekJ5sXx1,57015,1120503,-1063488,609
2022-01-22 01:20:51-05:00,6958,6XHt7CrURSomkQrtVXV5JuKSZY4tQRpUyQKfCDaSTYaD,GCgcmPSDDBsn2smYbpiX3PJybDkQWtufPu4YRsbEEU8X,False,15716367,15716367,715596,35779,679817,DddJ7EWCmYEEZETCBNgAUSg81Ls6fZtiAaY5ekJ5sXx1,715596,14978884,-14263288,455
2022-01-22 01:20:57-05:00,6959,4miF1JWfTjjFHkrpffjGFGVfkkWFME4smk47dEcxpH4y,c4QGrEkmzRKVDbYJe3FuQfrzqBqajt8mnaKJYF2Fy3t,False,194314643,194314643,8911749,445587,8466162,DddJ7EWCmYEEZETCBNgAUSg81Ls6fZtiAaY5ekJ5sXx1,8911749,63747700,-54835951,458
2022-01-22 01:20:57-05:00,6960,5BjBPqumCb9KC82ZNNch3dcRzbpGdRLJneru7o9a1D9R,FuZtBWKktxFu4yoiLVMzxq8fMhQyN8SGzGPz49xs3m6P,False,6327644,6327644,314503,15725,298778,DddJ7EWCmYEEZETCBNgAUSg81Ls6fZtiAaY5ekJ5sXx1,314503,5100436,-4785933,497
2022-01-22 01:20:57-05:00,6961,2kqN3TbCDgM4x8XfZvKgqJvDAHqvZxtT89NcfmQSQa5b,8fEx56PjuPAP61CBnrsnnnQnZmt8cw6KVjhYDK1mWJzP,True,24496963,6124240,31266,15633,15633,DddJ7EWCmYEEZETCBNgAUSg81Ls6fZtiAaY5ekJ5sXx1,1250658,10450629,-9199971,510
2022-01-22 01:20:57-05:00,6962,B4Uc39nKzz9wBRQsCkMR4A7RwTJ8rSuwpR6EQn2AesRb,H49bGZgatRZVpj6QufZRVgYrQtH7LpdbiqKBs23151m,True,1118302,279575,1705,852,853,4BnQKPLuE3DMTtxp8MjUBytgnhvxqq3ZTqZHTVZo4JJh,68219,1447386,-1379167,610
2022-01-22 01:20:57-05:00,6963,ECuu1L4QGdemZ7FjAjVAAxYN6piinweY7Fuk5csVovfT,Amd8WGcpdtB8yoA83R1BUT5uryuqoKbcBexYacbrbGVX,True,131083,32770,166,83,83,DddJ7EWCmYEEZETCBNgAUSg81Ls6fZtiAaY5ekJ5sXx1,6671,86204,-79533,508
2022-01-22 01:20:57-05:00,6964,JCagxpXPs6wVRUWbNBPCZ4uLCkZsachnofN7SZEEwGwB,5uGj1TBCkc7FV4ffdBJg31yLcCxkQLxRExjcinnJUow9,True,3623226799,905806699,5178515,2589257,2589258,DddJ7EWCmYEEZETCBNgAUSg81Ls6fZtiAaY5ekJ5sXx1,207140628,2617744228,-2410603600,571
2022-01-22 01:20:57-05:00,6965,FjDp4bWCtqehFD7FunCrjrcdxMezTJj5aqh2VnBvHDQU,HRYeZqcqhP1RPiAGXziR1qCWwk4sF6c5ZYbvSDhX7foN,False,344412,344412,16591,829,15762,4BnQKPLuE3DMTtxp8MjUBytgnhvxqq3ZTqZHTVZo4JJh,16591,235901,-219310,481
2022-01-22 01:20:57-05:00,6966,4MmpDGUTyMcYEqJ1RoZ46AN2BhrBUseHaHqF8AmiTPyD,7HW2YZpYM349HMfW7u4h9ESZ1AXkwN8JcVDTNFzp9aTz,False,5591240,5591240,252920,12646,240274,4BnQKPLuE3DMTtxp8MjUBytgnhvxqq3ZTqZHTVZo4JJh,252920,4700815,-4447895,452
2022-01-22 01:20:57-05:00,6967,GWkVXmZNQdcdWNNu8dvRqct4aMhLoDNqijrTvxbfEdKN,6LKRNbJv2XkyjJQKCFAqFRPzvANrRBSTmu8doRWqTicU,True,4656024,1164006,6068,3034,3034,HfEnetJ7uBSmZWCjBNxdvv9HEC5nsW4wDV7wu6WnhWan,242722,2065775,-1823053,521
2022-01-22 01:20:57-05:00,6968,4hrm69kAKNcfBkiP2YgtW94Pbip6FLfQAwnDRAAack69,BjbZRdGMoC7Mfoa4H19UvE2eQafgKD5rqnK7BSGwqS1s,False,1581,1581,76,3,73,DddJ7EWCmYEEZETCBNgAUSg81Ls6fZtiAaY5ekJ5sXx1,76,1136,-1060,480
2022-01-22 01:20:57-05:00,6969,6yw4GPvkqUbakcEWtqSCfjVLukty11xqjDpGxtEN9Km2,5ppEx7wkpqbG5nApCWMdRja3oRSheFmAAsNHUX7h2w2Y,True,70874,17718,95,47,48,DddJ7EWCmYEEZETCBNgAUSg81Ls6fZtiAaY5ekJ5sXx1,3828,90613,-86785,540
2022-01-22 01:20:57-05:00,6970,i7TcF4weYcqgrRdH3GpndbEYxCxfcSfr9JWYrAUg1CF,BkDfknUir7PnSEW8auoB87PytycEFwyX5kT2GY4SGJJL,False,245970,245970,10537,526,10011,4BnQKPLuE3DMTtxp8MjUBytgnhvxqq3ZTqZHTVZo4JJh,10537,293059,-282522,428
2022-01-22 01:20:57-05:00,6971,6h43GsVT3TjtLa5nRpsXp15GDpAY4smWCYHgcq58dSPM,CTgbWridYWnfE5Emwr7qiCEb3LcXHupqeB9zwmddoEqB,False,7383663,7383663,318057,15902,302155,DddJ7EWCmYEEZETCBNgAUSg81Ls6fZtiAaY5ekJ5sXx1,318057,8365074,-8047017,430
2022-01-22 01:20:57-05:00,6972,F2v1YwVAwXLiUgsJ5uwn4qAAkTXitn1E75fJcPnGuAcy,5rdJ4H5GxPg4Juu77mGc7uya5LwEqLzDSRyG8mQ2mDbK,True,827519,206879,1098,549,549,DddJ7EWCmYEEZETCBNgAUSg81Ls6fZtiAaY5ekJ5sXx1,43920,663236,-619316,530
2022-01-22 01:20:57-05:00,6973,AKxRtcdpi7gWhAuL8ENj7zhgeQezzEXe9TSANE6bQoRA,2YH4vrU9deP8Cu6E8Hzf8GqKG1yVjv5pdz4FE7r5YKir,False,318592,318592,13945,697,13248,HfEnetJ7uBSmZWCjBNxdvv9HEC5nsW4wDV7wu6WnhWan,13945,225537,-211592,437
2022-01-22 01:20:57-05:00,6974,7vKmhLV45Q5etXhJL5ng8rxWhYSiUCDmAbGnwBPr7zcx,cP6xPeuHLnjr858QK1F9qYn7rJpEbPy7wEJHoju6oV7,False,2013497,2013497,87362,4368,82994,DddJ7EWCmYEEZETCBNgAUSg81Ls6fZtiAaY5ekJ5sXx1,87362,1440036,-1352674,433
2022-01-22 01:20:57-05:00,6975,7LRBswSEDBjJzQ4YurfTxLydh7tFS2jVn5V95Z6wL7ci,fD41VYGmk66MW46KKb23vAqQvUSDScgXnVdsHhJBZzu,False,5490,5490,253,12,241,DddJ7EWCmYEEZETCBNgAUSg81Ls6fZtiAaY5ekJ5sXx1,253,4400,-4147,460
2022-01-22 01:20:57-05:00,6976,2ce2v2TCbjNH635NgbwTG3sqiRWYrRRaBpxPxBZJ929q,9cnoebT43FkWDFhidndGCVNiFD4NErv8DuL1Va4Jv9S8,False,258390,258390,12709,635,12074,DddJ7EWCmYEEZETCBNgAUSg81Ls6fZtiAaY5ekJ5sXx1,12709,294831,-282122,491
2022-01-22 01:20:57-05:00,6977,91tPxdvLhrVtytKuNkf33XocRnpEqA1x3jDb1Je6xeui,2ByoMpaZg1uzkA48vMufvcx8BLYxWLXUK3tXAJcupanF,True,1356,339,1,0,1,DddJ7EWCmYEEZETCBNgAUSg81Ls6fZtiAaY5ekJ5sXx1,69,952,-883,508
2022-01-22 01:20:58-05:00,6978,6oroGB3mvzK3tDfiB9X2NJuL3x476pxhgRnt7VxqhdLo,2SoK8tKkLn2ppKURpTVazKsCEis4uahkHMsac1m85J4r,True,77390,19347,113,56,57,DddJ7EWCmYEEZETCBNgAUSg81Ls6fZtiAaY5ekJ5sXx1,4548,96278,-91730,587
2022-01-22 01:20:58-05:00,6979,CCi9urfx5bFFMazAAVz1WtJzJotHA8E1i8RrtgMP97Fp,2DFvm5fZj29qvqoLmbReUaisd9qBTNUfuE7HgmmHUc7w,True,3407357,851839,4753,2376,2377,DddJ7EWCmYEEZETCBNgAUSg81Ls6fZtiAaY5ekJ5sXx1,190131,3066660,-2876529,558
2022-01-22 01:20:58-05:00,6980,CCHzYXr5zMXFu8MMZNkfUWGyUcF8xy7Vvhq7tNCtZg2L,AuEXkCJTTJ3HK8iP4qTWpQr4vp6HPRJZyZwfRjF8zjfp,True,6290,1572,8,4,4,DddJ7EWCmYEEZETCBNgAUSg81Ls6fZtiAaY5ekJ5sXx1,327,3966,-3639,519
2022-01-22 01:20:58-05:00,6981,84SgzR8J6DeqPJ1uXphP1BHMotYGKh3kS4owMMj9x58x,CL7Jkwe3NK4qaAVK2QjuftXnQ5YLqDT9qYeeEi7kJXrV,True,16285338860,4071334715,22533192,11266596,11266596,DddJ7EWCmYEEZETCBNgAUSg81Ls6fZtiAaY5ekJ5sXx1,901327708,13581200511,-12679872803,553
2022-01-22 01:20:58-05:00,6982,8nwpM4BmiMV8t2GgMnNy8zhPwBLM8xcBnCNTHyPySbuA,2bVCmJNzMi7ZqTfRB6Nwbk9omrY7urgPuDFvTVeVxc94,True,11490,2872,14,7,7,DddJ7EWCmYEEZETCBNgAUSg81Ls6fZtiAaY5ekJ5sXx1,585,3756,-3171,509
2022-01-22 01:20:58-05:00,6983,6SqJHnwgDCdUdUercq1UushY4tKpbJPKTapGM3ub7Sgm,8MQCsx2SzMUCBWkbriEgkP2ooWC6MDRJvT23xLYEYHTe,True,5201594,1300398,7429,3714,3715,DddJ7EWCmYEEZETCBNgAUSg81Ls6fZtiAaY5ekJ5sXx1,297178,4094678,-3797500,571
2022-01-22 01:20:59-05:00,6984,H6fVnghBUSJRKp2mxSG7Fq2Lr4dE3YMS7yM1XTrxoe3Z,JjgtLi79grUZXofhWukB1yNXZkXFMUX5jm9HcXNDsB6,True,1300823,325205,1741,870,871,4BnQKPLuE3DMTtxp8MjUBytgnhvxqq3ZTqZHTVZo4JJh,69658,770895,-701237,535
2022-01-22 01:20:59-05:00,6985,E9FFPvygPSF22u7gqFq4w6yE5kV15zbeGDXFQc349RsG,yi1REPVUwKhr5ss5YJc56crYz8LVfkqNVMpKcdSfwfY,True,71713,17928,90,45,45,DddJ7EWCmYEEZETCBNgAUSg81Ls6fZtiAaY5ekJ5sXx1,3604,38803,-35199,502
2022-01-22 01:20:59-05:00,6986,HqYn1PU7foJ9daTJMbd19LjTqWR2vQ1XqMEmffM2kCFA,8o6U7rDTtzSvywjzENEZSDYxCf7XK85rueCYVM4vZjY1,True,23460849,5865212,31496,15748,15748,DddJ7EWCmYEEZETCBNgAUSg81Ls6fZtiAaY5ekJ5sXx1,1259870,20784853,-19524983,537
2022-01-22 01:20:59-05:00,6987,DdAPWdHnb7ocaYtcwwwYnppsH39sZpmzMyANeoJbCV7s,3BVmC39L8dEypPN1BZhsf9bx9Ge2sXCZR8Y6RH4eBNMJ,True,45436756,11359189,65102,32551,32551,DddJ7EWCmYEEZETCBNgAUSg81Ls6fZtiAaY5ekJ5sXx1,2604117,49478327,-46874210,573
2022-01-22 01:20:59-05:00,6988,GhV3DChNShu8mGwUUy7VLidabCV6Y2aKdp7cqPynd6Ci,8R8QkgruGRCeE1pjXmn3WjdVDiawNbXFid8gU8BfabZA,False,831,831,38,1,37,DddJ7EWCmYEEZETCBNgAUSg81Ls6fZtiAaY5ekJ5sXx1,38,583,-545,457
2022-01-22 01:20:59-05:00,6989,9rfebymEFqy2SoBoDKKUppZVRPr1zNh6gkFYkmVsqbqz,6pQ3MsewzM8jzKEQG5zJDry8iEMUjGA1UDJPEQjFWTgR,False,384905,384905,16826,841,15985,4BnQKPLuE3DMTtxp8MjUBytgnhvxqq3ZTqZHTVZo4JJh,16826,165028,-148202,437
2022-01-22 01:20:59-05:00,6990,2rCRdyfi65rpxRRmg7knaSb8t55FuPt3h8wF4Fzhy8MM,CLVY5nSG3jTdRo7tRSKgK9DJgW6aswfWKe4tLxzsENmb,False,29320,29320,1265,63,1202,DddJ7EWCmYEEZETCBNgAUSg81Ls6fZtiAaY5ekJ5sXx1,1265,19157,-17892,431
2022-01-22 01:20:59-05:00,6991,EV21gv8jEvXtmGDoGRNm5LJEvTBccLMZyVDCLsp54jP3,DGxxoU52aQNoUQcxdvQtv2H5q2PhK6TGkLgNSaFgnZrb,False,207715,207715,9343,467,8876,4BnQKPLuE3DMTtxp8MjUBytgnhvxqq3ZTqZHTVZo4JJh,9343,152488,-143145,449
2022-01-22 01:20:59-05:00,6992,Ck946unSEhqFVgSURskkU3J1yd2TqWbk3nYuZRTzohLb,6mbR3HfdmSK9deU7L64vDti4p9bVZkZgQsBCtPrD9BV,True,674764586,168691146,912961,456480,456481,DddJ7EWCmYEEZETCBNgAUSg81Ls6fZtiAaY5ekJ5sXx1,36518470,152053884,-115535414,541
2022-01-22 01:20:59-05:00,6993,96StvqZyFUPtyMr4o9s7K4V29RSNyRpVi76vNwxG5rUf,GZKXFSFq4aGiTaqovtxqNCCVGkAFNXPh4Hep1ZMwdZ8g,True,997550,249387,1523,761,762,4BnQKPLuE3DMTtxp8MjUBytgnhvxqq3ZTqZHTVZo4JJh,60930,1253466,-1192536,610
2022-01-22 01:20:59-05:00,6994,6rb3fRVWJ5cSzFcmuC1YwdrNxiNctvboDF7HwsfyGoCA,H6JaYfFZkRk6iSJrA4nVeuFpMVQtVwQZHVgK1TyaupTE,False,2502,2502,106,5,101,4BnQKPLuE3DMTtxp8MjUBytgnhvxqq3ZTqZHTVZo4JJh,106,2845,-2739,423
2022-01-22 01:20:59-05:00,6995,DdEiAJ4pcXU213GVEa5KeDonBXZhTV7zeNcKigEQwN8Y,FoAs2bsVjQFKaJW7dpVKMxoJf7Qe5PcuH6i9jJzAR5e1,True,29369359,7342339,38255,19127,19128,DddJ7EWCmYEEZETCBNgAUSg81Ls6fZtiAaY5ekJ5sXx1,1530209,9485461,-7955252,521
2022-01-22 01:21:00-05:00,6996,BPsM1um9ZJf7eNoVMsQCRSwgARMuLCGGSDxf9tZeNeEy,BpzDdXfxVygiSYSmsHV6uPxQMeTFtrURMCCqhswQjd5X,True,52082,13020,78,39,39,4BnQKPLuE3DMTtxp8MjUBytgnhvxqq3ZTqZHTVZo4JJh,3120,35600,-32480,599
2022-01-22 01:21:00-05:00,6997,X5SF9srgzDgBRBhv8xUWyszYYSQiqFF6cVnVLWzQgp1,7rTqnMkPuUUJFt5px1DxwsUK8U5fQUtnx9N4v6dA4vGb,False,1540,1540,68,3,65,72FwbpFGoLEazJEdpqNtPNefsadUrimUqma9wSoy4qiS,68,1111,-1043,441
2022-01-22 01:21:02-05:00,6998,WMUVFELv3C3KdMKJ5ZL4rG7o1YrV1qTP6Mmp2S5Rp8S,7UNzS3zDqT1oeq9a7eJGU8cgf8eUzEAZubSBQvNmK6uJ,True,778631,194657,1051,525,526,DddJ7EWCmYEEZETCBNgAUSg81Ls6fZtiAaY5ekJ5sXx1,42069,352392,-310323,540
2022-01-22 01:21:02-05:00,6999,8MGEQ1KEMv9WSgVifjN7CQ7tDbJBJbWgGYu71dTDKEPQ,mQY2X9KYVXf9JmGY8XwMK4G8odM4HmWkgEmYYqKnkvF,True,7429608,1857402,11032,5516,5516,HfEnetJ7uBSmZWCjBNxdvv9HEC5nsW4wDV7wu6WnhWan,441318,6103353,-5662035,593
2022-01-22 01:21:02-05:00,7000,DrzTARa7RK8RXoxHZPKCBqYtMC8TAUHRw8SznXRKTa5M,FYANet92VhyXkKZqqBJR4sFxuCftWb68sgQU9VHCdTJk,False,1537,1537,68,3,65,72FwbpFGoLEazJEdpqNtPNefsadUrimUqma9wSoy4qiS,68,1074,-1006,442
2022-01-22 01:21:02-05:00,7001,8mbMH9EKd9kQDyFrYiDJCV9VaWxWCzpZBQZLyYN2yNVx,J9gT39dF1egMeQvweXYWeRAX3kpmBABijYZhfj6M2UqU,False,1047080,1047080,49068,2453,46615,72FwbpFGoLEazJEdpqNtPNefsadUrimUqma9wSoy4qiS,49068,655528,-606460,468
2022-01-22 01:21:03-05:00,7002,8xQ3tsWVUe75EG1HmocULJ3kh52utveoFMEPotTGrKno,i3SKW3ywrwYucX9ySEx1C4zaUKGnzLerP3V38437NyV,True,6094618,1523653,8227,4113,4114,DddJ7EWCmYEEZETCBNgAUSg81Ls6fZtiAaY5ekJ5sXx1,329096,5116082,-4786986,539
2022-01-22 01:21:03-05:00,7003,3WcJUt8jQ1ngL3ZCGo6dFrc3GmTMTYtzeDva7mri2Tqx,HeG1Pz2oMjqtkfsRMsbqP3VpatnVEQzcWmKDVoFp4Htr,False,935137,935137,39525,1976,37549,HfEnetJ7uBSmZWCjBNxdvv9HEC5nsW4wDV7wu6WnhWan,39525,689861,-650336,422
2022-01-22 01:21:03-05:00,7004,2jDRvE3pQNjWy1NRFa4tzB3KmU5UkbUCHw8sQRFujo66,C4zNi2szDrEEh4coTF3WRUghfP4ZwAVVSYTLWfkejQRu,True,29188921,7297230,45052,22526,22526,DddJ7EWCmYEEZETCBNgAUSg81Ls6fZtiAaY5ekJ5sXx1,1802094,18211112,-16409018,617
2022-01-22 01:21:03-05:00,7005,7MSzV5yy5FmrM4j1BcYSRiTGWfit1AJahheRUaXzz349,aPSTZLxBpVr3sucjbj95emRV2J1GrUWr7wbARYqJkQZ,False,191163,191163,9475,473,9002,DddJ7EWCmYEEZETCBNgAUSg81Ls6fZtiAaY5ekJ5sXx1,9475,119396,-109921,495
2022-01-22 01:21:03-05:00,7006,8GdYhwX26GRmVfGFCbJ3MJrH1UdneN2FNRUexhLsqprN,DpUTHSVucDPyCWoLCdpm8EFRZFiKL88tmnSiWG2TRpS8,True,10079887,2519971,15368,7684,7684,4BnQKPLuE3DMTtxp8MjUBytgnhvxqq3ZTqZHTVZo4JJh,614751,7388758,-6774007,609
2022-01-22 01:21:04-05:00,7007,3C2MZQKh9x4zNTCMbhhvoafGaFMwUooqfy9MCgPyXs6E,AHjgWKpYPWe6ketjDHDKFBFsKQiRJ41jnkuo39MVYxZo,True,9144534,2286133,13647,6823,6824,72FwbpFGoLEazJEdpqNtPNefsadUrimUqma9wSoy4qiS,545913,8272207,-7726294,596
2022-01-22 01:21:04-05:00,7008,brCL9pzP6q4b6rKgAH1AJbMoqffBWyXLX8oAnZDoi77,Dx4G5UP9jTb47JQypWJnv48mPTzhJvqPD1BtBtDT7TJF,True,348778,87194,505,252,253,DddJ7EWCmYEEZETCBNgAUSg81Ls6fZtiAaY5ekJ5sXx1,20232,138651,-118419,580
2022-01-22 01:21:04-05:00,7009,8NdcaYUC1X5CP7FMDip78uqtqmCt8GcZdCzLRTYTihmb,9Ei1K9bXWXSXcBfeX5exPSXGCAu62WSKzvnnd4wHvyVh,True,5638,1409,7,3,4,DddJ7EWCmYEEZETCBNgAUSg81Ls6fZtiAaY5ekJ5sXx1,304,4185,-3881,539
2022-01-22 01:21:04-05:00,7010,6Y1UoGwrKyKsScZQm9ng1rNrXXykKT82V7kUopc43kAy,8YtWQTTKymCESbPMWCP9TMehbMU25zJMtxt9grqrpbD4,True,1637083,409270,2235,1117,1118,72FwbpFGoLEazJEdpqNtPNefsadUrimUqma9wSoy4qiS,89401,2056027,-1966626,546
2022-01-22 01:21:04-05:00,7011,FF8rqfM9PTEjYiVFy8jS81weDRwdaYooux2uSa2LexrJ,JBk1JghH1gged1YpDbkczFXP9ka5ivYSkaYoVbbXD4kg,True,8103716,2025929,12280,6140,6140,4BnQKPLuE3DMTtxp8MjUBytgnhvxqq3ZTqZHTVZo4JJh,491208,6464534,-5973326,606
2022-01-22 01:21:04-05:00,7012,DMgD2KCEhTGFLUZ5GnfNcwfiiwKYbyVpoWiN6knMkCAf,5KU2vgBkPTNVHsSULjgX7ZkZS56U3Dy3xqLTxL5sUZJ3,True,61611130,15402782,93770,46885,46885,4BnQKPLuE3DMTtxp8MjUBytgnhvxqq3ZTqZHTVZo4JJh,3750810,58128618,-54377808,608
2022-01-22 01:21:04-05:00,7013,9ydHRjDWvWV2XqbXKKpeLDh2RV7WnQZWDTi4ahgDjGNh,AiJQBv4a1Z4w2rsRog5WTaKb4dTjAXfAvXcWoW4DztSW,False,2912532,2912532,127164,6358,120806,72FwbpFGoLEazJEdpqNtPNefsadUrimUqma9wSoy4qiS,127164,1219157,-1091993,436
2022-01-22 01:21:05-05:00,7014,M69XSefqeum2arinvHEqmA3L2XHWNFN17p4msRhRZXf,2vK15yYUANLSbAoiBfgJ9VLyqsmtEpd2iNytQjms8GaQ,True,11701577,2925394,17155,8577,8578,DddJ7EWCmYEEZETCBNgAUSg81Ls6fZtiAaY5ekJ5sXx1,686229,11469392,-10783163,586
2022-01-22 01:21:06-05:00,7015,EL9JxeMvWWLTdVC5QrZzSSgApEwv1nDhZc6yNmH9G8ad,EqSQLSFx1eKkTYAdv5XhekttqVh7TappXAHuv9EedCXq,True,4525,1131,6,3,3,72FwbpFGoLEazJEdpqNtPNefsadUrimUqma9wSoy4qiS,275,3257,-2982,607
2022-01-22 01:21:06-05:00,7016,9vcKW1GfrDZ3KLPh2pEVFF8ZyKqD1pJW1hiE8H98Av7S,C6Ki27mo4sCHu6u8UnR1p7WSgsTjFQxGGR9Lk9n5Rhjq,True,119970,29992,174,87,87,72FwbpFGoLEazJEdpqNtPNefsadUrimUqma9wSoy4qiS,6976,95244,-88268,581
2022-01-22 01:21:06-05:00,7017,CYv2hNAzvRak1LBSayFxMJEXoAQdMEZHnNpQLZ5G5RVo,HkvTQbtKxWv2E5z6MsViv1LS4jm8T286fiY1C7n6ZZ9C,True,364576071,91144017,490419,245209,245210,72FwbpFGoLEazJEdpqNtPNefsadUrimUqma9wSoy4qiS,19616777,313112452,-293495675,538
2022-01-22 01:21:06-05:00,7018,HGJoZvLakWfSDFwuvShNBc4kCf7nP7VqzyM3mELpbFEf,12Qn5jin7QvsBngXqYAv4UstyG3b6nRf1jsLp9Dp8G7k,True,700517,175129,1055,527,528,DddJ7EWCmYEEZETCBNgAUSg81Ls6fZtiAaY5ekJ5sXx1,42231,530820,-488589,602
2022-01-22 01:21:06-05:00,7019,8NJzKTpGqPYjGosrFgtAq3fEWx73pDYDsae6xcWDWXLd,HKrgS9rZmC5K2BeGo4AACwu37nkUDCeePN7vVJ76wvuF,False,113016337,113016337,5634393,281719,5352674,4BnQKPLuE3DMTtxp8MjUBytgnhvxqq3ZTqZHTVZo4JJh,5634393,86598462,-80964069,498
2022-01-22 01:21:06-05:00,7020,89CkXnSZnr52Zsoh48efv9MQacrkB6GMtrbEpNJSyA2H,HcvRBS4Z22CpYgDNgm4TVF4AVXFDuYzBUAFcdHAwdpg4,False,139488,139488,5972,298,5674,HfEnetJ7uBSmZWCjBNxdvv9HEC5nsW4wDV7wu6WnhWan,5972,98770,-92798,428
2022-01-22 01:21:06-05:00,7021,B8kSMCHEX64joQD9EWuQFN15QunybWnKiiE8DuGZyMLk,EkKznVWgH3CLUXJk1uVWZUMvBRVPXakAVDwHXZwfm3bA,False,34120105,34120105,1581195,79059,1502136,DddJ7EWCmYEEZETCBNgAUSg81Ls6fZtiAaY5ekJ5sXx1,1581195,17779178,-16197983,463
2022-01-22 01:21:06-05:00,7022,HjkXypCkrCSprGVXBkrbHMZJji2gMToLvCLweRhcH7Vs,2ddyaPR86fCsVf4VJRG1VdZgdkY84TzXb8NMPqRyDqzV,True,31024918,7756229,40175,20087,20088,72FwbpFGoLEazJEdpqNtPNefsadUrimUqma9wSoy4qiS,1607039,11059852,-9452813,517
2022-01-22 01:21:06-05:00,7023,ymyzGH4Qc7HH5PbKpVphCbsQgLLXyGkPcXamQJuNj5C,8oTLHaV2XzbKXNWRuUjCfHjUn61Pw93LYK14m9q2VDpZ,True,594078,148519,889,444,445,DddJ7EWCmYEEZETCBNgAUSg81Ls6fZtiAaY5ekJ5sXx1,35598,399826,-364228,599
2022-01-22 01:21:06-05:00,7024,o2aCmkxsxSiyUX8soTEjwUCbJeXmCZsEaf8CWwxDT5n,3pvS2bTsUuiQyqZp5rdnTpq4cqWGgtv4E5rN9HsBxpRt,True,1033,258,1,0,1,72FwbpFGoLEazJEdpqNtPNefsadUrimUqma9wSoy4qiS,62,580,-518,600
2022-01-22 01:21:06-05:00,7025,3REbHhGGpn5b2GH67yQy2Dn7ZLNGLfM6hkBNU8UE1BRm,FBeCamJw884cPNpzbzhjSF7CFXyyhjnj3qWWCdBCK1NP,False,276053,276053,11932,596,11336,DddJ7EWCmYEEZETCBNgAUSg81Ls6fZtiAaY5ekJ5sXx1,11932,118815,-106883,432
2022-01-22 01:21:06-05:00,7026,8VnGmfop6qcUezAJ2M15jz2Nn6mPQgehDcJPvypq4XJn,6F6sqXNhgkW9ev8QNMm4ydywUUmemhwgydRQYNeqyUmi,True,454156,113539,601,300,301,DddJ7EWCmYEEZETCBNgAUSg81Ls6fZtiAaY5ekJ5sXx1,24078,572189,-548111,530
2022-01-22 01:21:06-05:00,7027,9k5YHTFCHczFg6KAZXf2ostkFLH7WdVAxiA9zCGRprg3,2b52r1TA8dkJsnuMuM9cNfGxKEynd42WjQUuzcQTRcD9,True,2734,683,3,1,2,DddJ7EWCmYEEZETCBNgAUSg81Ls6fZtiAaY5ekJ5sXx1,143,1956,-1813,523
2022-01-22 01:21:07-05:00,7028,CEtpqFD4BbeiNfaXyLLYEapY2mWgE26H5q6H34tWwRuD,BVqRyqwGFPzSkk1H2finiyfaL3LScbEiQGk3mihirxqs,True,8277499,2069374,12585,6292,6293,72FwbpFGoLEazJEdpqNtPNefsadUrimUqma9wSoy4qiS,503414,5985503,-5482089,608
2022-01-22 01:21:07-05:00,7029,ApAgbKGyEYXRonGM33w56ZxHQNAGSd9ji4K3zAGN2yA8,FZAhAUDtEaNsFmh4fP8uXNjoHneNkpZ2wQCfEeU4RYRM,True,4361271,1090317,6311,3155,3156,3zqXX6kzhkbW3d4TwD2CNjMRwxTbREXySekvq37kfCNk,252441,2873360,-2620919,578
2022-01-22 01:21:07-05:00,7030,5jin5wXjQQ25nGM2ECrCXcg1a95vquh6kM7rMRru6Ke7,EKM657EQ8HWWgf4cssByoYHoXGjFfTspTKXAGmygAPQG,True,1612957,403239,2136,1068,1068,3zqXX6kzhkbW3d4TwD2CNjMRwxTbREXySekvq37kfCNk,85464,1299681,-1214217,529
2022-01-22 01:21:07-05:00,7031,DGAQzgZhS2yioeZmG3cbacM3hdz4F1aZn1PWRwgiFukc,48KUtJaNCPNxkLXJBtWAdDxY4b9vZzLgbGxTNdwMqmjz,True,22567878,5641969,32542,16271,16271,3zqXX6kzhkbW3d4TwD2CNjMRwxTbREXySekvq37kfCNk,1301690,17326222,-16024532,576
2022-01-22 01:21:07-05:00,7032,AQr9mVmcXCNQhBVCfx63MwR6c4WqDSC9K2BZqr7N8LCx,CB7TWUaL381ounsLw6neAUaKRxJL9P1HC9uGX5e1Uxod,True,24703998,6175999,31042,15521,15521,3zqXX6kzhkbW3d4TwD2CNjMRwxTbREXySekvq37kfCNk,1241698,25005776,-23764078,502
2022-01-22 01:21:09-05:00,7033,2F45BX9mRmtNCHPejKFknN5aNgGvR4vVLFjMaY1a7dR8,ALdSutsvEFRUEQGGBbi31QywTL1pdXSDWrNJzvNTaoXL,True,1075985,268996,1470,735,735,3zqXX6kzhkbW3d4TwD2CNjMRwxTbREXySekvq37kfCNk,58806,838642,-779836,546
2022-01-22 01:21:38-05:00,7034,CyWBZ1xJ9LahUnPesbXLZ4Rr5UyWAHgVFYwfrnhyrkNL,2Lpk87Xth8ZL5J9BfzmMpEE3x76FDrrrmdKiCNkSVip2,True,11243845,2810960,17526,8763,8763,4BnQKPLuE3DMTtxp8MjUBytgnhvxqq3ZTqZHTVZo4JJh,701041,6994625,-6293584,623
2022-01-22 01:21:38-05:00,7035,GM22yjVoBCzgBcVTT5EcgRhVWiXVV82kSj1dPCbegKWj,CDDy8JmJMwJyx1YAvEPpj8AYxCpngRovf3wWfVzao5Rc,True,6651942,1662985,10401,5200,5201,DddJ7EWCmYEEZETCBNgAUSg81Ls6fZtiAaY5ekJ5sXx1,416051,2195986,-1779935,625
2022-01-22 01:21:38-05:00,7036,3oCun4gm3k8sXxVxiYM8okGi8iCXH9LvDkHf9PBQWYXR,E1np1dZ7jUm811ddvy1jQerBwGSYb5BbZWnUHeotvrfH,True,34731688,8682922,54298,27149,27149,4BnQKPLuE3DMTtxp8MjUBytgnhvxqq3ZTqZHTVZo4JJh,2171957,7820269,-5648312,625
2022-01-22 01:21:38-05:00,7037,8sneA6wAg6geVDJ1g7YWg4R1PfjuRVzeHp1nUBJinhZa,14i1uWtmcTjrdbg3DSr9vzd5NBnxqsn1A4QdgFBZqeYM,False,12877,12877,631,31,600,3zqXX6kzhkbW3d4TwD2CNjMRwxTbREXySekvq37kfCNk,631,8600,-7969,490
2022-01-22 01:21:38-05:00,7038,BjCNaM7YbE9SjFi7tzi4677zg1fKXGJwtecz2GWwWuhd,6rNsSrKZezQrLb2whToNjnizpnurDXrobHqfEK3QqU1M,True,4114703327,1028675831,6368156,3184078,3184078,3zqXX6kzhkbW3d4TwD2CNjMRwxTbREXySekvq37kfCNk,254726244,1437588164,-1182861920,619
2022-01-22 01:21:38-05:00,7039,4mB2DVbQVqVk535v98Cj8SPNg1tTc3DFyY2Q7VBbY645,HXo255k3RgsTGsc4hiP6ZTXUspBTqJ37duQa5eK7tqp3,True,41089354,10272338,63983,31991,31992,4BnQKPLuE3DMTtxp8MjUBytgnhvxqq3ZTqZHTVZo4JJh,2559356,24983660,-22424304,622
2022-01-22 01:21:38-05:00,7040,69byqtDPmgEY1NqKBCR95CEPVHRUxgbNW9Y4P4HjQ7ND,E47T4q4zMGzNL6vDxgWdLn3EQbW3WfVryr8Jsymy1hAL,True,18571914,4642978,28855,14427,14428,4BnQKPLuE3DMTtxp8MjUBytgnhvxqq3ZTqZHTVZo4JJh,1154234,12242486,-11088252,621
2022-01-22 01:21:43-05:00,7041,DiPSJvnnEwg1En7HJfEsKrUbBgtUf4KzGMyMCZDQSYgp,s8UVC6vPBofuXUS6RW1aQmZ8C35PrC5r4A6ugmvzLGB,True,62503,15625,97,48,49,3zqXX6kzhkbW3d4TwD2CNjMRwxTbREXySekvq37kfCNk,3893,34939,-31046,622
2022-01-22 01:21:43-05:00,7042,FtF3PVw8YNJseWPMcA2GEuQZ6nni1mq5kYPa2LrSzfkW,4yr1TM2dXrBvLNMpSaoryuGU2P8D3WG1ZCkvVzWFiQRH,True,11848914951,2962228735,18440246,9220123,9220123,3zqXX6kzhkbW3d4TwD2CNjMRwxTbREXySekvq37kfCNk,737609854,4093388356,-3355778502,622
2022-01-22 01:21:49-05:00,7043,FLQcLhAsRBKnLcSYkK94Za6NhGudrCGhGGxFTdDhVC6L,7vr92sRGp6DopaDv3wJr7gw4BFmxY74K8kFheKyxZdLX,True,16611,4152,25,12,13,3zqXX6kzhkbW3d4TwD2CNjMRwxTbREXySekvq37kfCNk,1035,9608,-8573,623
2022-01-22 01:26:00-05:00,7044,DZSNYptWi3UbyYo4heSHfJFmCWjUNk1iDb75nJfPCPWp,D6dtmxaPmcRSWSRgb1wX4G2eMgeEw2oweCW8YJTHxuDc,False,2512,2512,0,0,0,DddJ7EWCmYEEZETCBNgAUSg81Ls6fZtiAaY5ekJ5sXx1,0,5468,-9987,0
2022-01-22 01:27:03-05:00,7045,BYvjENe16Ta77PqGV7JKEWrsqCTfkMGYwTSG5gXneDvd,EvxAXgvhPC6QkNurbK7vWyTApGo8J2R4EgMAknkHVU3d,True,98117,24529,145,72,73,3zqXX6kzhkbW3d4TwD2CNjMRwxTbREXySekvq37kfCNk,5816,97957,-92141,592
2022-01-22 01:27:03-05:00,7046,Hc2e1tBoiCVKrbD7GvV5i8jgpcd219DoKJwokHvZQumE,xREhnQUqoWUi5HUxkehdh9qw7g89CgkrYemD9ZJYLaJ,False,5651,5651,260,13,247,HfEnetJ7uBSmZWCjBNxdvv9HEC5nsW4wDV7wu6WnhWan,260,4200,-3940,460
2022-01-22 01:27:03-05:00,7047,HSZrdquqBs1gWQGSBcLGs4aa4ox27rLHh6KKmdHrgrVs,DywbuaDt997DQA1GT9GsLL8ML73CxQgHwMLw2MyG8m7M,False,500532,500532,23999,1199,22800,3zqXX6kzhkbW3d4TwD2CNjMRwxTbREXySekvq37kfCNk,23999,189412,-165413,479
2022-01-22 01:27:03-05:00,7048,6tFQaTqqffino9kwMZTL2xVNBG8k9VREFhXqVi2si3A3,3w3wGxBbS4bmXeqmvd595SAWFeXekVpnH4UdbeEs8Sx5,True,138146,34536,174,87,87,3zqXX6kzhkbW3d4TwD2CNjMRwxTbREXySekvq37kfCNk,6985,94296,-87311,505
2022-01-22 01:27:07-05:00,7049,F2v1YwVAwXLiUgsJ5uwn4qAAkTXitn1E75fJcPnGuAcy,5rdJ4H5GxPg4Juu77mGc7uya5LwEqLzDSRyG8mQ2mDbK,False,607765,607765,29947,1497,28450,DddJ7EWCmYEEZETCBNgAUSg81Ls6fZtiAaY5ekJ5sXx1,29947,507310,-477363,492
2022-01-22 01:27:07-05:00,7050,7feC64HZfQpniey2iXsMMgQXnfcunJus74DiKDeKaEUw,GstsCxAiBBEUrXNkvZZ9Sg4vNK916PsKe2Mx6e4M6dU7,True,252159,63039,384,192,192,HfEnetJ7uBSmZWCjBNxdvv9HEC5nsW4wDV7wu6WnhWan,15392,163670,-148278,610
2022-01-22 01:27:07-05:00,7051,BrHRMouGRz3LBNzd9anfdYMhWfg8yUPHL4PqJ8WdEDFS,4uzoLa3mC2VYHAPBoHLX4gTjPTC28rPf2fvEGtJWPYc,True,1931106,482776,2841,1420,1421,DddJ7EWCmYEEZETCBNgAUSg81Ls6fZtiAaY5ekJ5sXx1,113664,2382637,-2268973,588
2022-01-22 01:27:07-05:00,7052,6d6HN8LWikwW2HYdy3BABWuxKHt1sgv4DcneACR133sE,4eKvzmfFvX96XbujKBhUauAvWP4yQYwZH3pd7gXzbCvJ,False,52631,52631,2485,124,2361,3zqXX6kzhkbW3d4TwD2CNjMRwxTbREXySekvq37kfCNk,2485,30039,-27554,472
2022-01-22 01:27:08-05:00,7053,HGJoZvLakWfSDFwuvShNBc4kCf7nP7VqzyM3mELpbFEf,12Qn5jin7QvsBngXqYAv4UstyG3b6nRf1jsLp9Dp8G7k,True,514667,128666,761,380,381,HfEnetJ7uBSmZWCjBNxdvv9HEC5nsW4wDV7wu6WnhWan,30455,407619,-377164,591
2022-01-22 01:27:08-05:00,7054,AHm7zF4rpaxaayBLn5QDHgJSp8KAr647s4cNvQ9wLgd7,FDM33WngED24pukBvSDpPAzinW6afVAeGReum5nyLRiC,True,26102,6525,32,16,16,HfEnetJ7uBSmZWCjBNxdvv9HEC5nsW4wDV7wu6WnhWan,1316,22373,-21057,504
2022-01-22 01:27:08-05:00,7055,CgQB5KmWNz21q9mPfFBve8Ksbqdsdr8jNfwkrxmNZPLN,2dtPpz7Ck4hhBQq8DUywp4Bq21Jk1enHLe8AgXa8ARZu,True,36558915,9139728,52059,26029,26030,DddJ7EWCmYEEZETCBNgAUSg81Ls6fZtiAaY5ekJ5sXx1,2082369,26450786,-24368417,569
2022-01-22 01:27:09-05:00,7056,E9FFPvygPSF22u7gqFq4w6yE5kV15zbeGDXFQc349RsG,yi1REPVUwKhr5ss5YJc56crYz8LVfkqNVMpKcdSfwfY,False,52687,52687,2416,120,2296,4BnQKPLuE3DMTtxp8MjUBytgnhvxqq3ZTqZHTVZo4JJh,2416,29914,-27498,458
2022-01-22 01:27:09-05:00,7057,CYv2hNAzvRak1LBSayFxMJEXoAQdMEZHnNpQLZ5G5RVo,HkvTQbtKxWv2E5z6MsViv1LS4jm8T286fiY1C7n6ZZ9C,True,267852244,66963061,338663,169331,169332,4BnQKPLuE3DMTtxp8MjUBytgnhvxqq3ZTqZHTVZo4JJh,13546548,239249885,-225703337,505
2022-01-22 01:27:09-05:00,7058,2QStaRnbSnDhA891Lb1bxjVeMYpJUpNdqaVkw3rqU45V,DakRWPnttPoRcjY5V7WLwiwBx39BapCo9Atog8dL17Ku,False,71349,71349,3551,177,3374,4BnQKPLuE3DMTtxp8MjUBytgnhvxqq3ZTqZHTVZo4JJh,3551,44962,-41411,497
2022-01-22 01:27:09-05:00,7059,2jPxG5FL6D6XEJsRszJ9cmQ54AWSpZyPFSbn3DpWBSuM,3toQou4UVNvyWYvMvkuv379RVEF2aN2TzCpKKBUqeQV6,True,6127416,1531854,9015,4507,4508,DddJ7EWCmYEEZETCBNgAUSg81Ls6fZtiAaY5ekJ5sXx1,360615,4624535,-4263920,588
2022-01-22 01:27:10-05:00,7060,87R8o8xLjHw2GpunYkm7pX7uJ8hjM4B1y4Qm7aQf6Yh4,48aSVPQoFYdncF5NtJ114urbdTzVjTgYLgPzMfpJbZB3,False,2015817,2015817,92038,4601,87437,HfEnetJ7uBSmZWCjBNxdvv9HEC5nsW4wDV7wu6WnhWan,92038,2780156,-2688118,456
2022-01-22 01:27:10-05:00,7061,6h5DgBXbebbFDYCqknQuEx7NFsHVmts1Rqgo3SeZmdyx,AzatTx5LLzbRWFi25TQGExAsuw5Le2JpH8MsUwZBsprC,False,85825809,85825809,3903862,195193,3708669,4BnQKPLuE3DMTtxp8MjUBytgnhvxqq3ZTqZHTVZo4JJh,3903862,30379434,-26475572,454
2022-01-22 01:27:10-05:00,7062,CRaKcudjkQiSw5YPVjTLVdXvJskeGiHSYtq5ZcMPJhgQ,AgqTg3b3bAcaBmRidhNC4Uf9ZwNbeH52RQEqumWyuUs7,True,27470,6867,38,19,19,4BnQKPLuE3DMTtxp8MjUBytgnhvxqq3ZTqZHTVZo4JJh,1547,26991,-25444,563
2022-01-22 01:27:10-05:00,7063,3qnPsgqW11AcDEmyjmJquPcPLyE3EdJQuVLJ5kinDrd3,86rZadBB7emKio76aFTahpbrFtxd9tqZ4Mxgzaavq2xU,True,5014,1253,7,3,4,4BnQKPLuE3DMTtxp8MjUBytgnhvxqq3ZTqZHTVZo4JJh,298,3851,-3553,594
2022-01-22 01:27:10-05:00,7064,EmGW2aAG69ssWqCtbfDocRaM2u3TJsczn2HHP9jdmRvD,aypkDKsp9uqAB4F6mwvm5LofpsrFBuZT2MMWtE2eHdB,True,20351,5087,26,13,13,4BnQKPLuE3DMTtxp8MjUBytgnhvxqq3ZTqZHTVZo4JJh,1059,16386,-15327,520
2022-01-22 01:27:10-05:00,7065,9UyQC8vc6zJJaSdnjvTAzgmcsw4fC3xFBBiCC1w9Sbjx,3ppBfboe6FPmt7f6WrivspMUoAznZKWQMeh3rCgw7vjQ,True,282570,70642,372,186,186,3zqXX6kzhkbW3d4TwD2CNjMRwxTbREXySekvq37kfCNk,14896,183304,-168408,527
2022-01-22 01:27:10-05:00,7066,CEtpqFD4BbeiNfaXyLLYEapY2mWgE26H5q6H34tWwRuD,BVqRyqwGFPzSkk1H2finiyfaL3LScbEiQGk3mihirxqs,True,6081437,1520359,9103,4551,4552,4BnQKPLuE3DMTtxp8MjUBytgnhvxqq3ZTqZHTVZo4JJh,364141,4602398,-4238257,598
2022-01-22 01:27:10-05:00,7067,ioPHEVyheRnHYomVS7PmP6Coyhjk6LCs7hMD5Mq9Ngv,DYTpFmZ4yXVghKwkaovgCdpv3jfWkjtXRzxsZjKJfXNN,False,760,760,38,1,37,4BnQKPLuE3DMTtxp8MjUBytgnhvxqq3ZTqZHTVZo4JJh,38,569,-531,500
2022-01-22 01:27:11-05:00,7068,ES1MDwRUa3hoToPKQiiZkzMYe9PDVnAQwMrEvZrzvnc1,C4wBG3xTDkmDQneB28xYnf1aBNEeq7UB8oR7NuEfLkFg,True,867523,216880,1100,550,550,DddJ7EWCmYEEZETCBNgAUSg81Ls6fZtiAaY5ekJ5sXx1,44017,570147,-526130,507
2022-01-22 01:27:11-05:00,7069,961Wz2gAzstN9CQjgoe22Htq41zJsYbn8T2pAJqUVo4G,66vPnY7rg7HS9VchM2H33BBqkZK53RDMbrQwj6gSMCdR,False,534380143,534380143,24420703,1221035,23199668,4BnQKPLuE3DMTtxp8MjUBytgnhvxqq3ZTqZHTVZo4JJh,24420703,186167226,-161746523,456
2022-01-22 01:27:13-05:00,7070,8NdcaYUC1X5CP7FMDip78uqtqmCt8GcZdCzLRTYTihmb,9Ei1K9bXWXSXcBfeX5exPSXGCAu62WSKzvnnd4wHvyVh,True,4142,1035,5,2,3,4BnQKPLuE3DMTtxp8MjUBytgnhvxqq3ZTqZHTVZo4JJh,210,3209,-2999,507
2022-01-22 01:27:13-05:00,7071,DqBDL1BcCT99qqNXJeTbzP8pt6123zKKUrsX5DfPZPPW,FNaFupygF8timeWhwZkwDZ4YnsfGXA3pHqjzedda7RxN,False,766378,766378,35256,1762,33494,4BnQKPLuE3DMTtxp8MjUBytgnhvxqq3ZTqZHTVZo4JJh,35256,226537,-191281,460
2022-01-22 01:27:13-05:00,7072,6Y1UoGwrKyKsScZQm9ng1rNrXXykKT82V7kUopc43kAy,8YtWQTTKymCESbPMWCP9TMehbMU25zJMtxt9grqrpbD4,True,1202680,300670,1550,775,775,4BnQKPLuE3DMTtxp8MjUBytgnhvxqq3ZTqZHTVZo4JJh,62033,1562137,-1500104,515
2022-01-22 01:27:13-05:00,7073,HkRKcvAWLM5sCDL6a5DvYsH55bg5BnZnyP9WwX7wLUDF,GXtDJS8BCoZKnvviGaUb2QfKs2LQQZPMa9564tf5Jq8Y,False,48109181,48109181,2300218,115010,2185208,4BnQKPLuE3DMTtxp8MjUBytgnhvxqq3ZTqZHTVZo4JJh,2300218,24049336,-21749118,478
2022-01-22 01:27:13-05:00,7074,H1LftKtj94Zs6PG2A7gJt9rPurBkXkTy2hbbArQwAehi,8bANmhgdnPYa3PqdPnk5BA2xhvqJmPyaMF77mrBePJ13,True,1209,302,1,0,1,4BnQKPLuE3DMTtxp8MjUBytgnhvxqq3ZTqZHTVZo4JJh,70,1482,-1412,578
2022-01-22 01:27:13-05:00,7075,9LZ3rShLfzErXsGkh4dYfAm58GNPWhK6ohDy5RrLJhc,41tLyuvuJ5M7YctkSASD2R7RGGetD7FmKaZUdkTdgXgt,False,45621,45621,2132,106,2026,4BnQKPLuE3DMTtxp8MjUBytgnhvxqq3ZTqZHTVZo4JJh,2132,26006,-23874,467
2022-01-22 01:27:13-05:00,7076,H6fVnghBUSJRKp2mxSG7Fq2Lr4dE3YMS7yM1XTrxoe3Z,JjgtLi79grUZXofhWukB1yNXZkXFMUX5jm9HcXNDsB6,True,955628,238907,1198,599,599,4BnQKPLuE3DMTtxp8MjUBytgnhvxqq3ZTqZHTVZo4JJh,47927,593846,-545919,501
2022-01-22 01:27:13-05:00,7077,6SqJHnwgDCdUdUercq1UushY4tKpbJPKTapGM3ub7Sgm,8MQCsx2SzMUCBWkbriEgkP2ooWC6MDRJvT23xLYEYHTe,True,3821263,955315,5245,2622,2623,4BnQKPLuE3DMTtxp8MjUBytgnhvxqq3ZTqZHTVZo4JJh,209816,3137875,-2928059,549
2022-01-22 01:27:15-05:00,7078,4kbcrzH6o2LvLUCNphyL52i8uGzVD8wcUNEqoQ14z3VG,5Q1atmEBs2AqaDZsiZFG5stHzj1fE6ZvypgfkEc9LYqE,False,5619932,5619932,270718,13535,257183,3zqXX6kzhkbW3d4TwD2CNjMRwxTbREXySekvq37kfCNk,270718,5157187,-4886469,481
2022-01-22 01:27:15-05:00,7079,9VSpd4vToJrnQhmJ595Ua7GhmhutYRgd6rCk3pL4yNxr,7axwFe8aQVPYLNgM9rdUwnFf6vW69Jsw2XpKNjYRDn6N,True,10700334,2675083,15126,7563,7563,4BnQKPLuE3DMTtxp8MjUBytgnhvxqq3ZTqZHTVZo4JJh,605074,7303940,-6698866,565
2022-01-22 01:27:15-05:00,7080,8nXbrdjjaHB73CRPRenGEQj73wbtEFGDwXsehRGMhsap,43pvdcJ6f27wz94D6ZboKwRJYbyvYCrjsJhYsvk7LJCM,True,2046399,511599,3089,1544,1545,3zqXX6kzhkbW3d4TwD2CNjMRwxTbREXySekvq37kfCNk,123560,932865,-809305,603
2022-01-22 01:27:15-05:00,7081,3Lv2XpiD4KBUHq7Zx6u3zNhpXoySodXHH8o8f5yaaPxG,H6TN4rhpBXkEH3mZnymYNcKfmnxRH2uzfwzeLH2q6ahP,True,5885,1471,7,3,4,4BnQKPLuE3DMTtxp8MjUBytgnhvxqq3ZTqZHTVZo4JJh,296,4514,-4218,502
2022-01-22 01:27:15-05:00,7082,4cKgCTttVp8pzJnp43PP7uLLUXNcU7YGPJ3cCGHaUFe7,BBQqjwTpVEgpDzMk4wDDH8rCjaSxCRPWVhtFxERSujTD,True,1283301,320825,1821,910,911,4BnQKPLuE3DMTtxp8MjUBytgnhvxqq3ZTqZHTVZo4JJh,72848,975004,-902156,567
2022-01-22 01:27:15-05:00,7083,2kqN3TbCDgM4x8XfZvKgqJvDAHqvZxtT89NcfmQSQa5b,8fEx56PjuPAP61CBnrsnnnQnZmt8cw6KVjhYDK1mWJzP,False,17989918,17989918,836587,41829,794758,4BnQKPLuE3DMTtxp8MjUBytgnhvxqq3ZTqZHTVZo4JJh,836587,8119377,-7282790,465
2022-01-22 01:27:15-05:00,7084,BPRoaqrDs8vhqv2T7d9qV2oPU33pi1K1LUaotM7yuD2i,6qo8uQGAEwBfYQR36v6nRiqA2xGV6SjJAsXsdzy5bqNH,False,32659432,32659432,1553155,77657,1475498,3zqXX6kzhkbW3d4TwD2CNjMRwxTbREXySekvq37kfCNk,1553155,25914509,-24361354,475
2022-01-22 01:27:15-05:00,7085,BAczoNDnbwj5AJX5LwzynzYab7ji7VbhRy9edA9Prax,34sbkUKnMetUNyMs6BhiWut85d5UZtBWnPtwx8jEpJNA,True,40954,10238,52,26,26,DddJ7EWCmYEEZETCBNgAUSg81Ls6fZtiAaY5ekJ5sXx1,2082,32397,-30315,508
2022-01-22 01:27:15-05:00,7086,J4krKPBBTMVLZRgrSeYJAMyHQs2FkNm5TXk7nQWwDB43,ASmLbfNbhTD2HHeV7qzAqiHjUx5a8Traj8oPDwbkMdFg,True,896650,224162,1227,613,614,4BnQKPLuE3DMTtxp8MjUBytgnhvxqq3ZTqZHTVZo4JJh,49090,622163,-573073,547
2022-01-22 01:27:16-05:00,7087,8nwpM4BmiMV8t2GgMnNy8zhPwBLM8xcBnCNTHyPySbuA,2bVCmJNzMi7ZqTfRB6Nwbk9omrY7urgPuDFvTVeVxc94,False,8442,8442,395,19,376,4BnQKPLuE3DMTtxp8MjUBytgnhvxqq3ZTqZHTVZo4JJh,395,2950,-2555,467
2022-01-22 01:27:16-05:00,7088,GqAS41YJssg9aaEp3hs3sG98APCsXhiQBQszXaSjZ2bN,2wodJ3AhrXdE1T4oVL95KvoBND7PubG5Wd5GWiLCMZJU,True,6027303,1506825,8844,4422,4422,4BnQKPLuE3DMTtxp8MjUBytgnhvxqq3ZTqZHTVZo4JJh,353795,7475310,-7121515,586
2022-01-22 01:27:16-05:00,7089,CCHzYXr5zMXFu8MMZNkfUWGyUcF8xy7Vvhq7tNCtZg2L,AuEXkCJTTJ3HK8iP4qTWpQr4vp6HPRJZyZwfRjF8zjfp,False,4620,4620,221,11,210,4BnQKPLuE3DMTtxp8MjUBytgnhvxqq3ZTqZHTVZo4JJh,221,3049,-2828,478
2022-01-22 01:27:16-05:00,7090,2bikYf33ZxxDmvkMNjWDGGqEpbYJPvWv5At3hzyeLEQK,5FtirUBjRAZ3k5arFFVwKz42ixWzhkEBLkaK9PraRZ78,False,4619,4619,222,11,211,4BnQKPLuE3DMTtxp8MjUBytgnhvxqq3ZTqZHTVZo4JJh,222,3050,-2828,480
2022-01-22 01:27:16-05:00,7091,U3vvMQ4X4aKzVYfhMw1V1p58HRqaLnuXozqmmefYeD9,7JA94MArkNCFRhBq8f5a32DgMF6aPdFsoC5HvXDQ6NuR,True,9966123,2491530,14676,7338,7338,3zqXX6kzhkbW3d4TwD2CNjMRwxTbREXySekvq37kfCNk,587041,8749958,-8162917,589
2022-01-22 01:27:16-05:00,7092,6Bq55LtGCEeGqh4JrFLCmmGc2iJfTTBJixivqH78aGSE,DSNrCgWJeNe2P9tAQu5FvCueTzNKDKds7wzuwTQSMRG,True,218012,54503,328,164,164,4BnQKPLuE3DMTtxp8MjUBytgnhvxqq3ZTqZHTVZo4JJh,13138,153775,-140637,602
2022-01-22 01:27:16-05:00,7093,AQr9mVmcXCNQhBVCfx63MwR6c4WqDSC9K2BZqr7N8LCx,CB7TWUaL381ounsLw6neAUaKRxJL9P1HC9uGX5e1Uxod,False,18148984,18148984,831641,41582,790059,3zqXX6kzhkbW3d4TwD2CNjMRwxTbREXySekvq37kfCNk,831641,19033725,-18202084,458
2022-01-22 01:27:16-05:00,7094,BJV5jbowrbELXfDvfMovaQy4PiRf12pLYHimW9bgzW5X,6WXrWso5FvLx7RMCFBzrbzh5qevKkk2LJAihUfWXxXzB,True,686933,171733,1023,511,512,4BnQKPLuE3DMTtxp8MjUBytgnhvxqq3ZTqZHTVZo4JJh,40956,853207,-812251,596
2022-01-22 01:27:16-05:00,7095,2FEbsetZMkRqLjSC8GBbgecKgX5T1T1fci2sLQux29p8,H722Fcd6DkTFRZxqQWbPDufBfXEgmFfhiEpQZWhxwYv1,True,153307,38326,227,113,114,4BnQKPLuE3DMTtxp8MjUBytgnhvxqq3ZTqZHTVZo4JJh,9096,109450,-100354,593
2022-01-22 01:27:16-05:00,7096,A3E9T7xYkPeNiWKdvhNTYiD5j7k2Xecpe318eFqVro4m,2QJk8iVJEy2QZmbFHnR7RBJsi7NpXWFFkEmweWtKKHfE,True,61645893,15411473,80485,40242,40243,4BnQKPLuE3DMTtxp8MjUBytgnhvxqq3ZTqZHTVZo4JJh,3219415,53787923,-50568508,522
2022-01-22 01:27:16-05:00,7097,AA9zFZTXqBR8Mw1fwEH59edzBiswoGasRNWsi6aLeysB,4VeitxYqqtRxyfdSVpshdJ3EDcgksRVnaHvAqWxTeujH,False,53589,53589,2659,132,2527,4BnQKPLuE3DMTtxp8MjUBytgnhvxqq3ZTqZHTVZo4JJh,2659,30592,-27933,496
2022-01-22 01:27:16-05:00,7098,FLTW9fwjWqGPm5PiE3C9LFzwZxtDh8c2MnEoRq8W7MfQ,GKsfzKBP2QkmoEWvTaUN1h4nqrT3kAcwYRC9WxW9bB3h,False,388591,388591,18327,916,17411,3zqXX6kzhkbW3d4TwD2CNjMRwxTbREXySekvq37kfCNk,18327,256078,-237751,471
2022-01-22 01:27:16-05:00,7099,FpqCxvTkSiwDwD5qEt6hXJxzFDLFLAQ8VevK8zwRqYun,A3p6YQisCJKpNkF7vkjZRbEfbnUt7vTZdR2zPBUSdTkk,False,12933405,12933405,637632,31881,605751,4BnQKPLuE3DMTtxp8MjUBytgnhvxqq3ZTqZHTVZo4JJh,637632,8848604,-8210972,493
2022-01-22 01:27:16-05:00,7100,C9beggursF9WdLyzunVSoz2Bw6kAxoQpUifPHbo4ybvw,3R7KdKBK7FoudsNXUeRuC2AGVFusMhmTYXSGdnA88pJT,True,1165924617,291481154,1651337,825668,825669,4BnQKPLuE3DMTtxp8MjUBytgnhvxqq3ZTqZHTVZo4JJh,66053481,542458364,-476404883,566
2022-01-22 01:27:17-05:00,7101,2s9VGesQYbKr3LwuraMEa9sXbXz7f8299HPPAHgSaUdp,8uMS2GDsbmygjbRnc2gjwNkXKogmJX1i8nchmqt8ixCe,True,1421310139,355327534,2093859,1046929,1046930,4BnQKPLuE3DMTtxp8MjUBytgnhvxqq3ZTqZHTVZo4JJh,83754384,1093376323,-1009621939,589
2022-01-22 01:27:17-05:00,7102,Ckqos6cdncPKj13DnCmDVZsZTqp6eS7277CRrT9WhcEr,AtUV8m7VQJvZq7GLCAHMf3jV7iamKEPnWVZHWuuVZQp1,True,39388,9847,55,27,28,3zqXX6kzhkbW3d4TwD2CNjMRwxTbREXySekvq37kfCNk,2221,38680,-36459,563
2022-01-22 01:27:17-05:00,7103,8xQ3tsWVUe75EG1HmocULJ3kh52utveoFMEPotTGrKno,i3SKW3ywrwYucX9ySEx1C4zaUKGnzLerP3V38437NyV,True,4503660,1125915,6339,3169,3170,3zqXX6kzhkbW3d4TwD2CNjMRwxTbREXySekvq37kfCNk,253564,3911112,-3657548,563
2022-01-22 01:27:17-05:00,7104,Sapmbypb7FUXhKQEdjyH2AUDgh8QWQ1mu6SSHm7673N,7AGij8bP7Kq3iARJ41duwggPrDfuXDoKwRSKV9SG8nk2,False,8841165,8841165,426056,21302,404754,4BnQKPLuE3DMTtxp8MjUBytgnhvxqq3ZTqZHTVZo4JJh,426056,3151737,-2725681,481
2022-01-22 01:27:17-05:00,7105,2FrqGFZjbiNykJyo9BZ5S9FguQJPJiTi681rJJsQ5dta,3QUncYP92NKrfpaTvuF9iQg11PXKgZAgEngwh6BbnCCj,True,26029,6507,33,16,17,3zqXX6kzhkbW3d4TwD2CNjMRwxTbREXySekvq37kfCNk,1320,19332,-18012,507
2022-01-22 01:27:18-05:00,7106,DdYgcyV1T2CDYiQVr4VL9Ym8RdKm93a7SKy8HxuyaoMW,GPdAeqeXb1UJ56AttcwwY1CyFhRyfptDC4BAX2Tc8MpE,True,16677,4169,23,11,12,3zqXX6kzhkbW3d4TwD2CNjMRwxTbREXySekvq37kfCNk,942,14337,-13395,564
2022-01-22 01:27:18-05:00,7107,5sN3cfz4hZjwy2HkAStKWeL8wHhdbkW8F7USzwCzmggh,Fme7U7QY92biAsV3RR2Fj7rJPnpdcov13mmFhVDFuyYG,True,22695206,5673801,33088,16544,16544,4BnQKPLuE3DMTtxp8MjUBytgnhvxqq3ZTqZHTVZo4JJh,1323551,16465715,-15142164,583
2022-01-22 01:27:18-05:00,7108,BLJgLzizx2yLgd12pVBAHTMqn9J5JA3JHCF8PnLnPyUk,HhDmwMysBFWhXnd3mrV31w75WBRKBS8wJSiEMZgqdUSp,True,32432239,8108059,47847,23923,23924,3zqXX6kzhkbW3d4TwD2CNjMRwxTbREXySekvq37kfCNk,1913900,25791837,-23877937,590
2022-01-22 01:27:18-05:00,7109,Fd2HrzBAr4JobRPARZwpQHHVoSCEoog32A6tKMWAC1sK,BYappsar5sQf8VLem4wrLuTtrDFH9y8pEx1aMxfuU4Pq,False,948918,948918,47253,2362,44891,3zqXX6kzhkbW3d4TwD2CNjMRwxTbREXySekvq37kfCNk,47253,792482,-745229,497
2022-01-22 01:27:18-05:00,7110,pgzvXpnUYiY7hLrfjmwScqLd8oj9vYcXpFvpm4y4JvG,GdqdQgoyBAFuXdbvoZyDhB3jyqJzVo4nkGh7EPFxkBF2,True,66846,16711,90,45,45,4BnQKPLuE3DMTtxp8MjUBytgnhvxqq3ZTqZHTVZo4JJh,3627,88842,-85215,542
2022-01-22 01:27:18-05:00,7111,brCL9pzP6q4b6rKgAH1AJbMoqffBWyXLX8oAnZDoi77,Dx4G5UP9jTb47JQypWJnv48mPTzhJvqPD1BtBtDT7TJF,True,256213,64053,358,179,179,3zqXX6kzhkbW3d4TwD2CNjMRwxTbREXySekvq37kfCNk,14356,108542,-94186,560
2022-01-22 01:27:18-05:00,7112,BFs34P4fwk5wYXr8dQGiVNLACM64sebEfJAaFXd86aMV,H6MpEFEHgdsBZuGSpfKznAaUaCPuEwsgLjcNCPm3kzmQ,True,4427540,1106885,6419,3209,3210,4BnQKPLuE3DMTtxp8MjUBytgnhvxqq3ZTqZHTVZo4JJh,256773,3581648,-3324875,579
2022-01-22 01:27:18-05:00,7113,8VnGmfop6qcUezAJ2M15jz2Nn6mPQgehDcJPvypq4XJn,6F6sqXNhgkW9ev8QNMm4ydywUUmemhwgydRQYNeqyUmi,False,333630,333630,16490,824,15666,3zqXX6kzhkbW3d4TwD2CNjMRwxTbREXySekvq37kfCNk,16490,434561,-418071,494
2022-01-22 01:27:18-05:00,7114,E8ifvhmyJGBGVQomo3AnZw2UcaLHcpGsTtuoCid8voU3,FMQUWTbTAfSLfrc6GTrz4DM2ZSgoxF3KtqGn8AyjVtsf,True,224358,56089,289,144,145,3zqXX6kzhkbW3d4TwD2CNjMRwxTbREXySekvq37kfCNk,11586,151619,-140033,516
2022-01-22 01:27:18-05:00,7115,2hirR46fpyHEg1Fv9vAzYgnoNRBWaky7LoFGVof4DnpK,DXTEHauVDdz4Mjjj6sJHPUh6TnzU6ob6Nj63To2vCNPW,True,71446782,17861695,100270,50135,50135,72FwbpFGoLEazJEdpqNtPNefsadUrimUqma9wSoy4qiS,4010807,27940104,-23929297,561
2022-01-22 01:27:18-05:00,7116,5jin5wXjQQ25nGM2ECrCXcg1a95vquh6kM7rMRru6Ke7,EKM657EQ8HWWgf4cssByoYHoXGjFfTspTKXAGmygAPQG,False,1184901,1184901,58511,2925,55586,3zqXX6kzhkbW3d4TwD2CNjMRwxTbREXySekvq37kfCNk,58511,993992,-935481,493
2022-01-22 01:27:20-05:00,7117,3onLoSaH9BskwjFu4nbEFykBsDaFgKgWVHPqdSUjHraw,D3YAuBorbpirBJmvhxQvFJbQPRycWyyymjsvm8GDetv3,False,24953525,24953525,1206622,60331,1146291,3zqXX6kzhkbW3d4TwD2CNjMRwxTbREXySekvq37kfCNk,1206622,24081389,-22874767,483
2022-01-22 01:27:20-05:00,7118,2SNV9Q6vzQP5XxxqSrwXpQdRvk45FPiqLXmhNZzbLt1k,6dLG3ojK5Unm1mBh9aDZfryvoT2a6cSuWA8CxXy3oi7n,True,114456479,28614117,174613,87306,87307,3zqXX6kzhkbW3d4TwD2CNjMRwxTbREXySekvq37kfCNk,6984532,70507793,-63523261,610
2022-01-22 01:27:20-05:00,7119,4FazDUgfQ3AKoFcnWHr8E9Ht8jLA3tkxf75yrGZVHdmF,HzRMH6mbgEKydRCnnMvSsKgTEVNQi6nuzoR1xutYFdzg,False,1934,1934,91,4,87,4BnQKPLuE3DMTtxp8MjUBytgnhvxqq3ZTqZHTVZo4JJh,91,2172,-2081,470
2022-01-22 01:27:20-05:00,7120,6BQVtmNsxihi4PcA7MurtguTwa6SmbmKyP14RHyjVZkf,7ZFv5ms4HzVKiw7KgE8RUoKxW9rB6JUD7ujZxMx4DwnM,True,105188,26297,154,77,77,4BnQKPLuE3DMTtxp8MjUBytgnhvxqq3ZTqZHTVZo4JJh,6169,69909,-63740,586
2022-01-22 01:27:20-05:00,7121,GH6Q9E1jZPTTp46aDd57UNZPNS2D6PBSwyLL3EHSjGn2,2XvwZXNsrPWx4EfPvhTP933bzCC3SJHDQ8xARfrXdVY9,False,622110,622110,30224,1511,28713,HfEnetJ7uBSmZWCjBNxdvv9HEC5nsW4wDV7wu6WnhWan,30224,800297,-770073,485
2022-01-22 01:27:20-05:00,7122,8GdYhwX26GRmVfGFCbJ3MJrH1UdneN2FNRUexhLsqprN,DpUTHSVucDPyCWoLCdpm8EFRZFiKL88tmnSiWG2TRpS8,True,7404647,1851161,11102,5551,5551,3zqXX6kzhkbW3d4TwD2CNjMRwxTbREXySekvq37kfCNk,444114,5679891,-5235777,599
2022-01-22 01:27:20-05:00,7123,DYCYiQFH9QHzCo3eAw1pFoDu7pzwFMo1E2WDZjVFRz5w,CPh4FWsGak1kd1WFEH9qBjNhnun3R2tHtZA57zW8ugn5,True,3042586,760645,4517,2258,2259,HfEnetJ7uBSmZWCjBNxdvv9HEC5nsW4wDV7wu6WnhWan,180705,2443088,-2262383,593
2022-01-22 01:27:20-05:00,7124,FKQVm9RsteDe7dQmwx4NGYhz3Wrvwh7TCp9rFbTgAomx,Dbwox8eRCdmH5KXyi5sBaqWzhxtaVPo1teWXJ2kRFT1f,True,21894051,5473512,32004,16002,16002,4BnQKPLuE3DMTtxp8MjUBytgnhvxqq3ZTqZHTVZo4JJh,1280181,26354899,-25074718,584
2022-01-22 01:27:20-05:00,7125,67Z7ZGhNu5xxEh9BYKWcXp9m1T4tFiE1o1M16hCzUWQA,CT7YKWixz7BhTbvg5F6M5HCyPGnHoFLNFuDV9GhoLTo3,True,103020,25755,144,72,72,72FwbpFGoLEazJEdpqNtPNefsadUrimUqma9wSoy4qiS,5788,97478,-91690,561
2022-01-22 01:27:20-05:00,7126,6CeKxTJvFqhyNEyzySiBBKEwYVMe7j3A6nkMes4BW6o2,DzDR9XvwY1z7ygQ8YrCXrwDGHSf67JZF8BzUnuFE2fxQ,False,137892,137892,6786,339,6447,4BnQKPLuE3DMTtxp8MjUBytgnhvxqq3ZTqZHTVZo4JJh,6786,94352,-87566,492
2022-01-22 01:27:20-05:00,7127,M69XSefqeum2arinvHEqmA3L2XHWNFN17p4msRhRZXf,2vK15yYUANLSbAoiBfgJ9VLyqsmtEpd2iNytQjms8GaQ,True,8595946,2148986,12220,6110,6110,4BnQKPLuE3DMTtxp8MjUBytgnhvxqq3ZTqZHTVZo4JJh,488837,8756449,-8267612,568
2022-01-22 01:27:20-05:00,7128,DdEiAJ4pcXU213GVEa5KeDonBXZhTV7zeNcKigEQwN8Y,FoAs2bsVjQFKaJW7dpVKMxoJf7Qe5PcuH6i9jJzAR5e1,False,21574584,21574584,1039518,51975,987543,3zqXX6kzhkbW3d4TwD2CNjMRwxTbREXySekvq37kfCNk,1039518,7458402,-6418884,481
2022-01-22 01:27:20-05:00,7129,7jvKp6onXyWgwsFrFWj4hYTXJsYYD6ot5mn6rPFuJriy,J7N6HiozevJVTiY9hDEUs2ud5BwT5QSE7wnMBS1w5ie2,True,2622811,655702,4022,2011,2011,4BnQKPLuE3DMTtxp8MjUBytgnhvxqq3ZTqZHTVZo4JJh,160882,2054110,-1893228,613
2022-01-22 01:27:24-05:00,7130,DZ39kEQZn3qA98LxtGmKU6yhWDuiH6Qjqi52VNrvWzRw,D3XS2JoLKi8KiKrWpq9YegcH7uLQ5n8xdpymMMf8jUrR,True,5113785,1278446,6880,3440,3440,HfEnetJ7uBSmZWCjBNxdvv9HEC5nsW4wDV7wu6WnhWan,275224,4158047,-3882823,538
2022-01-22 01:27:24-05:00,7131,6BPPDj3BVgBPD3agd8b4B12d9Gvp4bFPXRWjzbtsmtRF,8VZnAwXPyKK2AHoMTZxKXthAiFMrL6b5EXAGqsAMTdhm,False,996,996,48,2,46,HfEnetJ7uBSmZWCjBNxdvv9HEC5nsW4wDV7wu6WnhWan,48,733,-685,481
2022-01-22 01:27:24-05:00,7132,6osqTNxgZv1Y1EjnVR7D1G4cywof1CrWswj87tAnktWV,Fah93R9W7SFuajFif4AbXDdxouWA5rrLz29vzVRGsMxv,False,393746,393746,18638,931,17707,HfEnetJ7uBSmZWCjBNxdvv9HEC5nsW4wDV7wu6WnhWan,18638,511835,-493197,473
2022-01-22 01:27:24-05:00,7133,9vcKW1GfrDZ3KLPh2pEVFF8ZyKqD1pJW1hiE8H98Av7S,C6Ki27mo4sCHu6u8UnR1p7WSgsTjFQxGGR9Lk9n5Rhjq,True,88130,22032,123,61,62,3zqXX6kzhkbW3d4TwD2CNjMRwxTbREXySekvq37kfCNk,4954,73004,-68050,562
2022-01-22 01:27:24-05:00,7134,91tPxdvLhrVtytKuNkf33XocRnpEqA1x3jDb1Je6xeui,2ByoMpaZg1uzkA48vMufvcx8BLYxWLXUK3tXAJcupanF,False,996,996,47,2,45,4BnQKPLuE3DMTtxp8MjUBytgnhvxqq3ZTqZHTVZo4JJh,47,731,-684,471
2022-01-22 01:27:24-05:00,7135,Ht2oWgWWVsA4u5fwp8o8dwgUjoGSRDF2gAwQPDXCwKfZ,8pYWhoNFpmDYuawZub9rd5qkSsAJuPGeJwoa23YyVVym,True,1707134,426783,2223,1111,1112,72FwbpFGoLEazJEdpqNtPNefsadUrimUqma9wSoy4qiS,88945,1596676,-1507731,521
2022-01-22 01:27:25-05:00,7136,ECuu1L4QGdemZ7FjAjVAAxYN6piinweY7Fuk5csVovfT,Amd8WGcpdtB8yoA83R1BUT5uryuqoKbcBexYacbrbGVX,False,96258,96258,4450,222,4228,3zqXX6kzhkbW3d4TwD2CNjMRwxTbREXySekvq37kfCNk,4450,66156,-61706,462
2022-01-22 01:27:25-05:00,7137,CagSUfZLwXuCdypC4KzU6FSNdmCj9dKDroPcNeaRtsyt,yxw5d1ztZuEUY2QjL7eLpr72QJAj5rJd6ERvg91cy1m,True,51324,12831,74,37,37,4BnQKPLuE3DMTtxp8MjUBytgnhvxqq3ZTqZHTVZo4JJh,2988,36193,-33205,582
2022-01-22 01:27:25-05:00,7138,2p2fGXdKrmxjomLSnyaNg84J82cBBBNympZ6qQc8UZgU,HKAM8bazuLMUY6yapZJqYsgaWkTBqKHyMs1hSfpYsZGi,False,25581346,25581346,1222389,61119,1161270,HfEnetJ7uBSmZWCjBNxdvv9HEC5nsW4wDV7wu6WnhWan,1222389,22280808,-21058419,477
2022-01-22 01:27:25-05:00,7139,HGAFdundf5voDqeh9g7d6Q9mgMf8eEg898QMRBqwPZ6C,deanBuZXWBHEe2TGfP37S9aMBEnEgmZoyRJjAvruzfA,True,5204035,1301008,8134,4067,4067,72FwbpFGoLEazJEdpqNtPNefsadUrimUqma9wSoy4qiS,325396,4207963,-3882567,625
2022-01-22 01:27:25-05:00,7140,9Hz4p7gcfDbXBJp8KzhaBBPh9i7xe9kun7zLfDtqPe6c,2bJ43Lep6kp6WY7Ct56oiscKnAbdtC265G5yRvRPFThU,True,30139327,7534831,44245,22122,22123,3zqXX6kzhkbW3d4TwD2CNjMRwxTbREXySekvq37kfCNk,1769821,14098557,-12328736,587
2022-01-22 01:27:25-05:00,7141,HhwiZPKZBGa16oVi739s4qtMDMTwzWXc7iwNfX63t2UP,5AnbMbAFKy85yHt5y2M5S38nNkA1vT4ejY5NjGbRNUqn,False,43617,43617,2060,103,1957,72FwbpFGoLEazJEdpqNtPNefsadUrimUqma9wSoy4qiS,2060,43101,-41041,472
2022-01-22 01:27:25-05:00,7142,5RvNKzSeJ1fvqsKpcQu25evEZGmKjyEDgwsMZkykoT3P,BRqSGfE4XHXu4HrinwetWumfVTmr82iuF6Y5oSV6eMiK,True,4622,1155,5,2,3,DddJ7EWCmYEEZETCBNgAUSg81Ls6fZtiAaY5ekJ5sXx1,237,3061,-2824,512
2022-01-22 01:27:26-05:00,7143,7uHMFnppZKtV7nAySv8UGcoGTSQ98RVz1GP47dsFWpYr,FmS9WPYVTT8i4agyidApdLnoHAUMfdRFPnAVJQUwfWr5,False,54076032,54076032,2708379,135418,2572961,4BnQKPLuE3DMTtxp8MjUBytgnhvxqq3ZTqZHTVZo4JJh,2708379,22463126,-19754747,500
2022-01-22 01:27:26-05:00,7144,9gYrMXAGmGSV4VFjXzYP5WwH2aFpB1TxA6CqpYsosKLv,Dh8aH6RK48wu4fkT9xKw5XL7itxnPDuw3SDwPwvL5sva,False,837,837,41,2,39,4BnQKPLuE3DMTtxp8MjUBytgnhvxqq3ZTqZHTVZo4JJh,41,623,-582,489
2022-01-22 01:27:26-05:00,7145,2AAWghW6BUAFBtF3R6hB9uoqMc5oUDkU8FTd2JrXKema,798cfEUZ2YhXwNTNjXMS4Z2J8gAHaK4zZwpMkq2HzWWM,True,44309768623,11077442155,65223177,32611588,32611589,3zqXX6kzhkbW3d4TwD2CNjMRwxTbREXySekvq37kfCNk,2608927109,20928964893,-18320037784,588
2022-01-22 01:27:26-05:00,7146,LNX7AwwiGpuaXA4J86d1xqqtF6kD7qbCusssSZqtpKd,45a5FGVssw2NoGipB7NRN4XDLPob4GHNxSM9fqgsTpqA,False,27215540,27215540,1355928,67796,1288132,4BnQKPLuE3DMTtxp8MjUBytgnhvxqq3ZTqZHTVZo4JJh,1355928,12809947,-11454019,498
2022-01-22 01:27:26-05:00,7147,3C2MZQKh9x4zNTCMbhhvoafGaFMwUooqfy9MCgPyXs6E,AHjgWKpYPWe6ketjDHDKFBFsKQiRJ41jnkuo39MVYxZo,True,6711546,1677886,9635,4817,4818,3zqXX6kzhkbW3d4TwD2CNjMRwxTbREXySekvq37kfCNk,385411,6326989,-5941578,574
2022-01-22 01:27:26-05:00,7148,3SCNhx5gRKXVkpwmebmSP6hUq6gwnN8cVrumzE2YjtLU,27ZNezLpQR7XhXdzmDrmxuVnh6PqYwYhrgbxFAQd7GYJ,False,35590527,35590527,1576927,78846,1498081,4BnQKPLuE3DMTtxp8MjUBytgnhvxqq3ZTqZHTVZo4JJh,1576927,8166400,-6589473,443
2022-01-22 01:27:27-05:00,7149,6u6bPgAmK8ufACrQV99A1Y5nhGkue3KEUHmQQkcNkxwP,7636yXT5w4DcVpc7LJdN46aiggzSq6U2GXHXL5kyy9F3,False,3733615,3733615,180763,9038,171725,4BnQKPLuE3DMTtxp8MjUBytgnhvxqq3ZTqZHTVZo4JJh,180763,3126855,-2946092,484
2022-01-22 01:27:27-05:00,7150,Avok5yeEYbNXwtBCqqb2y3WRnGgoXeuGKCtUBYxf3N7U,Byms3hWr4yaf3TYW8HALsNvhFhMgLYwvdpiKqJqegyVY,False,2074310,2074310,97600,4880,92720,72FwbpFGoLEazJEdpqNtPNefsadUrimUqma9wSoy4qiS,97600,1951120,-1853520,470
2022-01-22 01:27:27-05:00,7151,HjkXypCkrCSprGVXBkrbHMZJji2gMToLvCLweRhcH7Vs,2ddyaPR86fCsVf4VJRG1VdZgdkY84TzXb8NMPqRyDqzV,False,22770856,22770856,1069031,53451,1015580,72FwbpFGoLEazJEdpqNtPNefsadUrimUqma9wSoy4qiS,1069031,8656484,-7587453,469
2022-01-22 01:27:27-05:00,7152,5rW9kqXB9feGSKSvSMNJF1FCsBYV3vGmTmc8MvzaZ3pi,7AjnjcfPJevW5521hXw4VtgRCfHSsAqyzyArukKfNcHo,True,348624,87156,499,249,250,3zqXX6kzhkbW3d4TwD2CNjMRwxTbREXySekvq37kfCNk,19991,302733,-282742,573
2022-01-22 01:27:27-05:00,7153,Ehw3RgdbzyAHHddgSv7F6f3WtYhyBtRg2ropQaWGgwcL,GGw3xDe5jKd5UNB9bPLqp2xzw2SKz7CMg358Fy7UypDL,False,527984658,527984658,25199895,1259994,23939901,3zqXX6kzhkbW3d4TwD2CNjMRwxTbREXySekvq37kfCNk,25199895,277865246,-252665351,477
2022-01-22 01:27:27-05:00,7154,GGGyesjbt7h2XHHp9u8vpiWGugFwEbrtYaKrNQSDhQd7,8tydo1ZjGHmPBSqU33tywB3f9szdsHk1ckGFe4Ay5pgs,False,1588849,1588849,79108,3955,75153,4BnQKPLuE3DMTtxp8MjUBytgnhvxqq3ZTqZHTVZo4JJh,79108,1860193,-1781085,497
2022-01-22 01:27:27-05:00,7155,6oroGB3mvzK3tDfiB9X2NJuL3x476pxhgRnt7VxqhdLo,2SoK8tKkLn2ppKURpTVazKsCEis4uahkHMsac1m85J4r,True,56778,14194,79,39,40,3zqXX6kzhkbW3d4TwD2CNjMRwxTbREXySekvq37kfCNk,3170,73234,-70064,558
2022-01-22 01:27:27-05:00,7156,Frobc1KZTVcsyfwyKwSpHJobxmiJBomzHhGCLdrzdAz8,HziyKP9uxWCuXddtbRzWMczHNdgyQB5UXQZj4MnMm14,True,15558378,3889594,22983,11491,11492,3zqXX6kzhkbW3d4TwD2CNjMRwxTbREXySekvq37kfCNk,919346,6855248,-5935902,590
2022-01-22 01:27:27-05:00,7157,AM5fwZR9BUW8AFkhdGWXW4PHd2cy8ora63kDf2z2eknw,E7ru6hg4MchnRG5zcr5YazwX8Snt55r5Xq9zCHCGaYZT,False,30082,30082,1460,73,1387,3zqXX6kzhkbW3d4TwD2CNjMRwxTbREXySekvq37kfCNk,1460,24833,-23373,485
2022-01-22 01:27:27-05:00,7158,CvZssqscu2dm35mwcE3zg9zedavbRjVJjWD59Py5ExUK,7pXaoR6aHKYofCmg1eHipygNYDteEaf8rbbS8BDYGQK6,True,22169,5542,29,14,15,3zqXX6kzhkbW3d4TwD2CNjMRwxTbREXySekvq37kfCNk,1191,15185,-13994,537
2022-01-22 01:27:27-05:00,7159,DJiXXW7sjNsAAxWupDKBUsFhXSgPoerVYaAtJqqNgVbn,2MsqvNuJw1xQhJ3UnXt9i7oNHDuZpR9w7iE1WQcGqt5m,False,4614,4614,219,10,209,72FwbpFGoLEazJEdpqNtPNefsadUrimUqma9wSoy4qiS,219,3052,-2833,474
2022-01-22 01:27:27-05:00,7160,7T5Z5qX5petKARUrhAuB7xaWJPTKrcQTx9n63cM85Pvz,Hw2gx2SBkEj2SA4RE2hWETJNYmLUBqSZirAaRpuvMgH1,False,653798,653798,30413,1520,28893,3zqXX6kzhkbW3d4TwD2CNjMRwxTbREXySekvq37kfCNk,30413,429196,-398783,465
2022-01-22 01:27:27-05:00,7161,5nauZoaxftcYR591YH4v52myeJLnXtY4okdttL9qSdkg,7x3G299D3bC7EwUQojhTXUv29BG4NGzrLbgS4mEyqG5r,False,14559417,14559417,716407,35820,680587,3zqXX6kzhkbW3d4TwD2CNjMRwxTbREXySekvq37kfCNk,716407,7272330,-6555923,492
2022-01-22 01:27:29-05:00,7162,FEKYaAbNo9UF62dkkV8JbV9HvHYsiBLmvQp561HEXWx6,2Bcc55F83cWDvW4X2QQMfgpZQZWMVZsMD3W98KNL8GqK,False,44590829,44590829,2081807,104090,1977717,72FwbpFGoLEazJEdpqNtPNefsadUrimUqma9wSoy4qiS,2081807,41857669,-39775862,466
2022-01-22 01:27:29-05:00,7163,FL1C5wMXApaNzez9LFMAiFYVFiLSRQxgZ3GfPrscdvRB,2FkYGYyTzbTFjJBiggre23H7TvqHjzBTdyrzQ5VNGqht,True,1255375,313843,1717,858,859,3zqXX6kzhkbW3d4TwD2CNjMRwxTbREXySekvq37kfCNk,68703,313655,-244952,547
2022-01-22 01:27:29-05:00,7164,ApAgbKGyEYXRonGM33w56ZxHQNAGSd9ji4K3zAGN2yA8,FZAhAUDtEaNsFmh4fP8uXNjoHneNkpZ2wQCfEeU4RYRM,True,3200817,800204,4399,2199,2200,4BnQKPLuE3DMTtxp8MjUBytgnhvxqq3ZTqZHTVZo4JJh,175993,2211821,-2035828,549
2022-01-22 01:27:29-05:00,7165,EL9JxeMvWWLTdVC5QrZzSSgApEwv1nDhZc6yNmH9G8ad,EqSQLSFx1eKkTYAdv5XhekttqVh7TappXAHuv9EedCXq,True,3321,830,4,2,2,4BnQKPLuE3DMTtxp8MjUBytgnhvxqq3ZTqZHTVZo4JJh,196,2506,-2310,590
2022-01-22 01:27:29-05:00,7166,6yw4GPvkqUbakcEWtqSCfjVLukty11xqjDpGxtEN9Km2,5ppEx7wkpqbG5nApCWMdRja3oRSheFmAAsNHUX7h2w2Y,False,51997,51997,2574,128,2446,3zqXX6kzhkbW3d4TwD2CNjMRwxTbREXySekvq37kfCNk,2574,68823,-66249,495
2022-01-22 01:27:29-05:00,7167,3njiRuSRMXRzKmamyiR72Hc38PU8UDDmWdfPhgxmGxEW,5WoF3gkgygyNNbwxWgVfqGWkExcDixuzgJQQjXEZQ6J5,False,8029620,8029620,397290,19864,377426,3zqXX6kzhkbW3d4TwD2CNjMRwxTbREXySekvq37kfCNk,397290,8735750,-8338460,494
2022-01-22 01:27:29-05:00,7168,HPDN6Ro6gPgYbNgnv7yhFCpyY3uYzT18epFxRFNZ985w,3Jop74A52E7gYLXJRUAoPBzSZ6mmP2gmaCg7eG6eQHu5,True,34989584,8747395,49481,24740,24741,3zqXX6kzhkbW3d4TwD2CNjMRwxTbREXySekvq37kfCNk,1979247,17673829,-15694582,565
