ts,record_id,user_authority,user,partial,base_asset_value,base_asset_value_closed,liquidation_fee,fee_to_liquidator,fee_to_insurance_fund,liquidator,total_collateral,collateral,unrealized_pnl,margin_ratio
2022-05-09 12:53:44-04:00,20481,m7gf1jAYXBZjRZEY9w4MjPfhzLwgDKaXyaCVhRD6C5E,Aa2aTZnpPux1i5K2MT4i1TsVM8vR7qR7rZGijQW4zpwd,True,306056626,51973167,198758,99379,99379,72FwbpFGoLEazJEdpqNtPNefsadUrimUqma9wSoy4qiS,11704367,170353130,-158648763,382
2022-05-09 12:54:02-04:00,20482,5xkW7wHTcF5WadNtBBqKPKctVwyQtTqqscivAmxzseCk,7m31ZMZdCn5Gz2q5sETWA7uKA5LsKD7pJHBBqU3g7tCn,True,113961086,28490271,80009,40004,40005,6L1WYrPiCMyi7XemPww4B4hvpKD1LQKD4RpiSKmrmgSC,3200370,24928424,-21728054,280
2022-05-09 12:54:06-04:00,20483,92cQnCMBkPL8DmE4xYQXJVAQ8EXk3moXXVHaM2zQT4uj,A5MAQitMT3yojsCtjyq9pypZQP9Df6m95X5srsEXaxr6,True,2249925823,562481455,1612266,806133,806133,DQCvC9mR68hJ3tJsUiddh6JwcBJAmntqGJR2nUsEq7yj,64490668,2534577996,-2470087328,286
2022-05-09 12:54:09-04:00,20484,HXQXfEQe7aCpr6WKh37XaDZsjZcuQPk5t8tWNFgEoK6U,5ufXkCEDwgiXwtyPye4wYVVA3oLW54JVzz4tnXFofto4,True,77242856,19310714,54833,27416,27417,2a35JJeTUW1pm6M3e8DHCjp8qr4vbc2cRPhuzZWyFzYd,2193351,42133912,-39940561,283
2022-05-09 12:54:24-04:00,20485,9L2rA8qtfvjKMzqtLn9Cc9Y3ih1e8Z3w9huDzyZXg1xk,GopCtogALLkVyW1T3FGofVWMmjnsdG6EkpJUWob3svaP,True,48423099,12105774,34589,17294,17295,6L1WYrPiCMyi7XemPww4B4hvpKD1LQKD4RpiSKmrmgSC,1383588,11660656,-10277068,285
2022-05-09 12:54:26-04:00,20486,Bzp3ZUxzRWqW4QoLq9PtKN1HQeSaKXFQrX1G3a4ocrre,H12B3p4v1ZtZ9gaSgpxCJsKXmmEjiqaRZQzexjzAhevo,True,816006818,57031976,254430,127215,127215,A9TwRM1BMxqb8DCC7YNAMV6zPenEJm3HTZBy7wJKK58U,36403600,425672840,-389269240,446
2022-05-09 12:54:32-04:00,20487,8KzrbHiup39X7Zw9grvh7gS9ZcA1zuhLGqgYguSjwnD6,A2EPmTs73YiS15ZKcjom55huNYaJY3WeP7NBDar1VE3R,True,865669220,216417305,1146026,573013,573013,A9TwRM1BMxqb8DCC7YNAMV6zPenEJm3HTZBy7wJKK58U,45841048,1204406226,-1158565178,529
2022-05-09 12:54:33-04:00,20488,6v2KNGc2fG2d6gej4197zgxpPZHY8cdd7wXxyceEPowK,3u6LAZVkQRKaxNkTwACrDMXMf5fEY3VZmrUr4t2pAyE9,True,168438404,42109601,125738,62869,62869,3zqXX6kzhkbW3d4TwD2CNjMRwxTbREXySekvq37kfCNk,5029525,57592241,-52562716,298
2022-05-09 12:54:56-04:00,20489,D7dQmfuiK31BHRG4Y9wpkRu7sChiZhTYes47YPNGvnpF,AN5jjtJp7d9DG3xJo3DnDRmGmzj5pKKy1owwVuREpReQ,True,133586107,33396526,187211,93605,93606,47z82br5WdW2DZajdnPDPSSRRKsyAggqXqK6oPUwTaLf,7488459,22063178,-14574719,560
2022-05-09 12:55:12-04:00,20490,8qq2gfbca7JXvq4gViBBVT2QAbM4MvBMEQLXgn8UUTvt,3o5jpBVYdFFEYrGRdCUkLrUC85wsuTKgy8iYwnpZyC1B,True,39982654,2732286,12010,6005,6005,5HnvdJnCCcmRsm4GkXnYWd4q9RpwuvYDGEUMPkYR3Ts9,1757589,30654897,-28897308,439
2022-05-09 12:55:14-04:00,20491,9eWpSyu71Z6dmx7yTh7WrbVScdrrZN14d5tfmqEGFgXt,2r89PFKSD9zmSp2Wyx4CQ75HAtmUgwhAS2oG5MuYuiV6,True,136844997,24692562,94197,47098,47099,47z82br5WdW2DZajdnPDPSSRRKsyAggqXqK6oPUwTaLf,5220398,64865292,-59644894,381
2022-05-09 12:55:15-04:00,20492,AZq9LHFskHUujKDJZTpWhpP9LRaDjQKcrf2Bz2eY6TtN,EtStidHXHYYQJ6E1h7LHmgewtiK7AjMAsDBw4XBCrdQs,True,156054524,39013631,198797,99398,99399,47z82br5WdW2DZajdnPDPSSRRKsyAggqXqK6oPUwTaLf,7951886,106886796,-98934910,509
2022-05-09 12:55:43-04:00,20493,EVMrznfJS54BZiywDD2WhUtxzicDtbEpm2a5yLrtCgRF,CpzsMYVYvKg8ihrX1cKRw7TDEYwD3kAyiX92hsf2KiTz,True,110979257,7499316,33945,16972,16973,2a35JJeTUW1pm6M3e8DHCjp8qr4vbc2cRPhuzZWyFzYd,5023494,85294917,-80271423,452
2022-05-09 12:56:42-04:00,20494,85gxgPczGaY9xtDwEvNrWLPhsJFqHPCG1DbbedtFwsVK,AhZjmArZneA5QoTrL8TxzLni6aUxQYZbTYym1YcY4Qhz,True,95058770,23764692,148355,74177,74178,47z82br5WdW2DZajdnPDPSSRRKsyAggqXqK6oPUwTaLf,5934224,31347925,-25413701,624
2022-05-09 12:58:50-04:00,20495,To5Z4jqSX6wuuiTrWWMY3LdpVtsLUTzNtXFH9H9Efti,E8TNMoGpjAp1sEXs7wp689zAPyJbuVaDWsxPLGH6DmUR,False,152142,152142,10739,536,10203,47z82br5WdW2DZajdnPDPSSRRKsyAggqXqK6oPUwTaLf,10739,58920,-48181,705
2022-05-09 12:58:52-04:00,20496,648dg79UazWHnwQ9p4kxQdcRXPhc21377kEQnSPssvfz,3d12WWiYbtie5eEyJjqTiLfyR82oQPdaQV2HdVH5d4AK,False,11834927,11834927,723603,36180,687423,72FwbpFGoLEazJEdpqNtPNefsadUrimUqma9wSoy4qiS,723603,12619313,-11895710,611
2022-05-09 12:59:11-04:00,20497,FRbeFwhUYCiHW5oP26mad8KND7CCYDbfnoNxX7GuXVp8,GrzXKxPX2WDka8i2D8sunMUsrsThKasQi8NYLwuCGygV,True,85045913,8090218,34348,17174,17174,2a35JJeTUW1pm6M3e8DHCjp8qr4vbc2cRPhuzZWyFzYd,3610801,42977696,-39366895,424
2022-05-09 12:59:25-04:00,20498,BEATjyYuro1xc1kbgBoxBnVEk3usoUk9qwmdRndXdYW5,9RGBffhSMgab1KCM6dMvwiBENbnp5pERfCEjw4q5ckFS,True,31929751,7982437,47307,23653,23654,5HnvdJnCCcmRsm4GkXnYWd4q9RpwuvYDGEUMPkYR3Ts9,1892295,14551226,-12658931,592
2022-05-09 12:59:26-04:00,20499,4oMasDRj8HWfknmdwt6Mkz3eonr8J2byoiSTRo4sCnFQ,3emcATkEFvDVETiK97eVET2Z2jzkgiiSxX3gu5wsUKPe,True,109082836,27270708,156343,78171,78172,72FwbpFGoLEazJEdpqNtPNefsadUrimUqma9wSoy4qiS,6253765,80808892,-74555127,573
2022-05-09 12:59:26-04:00,20500,HooxSzasW3HMoFJ6sAvRQ75Char1J5aBdJtsqfDV6myp,BCmsWwpGeV4NNfeKZKKydty2uueLGHYTJDk1WErpXsVT,True,51870961,12967740,79082,39541,39541,72FwbpFGoLEazJEdpqNtPNefsadUrimUqma9wSoy4qiS,3163319,20994248,-17830929,609
2022-05-09 12:59:47-04:00,20501,532MfQR1PzPn6cmC1kpZsz9MyBWSamSeieh1F6GqVY33,6sJ8XXMZzGbHjVU1vWNW8unWoBZhJa54GguYJQhcb8PA,True,355795808,88948951,514985,257492,257493,Hu94aiQWvce6THeGyCFqGRPM1pQrK3ihzkcXo1EpJcJL,20599470,103644497,-83045027,578
2022-05-09 12:59:55-04:00,20502,8sQzUoiFfBUsfVKdUjUh3xUjwnaCP1Qmw9BGwtH768ZR,8wZxijgcyRwqxiRKMMZhoREAb6iHhRGCgjgZRd5Yp6RP,True,96740219,24185054,123970,61985,61985,72FwbpFGoLEazJEdpqNtPNefsadUrimUqma9wSoy4qiS,4958823,54572220,-49613397,512
2022-05-09 13:00:08-04:00,20503,442usWu6XpJZvU25bqXeynRrQ15jAzWwU9DWMgHpTn3Q,CtvADKp39bjJf3cPKWNL3wxnhq273fVM4fC5DmEcg5cC,False,14201537,14201537,882098,44104,837994,47z82br5WdW2DZajdnPDPSSRRKsyAggqXqK6oPUwTaLf,882098,3713342,-2831244,621
2022-05-09 13:00:15-04:00,20504,8sQzUoiFfBUsfVKdUjUh3xUjwnaCP1Qmw9BGwtH768ZR,8wZxijgcyRwqxiRKMMZhoREAb6iHhRGCgjgZRd5Yp6RP,True,72555165,18138791,120871,60435,60436,Hu94aiQWvce6THeGyCFqGRPM1pQrK3ihzkcXo1EpJcJL,4834853,42046415,-37211562,666
2022-05-09 13:00:23-04:00,20505,DLwEaZipqHmVBD5hc5v1NZtDStHyG4hAMwxywDTGGc2e,28GtwJw67UWfrSKxtuvpzoKzPyKXLgP3GKLm3fHdR566,True,18316766,4579191,28041,14020,14021,72FwbpFGoLEazJEdpqNtPNefsadUrimUqma9wSoy4qiS,1121675,11155589,-10033914,612
2022-05-09 13:00:33-04:00,20506,m7gf1jAYXBZjRZEY9w4MjPfhzLwgDKaXyaCVhRD6C5E,Aa2aTZnpPux1i5K2MT4i1TsVM8vR7qR7rZGijQW4zpwd,True,253136648,24343459,101111,50555,50556,5HnvdJnCCcmRsm4GkXnYWd4q9RpwuvYDGEUMPkYR3Ts9,10514123,153645395,-143131272,415
2022-05-09 13:00:34-04:00,20507,8J4BZXZzkK4SmWxc2YoaJRg9ivuuXbdVe5XpEhVds1ZM,3pirVwiye9NftvMpX5F7WpfcGZy5uV3c11xCdkkZbL9D,True,194174427,48543606,146084,73042,73042,8sEswn3kzEhnYjAZVvCQnHEUvYd7pFVvc2Xc2Kd1BpbC,5843391,40498499,-34655108,300
2022-05-09 13:00:46-04:00,20508,5FewDaMC9U7n5EHcto98GaAmDVxDh5SYimuTP6AtfakM,7DAULUoqV7f9hsBzKEhjQPnWaHSqiMWcBqWcdcadaQv4,True,108694017,27173504,167281,83640,83641,F31bVJvHB2XkhGdgjyTim48hY2cLFEx661AiPS3SzYJ2,6691245,27876748,-21185503,615
2022-05-09 13:00:48-04:00,20509,BTXpvCdmYEmg5fB2Hsjc6Wked2sky4oQpGu7r8KuPau4,CaEwxQQds9f44npaSrYAsC6WpE3T6MpAGr9jgXZeqWjA,True,28647774,1279137,5079,2539,2540,68sueyVfmy5ToEGtLFGDkwebX47xAmzyXE29z8JrmcWv,1137552,9439541,-8301989,397
2022-05-09 13:00:49-04:00,20510,8uoS53t92hUWWx6mZHGhpKs3dkYJYyiRufnp4H1anBJH,E1Nc6fTaZ7EFFJqVDnEfV3odtasBRhEzbtg4JDFDzJ3k,True,50334972,12583743,78187,39093,39094,6L1WYrPiCMyi7XemPww4B4hvpKD1LQKD4RpiSKmrmgSC,3127497,45596046,-42468549,621
2022-05-09 13:00:49-04:00,20511,E3Tv8DA7HAQjNtMJ5GDaVvGj3RSsuqLGA99oV14vyrPU,2Bhtp9jmtvyj2FjK2M8RUKezH1gmV1RYCAzbDepzrrFS,True,59300944,2888767,12029,6014,6015,6L1WYrPiCMyi7XemPww4B4hvpKD1LQKD4RpiSKmrmgSC,2469478,28169015,-25699537,416
2022-05-09 13:00:52-04:00,20512,68gVM4kjmSYxT1uJW13rYSway8uVLUdcLa7sJuqHQaAf,DshroBQ3da7BcAiQpiFREsLKWbUDrBRmmZRw3Zu2Qfs9,True,37923705,9480926,28018,14009,14009,2a35JJeTUW1pm6M3e8DHCjp8qr4vbc2cRPhuzZWyFzYd,1120758,11976953,-10856195,295
2022-05-09 13:01:27-04:00,20513,BQYbbwd1MLtj6fBuBiTncAaXdAqKWa1JbcbGkZbLA728,2Wsyr6KoMbSVSvFy3YzutuEQ6skGUZyVHGM42SN4eU98,True,8040628405,643917162,2199558,1099779,1099779,DA18qE9qesbBqpwNv1M4befYcNQkbSBSeLPTmQzrmbJw,274660157,10094771016,-9820110859,341
2022-05-09 13:01:31-04:00,20514,6pUtYz474QrpATEZnfb3iFbTKYA65pNyKAo4TQZAjtqe,8dipRUXvxJiDLdHEtCPkso4vErbVwshHQiRfvSngBS9J,True,92503505,7580034,25896,12948,12948,Hu94aiQWvce6THeGyCFqGRPM1pQrK3ihzkcXo1EpJcJL,3160356,70679972,-67519616,341
2022-05-09 13:01:32-04:00,20515,GcwFXxcxRF2xwbgFbQZoYEDreimd3J3UJ9sPfuwYVKtS,7uXjmKS8RxP2qSS7ataBH5hkfpgsFcpSBWUEBuV5zgyZ,True,38369500,9592375,29028,14514,14514,6L1WYrPiCMyi7XemPww4B4hvpKD1LQKD4RpiSKmrmgSC,1161135,12771931,-11610796,302
2022-05-09 13:01:38-04:00,20516,7zuFEyLQFHkAjm3mAuxN42VenwF6fZcqM81mmR8sBnmY,CSnQxjc4Jn8iP4JSxj5wsrvxGsLoAYQn1bKC8naY7YZP,True,2453718771,613429692,1785065,892532,892533,3zqXX6kzhkbW3d4TwD2CNjMRwxTbREXySekvq37kfCNk,71402609,291388358,-219985749,290
2022-05-09 13:01:41-04:00,20517,BA9VJg7R6mQB3YYaysjHStocNKqgRN4rTvx4WYGXpLQU,88BWs4dLHvWU1RWfzohaBX56WG8dCqCnN82Dk4TrN3yb,False,12683765,12683765,365842,18292,347550,68sueyVfmy5ToEGtLFGDkwebX47xAmzyXE29z8JrmcWv,365842,6667777,-6301935,288
2022-05-09 13:01:41-04:00,20518,BSUa3ArsftaRgVww5eEU9bFsq7bYRfRsdAWc1PY9Tqwp,4rtPyGw8SrDEZfLF7NZhKKp6opuBi5jxxwCb4CKtb4AR,True,49752780,2645728,11214,5607,5607,5HnvdJnCCcmRsm4GkXnYWd4q9RpwuvYDGEUMPkYR3Ts9,2108993,22350155,-20241162,423
2022-05-09 13:01:42-04:00,20519,CvR57tmtnHbMmPivvJR6VenXivQaWue7z77N81WPpzfv,B4ASc8cUjrzuchv2SHwPrnjKvZgZpwvcLArsdYmMAqBQ,True,62184312,15546078,45641,22820,22821,5HnvdJnCCcmRsm4GkXnYWd4q9RpwuvYDGEUMPkYR3Ts9,1825654,20405376,-18579722,293
2022-05-09 13:01:42-04:00,20520,BEATjyYuro1xc1kbgBoxBnVEk3usoUk9qwmdRndXdYW5,9RGBffhSMgab1KCM6dMvwiBENbnp5pERfCEjw4q5ckFS,True,23781955,5945488,41990,20995,20995,68sueyVfmy5ToEGtLFGDkwebX47xAmzyXE29z8JrmcWv,1679629,11339339,-9659710,706
2022-05-09 13:01:42-04:00,20521,djW9rVm1v4nW64QiVqgFUCRza24VqthDcSfVEyRHPed,EsXvQmXVXECqZPtmSdiuwieHPP5jsmyn67p78vHaJcqq,False,34229588,34229588,994353,49717,944636,Hu94aiQWvce6THeGyCFqGRPM1pQrK3ihzkcXo1EpJcJL,994353,6053956,-5059603,290
2022-05-09 13:01:49-04:00,20522,68rnn3Qarf9iTY3JDJqV7sAaNEexx2NSJiqmfrLB2ke1,34ytjVJQ3wKhuKJ6tkB9D9CufVNofmZFYchcxTarHNio,False,10208356,10208356,308293,15414,292879,3zqXX6kzhkbW3d4TwD2CNjMRwxTbREXySekvq37kfCNk,308293,4195137,-3886844,302
2022-05-09 13:01:55-04:00,20523,Aog11AwpgWF7UgvLLJbV5kn3UrJURYQUhnBFnAFSqbp8,2WXYGpuib3fK3BCXDQVQsoktEnASPuZfcnmC2AZ7KTQK,True,36056200,9014050,25987,12993,12994,5HnvdJnCCcmRsm4GkXnYWd4q9RpwuvYDGEUMPkYR3Ts9,1039485,9344843,-8305358,288
2022-05-09 13:01:55-04:00,20524,GtDk7DkAB2jvQynR57z8mjg6UoaTqYDr8Z4wsFX6KGSr,tAPvp4fscJZySZUVG2GZWZwSRVhfnNvkjCC6ZvmxqDQ,True,47953485,11988371,34903,17451,17452,5HnvdJnCCcmRsm4GkXnYWd4q9RpwuvYDGEUMPkYR3Ts9,1396137,9984879,-8588742,291
2022-05-09 13:02:04-04:00,20525,C33hfnDHzVwKXxr6AwFAXhd1vJYrPKhtqc75Qpjm19Zt,2WYBMSyrHQEYZqxEtxBMe2xn7eioJEGsudqdCmGvssGh,False,31945633,31945633,956517,47825,908692,5HnvdJnCCcmRsm4GkXnYWd4q9RpwuvYDGEUMPkYR3Ts9,956517,7315473,-6358956,299
2022-05-09 13:02:11-04:00,20526,8T4WK27RvWVGqPuNqY6whk1fmU4vd5qaUQPZG1GJ79bh,DvSz7knS8N3K7L6JhQf1s4mJSyxB8uJXNQXtyjJn8QRL,True,82261742,19173146,60423,30211,30212,72FwbpFGoLEazJEdpqNtPNefsadUrimUqma9wSoy4qiS,2592477,19534800,-16942323,315
2022-05-09 13:02:14-04:00,20527,EEQmHFk3WFNmPfe7ujtP1PK6P5yqV5mmWumNSoTu45P8,FG9DScQDQPrgcmBbRugZ5NfhSTRMnKSWLxcUeTF9MgJZ,True,85249391,21312347,63657,31828,31829,47z82br5WdW2DZajdnPDPSSRRKsyAggqXqK6oPUwTaLf,2546305,17757767,-15211462,298
2022-05-09 13:02:49-04:00,20528,EHi1UBG8wMUFZECktsFUZkGjJPaBNEedswS62hyYn6jC,Drx9ErQhAjnPuJ83LPYFnY5ZV5XDzGuXDuSf16VqWayp,True,122961646,6637104,24645,12322,12323,5HnvdJnCCcmRsm4GkXnYWd4q9RpwuvYDGEUMPkYR3Ts9,4565847,92824174,-88258327,371
2022-05-09 13:03:26-04:00,20529,8L2s5h1hSU79naWcS7cvT3oxiPL6ofTDWmqTK1S4F99g,32DYf6ArTTcNwokJrbhHT1QGe4pZ9z29oPdw97aDR7AQ,False,28226868,28226868,816910,40845,776065,5HnvdJnCCcmRsm4GkXnYWd4q9RpwuvYDGEUMPkYR3Ts9,816910,29432850,-28615940,289
2022-05-09 13:03:57-04:00,20530,HeyRAEkqGTtCj2cMfGR6pbeY5nu4qERFmZSovsfhUtaq,5MDbdhQUt3USB1RFmdLsrAc5UUXZ1n8jXRQFtJ6ibj9B,True,51182898,2709003,11505,5752,5753,C4UnXuShCvjSMgBAgVNMy1oakxCNk1et27A82fywU112,2173918,17241186,-15067268,424
2022-05-09 13:03:57-04:00,20531,A7j77tzgnQVGtHTa65VtVZqJRYeJvQk7am8NW6e66379,4vJGwEvXU2tGWoWWGwbsYcfKQAMCHbrBMRk4ZVFzneLs,True,62070104,15517526,46463,23231,23232,C4UnXuShCvjSMgBAgVNMy1oakxCNk1et27A82fywU112,1858547,24375929,-22517382,299
2022-05-09 13:03:58-04:00,20532,H9pFRayNBHTAhsbtGyfs1XXUWGxAbw7SgpT1xdrSRWEY,9LNreyXuhgyLCDYViNyA1jUw6h1nv4GmDtTYMoUQBqCG,True,1430143492,202264335,609418,304709,304709,C4UnXuShCvjSMgBAgVNMy1oakxCNk1et27A82fywU112,43089969,658392515,-615302546,301
2022-05-09 13:04:44-04:00,20533,EyNCsqWu8zLyuRnXSbzJWnWZg7ZLjb4oJSZFdDSkbXmT,6rMMMkZibUHXYs8hXY3FmG4rgBx6gWDRGJwR2bP2t6ZD,True,13775659580,2581029811,9684018,4842009,4842009,2py1FiYeL2f7J3HU36qiJz6TD6HCmiTN36RyxYtapQCZ,516862504,3566385650,-3049523146,375
2022-05-09 13:04:45-04:00,20534,BQYbbwd1MLtj6fBuBiTncAaXdAqKWa1JbcbGkZbLA728,2Wsyr6KoMbSVSvFy3YzutuEQ6skGUZyVHGM42SN4eU98,True,7377337614,581845858,1996080,998040,998040,DQCvC9mR68hJ3tJsUiddh6JwcBJAmntqGJR2nUsEq7yj,253086970,8861587776,-8608500806,343
2022-05-09 13:04:45-04:00,20535,BTXpvCdmYEmg5fB2Hsjc6Wked2sky4oQpGu7r8KuPau4,CaEwxQQds9f44npaSrYAsC6WpE3T6MpAGr9jgXZeqWjA,True,27312208,2560879,10078,5039,5039,5HnvdJnCCcmRsm4GkXnYWd4q9RpwuvYDGEUMPkYR3Ts9,1074943,9051361,-7976418,393
2022-05-09 13:04:45-04:00,20536,F2AU2PjaSmHxWWhkz8XxMggkCMWbMVgawt89tSnYS6RL,ET9febRJiW197DYMaJbgk3kWsAeFv5f4peQ4vFCVppK6,True,498143804,124535951,777551,388775,388776,A9TwRM1BMxqb8DCC7YNAMV6zPenEJm3HTZBy7wJKK58U,31102063,83750103,-52648040,624
2022-05-09 13:04:45-04:00,20537,6pUtYz474QrpATEZnfb3iFbTKYA65pNyKAo4TQZAjtqe,8dipRUXvxJiDLdHEtCPkso4vErbVwshHQiRfvSngBS9J,True,84693975,6470166,22192,11096,11096,68sueyVfmy5ToEGtLFGDkwebX47xAmzyXE29z8JrmcWv,2904964,61290172,-58385208,342
2022-05-09 13:04:48-04:00,20538,E4VzeJLsf5Y6t3yNi8VpS8QxhJbJGPhnkNBmU2XoCBs9,63CXyYfevXtrL1QcfQtAhz29xeea5BwWcj6d6BWb4qiB,True,409068295,102267073,305147,152573,152574,A9TwRM1BMxqb8DCC7YNAMV6zPenEJm3HTZBy7wJKK58U,12205909,209193497,-196987588,298
2022-05-09 13:04:50-04:00,20539,42h4NteqFpLjgjMS4gTTFoLvrEMpEP4sbGRd7SM5YCZR,AasJCLP5qsGzxkQs5jWysSarwoJTuZ6ZDeabNJNimWAX,True,751516515,187879128,563097,281548,281549,DA18qE9qesbBqpwNv1M4befYcNQkbSBSeLPTmQzrmbJw,22523903,104652512,-82128609,299
2022-05-09 13:04:55-04:00,20540,m7gf1jAYXBZjRZEY9w4MjPfhzLwgDKaXyaCVhRD6C5E,Aa2aTZnpPux1i5K2MT4i1TsVM8vR7qR7rZGijQW4zpwd,True,227476277,38663681,154604,77302,77302,72FwbpFGoLEazJEdpqNtPNefsadUrimUqma9wSoy4qiS,9096100,130151067,-121054967,399
2022-05-09 13:04:55-04:00,20541,E3Tv8DA7HAQjNtMJ5GDaVvGj3RSsuqLGA99oV14vyrPU,2Bhtp9jmtvyj2FjK2M8RUKezH1gmV1RYCAzbDepzrrFS,True,56198145,5507005,21954,10977,10977,5HnvdJnCCcmRsm4GkXnYWd4q9RpwuvYDGEUMPkYR3Ts9,2240450,26042785,-23802335,398
2022-05-09 13:04:55-04:00,20542,5tW54mXQxtM7vGc91HrDeDtWkxJeH2uM4yAviqZnMZCN,7Kg5Zwx5afFdLbTifeyKJLSNVj2p9Xf5anbbqQozNzmY,True,1998085131,194605416,1256145,628072,628073,2py1FiYeL2f7J3HU36qiJz6TD6HCmiTN36RyxYtapQCZ,128973087,524700514,-395727427,645
2022-05-09 13:04:56-04:00,20543,AMX6F2JfPDPrH25kErHeEbgDdVuZZC8k2bmFK4ctxp7u,F8sw2kRoeh46AX3uw6GwFep8xGUP5XyfuoLqWCwpvuXy,False,9711045,9711045,293614,14680,278934,72FwbpFGoLEazJEdpqNtPNefsadUrimUqma9wSoy4qiS,293614,5208369,-4914755,302
2022-05-09 13:04:56-04:00,20544,9ancY5Fso8pUktKpRj3qc1YPQA6thy5n4f7uvNnsqMWR,CLUi9rvU9NTi7h4sNwqfr8aqChyGDbVJA1aKvKMWQv2r,True,280049019,70012254,184780,92390,92390,72FwbpFGoLEazJEdpqNtPNefsadUrimUqma9wSoy4qiS,7391208,78570178,-71178970,263
2022-05-09 13:04:56-04:00,20545,fAJK1wrBhSW297AtFWX2U4rUBf2gkzfQ6UrQL9yHEYW,5pyTFpanSyUCHxeMhJMKtpdrcMSAWc8bFadbyM7q4q4B,True,88216050,22054012,57880,28940,28940,72FwbpFGoLEazJEdpqNtPNefsadUrimUqma9wSoy4qiS,2315205,11387909,-9072704,262
2022-05-09 13:04:56-04:00,20546,7PzGZgzieFyyFs1dbajkNQgVxooFUNZrj1bUsQvrSwbp,A2gDREmSmJTBPPw3sbKVY3smC9wbHMDdv87gr4Tr2ES7,True,76336962,19084240,52876,26438,26438,68sueyVfmy5ToEGtLFGDkwebX47xAmzyXE29z8JrmcWv,2115048,14155190,-12040142,277
2022-05-09 13:05:04-04:00,20547,6naM66ATXRRjYeSkLvGpPU5n61xnkMwZm5cxgdf9SEeJ,4LKFc7ZBN6y9ohn7oxhbwukTHyWRNGH8cT5fRop2ps1N,False,14316706,14316706,415942,20797,395145,72FwbpFGoLEazJEdpqNtPNefsadUrimUqma9wSoy4qiS,415942,7394936,-6978994,290
2022-05-09 13:05:05-04:00,20548,DBT4GeddD8Ve8v7kerU1xrdJyy5moqUedcjYgM2jWESV,FVdbkwTpM3U6E4qQ9E2T9rTJ4dFYdkixsibnEiZqNUsA,True,211150219,52787554,152550,76275,76275,72FwbpFGoLEazJEdpqNtPNefsadUrimUqma9wSoy4qiS,6102038,69392262,-63290224,288
2022-05-09 13:05:10-04:00,20549,BSUa3ArsftaRgVww5eEU9bFsq7bYRfRsdAWc1PY9Tqwp,4rtPyGw8SrDEZfLF7NZhKKp6opuBi5jxxwCb4CKtb4AR,True,46919452,2196554,8942,4471,4471,68sueyVfmy5ToEGtLFGDkwebX47xAmzyXE29z8JrmcWv,1910179,21234666,-19324487,407
2022-05-09 13:05:10-04:00,20550,BQYbbwd1MLtj6fBuBiTncAaXdAqKWa1JbcbGkZbLA728,2Wsyr6KoMbSVSvFy3YzutuEQ6skGUZyVHGM42SN4eU98,True,6778428138,535900400,1850212,925106,925106,F31bVJvHB2XkhGdgjyTim48hY2cLFEx661AiPS3SzYJ2,234027272,8351760742,-8117733470,345
2022-05-09 13:05:13-04:00,20551,FRbeFwhUYCiHW5oP26mad8KND7CCYDbfnoNxX7GuXVp8,GrzXKxPX2WDka8i2D8sunMUsrsThKasQi8NYLwuCGygV,True,76383937,13036498,51104,25552,25552,5HnvdJnCCcmRsm4GkXnYWd4q9RpwuvYDGEUMPkYR3Ts9,2994343,38693348,-35699005,392
2022-05-09 13:05:13-04:00,20552,BTXpvCdmYEmg5fB2Hsjc6Wked2sky4oQpGu7r8KuPau4,CaEwxQQds9f44npaSrYAsC6WpE3T6MpAGr9jgXZeqWjA,False,24670824,24670824,984358,49217,935141,68sueyVfmy5ToEGtLFGDkwebX47xAmzyXE29z8JrmcWv,984360,8647001,-7662641,398
2022-05-09 13:05:14-04:00,20553,6pUtYz474QrpATEZnfb3iFbTKYA65pNyKAo4TQZAjtqe,8dipRUXvxJiDLdHEtCPkso4vErbVwshHQiRfvSngBS9J,True,77951962,6164809,20648,10324,10324,Hu94aiQWvce6THeGyCFqGRPM1pQrK3ihzkcXo1EpJcJL,2610925,59011455,-56400530,334
2022-05-09 13:05:15-04:00,20554,F9s8a7Cpiw5dw3a2aNFMofqwyDWNXvDLnSdJzoj1gRiV,GpKsQKJD79KBRWdCTkyi4zX7NaoCWsLUjrKxAwJB6o6s,True,7144332464,1785060079,5335046,2667523,2667523,2xTUy2RS74GJMMDnmFaegMzFLn19RVfYG4CibhBmjP1i,213524180,773232648,-559708468,298
2022-05-09 13:05:15-04:00,20555,BePQMfbkFe8vQ54rFkkf2dzXunPq2Xwpibrm1JVzSHLz,8R6rnjVUnMGUxx5sRjnuuyEnfyBGeet7y2jSJwVswyT3,True,20688867663,5172216915,15642063,7821031,7821032,GXyFXZMNk2NFyEzw6JetVqsujqcz2yCixH7n8EpDJYWD,625682543,6041575273,-5415892730,302
2022-05-09 13:05:15-04:00,20556,EHi1UBG8wMUFZECktsFUZkGjJPaBNEedswS62hyYn6jC,Drx9ErQhAjnPuJ83LPYFnY5ZV5XDzGuXDuSf16VqWayp,True,115809043,12484368,43397,21698,21699,2a35JJeTUW1pm6M3e8DHCjp8qr4vbc2cRPhuzZWyFzYd,4025703,85357361,-81331658,347
2022-05-09 13:05:15-04:00,20557,7j27KC1mxT1a4oZJ4UqRxi3auGBPfz4qCZA9WE6b8VSq,7TSpJz6hYsMk5yyLMUCHUMHvKKvzEjJzG8iqNHALypBL,False,5532658,5532658,153065,7653,145412,68sueyVfmy5ToEGtLFGDkwebX47xAmzyXE29z8JrmcWv,153065,2976207,-2823142,276
2022-05-09 13:05:20-04:00,20558,FncFHJooh1hy9Gc2y5sKdcYkZ5uHzsxHG4vHT9cVZGcK,BkFa4b5Jyv4ZJCCpwDYv355ezVFiZfAtn18AV7kstd2v,False,26595967,26595967,756862,37843,719019,72FwbpFGoLEazJEdpqNtPNefsadUrimUqma9wSoy4qiS,756862,7491412,-6734550,284
2022-05-09 13:05:21-04:00,20559,H9pFRayNBHTAhsbtGyfs1XXUWGxAbw7SgpT1xdrSRWEY,9LNreyXuhgyLCDYViNyA1jUw6h1nv4GmDtTYMoUQBqCG,True,1220766466,154282163,446983,223491,223492,A9TwRM1BMxqb8DCC7YNAMV6zPenEJm3HTZBy7wJKK58U,35367860,582182701,-546814841,289
2022-05-09 13:05:21-04:00,20560,AL8JFS4gjaQx89f9j8wtaNJgV76K8bw1ugvNtgvhgAnb,HJYvG2kGKe8kXgtZSWTWwTmSjxA3XUeCvyT7acoKtS1C,True,4924736986,1231184246,3688596,1844298,1844298,2py1FiYeL2f7J3HU36qiJz6TD6HCmiTN36RyxYtapQCZ,147543866,1574802263,-1427258397,299
2022-05-09 13:05:21-04:00,20561,HeyRAEkqGTtCj2cMfGR6pbeY5nu4qERFmZSovsfhUtaq,5MDbdhQUt3USB1RFmdLsrAc5UUXZ1n8jXRQFtJ6ibj9B,True,48276174,2278149,9271,4635,4636,3zqXX6kzhkbW3d4TwD2CNjMRwxTbREXySekvq37kfCNk,1964692,16188681,-14223989,406
2022-05-09 13:05:21-04:00,20562,8e3Du79eCAvuNc6ZX44quJRCuCxmjVDNhRHr1eTB3wqr,3Lb3b9ikztneijmjUzNgHKzCBBfFNKbpjAyc7DQ8pE2M,True,178863327,44715831,126142,63071,63071,5HnvdJnCCcmRsm4GkXnYWd4q9RpwuvYDGEUMPkYR3Ts9,5045691,107406723,-102361032,282
2022-05-09 13:05:29-04:00,20563,E3Tv8DA7HAQjNtMJ5GDaVvGj3RSsuqLGA99oV14vyrPU,2Bhtp9jmtvyj2FjK2M8RUKezH1gmV1RYCAzbDepzrrFS,True,50593482,2580743,10818,5409,5409,3zqXX6kzhkbW3d4TwD2CNjMRwxTbREXySekvq37kfCNk,2120838,24027824,-21906986,419
2022-05-09 13:05:33-04:00,20564,BQYbbwd1MLtj6fBuBiTncAaXdAqKWa1JbcbGkZbLA728,2Wsyr6KoMbSVSvFy3YzutuEQ6skGUZyVHGM42SN4eU98,True,6230430997,243253051,859253,429626,429627,72XWPCtRYEDZbddP7d6dHtUBRRDLSJsB2xZTAfefoEVZ,220080319,7948369298,-7728288979,353
2022-05-09 13:05:40-04:00,20565,6pUtYz474QrpATEZnfb3iFbTKYA65pNyKAo4TQZAjtqe,8dipRUXvxJiDLdHEtCPkso4vErbVwshHQiRfvSngBS9J,True,71681342,2807040,9729,4864,4865,Hu94aiQWvce6THeGyCFqGRPM1pQrK3ihzkcXo1EpJcJL,2484466,56395796,-53911330,346
2022-05-09 13:05:40-04:00,20566,hUBD9yh8fzVe8fkEEaHJbqJ1bfy3acpQkywhAFSyhLH,BH9ctVDPSTb4ESpz9SYrA1KdVNF37Hoyp2WMmo9Cz6Uy,False,25645706,25645706,770705,38535,732170,5HnvdJnCCcmRsm4GkXnYWd4q9RpwuvYDGEUMPkYR3Ts9,770705,14744999,-13974294,300
2022-05-09 13:05:42-04:00,20567,8J4BZXZzkK4SmWxc2YoaJRg9ivuuXbdVe5XpEhVds1ZM,3pirVwiye9NftvMpX5F7WpfcGZy5uV3c11xCdkkZbL9D,True,144202010,36050502,106712,53356,53356,5HnvdJnCCcmRsm4GkXnYWd4q9RpwuvYDGEUMPkYR3Ts9,4268496,31690194,-27421698,296
2022-05-09 13:05:47-04:00,20568,68gVM4kjmSYxT1uJW13rYSway8uVLUdcLa7sJuqHQaAf,DshroBQ3da7BcAiQpiFREsLKWbUDrBRmmZRw3Zu2Qfs9,False,28197446,28197446,847407,42370,805037,8sEswn3kzEhnYjAZVvCQnHEUvYd7pFVvc2Xc2Kd1BpbC,847407,9234952,-8387545,300
2022-05-09 13:05:58-04:00,20569,Ejg8vXVsro4jB2fpdUUXCRfKTiE5TUwfRXhHeR8qtrEi,GnF7xwsjzso48ZEAdYYuxNkJso7ug3s46uogi4XDbs1,True,58058986,14514746,43002,21501,21501,72FwbpFGoLEazJEdpqNtPNefsadUrimUqma9wSoy4qiS,1720083,18881135,-17161052,296
2022-05-09 13:06:02-04:00,20570,HwosLQgDY1xtHQRQ4hzroPQHFWssPzTj5vRkP37FcviB,HKTNEYNXrephNkH7apbobK4mcQXcNayQA4W1NgM6sLr8,False,190023,190023,7295,364,6931,5HnvdJnCCcmRsm4GkXnYWd4q9RpwuvYDGEUMPkYR3Ts9,7296,129000,-121704,383
2022-05-09 13:06:05-04:00,20571,E3Tv8DA7HAQjNtMJ5GDaVvGj3RSsuqLGA99oV14vyrPU,2Bhtp9jmtvyj2FjK2M8RUKezH1gmV1RYCAzbDepzrrFS,True,47863107,2161113,8851,4425,4426,2a35JJeTUW1pm6M3e8DHCjp8qr4vbc2cRPhuzZWyFzYd,1960388,22847682,-20887294,409
2022-05-09 13:06:07-04:00,20572,H9pFRayNBHTAhsbtGyfs1XXUWGxAbw7SgpT1xdrSRWEY,9LNreyXuhgyLCDYViNyA1jUw6h1nv4GmDtTYMoUQBqCG,True,1061102883,149700272,416742,208371,208371,F31bVJvHB2XkhGdgjyTim48hY2cLFEx661AiPS3SzYJ2,29539457,502553166,-473013709,278
2022-05-09 13:06:07-04:00,20573,h31YQCAHWdc5SKyX1swuYJCvU9yWUvr94DZoF6NRjkU,CAMppHi8Kbi71AURWdRjf9RyQqjjQrApUmq5LkYp1JLk,False,10069329,10069329,229563,11478,218085,68sueyVfmy5ToEGtLFGDkwebX47xAmzyXE29z8JrmcWv,229563,4195534,-3965971,227
2022-05-09 13:06:08-04:00,20574,7PzGZgzieFyyFs1dbajkNQgVxooFUNZrj1bUsQvrSwbp,A2gDREmSmJTBPPw3sbKVY3smC9wbHMDdv87gr4Tr2ES7,True,56695823,14173955,37631,18815,18816,8sEswn3kzEhnYjAZVvCQnHEUvYd7pFVvc2Xc2Kd1BpbC,1505273,11092368,-9587095,265
2022-05-09 13:06:09-04:00,20575,EyNCsqWu8zLyuRnXSbzJWnWZg7ZLjb4oJSZFdDSkbXmT,6rMMMkZibUHXYs8hXY3FmG4rgBx6gWDRGJwR2bP2t6ZD,True,11084575731,1914528431,6859135,3429567,3429568,DQCvC9mR68hJ3tJsUiddh6JwcBJAmntqGJR2nUsEq7yj,397124448,3068908017,-2671783569,358
2022-05-09 13:06:09-04:00,20576,7zuFEyLQFHkAjm3mAuxN42VenwF6fZcqM81mmR8sBnmY,CSnQxjc4Jn8iP4JSxj5wsrvxGsLoAYQn1bKC8naY7YZP,True,1815063081,453765770,1109788,554894,554894,gjBMZYVujDjD1ECG4i97M8Q3gV9ESnwwTSUGropkusj,44391546,234692845,-190301299,244
2022-05-09 13:06:09-04:00,20577,F9s8a7Cpiw5dw3a2aNFMofqwyDWNXvDLnSdJzoj1gRiV,GpKsQKJD79KBRWdCTkyi4zX7NaoCWsLUjrKxAwJB6o6s,True,5310789554,1326674703,3989581,1994790,1994791,2py1FiYeL2f7J3HU36qiJz6TD6HCmiTN36RyxYtapQCZ,159706303,628919330,-469213027,300
2022-05-09 13:06:09-04:00,20578,CvR57tmtnHbMmPivvJR6VenXivQaWue7z77N81WPpzfv,B4ASc8cUjrzuchv2SHwPrnjKvZgZpwvcLArsdYmMAqBQ,True,46256590,11564147,34959,17479,17480,2a35JJeTUW1pm6M3e8DHCjp8qr4vbc2cRPhuzZWyFzYd,1398369,15714981,-14316612,302
2022-05-09 13:06:11-04:00,20579,HeyRAEkqGTtCj2cMfGR6pbeY5nu4qERFmZSovsfhUtaq,5MDbdhQUt3USB1RFmdLsrAc5UUXZ1n8jXRQFtJ6ibj9B,True,45551165,11387790,37712,18856,18856,3zqXX6kzhkbW3d4TwD2CNjMRwxTbREXySekvq37kfCNk,1508561,15645057,-14136496,331
2022-05-09 13:06:11-04:00,20580,42h4NteqFpLjgjMS4gTTFoLvrEMpEP4sbGRd7SM5YCZR,AasJCLP5qsGzxkQs5jWysSarwoJTuZ6ZDeabNJNimWAX,False,550997090,550997090,9320509,466025,8854484,6UQfSsLooL4pQKQfLtXCutQS2BnF7A7F7ewJopDLmUpc,9320509,83579270,-74258761,169
2022-05-09 13:06:14-04:00,20581,Bzp3ZUxzRWqW4QoLq9PtKN1HQeSaKXFQrX1G3a4ocrre,H12B3p4v1ZtZ9gaSgpxCJsKXmmEjiqaRZQzexjzAhevo,True,747659027,101623279,362844,181422,181422,F31bVJvHB2XkhGdgjyTim48hY2cLFEx661AiPS3SzYJ2,26695059,444513607,-417818548,357
2022-05-09 13:06:14-04:00,20582,9dkQYcXQiH55NWkBrnLnCDF2nVvovzpxbpzDbhxmfk9C,6xHVNSYQTh9oTSMewwVvNa6ZZU7o5MmgCL5WQkD2AHWV,True,56321003,14080250,36404,18202,18202,3zqXX6kzhkbW3d4TwD2CNjMRwxTbREXySekvq37kfCNk,1456217,85153730,-83697513,258
2022-05-09 13:06:16-04:00,20583,E4VzeJLsf5Y6t3yNi8VpS8QxhJbJGPhnkNBmU2XoCBs9,63CXyYfevXtrL1QcfQtAhz29xeea5BwWcj6d6BWb4qiB,False,299824727,299824727,4924267,246213,4678054,A9TwRM1BMxqb8DCC7YNAMV6zPenEJm3HTZBy7wJKK58U,4924267,159650162,-154725895,164
2022-05-09 13:06:16-04:00,20584,9eWpSyu71Z6dmx7yTh7WrbVScdrrZN14d5tfmqEGFgXt,2r89PFKSD9zmSp2Wyx4CQ75HAtmUgwhAS2oG5MuYuiV6,True,111270913,9622777,36589,18294,18295,47z82br5WdW2DZajdnPDPSSRRKsyAggqXqK6oPUwTaLf,4230963,61198123,-56967160,380
2022-05-09 13:06:16-04:00,20585,HSF97F9d5EPgx4kGYuG4AfwHnh6bovzyTneYUouszBQp,Bh8fR6QoGS1ykk27256kFb2gjCVbQtu8Nu4Ls7GEKSAs,False,2478816343,2478816343,49170622,2458531,46712091,AmTrMPzuTp2BjnjqGNKqz9FTTCdpoKcPAJLwFc8ozcbh,49170622,1789935256,-1740764634,198
2022-05-09 13:06:18-04:00,20586,5tW54mXQxtM7vGc91HrDeDtWkxJeH2uM4yAviqZnMZCN,7Kg5Zwx5afFdLbTifeyKJLSNVj2p9Xf5anbbqQozNzmY,True,1769159182,380875907,2010697,1005348,1005349,A9TwRM1BMxqb8DCC7YNAMV6zPenEJm3HTZBy7wJKK58U,93396409,486836901,-393440492,527
2022-05-09 13:06:22-04:00,20587,EVMrznfJS54BZiywDD2WhUtxzicDtbEpm2a5yLrtCgRF,CpzsMYVYvKg8ihrX1cKRw7TDEYwD3kAyiX92hsf2KiTz,True,103096624,14346406,63732,31866,31866,Hu94aiQWvce6THeGyCFqGRPM1pQrK3ihzkcXo1EpJcJL,4580019,78448817,-73868798,444
2022-05-09 13:06:22-04:00,20588,m7gf1jAYXBZjRZEY9w4MjPfhzLwgDKaXyaCVhRD6C5E,Aa2aTZnpPux1i5K2MT4i1TsVM8vR7qR7rZGijQW4zpwd,True,185776715,46444178,147639,73819,73820,5HnvdJnCCcmRsm4GkXnYWd4q9RpwuvYDGEUMPkYR3Ts9,5905615,117331167,-111425552,317
2022-05-09 13:06:24-04:00,20589,m7gf1jAYXBZjRZEY9w4MjPfhzLwgDKaXyaCVhRD6C5E,Aa2aTZnpPux1i5K2MT4i1TsVM8vR7qR7rZGijQW4zpwd,True,139332537,13553762,56011,28005,28006,5HnvdJnCCcmRsm4GkXnYWd4q9RpwuvYDGEUMPkYR3Ts9,5757976,89327879,-83569903,413
2022-05-09 13:06:26-04:00,20590,6mCEvqP1YwHZNUT9orECs4tE3YzfD2Hfa5FTt9TLo8DH,ApWyeUDzPp6TBczuStvXxEAivhVVJrqC1rodNTNKNFR3,False,1336358,1336358,40069,2003,38066,47z82br5WdW2DZajdnPDPSSRRKsyAggqXqK6oPUwTaLf,40069,793369,-753300,299
2022-05-09 13:06:33-04:00,20591,E3Tv8DA7HAQjNtMJ5GDaVvGj3RSsuqLGA99oV14vyrPU,2Bhtp9jmtvyj2FjK2M8RUKezH1gmV1RYCAzbDepzrrFS,True,45458833,6026861,22648,11324,11324,6L1WYrPiCMyi7XemPww4B4hvpKD1LQKD4RpiSKmrmgSC,1708376,21249943,-19541567,375
2022-05-09 13:06:34-04:00,20592,iEXYXt9JNg6tud7wsHcTe349MNWHBgAoRptNpasAGwb,DNCFSLLWNWEVfsqht6EuiQ7PwCdzhHjDk9i4UpgnDTxB,True,258838334,45836977,143495,71747,71748,68sueyVfmy5ToEGtLFGDkwebX47xAmzyXE29z8JrmcWv,8103126,25567475,-17464349,313
2022-05-09 13:06:40-04:00,20593,8T4WK27RvWVGqPuNqY6whk1fmU4vd5qaUQPZG1GJ79bh,DvSz7knS8N3K7L6JhQf1s4mJSyxB8uJXNQXtyjJn8QRL,True,62350838,14209661,40891,20445,20446,C5o4TfkUfECutAWsDELjhsZX6PYyYgK3XeKvx6p4FphM,1794296,16596596,-14802300,287
2022-05-09 13:06:50-04:00,20594,CbhrZUdan1axNDFUrX1ZuEohfNMEGrszKSkk6pppVQuw,DHEAjJNtuEePezYAv77thWabbVxxqQpfuiC6moRSrpG1,False,383514,383514,10340,517,9823,47z82br5WdW2DZajdnPDPSSRRKsyAggqXqK6oPUwTaLf,10340,387868,-377528,269
2022-05-09 13:06:50-04:00,20595,EgpRPHPAC2cPBiar3SUD5PGZnzbCXBzUpa4KVTF5q9XY,2zf7NkfWagBWWts9RgacdRgkSzgJaChpFW5mMZczXa18,True,105234426,26308606,59316,29658,29658,F31bVJvHB2XkhGdgjyTim48hY2cLFEx661AiPS3SzYJ2,2372674,106567270,-104194596,225
2022-05-09 13:06:50-04:00,20596,BQYbbwd1MLtj6fBuBiTncAaXdAqKWa1JbcbGkZbLA728,2Wsyr6KoMbSVSvFy3YzutuEQ6skGUZyVHGM42SN4eU98,True,5943251146,1303612052,3844959,1922479,1922480,72XWPCtRYEDZbddP7d6dHtUBRRDLSJsB2xZTAfefoEVZ,175294266,7628261936,-7452967670,294
2022-05-09 13:06:51-04:00,20597,GcwFXxcxRF2xwbgFbQZoYEDreimd3J3UJ9sPfuwYVKtS,7uXjmKS8RxP2qSS7ataBH5hkfpgsFcpSBWUEBuV5zgyZ,False,28375374,28375374,730356,36517,693839,68sueyVfmy5ToEGtLFGDkwebX47xAmzyXE29z8JrmcWv,730356,9840230,-9109874,257
2022-05-09 13:06:52-04:00,20598,6pUtYz474QrpATEZnfb3iFbTKYA65pNyKAo4TQZAjtqe,8dipRUXvxJiDLdHEtCPkso4vErbVwshHQiRfvSngBS9J,True,68390052,14993663,43637,21818,21819,72FwbpFGoLEazJEdpqNtPNefsadUrimUqma9wSoy4qiS,1990487,53617845,-51627358,291
2022-05-09 13:06:53-04:00,20599,8J4BZXZzkK4SmWxc2YoaJRg9ivuuXbdVe5XpEhVds1ZM,3pirVwiye9NftvMpX5F7WpfcGZy5uV3c11xCdkkZbL9D,True,106125042,26531260,53382,26691,26691,72FwbpFGoLEazJEdpqNtPNefsadUrimUqma9wSoy4qiS,2135318,24728929,-22593611,201
2022-05-09 13:06:53-04:00,20600,FRbeFwhUYCiHW5oP26mad8KND7CCYDbfnoNxX7GuXVp8,GrzXKxPX2WDka8i2D8sunMUsrsThKasQi8NYLwuCGygV,True,62611246,15652811,55175,27587,27588,68sueyVfmy5ToEGtLFGDkwebX47xAmzyXE29z8JrmcWv,2207046,32905581,-30698535,352
2022-05-09 13:06:55-04:00,20601,CvR57tmtnHbMmPivvJR6VenXivQaWue7z77N81WPpzfv,B4ASc8cUjrzuchv2SHwPrnjKvZgZpwvcLArsdYmMAqBQ,False,34082255,34082255,753222,37661,715561,2a35JJeTUW1pm6M3e8DHCjp8qr4vbc2cRPhuzZWyFzYd,753222,12100968,-11347746,221
2022-05-09 13:06:55-04:00,20602,CxgBZovBTr5QSarLWNH7uvfct5AuswfkcaVQGSZ4M7RP,8cmWEK7LG1kuFufhLKoVWBXJGzoUWNU6vhGVAfsScBDj,True,52290163,6028073,24503,12251,12252,3zqXX6kzhkbW3d4TwD2CNjMRwxTbREXySekvq37kfCNk,2125562,29835570,-27710008,406
2022-05-09 13:06:56-04:00,20603,EHi1UBG8wMUFZECktsFUZkGjJPaBNEedswS62hyYn6jC,Drx9ErQhAjnPuJ83LPYFnY5ZV5XDzGuXDuSf16VqWayp,True,102993883,11517921,40834,20417,20417,3zqXX6kzhkbW3d4TwD2CNjMRwxTbREXySekvq37kfCNk,3651514,79558257,-75906743,354
2022-05-09 13:06:58-04:00,20604,8J4BZXZzkK4SmWxc2YoaJRg9ivuuXbdVe5XpEhVds1ZM,3pirVwiye9NftvMpX5F7WpfcGZy5uV3c11xCdkkZbL9D,True,79593695,19898423,52046,26023,26023,47z82br5WdW2DZajdnPDPSSRRKsyAggqXqK6oPUwTaLf,2081849,19027630,-16945781,261
2022-05-09 13:06:58-04:00,20605,9ancY5Fso8pUktKpRj3qc1YPQA6thy5n4f7uvNnsqMWR,CLUi9rvU9NTi7h4sNwqfr8aqChyGDbVJA1aKvKMWQv2r,False,205539421,205539421,2709084,135454,2573630,2a35JJeTUW1pm6M3e8DHCjp8qr4vbc2cRPhuzZWyFzYd,2709084,60594112,-57885028,131
2022-05-09 13:07:00-04:00,20606,BSUa3ArsftaRgVww5eEU9bFsq7bYRfRsdAWc1PY9Tqwp,4rtPyGw8SrDEZfLF7NZhKKp6opuBi5jxxwCb4CKtb4AR,True,44279922,11069979,36454,18227,18227,3zqXX6kzhkbW3d4TwD2CNjMRwxTbREXySekvq37kfCNk,1458261,19672276,-18214015,329
2022-05-09 13:07:01-04:00,20607,72F3iHXabQD5CDurG76r2riHaH8xGcKRqgBkDpmUnNMn,6Wue3rtmyr1RrEgDoK23ehAjymtLE8AYT2niknNe8Z7M,False,8968431,8968431,180180,9009,171171,5HnvdJnCCcmRsm4GkXnYWd4q9RpwuvYDGEUMPkYR3Ts9,180180,2839752,-2659572,200
2022-05-09 13:07:07-04:00,20608,8e3Du79eCAvuNc6ZX44quJRCuCxmjVDNhRHr1eTB3wqr,3Lb3b9ikztneijmjUzNgHKzCBBfFNKbpjAyc7DQ8pE2M,True,133165120,33291280,98429,49214,49215,3zqXX6kzhkbW3d4TwD2CNjMRwxTbREXySekvq37kfCNk,3937173,81690985,-77753812,295
2022-05-09 13:07:07-04:00,20609,DBT4GeddD8Ve8v7kerU1xrdJyy5moqUedcjYgM2jWESV,FVdbkwTpM3U6E4qQ9E2T9rTJ4dFYdkixsibnEiZqNUsA,False,155284691,155284691,2871514,143575,2727939,3zqXX6kzhkbW3d4TwD2CNjMRwxTbREXySekvq37kfCNk,2871514,53419192,-50547678,184
2022-05-09 13:07:15-04:00,20610,G5NLYTLxDZfJFKsJdMeWS8Ez95ZFwR5AX4hKhnfVJvoE,AwrC3pKhTeEDr1HCTWoKWjadteZccvqcisbC7vxTjn7w,False,2222706,2222706,63569,3178,60391,47z82br5WdW2DZajdnPDPSSRRKsyAggqXqK6oPUwTaLf,63569,2234522,-2170953,285
2022-05-09 13:07:21-04:00,20611,H9pFRayNBHTAhsbtGyfs1XXUWGxAbw7SgpT1xdrSRWEY,9LNreyXuhgyLCDYViNyA1jUw6h1nv4GmDtTYMoUQBqCG,True,905905228,226476306,590632,295316,295316,2py1FiYeL2f7J3HU36qiJz6TD6HCmiTN36RyxYtapQCZ,23625332,443432947,-419807615,260
2022-05-09 13:07:22-04:00,20612,A36aouot1oFLUtswuBUM4EVcis9chKaSJu53MRoPDjab,33U9gpq1RRFMGWDrWa3ezXXkwgBewdAS6QGgGVPtGvqb,False,1503997,1503997,40269,2013,38256,68sueyVfmy5ToEGtLFGDkwebX47xAmzyXE29z8JrmcWv,40269,1034124,-993855,267
2022-05-09 13:07:23-04:00,20613,GgAdS7cJ2KDgGE3xDrYAwqEEKqSsmfpEyBxtN4CMsjid,BidFJqkCxq71QWE7k8o4BnQjWQ61p4BT29jHgw4cC7b3,False,5029836,5029836,149863,7493,142370,68sueyVfmy5ToEGtLFGDkwebX47xAmzyXE29z8JrmcWv,149863,1792936,-1643073,297
2022-05-09 13:07:34-04:00,20614,8xvLGVeDmhVYQhN2ZpWkVG9jCrukRsNQ4926a4TMiZqa,9ciBySSjvADwp47WkETiFWZKVTFL8Hf1XvK7aSxhcgQS,False,103806,103806,2906,145,2761,68sueyVfmy5ToEGtLFGDkwebX47xAmzyXE29z8JrmcWv,2906,83856,-80950,279
2022-05-09 13:07:38-04:00,20615,fAJK1wrBhSW297AtFWX2U4rUBf2gkzfQ6UrQL9yHEYW,5pyTFpanSyUCHxeMhJMKtpdrcMSAWc8bFadbyM7q4q4B,False,65100336,65100336,1195623,59781,1135842,6L1WYrPiCMyi7XemPww4B4hvpKD1LQKD4RpiSKmrmgSC,1195623,9062155,-7866532,183
2022-05-09 13:07:38-04:00,20616,AXBfrbCpYAWKN5jgDVVMiKXscQ96YtotKV3DT6XSzm9o,Dh3SiHAqrQzPQnTLRMxtBn2EFyHNgyfnYGpgcuNGTvyL,True,21570410,5392602,31303,15651,15652,6L1WYrPiCMyi7XemPww4B4hvpKD1LQKD4RpiSKmrmgSC,1252140,13664833,-12412693,580
2022-05-09 13:07:44-04:00,20617,F4hN7ecndZ8Gr5KQNSFaSrMGawMasz7jfWTLTMpk7gaB,AJ23FpXSGjipcqywk88WGsKfqfiiUjPzZLsvLtBAhB12,True,375076881,43744764,178510,89255,89255,68sueyVfmy5ToEGtLFGDkwebX47xAmzyXE29z8JrmcWv,15305845,11398155,3907690,408
2022-05-09 13:07:50-04:00,20618,GtDk7DkAB2jvQynR57z8mjg6UoaTqYDr8Z4wsFX6KGSr,tAPvp4fscJZySZUVG2GZWZwSRVhfnNvkjCC6ZvmxqDQ,False,35502917,35502917,899037,44951,854086,47z82br5WdW2DZajdnPDPSSRRKsyAggqXqK6oPUwTaLf,899037,7802827,-6903790,253
2022-05-09 13:07:50-04:00,20619,4Eh2J8pz6nSz2E2BaPSMbDNhEovGA4QRmNtzAJPw9ZRi,CrHeEQC5KpQFLGhz2EpLYWgk7kWsqLPvEfLsSQvUxv61,False,3944708,3944708,107689,5384,102305,68sueyVfmy5ToEGtLFGDkwebX47xAmzyXE29z8JrmcWv,107689,2837216,-2729527,272
2022-05-09 13:07:54-04:00,20620,Aog11AwpgWF7UgvLLJbV5kn3UrJURYQUhnBFnAFSqbp8,2WXYGpuib3fK3BCXDQVQsoktEnASPuZfcnmC2AZ7KTQK,False,26694447,26694447,665795,33289,632506,47z82br5WdW2DZajdnPDPSSRRKsyAggqXqK6oPUwTaLf,665795,7242538,-6576743,249
2022-05-09 13:07:55-04:00,20621,GYgxUfZ19oSyHuovGRA6gBJT32goSxCrKR8hQQdBsrRG,2r8c6SU74hRq7xEmYBJ92WoSB6v6XCAXR3JcDznfCxkN,True,121001153,30250288,90493,45246,45247,68sueyVfmy5ToEGtLFGDkwebX47xAmzyXE29z8JrmcWv,3619722,96195991,-92576269,299
2022-05-09 13:07:55-04:00,20622,cG5VSSaBpjNdRLMQT7dmotpcWRTfdmJZYdWsrzNzRTE,5RESxV6aZenjAdaqw1jxoYSGttpLrNuZiRJy2WeLAVJv,False,11073222,11073222,303711,15185,288526,6L1WYrPiCMyi7XemPww4B4hvpKD1LQKD4RpiSKmrmgSC,303711,7578644,-7274933,274
2022-05-09 13:07:59-04:00,20623,BWJeoypk8ctbsFZ5jqc5ajV9qutjCknk4hRxEQobHwVi,GEAiFZAhBe1DnjXCDttq1oqVAUZ2uwRx7E5bhwRZtGJX,False,3679193,3679193,104986,5249,99737,68sueyVfmy5ToEGtLFGDkwebX47xAmzyXE29z8JrmcWv,104986,2542721,-2437735,285
2022-05-09 13:09:11-04:00,20624,Bzp3ZUxzRWqW4QoLq9PtKN1HQeSaKXFQrX1G3a4ocrre,H12B3p4v1ZtZ9gaSgpxCJsKXmmEjiqaRZQzexjzAhevo,True,649219693,42677752,197878,98939,98939,F31bVJvHB2XkhGdgjyTim48hY2cLFEx661AiPS3SzYJ2,30101606,397428372,-367326766,463
2022-05-09 13:12:46-04:00,20625,7BEY9qatFJomsayFmky3h3dAbKhY5XkRGwMobJuxXYhQ,J8MK3tAQKreBUG2reXY6gqr1uhbHhcAZEcxsLQmG5Ntt,True,182190505,45547626,324672,162336,162336,8sEswn3kzEhnYjAZVvCQnHEUvYd7pFVvc2Xc2Kd1BpbC,12986911,82770397,-69783486,712
2022-05-09 13:13:03-04:00,20626,6HtdpTubfGUuwW6rympMFLyUsdELKDpYagmkErBdLGc6,7e6N7pnwFYx9kU2TXJWt9gCsCpUZTxnFKzjDNZeyWQyq,False,12743380,12743380,693458,34672,658786,Hu94aiQWvce6THeGyCFqGRPM1pQrK3ihzkcXo1EpJcJL,693458,4543339,-3849881,544
2022-05-09 13:13:14-04:00,20627,7GpG8k6hM27vK1R5Sx1v5xUBuF6vybP41dcymjXDi5P7,7Aip6HDcbZ5mvoSucNupRS9enRdGx37F8L432K7V81do,True,22701242,5675310,31815,15907,15908,47z82br5WdW2DZajdnPDPSSRRKsyAggqXqK6oPUwTaLf,1272633,19076693,-17804060,560
2022-05-09 13:16:17-04:00,20628,F4hN7ecndZ8Gr5KQNSFaSrMGawMasz7jfWTLTMpk7gaB,AJ23FpXSGjipcqywk88WGsKfqfiiUjPzZLsvLtBAhB12,True,332317125,14218569,60679,30339,30340,F31bVJvHB2XkhGdgjyTim48hY2cLFEx661AiPS3SzYJ2,14182053,6280195,7901858,426
2022-05-09 13:17:09-04:00,20629,GCNi25P1Ywvfx5JpyxFVV68sRkio7LEhFgY85ZqveKR3,34mxz8fCss7KNAbEi2Wj9z5dTgXCGxuq2vyqzBPChtmq,True,851735339,212933834,612309,306154,306155,2xTUy2RS74GJMMDnmFaegMzFLn19RVfYG4CibhBmjP1i,24492361,356004491,-331512130,287
2022-05-09 13:17:09-04:00,20630,2tPYXtNrw134ACVhkYdnG9FGT4iHm61PuX8L7AfG9aAT,EyyPLVdjgewzVDKePQUj85BBttWy4MixVr9CSD8JVbrP,True,59536532,14884133,41704,20852,20852,2a35JJeTUW1pm6M3e8DHCjp8qr4vbc2cRPhuzZWyFzYd,1668160,32226089,-30557929,280
2022-05-09 13:17:09-04:00,20631,6xeNr9LhAfC6FRV62dALYdgx3bsoUpUpmEBiUPYCV5fz,8GP5cEpfNTEjvqm9usBUXs7jPCK5RciqjVJqtvX9fuGs,True,863575251,215893812,638495,319247,319248,Hu94aiQWvce6THeGyCFqGRPM1pQrK3ihzkcXo1EpJcJL,25539833,181459695,-155919862,295
2022-05-09 13:27:47-04:00,20632,4iCuPKeTUGU5NX1svHMm7z7kt4YdEeJmUTnwN95acfkP,3UQYJzipqQvXYNGhHrT8KJtU9QZZe7u7gW8xaaAnPGJx,True,422085019,67607148,194828,97414,97414,4yhyLx1phodwcvvwVU2bramHcdbJYvfadd7pANsRzX8M,12163578,40245516,-28081938,288
2022-05-09 13:40:20-04:00,20633,DLwEaZipqHmVBD5hc5v1NZtDStHyG4hAMwxywDTGGc2e,28GtwJw67UWfrSKxtuvpzoKzPyKXLgP3GKLm3fHdR566,False,13486725,13486725,842784,42139,800645,Hu94aiQWvce6THeGyCFqGRPM1pQrK3ihzkcXo1EpJcJL,842784,8619075,-7776291,624
2022-05-09 13:42:53-04:00,20634,6wGzqSWYjB1nukhDwLdgXDzMNSeasuRur3FVZAkVF4pM,HTcJjvQNFJQEewRf8iCcsZgFcfHoUXzpbb7WscqdK4kS,True,31753920,7938480,49026,24513,24513,2a35JJeTUW1pm6M3e8DHCjp8qr4vbc2cRPhuzZWyFzYd,1961073,10952628,-8991555,617
2022-05-09 13:48:34-04:00,20635,HooxSzasW3HMoFJ6sAvRQ75Char1J5aBdJtsqfDV6myp,BCmsWwpGeV4NNfeKZKKydty2uueLGHYTJDk1WErpXsVT,True,38200779,9550194,59199,29599,29600,8sEswn3kzEhnYjAZVvCQnHEUvYd7pFVvc2Xc2Kd1BpbC,2367976,16443656,-14075680,619
2022-05-09 13:51:52-04:00,20636,5FewDaMC9U7n5EHcto98GaAmDVxDh5SYimuTP6AtfakM,7DAULUoqV7f9hsBzKEhjQPnWaHSqiMWcBqWcdcadaQv4,True,79976774,19994193,124505,62252,62253,5HnvdJnCCcmRsm4GkXnYWd4q9RpwuvYDGEUMPkYR3Ts9,4980225,22413250,-17433025,622
2022-05-09 13:52:12-04:00,20637,7GpG8k6hM27vK1R5Sx1v5xUBuF6vybP41dcymjXDi5P7,7Aip6HDcbZ5mvoSucNupRS9enRdGx37F8L432K7V81do,True,16834517,4208629,26235,13117,13118,68sueyVfmy5ToEGtLFGDkwebX47xAmzyXE29z8JrmcWv,1049403,14593872,-13544469,623
2022-05-09 13:52:30-04:00,20638,4oMasDRj8HWfknmdwt6Mkz3eonr8J2byoiSTRo4sCnFQ,3emcATkEFvDVETiK97eVET2Z2jzkgiiSxX3gu5wsUKPe,True,81090094,11834585,78121,39060,39061,6L1WYrPiCMyi7XemPww4B4hvpKD1LQKD4RpiSKmrmgSC,5352843,61991647,-56638804,660
2022-05-09 13:53:09-04:00,20639,8uoS53t92hUWWx6mZHGhpKs3dkYJYyiRufnp4H1anBJH,E1Nc6fTaZ7EFFJqVDnEfV3odtasBRhEzbtg4JDFDzJ3k,True,37005585,9251396,57591,28795,28796,2a35JJeTUW1pm6M3e8DHCjp8qr4vbc2cRPhuzZWyFzYd,2303666,34900775,-32597109,622
2022-05-09 13:54:14-04:00,20640,HbJxpWkhz7Vn2iKtjtgWAuN6f2vQC38JJnTQGEFNDvxQ,HgchxTa4ji58Tw3XB5MH2WtnqcnrhocgLpPsfCQemfDf,True,373870999,93467749,241680,120840,120840,68sueyVfmy5ToEGtLFGDkwebX47xAmzyXE29z8JrmcWv,9667263,36006494,-26339231,258
2022-05-09 13:54:15-04:00,20641,EyNCsqWu8zLyuRnXSbzJWnWZg7ZLjb4oJSZFdDSkbXmT,6rMMMkZibUHXYs8hXY3FmG4rgBx6gWDRGJwR2bP2t6ZD,True,9165743773,846619759,3565044,1782522,1782522,4yhyLx1phodwcvvwVU2bramHcdbJYvfadd7pANsRzX8M,385961786,2674226866,-2288265080,421
2022-05-09 13:57:06-04:00,20642,532MfQR1PzPn6cmC1kpZsz9MyBWSamSeieh1F6GqVY33,6sJ8XXMZzGbHjVU1vWNW8unWoBZhJa54GguYJQhcb8PA,True,264537038,33362406,223176,111588,111588,8sEswn3kzEhnYjAZVvCQnHEUvYd7pFVvc2Xc2Kd1BpbC,17696097,82294111,-64598014,668
2022-05-09 13:59:31-04:00,20643,F4hN7ecndZ8Gr5KQNSFaSrMGawMasz7jfWTLTMpk7gaB,AJ23FpXSGjipcqywk88WGsKfqfiiUjPzZLsvLtBAhB12,True,318496143,32849165,134587,67293,67294,5HnvdJnCCcmRsm4GkXnYWd4q9RpwuvYDGEUMPkYR3Ts9,13049227,15443177,-2393950,409
2022-05-09 14:00:04-04:00,20644,2r64Rnbu3ZjmJTHHUxxV9TWWGzwpAepA4ySbtKivBXCj,6RRzx6KLkMiFK9JSuznrSJGiPgkHwatBSskudHqbfKJ5,False,15795463,15795463,979123,48956,930167,8sEswn3kzEhnYjAZVvCQnHEUvYd7pFVvc2Xc2Kd1BpbC,979124,15285765,-14306641,619
2022-05-09 14:00:15-04:00,20645,CxgBZovBTr5QSarLWNH7uvfct5AuswfkcaVQGSZ4M7RP,8cmWEK7LG1kuFufhLKoVWBXJGzoUWNU6vhGVAfsScBDj,True,46126294,2327922,9889,4944,4945,2a35JJeTUW1pm6M3e8DHCjp8qr4vbc2cRPhuzZWyFzYd,1959491,25833366,-23873875,424
2022-05-09 14:01:21-04:00,20646,EEQmHFk3WFNmPfe7ujtP1PK6P5yqV5mmWumNSoTu45P8,FG9DScQDQPrgcmBbRugZ5NfhSTRMnKSWLxcUeTF9MgJZ,True,63318065,15829516,46466,23233,23233,5HnvdJnCCcmRsm4GkXnYWd4q9RpwuvYDGEUMPkYR3Ts9,1858641,13886330,-12027689,293
2022-05-09 14:01:49-04:00,20647,EHi1UBG8wMUFZECktsFUZkGjJPaBNEedswS62hyYn6jC,Drx9ErQhAjnPuJ83LPYFnY5ZV5XDzGuXDuSf16VqWayp,True,91275684,4866193,18079,9039,9040,2a35JJeTUW1pm6M3e8DHCjp8qr4vbc2cRPhuzZWyFzYd,3391260,70530661,-67139401,371
2022-05-09 14:02:17-04:00,20648,F4hN7ecndZ8Gr5KQNSFaSrMGawMasz7jfWTLTMpk7gaB,AJ23FpXSGjipcqywk88WGsKfqfiiUjPzZLsvLtBAhB12,True,285233735,13413550,56817,28408,28409,F31bVJvHB2XkhGdgjyTim48hY2cLFEx661AiPS3SzYJ2,12082061,11592173,489888,423
2022-05-09 14:07:22-04:00,20649,7GpG8k6hM27vK1R5Sx1v5xUBuF6vybP41dcymjXDi5P7,7Aip6HDcbZ5mvoSucNupRS9enRdGx37F8L432K7V81do,False,12381357,12381357,773099,38654,734445,2a35JJeTUW1pm6M3e8DHCjp8qr4vbc2cRPhuzZWyFzYd,773099,11175987,-10402888,624
2022-05-09 14:09:15-04:00,20650,HGAFdundf5voDqeh9g7d6Q9mgMf8eEg898QMRBqwPZ6C,deanBuZXWBHEe2TGfP37S9aMBEnEgmZoyRJjAvruzfA,False,37683,37683,1731,86,1645,Hu94aiQWvce6THeGyCFqGRPM1pQrK3ihzkcXo1EpJcJL,1732,55132,-53400,459
2022-05-09 14:09:20-04:00,20651,4oMasDRj8HWfknmdwt6Mkz3eonr8J2byoiSTRo4sCnFQ,3emcATkEFvDVETiK97eVET2Z2jzkgiiSxX3gu5wsUKPe,True,68405700,8439961,54402,27201,27201,5HnvdJnCCcmRsm4GkXnYWd4q9RpwuvYDGEUMPkYR3Ts9,4409297,53804121,-49394824,644
2022-05-09 14:09:20-04:00,20652,BSUa3ArsftaRgVww5eEU9bFsq7bYRfRsdAWc1PY9Tqwp,4rtPyGw8SrDEZfLF7NZhKKp6opuBi5jxxwCb4CKtb4AR,True,33125335,1466933,5893,2946,2947,6L1WYrPiCMyi7XemPww4B4hvpKD1LQKD4RpiSKmrmgSC,1330755,15075894,-13745139,401
2022-05-09 14:09:32-04:00,20653,CxgBZovBTr5QSarLWNH7uvfct5AuswfkcaVQGSZ4M7RP,8cmWEK7LG1kuFufhLKoVWBXJGzoUWNU6vhGVAfsScBDj,True,43654775,2054643,8484,4242,4242,8sEswn3kzEhnYjAZVvCQnHEUvYd7pFVvc2Xc2Kd1BpbC,1802798,24398188,-22595390,412
2022-05-09 14:09:35-04:00,20654,E3Tv8DA7HAQjNtMJ5GDaVvGj3RSsuqLGA99oV14vyrPU,2Bhtp9jmtvyj2FjK2M8RUKezH1gmV1RYCAzbDepzrrFS,True,39303509,3778754,14900,7450,7450,8sEswn3kzEhnYjAZVvCQnHEUvYd7pFVvc2Xc2Kd1BpbC,1549886,18809213,-17259327,394
2022-05-09 14:10:11-04:00,20655,532MfQR1PzPn6cmC1kpZsz9MyBWSamSeieh1F6GqVY33,6sJ8XXMZzGbHjVU1vWNW8unWoBZhJa54GguYJQhcb8PA,True,228605739,32093008,208416,104208,104208,4yhyLx1phodwcvvwVU2bramHcdbJYvfadd7pANsRzX8M,14845984,74348868,-59502884,649
2022-05-09 14:10:47-04:00,20656,Eo5LYLiUCspbrK13ker5skq9kMjnpUJEJPSbRDWjH6V4,GefeNAw5BdDkibatZknZVGsLhkfc8wfxriEfjHNpvMPm,True,1017934947,254483736,769924,384962,384962,72XWPCtRYEDZbddP7d6dHtUBRRDLSJsB2xZTAfefoEVZ,30796975,364422949,-333625974,302
2022-05-09 14:11:01-04:00,20657,E3Tv8DA7HAQjNtMJ5GDaVvGj3RSsuqLGA99oV14vyrPU,2Bhtp9jmtvyj2FjK2M8RUKezH1gmV1RYCAzbDepzrrFS,True,35431736,1535150,6247,3123,3124,6L1WYrPiCMyi7XemPww4B4hvpKD1LQKD4RpiSKmrmgSC,1441967,17573056,-16131089,406
2022-05-09 14:11:09-04:00,20658,BSUa3ArsftaRgVww5eEU9bFsq7bYRfRsdAWc1PY9Tqwp,4rtPyGw8SrDEZfLF7NZhKKp6opuBi5jxxwCb4CKtb4AR,True,31561348,2863294,11138,5569,5569,C4UnXuShCvjSMgBAgVNMy1oakxCNk1et27A82fywU112,1227808,14427556,-13199748,389
2022-05-09 14:11:10-04:00,20659,EHi1UBG8wMUFZECktsFUZkGjJPaBNEedswS62hyYn6jC,Drx9ErQhAjnPuJ83LPYFnY5ZV5XDzGuXDuSf16VqWayp,True,86112372,9299721,33219,16609,16610,5HnvdJnCCcmRsm4GkXnYWd4q9RpwuvYDGEUMPkYR3Ts9,3076062,64819312,-61743250,357
2022-05-09 14:11:29-04:00,20660,8T4WK27RvWVGqPuNqY6whk1fmU4vd5qaUQPZG1GJ79bh,DvSz7knS8N3K7L6JhQf1s4mJSyxB8uJXNQXtyjJn8QRL,True,48014182,10652393,35956,17978,17978,5HnvdJnCCcmRsm4GkXnYWd4q9RpwuvYDGEUMPkYR3Ts9,1620701,14221423,-12600722,337
2022-05-09 14:11:29-04:00,20661,6pUtYz474QrpATEZnfb3iFbTKYA65pNyKAo4TQZAjtqe,8dipRUXvxJiDLdHEtCPkso4vErbVwshHQiRfvSngBS9J,True,53334586,2062786,7253,3626,3627,5HnvdJnCCcmRsm4GkXnYWd4q9RpwuvYDGEUMPkYR3Ts9,1875573,42735532,-40859959,351
2022-05-09 14:11:32-04:00,20662,CxgBZovBTr5QSarLWNH7uvfct5AuswfkcaVQGSZ4M7RP,8cmWEK7LG1kuFufhLKoVWBXJGzoUWNU6vhGVAfsScBDj,True,41473169,3600979,14476,7238,7238,8sEswn3kzEhnYjAZVvCQnHEUvYd7pFVvc2Xc2Kd1BpbC,1667351,22694346,-21026995,402
2022-05-09 14:11:38-04:00,20663,EyNCsqWu8zLyuRnXSbzJWnWZg7ZLjb4oJSZFdDSkbXmT,6rMMMkZibUHXYs8hXY3FmG4rgBx6gWDRGJwR2bP2t6ZD,True,8269797411,1437837996,5764223,2882111,2882112,GXyFXZMNk2NFyEzw6JetVqsujqcz2yCixH7n8EpDJYWD,331532233,2380109691,-2048577458,400
2022-05-09 14:12:21-04:00,20664,4oMasDRj8HWfknmdwt6Mkz3eonr8J2byoiSTRo4sCnFQ,3emcATkEFvDVETiK97eVET2Z2jzkgiiSxX3gu5wsUKPe,True,59553929,8601181,56948,28474,28474,Hu94aiQWvce6THeGyCFqGRPM1pQrK3ihzkcXo1EpJcJL,3943085,47686072,-43742987,662
2022-05-09 14:12:29-04:00,20665,BQYbbwd1MLtj6fBuBiTncAaXdAqKWa1JbcbGkZbLA728,2Wsyr6KoMbSVSvFy3YzutuEQ6skGUZyVHGM42SN4eU98,True,4631229255,178587103,625556,312778,312778,DA18qE9qesbBqpwNv1M4befYcNQkbSBSeLPTmQzrmbJw,162223047,6000415120,-5838192073,350
2022-05-09 14:12:31-04:00,20666,DRVtEzZs9u9ysrcANZLEjrvbuuGqYn77v2h4cDFKuNUx,Fv9qiMZhuSBL2cs9AWUYbDLQjB46W2ZwrhxaNXtPLDpC,True,1428502423,357125605,1028759,514379,514380,2py1FiYeL2f7J3HU36qiJz6TD6HCmiTN36RyxYtapQCZ,41150389,214431407,-173281018,288
2022-05-09 14:12:34-04:00,20667,3Xbsek5MsEGoWr3G9yhuohREr26B2vSQcjqXdspTFHta,2rPxkUiMo9wGDq8EvAiwY3ngRpKmL223cBWWNTYoBmFp,True,58488142,14622035,41026,20513,20513,2a35JJeTUW1pm6M3e8DHCjp8qr4vbc2cRPhuzZWyFzYd,1641064,10306380,-8665316,280
2022-05-09 14:12:34-04:00,20668,5xkW7wHTcF5WadNtBBqKPKctVwyQtTqqscivAmxzseCk,7m31ZMZdCn5Gz2q5sETWA7uKA5LsKD7pJHBBqU3g7tCn,True,84856999,21214249,61703,30851,30852,8sEswn3kzEhnYjAZVvCQnHEUvYd7pFVvc2Xc2Kd1BpbC,2468131,19378132,-16910001,290
2022-05-09 14:12:35-04:00,20669,92cQnCMBkPL8DmE4xYQXJVAQ8EXk3moXXVHaM2zQT4uj,A5MAQitMT3yojsCtjyq9pypZQP9Df6m95X5srsEXaxr6,True,1675572813,418893203,1256206,628103,628103,AmTrMPzuTp2BjnjqGNKqz9FTTCdpoKcPAJLwFc8ozcbh,50248266,1914783757,-1864535491,299
2022-05-09 14:12:37-04:00,20670,HXQXfEQe7aCpr6WKh37XaDZsjZcuQPk5t8tWNFgEoK6U,5ufXkCEDwgiXwtyPye4wYVVA3oLW54JVzz4tnXFofto4,True,57522793,14380698,42578,21289,21289,2a35JJeTUW1pm6M3e8DHCjp8qr4vbc2cRPhuzZWyFzYd,1703128,32067982,-30364854,296
2022-05-09 14:12:50-04:00,20671,9L2rA8qtfvjKMzqtLn9Cc9Y3ih1e8Z3w9huDzyZXg1xk,GopCtogALLkVyW1T3FGofVWMmjnsdG6EkpJUWob3svaP,True,36060698,9015174,26901,13450,13451,8sEswn3kzEhnYjAZVvCQnHEUvYd7pFVvc2Xc2Kd1BpbC,1076047,9040502,-7964455,298
2022-05-09 14:13:00-04:00,20672,BSUa3ArsftaRgVww5eEU9bFsq7bYRfRsdAWc1PY9Tqwp,4rtPyGw8SrDEZfLF7NZhKKp6opuBi5jxxwCb4CKtb4AR,True,28609185,2751712,10847,5423,5424,Hu94aiQWvce6THeGyCFqGRPM1pQrK3ihzkcXo1EpJcJL,1127801,13529699,-12401898,394
2022-05-09 14:13:00-04:00,20673,CZhzJ91hP1pFbNNz7YnUKXznvs6ZFVSRNLbe1SaTw29o,X3B4LpHFfeJPmCnEmRQ8V6MNMi7KpTE4MLD7LHYXUwy,True,1154790249,73756247,280510,140255,140255,2a35JJeTUW1pm6M3e8DHCjp8qr4vbc2cRPhuzZWyFzYd,43919168,249168690,-205249522,380
2022-05-09 14:13:00-04:00,20674,532MfQR1PzPn6cmC1kpZsz9MyBWSamSeieh1F6GqVY33,6sJ8XXMZzGbHjVU1vWNW8unWoBZhJa54GguYJQhcb8PA,True,194681521,24841131,163407,81703,81704,8sEswn3kzEhnYjAZVvCQnHEUvYd7pFVvc2Xc2Kd1BpbC,12806358,64978633,-52172275,657
2022-05-09 14:13:00-04:00,20675,E3Tv8DA7HAQjNtMJ5GDaVvGj3RSsuqLGA99oV14vyrPU,2Bhtp9jmtvyj2FjK2M8RUKezH1gmV1RYCAzbDepzrrFS,True,33799483,3061045,12123,6061,6062,Hu94aiQWvce6THeGyCFqGRPM1pQrK3ihzkcXo1EpJcJL,1338617,16289457,-14950840,396
2022-05-09 14:13:08-04:00,20676,6qDAr9rGtFMeiTx9KfAeu3WBqiZzRzEtMfipFaZ2gQiJ,MGfCsHXhA5C6S28qKoQjeZmn28dehGUJ4MLSaic7CfB,True,1524837024,381209256,2361730,1180865,1180865,Hu94aiQWvce6THeGyCFqGRPM1pQrK3ihzkcXo1EpJcJL,94469218,475806418,-381337200,619
2022-05-09 14:13:17-04:00,20677,CxgBZovBTr5QSarLWNH7uvfct5AuswfkcaVQGSZ4M7RP,8cmWEK7LG1kuFufhLKoVWBXJGzoUWNU6vhGVAfsScBDj,True,37761779,1741937,7115,3557,3558,2a35JJeTUW1pm6M3e8DHCjp8qr4vbc2cRPhuzZWyFzYd,1542464,21280839,-19738375,408
2022-05-09 14:13:17-04:00,20678,6pUtYz474QrpATEZnfb3iFbTKYA65pNyKAo4TQZAjtqe,8dipRUXvxJiDLdHEtCPkso4vErbVwshHQiRfvSngBS9J,True,51152096,4207485,14383,7191,7192,8sEswn3kzEhnYjAZVvCQnHEUvYd7pFVvc2Xc2Kd1BpbC,1748616,40609618,-38861002,341
2022-05-09 14:13:47-04:00,20679,4MSyrHopFkuaCEEvLAUV9cJfVre6cLAx5sJF5LEMSCTX,6HhLHoswuDKrcixShWCDcquW6PgmbS5FidEnkM3bwuJQ,False,288277,288277,8522,426,8096,2a35JJeTUW1pm6M3e8DHCjp8qr4vbc2cRPhuzZWyFzYd,8522,132517,-123995,295
2022-05-09 14:13:49-04:00,20680,AL8JFS4gjaQx89f9j8wtaNJgV76K8bw1ugvNtgvhgAnb,HJYvG2kGKe8kXgtZSWTWwTmSjxA3XUeCvyT7acoKtS1C,True,3657125628,914281407,2678399,1339199,1339200,gjBMZYVujDjD1ECG4i97M8Q3gV9ESnwwTSUGropkusj,107135999,1214418079,-1107282080,292
2022-05-09 14:13:50-04:00,20681,BePQMfbkFe8vQ54rFkkf2dzXunPq2Xwpibrm1JVzSHLz,8R6rnjVUnMGUxx5sRjnuuyEnfyBGeet7y2jSJwVswyT3,True,15359543228,3839885807,11292618,5646309,5646309,8HQmsTbxhLhy25fvfCb16HudTGQ9wkHoEBRz5WYeqiZw,451704749,4677830107,-4226125358,294
2022-05-09 14:13:51-04:00,20682,7zuFEyLQFHkAjm3mAuxN42VenwF6fZcqM81mmR8sBnmY,CSnQxjc4Jn8iP4JSxj5wsrvxGsLoAYQn1bKC8naY7YZP,True,1358099142,339524785,999375,499687,499688,2py1FiYeL2f7J3HU36qiJz6TD6HCmiTN36RyxYtapQCZ,39975039,185947223,-145972184,294
2022-05-09 14:13:53-04:00,20683,EHi1UBG8wMUFZECktsFUZkGjJPaBNEedswS62hyYn6jC,Drx9ErQhAjnPuJ83LPYFnY5ZV5XDzGuXDuSf16VqWayp,True,76513155,8559194,30688,15344,15344,C4UnXuShCvjSMgBAgVNMy1oakxCNk1et27A82fywU112,2743347,60405737,-57662390,358
2022-05-09 14:13:55-04:00,20684,BQYbbwd1MLtj6fBuBiTncAaXdAqKWa1JbcbGkZbLA728,2Wsyr6KoMbSVSvFy3YzutuEQ6skGUZyVHGM42SN4eU98,True,4442652523,357431031,1219752,609876,609876,72XWPCtRYEDZbddP7d6dHtUBRRDLSJsB2xZTAfefoEVZ,151607862,5756489874,-5604882012,341
2022-05-09 14:14:06-04:00,20685,27EpDzAwbab8WrHcBC8WUpTkujhjR8MPXXxf4PAVX2Cv,D9GQg6FhMvTok1sM5CokhA6tNmwssA7dSyicCBcqWEuY,False,11511107,11511107,345847,17292,328555,C4UnXuShCvjSMgBAgVNMy1oakxCNk1et27A82fywU112,345847,4930140,-4584293,300
2022-05-09 14:14:08-04:00,20686,HeyRAEkqGTtCj2cMfGR6pbeY5nu4qERFmZSovsfhUtaq,5MDbdhQUt3USB1RFmdLsrAc5UUXZ1n8jXRQFtJ6ibj9B,True,34070379,1499782,6036,3018,3018,6L1WYrPiCMyi7XemPww4B4hvpKD1LQKD4RpiSKmrmgSC,1371359,12066747,-10695388,402
2022-05-09 14:14:31-04:00,20687,6v2KNGc2fG2d6gej4197zgxpPZHY8cdd7wXxyceEPowK,3u6LAZVkQRKaxNkTwACrDMXMf5fEY3VZmrUr4t2pAyE9,True,125141120,31285280,91482,45741,45741,4yhyLx1phodwcvvwVU2bramHcdbJYvfadd7pANsRzX8M,3659311,44269377,-40610066,292
2022-05-09 14:14:31-04:00,20688,3VYtHvoT9wi4K1PBjg6JjCf6U9fVPDf6tX9jyRRvLxcg,Ba5fjpVyAxLbiP6hYJmrxzougi7JUEDfDLKBxSbbTL7q,True,1462627949,365656987,1091777,545888,545889,A9TwRM1BMxqb8DCC7YNAMV6zPenEJm3HTZBy7wJKK58U,43671107,79171044,-35499937,298
2022-05-09 14:14:37-04:00,20689,A7j77tzgnQVGtHTa65VtVZqJRYeJvQk7am8NW6e66379,4vJGwEvXU2tGWoWWGwbsYcfKQAMCHbrBMRk4ZVFzneLs,True,46108712,11527178,33939,16969,16970,6L1WYrPiCMyi7XemPww4B4hvpKD1LQKD4RpiSKmrmgSC,1357570,18689522,-17331952,294
2022-05-09 14:14:42-04:00,20690,Ejg8vXVsro4jB2fpdUUXCRfKTiE5TUwfRXhHeR8qtrEi,GnF7xwsjzso48ZEAdYYuxNkJso7ug3s46uogi4XDbs1,True,43153713,10788428,31914,15957,15957,68sueyVfmy5ToEGtLFGDkwebX47xAmzyXE29z8JrmcWv,1276588,14537945,-13261357,295
2022-05-09 14:14:46-04:00,20691,9XuUGP13n5xuMtUYhAH1fe9jFKK7FjgTzcuJqDfV1gqC,AFNffLzWzrg7vgdwxyHeaSc6kUtqYPV8pRvdUx8wt7x3,True,8134835395,2033708848,5943442,2971721,2971721,2xTUy2RS74GJMMDnmFaegMzFLn19RVfYG4CibhBmjP1i,237737704,416485138,-178747434,292
2022-05-09 14:14:47-04:00,20692,5hfwMBNetuL1wYHVXrGkKWNAjKyN8WhmqjZd8EjXYN8d,DT9rQfjr27ULJ5PiQ3pShDFvT4LyV6ogcSXnp4mUdwhY,True,206262748,51565687,152273,76136,76137,8sEswn3kzEhnYjAZVvCQnHEUvYd7pFVvc2Xc2Kd1BpbC,6090944,60400696,-54309752,295
2022-05-09 14:21:21-04:00,20693,EuCmBVG3iBdaofTrthgKu5WZ9fJivBjSQRzkJurGMQYt,BLsKaPzKnDhZwwk2pTerwkZ6WpbeQAmY7db46aZvtJtA,False,5885,5885,177,8,169,5HnvdJnCCcmRsm4GkXnYWd4q9RpwuvYDGEUMPkYR3Ts9,177,9862,-9685,300
2022-05-09 14:21:30-04:00,20694,2iHmrYwG4wYoUqX1uZhx1TMAWn3JdUx3idqQ7T5e1eAx,EvtnpMHszPxf8rgvmdfmnpwwcCDz135CN9SXZwRvTorG,True,328435848,82108962,247180,123590,123590,47z82br5WdW2DZajdnPDPSSRRKsyAggqXqK6oPUwTaLf,9887215,871433182,-861545967,301
2022-05-09 14:21:34-04:00,20695,2tPYXtNrw134ACVhkYdnG9FGT4iHm61PuX8L7AfG9aAT,EyyPLVdjgewzVDKePQUj85BBttWy4MixVr9CSD8JVbrP,True,44353068,11088267,32921,16460,16461,5HnvdJnCCcmRsm4GkXnYWd4q9RpwuvYDGEUMPkYR3Ts9,1316876,24534704,-23217828,296
2022-05-09 14:21:34-04:00,20696,EVMrznfJS54BZiywDD2WhUtxzicDtbEpm2a5yLrtCgRF,CpzsMYVYvKg8ihrX1cKRw7TDEYwD3kAyiX92hsf2KiTz,True,88384886,6035602,28181,14090,14091,8sEswn3kzEhnYjAZVvCQnHEUvYd7pFVvc2Xc2Kd1BpbC,4126920,71588854,-67461934,466
2022-05-09 14:22:00-04:00,20697,GMpoV2jRyLdf2V3Gb5TQZ5gEs5ftMjD3JhFUzkA6fWVz,5bi814d5gdToTLVWCmbdB6J15kMdsTQk74cZTRd62p81,True,99015533,24753883,175131,87565,87566,8sEswn3kzEhnYjAZVvCQnHEUvYd7pFVvc2Xc2Kd1BpbC,7005249,42053983,-35048734,707
2022-05-09 14:22:05-04:00,20698,HooxSzasW3HMoFJ6sAvRQ75Char1J5aBdJtsqfDV6myp,BCmsWwpGeV4NNfeKZKKydty2uueLGHYTJDk1WErpXsVT,True,28063291,7015822,42734,21367,21367,5HnvdJnCCcmRsm4GkXnYWd4q9RpwuvYDGEUMPkYR3Ts9,1709376,12853453,-11144077,609
2022-05-09 14:22:40-04:00,20699,BSUa3ArsftaRgVww5eEU9bFsq7bYRfRsdAWc1PY9Tqwp,4rtPyGw8SrDEZfLF7NZhKKp6opuBi5jxxwCb4CKtb4AR,True,25797190,1148909,4705,2352,2353,2a35JJeTUW1pm6M3e8DHCjp8qr4vbc2cRPhuzZWyFzYd,1056671,12521729,-11465058,409
2022-05-09 14:22:52-04:00,20700,5FewDaMC9U7n5EHcto98GaAmDVxDh5SYimuTP6AtfakM,7DAULUoqV7f9hsBzKEhjQPnWaHSqiMWcBqWcdcadaQv4,True,58810066,14702516,91444,45722,45722,2a35JJeTUW1pm6M3e8DHCjp8qr4vbc2cRPhuzZWyFzYd,3657767,17905140,-14247373,621
2022-05-09 14:22:55-04:00,20701,CxgBZovBTr5QSarLWNH7uvfct5AuswfkcaVQGSZ4M7RP,8cmWEK7LG1kuFufhLKoVWBXJGzoUWNU6vhGVAfsScBDj,True,35905722,3464580,13713,6856,6857,6L1WYrPiCMyi7XemPww4B4hvpKD1LQKD4RpiSKmrmgSC,1421229,20203157,-18781928,395
2022-05-09 14:22:55-04:00,20702,CZhzJ91hP1pFbNNz7YnUKXznvs6ZFVSRNLbe1SaTw29o,X3B4LpHFfeJPmCnEmRQ8V6MNMi7KpTE4MLD7LHYXUwy,True,1076599034,123214116,448676,224338,224338,2a35JJeTUW1pm6M3e8DHCjp8qr4vbc2cRPhuzZWyFzYd,39203690,228897681,-189693991,364
2022-05-09 14:22:56-04:00,20703,EyNCsqWu8zLyuRnXSbzJWnWZg7ZLjb4oJSZFdDSkbXmT,6rMMMkZibUHXYs8hXY3FmG4rgBx6gWDRGJwR2bP2t6ZD,True,6783610270,623992216,2551844,1275922,1275922,8HQmsTbxhLhy25fvfCb16HudTGQ9wkHoEBRz5WYeqiZw,277418865,2085013719,-1807594854,408
2022-05-09 14:22:58-04:00,20704,EHi1UBG8wMUFZECktsFUZkGjJPaBNEedswS62hyYn6jC,Drx9ErQhAjnPuJ83LPYFnY5ZV5XDzGuXDuSf16VqWayp,True,67706745,3591108,13076,6538,6538,3zqXX6kzhkbW3d4TwD2CNjMRwxTbREXySekvq37kfCNk,2465443,53570071,-51104628,364
2022-05-09 14:23:00-04:00,20705,E3Tv8DA7HAQjNtMJ5GDaVvGj3RSsuqLGA99oV14vyrPU,2Bhtp9jmtvyj2FjK2M8RUKezH1gmV1RYCAzbDepzrrFS,True,30648023,1431187,5772,2886,2886,5HnvdJnCCcmRsm4GkXnYWd4q9RpwuvYDGEUMPkYR3Ts9,1236079,15119618,-13883539,403
2022-05-09 14:23:08-04:00,20706,EEQmHFk3WFNmPfe7ujtP1PK6P5yqV5mmWumNSoTu45P8,FG9DScQDQPrgcmBbRugZ5NfhSTRMnKSWLxcUeTF9MgJZ,True,47070072,11767518,34842,17421,17421,C4UnXuShCvjSMgBAgVNMy1oakxCNk1et27A82fywU112,1393698,10833005,-9439307,296
2022-05-09 14:23:12-04:00,20707,6pUtYz474QrpATEZnfb3iFbTKYA65pNyKAo4TQZAjtqe,8dipRUXvxJiDLdHEtCPkso4vErbVwshHQiRfvSngBS9J,True,46782734,3580698,12034,6017,6017,8sEswn3kzEhnYjAZVvCQnHEUvYd7pFVvc2Xc2Kd1BpbC,1572356,35271745,-33699389,336
2022-05-09 14:23:14-04:00,20708,EitU96ThqHErybDn2j1NY6JHkqV1R3mWM1uWH7wYKr1T,2p9eYbLyBqXrhHtRKp1jJb7VGjCmb4LkA6kzqLr1ijet,False,654004,654004,19738,986,18752,8sEswn3kzEhnYjAZVvCQnHEUvYd7pFVvc2Xc2Kd1BpbC,19738,426031,-406293,301
2022-05-09 14:23:16-04:00,20709,BSUa3ArsftaRgVww5eEU9bFsq7bYRfRsdAWc1PY9Tqwp,4rtPyGw8SrDEZfLF7NZhKKp6opuBi5jxxwCb4CKtb4AR,False,24583990,24583990,987673,49383,938290,8sEswn3kzEhnYjAZVvCQnHEUvYd7pFVvc2Xc2Kd1BpbC,987675,11556557,-10568882,401
2022-05-09 14:23:16-04:00,20710,AWvHDdb2ikqV8wc7qQ8azbvNTZdixMNxhQjhQdhayYtR,9EpgEPBb1nog6aQeFdMXfSRiLSnzGQFQ39mbLdCxgYTv,False,192542,192542,5032,251,4781,68sueyVfmy5ToEGtLFGDkwebX47xAmzyXE29z8JrmcWv,5032,127847,-122815,261
2022-05-09 14:23:16-04:00,20711,6pUtYz474QrpATEZnfb3iFbTKYA65pNyKAo4TQZAjtqe,8dipRUXvxJiDLdHEtCPkso4vErbVwshHQiRfvSngBS9J,True,43141663,3417932,11883,5941,5942,Hu94aiQWvce6THeGyCFqGRPM1pQrK3ihzkcXo1EpJcJL,1499949,33931639,-32431690,347
2022-05-09 14:23:19-04:00,20712,8m9tCYNQrHhH5hx4Me2PfeqVzJGVTZvTepHYHkh6rvEW,6fTSaXH5NDwGSC12foFEeXwVGyNhTqVXABp8Qni5cHMP,False,8164032,8164032,246491,12324,234167,8sEswn3kzEhnYjAZVvCQnHEUvYd7pFVvc2Xc2Kd1BpbC,246491,3527859,-3281368,301
2022-05-09 14:23:20-04:00,20713,zLTuMVfVswjMkhyvjaXnvjcKXv5xNk3iSWSjRGpVqXf,J3D8NHUJCiSjvFYfJ5Es4YDhF1KcPZWRUmCQ5L92t8eB,False,1777935,1777935,46553,2327,44226,Hu94aiQWvce6THeGyCFqGRPM1pQrK3ihzkcXo1EpJcJL,46553,647132,-600579,261
2022-05-09 14:23:26-04:00,20714,HeyRAEkqGTtCj2cMfGR6pbeY5nu4qERFmZSovsfhUtaq,5MDbdhQUt3USB1RFmdLsrAc5UUXZ1n8jXRQFtJ6ibj9B,True,32477872,2926141,11465,5732,5733,Hu94aiQWvce6THeGyCFqGRPM1pQrK3ihzkcXo1EpJcJL,1272598,11451115,-10178517,391
2022-05-09 14:23:35-04:00,20715,BQYbbwd1MLtj6fBuBiTncAaXdAqKWa1JbcbGkZbLA728,2Wsyr6KoMbSVSvFy3YzutuEQ6skGUZyVHGM42SN4eU98,True,4069047625,320134733,1055938,527969,527969,gjBMZYVujDjD1ECG4i97M8Q3gV9ESnwwTSUGropkusj,134214243,5057966572,-4923752329,329
2022-05-09 14:23:37-04:00,20716,GCNi25P1Ywvfx5JpyxFVV68sRkio7LEhFgY85ZqveKR3,34mxz8fCss7KNAbEi2Wj9z5dTgXCGxuq2vyqzBPChtmq,True,633711318,158427829,466080,233040,233040,AmTrMPzuTp2BjnjqGNKqz9FTTCdpoKcPAJLwFc8ozcbh,18643234,272376878,-253733644,294
2022-05-09 14:23:38-04:00,20717,7PzGZgzieFyyFs1dbajkNQgVxooFUNZrj1bUsQvrSwbp,A2gDREmSmJTBPPw3sbKVY3smC9wbHMDdv87gr4Tr2ES7,True,42277549,10569387,30498,15249,15249,47z82br5WdW2DZajdnPDPSSRRKsyAggqXqK6oPUwTaLf,1219934,8654625,-7434691,288
2022-05-09 14:23:38-04:00,20718,9dkQYcXQiH55NWkBrnLnCDF2nVvovzpxbpzDbhxmfk9C,6xHVNSYQTh9oTSMewwVvNa6ZZU7o5MmgCL5WQkD2AHWV,True,42066195,6248096,18392,9196,9196,2a35JJeTUW1pm6M3e8DHCjp8qr4vbc2cRPhuzZWyFzYd,1238337,64186097,-62947760,294
2022-05-09 14:23:41-04:00,20719,EVMrznfJS54BZiywDD2WhUtxzicDtbEpm2a5yLrtCgRF,CpzsMYVYvKg8ihrX1cKRw7TDEYwD3kAyiX92hsf2KiTz,True,81974047,5368977,24387,12193,12194,Hu94aiQWvce6THeGyCFqGRPM1pQrK3ihzkcXo1EpJcJL,3723502,65187561,-61464059,454
2022-05-09 14:23:44-04:00,20720,HpDwBPWZHfLzJUvTTABTA6qddyLLJiVTfqBx5gUktSUb,BqXLpaAeTNfNSeevfdazNqTgqEXj6Edgp8txWvCoxEz6,False,3634009,3634009,100582,5029,95553,68sueyVfmy5ToEGtLFGDkwebX47xAmzyXE29z8JrmcWv,100582,3434840,-3334258,276
2022-05-09 14:23:49-04:00,20721,H9pFRayNBHTAhsbtGyfs1XXUWGxAbw7SgpT1xdrSRWEY,9LNreyXuhgyLCDYViNyA1jUw6h1nv4GmDtTYMoUQBqCG,True,676919912,85579978,258869,129434,129435,2xTUy2RS74GJMMDnmFaegMzFLn19RVfYG4CibhBmjP1i,20476082,337855838,-317379756,302
2022-05-09 14:23:56-04:00,20722,m7gf1jAYXBZjRZEY9w4MjPfhzLwgDKaXyaCVhRD6C5E,Aa2aTZnpPux1i5K2MT4i1TsVM8vR7qR7rZGijQW4zpwd,True,125018662,21386927,84150,42075,42075,4yhyLx1phodwcvvwVU2bramHcdbJYvfadd7pANsRzX8M,4919083,75950861,-71031778,393
2022-05-09 14:23:56-04:00,20723,6xeNr9LhAfC6FRV62dALYdgx3bsoUpUpmEBiUPYCV5fz,8GP5cEpfNTEjvqm9usBUXs7jPCK5RciqjVJqtvX9fuGs,True,642013088,160503272,477107,238553,238554,2xTUy2RS74GJMMDnmFaegMzFLn19RVfYG4CibhBmjP1i,19084314,141700738,-122616424,297
2022-05-09 14:23:56-04:00,20724,BQYbbwd1MLtj6fBuBiTncAaXdAqKWa1JbcbGkZbLA728,2Wsyr6KoMbSVSvFy3YzutuEQ6skGUZyVHGM42SN4eU98,True,3745885281,296575833,1030293,515146,515147,gjBMZYVujDjD1ECG4i97M8Q3gV9ESnwwTSUGropkusj,130130694,4763897452,-4633766758,347
2022-05-09 14:23:57-04:00,20725,6VJcr3VAEcEZaHEpt48QL8QxHKABufVp8n2JSEVTLh9U,8naR6kiySKj3vai9dCetdgCnCHgf2oyLjGqKTJ3Lz64Y,False,13517185,13517185,375140,18757,356383,2a35JJeTUW1pm6M3e8DHCjp8qr4vbc2cRPhuzZWyFzYd,375140,11198323,-10823183,277
2022-05-09 14:24:02-04:00,20726,8uoS53t92hUWWx6mZHGhpKs3dkYJYyiRufnp4H1anBJH,E1Nc6fTaZ7EFFJqVDnEfV3odtasBRhEzbtg4JDFDzJ3k,True,27213404,6803351,42337,21168,21169,6L1WYrPiCMyi7XemPww4B4hvpKD1LQKD4RpiSKmrmgSC,1693510,26682157,-24988647,622
2022-05-09 14:24:31-04:00,20727,781gNSC1EkXYANS4jMh2qy9K185NibH5SJEGcY4DVhL,CcVfTBsWeTvCbkwXM5JovZvHg54G9UohLzzSDo986yHm,False,1713326,1713326,50683,2534,48149,Hu94aiQWvce6THeGyCFqGRPM1pQrK3ihzkcXo1EpJcJL,50683,832357,-781674,295
2022-05-09 14:24:36-04:00,20728,4oMasDRj8HWfknmdwt6Mkz3eonr8J2byoiSTRo4sCnFQ,3emcATkEFvDVETiK97eVET2Z2jzkgiiSxX3gu5wsUKPe,True,50442936,6253403,41782,20891,20891,68sueyVfmy5ToEGtLFGDkwebX47xAmzyXE29z8JrmcWv,3370434,41278119,-37907685,668
2022-05-09 14:24:47-04:00,20729,7agvoo7kQa27Gx8Vn4fr3PMZBeXSW3tSrg8DFCnLZAh3,5nFTJaKiqFRNxicLeyxywDgmasU97xtnZSRz8Dy8HpAd,True,378840996,94710248,239156,119578,119578,5HnvdJnCCcmRsm4GkXnYWd4q9RpwuvYDGEUMPkYR3Ts9,9566310,36247051,-26680741,252
2022-05-09 14:24:53-04:00,20730,9eWpSyu71Z6dmx7yTh7WrbVScdrrZN14d5tfmqEGFgXt,2r89PFKSD9zmSp2Wyx4CQ75HAtmUgwhAS2oG5MuYuiV6,True,101448019,18091971,71021,35510,35511,2a35JJeTUW1pm6M3e8DHCjp8qr4vbc2cRPhuzZWyFzYd,3982470,49902089,-45919619,392
2022-05-09 14:25:21-04:00,20731,Eo5LYLiUCspbrK13ker5skq9kMjnpUJEJPSbRDWjH6V4,GefeNAw5BdDkibatZknZVGsLhkfc8wfxriEfjHNpvMPm,True,752398788,188099697,474365,237182,237183,AmTrMPzuTp2BjnjqGNKqz9FTTCdpoKcPAJLwFc8ozcbh,18974628,280259313,-261284685,252
2022-05-09 14:25:25-04:00,20732,92cQnCMBkPL8DmE4xYQXJVAQ8EXk3moXXVHaM2zQT4uj,A5MAQitMT3yojsCtjyq9pypZQP9Df6m95X5srsEXaxr6,True,1241973536,310493384,857149,428574,428575,2py1FiYeL2f7J3HU36qiJz6TD6HCmiTN36RyxYtapQCZ,34285986,1447448859,-1413162873,276
2022-05-09 14:25:25-04:00,20733,4uNUqcnkVMJH9XZWzukBy8smUa9KUNs8kLMDpyfbWQMz,4kqp3UGFJ7pSUU17zw31nNqLH4SMhU4qpyG8T9ynY3d3,True,1156474780,289118695,831380,415690,415690,F31bVJvHB2XkhGdgjyTim48hY2cLFEx661AiPS3SzYJ2,33255203,201779380,-168524177,287
2022-05-09 14:25:30-04:00,20734,DRVtEzZs9u9ysrcANZLEjrvbuuGqYn77v2h4cDFKuNUx,Fv9qiMZhuSBL2cs9AWUYbDLQjB46W2ZwrhxaNXtPLDpC,True,1058728023,264682005,686820,343410,343410,A2p75MbAbeUdHkPLkAjgGeiwuu9WPrkMHzjCkDXF1Xr3,27472835,170103679,-142630844,259
2022-05-09 14:25:30-04:00,20735,AAtViqeicsECZgTLkvk96iozpRCyassCELu4CNrrWBph,4Y6ypLbKhu4pFju54jScsF2ZH1G7wR9sWJDN3Aeb7Cxa,False,1714249,1714249,51174,2558,48616,3zqXX6kzhkbW3d4TwD2CNjMRwxTbREXySekvq37kfCNk,51174,831925,-780751,298
2022-05-09 14:25:33-04:00,20736,4T2MDxf43fxhNe8A2aF7G8hFFpPnkeWkMGPRiYVcBo9h,4cjUvZRpju4xAdS8b5CjxhVEk3o52KBGwjkH9hq23u8A,True,131672669,32918167,81311,40655,40656,F31bVJvHB2XkhGdgjyTim48hY2cLFEx661AiPS3SzYJ2,3252459,14047304,-10794845,247
2022-05-09 14:25:33-04:00,20737,EHi1UBG8wMUFZECktsFUZkGjJPaBNEedswS62hyYn6jC,Drx9ErQhAjnPuJ83LPYFnY5ZV5XDzGuXDuSf16VqWayp,True,63918336,6938134,24477,12238,12239,C4UnXuShCvjSMgBAgVNMy1oakxCNk1et27A82fywU112,2255066,49228502,-46973436,352
2022-05-09 14:25:33-04:00,20738,3VYtHvoT9wi4K1PBjg6JjCf6U9fVPDf6tX9jyRRvLxcg,Ba5fjpVyAxLbiP6hYJmrxzougi7JUEDfDLKBxSbbTL7q,True,1086760138,271690034,809212,404606,404606,A2p75MbAbeUdHkPLkAjgGeiwuu9WPrkMHzjCkDXF1Xr3,32368506,69224693,-36856187,297
2022-05-09 14:25:36-04:00,20739,5xkW7wHTcF5WadNtBBqKPKctVwyQtTqqscivAmxzseCk,7m31ZMZdCn5Gz2q5sETWA7uKA5LsKD7pJHBBqU3g7tCn,True,62887997,15721999,41291,20645,20646,72FwbpFGoLEazJEdpqNtPNefsadUrimUqma9wSoy4qiS,1651675,15089010,-13437335,262
2022-05-09 14:25:37-04:00,20740,HXQXfEQe7aCpr6WKh37XaDZsjZcuQPk5t8tWNFgEoK6U,5ufXkCEDwgiXwtyPye4wYVVA3oLW54JVzz4tnXFofto4,True,42632229,10658057,28767,14383,14384,72FwbpFGoLEazJEdpqNtPNefsadUrimUqma9wSoy4qiS,1150684,24434238,-23283554,269
2022-05-09 14:25:46-04:00,20741,9L2rA8qtfvjKMzqtLn9Cc9Y3ih1e8Z3w9huDzyZXg1xk,GopCtogALLkVyW1T3FGofVWMmjnsdG6EkpJUWob3svaP,False,26725887,26725887,729509,36475,693034,C4UnXuShCvjSMgBAgVNMy1oakxCNk1et27A82fywU112,729509,7022503,-6292994,272
2022-05-09 14:25:49-04:00,20742,4Jni5Mqx1zXwwPLyngFRCzFbjK1JVs2uK9fwc2ryHnAY,8ms7WMNAnwk77tdfL1nukvPd3qPWZknQs45JZQE68hCg,False,50158,50158,1443,72,1371,5HnvdJnCCcmRsm4GkXnYWd4q9RpwuvYDGEUMPkYR3Ts9,1443,14008,-12565,287
2022-05-09 14:25:50-04:00,20743,3Xbsek5MsEGoWr3G9yhuohREr26B2vSQcjqXdspTFHta,2rPxkUiMo9wGDq8EvAiwY3ngRpKmL223cBWWNTYoBmFp,True,43345568,10836392,26987,13493,13494,Hu94aiQWvce6THeGyCFqGRPM1pQrK3ihzkcXo1EpJcJL,1079499,8099062,-7019563,249
2022-05-09 14:25:50-04:00,20744,Ejg8vXVsro4jB2fpdUUXCRfKTiE5TUwfRXhHeR8qtrEi,GnF7xwsjzso48ZEAdYYuxNkJso7ug3s46uogi4XDbs1,False,32063011,32063011,942400,47120,895280,6L1WYrPiCMyi7XemPww4B4hvpKD1LQKD4RpiSKmrmgSC,942400,11190715,-10248315,293
2022-05-09 14:25:51-04:00,20745,6v2KNGc2fG2d6gej4197zgxpPZHY8cdd7wXxyceEPowK,3u6LAZVkQRKaxNkTwACrDMXMf5fEY3VZmrUr4t2pAyE9,True,92975399,23243849,67184,33592,33592,4yhyLx1phodwcvvwVU2bramHcdbJYvfadd7pANsRzX8M,2687388,34025572,-31338184,289
2022-05-09 14:25:57-04:00,20746,A7j77tzgnQVGtHTa65VtVZqJRYeJvQk7am8NW6e66379,4vJGwEvXU2tGWoWWGwbsYcfKQAMCHbrBMRk4ZVFzneLs,True,34264716,8566179,25170,12585,12585,68sueyVfmy5ToEGtLFGDkwebX47xAmzyXE29z8JrmcWv,1006813,14322623,-13315810,293
2022-05-09 14:28:54-04:00,20747,EVMrznfJS54BZiywDD2WhUtxzicDtbEpm2a5yLrtCgRF,CpzsMYVYvKg8ihrX1cKRw7TDEYwD3kAyiX92hsf2KiTz,True,76260892,10569252,46496,23248,23248,C4UnXuShCvjSMgBAgVNMy1oakxCNk1et27A82fywU112,3354937,59818199,-56463262,439
2022-05-09 14:29:03-04:00,20748,532MfQR1PzPn6cmC1kpZsz9MyBWSamSeieh1F6GqVY33,6sJ8XXMZzGbHjVU1vWNW8unWoBZhJa54GguYJQhcb8PA,True,168311120,23412480,154349,77174,77175,5HnvdJnCCcmRsm4GkXnYWd4q9RpwuvYDGEUMPkYR3Ts9,11096134,58867969,-47771835,659
2022-05-09 14:29:22-04:00,20749,6qDAr9rGtFMeiTx9KfAeu3WBqiZzRzEtMfipFaZ2gQiJ,MGfCsHXhA5C6S28qKoQjeZmn28dehGUJ4MLSaic7CfB,True,1118534599,279633649,1675357,837678,837679,2py1FiYeL2f7J3HU36qiJz6TD6HCmiTN36RyxYtapQCZ,67014319,378135961,-311121642,599
2022-05-09 14:30:20-04:00,20750,2tPYXtNrw134ACVhkYdnG9FGT4iHm61PuX8L7AfG9aAT,EyyPLVdjgewzVDKePQUj85BBttWy4MixVr9CSD8JVbrP,False,32957719,32957719,976873,48843,928030,68sueyVfmy5ToEGtLFGDkwebX47xAmzyXE29z8JrmcWv,976873,18697355,-17720482,296
2022-05-09 14:30:20-04:00,20751,2iHmrYwG4wYoUqX1uZhx1TMAWn3JdUx3idqQ7T5e1eAx,EvtnpMHszPxf8rgvmdfmnpwwcCDz135CN9SXZwRvTorG,True,244051874,61012968,184125,92062,92063,F31bVJvHB2XkhGdgjyTim48hY2cLFEx661AiPS3SzYJ2,7365023,655803152,-648438129,301
2022-05-09 14:30:49-04:00,20752,CxgBZovBTr5QSarLWNH7uvfct5AuswfkcaVQGSZ4M7RP,8cmWEK7LG1kuFufhLKoVWBXJGzoUWNU6vhGVAfsScBDj,True,32365693,1481424,6096,3048,3048,2a35JJeTUW1pm6M3e8DHCjp8qr4vbc2cRPhuzZWyFzYd,1332067,18654020,-17321953,411
2022-05-09 14:30:57-04:00,20753,GCNi25P1Ywvfx5JpyxFVV68sRkio7LEhFgY85ZqveKR3,34mxz8fCss7KNAbEi2Wj9z5dTgXCGxuq2vyqzBPChtmq,True,471331186,117832796,355621,177810,177811,DA18qE9qesbBqpwNv1M4befYcNQkbSBSeLPTmQzrmbJw,14224851,208482631,-194257780,301
2022-05-09 14:30:58-04:00,20754,36RSXNs4AU556TmN1k6UC8dS9mc42Ge1PaCQJEFvh8UE,JuYbjiCxNBwxHXD4U3VXPnVASDHff4DTvzFVb6ywdme,False,16906,16906,506,25,481,6L1WYrPiCMyi7XemPww4B4hvpKD1LQKD4RpiSKmrmgSC,506,8945,-8439,299
2022-05-09 14:31:29-04:00,20755,CZhzJ91hP1pFbNNz7YnUKXznvs6ZFVSRNLbe1SaTw29o,X3B4LpHFfeJPmCnEmRQ8V6MNMi7KpTE4MLD7LHYXUwy,True,950070713,53520479,199649,99824,99825,DQCvC9mR68hJ3tJsUiddh6JwcBJAmntqGJR2nUsEq7yj,35440809,210863954,-175423145,373
2022-05-09 14:31:35-04:00,20756,4oMasDRj8HWfknmdwt6Mkz3eonr8J2byoiSTRo4sCnFQ,3emcATkEFvDVETiK97eVET2Z2jzkgiiSxX3gu5wsUKPe,True,43625486,6202849,39308,19654,19654,6L1WYrPiCMyi7XemPww4B4hvpKD1LQKD4RpiSKmrmgSC,2764605,36611944,-33847339,633
2022-05-09 14:31:39-04:00,20757,E3Tv8DA7HAQjNtMJ5GDaVvGj3RSsuqLGA99oV14vyrPU,2Bhtp9jmtvyj2FjK2M8RUKezH1gmV1RYCAzbDepzrrFS,True,29145539,2822774,11225,5612,5613,C4UnXuShCvjSMgBAgVNMy1oakxCNk1et27A82fywU112,1159010,14435619,-13276609,397
2022-05-09 14:31:55-04:00,20758,3Xbsek5MsEGoWr3G9yhuohREr26B2vSQcjqXdspTFHta,2rPxkUiMo9wGDq8EvAiwY3ngRpKmL223cBWWNTYoBmFp,False,32433245,32433245,976581,48829,927752,5HnvdJnCCcmRsm4GkXnYWd4q9RpwuvYDGEUMPkYR3Ts9,976581,6317205,-5340624,301
2022-05-09 14:31:55-04:00,20759,7BEY9qatFJomsayFmky3h3dAbKhY5XkRGwMobJuxXYhQ,J8MK3tAQKreBUG2reXY6gqr1uhbHhcAZEcxsLQmG5Ntt,True,133571727,33392931,238020,119010,119010,5HnvdJnCCcmRsm4GkXnYWd4q9RpwuvYDGEUMPkYR3Ts9,9520810,64933286,-55412476,712
2022-05-09 14:31:58-04:00,20760,6xeNr9LhAfC6FRV62dALYdgx3bsoUpUpmEBiUPYCV5fz,8GP5cEpfNTEjvqm9usBUXs7jPCK5RciqjVJqtvX9fuGs,True,477181403,119295350,356969,178484,178485,68sueyVfmy5ToEGtLFGDkwebX47xAmzyXE29z8JrmcWv,14278794,110574104,-96295310,299
2022-05-09 14:32:05-04:00,20761,Eo5LYLiUCspbrK13ker5skq9kMjnpUJEJPSbRDWjH6V4,GefeNAw5BdDkibatZknZVGsLhkfc8wfxriEfjHNpvMPm,True,562836607,140709151,425944,212972,212972,6L1WYrPiCMyi7XemPww4B4hvpKD1LQKD4RpiSKmrmgSC,17037779,214470914,-197433135,302
2022-05-09 14:32:31-04:00,20762,3HuYXkGL9jnp7iLZ6dMmC5dNcmTxPdpAEGZhPzxCDD1F,DeoJsUX13b9HjDU2RMWq5wgQEVriEho9cDEqBbRKLRn9,True,45110255,9233231,56632,28316,28316,68sueyVfmy5ToEGtLFGDkwebX47xAmzyXE29z8JrmcWv,2766891,48227025,-45460134,613
2022-05-09 14:32:32-04:00,20763,Fkm1PUcwZy3YLH28Xr6Ch7wP9CLpLEuZVxTFS1BcQUi4,FMe7RmFSyratCnpE4mmk5DbRQuusf2NgnxuXticqhGvP,False,231847,231847,11551,577,10974,6L1WYrPiCMyi7XemPww4B4hvpKD1LQKD4RpiSKmrmgSC,11554,111095,-99541,498
2022-05-09 14:32:42-04:00,20764,6pUtYz474QrpATEZnfb3iFbTKYA65pNyKAo4TQZAjtqe,8dipRUXvxJiDLdHEtCPkso4vErbVwshHQiRfvSngBS9J,True,39626701,1532053,5377,2688,2689,5HnvdJnCCcmRsm4GkXnYWd4q9RpwuvYDGEUMPkYR3Ts9,1391036,32410272,-31019236,351
2022-05-09 14:32:43-04:00,20765,CxgBZovBTr5QSarLWNH7uvfct5AuswfkcaVQGSZ4M7RP,8cmWEK7LG1kuFufhLKoVWBXJGzoUWNU6vhGVAfsScBDj,True,30784984,2694372,10736,5368,5368,2a35JJeTUW1pm6M3e8DHCjp8qr4vbc2cRPhuzZWyFzYd,1226686,17316846,-16090160,398
2022-05-09 14:32:49-04:00,20766,532MfQR1PzPn6cmC1kpZsz9MyBWSamSeieh1F6GqVY33,6sJ8XXMZzGbHjVU1vWNW8unWoBZhJa54GguYJQhcb8PA,True,143339004,18618722,121867,60933,60934,F31bVJvHB2XkhGdgjyTim48hY2cLFEx661AiPS3SzYJ2,9382149,51184897,-41802748,654
2022-05-09 14:32:49-04:00,20767,CZhzJ91hP1pFbNNz7YnUKXznvs6ZFVSRNLbe1SaTw29o,X3B4LpHFfeJPmCnEmRQ8V6MNMi7KpTE4MLD7LHYXUwy,True,893451660,92264677,331928,165964,165964,2a35JJeTUW1pm6M3e8DHCjp8qr4vbc2cRPhuzZWyFzYd,32142586,193874290,-161731704,359
2022-05-09 14:32:49-04:00,20768,E3Tv8DA7HAQjNtMJ5GDaVvGj3RSsuqLGA99oV14vyrPU,2Bhtp9jmtvyj2FjK2M8RUKezH1gmV1RYCAzbDepzrrFS,True,26237965,2282389,9246,4623,4623,6L1WYrPiCMyi7XemPww4B4hvpKD1LQKD4RpiSKmrmgSC,1062985,13497156,-12434171,405
2022-05-09 14:32:50-04:00,20769,DRVtEzZs9u9ysrcANZLEjrvbuuGqYn77v2h4cDFKuNUx,Fv9qiMZhuSBL2cs9AWUYbDLQjB46W2ZwrhxaNXtPLDpC,True,791195839,197798959,598395,299197,299198,A2p75MbAbeUdHkPLkAjgGeiwuu9WPrkMHzjCkDXF1Xr3,23935836,133771051,-109835215,302
2022-05-09 14:32:58-04:00,20770,EHi1UBG8wMUFZECktsFUZkGjJPaBNEedswS62hyYn6jC,Drx9ErQhAjnPuJ83LPYFnY5ZV5XDzGuXDuSf16VqWayp,True,56736270,6303358,22071,11035,11036,5HnvdJnCCcmRsm4GkXnYWd4q9RpwuvYDGEUMPkYR3Ts9,1986657,45882089,-43895432,350
2022-05-09 14:32:58-04:00,20771,EVMrznfJS54BZiywDD2WhUtxzicDtbEpm2a5yLrtCgRF,CpzsMYVYvKg8ihrX1cKRw7TDEYwD3kAyiX92hsf2KiTz,True,65408757,4462130,20639,10319,10320,6L1WYrPiCMyi7XemPww4B4hvpKD1LQKD4RpiSKmrmgSC,3025558,54501983,-51476425,462
2022-05-09 14:32:59-04:00,20772,4uNUqcnkVMJH9XZWzukBy8smUa9KUNs8kLMDpyfbWQMz,4kqp3UGFJ7pSUU17zw31nNqLH4SMhU4qpyG8T9ynY3d3,True,860861490,215215372,648230,324115,324115,DA18qE9qesbBqpwNv1M4befYcNQkbSBSeLPTmQzrmbJw,25929228,158831295,-132902067,301
2022-05-09 14:32:59-04:00,20773,6pUtYz474QrpATEZnfb3iFbTKYA65pNyKAo4TQZAjtqe,8dipRUXvxJiDLdHEtCPkso4vErbVwshHQiRfvSngBS9J,True,38005222,3098379,10567,5283,5284,5HnvdJnCCcmRsm4GkXnYWd4q9RpwuvYDGEUMPkYR3Ts9,1296233,30800862,-29504629,341
2022-05-09 14:32:59-04:00,20774,BQYbbwd1MLtj6fBuBiTncAaXdAqKWa1JbcbGkZbLA728,2Wsyr6KoMbSVSvFy3YzutuEQ6skGUZyVHGM42SN4eU98,True,3437156379,132646855,451323,225661,225662,6L1WYrPiCMyi7XemPww4B4hvpKD1LQKD4RpiSKmrmgSC,116947332,4532071247,-4415123915,340
2022-05-09 14:33:08-04:00,20775,8T4WK27RvWVGqPuNqY6whk1fmU4vd5qaUQPZG1GJ79bh,DvSz7knS8N3K7L6JhQf1s4mJSyxB8uJXNQXtyjJn8QRL,True,37058967,7927119,27420,13710,13710,68sueyVfmy5ToEGtLFGDkwebX47xAmzyXE29z8JrmcWv,1281923,12434163,-11152240,345
2022-05-09 14:33:12-04:00,20776,92cQnCMBkPL8DmE4xYQXJVAQ8EXk3moXXVHaM2zQT4uj,A5MAQitMT3yojsCtjyq9pypZQP9Df6m95X5srsEXaxr6,True,924421874,231105468,659263,329631,329632,CGtKBgcWZ6HKE3tFNLPUM9khDv2Rc7d6BrPtxz7J1aY,26370559,1093331850,-1066961291,285
2022-05-09 14:33:15-04:00,20777,HXQXfEQe7aCpr6WKh37XaDZsjZcuQPk5t8tWNFgEoK6U,5ufXkCEDwgiXwtyPye4wYVVA3oLW54JVzz4tnXFofto4,False,31733956,31733956,881701,44085,837616,68sueyVfmy5ToEGtLFGDkwebX47xAmzyXE29z8JrmcWv,881701,18584610,-17702909,277
2022-05-09 14:33:43-04:00,20778,FRbeFwhUYCiHW5oP26mad8KND7CCYDbfnoNxX7GuXVp8,GrzXKxPX2WDka8i2D8sunMUsrsThKasQi8NYLwuCGygV,True,46802151,4453299,18891,9445,9446,C4UnXuShCvjSMgBAgVNMy1oakxCNk1et27A82fywU112,1985425,25165707,-23180282,424
2022-05-09 14:33:43-04:00,20779,CxgBZovBTr5QSarLWNH7uvfct5AuswfkcaVQGSZ4M7RP,8cmWEK7LG1kuFufhLKoVWBXJGzoUWNU6vhGVAfsScBDj,True,28028761,1300030,5352,2676,2676,8sEswn3kzEhnYjAZVvCQnHEUvYd7pFVvc2Xc2Kd1BpbC,1154099,16250470,-15096371,411
2022-05-09 14:33:45-04:00,20780,5xkW7wHTcF5WadNtBBqKPKctVwyQtTqqscivAmxzseCk,7m31ZMZdCn5Gz2q5sETWA7uKA5LsKD7pJHBBqU3g7tCn,True,46814509,11703627,31472,15736,15736,6L1WYrPiCMyi7XemPww4B4hvpKD1LQKD4RpiSKmrmgSC,1258895,11688431,-10429536,268
2022-05-09 14:33:47-04:00,20781,9dkQYcXQiH55NWkBrnLnCDF2nVvovzpxbpzDbhxmfk9C,6xHVNSYQTh9oTSMewwVvNa6ZZU7o5MmgCL5WQkD2AHWV,False,35587604,35587604,989449,49472,939977,C4UnXuShCvjSMgBAgVNMy1oakxCNk1et27A82fywU112,989450,51988685,-50999235,278
2022-05-09 14:33:53-04:00,20782,8xmtY5ja4VVFwdS6VRh8rU5MmcagH3sHCYNGSMXqZ5jX,H7HCc7HBpxPm66nKe9fWBaQ7XYQU6WbLD3FxmwhGeJsK,False,9622673,9622673,284495,14224,270271,3zqXX6kzhkbW3d4TwD2CNjMRwxTbREXySekvq37kfCNk,284495,5217622,-4933127,295
2022-05-09 14:33:54-04:00,20783,6qDAr9rGtFMeiTx9KfAeu3WBqiZzRzEtMfipFaZ2gQiJ,MGfCsHXhA5C6S28qKoQjeZmn28dehGUJ4MLSaic7CfB,True,822767413,205691853,1230135,615067,615068,4yhyLx1phodwcvvwVU2bramHcdbJYvfadd7pANsRzX8M,49205425,298694421,-249488996,598
2022-05-09 14:33:57-04:00,20784,CZhzJ91hP1pFbNNz7YnUKXznvs6ZFVSRNLbe1SaTw29o,X3B4LpHFfeJPmCnEmRQ8V6MNMi7KpTE4MLD7LHYXUwy,True,798223630,90805200,328164,164082,164082,A2p75MbAbeUdHkPLkAjgGeiwuu9WPrkMHzjCkDXF1Xr3,28847305,180206056,-151358751,361
2022-05-09 14:34:03-04:00,20785,BQYbbwd1MLtj6fBuBiTncAaXdAqKWa1JbcbGkZbLA728,2Wsyr6KoMbSVSvFy3YzutuEQ6skGUZyVHGM42SN4eU98,True,3299590165,263225134,890103,445051,445052,2py1FiYeL2f7J3HU36qiJz6TD6HCmiTN36RyxYtapQCZ,111576650,4347845647,-4236268997,338
2022-05-09 14:34:06-04:00,20786,E3Tv8DA7HAQjNtMJ5GDaVvGj3RSsuqLGA99oV14vyrPU,2Bhtp9jmtvyj2FjK2M8RUKezH1gmV1RYCAzbDepzrrFS,False,23882139,23882139,980300,49015,931285,Hu94aiQWvce6THeGyCFqGRPM1pQrK3ihzkcXo1EpJcJL,980302,12606226,-11625924,410
2022-05-09 14:34:06-04:00,20787,8e3Du79eCAvuNc6ZX44quJRCuCxmjVDNhRHr1eTB3wqr,3Lb3b9ikztneijmjUzNgHKzCBBfFNKbpjAyc7DQ8pE2M,True,98804872,24701218,69045,34522,34523,6L1WYrPiCMyi7XemPww4B4hvpKD1LQKD4RpiSKmrmgSC,2761820,62146518,-59384698,279
2022-05-09 14:34:08-04:00,20788,4oMasDRj8HWfknmdwt6Mkz3eonr8J2byoiSTRo4sCnFQ,3emcATkEFvDVETiK97eVET2Z2jzkgiiSxX3gu5wsUKPe,True,37119620,4673361,30496,15248,15248,5HnvdJnCCcmRsm4GkXnYWd4q9RpwuvYDGEUMPkYR3Ts9,2422280,31565755,-29143475,652
2022-05-09 14:34:13-04:00,20789,AL8JFS4gjaQx89f9j8wtaNJgV76K8bw1ugvNtgvhgAnb,HJYvG2kGKe8kXgtZSWTWwTmSjxA3XUeCvyT7acoKtS1C,True,2720762479,680190619,2059396,1029698,1029698,DQCvC9mR68hJ3tJsUiddh6JwcBJAmntqGJR2nUsEq7yj,82375858,935149335,-852773477,302
2022-05-09 14:34:15-04:00,20790,J6jBKPDR6R5cLMqLufw3zoVfheNYs1KF7C4Ft2dakXeA,6wTTLK675Ym6toJRp7tYaUZzisWfgGjSp3X3yJ31xiKt,False,21660477,21660477,635119,31755,603364,C4UnXuShCvjSMgBAgVNMy1oakxCNk1et27A82fywU112,635119,6260331,-5625212,293
2022-05-09 14:34:15-04:00,20791,HeyRAEkqGTtCj2cMfGR6pbeY5nu4qERFmZSovsfhUtaq,5MDbdhQUt3USB1RFmdLsrAc5UUXZ1n8jXRQFtJ6ibj9B,True,29450027,2799680,11021,5510,5511,C4UnXuShCvjSMgBAgVNMy1oakxCNk1et27A82fywU112,1159429,10615780,-9456351,393
2022-05-09 14:34:51-04:00,20792,A7j77tzgnQVGtHTa65VtVZqJRYeJvQk7am8NW6e66379,4vJGwEvXU2tGWoWWGwbsYcfKQAMCHbrBMRk4ZVFzneLs,False,25488728,25488728,771834,38591,733243,68sueyVfmy5ToEGtLFGDkwebX47xAmzyXE29z8JrmcWv,771834,10968516,-10196682,302
2022-05-09 14:35:47-04:00,20793,532MfQR1PzPn6cmC1kpZsz9MyBWSamSeieh1F6GqVY33,6sJ8XXMZzGbHjVU1vWNW8unWoBZhJa54GguYJQhcb8PA,True,123497596,16916840,110099,55049,55050,4yhyLx1phodwcvvwVU2bramHcdbJYvfadd7pANsRzX8M,8037596,46603052,-38565456,650
2022-05-09 14:35:54-04:00,20794,3HuYXkGL9jnp7iLZ6dMmC5dNcmTxPdpAEGZhPzxCDD1F,DeoJsUX13b9HjDU2RMWq5wgQEVriEho9cDEqBbRKLRn9,True,35293007,6783055,40864,20432,20432,68sueyVfmy5ToEGtLFGDkwebX47xAmzyXE29z8JrmcWv,2126242,40419626,-38293384,602
2022-05-09 14:36:39-04:00,20795,CZhzJ91hP1pFbNNz7YnUKXznvs6ZFVSRNLbe1SaTw29o,X3B4LpHFfeJPmCnEmRQ8V6MNMi7KpTE4MLD7LHYXUwy,True,704908047,39208054,144664,72332,72332,Hu94aiQWvce6THeGyCFqGRPM1pQrK3ihzkcXo1EpJcJL,26008758,165229134,-139220376,368
2022-05-09 14:36:50-04:00,20796,6mHh6gBJZiXeMHuc52cw8hBd91dWwXZ8PoxYLvZsJ3s2,6HTpN4dAQSiRurBeBgbHWJEqM1SA4L4Zw36EXy3o8YZR,True,44216412,4087991,20314,10157,10157,3zqXX6kzhkbW3d4TwD2CNjMRwxTbREXySekvq37kfCNk,2197274,20984377,-18787103,496
2022-05-09 14:36:59-04:00,20797,EyNCsqWu8zLyuRnXSbzJWnWZg7ZLjb4oJSZFdDSkbXmT,6rMMMkZibUHXYs8hXY3FmG4rgBx6gWDRGJwR2bP2t6ZD,True,6130518874,1066337213,4274864,2137432,2137432,DA18qE9qesbBqpwNv1M4befYcNQkbSBSeLPTmQzrmbJw,245767841,1854651540,-1608883699,400
2022-05-09 14:37:01-04:00,20798,85Vef6kFyB9jJC9PK6yaBodYbDR7Vuck1cCMMDUpt5k6,27GkpakVqaNeL7W4om2fSxxJsCpcAis4WSGtNz4AgXdw,True,44198137,4087523,20035,10017,10018,68sueyVfmy5ToEGtLFGDkwebX47xAmzyXE29z8JrmcWv,2166406,20967919,-18801513,490
2022-05-09 14:37:10-04:00,20799,CxgBZovBTr5QSarLWNH7uvfct5AuswfkcaVQGSZ4M7RP,8cmWEK7LG1kuFufhLKoVWBXJGzoUWNU6vhGVAfsScBDj,True,26589181,2584150,9807,4903,4904,72FwbpFGoLEazJEdpqNtPNefsadUrimUqma9wSoy4qiS,1009197,15435770,-14426573,379
2022-05-09 14:37:12-04:00,20800,8trFFwvXKKMwMx952ugCZmqyw29e1HxEKBuQmFn8ZwTf,FsD7gCvHXM3QchQiDcd292ksy5afZMWApneNTat5ndeS,True,43817670,10954417,30709,15354,15355,6L1WYrPiCMyi7XemPww4B4hvpKD1LQKD4RpiSKmrmgSC,1228391,7247555,-6019164,280
2022-05-09 14:37:12-04:00,20801,5ff6DUfD3e6HXEZEmZMdq6KEg29CpUbP2Cwb2MD2uVHz,3Mp9r2mqrq9uit1dmeAEvU2MKjEpRWSGYM3AHqYtN3ua,False,1742423,1742423,50074,2503,47571,3zqXX6kzhkbW3d4TwD2CNjMRwxTbREXySekvq37kfCNk,50074,722751,-672677,287
2022-05-09 14:37:31-04:00,20802,EHi1UBG8wMUFZECktsFUZkGjJPaBNEedswS62hyYn6jC,Drx9ErQhAjnPuJ83LPYFnY5ZV5XDzGuXDuSf16VqWayp,True,50302424,2681314,9776,4888,4888,5HnvdJnCCcmRsm4GkXnYWd4q9RpwuvYDGEUMPkYR3Ts9,1834098,40640238,-38806140,364
2022-05-09 14:37:35-04:00,20803,6v2KNGc2fG2d6gej4197zgxpPZHY8cdd7wXxyceEPowK,3u6LAZVkQRKaxNkTwACrDMXMf5fEY3VZmrUr4t2pAyE9,True,69191084,17297771,51993,25996,25997,F31bVJvHB2XkhGdgjyTim48hY2cLFEx661AiPS3SzYJ2,2079738,26123951,-24044213,300
2022-05-09 14:37:36-04:00,20804,4oMasDRj8HWfknmdwt6Mkz3eonr8J2byoiSTRo4sCnFQ,3emcATkEFvDVETiK97eVET2Z2jzkgiiSxX3gu5wsUKPe,True,32181766,4536213,29985,14992,14993,8sEswn3kzEhnYjAZVvCQnHEUvYd7pFVvc2Xc2Kd1BpbC,2127291,28050222,-25922931,661
2022-05-09 14:37:41-04:00,20805,BePQMfbkFe8vQ54rFkkf2dzXunPq2Xwpibrm1JVzSHLz,8R6rnjVUnMGUxx5sRjnuuyEnfyBGeet7y2jSJwVswyT3,True,11425221223,2856305305,8649398,4324699,4324699,CGtKBgcWZ6HKE3tFNLPUM9khDv2Rc7d6BrPtxz7J1aY,345975933,3613981199,-3268005266,302
2022-05-09 14:37:42-04:00,20806,CxgBZovBTr5QSarLWNH7uvfct5AuswfkcaVQGSZ4M7RP,8cmWEK7LG1kuFufhLKoVWBXJGzoUWNU6vhGVAfsScBDj,False,23991707,23991707,986063,49303,936760,8sEswn3kzEhnYjAZVvCQnHEUvYd7pFVvc2Xc2Kd1BpbC,986066,14260109,-13274043,411
2022-05-09 14:37:42-04:00,20807,7zuFEyLQFHkAjm3mAuxN42VenwF6fZcqM81mmR8sBnmY,CSnQxjc4Jn8iP4JSxj5wsrvxGsLoAYQn1bKC8naY7YZP,True,1009860079,252465019,756534,378267,378267,DQCvC9mR68hJ3tJsUiddh6JwcBJAmntqGJR2nUsEq7yj,30261386,148481795,-118220409,299
2022-05-09 14:37:42-04:00,20808,6qDAr9rGtFMeiTx9KfAeu3WBqiZzRzEtMfipFaZ2gQiJ,MGfCsHXhA5C6S28qKoQjeZmn28dehGUJ4MLSaic7CfB,True,606942556,151735639,946057,473028,473029,F31bVJvHB2XkhGdgjyTim48hY2cLFEx661AiPS3SzYJ2,37842286,235099963,-197257677,623
2022-05-09 14:38:03-04:00,20809,6pUtYz474QrpATEZnfb3iFbTKYA65pNyKAo4TQZAjtqe,8dipRUXvxJiDLdHEtCPkso4vErbVwshHQiRfvSngBS9J,True,34800898,2669144,9048,4524,4524,6L1WYrPiCMyi7XemPww4B4hvpKD1LQKD4RpiSKmrmgSC,1179721,26740439,-25560718,338
2022-05-09 14:38:03-04:00,20810,3VYtHvoT9wi4K1PBjg6JjCf6U9fVPDf6tX9jyRRvLxcg,Ba5fjpVyAxLbiP6hYJmrxzougi7JUEDfDLKBxSbbTL7q,True,807263706,201815926,593822,296911,296911,A9TwRM1BMxqb8DCC7YNAMV6zPenEJm3HTZBy7wJKK58U,23752896,59212862,-35459966,294
2022-05-09 14:38:11-04:00,20811,C9DJXDw2JgR481KiF5z9XnPZxYpeE92M73zMNjjjnv1w,BzNPYnJPmhCGY1xHpFWPsDVqhysc5GwGe74SZACcodKx,True,44206398,4087552,20496,10248,10248,3zqXX6kzhkbW3d4TwD2CNjMRwxTbREXySekvq37kfCNk,2216667,21010315,-18793648,501
2022-05-09 14:38:17-04:00,20812,2iHmrYwG4wYoUqX1uZhx1TMAWn3JdUx3idqQ7T5e1eAx,EvtnpMHszPxf8rgvmdfmnpwwcCDz135CN9SXZwRvTorG,True,181223476,45305869,134136,67068,67068,68sueyVfmy5ToEGtLFGDkwebX47xAmzyXE29z8JrmcWv,5365468,493511536,-488146068,296
2022-05-09 14:38:17-04:00,20813,9eWpSyu71Z6dmx7yTh7WrbVScdrrZN14d5tfmqEGFgXt,2r89PFKSD9zmSp2Wyx4CQ75HAtmUgwhAS2oG5MuYuiV6,True,82882172,7221439,29951,14975,14976,5HnvdJnCCcmRsm4GkXnYWd4q9RpwuvYDGEUMPkYR3Ts9,3437573,46734111,-43296538,414
2022-05-09 14:38:21-04:00,20814,BQYbbwd1MLtj6fBuBiTncAaXdAqKWa1JbcbGkZbLA728,2Wsyr6KoMbSVSvFy3YzutuEQ6skGUZyVHGM42SN4eU98,True,3030142634,240219814,828157,414078,414079,68sueyVfmy5ToEGtLFGDkwebX47xAmzyXE29z8JrmcWv,104464150,3819104893,-3714640743,344
2022-05-09 14:38:21-04:00,20815,9XuUGP13n5xuMtUYhAH1fe9jFKK7FjgTzcuJqDfV1gqC,AFNffLzWzrg7vgdwxyHeaSc6kUtqYPV8pRvdUx8wt7x3,True,6050802979,1512700744,4536767,2268383,2268384,CGtKBgcWZ6HKE3tFNLPUM9khDv2Rc7d6BrPtxz7J1aY,181470694,366749142,-185278448,299
2022-05-09 14:38:22-04:00,20816,GCNi25P1Ywvfx5JpyxFVV68sRkio7LEhFgY85ZqveKR3,34mxz8fCss7KNAbEi2Wj9z5dTgXCGxuq2vyqzBPChtmq,True,350118846,87529711,262242,131121,131121,6L1WYrPiCMyi7XemPww4B4hvpKD1LQKD4RpiSKmrmgSC,10489686,159565503,-149075817,299
2022-05-09 14:38:28-04:00,20817,HSAmcb4DEGUpAej7dYdcMyqgLCuWXPmYK4Q2BU29uRzg,88bpA58iwt2bg4qx3uyAoHxkoBs4Rkeh7HmfdQjdtKLW,True,44204431,4087569,20500,10250,10250,3zqXX6kzhkbW3d4TwD2CNjMRwxTbREXySekvq37kfCNk,2217007,21012650,-18795643,501
2022-05-09 14:38:28-04:00,20818,5hfwMBNetuL1wYHVXrGkKWNAjKyN8WhmqjZd8EjXYN8d,DT9rQfjr27ULJ5PiQ3pShDFvT4LyV6ogcSXnp4mUdwhY,True,153389062,38347265,115766,57883,57883,3zqXX6kzhkbW3d4TwD2CNjMRwxTbREXySekvq37kfCNk,4630672,46671696,-42041024,301
2022-05-09 14:38:28-04:00,20819,7giGmfkXWV49jM3a3LiHcKxdfGfy1qsszBSXAFmcFcAf,92LzLQ8NLqi3svjhRsxTGmfTxNdRVHmSzazYCn7ozACN,True,470321002,81721300,243132,121566,121566,3zqXX6kzhkbW3d4TwD2CNjMRwxTbREXySekvq37kfCNk,13992728,89334027,-75341299,297
2022-05-09 14:38:36-04:00,20820,HeyRAEkqGTtCj2cMfGR6pbeY5nu4qERFmZSovsfhUtaq,5MDbdhQUt3USB1RFmdLsrAc5UUXZ1n8jXRQFtJ6ibj9B,True,26593507,1242794,5101,2550,2551,Hu94aiQWvce6THeGyCFqGRPM1pQrK3ihzkcXo1EpJcJL,1091568,9654434,-8562866,410
2022-05-09 14:38:41-04:00,20821,HfCJxSbeYoFSHzdVAt79inkMzck33hBipvFPRcUjgAHM,HiPZ5UQuakSiAci4mX7Kr7J5RWawRR8ZuDpdMDoZgeY2,True,44207271,4087585,20535,10267,10268,3zqXX6kzhkbW3d4TwD2CNjMRwxTbREXySekvq37kfCNk,2220998,21011104,-18790106,502
2022-05-09 14:38:45-04:00,20822,EVMrznfJS54BZiywDD2WhUtxzicDtbEpm2a5yLrtCgRF,CpzsMYVYvKg8ihrX1cKRw7TDEYwD3kAyiX92hsf2KiTz,True,60699619,4005620,18199,9099,9100,C4UnXuShCvjSMgBAgVNMy1oakxCNk1et27A82fywU112,2757911,49636926,-46879015,454
2022-05-09 14:39:46-04:00,20823,7eeGop9Aw2FeAhtm9GaXzemxvSd4MK2EoHSRETn9GDPc,93ZvMtq5ur5uJtnCbuvnd9UJDc1WhFmQKxTjB49Hm1WL,True,3018585186,754646296,2285173,1142586,1142587,2py1FiYeL2f7J3HU36qiJz6TD6HCmiTN36RyxYtapQCZ,91406957,677730330,-586323373,302
2022-05-09 14:39:53-04:00,20824,EHi1UBG8wMUFZECktsFUZkGjJPaBNEedswS62hyYn6jC,Drx9ErQhAjnPuJ83LPYFnY5ZV5XDzGuXDuSf16VqWayp,True,47489209,5159100,18385,9192,9193,8sEswn3kzEhnYjAZVvCQnHEUvYd7pFVvc2Xc2Kd1BpbC,1692421,37372072,-35679651,356
2022-05-09 14:39:57-04:00,20825,Eo5LYLiUCspbrK13ker5skq9kMjnpUJEJPSbRDWjH6V4,GefeNAw5BdDkibatZknZVGsLhkfc8wfxriEfjHNpvMPm,True,418156099,104539024,316011,158005,158006,C4UnXuShCvjSMgBAgVNMy1oakxCNk1et27A82fywU112,12640478,164690696,-152050218,302
2022-05-09 14:40:03-04:00,20826,6xeNr9LhAfC6FRV62dALYdgx3bsoUpUpmEBiUPYCV5fz,8GP5cEpfNTEjvqm9usBUXs7jPCK5RciqjVJqtvX9fuGs,True,354468446,88617111,262605,131302,131303,C4UnXuShCvjSMgBAgVNMy1oakxCNk1et27A82fywU112,10504218,86145872,-75641654,296
2022-05-09 14:40:04-04:00,20827,B7235jQd2oUYooVva8FoqrbCAbcnZS1kfaAfATNBgADN,B6dRkkWvQrBpiaVnMJC4yniaNvxHfCcynjehdRP7eH1m,True,344035265,86008815,226153,113076,113077,C4UnXuShCvjSMgBAgVNMy1oakxCNk1et27A82fywU112,9046189,7269408,1776781,262
2022-05-09 14:40:13-04:00,20828,532MfQR1PzPn6cmC1kpZsz9MyBWSamSeieh1F6GqVY33,6sJ8XXMZzGbHjVU1vWNW8unWoBZhJa54GguYJQhcb8PA,True,105699463,13856413,92370,46185,46185,C4UnXuShCvjSMgBAgVNMy1oakxCNk1et27A82fywU112,7046204,40203845,-33157641,666
2022-05-09 14:40:13-04:00,20829,HDH8Rdbb9rK3sGRcL5NW8ieXPuDVJaip5K2Mbx3wyuSk,Wi9CatvwZ5V9K6eTyLpbmdQySg6WuXGmZwKpxccNQ3k,True,44593231,2762009,10563,5281,5282,5HnvdJnCCcmRsm4GkXnYWd4q9RpwuvYDGEUMPkYR3Ts9,1705589,20090909,-18385320,382
2022-05-09 14:40:16-04:00,20830,H9pFRayNBHTAhsbtGyfs1XXUWGxAbw7SgpT1xdrSRWEY,9LNreyXuhgyLCDYViNyA1jUw6h1nv4GmDtTYMoUQBqCG,True,588537549,83052161,245750,122875,122875,47z82br5WdW2DZajdnPDPSSRRKsyAggqXqK6oPUwTaLf,17414828,291841379,-274426551,295
2022-05-09 14:40:25-04:00,20831,CZhzJ91hP1pFbNNz7YnUKXznvs6ZFVSRNLbe1SaTw29o,X3B4LpHFfeJPmCnEmRQ8V6MNMi7KpTE4MLD7LHYXUwy,True,662843112,68709217,238488,119244,119244,F31bVJvHB2XkhGdgjyTim48hY2cLFEx661AiPS3SzYJ2,23007213,151559415,-128552202,347
2022-05-09 14:40:29-04:00,20832,6pUtYz474QrpATEZnfb3iFbTKYA65pNyKAo4TQZAjtqe,8dipRUXvxJiDLdHEtCPkso4vErbVwshHQiRfvSngBS9J,True,32041219,2558481,8624,4312,4312,47z82br5WdW2DZajdnPDPSSRRKsyAggqXqK6oPUwTaLf,1080138,25718956,-24638818,337
2022-05-09 14:40:36-04:00,20833,EEQmHFk3WFNmPfe7ujtP1PK6P5yqV5mmWumNSoTu45P8,FG9DScQDQPrgcmBbRugZ5NfhSTRMnKSWLxcUeTF9MgJZ,True,34996848,8749212,26328,13164,13164,C4UnXuShCvjSMgBAgVNMy1oakxCNk1et27A82fywU112,1053150,8438372,-7385222,300
2022-05-09 14:40:45-04:00,20834,7PzGZgzieFyyFs1dbajkNQgVxooFUNZrj1bUsQvrSwbp,A2gDREmSmJTBPPw3sbKVY3smC9wbHMDdv87gr4Tr2ES7,False,31445213,31445213,926487,46324,880163,C4UnXuShCvjSMgBAgVNMy1oakxCNk1et27A82fywU112,926487,6765483,-5838996,294
2022-05-09 14:40:47-04:00,20835,Af5aSkdtYSRqdSfK3mPBK3Grq33PDCLCASBdsMo5cmkm,9PvGthPurjNkCoTUVDBW9nNNmvAdrwK8tk4hknK7Wydg,True,388764998,97191249,293674,146837,146837,A9TwRM1BMxqb8DCC7YNAMV6zPenEJm3HTZBy7wJKK58U,11746994,90933779,-79186785,302
2022-05-09 14:40:52-04:00,20836,BQYbbwd1MLtj6fBuBiTncAaXdAqKWa1JbcbGkZbLA728,2Wsyr6KoMbSVSvFy3YzutuEQ6skGUZyVHGM42SN4eU98,True,2783038115,220786377,767555,383777,383778,A2p75MbAbeUdHkPLkAjgGeiwuu9WPrkMHzjCkDXF1Xr3,96751288,3598586942,-3501835654,347
2022-05-09 14:40:53-04:00,20837,Bsr6kx1B6BSEd5UnJ7Z61M49iUb3bFrDVhiEtMVtPDF2,3CFd1pUJAJPA9fobwn4Jj2mRju1CWmoop4Mh4znypNWT,False,121458,121458,3429,171,3258,68sueyVfmy5ToEGtLFGDkwebX47xAmzyXE29z8JrmcWv,3429,91813,-88384,282
2022-05-09 14:40:54-04:00,20838,CYkojG4q1SnizNs59qsYTEBU1c11XC8nteMhxRbwhCBq,A9MsPy3aeMzdQUWXK6qmWLiZfKREiBrSVaJAKp2nEcSt,False,93252,93252,2535,126,2409,5HnvdJnCCcmRsm4GkXnYWd4q9RpwuvYDGEUMPkYR3Ts9,2535,71183,-68648,271
2022-05-09 14:41:06-04:00,20839,78EeyPYzQjrmW6z9VGhRci6ihMUZb5rtpXo3GAxugf55,9AgZ45TMxaqwWGVWSgnEkvio3s6fXtHjAVRVCA7Zgsd2,False,230422,230422,6449,322,6127,6L1WYrPiCMyi7XemPww4B4hvpKD1LQKD4RpiSKmrmgSC,6449,157208,-150759,279
2022-05-09 14:41:09-04:00,20840,85Vef6kFyB9jJC9PK6yaBodYbDR7Vuck1cCMMDUpt5k6,27GkpakVqaNeL7W4om2fSxxJsCpcAis4WSGtNz4AgXdw,True,39868577,3062492,14627,7313,7314,2a35JJeTUW1pm6M3e8DHCjp8qr4vbc2cRPhuzZWyFzYd,1904334,19785400,-17881066,477
2022-05-09 14:41:09-04:00,20841,7hTjPRQSYAoWHhtpsVz2oKK5SAuFJd8dPHShKgKJq8dy,6DcHcrtcXR88d8e2KahhAiWTeRznNfF8oXLHmh5wE7wz,False,3964577,3964577,110480,5524,104956,5HnvdJnCCcmRsm4GkXnYWd4q9RpwuvYDGEUMPkYR3Ts9,110480,3039375,-2928895,278
2022-05-09 14:41:12-04:00,20842,9UKMqQgFYdJb5vXVqPhA8CAMRY1eifgWivANiKQqj3yb,DpE3uNQUZbyYnqjpfHWqp9CHqPBs2uTQLRM6AtzF6Por,False,1376947,1376947,38264,1913,36351,5HnvdJnCCcmRsm4GkXnYWd4q9RpwuvYDGEUMPkYR3Ts9,38264,611045,-572781,277
2022-05-09 14:41:30-04:00,20843,CZhzJ91hP1pFbNNz7YnUKXznvs6ZFVSRNLbe1SaTw29o,X3B4LpHFfeJPmCnEmRQ8V6MNMi7KpTE4MLD7LHYXUwy,True,592149541,67761803,237842,118921,118921,6L1WYrPiCMyi7XemPww4B4hvpKD1LQKD4RpiSKmrmgSC,20784371,140828499,-120044128,350
2022-05-09 14:41:30-04:00,20844,4oMasDRj8HWfknmdwt6Mkz3eonr8J2byoiSTRo4sCnFQ,3emcATkEFvDVETiK97eVET2Z2jzkgiiSxX3gu5wsUKPe,True,27295484,3481457,22285,11142,11143,6L1WYrPiCMyi7XemPww4B4hvpKD1LQKD4RpiSKmrmgSC,1747237,24149148,-22401911,640
2022-05-09 14:41:34-04:00,20845,m7gf1jAYXBZjRZEY9w4MjPfhzLwgDKaXyaCVhRD6C5E,Aa2aTZnpPux1i5K2MT4i1TsVM8vR7qR7rZGijQW4zpwd,True,103099632,9793297,40871,20435,20436,47z82br5WdW2DZajdnPDPSSRRKsyAggqXqK6oPUwTaLf,4302830,68380445,-64077615,417
2022-05-09 14:41:39-04:00,20846,FXgL4rWZ42xYgTogwKixG89XDP3CkzuHKsnKmQuhKKhJ,H9ZJNzdokbUH9edFbzCq45fRdn2ENRQNZfPUQ1nTENaK,True,44482205,2742404,10036,5018,5018,47z82br5WdW2DZajdnPDPSSRRKsyAggqXqK6oPUwTaLf,1627949,20145806,-18517857,365
2022-05-09 14:41:43-04:00,20847,JCP5xp4aokniY9q9odnrBHtKtn58Eq48nh9g4u5hFr4P,FUXuuEJy1c8xLwAJ9tBqBMDbJEYEpfXic4iCZBSRapBC,False,1181269,1181269,35512,1775,33737,3zqXX6kzhkbW3d4TwD2CNjMRwxTbREXySekvq37kfCNk,35512,754051,-718539,300
2022-05-09 14:41:50-04:00,20848,6mHh6gBJZiXeMHuc52cw8hBd91dWwXZ8PoxYLvZsJ3s2,6HTpN4dAQSiRurBeBgbHWJEqM1SA4L4Zw36EXy3o8YZR,True,39791531,3060134,14150,7075,7075,C4UnXuShCvjSMgBAgVNMy1oakxCNk1et27A82fywU112,1840070,19802048,-17961978,462
2022-05-09 14:41:51-04:00,20849,8yU47VKn9uBQxPE11YbspLXDpLqDEJa9iAFdGnANPCmx,BXK5BYqWa1LDBkwqFKhk1mAp6gRGCV4HnAUFjGYhCYw5,True,143170881,35792720,199657,99828,99829,4yhyLx1phodwcvvwVU2bramHcdbJYvfadd7pANsRzX8M,7986316,113815510,-105829194,557
2022-05-09 14:41:53-04:00,20850,HSAmcb4DEGUpAej7dYdcMyqgLCuWXPmYK4Q2BU29uRzg,88bpA58iwt2bg4qx3uyAoHxkoBs4Rkeh7HmfdQjdtKLW,True,39852991,3062963,14853,7426,7427,3zqXX6kzhkbW3d4TwD2CNjMRwxTbREXySekvq37kfCNk,1932636,19829718,-17897082,484
2022-05-09 14:41:54-04:00,20851,HfCJxSbeYoFSHzdVAt79inkMzck33hBipvFPRcUjgAHM,HiPZ5UQuakSiAci4mX7Kr7J5RWawRR8ZuDpdMDoZgeY2,True,39858163,3062976,14899,7449,7450,3zqXX6kzhkbW3d4TwD2CNjMRwxTbREXySekvq37kfCNk,1938940,19828151,-17889211,486
2022-05-09 14:41:54-04:00,20852,3HuYXkGL9jnp7iLZ6dMmC5dNcmTxPdpAEGZhPzxCDD1F,DeoJsUX13b9HjDU2RMWq5wgQEVriEho9cDEqBbRKLRn9,True,28045775,4982662,28802,14401,14401,5HnvdJnCCcmRsm4GkXnYWd4q9RpwuvYDGEUMPkYR3Ts9,1621201,34423809,-32802608,578
2022-05-09 14:41:54-04:00,20853,EgpRPHPAC2cPBiar3SUD5PGZnzbCXBzUpa4KVTF5q9XY,2zf7NkfWagBWWts9RgacdRgkSzgJaChpFW5mMZczXa18,True,79009150,19752287,59785,29892,29893,5HnvdJnCCcmRsm4GkXnYWd4q9RpwuvYDGEUMPkYR3Ts9,2391416,80454817,-78063401,302
2022-05-09 14:41:55-04:00,20854,6qDAr9rGtFMeiTx9KfAeu3WBqiZzRzEtMfipFaZ2gQiJ,MGfCsHXhA5C6S28qKoQjeZmn28dehGUJ4MLSaic7CfB,True,444730722,111182680,660500,330250,330250,DQCvC9mR68hJ3tJsUiddh6JwcBJAmntqGJR2nUsEq7yj,26420034,184843913,-158423879,594
2022-05-09 14:41:56-04:00,20855,C9DJXDw2JgR481KiF5z9XnPZxYpeE92M73zMNjjjnv1w,BzNPYnJPmhCGY1xHpFWPsDVqhysc5GwGe74SZACcodKx,True,39782505,3062944,14319,7159,7160,3zqXX6kzhkbW3d4TwD2CNjMRwxTbREXySekvq37kfCNk,1859830,19827373,-17967543,467
2022-05-09 14:41:57-04:00,20856,5yT4BbB6NgZYTi82r7ahcfYwbABzDZoJuxRPXdgTf3v8,G7MK8fx2MT8iNn6CcfNc9CfQMAWSPqGsqtjfGgDqBiff,False,1181633,1181633,35801,1790,34011,3zqXX6kzhkbW3d4TwD2CNjMRwxTbREXySekvq37kfCNk,35801,753976,-718175,302
2022-05-09 14:41:58-04:00,20857,FM6CRTLqCFsU2xNekSaZX4d83CBX62mKoaCyqB7ahYgy,E2766k5MJUto75hFRYPg7naxuXJfcWNQHEePW1xkUmzj,False,1181269,1181269,35512,1775,33737,3zqXX6kzhkbW3d4TwD2CNjMRwxTbREXySekvq37kfCNk,35512,754051,-718539,300
2022-05-09 14:42:02-04:00,20858,HeyRAEkqGTtCj2cMfGR6pbeY5nu4qERFmZSovsfhUtaq,5MDbdhQUt3USB1RFmdLsrAc5UUXZ1n8jXRQFtJ6ibj9B,True,25284788,1114453,4498,2249,2249,68sueyVfmy5ToEGtLFGDkwebX47xAmzyXE29z8JrmcWv,1020542,9310094,-8289552,403
2022-05-09 14:42:03-04:00,20859,DRVtEzZs9u9ysrcANZLEjrvbuuGqYn77v2h4cDFKuNUx,Fv9qiMZhuSBL2cs9AWUYbDLQjB46W2ZwrhxaNXtPLDpC,True,587718657,146929664,441480,220740,220740,A2p75MbAbeUdHkPLkAjgGeiwuu9WPrkMHzjCkDXF1Xr3,17659218,105720536,-88061318,300
2022-05-09 14:42:05-04:00,20860,532MfQR1PzPn6cmC1kpZsz9MyBWSamSeieh1F6GqVY33,6sJ8XXMZzGbHjVU1vWNW8unWoBZhJa54GguYJQhcb8PA,True,90893708,12354058,81611,40805,40806,Hu94aiQWvce6THeGyCFqGRPM1pQrK3ihzkcXo1EpJcJL,6004492,36658542,-30654050,660
2022-05-09 14:42:07-04:00,20861,BuZNHHhRHk2J5Tss8EKjULEaq7Hym6AmFTcXSzmeuLAN,5AfSRx1w44cLAw98gosMWcrMzdMypZN5Bs2iLfyfsWbf,True,41978393,3001949,13646,6823,6823,3zqXX6kzhkbW3d4TwD2CNjMRwxTbREXySekvq37kfCNk,1908287,29911961,-28003674,454
2022-05-09 14:42:10-04:00,20862,EVMrznfJS54BZiywDD2WhUtxzicDtbEpm2a5yLrtCgRF,CpzsMYVYvKg8ihrX1cKRw7TDEYwD3kAyiX92hsf2KiTz,True,56457997,7819651,34676,17338,17338,C4UnXuShCvjSMgBAgVNMy1oakxCNk1et27A82fywU112,2503710,45588877,-43085167,443
2022-05-09 14:42:10-04:00,20863,7xak6qYnjhojLZe7XLb5j4SS9PBXxwSiL9fUwYvLetkX,5U8Q1PEwpDpsEDigx8Hmu9fGW8Cof5y5eypfSc8Zhriy,True,42076744,3011815,14196,7098,7098,C4UnXuShCvjSMgBAgVNMy1oakxCNk1et27A82fywU112,1983408,29906738,-27923330,471
2022-05-09 14:42:13-04:00,20864,95yx3SCWcW9Cp8oSEDV68kGXRKWGyNdYUtNb5UnWMGBD,7PncaFWqW2iKR6EUKf78EW6LLZr7ZWU5b2d2rP22fsU3,False,1133510,1133510,31591,1579,30012,5HnvdJnCCcmRsm4GkXnYWd4q9RpwuvYDGEUMPkYR3Ts9,31591,900350,-868759,278
2022-05-09 14:42:14-04:00,20865,26wo1RqwKXrNnfgMdZEmkGhnDbURpZcp2hasB5EA5QtD,34gwTVGRrdoaBzLUG6SBwRwBovkjBjCebqVUBan6GDnB,True,288334571,72083642,481479,240739,240740,F31bVJvHB2XkhGdgjyTim48hY2cLFEx661AiPS3SzYJ2,19259197,249883833,-230624636,667
2022-05-09 14:42:15-04:00,20866,6pUtYz474QrpATEZnfb3iFbTKYA65pNyKAo4TQZAjtqe,8dipRUXvxJiDLdHEtCPkso4vErbVwshHQiRfvSngBS9J,True,29430962,1139193,3947,1973,1974,C4UnXuShCvjSMgBAgVNMy1oakxCNk1et27A82fywU112,1019738,24573247,-23553509,346
2022-05-09 14:42:17-04:00,20867,85Vef6kFyB9jJC9PK6yaBodYbDR7Vuck1cCMMDUpt5k6,27GkpakVqaNeL7W4om2fSxxJsCpcAis4WSGtNz4AgXdw,True,36656480,2708688,12858,6429,6429,3zqXX6kzhkbW3d4TwD2CNjMRwxTbREXySekvq37kfCNk,1740102,18895756,-17155654,474
2022-05-09 14:42:19-04:00,20868,3r1dFzqvqBswFJEx9iqtqcDx1nQcy7J9LQPJYv4qXtQ4,6yZVDp3KsXmqWesRTusNJtPZXT8NS2krQHMs6X4QX7cU,True,42067215,3011824,13741,6870,6871,3zqXX6kzhkbW3d4TwD2CNjMRwxTbREXySekvq37kfCNk,1919367,29852252,-27932885,456
2022-05-09 14:42:25-04:00,20869,5xkW7wHTcF5WadNtBBqKPKctVwyQtTqqscivAmxzseCk,7m31ZMZdCn5Gz2q5sETWA7uKA5LsKD7pJHBBqU3g7tCn,True,34908891,8727222,25635,12817,12818,5HnvdJnCCcmRsm4GkXnYWd4q9RpwuvYDGEUMPkYR3Ts9,1025432,9049601,-8024169,293
2022-05-09 14:42:31-04:00,20870,3GJayRjZEH4EP3zBJ5ozjH3exAfLfiiQvTDT2V4aPdh2,BUeEcueaohte4zVL51QnLbRsdcMzf7DECdEyfKoYH5XG,True,52464334,3349278,14660,7330,7330,3zqXX6kzhkbW3d4TwD2CNjMRwxTbREXySekvq37kfCNk,2296406,29810559,-27514153,437
2022-05-09 14:42:31-04:00,20871,HDH8Rdbb9rK3sGRcL5NW8ieXPuDVJaip5K2Mbx3wyuSk,Wi9CatvwZ5V9K6eTyLpbmdQySg6WuXGmZwKpxccNQ3k,True,41632381,4225107,15183,7591,7592,3zqXX6kzhkbW3d4TwD2CNjMRwxTbREXySekvq37kfCNk,1496185,17597730,-16101545,359
2022-05-09 14:42:39-04:00,20872,JDeYjCLpfnzcfxDFgHf4aBcHsajwdR14GUaKAA9euzVf,EJbvKoyMZcoCx4vWa61uMbW2vr6mUhrgEuECdteVBuZZ,False,32272,32272,869,43,826,5HnvdJnCCcmRsm4GkXnYWd4q9RpwuvYDGEUMPkYR3Ts9,869,33558,-32689,269
2022-05-09 14:42:40-04:00,20873,5tW54mXQxtM7vGc91HrDeDtWkxJeH2uM4yAviqZnMZCN,7Kg5Zwx5afFdLbTifeyKJLSNVj2p9Xf5anbbqQozNzmY,True,1386866820,105291157,681796,340898,340898,F31bVJvHB2XkhGdgjyTim48hY2cLFEx661AiPS3SzYJ2,89804377,407534054,-317729677,647
2022-05-09 14:42:59-04:00,20874,8T4WK27RvWVGqPuNqY6whk1fmU4vd5qaUQPZG1GJ79bh,DvSz7knS8N3K7L6JhQf1s4mJSyxB8uJXNQXtyjJn8QRL,False,28862150,28862150,984804,49240,935564,47z82br5WdW2DZajdnPDPSSRRKsyAggqXqK6oPUwTaLf,984805,11031077,-10046272,341
2022-05-09 14:42:59-04:00,20875,GXbVMkrY5RVTYojwMRr5fFcxDc1gn6wFWAwVj78HeAQD,HZM8aR5SLY25yCq8kpF4TGbWAXiRvJNJGp1TMUzCJfhi,True,44629297,2764989,10504,5252,5252,3zqXX6kzhkbW3d4TwD2CNjMRwxTbREXySekvq37kfCNk,1695459,20118334,-18422875,379
2022-05-09 14:42:59-04:00,20876,EyNCsqWu8zLyuRnXSbzJWnWZg7ZLjb4oJSZFdDSkbXmT,6rMMMkZibUHXYs8hXY3FmG4rgBx6gWDRGJwR2bP2t6ZD,True,5033746562,462993316,1941265,970632,970633,DQCvC9mR68hJ3tJsUiddh6JwcBJAmntqGJR2nUsEq7yj,211057878,1621105617,-1410047739,419
2022-05-09 14:43:04-04:00,20877,BQYbbwd1MLtj6fBuBiTncAaXdAqKWa1JbcbGkZbLA728,2Wsyr6KoMbSVSvFy3YzutuEQ6skGUZyVHGM42SN4eU98,True,2556410297,98501247,347327,173663,173664,AmTrMPzuTp2BjnjqGNKqz9FTTCdpoKcPAJLwFc8ozcbh,90142292,3423062390,-3332920098,352
2022-05-09 14:43:09-04:00,20878,Fani89KviVFZek4si6YZ3apVuM2kSqVUijDnLBqtvJEH,EpC29dECx1cLC69bj2ncG3jFp7obPaxbH7F6mju27cwL,False,90922,90922,2579,128,2451,6L1WYrPiCMyi7XemPww4B4hvpKD1LQKD4RpiSKmrmgSC,2579,43025,-40446,283
2022-05-09 14:43:09-04:00,20879,FXgL4rWZ42xYgTogwKixG89XDP3CkzuHKsnKmQuhKKhJ,H9ZJNzdokbUH9edFbzCq45fRdn2ENRQNZfPUQ1nTENaK,True,41645214,4221438,15441,7720,7721,3zqXX6kzhkbW3d4TwD2CNjMRwxTbREXySekvq37kfCNk,1523326,17628172,-16104846,365
2022-05-09 14:43:15-04:00,20880,FRbeFwhUYCiHW5oP26mad8KND7CCYDbfnoNxX7GuXVp8,GrzXKxPX2WDka8i2D8sunMUsrsThKasQi8NYLwuCGygV,True,42017236,7180957,27940,13970,13970,6L1WYrPiCMyi7XemPww4B4hvpKD1LQKD4RpiSKmrmgSC,1634918,22664546,-21029628,389
2022-05-09 14:43:32-04:00,20881,4uNUqcnkVMJH9XZWzukBy8smUa9KUNs8kLMDpyfbWQMz,4kqp3UGFJ7pSUU17zw31nNqLH4SMhU4qpyG8T9ynY3d3,True,639483621,159870905,477962,238981,238981,A2p75MbAbeUdHkPLkAjgGeiwuu9WPrkMHzjCkDXF1Xr3,19118501,124965585,-105847084,298
2022-05-09 14:43:35-04:00,20882,EHi1UBG8wMUFZECktsFUZkGjJPaBNEedswS62hyYn6jC,Drx9ErQhAjnPuJ83LPYFnY5ZV5XDzGuXDuSf16VqWayp,True,42145594,4682130,16547,8273,8274,3zqXX6kzhkbW3d4TwD2CNjMRwxTbREXySekvq37kfCNk,1489521,34817728,-33328207,353
2022-05-09 14:43:37-04:00,20883,51kq1cj3PkCohe9bqSJUuYQUY8y1ZN4WRJHAwiriRvWq,63yTY7gptwwrWq5Br4sMnKJzREBfjokQCj4oMMrySR8w,True,42074359,3014193,14195,7097,7098,3zqXX6kzhkbW3d4TwD2CNjMRwxTbREXySekvq37kfCNk,1981515,29907222,-27925707,470
2022-05-09 14:43:38-04:00,20884,4oMasDRj8HWfknmdwt6Mkz3eonr8J2byoiSTRo4sCnFQ,3emcATkEFvDVETiK97eVET2Z2jzkgiiSxX3gu5wsUKPe,True,23655617,3319976,21985,10992,10993,2a35JJeTUW1pm6M3e8DHCjp8qr4vbc2cRPhuzZWyFzYd,1566542,21489493,-19922951,662
2022-05-09 14:43:49-04:00,20885,CZhzJ91hP1pFbNNz7YnUKXznvs6ZFVSRNLbe1SaTw29o,X3B4LpHFfeJPmCnEmRQ8V6MNMi7KpTE4MLD7LHYXUwy,True,522906950,28642633,104433,52216,52217,F31bVJvHB2XkhGdgjyTim48hY2cLFEx661AiPS3SzYJ2,19065741,129259611,-110193870,364
2022-05-09 14:43:49-04:00,20886,D64rDiWT3YG28fCgXCmbNjYa2JakZbpKQ1D2XuLChUfV,8WmMWq8cTsGQym5pUbHm9dPCpJugBeWUMVERYFGLxWHj,False,147797,147797,4197,209,3988,47z82br5WdW2DZajdnPDPSSRRKsyAggqXqK6oPUwTaLf,4197,107231,-103034,283
2022-05-09 14:43:52-04:00,20887,92cQnCMBkPL8DmE4xYQXJVAQ8EXk3moXXVHaM2zQT4uj,A5MAQitMT3yojsCtjyq9pypZQP9Df6m95X5srsEXaxr6,True,686730880,171682720,478144,239072,239072,gjBMZYVujDjD1ECG4i97M8Q3gV9ESnwwTSUGropkusj,19125770,825949558,-806823788,278
2022-05-09 14:44:05-04:00,20888,GYgxUfZ19oSyHuovGRA6gBJT32goSxCrKR8hQQdBsrRG,2r8c6SU74hRq7xEmYBJ92WoSB6v6XCAXR3JcDznfCxkN,True,89760144,22440036,63312,31656,31656,C4UnXuShCvjSMgBAgVNMy1oakxCNk1et27A82fywU112,2532486,72956324,-70423838,282
2022-05-09 14:44:05-04:00,20889,6mHh6gBJZiXeMHuc52cw8hBd91dWwXZ8PoxYLvZsJ3s2,6HTpN4dAQSiRurBeBgbHWJEqM1SA4L4Zw36EXy3o8YZR,True,36651834,2699309,12861,6430,6431,Hu94aiQWvce6THeGyCFqGRPM1pQrK3ihzkcXo1EpJcJL,1746357,18910524,-17164167,476
2022-05-09 14:44:07-04:00,20890,HeyRAEkqGTtCj2cMfGR6pbeY5nu4qERFmZSovsfhUtaq,5MDbdhQUt3USB1RFmdLsrAc5UUXZ1n8jXRQFtJ6ibj9B,False,24109169,24109169,954876,47743,907133,5HnvdJnCCcmRsm4GkXnYWd4q9RpwuvYDGEUMPkYR3Ts9,954878,8838014,-7883136,396
2022-05-09 14:44:08-04:00,20891,H9pFRayNBHTAhsbtGyfs1XXUWGxAbw7SgpT1xdrSRWEY,9LNreyXuhgyLCDYViNyA1jUw6h1nv4GmDtTYMoUQBqCG,True,502862731,63565013,183875,91937,91938,F31bVJvHB2XkhGdgjyTim48hY2cLFEx661AiPS3SzYJ2,14546421,257416884,-242870463,289
2022-05-09 14:44:16-04:00,20892,6FTpyyMAinMQb2zCAffxJ3x8oxgPLGqt2mniauxMsdwK,2Pp5q1VKN52hV8cq6Ku8NfCVLYZqv4mnBGD1PjjAGYvD,True,52515449,3361868,14634,7317,7317,5HnvdJnCCcmRsm4GkXnYWd4q9RpwuvYDGEUMPkYR3Ts9,2286062,29770665,-27484603,435
2022-05-09 14:44:17-04:00,20893,4A7jMDd3gXbca7GxDdnA89VR9q2QkgoZwfeFHbiFKJoT,Gio6N9Ct2B623hacv8DhLCfxmBmdCUiJKKwFhpVR27Yu,True,52450115,3359041,14717,7358,7359,6L1WYrPiCMyi7XemPww4B4hvpKD1LQKD4RpiSKmrmgSC,2298075,29848052,-27549977,438
2022-05-09 14:44:21-04:00,20894,6pUtYz474QrpATEZnfb3iFbTKYA65pNyKAo4TQZAjtqe,8dipRUXvxJiDLdHEtCPkso4vErbVwshHQiRfvSngBS9J,False,28202600,28202600,926620,46331,880289,C4UnXuShCvjSMgBAgVNMy1oakxCNk1et27A82fywU112,926622,23356427,-22429805,328
2022-05-09 14:44:22-04:00,20895,6v2KNGc2fG2d6gej4197zgxpPZHY8cdd7wXxyceEPowK,3u6LAZVkQRKaxNkTwACrDMXMf5fEY3VZmrUr4t2pAyE9,True,51406421,12851605,38521,19260,19261,C4UnXuShCvjSMgBAgVNMy1oakxCNk1et27A82fywU112,1540853,20060966,-18520113,299
2022-05-09 14:44:36-04:00,20896,6ysLiC97aFsZW4f8gTXFdppPfFGPPbipD9MspMecEfoZ,GBi462t3bgeNiCe8R2cgSwFrpf5z4L7vh2G3CKFgGKrx,True,52487418,3359010,14696,7348,7348,5HnvdJnCCcmRsm4GkXnYWd4q9RpwuvYDGEUMPkYR3Ts9,2296503,29810339,-27513836,437
2022-05-09 14:44:36-04:00,20897,9eWpSyu71Z6dmx7yTh7WrbVScdrrZN14d5tfmqEGFgXt,2r89PFKSD9zmSp2Wyx4CQ75HAtmUgwhAS2oG5MuYuiV6,True,75128407,13435931,51421,25710,25711,6L1WYrPiCMyi7XemPww4B4hvpKD1LQKD4RpiSKmrmgSC,2875296,38272742,-35397446,382
2022-05-09 14:44:38-04:00,20898,5gbb71ZWaLF2MnNuK8D6gQKQ4qzuBTcYzAvm5e2vmmVT,4a3b9s5BRAcAdCFD6EhhsemEXyFpnTYqSKvw82RUtjpb,True,155782855,38945713,243128,121564,121564,F31bVJvHB2XkhGdgjyTim48hY2cLFEx661AiPS3SzYJ2,9725136,174403680,-164678544,624
2022-05-09 14:44:41-04:00,20899,DqmCdPCrcuwFP2D2Zt9K35Wo8UaFY94TfFXb9D3D5r48,Efeh4gv3aYUDAewAL4H56qwHgzug7z6s8SMm6HkSP46D,True,42075036,3015865,14212,7106,7106,3zqXX6kzhkbW3d4TwD2CNjMRwxTbREXySekvq37kfCNk,1982795,29907859,-27925064,471
2022-05-09 14:45:04-04:00,20900,AZq9LHFskHUujKDJZTpWhpP9LRaDjQKcrf2Bz2eY6TtN,EtStidHXHYYQJ6E1h7LHmgewtiK7AjMAsDBw4XBCrdQs,True,116617743,29154435,181935,90967,90968,F31bVJvHB2XkhGdgjyTim48hY2cLFEx661AiPS3SzYJ2,7277435,81902645,-74625210,624
2022-05-09 14:45:54-04:00,20901,ATS5VRAN1aPKBiATDcUs5yd6yVuTmWqrqqRFNdfz6DZT,7VKq4rZLEtY2dhDFZMTQMvCYyJa1ASM9RHobUaYhHWAe,False,1367181,1367181,36011,1800,34211,47z82br5WdW2DZajdnPDPSSRRKsyAggqXqK6oPUwTaLf,36011,932798,-896787,263
2022-05-09 14:46:07-04:00,20902,CxLFMBDFkoMvpK9YUf7WtCq6hn7k3QACAuetAnGjU6KA,2gE52a1GWQnS6ifV6eVtKQyr13LXP5Jdt3yG9SjGPJPF,False,5041493,5041493,150031,7501,142530,47z82br5WdW2DZajdnPDPSSRRKsyAggqXqK6oPUwTaLf,150031,2625804,-2475773,297
2022-05-09 14:46:46-04:00,20903,8e3Du79eCAvuNc6ZX44quJRCuCxmjVDNhRHr1eTB3wqr,3Lb3b9ikztneijmjUzNgHKzCBBfFNKbpjAyc7DQ8pE2M,True,73578588,18394647,54192,27096,27096,F31bVJvHB2XkhGdgjyTim48hY2cLFEx661AiPS3SzYJ2,2167709,47231506,-45063797,294
2022-05-09 14:46:49-04:00,20904,CmMkpR7Yewedgu4GvLCZAFKdGj19ex69w4EhCQ58i25o,5QWRVRgDMHoincpRD981hPaPsYhGGZnkRVYxtDDYYGLc,True,461179189,79045046,237557,118778,118779,F31bVJvHB2XkhGdgjyTim48hY2cLFEx661AiPS3SzYJ2,13860056,84765073,-70905017,300
2022-05-09 14:47:02-04:00,20905,2tAZNJUVTkG27DSVBFnTAebcaz7wS4e599LWS7DFxxL3,DNUDt2KLAaqfJFUdw64AUKDZiWk6q5Ydhw5STGbLFRgg,False,1181778,1181778,35512,1775,33737,6L1WYrPiCMyi7XemPww4B4hvpKD1LQKD4RpiSKmrmgSC,35512,753542,-718030,300
2022-05-09 14:47:04-04:00,20906,5C9g5y6NoU7ffD7oWNQawibQTSeCnfZMnyjNCfCDxpjn,91qVcgwcmTTvCUX4KuR6xVDyctvEzd61deRmFWkRQTKy,False,1181279,1181279,34905,1745,33160,3zqXX6kzhkbW3d4TwD2CNjMRwxTbREXySekvq37kfCNk,34905,753434,-718529,295
2022-05-09 14:47:04-04:00,20907,DADN7s4BEsPs13MWvSt2R5w2v1chqxA71F64MGq5f27X,ELHJ5DYpGaEawSzbzSzhzrrj7tmUVh2hNgojnhy5s6CN,False,1180939,1180939,34847,1742,33105,3zqXX6kzhkbW3d4TwD2CNjMRwxTbREXySekvq37kfCNk,34847,753716,-718869,295
2022-05-09 14:47:11-04:00,20908,BHbambfJTGGgoiXdUgYXdSkzDoNpJeVATz6kaKwz36pp,6WbZHTRjNqKCfUrvrZnN5pYoTLkKXVdwJhwj7a7LEzwC,False,1181456,1181456,35046,1752,33294,3zqXX6kzhkbW3d4TwD2CNjMRwxTbREXySekvq37kfCNk,35046,753398,-718352,296
2022-05-09 14:47:11-04:00,20909,8trFFwvXKKMwMx952ugCZmqyw29e1HxEKBuQmFn8ZwTf,FsD7gCvHXM3QchQiDcd292ksy5afZMWApneNTat5ndeS,False,32638585,32638585,973014,48650,924364,6L1WYrPiCMyi7XemPww4B4hvpKD1LQKD4RpiSKmrmgSC,973014,5712085,-4739071,298
2022-05-09 14:47:12-04:00,20910,HbJxpWkhz7Vn2iKtjtgWAuN6f2vQC38JJnTQGEFNDvxQ,HgchxTa4ji58Tw3XB5MH2WtnqcnrhocgLpPsfCQemfDf,True,274169852,43874124,128253,64126,64127,F31bVJvHB2XkhGdgjyTim48hY2cLFEx661AiPS3SzYJ2,8014564,29806011,-21791447,292
2022-05-09 14:51:10-04:00,20911,6wGzqSWYjB1nukhDwLdgXDzMNSeasuRur3FVZAkVF4pM,HTcJjvQNFJQEewRf8iCcsZgFcfHoUXzpbb7WscqdK4kS,True,23365079,5841269,36300,18150,18150,5HnvdJnCCcmRsm4GkXnYWd4q9RpwuvYDGEUMPkYR3Ts9,1452008,8646058,-7194050,621
2022-05-09 14:52:53-04:00,20912,DK24JASWC2tR9MyHiQwGVNXZj97AuhYo6BmfxGp289eR,BFjgan9PWn6ECgXUbLKbqzNnHcsGfJ1yYYxioPNCmwGj,True,335703308,83925826,457047,228523,228524,A9TwRM1BMxqb8DCC7YNAMV6zPenEJm3HTZBy7wJKK58U,18281932,31891955,-13610023,544
2022-05-09 06:46:40-04:00,19889,C8EuUJigyRy2ojSuZtDSnc4JxmVqoe5XTr4xaPPmKsyV,6PrUiT94hGcBm2AvkmkrnRnjXkR8WxmtJcvSapde3J1P,True,41660692,10415173,31239,15619,15620,68sueyVfmy5ToEGtLFGDkwebX47xAmzyXE29z8JrmcWv,1249579,94493997,-93244418,299
2022-05-09 06:46:46-04:00,19890,3AaMzK9WAbD9m27szcJYnucnSPQ4W7tk8EztgWv4vqUo,8oUBQUKo9wHLu1tUEF1AeCUa7oRYyDSoFNRMqQAqKMbH,True,54739603,2625220,10789,5394,5395,C5o4TfkUfECutAWsDELjhsZX6PYyYgK3XeKvx6p4FphM,2249851,17078135,-14828284,411
2022-05-09 06:46:48-04:00,19891,EkKmfEnxTscSs2BDs1mg6SyHdStC8AYTy9zihw9VWP63,DW4ujEZj4H83B9CrSfbks2pkHEj3gh2d114eo1aDh4s9,True,46679747,11669936,33807,16903,16904,2a35JJeTUW1pm6M3e8DHCjp8qr4vbc2cRPhuzZWyFzYd,1352303,15338833,-13986530,289
2022-05-09 06:46:48-04:00,19892,9ancY5Fso8pUktKpRj3qc1YPQA6thy5n4f7uvNnsqMWR,CLUi9rvU9NTi7h4sNwqfr8aqChyGDbVJA1aKvKMWQv2r,True,684931990,171232997,512774,256387,256387,72XWPCtRYEDZbddP7d6dHtUBRRDLSJsB2xZTAfefoEVZ,20510974,168058823,-147547849,299
2022-05-09 06:46:50-04:00,19893,8J4BZXZzkK4SmWxc2YoaJRg9ivuuXbdVe5XpEhVds1ZM,3pirVwiye9NftvMpX5F7WpfcGZy5uV3c11xCdkkZbL9D,True,471510050,117877512,322185,161092,161093,DA18qE9qesbBqpwNv1M4befYcNQkbSBSeLPTmQzrmbJw,12887405,83760903,-70873498,273
2022-05-09 06:46:50-04:00,19894,CvR57tmtnHbMmPivvJR6VenXivQaWue7z77N81WPpzfv,B4ASc8cUjrzuchv2SHwPrnjKvZgZpwvcLArsdYmMAqBQ,True,151433136,37858284,112976,56488,56488,C4UnXuShCvjSMgBAgVNMy1oakxCNk1et27A82fywU112,4519077,44523532,-40004455,298
2022-05-09 06:46:55-04:00,19895,GdUWbwTgHF1RRbpVXCahz36G7MqYrM6QaBgnjL2eLKxk,JDYxQpYMt38mmjzLrVjgi3ezpc3DQ8YJEtJTZbG6fCCq,True,40360018,3956761,15657,7828,7829,8sEswn3kzEhnYjAZVvCQnHEUvYd7pFVvc2Xc2Kd1BpbC,1597131,13534090,-11936959,395
2022-05-09 06:46:55-04:00,19896,8uoS53t92hUWWx6mZHGhpKs3dkYJYyiRufnp4H1anBJH,E1Nc6fTaZ7EFFJqVDnEfV3odtasBRhEzbtg4JDFDzJ3k,True,93089353,23272338,145128,72564,72564,C4UnXuShCvjSMgBAgVNMy1oakxCNk1et27A82fywU112,5805125,77699412,-71894287,623
2022-05-09 06:47:04-04:00,19897,Bzp3ZUxzRWqW4QoLq9PtKN1HQeSaKXFQrX1G3a4ocrre,H12B3p4v1ZtZ9gaSgpxCJsKXmmEjiqaRZQzexjzAhevo,True,1125730633,79519317,354364,177182,177182,68sueyVfmy5ToEGtLFGDkwebX47xAmzyXE29z8JrmcWv,50166373,705375968,-655209595,445
2022-05-09 06:47:06-04:00,19898,HV3BVN9zLURqQBJyUFFeytFvjhhoYYJ3VXTCDYpML7Fd,ZCesJgyYoyWb3wfUP6BusxEBtVAYb2AAe94QbxVkFsb,True,47589853,11897463,30708,15354,15354,C4UnXuShCvjSMgBAgVNMy1oakxCNk1et27A82fywU112,1228323,11216618,-9988295,258
2022-05-09 06:47:07-04:00,19899,DBT4GeddD8Ve8v7kerU1xrdJyy5moqUedcjYgM2jWESV,FVdbkwTpM3U6E4qQ9E2T9rTJ4dFYdkixsibnEiZqNUsA,True,514161765,128540441,368069,184034,184035,DA18qE9qesbBqpwNv1M4befYcNQkbSBSeLPTmQzrmbJw,14722770,151050869,-136328099,286
2022-05-09 06:47:08-04:00,19900,42h4NteqFpLjgjMS4gTTFoLvrEMpEP4sbGRd7SM5YCZR,AasJCLP5qsGzxkQs5jWysSarwoJTuZ6ZDeabNJNimWAX,True,1829160693,457290173,1338984,669492,669492,CGtKBgcWZ6HKE3tFNLPUM9khDv2Rc7d6BrPtxz7J1aY,53559385,200061508,-146502123,292
2022-05-09 06:47:10-04:00,19901,7YCSi1xGHn5j65W5cZPkQ9RQzvpNgCGdrafAGGTLYkjE,BdVVPyQgd93sMf1SDCFFMvyugNsbdkrVNgaQCJEGjTLC,False,24322079,24322079,952543,47627,904916,2a35JJeTUW1pm6M3e8DHCjp8qr4vbc2cRPhuzZWyFzYd,952545,9396182,-8443637,391
2022-05-09 06:47:15-04:00,19902,6pUtYz474QrpATEZnfb3iFbTKYA65pNyKAo4TQZAjtqe,8dipRUXvxJiDLdHEtCPkso4vErbVwshHQiRfvSngBS9J,True,317764073,39163319,127346,63673,63673,8sEswn3kzEhnYjAZVvCQnHEUvYd7pFVvc2Xc2Kd1BpbC,10332722,205174267,-194841545,325
2022-05-09 06:47:17-04:00,19903,m7gf1jAYXBZjRZEY9w4MjPfhzLwgDKaXyaCVhRD6C5E,Aa2aTZnpPux1i5K2MT4i1TsVM8vR7qR7rZGijQW4zpwd,True,603120681,125493760,437448,218724,218724,AmTrMPzuTp2BjnjqGNKqz9FTTCdpoKcPAJLwFc8ozcbh,21023709,257723318,-236699609,348
2022-05-09 06:47:18-04:00,19904,Frobc1KZTVcsyfwyKwSpHJobxmiJBomzHhGCLdrzdAz8,HziyKP9uxWCuXddtbRzWMczHNdgyQB5UXQZj4MnMm14,False,225301,225301,5798,289,5509,47z82br5WdW2DZajdnPDPSSRRKsyAggqXqK6oPUwTaLf,5799,163492,-157693,257
2022-05-09 06:47:18-04:00,19905,AtaNpuHGEDd7kfakJbTbpphMdQk7ZWk9iB585TtNATKx,72egdmxZyhyYsM93hTMuoDd6NeYVB7gpiJG4PWj4Qi8f,True,33141616,1544156,6104,3052,3052,47z82br5WdW2DZajdnPDPSSRRKsyAggqXqK6oPUwTaLf,1310140,11235415,-9925275,395
2022-05-09 06:47:21-04:00,19906,E4VzeJLsf5Y6t3yNi8VpS8QxhJbJGPhnkNBmU2XoCBs9,63CXyYfevXtrL1QcfQtAhz29xeea5BwWcj6d6BWb4qiB,True,995568405,248892101,726272,363136,363136,CGtKBgcWZ6HKE3tFNLPUM9khDv2Rc7d6BrPtxz7J1aY,29050905,469907091,-440856186,291
2022-05-09 06:47:21-04:00,19907,FRbeFwhUYCiHW5oP26mad8KND7CCYDbfnoNxX7GuXVp8,GrzXKxPX2WDka8i2D8sunMUsrsThKasQi8NYLwuCGygV,True,139098747,23864396,94881,47440,47441,72FwbpFGoLEazJEdpqNtPNefsadUrimUqma9wSoy4qiS,5530369,65689004,-60158635,397
2022-05-09 06:47:24-04:00,19908,7w76zJFb9nTPDbfC4DCscQ2F5vimT8hiivT8WkuwWYWX,5X5XNdoFZv15bmbv97VRxHgTZzKyiFZpoz7MRNkPZS6f,True,35403186,1537330,5895,2947,2948,8sEswn3kzEhnYjAZVvCQnHEUvYd7pFVvc2Xc2Kd1BpbC,1357635,11892096,-10534461,383
2022-05-09 06:47:24-04:00,19909,fAJK1wrBhSW297AtFWX2U4rUBf2gkzfQ6UrQL9yHEYW,5pyTFpanSyUCHxeMhJMKtpdrcMSAWc8bFadbyM7q4q4B,True,214867537,53716884,147041,73520,73521,68sueyVfmy5ToEGtLFGDkwebX47xAmzyXE29z8JrmcWv,5881643,21619203,-15737560,273
2022-05-09 06:47:26-04:00,19910,HHNj1MooHaJCm7SYAjdKSnk2sa7yUFH2PrQYWiN9E6uy,H6hKDBEsDh76s9H9FVBn1ZDTR27JEZTHUM7zwoWw26bc,True,2336222065,413023441,1748464,874232,874232,gjBMZYVujDjD1ECG4i97M8Q3gV9ESnwwTSUGropkusj,98900000,144054161,-45154161,423
2022-05-09 06:47:26-04:00,19911,Cv5oVktxmqbU1SxraxH67NEWMKnjgA18R832Fhe9h74a,Cs7xBD4BDiohyopnaYDDChUtR9vmx7uwot6Qp9beQLzt,False,5027239,5027239,149711,7485,142226,68sueyVfmy5ToEGtLFGDkwebX47xAmzyXE29z8JrmcWv,149712,2012385,-1862673,297
2022-05-09 06:47:27-04:00,19912,H8P77smmiLj1vtt7hoSjf2vmcnBdW4rsgCtagtXZg6yy,3FxygrzNpSWivjLU3CumYif6rXhSzyjLqdKiyvphDnnc,True,54749019,2638341,10968,5484,5484,3zqXX6kzhkbW3d4TwD2CNjMRwxTbREXySekvq37kfCNk,2276225,17100188,-14823963,415
2022-05-09 06:47:27-04:00,19913,EHi1UBG8wMUFZECktsFUZkGjJPaBNEedswS62hyYn6jC,Drx9ErQhAjnPuJ83LPYFnY5ZV5XDzGuXDuSf16VqWayp,True,457381774,51227373,186469,93234,93235,3zqXX6kzhkbW3d4TwD2CNjMRwxTbREXySekvq37kfCNk,16648847,313147547,-296498700,364
2022-05-09 06:47:27-04:00,19914,7A1A93jqxV65F7XwvBarhgfTm3iFh3s75jFNzVCtFnez,8Z6QWdy4zGUzuMdKhkdxzq7RaLHhJmrpYEKeqsw8bopx,False,30159051,30159051,878467,43923,834544,C4UnXuShCvjSMgBAgVNMy1oakxCNk1et27A82fywU112,878467,7765883,-6887416,291
2022-05-09 06:47:28-04:00,19915,HXQXfEQe7aCpr6WKh37XaDZsjZcuQPk5t8tWNFgEoK6U,5ufXkCEDwgiXwtyPye4wYVVA3oLW54JVzz4tnXFofto4,True,458526770,114631692,343839,171919,171920,C4UnXuShCvjSMgBAgVNMy1oakxCNk1et27A82fywU112,13753581,213628220,-199874639,299
2022-05-09 06:47:39-04:00,19916,BTXpvCdmYEmg5fB2Hsjc6Wked2sky4oQpGu7r8KuPau4,CaEwxQQds9f44npaSrYAsC6WpE3T6MpAGr9jgXZeqWjA,True,66044971,4081642,18354,9177,9177,3zqXX6kzhkbW3d4TwD2CNjMRwxTbREXySekvq37kfCNk,2969948,20988392,-18018444,449
2022-05-09 06:47:42-04:00,19917,Apqv5iu4bJ6pVg2NxjfwuvnfxDK6navHhhU1CVJEHeMa,7pDPJrxndRsLq983bEwvd3MKYnnqyQzQNMhEaC5NZYN1,False,30180061,30180061,887925,44396,843529,72FwbpFGoLEazJEdpqNtPNefsadUrimUqma9wSoy4qiS,887925,7759154,-6871229,294
2022-05-09 06:47:59-04:00,19918,68gVM4kjmSYxT1uJW13rYSway8uVLUdcLa7sJuqHQaAf,DshroBQ3da7BcAiQpiFREsLKWbUDrBRmmZRw3Zu2Qfs9,True,91926270,22981567,59819,29909,29910,C5o4TfkUfECutAWsDELjhsZX6PYyYgK3XeKvx6p4FphM,2392767,26091788,-23699021,260
2022-05-09 06:48:00-04:00,19919,5NVJU6YoZuuEjGNUUUJcGwS2Qd8b8CH7QSgMV7UWL5E7,8ZUq3o1nSkEvSfmiTz4anUpSMECCnX38MRwV7E5AGYSt,False,31185582,31185582,935388,46769,888619,C5o4TfkUfECutAWsDELjhsZX6PYyYgK3XeKvx6p4FphM,935388,8010602,-7075214,299
2022-05-09 06:48:01-04:00,19920,DvSVpLMQyz91ksMwhuwwFDiKMo53FC5FVG5XrQZYWurJ,5jL2cYHg1QQpWYRCF4f378jpeHnTfPMWXiiHuhLNbzq8,True,36291561,1542386,6328,3164,3164,6L1WYrPiCMyi7XemPww4B4hvpKD1LQKD4RpiSKmrmgSC,1488963,12491127,-11002164,410
2022-05-09 06:48:06-04:00,19921,AXbnJEF6Xottm9wMck8NTq6ZhgM54Fb9V3Zsc2LNTQkN,49Pg4iQXwjTucVDHFuCsEXWin4NLPAMCmVkiU6biMLd7,False,2088166,2088166,62477,3123,59354,3zqXX6kzhkbW3d4TwD2CNjMRwxTbREXySekvq37kfCNk,62477,688811,-626334,299
2022-05-09 06:48:20-04:00,19922,EyNCsqWu8zLyuRnXSbzJWnWZg7ZLjb4oJSZFdDSkbXmT,6rMMMkZibUHXYs8hXY3FmG4rgBx6gWDRGJwR2bP2t6ZD,True,48729365555,11284422548,36549139,18274569,18274570,GXyFXZMNk2NFyEzw6JetVqsujqcz2yCixH7n8EpDJYWD,1578296471,9026810987,-7448514516,323
2022-05-09 06:48:20-04:00,19923,7zuFEyLQFHkAjm3mAuxN42VenwF6fZcqM81mmR8sBnmY,CSnQxjc4Jn8iP4JSxj5wsrvxGsLoAYQn1bKC8naY7YZP,True,8047467668,2011866917,5870959,2935479,2935480,A9TwRM1BMxqb8DCC7YNAMV6zPenEJm3HTZBy7wJKK58U,234838390,634424414,-399586024,291
2022-05-09 06:48:22-04:00,19924,GNohZMtk1VAuhLAgNGT8J3HYCKDCiyjvLeAWr64d7Duy,6soTLVj9DzFht8DzvjRfNPAWhZuiDBS5fDE1fpeuDSSz,True,22098500,5524625,34364,17182,17182,6L1WYrPiCMyi7XemPww4B4hvpKD1LQKD4RpiSKmrmgSC,1374598,15981446,-14606848,622
2022-05-09 06:48:23-04:00,19925,CpeJ8BVz8Nd6SqnM3DYejnvAYnovDwu1taCqMEBD4RRi,GMmBgzDTtes62wJTENptaWPxNY2srWCrAdWErkj22Hzj,True,31736851,3024980,12237,6118,6119,8sEswn3kzEhnYjAZVvCQnHEUvYd7pFVvc2Xc2Kd1BpbC,1283984,10562811,-9278827,404
2022-05-09 06:48:31-04:00,19926,9eWpSyu71Z6dmx7yTh7WrbVScdrrZN14d5tfmqEGFgXt,2r89PFKSD9zmSp2Wyx4CQ75HAtmUgwhAS2oG5MuYuiV6,True,369586942,31768139,128770,64385,64385,47z82br5WdW2DZajdnPDPSSRRKsyAggqXqK6oPUwTaLf,14980978,177103775,-162122797,405
2022-05-09 06:48:52-04:00,19927,6wGzqSWYjB1nukhDwLdgXDzMNSeasuRur3FVZAkVF4pM,HTcJjvQNFJQEewRf8iCcsZgFcfHoUXzpbb7WscqdK4kS,True,79828049,19957012,123891,61945,61946,3zqXX6kzhkbW3d4TwD2CNjMRwxTbREXySekvq37kfCNk,4955669,21709086,-16753417,620
2022-05-09 06:48:56-04:00,19928,7rq3F5ZQXc991M4SCSqvhYKL2SsPT1DKjBBUoxovYt1e,BwzUY6Tyc5TnBfSajK9WeyjGVqVj6Lup73vd88dSc1vh,False,1262475,1262475,77426,3871,73555,6L1WYrPiCMyi7XemPww4B4hvpKD1LQKD4RpiSKmrmgSC,77426,827547,-750121,613
2022-05-09 06:48:58-04:00,19929,GcwFXxcxRF2xwbgFbQZoYEDreimd3J3UJ9sPfuwYVKtS,7uXjmKS8RxP2qSS7ataBH5hkfpgsFcpSBWUEBuV5zgyZ,True,125779107,31444776,93267,46633,46634,47z82br5WdW2DZajdnPDPSSRRKsyAggqXqK6oPUwTaLf,3730689,35913061,-32182372,296
2022-05-09 06:49:05-04:00,19930,Bu65ba81oA2rZqxGAsctgz39NPPJqbXR3SvdMX5KQfTK,DcxNLDe2GwGiQPtQhzMiUjrMaqXjuyx1EGgX3xPtE98T,True,53044410,13261102,40038,20019,20019,C5o4TfkUfECutAWsDELjhsZX6PYyYgK3XeKvx6p4FphM,1601556,15292732,-13691176,301
2022-05-09 06:50:06-04:00,19931,25NUDrsdLhS3fcARLiTMbbmZHvvzvzPj9xAdoN8sJBN3,8baNRGHfYRcLdhbHNuH72ofAWM9UojqhTMLnbBayzGnW,False,246076,246076,15297,764,14533,C5o4TfkUfECutAWsDELjhsZX6PYyYgK3XeKvx6p4FphM,15297,173481,-158184,621
2022-05-09 06:50:24-04:00,19932,243SAnGxchCVB1LQAUF4SsozR86yDwEdg2QQpbWGsMYe,5u8sNkb2oEQjUXJAB3yGStmv3Uwz16gBgExBo5myVK4b,False,81960,81960,5017,250,4767,5HnvdJnCCcmRsm4GkXnYWd4q9RpwuvYDGEUMPkYR3Ts9,5017,56886,-51869,612
2022-05-09 06:55:02-04:00,19933,cXqFkCF4gaT9vAcZYMgwLXmmuD5w4hwgxT8YXE8JuBw,5Wtf4ZBL6R1afLeC4WfhFGkfi42TagtNAg6EZWn7gKhg,True,78428050,19607012,59283,29641,29642,8sEswn3kzEhnYjAZVvCQnHEUvYd7pFVvc2Xc2Kd1BpbC,2371327,24050258,-21678931,302
2022-05-09 06:55:13-04:00,19934,BgNgALwBEuiumVgiXRmBZRnyFrr9QTDy2maHzsNwNHGf,ag35Ec2uFtqkarizCxFyhM2SPBuUwfmLRhAdFEWFCNa,False,160551,160551,9944,497,9447,2a35JJeTUW1pm6M3e8DHCjp8qr4vbc2cRPhuzZWyFzYd,9944,102979,-93035,619
2022-05-09 06:55:44-04:00,19935,DMACzuFBuj2vGqxZ3FV7QAo24jMV3EHKL8MrDrGbRkaJ,EnLfmDVW4ba2uqZKhj3X1TFnx8AHv7xwSWrMbVBYwcu9,True,36293664,9073416,27431,13715,13716,2a35JJeTUW1pm6M3e8DHCjp8qr4vbc2cRPhuzZWyFzYd,1097266,6173073,-5075807,302
2022-05-09 06:56:22-04:00,19936,djW9rVm1v4nW64QiVqgFUCRza24VqthDcSfVEyRHPed,EsXvQmXVXECqZPtmSdiuwieHPP5jsmyn67p78vHaJcqq,True,112388607,28097151,85122,42561,42561,8sEswn3kzEhnYjAZVvCQnHEUvYd7pFVvc2Xc2Kd1BpbC,3404887,15188866,-11783979,302
2022-05-09 06:56:32-04:00,19937,A415rwvXESPhU3yhq4TaPNA6PPVuiaACMHohRduoEp3R,GX9LnZmX6Lycn91ebcFUYgaTD9RQutdmwvKYzpfTXGZx,False,11226054,11226054,335277,16763,318514,Hu94aiQWvce6THeGyCFqGRPM1pQrK3ihzkcXo1EpJcJL,335277,5667550,-5332273,298
2022-05-09 06:56:33-04:00,19938,GtDk7DkAB2jvQynR57z8mjg6UoaTqYDr8Z4wsFX6KGSr,tAPvp4fscJZySZUVG2GZWZwSRVhfnNvkjCC6ZvmxqDQ,True,157356749,39339187,118520,59260,59260,8sEswn3kzEhnYjAZVvCQnHEUvYd7pFVvc2Xc2Kd1BpbC,4740818,26084106,-21343288,301
2022-05-09 06:56:33-04:00,19939,agiVhhsNiMPzMaNWTHKRZ435HtBjqQvRuReKkpG32pn,HgcU2oCotYPxvGY6M21SbdqhzXJmNPDWEiTCDu4rA5dB,True,41871954,10467988,31330,15665,15665,2a35JJeTUW1pm6M3e8DHCjp8qr4vbc2cRPhuzZWyFzYd,1253217,15691499,-14438282,299
2022-05-09 06:57:26-04:00,19940,5rnSL1jkLDsAvWsKNrbxtBJEcavHbc41kSTWywUEmSaX,87ZzyZEPJAXq6UiTqQVNuChRQVSb7QcUJgV41saA8CFC,True,36002086,1585679,6463,3231,3232,Hu94aiQWvce6THeGyCFqGRPM1pQrK3ihzkcXo1EpJcJL,1467627,12345542,-10877915,407
2022-05-09 06:57:27-04:00,19941,iEXYXt9JNg6tud7wsHcTe349MNWHBgAoRptNpasAGwb,DNCFSLLWNWEVfsqht6EuiQ7PwCdzhHjDk9i4UpgnDTxB,True,338402644,64094126,202679,101339,101340,68sueyVfmy5ToEGtLFGDkwebX47xAmzyXE29z8JrmcWv,10701015,40917447,-30216432,316
2022-05-09 06:57:27-04:00,19942,EEQmHFk3WFNmPfe7ujtP1PK6P5yqV5mmWumNSoTu45P8,FG9DScQDQPrgcmBbRugZ5NfhSTRMnKSWLxcUeTF9MgJZ,True,279209596,69802399,205798,102899,102899,5HnvdJnCCcmRsm4GkXnYWd4q9RpwuvYDGEUMPkYR3Ts9,8231935,46524097,-38292162,294
2022-05-09 06:57:29-04:00,19943,7w76zJFb9nTPDbfC4DCscQ2F5vimT8hiivT8WkuwWYWX,5X5XNdoFZv15bmbv97VRxHgTZzKyiFZpoz7MRNkPZS6f,True,33835541,3098706,12101,6050,6051,2a35JJeTUW1pm6M3e8DHCjp8qr4vbc2cRPhuzZWyFzYd,1321425,11208686,-9887261,390
2022-05-09 06:57:32-04:00,19944,7PzGZgzieFyyFs1dbajkNQgVxooFUNZrj1bUsQvrSwbp,A2gDREmSmJTBPPw3sbKVY3smC9wbHMDdv87gr4Tr2ES7,True,250918511,62729627,188736,94368,94368,3zqXX6kzhkbW3d4TwD2CNjMRwxTbREXySekvq37kfCNk,7549476,35942974,-28393498,300
2022-05-09 06:57:33-04:00,19945,7tFD53kPTqrzjCu1Wji78gUqhoRtCUhsP1pM3DQKT7uG,BJvgPLYBDJrQJdQVowrsMwUGMurq4zTihoFwWoEokfu3,True,119149396,15125026,45622,22811,22811,Hu94aiQWvce6THeGyCFqGRPM1pQrK3ihzkcXo1EpJcJL,3594039,33568917,-29974878,301
2022-05-09 06:57:43-04:00,19946,3CTLVMSTYE6azjXhZyhPD5XiUe23aJ4pb456SQnUiohH,13q8wAZ1zte3bd3LdeKLEUY7ubu2suCNRZVrgMScpV3C,True,31764865,3019225,12316,6158,6158,8sEswn3kzEhnYjAZVvCQnHEUvYd7pFVvc2Xc2Kd1BpbC,1295765,10547420,-9251655,407
2022-05-09 06:57:45-04:00,19947,AtaNpuHGEDd7kfakJbTbpphMdQk7ZWk9iB585TtNATKx,72egdmxZyhyYsM93hTMuoDd6NeYVB7gpiJG4PWj4Qi8f,True,31548654,3111085,12377,6188,6189,68sueyVfmy5ToEGtLFGDkwebX47xAmzyXE29z8JrmcWv,1255230,10558620,-9303390,397
2022-05-09 06:57:52-04:00,19948,4gVzwxCsAebj7mjp48mP9QXo99xAVFN3629fPMPbCHpj,AVFph8w5CWcTJExejj4XB7TqsMBWPramC3CS6im2HQrg,False,2064848,2064848,60834,3041,57793,5HnvdJnCCcmRsm4GkXnYWd4q9RpwuvYDGEUMPkYR3Ts9,60834,690586,-629752,294
2022-05-09 06:57:54-04:00,19949,GdUWbwTgHF1RRbpVXCahz36G7MqYrM6QaBgnjL2eLKxk,JDYxQpYMt38mmjzLrVjgi3ezpc3DQ8YJEtJTZbG6fCCq,True,36295887,1555898,6318,3159,3159,2a35JJeTUW1pm6M3e8DHCjp8qr4vbc2cRPhuzZWyFzYd,1474104,12475196,-11001092,406
2022-05-09 06:58:00-04:00,19950,62q4KpVd3UXPomDaqpTF7recRAEh2ZKgWRgT92ztmda4,8xRdV8nWLb3CiCcHt2ZXEJv3NSfaa178zarhUkKv2rP9,True,49506027,4447611,17515,8757,8758,3zqXX6kzhkbW3d4TwD2CNjMRwxTbREXySekvq37kfCNk,1949608,15115574,-13165966,393
2022-05-09 06:58:01-04:00,19951,8T4WK27RvWVGqPuNqY6whk1fmU4vd5qaUQPZG1GJ79bh,DvSz7knS8N3K7L6JhQf1s4mJSyxB8uJXNQXtyjJn8QRL,True,256620543,62705914,191045,95522,95523,8sEswn3kzEhnYjAZVvCQnHEUvYd7pFVvc2Xc2Kd1BpbC,7818456,40963039,-33144583,304
2022-05-09 06:58:09-04:00,19952,F2AU2PjaSmHxWWhkz8XxMggkCMWbMVgawt89tSnYS6RL,ET9febRJiW197DYMaJbgk3kWsAeFv5f4peQ4vFCVppK6,True,1250281759,312570439,1929962,964981,964981,8sEswn3kzEhnYjAZVvCQnHEUvYd7pFVvc2Xc2Kd1BpbC,77198490,132393621,-55195131,617
2022-05-09 06:58:26-04:00,19953,QRNE94J8jKk3gvaSpXcHBvQARihaaomxa44Z8X1zvhh,J4e3wsNJHnifiCj8TbA2BxcCYwfa1aHks7T8nk6tKdhG,False,7500678,7500678,224300,11215,213085,C4UnXuShCvjSMgBAgVNMy1oakxCNk1et27A82fywU112,224300,2718522,-2494222,299
2022-05-09 06:58:26-04:00,19954,4YPn7VhWcrtecLaCBiVmXdmHwNmfR8qf2kzEtivmWrmK,EoEKgrmC6Xx6Ln8fWttD7wEtAkZtUbNifmv2mSHqV1Mf,True,47498951,11874737,35890,17945,17945,C4UnXuShCvjSMgBAgVNMy1oakxCNk1et27A82fywU112,1435607,7659440,-6223833,302
2022-05-09 06:58:26-04:00,19955,9eWpSyu71Z6dmx7yTh7WrbVScdrrZN14d5tfmqEGFgXt,2r89PFKSD9zmSp2Wyx4CQ75HAtmUgwhAS2oG5MuYuiV6,True,336149619,60286750,236430,118215,118215,C4UnXuShCvjSMgBAgVNMy1oakxCNk1et27A82fywU112,13183024,142783411,-129600387,392
2022-05-09 06:58:29-04:00,19956,HDJrLBSkMZ34BjJKrxYvSjhMP1z3dvZeuCAEqHFHqSn7,DXYU9k5x6T9wDCJyPn9KLLSpBgw4FFxe8zg9YsCmfLvp,True,166859537,41714884,125428,62714,62714,2a35JJeTUW1pm6M3e8DHCjp8qr4vbc2cRPhuzZWyFzYd,5017145,40074367,-35057222,300
2022-05-09 06:58:29-04:00,19957,AL8JFS4gjaQx89f9j8wtaNJgV76K8bw1ugvNtgvhgAnb,HJYvG2kGKe8kXgtZSWTWwTmSjxA3XUeCvyT7acoKtS1C,True,16149858881,4037464720,12151191,6075595,6075596,GXyFXZMNk2NFyEzw6JetVqsujqcz2yCixH7n8EpDJYWD,486047669,4396473958,-3910426289,300
2022-05-09 06:58:31-04:00,19958,3AaMzK9WAbD9m27szcJYnucnSPQ4W7tk8EztgWv4vqUo,8oUBQUKo9wHLu1tUEF1AeCUa7oRYyDSoFNRMqQAqKMbH,True,51993519,2283994,9304,4652,4652,3zqXX6kzhkbW3d4TwD2CNjMRwxTbREXySekvq37kfCNk,2118198,15753745,-13635547,407
2022-05-09 06:58:33-04:00,19959,6pUtYz474QrpATEZnfb3iFbTKYA65pNyKAo4TQZAjtqe,8dipRUXvxJiDLdHEtCPkso4vErbVwshHQiRfvSngBS9J,True,277858106,21175218,72114,36057,36057,C4UnXuShCvjSMgBAgVNMy1oakxCNk1et27A82fywU112,9462728,183803393,-174340665,340
2022-05-09 06:58:34-04:00,19960,5euvq1j9LCJWT1K7xKAE2TjwzbrWA5t6j2SxtnWsEPeU,GKDnouGNzg5JkjWG7Qs4nmka6qUMdYrk1fKwrmj8TvdH,True,51939105,2283982,9259,4629,4630,2a35JJeTUW1pm6M3e8DHCjp8qr4vbc2cRPhuzZWyFzYd,2105604,15791580,-13685976,405
2022-05-09 06:58:34-04:00,19961,8J4BZXZzkK4SmWxc2YoaJRg9ivuuXbdVe5XpEhVds1ZM,3pirVwiye9NftvMpX5F7WpfcGZy5uV3c11xCdkkZbL9D,True,351693813,87923453,265662,132831,132831,2py1FiYeL2f7J3HU36qiJz6TD6HCmiTN36RyxYtapQCZ,10626495,65729188,-55102693,302
2022-05-09 06:58:34-04:00,19962,DvSVpLMQyz91ksMwhuwwFDiKMo53FC5FVG5XrQZYWurJ,5jL2cYHg1QQpWYRCF4f378jpeHnTfPMWXiiHuhLNbzq8,True,34652932,1546805,6188,3094,3094,C4UnXuShCvjSMgBAgVNMy1oakxCNk1et27A82fywU112,1386392,11916968,-10530576,400
2022-05-09 06:58:35-04:00,19963,EkKmfEnxTscSs2BDs1mg6SyHdStC8AYTy9zihw9VWP63,DW4ujEZj4H83B9CrSfbks2pkHEj3gh2d114eo1aDh4s9,True,34713305,8678326,25549,12774,12775,Hu94aiQWvce6THeGyCFqGRPM1pQrK3ihzkcXo1EpJcJL,1021990,11808431,-10786441,294
2022-05-09 06:58:38-04:00,19964,BJUNK2orMVx6mYsD9pnQzmsEh95ZF2NWPm9KJ1ZM67Qn,FpxLa3DwWrspYvHVsScSDcscHB2eBHGxRrQ4gVvn4VW,True,66384476,16596119,48305,24152,24153,5HnvdJnCCcmRsm4GkXnYWd4q9RpwuvYDGEUMPkYR3Ts9,1932206,22532856,-20600650,291
2022-05-09 07:03:57-04:00,19965,H7rsFRRhZPe2jLex2NkbYYzVtLobvFiqnCd4BUyJVPBB,8bedwDRfSKLP9vUxoXcpHNJzWQemMaf4QGT2mtHFVJFb,True,48669778,12167444,36863,18431,18432,Hu94aiQWvce6THeGyCFqGRPM1pQrK3ihzkcXo1EpJcJL,1474551,5159273,-3684722,302
2022-05-09 07:08:48-04:00,19966,AXBfrbCpYAWKN5jgDVVMiKXscQ96YtotKV3DT6XSzm9o,Dh3SiHAqrQzPQnTLRMxtBn2EFyHNgyfnYGpgcuNGTvyL,True,39937690,9984422,60926,30463,30463,6L1WYrPiCMyi7XemPww4B4hvpKD1LQKD4RpiSKmrmgSC,2437058,22913609,-20476551,610
2022-05-09 07:10:28-04:00,19967,3zVmiyif8VbqUW7dAeEMYJYrg8r5pCeBfALsdgu6kgFJ,FwzrxNbJsiCQwqayaDhwkbm9TRG11bK6fWs5Dn75da9a,True,39884447,9971111,30160,15080,15080,68sueyVfmy5ToEGtLFGDkwebX47xAmzyXE29z8JrmcWv,1206413,18441294,-17234881,302
2022-05-09 07:15:13-04:00,19968,xj242sRBwTMF1Df9grLWe4iXm6Yw1my5iBa2byzjgzk,BMZz3sBcTxtzUwasePcpzeCS1TANz9mqdL1ufhnW7vob,True,2288027428,572006857,1713477,856738,856739,3zqXX6kzhkbW3d4TwD2CNjMRwxTbREXySekvq37kfCNk,68539092,510496254,-441957162,299
2022-05-09 07:15:24-04:00,19969,BEuVsj9KuYBTaxrLpKwrQtHxmhRtB16siNfPXsAvf6rz,BTjWitiLbteuKMzaFj1daYyM2v9rZygESDktu8cuzC8g,False,28112705,28112705,850954,42547,808407,8sEswn3kzEhnYjAZVvCQnHEUvYd7pFVvc2Xc2Kd1BpbC,850954,4305196,-3454242,302
2022-05-09 07:22:09-04:00,19970,HT2SuCbePhjNZaar24uVwihYowCNvSjdvhJ8BRSVw9nX,98Ts4LCnapHVoCJ5PW3Armvh4jvDtpfs3SYRLRxiAgzZ,True,27830458,1658449,7818,3909,3909,5HnvdJnCCcmRsm4GkXnYWd4q9RpwuvYDGEUMPkYR3Ts9,1312082,15430258,-14118176,471
2022-05-09 07:22:30-04:00,19971,7w76zJFb9nTPDbfC4DCscQ2F5vimT8hiivT8WkuwWYWX,5X5XNdoFZv15bmbv97VRxHgTZzKyiFZpoz7MRNkPZS6f,True,30653986,3033301,12113,6056,6057,2a35JJeTUW1pm6M3e8DHCjp8qr4vbc2cRPhuzZWyFzYd,1224218,10355530,-9131312,399
2022-05-09 07:22:32-04:00,19972,5rnSL1jkLDsAvWsKNrbxtBJEcavHbc41kSTWywUEmSaX,87ZzyZEPJAXq6UiTqQVNuChRQVSb7QcUJgV41saA8CFC,True,34326266,3006083,11986,5993,5993,68sueyVfmy5ToEGtLFGDkwebX47xAmzyXE29z8JrmcWv,1368786,11811907,-10443121,398
2022-05-09 07:22:39-04:00,19973,D8BtQirMEk3W9Pq29B6KkKWrwPfmsUNpwz5npx7aGMLY,J7LMZwaSoh5hbGcwee6oPsnN4ZFD7Zp3LQWkJGNUHRfJ,True,14127645,3531911,25173,12586,12587,5HnvdJnCCcmRsm4GkXnYWd4q9RpwuvYDGEUMPkYR3Ts9,1006941,9398056,-8391115,712
2022-05-09 07:22:41-04:00,19974,AtaNpuHGEDd7kfakJbTbpphMdQk7ZWk9iB585TtNATKx,72egdmxZyhyYsM93hTMuoDd6NeYVB7gpiJG4PWj4Qi8f,True,28339529,1211694,4885,2442,2443,68sueyVfmy5ToEGtLFGDkwebX47xAmzyXE29z8JrmcWv,1142622,9717545,-8574923,403
2022-05-09 07:22:41-04:00,19975,68gVM4kjmSYxT1uJW13rYSway8uVLUdcLa7sJuqHQaAf,DshroBQ3da7BcAiQpiFREsLKWbUDrBRmmZRw3Zu2Qfs9,True,68621552,17155388,50156,25078,25078,8sEswn3kzEhnYjAZVvCQnHEUvYd7pFVvc2Xc2Kd1BpbC,2006247,20104033,-18097786,292
2022-05-09 07:22:42-04:00,19976,H8P77smmiLj1vtt7hoSjf2vmcnBdW4rsgCtagtXZg6yy,3FxygrzNpSWivjLU3CumYif6rXhSzyjLqdKiyvphDnnc,True,51964050,2284552,9297,4648,4649,2a35JJeTUW1pm6M3e8DHCjp8qr4vbc2cRPhuzZWyFzYd,2114775,15786205,-13671430,406
2022-05-09 07:22:42-04:00,19977,GdUWbwTgHF1RRbpVXCahz36G7MqYrM6QaBgnjL2eLKxk,JDYxQpYMt38mmjzLrVjgi3ezpc3DQ8YJEtJTZbG6fCCq,True,34651705,1535683,6101,3050,3051,68sueyVfmy5ToEGtLFGDkwebX47xAmzyXE29z8JrmcWv,1376800,11807229,-10430429,397
2022-05-09 07:22:42-04:00,19978,BTXpvCdmYEmg5fB2Hsjc6Wked2sky4oQpGu7r8KuPau4,CaEwxQQds9f44npaSrYAsC6WpE3T6MpAGr9jgXZeqWjA,True,61701183,3502572,15236,7618,7618,3zqXX6kzhkbW3d4TwD2CNjMRwxTbREXySekvq37kfCNk,2684152,19796383,-17112231,435
2022-05-09 07:22:50-04:00,19979,HV3BVN9zLURqQBJyUFFeytFvjhhoYYJ3VXTCDYpML7Fd,ZCesJgyYoyWb3wfUP6BusxEBtVAYb2AAe94QbxVkFsb,True,35555599,8888899,26474,13237,13237,8sEswn3kzEhnYjAZVvCQnHEUvYd7pFVvc2Xc2Kd1BpbC,1058985,8687093,-7628108,297
2022-05-09 07:22:52-04:00,19980,3CTLVMSTYE6azjXhZyhPD5XiUe23aJ4pb456SQnUiohH,13q8wAZ1zte3bd3LdeKLEUY7ubu2suCNRZVrgMScpV3C,True,28668438,1421142,5969,2984,2985,6L1WYrPiCMyi7XemPww4B4hvpKD1LQKD4RpiSKmrmgSC,1204140,9802216,-8598076,420
2022-05-09 07:22:55-04:00,19981,FRbeFwhUYCiHW5oP26mad8KND7CCYDbfnoNxX7GuXVp8,GrzXKxPX2WDka8i2D8sunMUsrsThKasQi8NYLwuCGygV,True,114651132,10826427,45673,22836,22837,5HnvdJnCCcmRsm4GkXnYWd4q9RpwuvYDGEUMPkYR3Ts9,4836823,56069019,-51232196,421
2022-05-09 07:23:38-04:00,19982,8L2s5h1hSU79naWcS7cvT3oxiPL6ofTDWmqTK1S4F99g,32DYf6ArTTcNwokJrbhHT1QGe4pZ9z29oPdw97aDR7AQ,True,167433337,41858334,126616,63308,63308,68sueyVfmy5ToEGtLFGDkwebX47xAmzyXE29z8JrmcWv,5064677,157009381,-151944704,302
2022-05-09 08:07:10-04:00,19983,4oMasDRj8HWfknmdwt6Mkz3eonr8J2byoiSTRo4sCnFQ,3emcATkEFvDVETiK97eVET2Z2jzkgiiSxX3gu5wsUKPe,True,589430719,73064904,488777,244388,244389,2a35JJeTUW1pm6M3e8DHCjp8qr4vbc2cRPhuzZWyFzYd,39430824,332446403,-293015579,668
2022-05-09 08:10:13-04:00,19984,DLwEaZipqHmVBD5hc5v1NZtDStHyG4hAMwxywDTGGc2e,28GtwJw67UWfrSKxtuvpzoKzPyKXLgP3GKLm3fHdR566,True,62773548,15693387,97940,48970,48970,8sEswn3kzEhnYjAZVvCQnHEUvYd7pFVvc2Xc2Kd1BpbC,3917603,30746027,-26828424,624
2022-05-09 08:10:19-04:00,19985,4Siq98BDakELWP5BzVoEN5tcg1ywRxTYs1aUcfW8spCt,2EBXLTVz1Gk9gS5JcVqCKAP5PatFGw1Vnww65Moz3SUn,True,23662772,5915693,36639,18319,18320,2a35JJeTUW1pm6M3e8DHCjp8qr4vbc2cRPhuzZWyFzYd,1465573,13545481,-12079908,619
2022-05-09 08:10:19-04:00,19986,442usWu6XpJZvU25bqXeynRrQ15jAzWwU9DWMgHpTn3Q,CtvADKp39bjJf3cPKWNL3wxnhq273fVM4fC5DmEcg5cC,True,48582168,12145542,74515,37257,37258,8sEswn3kzEhnYjAZVvCQnHEUvYd7pFVvc2Xc2Kd1BpbC,2980637,8230382,-5249745,613
2022-05-09 08:10:19-04:00,19987,Fn6J1eMQJoA5rXCwX2HjAF86AowsJfULLuYXVfzgb8aX,6Ett2WPmz4HoWVSVEZD73UzFetd3oFSh7C676MEVYd36,True,35515956,8878989,55211,27605,27606,6L1WYrPiCMyi7XemPww4B4hvpKD1LQKD4RpiSKmrmgSC,2208445,21249838,-19041393,621
2022-05-09 08:10:41-04:00,19988,CXppCp4b4npkAzw175YNy6Ei8nF7jCmNbqsbVosHS6fE,FSEchHNYxt7WdBYjyuS2Ft2yUnfk56TCkY8SXdSs8hfe,True,37125056,9281264,57975,28987,28988,Hu94aiQWvce6THeGyCFqGRPM1pQrK3ihzkcXo1EpJcJL,2319030,26458741,-24139711,624
2022-05-09 08:11:26-04:00,19989,532MfQR1PzPn6cmC1kpZsz9MyBWSamSeieh1F6GqVY33,6sJ8XXMZzGbHjVU1vWNW8unWoBZhJa54GguYJQhcb8PA,True,1965023575,274559389,1816715,908357,908358,CGtKBgcWZ6HKE3tFNLPUM9khDv2Rc7d6BrPtxz7J1aY,130022448,322974066,-192951618,661
2022-05-09 08:13:00-04:00,19990,CpeJ8BVz8Nd6SqnM3DYejnvAYnovDwu1taCqMEBD4RRi,GMmBgzDTtes62wJTENptaWPxNY2srWCrAdWErkj22Hzj,True,28645975,1393797,5846,2923,2923,2a35JJeTUW1pm6M3e8DHCjp8qr4vbc2cRPhuzZWyFzYd,1201638,9821343,-8619705,419
2022-05-09 08:13:03-04:00,19991,4nqsW3XCJxzSsDdQzvE3zeM9nqBv8xVdUG8GxFWn6Edf,6eVvNs2rckFeTGkXZgPEGLYg4rmz3MFtoVNPRNmktcrY,True,337421605,84355401,601764,300882,300882,C4UnXuShCvjSMgBAgVNMy1oakxCNk1et27A82fywU112,24070576,68019660,-43949084,713
2022-05-09 08:19:28-04:00,19992,26wo1RqwKXrNnfgMdZEmkGhnDbURpZcp2hasB5EA5QtD,34gwTVGRrdoaBzLUG6SBwRwBovkjBjCebqVUBan6GDnB,True,735104591,183776147,1292757,646378,646379,2py1FiYeL2f7J3HU36qiJz6TD6HCmiTN36RyxYtapQCZ,51710287,546532746,-494822459,703
2022-05-09 08:19:49-04:00,19993,8sQzUoiFfBUsfVKdUjUh3xUjwnaCP1Qmw9BGwtH768ZR,8wZxijgcyRwqxiRKMMZhoREAb6iHhRGCgjgZRd5Yp6RP,True,635797893,158949473,1104141,552070,552071,3zqXX6kzhkbW3d4TwD2CNjMRwxTbREXySekvq37kfCNk,44165649,230456051,-186290402,694
2022-05-09 09:20:26-04:00,19994,BAkPsWHtpVcEGqUgKTKjwZ6d5aaUcaUhdgYxBnpSTDW2,BDwDmVaZnXh22sf8nsDtjVfgxMAswbM3PW3si3k4nbRK,True,101247045,25311761,75065,37532,37533,Hu94aiQWvce6THeGyCFqGRPM1pQrK3ihzkcXo1EpJcJL,3002611,44827040,-41824429,296
2022-05-09 09:20:26-04:00,19995,Fczxdc24Eav8xcaKRDwWMEwPEzkGyEJ7qGcXYyGZFKVz,8GqweYpec4cnpaJvueF3FGWoaz72BAzpLYXBX7tuuqEt,True,36145712,9036428,26812,13406,13406,2a35JJeTUW1pm6M3e8DHCjp8qr4vbc2cRPhuzZWyFzYd,1072517,27241574,-26169057,296
2022-05-09 09:20:27-04:00,19996,F47ihi3LtNYspD1tkQhind1ce8udZ628Ye1NuDBd3Me1,HqzXiTisYpcPHCAMvceUL8WSrzEX38TuGkzPaGJSdAHm,True,38536258,9634064,28398,14199,14199,2a35JJeTUW1pm6M3e8DHCjp8qr4vbc2cRPhuzZWyFzYd,1135959,10061777,-8925818,294
2022-05-09 09:20:27-04:00,19997,4rVW5SPBGcoxE3wAnjbULgZm4xdHXtqhivrszp9W4YP7,Fzu9D4KRKhAF7p22sNqMybe11zGwuXVe58iSt32MbfYX,True,89459038,22364759,66702,33351,33351,Hu94aiQWvce6THeGyCFqGRPM1pQrK3ihzkcXo1EpJcJL,2668116,26459243,-23791127,298
2022-05-09 09:20:27-04:00,19998,CMVVfXQYALSc58NLD67L8YrJAbDHZ9rFZvYQC7r8Png4,44pytMX14zaEQv6aRQ223CxYB2uTP7VUTQfUY58EkaNB,True,110497206,27624301,82242,41121,41121,Hu94aiQWvce6THeGyCFqGRPM1pQrK3ihzkcXo1EpJcJL,3289680,51229248,-47939568,297
2022-05-09 09:20:30-04:00,19999,FU3fRyQxk6rwtD9Db1nTvTAjSwgSW9vi1q7SjZ92ijyM,7c3maBK3hpb1exxqcvnwiUfhhUBgLgCs5exANSZ7m494,True,142512011,35628002,107710,53855,53855,2a35JJeTUW1pm6M3e8DHCjp8qr4vbc2cRPhuzZWyFzYd,4308400,19928882,-15620482,302
2022-05-09 09:20:30-04:00,20000,Eps7NSYQhiSzaTpTLzx5aoDykXSKtQ6w1JBFuucC8hQp,EeNkTwr26mYEBqYHqoHaBZfybPS2PwcbJsgmQGJY6g89,False,32898840,32898840,995833,49791,946042,8sEswn3kzEhnYjAZVvCQnHEUvYd7pFVvc2Xc2Kd1BpbC,995833,15182653,-14186820,302
2022-05-09 09:20:51-04:00,20001,Ejg8vXVsro4jB2fpdUUXCRfKTiE5TUwfRXhHeR8qtrEi,GnF7xwsjzso48ZEAdYYuxNkJso7ug3s46uogi4XDbs1,True,344431247,86107811,260561,130280,130281,2a35JJeTUW1pm6M3e8DHCjp8qr4vbc2cRPhuzZWyFzYd,10422476,88620996,-78198520,302
2022-05-09 09:21:05-04:00,20002,A7j77tzgnQVGtHTa65VtVZqJRYeJvQk7am8NW6e66379,4vJGwEvXU2tGWoWWGwbsYcfKQAMCHbrBMRk4ZVFzneLs,True,367761001,91940250,273798,136899,136899,68sueyVfmy5ToEGtLFGDkwebX47xAmzyXE29z8JrmcWv,10951937,118452015,-107500078,297
2022-05-09 09:21:05-04:00,20003,62q4KpVd3UXPomDaqpTF7recRAEh2ZKgWRgT92ztmda4,8xRdV8nWLb3CiCcHt2ZXEJv3NSfaa178zarhUkKv2rP9,True,44961497,4254048,17276,8638,8638,5HnvdJnCCcmRsm4GkXnYWd4q9RpwuvYDGEUMPkYR3Ts9,1825924,14286419,-12460495,406
2022-05-09 09:21:09-04:00,20004,2tPYXtNrw134ACVhkYdnG9FGT4iHm61PuX8L7AfG9aAT,EyyPLVdjgewzVDKePQUj85BBttWy4MixVr9CSD8JVbrP,True,353919166,88479791,264763,132381,132382,Hu94aiQWvce6THeGyCFqGRPM1pQrK3ihzkcXo1EpJcJL,10590522,162874058,-152283536,299
2022-05-09 09:21:18-04:00,20005,5euvq1j9LCJWT1K7xKAE2TjwzbrWA5t6j2SxtnWsEPeU,GKDnouGNzg5JkjWG7Qs4nmka6qUMdYrk1fKwrmj8TvdH,True,49538348,4448957,17689,8844,8845,8sEswn3kzEhnYjAZVvCQnHEUvYd7pFVvc2Xc2Kd1BpbC,1969727,15103328,-13133601,397
2022-05-09 09:21:18-04:00,20006,HT2SuCbePhjNZaar24uVwihYowCNvSjdvhJ8BRSVw9nX,98Ts4LCnapHVoCJ5PW3Armvh4jvDtpfs3SYRLRxiAgzZ,True,26063560,3756490,17117,8558,8559,5HnvdJnCCcmRsm4GkXnYWd4q9RpwuvYDGEUMPkYR3Ts9,1187667,15281744,-14094077,455
2022-05-09 09:21:22-04:00,20007,GMpoV2jRyLdf2V3Gb5TQZ5gEs5ftMjD3JhFUzkA6fWVz,5bi814d5gdToTLVWCmbdB6J15kMdsTQk74cZTRd62p81,True,184411075,46102768,328693,164346,164347,8sEswn3kzEhnYjAZVvCQnHEUvYd7pFVvc2Xc2Kd1BpbC,13147751,67062467,-53914716,712
2022-05-09 09:21:26-04:00,20008,3AaMzK9WAbD9m27szcJYnucnSPQ4W7tk8EztgWv4vqUo,8oUBQUKo9wHLu1tUEF1AeCUa7oRYyDSoFNRMqQAqKMbH,True,49575584,4454644,17657,8828,8829,2a35JJeTUW1pm6M3e8DHCjp8qr4vbc2cRPhuzZWyFzYd,1965104,15065453,-13100349,396
2022-05-09 09:21:26-04:00,20009,FSonJL6JzKgaZG6C3qp7H8UQYrfWRsuDmbHkrwTHZgYd,6kZCMcaUrPmPQafMUSivWavmDwEmVdvF7N7hyRXb34bw,True,92233955,23058488,68797,34398,34399,2a35JJeTUW1pm6M3e8DHCjp8qr4vbc2cRPhuzZWyFzYd,2751903,20496181,-17744278,298
2022-05-09 09:21:30-04:00,20010,7qEVqFr1naSPCDV9q3xx6KMZn1yCHvkHZJkaA46NLmSE,8Mohcixq2L9PYrHpb95vuEsXqJ18JhEHi3RA83VM9cLv,True,91585826,22896456,68707,34353,34354,2a35JJeTUW1pm6M3e8DHCjp8qr4vbc2cRPhuzZWyFzYd,2748303,34845005,-32096702,300
2022-05-09 09:21:31-04:00,20011,5rnSL1jkLDsAvWsKNrbxtBJEcavHbc41kSTWywUEmSaX,87ZzyZEPJAXq6UiTqQVNuChRQVSb7QcUJgV41saA8CFC,True,31246185,2987214,12222,6111,6111,6L1WYrPiCMyi7XemPww4B4hvpKD1LQKD4RpiSKmrmgSC,1278489,11051690,-9773201,409
2022-05-09 09:22:09-04:00,20012,CpeJ8BVz8Nd6SqnM3DYejnvAYnovDwu1taCqMEBD4RRi,GMmBgzDTtes62wJTENptaWPxNY2srWCrAdWErkj22Hzj,True,27168435,1199067,4898,2449,2449,68sueyVfmy5ToEGtLFGDkwebX47xAmzyXE29z8JrmcWv,1109960,9097830,-7987870,408
2022-05-09 09:22:11-04:00,20013,H8P77smmiLj1vtt7hoSjf2vmcnBdW4rsgCtagtXZg6yy,3FxygrzNpSWivjLU3CumYif6rXhSzyjLqdKiyvphDnnc,True,49553716,4448534,17712,8856,8856,5HnvdJnCCcmRsm4GkXnYWd4q9RpwuvYDGEUMPkYR3Ts9,1973083,15101407,-13128324,398
2022-05-09 09:22:18-04:00,20014,Eo5LYLiUCspbrK13ker5skq9kMjnpUJEJPSbRDWjH6V4,GefeNAw5BdDkibatZknZVGsLhkfc8wfxriEfjHNpvMPm,True,6039016356,1509754089,4492893,2246446,2246447,6UQfSsLooL4pQKQfLtXCutQS2BnF7A7F7ewJopDLmUpc,179715726,1732851788,-1553136062,297
2022-05-09 09:22:19-04:00,20015,66wPLMYSaijGnKqyVVNNjzQJs8XZRhWbZjXJw24AqWWN,DgeG5GFqiGQKEQhRPVrQB6nLiUk4JVVk2W8ky2CoDosD,False,8045811,8045811,239085,11954,227131,Hu94aiQWvce6THeGyCFqGRPM1pQrK3ihzkcXo1EpJcJL,239085,4688174,-4449089,297
2022-05-09 09:22:31-04:00,20016,62q4KpVd3UXPomDaqpTF7recRAEh2ZKgWRgT92ztmda4,8xRdV8nWLb3CiCcHt2ZXEJv3NSfaa178zarhUkKv2rP9,True,40587745,1935977,8055,4027,4028,2a35JJeTUW1pm6M3e8DHCjp8qr4vbc2cRPhuzZWyFzYd,1688944,13273185,-11584241,416
2022-05-09 09:22:31-04:00,20017,3CTLVMSTYE6azjXhZyhPD5XiUe23aJ4pb456SQnUiohH,13q8wAZ1zte3bd3LdeKLEUY7ubu2suCNRZVrgMScpV3C,True,27165421,1203311,4926,2463,2463,2a35JJeTUW1pm6M3e8DHCjp8qr4vbc2cRPhuzZWyFzYd,1112179,9103896,-7991717,409
2022-05-09 09:25:26-04:00,20018,3RpbaFEL5ZYrQBPpaAeCUXs43Ssdr5Tm4ScMGtp6XbYF,CpKGwcVZrd3vKTNhdF8xNsd77FT3QxQWb7xFQxiyPB5p,True,897091902,224272975,1326877,663438,663439,gjBMZYVujDjD1ECG4i97M8Q3gV9ESnwwTSUGropkusj,53075106,446863215,-393788109,591
2022-05-09 09:26:00-04:00,20019,D5VZNThkv6XD6bimPshD2J3PvbPXgCbivZuPfkVxgdjc,8C77LmMk4C3KvyEb1N3scdbAgwN7J45nAcv9tkL5namB,True,165817718,41454429,252283,126141,126142,Hu94aiQWvce6THeGyCFqGRPM1pQrK3ihzkcXo1EpJcJL,10091324,83190257,-73098933,608
2022-05-09 09:29:15-04:00,20020,EVMrznfJS54BZiywDD2WhUtxzicDtbEpm2a5yLrtCgRF,CpzsMYVYvKg8ihrX1cKRw7TDEYwD3kAyiX92hsf2KiTz,True,343091946,47710995,211582,105791,105791,8sEswn3kzEhnYjAZVvCQnHEUvYd7pFVvc2Xc2Kd1BpbC,15214978,231418101,-216203123,443
2022-05-09 09:29:15-04:00,20021,DRVtEzZs9u9ysrcANZLEjrvbuuGqYn77v2h4cDFKuNUx,Fv9qiMZhuSBL2cs9AWUYbDLQjB46W2ZwrhxaNXtPLDpC,True,8493508043,2123377010,6390018,3195009,3195009,8sEswn3kzEhnYjAZVvCQnHEUvYd7pFVvc2Xc2Kd1BpbC,255600722,758956782,-503356060,300
2022-05-09 09:29:23-04:00,20022,26wo1RqwKXrNnfgMdZEmkGhnDbURpZcp2hasB5EA5QtD,34gwTVGRrdoaBzLUG6SBwRwBovkjBjCebqVUBan6GDnB,True,538421126,134605281,938203,469101,469102,5HnvdJnCCcmRsm4GkXnYWd4q9RpwuvYDGEUMPkYR3Ts9,37528127,421617254,-384089127,697
2022-05-09 09:29:52-04:00,20023,DHfy6B2AYsqMCxPLBCXMDfQn3Gr2VwJaLFHUZKqpCjsb,EPZpYaY1gCAb8pMtri5veRowBmCrCpTHBMa3Rmgt6S29,False,25817741,25817741,767502,38375,729127,68sueyVfmy5ToEGtLFGDkwebX47xAmzyXE29z8JrmcWv,767502,4713227,-3945725,297
2022-05-09 09:29:53-04:00,20024,7tFD53kPTqrzjCu1Wji78gUqhoRtCUhsP1pM3DQKT7uG,BJvgPLYBDJrQJdQVowrsMwUGMurq4zTihoFwWoEokfu3,True,103599379,14664341,44103,22051,22052,68sueyVfmy5ToEGtLFGDkwebX47xAmzyXE29z8JrmcWv,3115836,29135791,-26019955,300
2022-05-09 09:29:55-04:00,20025,3Xbsek5MsEGoWr3G9yhuohREr26B2vSQcjqXdspTFHta,2rPxkUiMo9wGDq8EvAiwY3ngRpKmL223cBWWNTYoBmFp,True,347495891,86873972,262978,131489,131489,8sEswn3kzEhnYjAZVvCQnHEUvYd7pFVvc2Xc2Kd1BpbC,10519124,40330215,-29811091,302
2022-05-09 09:29:55-04:00,20026,HT2SuCbePhjNZaar24uVwihYowCNvSjdvhJ8BRSVw9nX,98Ts4LCnapHVoCJ5PW3Armvh4jvDtpfs3SYRLRxiAgzZ,True,22206749,1506116,7258,3629,3629,68sueyVfmy5ToEGtLFGDkwebX47xAmzyXE29z8JrmcWv,1070229,12831408,-11761179,481
2022-05-09 09:29:58-04:00,20027,6d6HN8LWikwW2HYdy3BABWuxKHt1sgv4DcneACR133sE,4eKvzmfFvX96XbujKBhUauAvWP4yQYwZH3pd7gXzbCvJ,False,27626858,27626858,835476,41773,793703,Hu94aiQWvce6THeGyCFqGRPM1pQrK3ihzkcXo1EpJcJL,835476,9246131,-8410655,302
2022-05-09 09:29:58-04:00,20028,5euvq1j9LCJWT1K7xKAE2TjwzbrWA5t6j2SxtnWsEPeU,GKDnouGNzg5JkjWG7Qs4nmka6qUMdYrk1fKwrmj8TvdH,True,44969866,4257880,17350,8675,8675,5HnvdJnCCcmRsm4GkXnYWd4q9RpwuvYDGEUMPkYR3Ts9,1832513,14284599,-12452086,407
2022-05-09 10:30:25-04:00,20029,C8EuUJigyRy2ojSuZtDSnc4JxmVqoe5XTr4xaPPmKsyV,6PrUiT94hGcBm2AvkmkrnRnjXkR8WxmtJcvSapde3J1P,False,30967837,30967837,935414,46770,888644,6L1WYrPiCMyi7XemPww4B4hvpKD1LQKD4RpiSKmrmgSC,935414,71146461,-70211047,302
2022-05-09 10:30:25-04:00,20030,FuhTkUxSaJ7kvuu9LHZaPVfdbKAQSh9W8Zzso1XPKGZp,FLoqPzREreKfRCwqtXs3CJwpTSudmXrVYCRZadWvob7j,False,31249863,31249863,944033,47201,896832,8sEswn3kzEhnYjAZVvCQnHEUvYd7pFVvc2Xc2Kd1BpbC,944033,15374366,-14430333,302
2022-05-09 10:30:27-04:00,20031,5xkW7wHTcF5WadNtBBqKPKctVwyQtTqqscivAmxzseCk,7m31ZMZdCn5Gz2q5sETWA7uKA5LsKD7pJHBBqU3g7tCn,True,503596101,125899025,377314,188657,188657,Hu94aiQWvce6THeGyCFqGRPM1pQrK3ihzkcXo1EpJcJL,15092582,83278853,-68186271,299
2022-05-09 10:30:27-04:00,20032,26pvf6YygxQ8CdL4h4PcMuYNQtFbUVisTsYaFB3EZXvd,9tVSyevo14cUe2NMoBteqgV7vw44m6ooz2rD9ricKh55,True,50352219,12588054,37229,18614,18615,8sEswn3kzEhnYjAZVvCQnHEUvYd7pFVvc2Xc2Kd1BpbC,1489170,24142481,-22653311,295
2022-05-09 10:30:28-04:00,20033,DAawvqmcjnThXxJzsp7ExW1bhGaRGRxLgG6h85HpGAN5,2KRCBiCQoQd2fDSS1e2U19WVddWAqM6EPkqK8rZwaRNh,True,51783787,12945946,38382,19191,19191,Hu94aiQWvce6THeGyCFqGRPM1pQrK3ihzkcXo1EpJcJL,1535281,59709063,-58173782,296
2022-05-09 10:32:23-04:00,20034,EHi1UBG8wMUFZECktsFUZkGjJPaBNEedswS62hyYn6jC,Drx9ErQhAjnPuJ83LPYFnY5ZV5XDzGuXDuSf16VqWayp,True,404740839,22080110,81735,40867,40868,3zqXX6kzhkbW3d4TwD2CNjMRwxTbREXySekvq37kfCNk,14982603,277797469,-262814866,370
2022-05-09 10:32:23-04:00,20035,H7rsFRRhZPe2jLex2NkbYYzVtLobvFiqnCd4BUyJVPBB,8bedwDRfSKLP9vUxoXcpHNJzWQemMaf4QGT2mtHFVJFb,True,36119506,9029876,26254,13127,13127,8sEswn3kzEhnYjAZVvCQnHEUvYd7pFVvc2Xc2Kd1BpbC,1050179,4196572,-3146393,290
2022-05-09 10:32:23-04:00,20036,3zVmiyif8VbqUW7dAeEMYJYrg8r5pCeBfALsdgu6kgFJ,FwzrxNbJsiCQwqayaDhwkbm9TRG11bK6fWs5Dn75da9a,False,29610144,29610144,869223,43461,825762,2a35JJeTUW1pm6M3e8DHCjp8qr4vbc2cRPhuzZWyFzYd,869223,14098597,-13229374,293
2022-05-09 10:32:24-04:00,20037,HXQXfEQe7aCpr6WKh37XaDZsjZcuQPk5t8tWNFgEoK6U,5ufXkCEDwgiXwtyPye4wYVVA3oLW54JVzz4tnXFofto4,True,340748161,85187040,255125,127562,127563,Hu94aiQWvce6THeGyCFqGRPM1pQrK3ihzkcXo1EpJcJL,10205007,163260627,-153055620,299
2022-05-09 10:32:28-04:00,20038,8L2s5h1hSU79naWcS7cvT3oxiPL6ofTDWmqTK1S4F99g,32DYf6ArTTcNwokJrbhHT1QGe4pZ9z29oPdw97aDR7AQ,True,124416597,31104149,94088,47044,47044,C4UnXuShCvjSMgBAgVNMy1oakxCNk1et27A82fywU112,3763528,118880945,-115117417,302
2022-05-09 10:32:52-04:00,20039,3AaMzK9WAbD9m27szcJYnucnSPQ4W7tk8EztgWv4vqUo,8oUBQUKo9wHLu1tUEF1AeCUa7oRYyDSoFNRMqQAqKMbH,True,45013765,4247615,17338,8669,8669,8sEswn3kzEhnYjAZVvCQnHEUvYd7pFVvc2Xc2Kd1BpbC,1837447,14249612,-12412165,408
2022-05-09 10:38:22-04:00,20040,57UJpBg8pjTxWp9LVwVGjCDm9zgYnzs4ru49BdZrG62a,Dor96mgsM5EroCmZUAnuDPiAiLn7nNgGeZDbwHxpHxzw,True,47527954,11881988,35374,17687,17687,68sueyVfmy5ToEGtLFGDkwebX47xAmzyXE29z8JrmcWv,1414998,7767044,-6352046,297
2022-05-09 10:38:25-04:00,20041,7cGERqGwiV7e3MTM5KZNB71raK66QTZP81FyszsXZTy1,E75WGPAqdbVRnKkoWwbNNmMiVJQkFS2BaTMhSThBnma8,False,5168543,5168543,148609,7430,141179,3zqXX6kzhkbW3d4TwD2CNjMRwxTbREXySekvq37kfCNk,148609,2979258,-2830649,287
2022-05-09 10:38:25-04:00,20042,8nQCnDq6v2Fqe9v3qkHhHW3UQjd3Cg1iZJJBbkfnrjYz,FtCPxNE1WQajWJi48Hy3nqh9W1NQSkZPAz5hetsaam6t,False,6463185,6463185,187776,9388,178388,5HnvdJnCCcmRsm4GkXnYWd4q9RpwuvYDGEUMPkYR3Ts9,187776,3723581,-3535805,290
2022-05-09 10:38:29-04:00,20043,FncFHJooh1hy9Gc2y5sKdcYkZ5uHzsxHG4vHT9cVZGcK,BkFa4b5Jyv4ZJCCpwDYv355ezVFiZfAtn18AV7kstd2v,True,87140170,21785042,62622,31311,31311,68sueyVfmy5ToEGtLFGDkwebX47xAmzyXE29z8JrmcWv,2504902,20705189,-18200287,287
2022-05-09 10:39:32-04:00,20044,4oMasDRj8HWfknmdwt6Mkz3eonr8J2byoiSTRo4sCnFQ,3emcATkEFvDVETiK97eVET2Z2jzkgiiSxX3gu5wsUKPe,True,510573536,74249422,481228,240614,240614,2a35JJeTUW1pm6M3e8DHCjp8qr4vbc2cRPhuzZWyFzYd,33091482,296334835,-263243353,648
2022-05-09 10:39:33-04:00,20045,D8BtQirMEk3W9Pq29B6KkKWrwPfmsUNpwz5npx7aGMLY,J7LMZwaSoh5hbGcwee6oPsnN4ZFD7Zp3LQWkJGNUHRfJ,False,10338378,10338378,722851,36142,686709,8sEswn3kzEhnYjAZVvCQnHEUvYd7pFVvc2Xc2Kd1BpbC,722851,7273575,-6550724,699
2022-05-09 10:39:49-04:00,20046,532MfQR1PzPn6cmC1kpZsz9MyBWSamSeieh1F6GqVY33,6sJ8XXMZzGbHjVU1vWNW8unWoBZhJa54GguYJQhcb8PA,True,1674319207,211634367,1414038,707019,707019,68sueyVfmy5ToEGtLFGDkwebX47xAmzyXE29z8JrmcWv,111869927,286486124,-174616197,668
2022-05-09 10:39:54-04:00,20047,6wGzqSWYjB1nukhDwLdgXDzMNSeasuRur3FVZAkVF4pM,HTcJjvQNFJQEewRf8iCcsZgFcfHoUXzpbb7WscqdK4kS,True,58660066,14665016,89405,44702,44703,6L1WYrPiCMyi7XemPww4B4hvpKD1LQKD4RpiSKmrmgSC,3576215,17352378,-13776163,609
2022-05-09 10:40:04-04:00,20048,GcwFXxcxRF2xwbgFbQZoYEDreimd3J3UJ9sPfuwYVKtS,7uXjmKS8RxP2qSS7ataBH5hkfpgsFcpSBWUEBuV5zgyZ,True,93534860,23383715,70824,35412,35412,8sEswn3kzEhnYjAZVvCQnHEUvYd7pFVvc2Xc2Kd1BpbC,2832976,27769482,-24936506,302
2022-05-09 10:40:07-04:00,20049,CpeJ8BVz8Nd6SqnM3DYejnvAYnovDwu1taCqMEBD4RRi,GMmBgzDTtes62wJTENptaWPxNY2srWCrAdWErkj22Hzj,True,25897402,2267869,9032,4516,4516,8sEswn3kzEhnYjAZVvCQnHEUvYd7pFVvc2Xc2Kd1BpbC,1031519,8708387,-7676868,398
2022-05-09 10:40:07-04:00,20050,6pUtYz474QrpATEZnfb3iFbTKYA65pNyKAo4TQZAjtqe,8dipRUXvxJiDLdHEtCPkso4vErbVwshHQiRfvSngBS9J,True,256282233,20087422,70133,35066,35067,6L1WYrPiCMyi7XemPww4B4hvpKD1LQKD4RpiSKmrmgSC,8947926,177284003,-168336077,349
2022-05-09 10:40:08-04:00,20051,H8P77smmiLj1vtt7hoSjf2vmcnBdW4rsgCtagtXZg6yy,3FxygrzNpSWivjLU3CumYif6rXhSzyjLqdKiyvphDnnc,True,44986227,4241891,17289,8644,8645,5HnvdJnCCcmRsm4GkXnYWd4q9RpwuvYDGEUMPkYR3Ts9,1833591,14279401,-12445810,407
2022-05-09 10:40:11-04:00,20052,5rnSL1jkLDsAvWsKNrbxtBJEcavHbc41kSTWywUEmSaX,87ZzyZEPJAXq6UiTqQVNuChRQVSb7QcUJgV41saA8CFC,True,28165192,1381536,5741,2870,2871,C4UnXuShCvjSMgBAgVNMy1oakxCNk1et27A82fywU112,1170593,10274787,-9104194,415
2022-05-09 10:40:14-04:00,20053,7zuFEyLQFHkAjm3mAuxN42VenwF6fZcqM81mmR8sBnmY,CSnQxjc4Jn8iP4JSxj5wsrvxGsLoAYQn1bKC8naY7YZP,True,5986170259,1496542564,4480454,2240227,2240227,72XWPCtRYEDZbddP7d6dHtUBRRDLSJsB2xZTAfefoEVZ,179218181,529212582,-349994401,299
2022-05-09 10:40:14-04:00,20054,Bu65ba81oA2rZqxGAsctgz39NPPJqbXR3SvdMX5KQfTK,DcxNLDe2GwGiQPtQhzMiUjrMaqXjuyx1EGgX3xPtE98T,True,39409548,9852387,29641,14820,14821,2a35JJeTUW1pm6M3e8DHCjp8qr4vbc2cRPhuzZWyFzYd,1185660,11827848,-10642188,300
2022-05-09 10:40:16-04:00,20055,4KMzwWHPeW51cxu4nMpbqCaqo96dMqaHWyRCGQktfQfd,F7q4GNYcbnZa8dJ4qovQwjmxpKpdEmdxQMXRPb9nQupa,False,3969052,3969052,118848,5942,112906,Hu94aiQWvce6THeGyCFqGRPM1pQrK3ihzkcXo1EpJcJL,118849,1588368,-1469519,299
2022-05-09 10:40:18-04:00,20056,Aog11AwpgWF7UgvLLJbV5kn3UrJURYQUhnBFnAFSqbp8,2WXYGpuib3fK3BCXDQVQsoktEnASPuZfcnmC2AZ7KTQK,True,88000108,22000027,66118,33059,33059,5HnvdJnCCcmRsm4GkXnYWd4q9RpwuvYDGEUMPkYR3Ts9,2644747,19797590,-17152843,300
2022-05-09 10:40:35-04:00,20057,cXqFkCF4gaT9vAcZYMgwLXmmuD5w4hwgxT8YXE8JuBw,5Wtf4ZBL6R1afLeC4WfhFGkfi42TagtNAg6EZWn7gKhg,True,58272289,14568072,44004,22002,22002,Hu94aiQWvce6THeGyCFqGRPM1pQrK3ihzkcXo1EpJcJL,1760193,18568242,-16808049,302
2022-05-09 10:40:48-04:00,20058,H9pFRayNBHTAhsbtGyfs1XXUWGxAbw7SgpT1xdrSRWEY,9LNreyXuhgyLCDYViNyA1jUw6h1nv4GmDtTYMoUQBqCG,True,3481832333,493602841,1495584,747792,747792,68sueyVfmy5ToEGtLFGDkwebX47xAmzyXE29z8JrmcWv,105497283,1471568363,-1366071080,302
2022-05-09 10:41:00-04:00,20059,DMACzuFBuj2vGqxZ3FV7QAo24jMV3EHKL8MrDrGbRkaJ,EnLfmDVW4ba2uqZKhj3X1TFnx8AHv7xwSWrMbVBYwcu9,False,26966756,26966756,814908,40745,774163,5HnvdJnCCcmRsm4GkXnYWd4q9RpwuvYDGEUMPkYR3Ts9,814908,4875275,-4060367,302
2022-05-09 10:53:04-04:00,20060,2BtRzBie97hsFBLgu4X4dTGCtv8We7npaXM9MmcqdWvf,C2hEQdUE3nFGJB3e6pHx8JZguZfdW9FYDHi9PGXkakm,True,491690548,85396715,258216,129108,129108,A9TwRM1BMxqb8DCC7YNAMV6zPenEJm3HTZBy7wJKK58U,14867398,73213155,-58345757,302
2022-05-09 10:55:46-04:00,20061,djW9rVm1v4nW64QiVqgFUCRza24VqthDcSfVEyRHPed,EsXvQmXVXECqZPtmSdiuwieHPP5jsmyn67p78vHaJcqq,True,83502322,20875580,63154,31577,31577,5HnvdJnCCcmRsm4GkXnYWd4q9RpwuvYDGEUMPkYR3Ts9,2526184,12153482,-9627298,302
2022-05-09 10:55:54-04:00,20062,B7235jQd2oUYooVva8FoqrbCAbcnZS1kfaAfATNBgADN,B6dRkkWvQrBpiaVnMJC4yniaNvxHfCcynjehdRP7eH1m,True,431523977,68947786,206701,103350,103351,68sueyVfmy5ToEGtLFGDkwebX47xAmzyXE29z8JrmcWv,12936863,41664225,-28727362,299
2022-05-09 10:55:56-04:00,20063,GtDk7DkAB2jvQynR57z8mjg6UoaTqYDr8Z4wsFX6KGSr,tAPvp4fscJZySZUVG2GZWZwSRVhfnNvkjCC6ZvmxqDQ,True,116885604,29221401,87102,43551,43551,Hu94aiQWvce6THeGyCFqGRPM1pQrK3ihzkcXo1EpJcJL,3484110,20623896,-17139786,298
2022-05-09 10:55:58-04:00,20064,agiVhhsNiMPzMaNWTHKRZ435HtBjqQvRuReKkpG32pn,HgcU2oCotYPxvGY6M21SbdqhzXJmNPDWEiTCDu4rA5dB,False,31097480,31097480,913743,45687,868056,C4UnXuShCvjSMgBAgVNMy1oakxCNk1et27A82fywU112,913743,12048972,-11135229,293
2022-05-09 10:56:21-04:00,20065,EyNCsqWu8zLyuRnXSbzJWnWZg7ZLjb4oJSZFdDSkbXmT,6rMMMkZibUHXYs8hXY3FmG4rgBx6gWDRGJwR2bP2t6ZD,True,37139768576,8374943461,27814633,13907316,13907317,CGtKBgcWZ6HKE3tFNLPUM9khDv2Rc7d6BrPtxz7J1aY,1233475879,7392900741,-6159424862,332
2022-05-09 10:56:21-04:00,20066,EEQmHFk3WFNmPfe7ujtP1PK6P5yqV5mmWumNSoTu45P8,FG9DScQDQPrgcmBbRugZ5NfhSTRMnKSWLxcUeTF9MgJZ,True,207451786,51862946,151491,75745,75746,8sEswn3kzEhnYjAZVvCQnHEUvYd7pFVvc2Xc2Kd1BpbC,6059649,36735323,-30675674,292
2022-05-09 10:56:21-04:00,20067,7PzGZgzieFyyFs1dbajkNQgVxooFUNZrj1bUsQvrSwbp,A2gDREmSmJTBPPw3sbKVY3smC9wbHMDdv87gr4Tr2ES7,True,186445303,46611325,140180,70090,70090,8sEswn3kzEhnYjAZVvCQnHEUvYd7pFVvc2Xc2Kd1BpbC,5607204,28646812,-23039608,300
2022-05-09 10:56:38-04:00,20068,7w76zJFb9nTPDbfC4DCscQ2F5vimT8hiivT8WkuwWYWX,5X5XNdoFZv15bmbv97VRxHgTZzKyiFZpoz7MRNkPZS6f,True,27539574,1160926,4743,2371,2372,Hu94aiQWvce6THeGyCFqGRPM1pQrK3ihzkcXo1EpJcJL,1125341,9621052,-8495711,408
2022-05-09 10:56:38-04:00,20069,AtaNpuHGEDd7kfakJbTbpphMdQk7ZWk9iB585TtNATKx,72egdmxZyhyYsM93hTMuoDd6NeYVB7gpiJG4PWj4Qi8f,True,27077032,2401569,9596,4798,4798,2a35JJeTUW1pm6M3e8DHCjp8qr4vbc2cRPhuzZWyFzYd,1081965,9258247,-8176282,399
2022-05-09 10:56:38-04:00,20070,DvSVpLMQyz91ksMwhuwwFDiKMo53FC5FVG5XrQZYWurJ,5jL2cYHg1QQpWYRCF4f378jpeHnTfPMWXiiHuhLNbzq8,True,33022830,3046243,11886,5943,5943,68sueyVfmy5ToEGtLFGDkwebX47xAmzyXE29z8JrmcWv,1288555,11233283,-9944728,390
2022-05-09 11:00:47-04:00,20071,4iCuPKeTUGU5NX1svHMm7z7kt4YdEeJmUTnwN95acfkP,3UQYJzipqQvXYNGhHrT8KJtU9QZZe7u7gW8xaaAnPGJx,True,523410702,92194900,275331,137665,137666,2py1FiYeL2f7J3HU36qiJz6TD6HCmiTN36RyxYtapQCZ,15631189,91869557,-76238368,298
2022-05-09 11:19:55-04:00,20072,8sQzUoiFfBUsfVKdUjUh3xUjwnaCP1Qmw9BGwtH768ZR,8wZxijgcyRwqxiRKMMZhoREAb6iHhRGCgjgZRd5Yp6RP,True,467182717,116795679,832773,416386,416387,8sEswn3kzEhnYjAZVvCQnHEUvYd7pFVvc2Xc2Kd1BpbC,33310922,182746077,-149435155,713
2022-05-09 11:20:24-04:00,20073,4oMasDRj8HWfknmdwt6Mkz3eonr8J2byoiSTRo4sCnFQ,3emcATkEFvDVETiK97eVET2Z2jzkgiiSxX3gu5wsUKPe,True,432594983,52804540,352204,176102,176102,Hu94aiQWvce6THeGyCFqGRPM1pQrK3ihzkcXo1EpJcJL,28853925,258107237,-229253312,666
2022-05-09 11:22:36-04:00,20074,HbJxpWkhz7Vn2iKtjtgWAuN6f2vQC38JJnTQGEFNDvxQ,HgchxTa4ji58Tw3XB5MH2WtnqcnrhocgLpPsfCQemfDf,True,468387452,82504359,245222,122611,122611,Hu94aiQWvce6THeGyCFqGRPM1pQrK3ihzkcXo1EpJcJL,13921613,82441894,-68520281,297
2022-05-09 11:22:40-04:00,20075,8T4WK27RvWVGqPuNqY6whk1fmU4vd5qaUQPZG1GJ79bh,DvSz7knS8N3K7L6JhQf1s4mJSyxB8uJXNQXtyjJn8QRL,True,192283833,46614162,144933,72466,72467,2a35JJeTUW1pm6M3e8DHCjp8qr4vbc2cRPhuzZWyFzYd,5978526,33769440,-27790914,310
2022-05-09 11:22:41-04:00,20076,3CTLVMSTYE6azjXhZyhPD5XiUe23aJ4pb456SQnUiohH,13q8wAZ1zte3bd3LdeKLEUY7ubu2suCNRZVrgMScpV3C,True,25890347,2274794,9070,4535,4535,8sEswn3kzEhnYjAZVvCQnHEUvYd7pFVvc2Xc2Kd1BpbC,1032339,8716893,-7684554,398
2022-05-09 11:22:50-04:00,20077,7tFD53kPTqrzjCu1Wji78gUqhoRtCUhsP1pM3DQKT7uG,BJvgPLYBDJrQJdQVowrsMwUGMurq4zTihoFwWoEokfu3,True,88549671,11254588,34064,17032,17032,Hu94aiQWvce6THeGyCFqGRPM1pQrK3ihzkcXo1EpJcJL,2680151,25973785,-23293634,302
2022-05-09 11:23:00-04:00,20078,62q4KpVd3UXPomDaqpTF7recRAEh2ZKgWRgT92ztmda4,8xRdV8nWLb3CiCcHt2ZXEJv3NSfaa178zarhUkKv2rP9,True,38548138,1727673,7045,3522,3523,Hu94aiQWvce6THeGyCFqGRPM1pQrK3ihzkcXo1EpJcJL,1572094,12242816,-10670722,407
2022-05-09 11:23:02-04:00,20079,BJUNK2orMVx6mYsD9pnQzmsEh95ZF2NWPm9KJ1ZM67Qn,FpxLa3DwWrspYvHVsScSDcscHB2eBHGxRrQ4gVvn4VW,True,49404492,12351123,37399,18699,18700,C4UnXuShCvjSMgBAgVNMy1oakxCNk1et27A82fywU112,1495977,17330404,-15834427,302
2022-05-09 11:23:23-04:00,20080,EHi1UBG8wMUFZECktsFUZkGjJPaBNEedswS62hyYn6jC,Drx9ErQhAjnPuJ83LPYFnY5ZV5XDzGuXDuSf16VqWayp,True,381415974,40647096,145322,72661,72661,2a35JJeTUW1pm6M3e8DHCjp8qr4vbc2cRPhuzZWyFzYd,13636483,255279032,-241642549,357
2022-05-09 11:23:31-04:00,20081,EkKmfEnxTscSs2BDs1mg6SyHdStC8AYTy9zihw9VWP63,DW4ujEZj4H83B9CrSfbks2pkHEj3gh2d114eo1aDh4s9,False,25823036,25823036,782376,39118,743258,2a35JJeTUW1pm6M3e8DHCjp8qr4vbc2cRPhuzZWyFzYd,782376,9084171,-8301795,302
2022-05-09 11:23:42-04:00,20082,3AaMzK9WAbD9m27szcJYnucnSPQ4W7tk8EztgWv4vqUo,8oUBQUKo9wHLu1tUEF1AeCUa7oRYyDSoFNRMqQAqKMbH,True,40652427,1940269,8131,4065,4066,Hu94aiQWvce6THeGyCFqGRPM1pQrK3ihzkcXo1EpJcJL,1703721,13227225,-11523504,419
2022-05-09 11:23:43-04:00,20083,532MfQR1PzPn6cmC1kpZsz9MyBWSamSeieh1F6GqVY33,6sJ8XXMZzGbHjVU1vWNW8unWoBZhJa54GguYJQhcb8PA,True,1448347034,205583084,1363049,681524,681525,72XWPCtRYEDZbddP7d6dHtUBRRDLSJsB2xZTAfefoEVZ,96027786,266251012,-170223226,663
2022-05-09 11:23:45-04:00,20084,F2AU2PjaSmHxWWhkz8XxMggkCMWbMVgawt89tSnYS6RL,ET9febRJiW197DYMaJbgk3kWsAeFv5f4peQ4vFCVppK6,True,920262956,230065739,1415302,707651,707651,Hu94aiQWvce6THeGyCFqGRPM1pQrK3ihzkcXo1EpJcJL,56612112,115490734,-58878622,615
2022-05-09 11:23:52-04:00,20085,CpeJ8BVz8Nd6SqnM3DYejnvAYnovDwu1taCqMEBD4RRi,GMmBgzDTtes62wJTENptaWPxNY2srWCrAdWErkj22Hzj,False,23568407,23568407,959900,47995,911905,8sEswn3kzEhnYjAZVvCQnHEUvYd7pFVvc2Xc2Kd1BpbC,959901,8153262,-7193361,407
2022-05-09 11:23:54-04:00,20086,5euvq1j9LCJWT1K7xKAE2TjwzbrWA5t6j2SxtnWsEPeU,GKDnouGNzg5JkjWG7Qs4nmka6qUMdYrk1fKwrmj8TvdH,True,40596021,1937768,8084,4042,4042,C4UnXuShCvjSMgBAgVNMy1oakxCNk1et27A82fywU112,1693799,13269733,-11575934,417
2022-05-09 11:24:03-04:00,20087,4YPn7VhWcrtecLaCBiVmXdmHwNmfR8qf2kzEtivmWrmK,EoEKgrmC6Xx6Ln8fWttD7wEtAkZtUbNifmv2mSHqV1Mf,True,35292661,8823165,26631,13315,13316,6L1WYrPiCMyi7XemPww4B4hvpKD1LQKD4RpiSKmrmgSC,1065262,6064723,-4999461,301
2022-05-09 11:24:30-04:00,20088,GdUWbwTgHF1RRbpVXCahz36G7MqYrM6QaBgnjL2eLKxk,JDYxQpYMt38mmjzLrVjgi3ezpc3DQ8YJEtJTZbG6fCCq,True,33045384,3045970,11910,5955,5955,C4UnXuShCvjSMgBAgVNMy1oakxCNk1et27A82fywU112,1292232,11219602,-9927370,391
2022-05-09 11:24:33-04:00,20089,H8P77smmiLj1vtt7hoSjf2vmcnBdW4rsgCtagtXZg6yy,3FxygrzNpSWivjLU3CumYif6rXhSzyjLqdKiyvphDnnc,True,40631418,1942929,8132,4066,4066,Hu94aiQWvce6THeGyCFqGRPM1pQrK3ihzkcXo1EpJcJL,1700719,13249054,-11548335,418
2022-05-09 11:24:40-04:00,20090,FncFHJooh1hy9Gc2y5sKdcYkZ5uHzsxHG4vHT9cVZGcK,BkFa4b5Jyv4ZJCCpwDYv355ezVFiZfAtn18AV7kstd2v,True,64876828,16219207,49052,24526,24526,8sEswn3kzEhnYjAZVvCQnHEUvYd7pFVvc2Xc2Kd1BpbC,1962117,16090751,-14128634,302
2022-05-09 11:24:40-04:00,20091,AL8JFS4gjaQx89f9j8wtaNJgV76K8bw1ugvNtgvhgAnb,HJYvG2kGKe8kXgtZSWTWwTmSjxA3XUeCvyT7acoKtS1C,True,12001678368,3000419592,9054808,4527404,4527404,gjBMZYVujDjD1ECG4i97M8Q3gV9ESnwwTSUGropkusj,362192341,3409905877,-3047713536,301
2022-05-09 11:24:47-04:00,20092,3CTLVMSTYE6azjXhZyhPD5XiUe23aJ4pb456SQnUiohH,13q8wAZ1zte3bd3LdeKLEUY7ubu2suCNRZVrgMScpV3C,False,23555340,23555340,963054,48152,914902,6L1WYrPiCMyi7XemPww4B4hvpKD1LQKD4RpiSKmrmgSC,963056,8170115,-7207059,408
2022-05-09 11:24:48-04:00,20093,5rnSL1jkLDsAvWsKNrbxtBJEcavHbc41kSTWywUEmSaX,87ZzyZEPJAXq6UiTqQVNuChRQVSb7QcUJgV41saA8CFC,True,26715729,1199701,4917,2458,2459,C4UnXuShCvjSMgBAgVNMy1oakxCNk1et27A82fywU112,1095160,9539441,-8444281,409
2022-05-09 11:24:57-04:00,20094,6pUtYz474QrpATEZnfb3iFbTKYA65pNyKAo4TQZAjtqe,8dipRUXvxJiDLdHEtCPkso4vErbVwshHQiRfvSngBS9J,True,235660385,9315708,32936,16468,16468,8sEswn3kzEhnYjAZVvCQnHEUvYd7pFVvc2Xc2Kd1BpbC,8331929,169604991,-161273062,353
2022-05-09 11:25:25-04:00,20095,6HtdpTubfGUuwW6rympMFLyUsdELKDpYagmkErBdLGc6,7e6N7pnwFYx9kU2TXJWt9gCsCpUZTxnFKzjDNZeyWQyq,True,44007835,11001958,68642,34321,34321,8sEswn3kzEhnYjAZVvCQnHEUvYd7pFVvc2Xc2Kd1BpbC,2745690,11180676,-8434986,623
2022-05-09 11:26:06-04:00,20096,EVMrznfJS54BZiywDD2WhUtxzicDtbEpm2a5yLrtCgRF,CpzsMYVYvKg8ihrX1cKRw7TDEYwD3kAyiX92hsf2KiTz,True,294216283,19520280,91410,45705,45705,Hu94aiQWvce6THeGyCFqGRPM1pQrK3ihzkcXo1EpJcJL,13777703,212112013,-198334310,468
2022-05-09 11:26:23-04:00,20097,EHi1UBG8wMUFZECktsFUZkGjJPaBNEedswS62hyYn6jC,Drx9ErQhAjnPuJ83LPYFnY5ZV5XDzGuXDuSf16VqWayp,True,339625188,38127109,138615,69307,69308,2a35JJeTUW1pm6M3e8DHCjp8qr4vbc2cRPhuzZWyFzYd,12347471,238133938,-225786467,363
2022-05-09 11:26:24-04:00,20098,BTXpvCdmYEmg5fB2Hsjc6Wked2sky4oQpGu7r8KuPau4,CaEwxQQds9f44npaSrYAsC6WpE3T6MpAGr9jgXZeqWjA,True,58027641,3070910,13126,6563,6563,2a35JJeTUW1pm6M3e8DHCjp8qr4vbc2cRPhuzZWyFzYd,2480416,18016188,-15535772,427
2022-05-09 11:26:28-04:00,20099,62q4KpVd3UXPomDaqpTF7recRAEh2ZKgWRgT92ztmda4,8xRdV8nWLb3CiCcHt2ZXEJv3NSfaa178zarhUkKv2rP9,True,36720185,3298843,13159,6579,6580,Hu94aiQWvce6THeGyCFqGRPM1pQrK3ihzkcXo1EpJcJL,1464769,11748593,-10283824,398
2022-05-09 11:26:29-04:00,20100,GNohZMtk1VAuhLAgNGT8J3HYCKDCiyjvLeAWr64d7Duy,6soTLVj9DzFht8DzvjRfNPAWhZuiDBS5fDE1fpeuDSSz,True,16268577,4067144,25372,12686,12686,C4UnXuShCvjSMgBAgVNMy1oakxCNk1et27A82fywU112,1014916,12275368,-11260452,623
2022-05-09 11:26:29-04:00,20101,HT2SuCbePhjNZaar24uVwihYowCNvSjdvhJ8BRSVw9nX,98Ts4LCnapHVoCJ5PW3Armvh4jvDtpfs3SYRLRxiAgzZ,False,20615384,20615384,971477,48573,922904,2a35JJeTUW1pm6M3e8DHCjp8qr4vbc2cRPhuzZWyFzYd,971478,11817584,-10846106,471
2022-05-09 11:26:41-04:00,20102,9eWpSyu71Z6dmx7yTh7WrbVScdrrZN14d5tfmqEGFgXt,2r89PFKSD9zmSp2Wyx4CQ75HAtmUgwhAS2oG5MuYuiV6,True,274397271,23884743,98735,49367,49368,Hu94aiQWvce6THeGyCFqGRPM1pQrK3ihzkcXo1EpJcJL,11343090,135729678,-124386588,413
2022-05-09 11:26:43-04:00,20103,DvSVpLMQyz91ksMwhuwwFDiKMo53FC5FVG5XrQZYWurJ,5jL2cYHg1QQpWYRCF4f378jpeHnTfPMWXiiHuhLNbzq8,True,29901987,2903345,11655,5827,5828,6L1WYrPiCMyi7XemPww4B4hvpKD1LQKD4RpiSKmrmgSC,1200402,10515966,-9315564,401
2022-05-09 11:26:43-04:00,20104,7w76zJFb9nTPDbfC4DCscQ2F5vimT8hiivT8WkuwWYWX,5X5XNdoFZv15bmbv97VRxHgTZzKyiFZpoz7MRNkPZS6f,True,26313921,1130891,4531,2265,2266,8sEswn3kzEhnYjAZVvCQnHEUvYd7pFVvc2Xc2Kd1BpbC,1054479,9193808,-8139329,400
2022-05-09 11:26:49-04:00,20105,AtaNpuHGEDd7kfakJbTbpphMdQk7ZWk9iB585TtNATKx,72egdmxZyhyYsM93hTMuoDd6NeYVB7gpiJG4PWj4Qi8f,True,24608338,1135668,4632,2316,2316,5HnvdJnCCcmRsm4GkXnYWd4q9RpwuvYDGEUMPkYR3Ts9,1003872,8695714,-7691842,407
2022-05-09 11:26:59-04:00,20106,7GpG8k6hM27vK1R5Sx1v5xUBuF6vybP41dcymjXDi5P7,7Aip6HDcbZ5mvoSucNupRS9enRdGx37F8L432K7V81do,True,78273454,19568363,122271,61135,61136,2a35JJeTUW1pm6M3e8DHCjp8qr4vbc2cRPhuzZWyFzYd,4890847,54633838,-49742991,624
2022-05-09 11:27:39-04:00,20107,3AaMzK9WAbD9m27szcJYnucnSPQ4W7tk8EztgWv4vqUo,8oUBQUKo9wHLu1tUEF1AeCUa7oRYyDSoFNRMqQAqKMbH,True,38592249,1726901,7050,3525,3525,Hu94aiQWvce6THeGyCFqGRPM1pQrK3ihzkcXo1EpJcJL,1575681,12205247,-10629566,408
2022-05-09 11:27:42-04:00,20108,57UJpBg8pjTxWp9LVwVGjCDm9zgYnzs4ru49BdZrG62a,Dor96mgsM5EroCmZUAnuDPiAiLn7nNgGeZDbwHxpHxzw,True,35328884,8832221,26538,13269,13269,C4UnXuShCvjSMgBAgVNMy1oakxCNk1et27A82fywU112,1061526,6142676,-5081150,300
2022-05-09 11:27:43-04:00,20109,5euvq1j9LCJWT1K7xKAE2TjwzbrWA5t6j2SxtnWsEPeU,GKDnouGNzg5JkjWG7Qs4nmka6qUMdYrk1fKwrmj8TvdH,True,38548238,1726893,7058,3529,3529,2a35JJeTUW1pm6M3e8DHCjp8qr4vbc2cRPhuzZWyFzYd,1575700,12246290,-10670590,408
2022-05-09 11:27:43-04:00,20110,GzNALiTvxZxR3aTDD4UJP1QdVA5CrqQtKL8yxXcBfuz3,D84qRZSwsfURTQFWXV5cGdBHQyrQa3T5ULmHZ3N22J8N,False,3429616,3429616,103483,5174,98309,6L1WYrPiCMyi7XemPww4B4hvpKD1LQKD4RpiSKmrmgSC,103484,3576609,-3473125,301
2022-05-09 11:28:04-04:00,20111,GdUWbwTgHF1RRbpVXCahz36G7MqYrM6QaBgnjL2eLKxk,JDYxQpYMt38mmjzLrVjgi3ezpc3DQ8YJEtJTZbG6fCCq,True,29919359,2910038,11673,5836,5837,2a35JJeTUW1pm6M3e8DHCjp8qr4vbc2cRPhuzZWyFzYd,1200267,10503656,-9303389,401
2022-05-09 11:28:14-04:00,20112,7tFD53kPTqrzjCu1Wji78gUqhoRtCUhsP1pM3DQKT7uG,BJvgPLYBDJrQJdQVowrsMwUGMurq4zTihoFwWoEokfu3,True,76977532,10842107,32796,16398,16398,Hu94aiQWvce6THeGyCFqGRPM1pQrK3ihzkcXo1EpJcJL,2328536,22565584,-20237048,302
2022-05-09 11:28:14-04:00,20113,9L2rA8qtfvjKMzqtLn9Cc9Y3ih1e8Z3w9huDzyZXg1xk,GopCtogALLkVyW1T3FGofVWMmjnsdG6EkpJUWob3svaP,True,213473319,53368329,159388,79694,79694,Hu94aiQWvce6THeGyCFqGRPM1pQrK3ihzkcXo1EpJcJL,6375547,40262299,-33886752,298
2022-05-09 11:28:17-04:00,20114,Fczxdc24Eav8xcaKRDwWMEwPEzkGyEJ7qGcXYyGZFKVz,8GqweYpec4cnpaJvueF3FGWoaz72BAzpLYXBX7tuuqEt,False,26863745,26863745,797726,39886,757840,6L1WYrPiCMyi7XemPww4B4hvpKD1LQKD4RpiSKmrmgSC,797726,20670079,-19872353,296
2022-05-09 11:28:22-04:00,20115,5rnSL1jkLDsAvWsKNrbxtBJEcavHbc41kSTWywUEmSaX,87ZzyZEPJAXq6UiTqQVNuChRQVSb7QcUJgV41saA8CFC,True,25436451,2227560,8850,4425,4425,2a35JJeTUW1pm6M3e8DHCjp8qr4vbc2cRPhuzZWyFzYd,1010666,9151264,-8140598,397
2022-05-09 11:28:23-04:00,20116,A7j77tzgnQVGtHTa65VtVZqJRYeJvQk7am8NW6e66379,4vJGwEvXU2tGWoWWGwbsYcfKQAMCHbrBMRk4ZVFzneLs,True,273338310,68334577,204270,102135,102135,C4UnXuShCvjSMgBAgVNMy1oakxCNk1et27A82fywU112,8170836,91279914,-83109078,298
2022-05-09 11:28:24-04:00,20117,6pUtYz474QrpATEZnfb3iFbTKYA65pNyKAo4TQZAjtqe,8dipRUXvxJiDLdHEtCPkso4vErbVwshHQiRfvSngBS9J,True,225741642,18680056,63683,31841,31842,6L1WYrPiCMyi7XemPww4B4hvpKD1LQKD4RpiSKmrmgSC,7695958,161267229,-153571271,340
2022-05-09 11:28:25-04:00,20118,F47ihi3LtNYspD1tkQhind1ce8udZ628Ye1NuDBd3Me1,HqzXiTisYpcPHCAMvceUL8WSrzEX38TuGkzPaGJSdAHm,False,28613867,28613867,816632,40831,775801,5HnvdJnCCcmRsm4GkXnYWd4q9RpwuvYDGEUMPkYR3Ts9,816632,7799340,-6982708,285
2022-05-09 11:28:25-04:00,20119,BAkPsWHtpVcEGqUgKTKjwZ6d5aaUcaUhdgYxBnpSTDW2,BDwDmVaZnXh22sf8nsDtjVfgxMAswbM3PW3si3k4nbRK,True,75164026,18791006,53736,26868,26868,2a35JJeTUW1pm6M3e8DHCjp8qr4vbc2cRPhuzZWyFzYd,2149452,34289163,-32139711,285
2022-05-09 11:28:26-04:00,20120,4rVW5SPBGcoxE3wAnjbULgZm4xdHXtqhivrszp9W4YP7,Fzu9D4KRKhAF7p22sNqMybe11zGwuXVe58iSt32MbfYX,True,66424788,16606197,48147,24073,24074,C4UnXuShCvjSMgBAgVNMy1oakxCNk1et27A82fywU112,1925881,20438809,-18512928,289
2022-05-09 11:28:26-04:00,20121,Ejg8vXVsro4jB2fpdUUXCRfKTiE5TUwfRXhHeR8qtrEi,GnF7xwsjzso48ZEAdYYuxNkJso7ug3s46uogi4XDbs1,True,255817612,63954403,190820,95410,95410,2a35JJeTUW1pm6M3e8DHCjp8qr4vbc2cRPhuzZWyFzYd,7632822,68788850,-61156028,298
2022-05-09 11:28:26-04:00,20122,AAq29FSNdRbVT9BRteiCcGGmYQ1zaSavidMPJFU4izsD,BsKTRrwuEoKZvFJtmniTN4tycheTD6x8x5ekTm8eoXxj,False,5780382,5780382,173779,8688,165091,3zqXX6kzhkbW3d4TwD2CNjMRwxTbREXySekvq37kfCNk,173779,3435897,-3262118,300
2022-05-09 11:28:27-04:00,20123,CMVVfXQYALSc58NLD67L8YrJAbDHZ9rFZvYQC7r8Png4,44pytMX14zaEQv6aRQ223CxYB2uTP7VUTQfUY58EkaNB,True,82045502,20511375,59314,29657,29657,72FwbpFGoLEazJEdpqNtPNefsadUrimUqma9wSoy4qiS,2372573,39154811,-36782238,289
2022-05-09 11:28:28-04:00,20124,EDkNF7dY8qqW2zsDd4MCdS94XKU3saQ2edw4DQsmReDU,BdB82igoRH2QwiksQZn6xr1Kpo4k5YEGgipYU2sqQMEa,False,16983516,16983516,510810,25540,485270,C4UnXuShCvjSMgBAgVNMy1oakxCNk1et27A82fywU112,510810,3528313,-3017503,300
2022-05-09 11:28:31-04:00,20125,H8P77smmiLj1vtt7hoSjf2vmcnBdW4rsgCtagtXZg6yy,3FxygrzNpSWivjLU3CumYif6rXhSzyjLqdKiyvphDnnc,True,38560773,1725556,7002,3501,3501,5HnvdJnCCcmRsm4GkXnYWd4q9RpwuvYDGEUMPkYR3Ts9,1564871,12230723,-10665852,405
2022-05-09 11:28:38-04:00,20126,FU3fRyQxk6rwtD9Db1nTvTAjSwgSW9vi1q7SjZ92ijyM,7c3maBK3hpb1exxqcvnwiUfhhUBgLgCs5exANSZ7m494,True,105831112,26457778,78454,39227,39227,C4UnXuShCvjSMgBAgVNMy1oakxCNk1et27A82fywU112,3138167,15906629,-12768462,296
2022-05-09 11:28:41-04:00,20127,4oMasDRj8HWfknmdwt6Mkz3eonr8J2byoiSTRo4sCnFQ,3emcATkEFvDVETiK97eVET2Z2jzkgiiSxX3gu5wsUKPe,True,376188700,54930687,363586,181793,181793,Hu94aiQWvce6THeGyCFqGRPM1pQrK3ihzkcXo1EpJcJL,24899978,229081926,-204181948,661
2022-05-09 11:28:50-04:00,20128,2tPYXtNrw134ACVhkYdnG9FGT4iHm61PuX8L7AfG9aAT,EyyPLVdjgewzVDKePQUj85BBttWy4MixVr9CSD8JVbrP,True,263090421,65772605,198821,99410,99411,2a35JJeTUW1pm6M3e8DHCjp8qr4vbc2cRPhuzZWyFzYd,7952875,124516099,-116563224,302
2022-05-09 11:30:23-04:00,20129,62q4KpVd3UXPomDaqpTF7recRAEh2ZKgWRgT92ztmda4,8xRdV8nWLb3CiCcHt2ZXEJv3NSfaa178zarhUkKv2rP9,True,33328324,3138251,12792,6396,6396,68sueyVfmy5ToEGtLFGDkwebX47xAmzyXE29z8JrmcWv,1358592,11096776,-9738184,407
2022-05-09 11:30:28-04:00,20130,F1G1Yb2jhT1hULYuNM9QMuNNA6vHZ2Wg4LhFGWsJmr78,2oF52s77UVwjbZMLmxyNsGRZ36RHqSJiV5VL7FzoWgyB,False,10768759,10768759,325457,16272,309185,68sueyVfmy5ToEGtLFGDkwebX47xAmzyXE29z8JrmcWv,325458,5750069,-5424611,302
2022-05-09 11:30:29-04:00,20131,GCNi25P1Ywvfx5JpyxFVV68sRkio7LEhFgY85ZqveKR3,34mxz8fCss7KNAbEi2Wj9z5dTgXCGxuq2vyqzBPChtmq,True,3757848192,939462048,2758837,1379418,1379419,Hu94aiQWvce6THeGyCFqGRPM1pQrK3ihzkcXo1EpJcJL,110353516,1338013357,-1227659841,293
2022-05-09 11:30:33-04:00,20132,AXBfrbCpYAWKN5jgDVVMiKXscQ96YtotKV3DT6XSzm9o,Dh3SiHAqrQzPQnTLRMxtBn2EFyHNgyfnYGpgcuNGTvyL,True,29456573,7364143,45659,22829,22830,2a35JJeTUW1pm6M3e8DHCjp8qr4vbc2cRPhuzZWyFzYd,1826383,17680561,-15854178,620
2022-05-09 11:30:34-04:00,20133,FSonJL6JzKgaZG6C3qp7H8UQYrfWRsuDmbHkrwTHZgYd,6kZCMcaUrPmPQafMUSivWavmDwEmVdvF7N7hyRXb34bw,True,68544217,17136054,51140,25570,25570,Hu94aiQWvce6THeGyCFqGRPM1pQrK3ihzkcXo1EpJcJL,2045613,15985164,-13939551,298
2022-05-09 11:30:38-04:00,20134,BTXpvCdmYEmg5fB2Hsjc6Wked2sky4oQpGu7r8KuPau4,CaEwxQQds9f44npaSrYAsC6WpE3T6MpAGr9jgXZeqWjA,True,54773082,2556695,10659,5329,5330,Hu94aiQWvce6THeGyCFqGRPM1pQrK3ihzkcXo1EpJcJL,2283641,17136467,-14852826,416
2022-05-09 11:30:45-04:00,20135,EVMrznfJS54BZiywDD2WhUtxzicDtbEpm2a5yLrtCgRF,CpzsMYVYvKg8ihrX1cKRw7TDEYwD3kAyiX92hsf2KiTz,True,273458740,18291929,83272,41636,41636,Hu94aiQWvce6THeGyCFqGRPM1pQrK3ihzkcXo1EpJcJL,12449030,192323635,-179874605,455
2022-05-09 11:30:50-04:00,20136,7w76zJFb9nTPDbfC4DCscQ2F5vimT8hiivT8WkuwWYWX,5X5XNdoFZv15bmbv97VRxHgTZzKyiFZpoz7MRNkPZS6f,False,25109811,25109811,976727,48836,927891,5HnvdJnCCcmRsm4GkXnYWd4q9RpwuvYDGEUMPkYR3Ts9,976729,8659033,-7682304,388
2022-05-09 11:30:52-04:00,20137,3AaMzK9WAbD9m27szcJYnucnSPQ4W7tk8EztgWv4vqUo,8oUBQUKo9wHLu1tUEF1AeCUa7oRYyDSoFNRMqQAqKMbH,True,36742080,3309777,13020,6510,6510,8sEswn3kzEhnYjAZVvCQnHEUvYd7pFVvc2Xc2Kd1BpbC,1445363,11710247,-10264884,393
2022-05-09 11:30:52-04:00,20138,GcwFXxcxRF2xwbgFbQZoYEDreimd3J3UJ9sPfuwYVKtS,7uXjmKS8RxP2qSS7ataBH5hkfpgsFcpSBWUEBuV5zgyZ,True,69472315,17368078,52033,26016,26017,Hu94aiQWvce6THeGyCFqGRPM1pQrK3ihzkcXo1EpJcJL,2081321,21462674,-19381353,299
2022-05-09 11:30:52-04:00,20139,7qEVqFr1naSPCDV9q3xx6KMZn1yCHvkHZJkaA46NLmSE,8Mohcixq2L9PYrHpb95vuEsXqJ18JhEHi3RA83VM9cLv,True,68048071,17012017,50802,25401,25401,2a35JJeTUW1pm6M3e8DHCjp8qr4vbc2cRPhuzZWyFzYd,2032098,26746027,-24713929,298
2022-05-09 11:30:52-04:00,20140,532MfQR1PzPn6cmC1kpZsz9MyBWSamSeieh1F6GqVY33,6sJ8XXMZzGbHjVU1vWNW8unWoBZhJa54GguYJQhcb8PA,True,1229585020,154964978,1026968,513484,513484,Hu94aiQWvce6THeGyCFqGRPM1pQrK3ihzkcXo1EpJcJL,81485807,238686336,-157200529,662
2022-05-09 11:30:53-04:00,20141,H9pFRayNBHTAhsbtGyfs1XXUWGxAbw7SgpT1xdrSRWEY,9LNreyXuhgyLCDYViNyA1jUw6h1nv4GmDtTYMoUQBqCG,True,2973084930,376349735,1123735,561867,561868,A9TwRM1BMxqb8DCC7YNAMV6zPenEJm3HTZBy7wJKK58U,88772771,1305039751,-1216266980,298
2022-05-09 11:30:53-04:00,20142,7zuFEyLQFHkAjm3mAuxN42VenwF6fZcqM81mmR8sBnmY,CSnQxjc4Jn8iP4JSxj5wsrvxGsLoAYQn1bKC8naY7YZP,True,4449035671,1112258917,3350436,1675218,1675218,3zqXX6kzhkbW3d4TwD2CNjMRwxTbREXySekvq37kfCNk,134017451,437595222,-303577771,301
2022-05-09 11:30:53-04:00,20143,Aog11AwpgWF7UgvLLJbV5kn3UrJURYQUhnBFnAFSqbp8,2WXYGpuib3fK3BCXDQVQsoktEnASPuZfcnmC2AZ7KTQK,True,65394385,16348596,49276,24638,24638,6L1WYrPiCMyi7XemPww4B4hvpKD1LQKD4RpiSKmrmgSC,1971049,15441497,-13470448,301
2022-05-09 11:30:56-04:00,20144,DvSVpLMQyz91ksMwhuwwFDiKMo53FC5FVG5XrQZYWurJ,5jL2cYHg1QQpWYRCF4f378jpeHnTfPMWXiiHuhLNbzq8,True,26889852,1155977,4642,2321,2321,Hu94aiQWvce6THeGyCFqGRPM1pQrK3ihzkcXo1EpJcJL,1079957,9660413,-8580456,401
2022-05-09 11:30:58-04:00,20145,7KfkiubVVGHekg5W5NW1QqxnbudXQroe8tCBsx4GgXAC,5j5yEzQKUmQi7dFM89QTYSRpBca2y5S5EvvLC8ZNuDgM,True,21487921,5371980,33225,16612,16613,6L1WYrPiCMyi7XemPww4B4hvpKD1LQKD4RpiSKmrmgSC,1329016,22028848,-20699832,618
2022-05-09 11:30:58-04:00,20146,EHi1UBG8wMUFZECktsFUZkGjJPaBNEedswS62hyYn6jC,Drx9ErQhAjnPuJ83LPYFnY5ZV5XDzGuXDuSf16VqWayp,True,300352672,16278647,59962,29981,29981,3zqXX6kzhkbW3d4TwD2CNjMRwxTbREXySekvq37kfCNk,11063449,211378575,-200315126,368
2022-05-09 11:31:00-04:00,20147,7Mexx4M3Yjs2ZciwFqQc14xQa9JQ6nNg2uCVLieeoS1j,14gesYGg7s9TQNcpUJvGgziwqmaKtxf46yzKmJ4cDC6n,False,5021543,5021543,313273,15663,297610,3zqXX6kzhkbW3d4TwD2CNjMRwxTbREXySekvq37kfCNk,313273,5291753,-4978480,623
2022-05-09 11:31:00-04:00,20148,5euvq1j9LCJWT1K7xKAE2TjwzbrWA5t6j2SxtnWsEPeU,GKDnouGNzg5JkjWG7Qs4nmka6qUMdYrk1fKwrmj8TvdH,True,36693881,3302609,12971,6485,6486,8sEswn3kzEhnYjAZVvCQnHEUvYd7pFVvc2Xc2Kd1BpbC,1441178,11751274,-10310096,392
2022-05-09 11:31:00-04:00,20149,Bu65ba81oA2rZqxGAsctgz39NPPJqbXR3SvdMX5KQfTK,DcxNLDe2GwGiQPtQhzMiUjrMaqXjuyx1EGgX3xPtE98T,False,29285350,29285350,883364,44168,839196,2a35JJeTUW1pm6M3e8DHCjp8qr4vbc2cRPhuzZWyFzYd,883364,9136842,-8253478,301
2022-05-09 11:31:07-04:00,20150,CyWBZ1xJ9LahUnPesbXLZ4Rr5UyWAHgVFYwfrnhyrkNL,2Lpk87Xth8ZL5J9BfzmMpEE3x76FDrrrmdKiCNkSVip2,False,157943,157943,5958,297,5661,C5o4TfkUfECutAWsDELjhsZX6PYyYgK3XeKvx6p4FphM,5960,160519,-154559,377
2022-05-09 11:31:09-04:00,20151,AtaNpuHGEDd7kfakJbTbpphMdQk7ZWk9iB585TtNATKx,72egdmxZyhyYsM93hTMuoDd6NeYVB7gpiJG4PWj4Qi8f,False,23384189,23384189,910756,45537,865219,Hu94aiQWvce6THeGyCFqGRPM1pQrK3ihzkcXo1EpJcJL,910759,8165615,-7254856,389
2022-05-09 11:31:23-04:00,20152,6pUtYz474QrpATEZnfb3iFbTKYA65pNyKAo4TQZAjtqe,8dipRUXvxJiDLdHEtCPkso4vErbVwshHQiRfvSngBS9J,True,206545400,15684639,54038,27019,27019,2a35JJeTUW1pm6M3e8DHCjp8qr4vbc2cRPhuzZWyFzYd,7116089,139720339,-132604250,344
2022-05-09 11:31:24-04:00,20153,5rnSL1jkLDsAvWsKNrbxtBJEcavHbc41kSTWywUEmSaX,87ZzyZEPJAXq6UiTqQVNuChRQVSb7QcUJgV41saA8CFC,False,23144482,23144482,937404,46870,890534,47z82br5WdW2DZajdnPDPSSRRKsyAggqXqK6oPUwTaLf,937407,8557473,-7620066,405
2022-05-09 11:31:31-04:00,20154,AZq9LHFskHUujKDJZTpWhpP9LRaDjQKcrf2Bz2eY6TtN,EtStidHXHYYQJ6E1h7LHmgewtiK7AjMAsDBw4XBCrdQs,True,291572263,72893065,449194,224597,224597,C5o4TfkUfECutAWsDELjhsZX6PYyYgK3XeKvx6p4FphM,17967764,179703448,-161735684,616
2022-05-09 11:31:33-04:00,20155,GdUWbwTgHF1RRbpVXCahz36G7MqYrM6QaBgnjL2eLKxk,JDYxQpYMt38mmjzLrVjgi3ezpc3DQ8YJEtJTZbG6fCCq,True,26903512,1156756,4655,2327,2328,2a35JJeTUW1pm6M3e8DHCjp8qr4vbc2cRPhuzZWyFzYd,1082785,9652022,-8569237,402
2022-05-09 11:31:35-04:00,20156,Eo5LYLiUCspbrK13ker5skq9kMjnpUJEJPSbRDWjH6V4,GefeNAw5BdDkibatZknZVGsLhkfc8wfxriEfjHNpvMPm,True,4489077057,1122269264,3365704,1682852,1682852,A2p75MbAbeUdHkPLkAjgGeiwuu9WPrkMHzjCkDXF1Xr3,134628199,1340079865,-1205451666,299
2022-05-09 11:31:41-04:00,20157,8KzrbHiup39X7Zw9grvh7gS9ZcA1zuhLGqgYguSjwnD6,A2EPmTs73YiS15ZKcjom55huNYaJY3WeP7NBDar1VE3R,True,1617919652,404479913,2522645,1261322,1261323,AmTrMPzuTp2BjnjqGNKqz9FTTCdpoKcPAJLwFc8ozcbh,100905806,2081333777,-1980427971,623
2022-05-09 11:31:41-04:00,20158,EyNCsqWu8zLyuRnXSbzJWnWZg7ZLjb4oJSZFdDSkbXmT,6rMMMkZibUHXYs8hXY3FmG4rgBx6gWDRGJwR2bP2t6ZD,True,28535584107,6240598854,21328887,10664443,10664444,AmTrMPzuTp2BjnjqGNKqz9FTTCdpoKcPAJLwFc8ozcbh,975278664,6066693402,-5091414738,341
2022-05-09 11:31:41-04:00,20159,DRVtEzZs9u9ysrcANZLEjrvbuuGqYn77v2h4cDFKuNUx,Fv9qiMZhuSBL2cs9AWUYbDLQjB46W2ZwrhxaNXtPLDpC,True,6312489907,1578122476,4774836,2387418,2387418,GXyFXZMNk2NFyEzw6JetVqsujqcz2yCixH7n8EpDJYWD,190993449,626842448,-435848999,302
2022-05-09 11:31:46-04:00,20160,E17GuUpNNTyonDV7dtuit35hwQXtZ8fowHpHFHWSiiG3,GZ5DboskwBDP5fgYvp6djKFVFCo3MJkurtCY6cA8XVHr,True,21451010,5362752,32644,16322,16322,C4UnXuShCvjSMgBAgVNMy1oakxCNk1et27A82fywU112,1305770,22042505,-20736735,608
2022-05-09 11:31:46-04:00,20161,H8P77smmiLj1vtt7hoSjf2vmcnBdW4rsgCtagtXZg6yy,3FxygrzNpSWivjLU3CumYif6rXhSzyjLqdKiyvphDnnc,True,36679041,3294214,12588,6294,6294,5HnvdJnCCcmRsm4GkXnYWd4q9RpwuvYDGEUMPkYR3Ts9,1401693,11734195,-10332502,382
2022-05-09 11:31:53-04:00,20162,3N1uMGew9Byv6CRtGzFTRyNCCfNM6RpcRJQM2VCRHeLh,B53vnuTn9pYDK72eMxGAss5hCJg2vcfzF86kp7QAFc7d,False,11761369,11761369,331910,16595,315315,3zqXX6kzhkbW3d4TwD2CNjMRwxTbREXySekvq37kfCNk,331910,9068090,-8736180,282
2022-05-09 11:31:54-04:00,20163,GPk4gzzas2Kuizhmw4z8AR6w1tqqztjm9j993hhVVK4w,F6WhBjBdUFngXtSo2de9bVwWfVzTkmPDTSbCPCdm6xzE,False,1725874,1725874,45970,2298,43672,3zqXX6kzhkbW3d4TwD2CNjMRwxTbREXySekvq37kfCNk,45970,924796,-878826,266
2022-05-09 11:31:55-04:00,20164,5xkW7wHTcF5WadNtBBqKPKctVwyQtTqqscivAmxzseCk,7m31ZMZdCn5Gz2q5sETWA7uKA5LsKD7pJHBBqU3g7tCn,True,374240316,93560079,281010,140505,140505,AmTrMPzuTp2BjnjqGNKqz9FTTCdpoKcPAJLwFc8ozcbh,11240406,65839476,-54599070,300
2022-05-09 11:31:56-04:00,20165,6pUtYz474QrpATEZnfb3iFbTKYA65pNyKAo4TQZAjtqe,8dipRUXvxJiDLdHEtCPkso4vErbVwshHQiRfvSngBS9J,True,190407299,14983906,52005,26002,26003,C4UnXuShCvjSMgBAgVNMy1oakxCNk1et27A82fywU112,6608589,134665542,-128056953,347
2022-05-09 11:31:56-04:00,20166,B5CTBTggmGFvGFSunjbB4C9tLKcYcULehmEiEXRihY2J,FX3ebF8P89rZBWfR74PDWUzxnLuDkUDgGcPYCBD5sMUG,False,1990771,1990771,103581,5179,98402,2a35JJeTUW1pm6M3e8DHCjp8qr4vbc2cRPhuzZWyFzYd,103582,1320081,-1216499,520
2022-05-09 11:31:57-04:00,20167,BTXpvCdmYEmg5fB2Hsjc6Wked2sky4oQpGu7r8KuPau4,CaEwxQQds9f44npaSrYAsC6WpE3T6MpAGr9jgXZeqWjA,True,52052810,2294242,9297,4648,4649,Hu94aiQWvce6THeGyCFqGRPM1pQrK3ihzkcXo1EpJcJL,2109405,15745001,-13635596,405
2022-05-09 11:31:58-04:00,20168,D67hJmi2ZnR8e5ckLt63BerivBzrKAEx7rdz3wH8axDC,EXEwijwdiqL9ftWfNrBL1Bqt6UzeoPFdZ7f18nMFQYE2,False,1961900,1961900,58436,2921,55515,3zqXX6kzhkbW3d4TwD2CNjMRwxTbREXySekvq37kfCNk,58436,701236,-642800,297
2022-05-09 11:31:59-04:00,20169,DAawvqmcjnThXxJzsp7ExW1bhGaRGRxLgG6h85HpGAN5,2KRCBiCQoQd2fDSS1e2U19WVddWAqM6EPkqK8rZwaRNh,True,38481511,9620377,28467,14233,14234,47z82br5WdW2DZajdnPDPSSRRKsyAggqXqK6oPUwTaLf,1138708,45125428,-43986720,295
2022-05-09 11:31:59-04:00,20170,DvSVpLMQyz91ksMwhuwwFDiKMo53FC5FVG5XrQZYWurJ,5jL2cYHg1QQpWYRCF4f378jpeHnTfPMWXiiHuhLNbzq8,True,25684174,1116920,4459,2229,2230,47z82br5WdW2DZajdnPDPSSRRKsyAggqXqK6oPUwTaLf,1025614,9229085,-8203471,399
2022-05-09 11:32:01-04:00,20171,EVMrznfJS54BZiywDD2WhUtxzicDtbEpm2a5yLrtCgRF,CpzsMYVYvKg8ihrX1cKRw7TDEYwD3kAyiX92hsf2KiTz,True,254093498,35364521,157167,78583,78584,Hu94aiQWvce6THeGyCFqGRPM1pQrK3ihzkcXo1EpJcJL,11292445,176671087,-165378642,444
2022-05-09 11:32:04-04:00,20172,cXqFkCF4gaT9vAcZYMgwLXmmuD5w4hwgxT8YXE8JuBw,5Wtf4ZBL6R1afLeC4WfhFGkfi42TagtNAg6EZWn7gKhg,True,43246468,10811617,31429,15714,15715,2a35JJeTUW1pm6M3e8DHCjp8qr4vbc2cRPhuzZWyFzYd,1257192,14321035,-13063843,290
2022-05-09 11:32:05-04:00,20173,9ancY5Fso8pUktKpRj3qc1YPQA6thy5n4f7uvNnsqMWR,CLUi9rvU9NTi7h4sNwqfr8aqChyGDbVJA1aKvKMWQv2r,True,509109204,127277301,382871,191435,191436,A9TwRM1BMxqb8DCC7YNAMV6zPenEJm3HTZBy7wJKK58U,15314873,130585267,-115270394,300
2022-05-09 11:32:05-04:00,20174,3AaMzK9WAbD9m27szcJYnucnSPQ4W7tk8EztgWv4vqUo,8oUBQUKo9wHLu1tUEF1AeCUa7oRYyDSoFNRMqQAqKMbH,True,33327829,3139705,12509,6254,6255,Hu94aiQWvce6THeGyCFqGRPM1pQrK3ihzkcXo1EpJcJL,1327869,11069501,-9741632,398
2022-05-09 11:32:09-04:00,20175,5euvq1j9LCJWT1K7xKAE2TjwzbrWA5t6j2SxtnWsEPeU,GKDnouGNzg5JkjWG7Qs4nmka6qUMdYrk1fKwrmj8TvdH,True,33295072,3138508,12555,6277,6278,Hu94aiQWvce6THeGyCFqGRPM1pQrK3ihzkcXo1EpJcJL,1332007,11103412,-9771405,400
2022-05-09 11:32:09-04:00,20176,FU3fRyQxk6rwtD9Db1nTvTAjSwgSW9vi1q7SjZ92ijyM,7c3maBK3hpb1exxqcvnwiUfhhUBgLgCs5exANSZ7m494,True,78694052,19673513,59510,29755,29755,C4UnXuShCvjSMgBAgVNMy1oakxCNk1et27A82fywU112,2380431,12636174,-10255743,302
2022-05-09 11:32:11-04:00,20177,EHi1UBG8wMUFZECktsFUZkGjJPaBNEedswS62hyYn6jC,Drx9ErQhAjnPuJ83LPYFnY5ZV5XDzGuXDuSf16VqWayp,True,282984682,30304694,106169,53084,53085,Hu94aiQWvce6THeGyCFqGRPM1pQrK3ihzkcXo1EpJcJL,9914144,194224298,-184310154,350
2022-05-09 11:32:11-04:00,20178,CvR57tmtnHbMmPivvJR6VenXivQaWue7z77N81WPpzfv,B4ASc8cUjrzuchv2SHwPrnjKvZgZpwvcLArsdYmMAqBQ,True,112280804,28070201,77284,38642,38642,C4UnXuShCvjSMgBAgVNMy1oakxCNk1et27A82fywU112,3091373,34389765,-31298392,275
2022-05-09 11:32:11-04:00,20179,H9pFRayNBHTAhsbtGyfs1XXUWGxAbw7SgpT1xdrSRWEY,9LNreyXuhgyLCDYViNyA1jUw6h1nv4GmDtTYMoUQBqCG,True,2586978308,366266603,1102803,551401,551402,A2p75MbAbeUdHkPLkAjgGeiwuu9WPrkMHzjCkDXF1Xr3,77892149,1127024123,-1049131974,301
2022-05-09 11:32:12-04:00,20180,GdUWbwTgHF1RRbpVXCahz36G7MqYrM6QaBgnjL2eLKxk,JDYxQpYMt38mmjzLrVjgi3ezpc3DQ8YJEtJTZbG6fCCq,True,25698414,1121842,4495,2247,2248,2a35JJeTUW1pm6M3e8DHCjp8qr4vbc2cRPhuzZWyFzYd,1029788,9222088,-8192300,400
2022-05-09 11:32:15-04:00,20181,H8P77smmiLj1vtt7hoSjf2vmcnBdW4rsgCtagtXZg6yy,3FxygrzNpSWivjLU3CumYif6rXhSzyjLqdKiyvphDnnc,True,33339133,3144211,12669,6334,6335,2a35JJeTUW1pm6M3e8DHCjp8qr4vbc2cRPhuzZWyFzYd,1343411,11078317,-9734906,402
2022-05-09 11:32:15-04:00,20182,djW9rVm1v4nW64QiVqgFUCRza24VqthDcSfVEyRHPed,EsXvQmXVXECqZPtmSdiuwieHPP5jsmyn67p78vHaJcqq,True,61972452,15493113,45173,22586,22587,47z82br5WdW2DZajdnPDPSSRRKsyAggqXqK6oPUwTaLf,1806951,9681816,-7874865,291
2022-05-09 11:32:17-04:00,20183,3Xbsek5MsEGoWr3G9yhuohREr26B2vSQcjqXdspTFHta,2rPxkUiMo9wGDq8EvAiwY3ngRpKmL223cBWWNTYoBmFp,True,257163677,64290919,169357,84678,84679,C4UnXuShCvjSMgBAgVNMy1oakxCNk1et27A82fywU112,6774311,32592058,-25817747,263
2022-05-09 11:32:26-04:00,20184,4rVW5SPBGcoxE3wAnjbULgZm4xdHXtqhivrszp9W4YP7,Fzu9D4KRKhAF7p22sNqMybe11zGwuXVe58iSt32MbfYX,True,49412738,12353184,36797,18398,18399,C4UnXuShCvjSMgBAgVNMy1oakxCNk1et27A82fywU112,1471881,15762482,-14290601,297
2022-05-09 11:32:26-04:00,20185,fAJK1wrBhSW297AtFWX2U4rUBf2gkzfQ6UrQL9yHEYW,5pyTFpanSyUCHxeMhJMKtpdrcMSAWc8bFadbyM7q4q4B,True,159975096,39993774,113239,56619,56620,C4UnXuShCvjSMgBAgVNMy1oakxCNk1et27A82fywU112,4529580,17510025,-12980445,283
2022-05-09 11:32:26-04:00,20186,m7gf1jAYXBZjRZEY9w4MjPfhzLwgDKaXyaCVhRD6C5E,Aa2aTZnpPux1i5K2MT4i1TsVM8vR7qR7rZGijQW4zpwd,True,474179028,93475758,335536,167768,167768,A9TwRM1BMxqb8DCC7YNAMV6zPenEJm3HTZBy7wJKK58U,17020927,220455293,-203434366,358
2022-05-09 11:32:31-04:00,20187,62q4KpVd3UXPomDaqpTF7recRAEh2ZKgWRgT92ztmda4,8xRdV8nWLb3CiCcHt2ZXEJv3NSfaa178zarhUkKv2rP9,True,30034726,1428782,5663,2831,2832,2a35JJeTUW1pm6M3e8DHCjp8qr4vbc2cRPhuzZWyFzYd,1190453,10284729,-9094276,396
2022-05-09 11:32:33-04:00,20188,1264MYNRHy1LTCp37jAPzn1i6FYXm7PY69iBHMcuT6e4,FEwt7EyjEAkzTQQqXZxmY7fZxwk97yYL3RdCAheie3H2,False,3103221,3103221,193319,9665,183654,8sEswn3kzEhnYjAZVvCQnHEUvYd7pFVvc2Xc2Kd1BpbC,193320,2089997,-1896677,622
2022-05-09 11:32:34-04:00,20189,8sQzUoiFfBUsfVKdUjUh3xUjwnaCP1Qmw9BGwtH768ZR,8wZxijgcyRwqxiRKMMZhoREAb6iHhRGCgjgZRd5Yp6RP,True,341064538,85266134,578891,289445,289446,C4UnXuShCvjSMgBAgVNMy1oakxCNk1et27A82fywU112,23155649,144583277,-121427628,678
2022-05-09 11:32:38-04:00,20190,6pUtYz474QrpATEZnfb3iFbTKYA65pNyKAo4TQZAjtqe,8dipRUXvxJiDLdHEtCPkso4vErbVwshHQiRfvSngBS9J,True,175049327,6920244,24441,12220,12221,C5o4TfkUfECutAWsDELjhsZX6PYyYgK3XeKvx6p4FphM,6182518,128833661,-122651143,353
2022-05-09 11:32:42-04:00,20191,DBT4GeddD8Ve8v7kerU1xrdJyy5moqUedcjYgM2jWESV,FVdbkwTpM3U6E4qQ9E2T9rTJ4dFYdkixsibnEiZqNUsA,True,382858113,95714528,288024,144012,144012,2xTUy2RS74GJMMDnmFaegMzFLn19RVfYG4CibhBmjP1i,11520962,116541839,-105020877,300
2022-05-09 11:32:43-04:00,20192,D7dQmfuiK31BHRG4Y9wpkRu7sChiZhTYes47YPNGvnpF,AN5jjtJp7d9DG3xJo3DnDRmGmzj5pKKy1owwVuREpReQ,True,248505558,62126389,385147,192573,192574,2a35JJeTUW1pm6M3e8DHCjp8qr4vbc2cRPhuzZWyFzYd,15405916,30293545,-14887629,619
2022-05-09 11:32:48-04:00,20193,BAkPsWHtpVcEGqUgKTKjwZ6d5aaUcaUhdgYxBnpSTDW2,BDwDmVaZnXh22sf8nsDtjVfgxMAswbM3PW3si3k4nbRK,True,55941218,13985304,41597,20798,20799,C4UnXuShCvjSMgBAgVNMy1oakxCNk1et27A82fywU112,1663914,26200573,-24536659,297
2022-05-09 11:32:48-04:00,20194,GtDk7DkAB2jvQynR57z8mjg6UoaTqYDr8Z4wsFX6KGSr,tAPvp4fscJZySZUVG2GZWZwSRVhfnNvkjCC6ZvmxqDQ,True,86749442,21687360,61993,30996,30997,C4UnXuShCvjSMgBAgVNMy1oakxCNk1et27A82fywU112,2479741,16249545,-13769804,285
2022-05-09 11:32:53-04:00,20195,9eWpSyu71Z6dmx7yTh7WrbVScdrrZN14d5tfmqEGFgXt,2r89PFKSD9zmSp2Wyx4CQ75HAtmUgwhAS2oG5MuYuiV6,True,248863198,44492397,171541,85770,85771,2a35JJeTUW1pm6M3e8DHCjp8qr4vbc2cRPhuzZWyFzYd,9595025,110045571,-100450546,385
2022-05-09 11:32:55-04:00,20196,7tFD53kPTqrzjCu1Wji78gUqhoRtCUhsP1pM3DQKT7uG,BJvgPLYBDJrQJdQVowrsMwUGMurq4zTihoFwWoEokfu3,True,65682502,8324124,23354,11677,11677,47z82br5WdW2DZajdnPDPSSRRKsyAggqXqK6oPUwTaLf,1842817,20042850,-18200033,280
2022-05-09 11:33:02-04:00,20197,7agvoo7kQa27Gx8Vn4fr3PMZBeXSW3tSrg8DFCnLZAh3,5nFTJaKiqFRNxicLeyxywDgmasU97xtnZSRz8Dy8HpAd,True,475618575,83603376,249950,124975,124975,AmTrMPzuTp2BjnjqGNKqz9FTTCdpoKcPAJLwFc8ozcbh,14219643,84073250,-69853607,298
2022-05-09 11:33:17-04:00,20198,2tPYXtNrw134ACVhkYdnG9FGT4iHm61PuX8L7AfG9aAT,EyyPLVdjgewzVDKePQUj85BBttWy4MixVr9CSD8JVbrP,True,195134811,48783702,139276,69638,69638,C4UnXuShCvjSMgBAgVNMy1oakxCNk1et27A82fywU112,5571049,95177379,-89606330,285
2022-05-09 11:33:23-04:00,20199,6xeNr9LhAfC6FRV62dALYdgx3bsoUpUpmEBiUPYCV5fz,8GP5cEpfNTEjvqm9usBUXs7jPCK5RciqjVJqtvX9fuGs,True,2827912279,706978069,2044266,1022133,1022133,AmTrMPzuTp2BjnjqGNKqz9FTTCdpoKcPAJLwFc8ozcbh,81770672,475664880,-393894208,289
2022-05-09 11:33:23-04:00,20200,62q4KpVd3UXPomDaqpTF7recRAEh2ZKgWRgT92ztmda4,8xRdV8nWLb3CiCcHt2ZXEJv3NSfaa178zarhUkKv2rP9,True,28558315,1285673,5119,2559,2560,2a35JJeTUW1pm6M3e8DHCjp8qr4vbc2cRPhuzZWyFzYd,1137161,9493003,-8355842,398
2022-05-09 11:33:24-04:00,20201,42h4NteqFpLjgjMS4gTTFoLvrEMpEP4sbGRd7SM5YCZR,AasJCLP5qsGzxkQs5jWysSarwoJTuZ6ZDeabNJNimWAX,True,1360710785,340177696,1020241,510120,510121,A9TwRM1BMxqb8DCC7YNAMV6zPenEJm3HTZBy7wJKK58U,40809670,161971252,-121161582,299
2022-05-09 11:33:24-04:00,20202,A2gRXnnsmLvMSzZray4DJdn7dgsrZwwK8uxqnajnyZHs,Gtwdm7MT23sMC9bucL12YD9LLjWftjzGso887FsatiuN,True,921097204,230274301,649362,324681,324681,AmTrMPzuTp2BjnjqGNKqz9FTTCdpoKcPAJLwFc8ozcbh,25974481,116148715,-90174234,281
2022-05-09 11:33:24-04:00,20203,GCNi25P1Ywvfx5JpyxFVV68sRkio7LEhFgY85ZqveKR3,34mxz8fCss7KNAbEi2Wj9z5dTgXCGxuq2vyqzBPChtmq,True,2788830487,697207621,1950975,975487,975488,gjBMZYVujDjD1ECG4i97M8Q3gV9ESnwwTSUGropkusj,78039022,1028509558,-950470536,279
2022-05-09 11:33:25-04:00,20204,E4VzeJLsf5Y6t3yNi8VpS8QxhJbJGPhnkNBmU2XoCBs9,63CXyYfevXtrL1QcfQtAhz29xeea5BwWcj6d6BWb4qiB,True,740620247,185155061,553299,276649,276650,AmTrMPzuTp2BjnjqGNKqz9FTTCdpoKcPAJLwFc8ozcbh,22131960,358879727,-336747767,298
2022-05-09 11:33:25-04:00,20205,Eo5LYLiUCspbrK13ker5skq9kMjnpUJEJPSbRDWjH6V4,GefeNAw5BdDkibatZknZVGsLhkfc8wfxriEfjHNpvMPm,True,3335297978,833824494,2493817,1246908,1246909,2xTUy2RS74GJMMDnmFaegMzFLn19RVfYG4CibhBmjP1i,99752680,1035583343,-935830663,299
2022-05-09 11:33:28-04:00,20206,EHi1UBG8wMUFZECktsFUZkGjJPaBNEedswS62hyYn6jC,Drx9ErQhAjnPuJ83LPYFnY5ZV5XDzGuXDuSf16VqWayp,True,252046508,28158989,102498,51249,51249,8sEswn3kzEhnYjAZVvCQnHEUvYd7pFVvc2Xc2Kd1BpbC,9174495,181187459,-172012964,364
2022-05-09 11:33:29-04:00,20207,26pvf6YygxQ8CdL4h4PcMuYNQtFbUVisTsYaFB3EZXvd,9tVSyevo14cUe2NMoBteqgV7vw44m6ooz2rD9ricKh55,False,37174650,37174650,860617,43030,817587,47z82br5WdW2DZajdnPDPSSRRKsyAggqXqK6oPUwTaLf,860617,18440150,-17579533,231
2022-05-09 11:33:29-04:00,20208,7PzGZgzieFyyFs1dbajkNQgVxooFUNZrj1bUsQvrSwbp,A2gDREmSmJTBPPw3sbKVY3smC9wbHMDdv87gr4Tr2ES7,True,138549248,34637312,104457,52228,52229,C4UnXuShCvjSMgBAgVNMy1oakxCNk1et27A82fywU112,4178289,22743231,-18564942,301
2022-05-09 11:33:29-04:00,20209,8L2s5h1hSU79naWcS7cvT3oxiPL6ofTDWmqTK1S4F99g,32DYf6ArTTcNwokJrbhHT1QGe4pZ9z29oPdw97aDR7AQ,True,92030079,23007519,59564,29782,29782,47z82br5WdW2DZajdnPDPSSRRKsyAggqXqK6oPUwTaLf,2382591,90003294,-87620703,258
2022-05-09 11:33:30-04:00,20210,3AaMzK9WAbD9m27szcJYnucnSPQ4W7tk8EztgWv4vqUo,8oUBQUKo9wHLu1tUEF1AeCUa7oRYyDSoFNRMqQAqKMbH,True,30129590,1435759,5989,2994,2995,2a35JJeTUW1pm6M3e8DHCjp8qr4vbc2cRPhuzZWyFzYd,1256826,10259196,-9002370,417
2022-05-09 11:33:33-04:00,20211,9L2rA8qtfvjKMzqtLn9Cc9Y3ih1e8Z3w9huDzyZXg1xk,GopCtogALLkVyW1T3FGofVWMmjnsdG6EkpJUWob3svaP,True,158008535,39502133,102992,51496,51496,C4UnXuShCvjSMgBAgVNMy1oakxCNk1et27A82fywU112,4119704,31631702,-27511998,260
2022-05-09 11:33:36-04:00,20212,HXQXfEQe7aCpr6WKh37XaDZsjZcuQPk5t8tWNFgEoK6U,5ufXkCEDwgiXwtyPye4wYVVA3oLW54JVzz4tnXFofto4,True,252046734,63011683,160580,80290,80290,72FwbpFGoLEazJEdpqNtPNefsadUrimUqma9wSoy4qiS,6423223,124730850,-118307627,254
2022-05-09 11:33:43-04:00,20213,3RpbaFEL5ZYrQBPpaAeCUXs43Ssdr5Tm4ScMGtp6XbYF,CpKGwcVZrd3vKTNhdF8xNsd77FT3QxQWb7xFQxiyPB5p,True,661627634,165406908,1002072,501036,501036,C4UnXuShCvjSMgBAgVNMy1oakxCNk1et27A82fywU112,40082913,346648381,-306565468,605
2022-05-09 11:33:43-04:00,20214,DvSVpLMQyz91ksMwhuwwFDiKMo53FC5FVG5XrQZYWurJ,5jL2cYHg1QQpWYRCF4f378jpeHnTfPMWXiiHuhLNbzq8,False,24507894,24507894,961792,48089,913703,C4UnXuShCvjSMgBAgVNMy1oakxCNk1et27A82fywU112,961795,8679584,-7717789,392
2022-05-09 11:33:44-04:00,20215,A7j77tzgnQVGtHTa65VtVZqJRYeJvQk7am8NW6e66379,4vJGwEvXU2tGWoWWGwbsYcfKQAMCHbrBMRk4ZVFzneLs,True,202541009,50635252,137596,68798,68798,47z82br5WdW2DZajdnPDPSSRRKsyAggqXqK6oPUwTaLf,5503842,70299259,-64795417,271
2022-05-09 11:33:49-04:00,20216,H8P77smmiLj1vtt7hoSjf2vmcnBdW4rsgCtagtXZg6yy,3FxygrzNpSWivjLU3CumYif6rXhSzyjLqdKiyvphDnnc,True,30121460,1438603,6004,3002,3002,Hu94aiQWvce6THeGyCFqGRPM1pQrK3ihzkcXo1EpJcJL,1257280,10270645,-9013365,417
2022-05-09 11:33:51-04:00,20217,G6KNZdFV14LDXQfW6w54nXF3Ay3jWcSZsGonoFWMcRo4,8vP5gsK1yDTo9gXbkdqB1CmeSUJzHvALWVDnLMBvKohh,False,498331,498331,12033,601,11432,C5o4TfkUfECutAWsDELjhsZX6PYyYgK3XeKvx6p4FphM,12033,113841,-101808,241
2022-05-09 11:33:57-04:00,20218,BTXpvCdmYEmg5fB2Hsjc6Wked2sky4oQpGu7r8KuPau4,CaEwxQQds9f44npaSrYAsC6WpE3T6MpAGr9jgXZeqWjA,True,49573433,4605441,17790,8895,8895,8sEswn3kzEhnYjAZVvCQnHEUvYd7pFVvc2Xc2Kd1BpbC,1914973,15076816,-13161843,386
2022-05-09 11:34:03-04:00,20219,GdUWbwTgHF1RRbpVXCahz36G7MqYrM6QaBgnjL2eLKxk,JDYxQpYMt38mmjzLrVjgi3ezpc3DQ8YJEtJTZbG6fCCq,False,24502450,24502450,951169,47558,903611,C4UnXuShCvjSMgBAgVNMy1oakxCNk1et27A82fywU112,951171,8678301,-7727130,388
2022-05-09 11:34:04-04:00,20220,7BEY9qatFJomsayFmky3h3dAbKhY5XkRGwMobJuxXYhQ,J8MK3tAQKreBUG2reXY6gqr1uhbHhcAZEcxsLQmG5Ntt,True,248371577,62092894,441766,220883,220883,C4UnXuShCvjSMgBAgVNMy1oakxCNk1et27A82fywU112,17670649,105255503,-87584854,711
2022-05-09 11:34:04-04:00,20221,HqYTrtcvEwiJ7d5SsDEm36v6EC4shj2aXwJ7cUsfAP7t,5qxQvw4H3bbz2hebgt5vqEqANN1u96dsDVXUw1nGH21y,False,10689842,10689842,312489,15624,296865,C4UnXuShCvjSMgBAgVNMy1oakxCNk1et27A82fywU112,312489,4137747,-3825258,292
2022-05-09 11:34:04-04:00,20222,5euvq1j9LCJWT1K7xKAE2TjwzbrWA5t6j2SxtnWsEPeU,GKDnouGNzg5JkjWG7Qs4nmka6qUMdYrk1fKwrmj8TvdH,True,30067192,1434036,5866,2933,2933,72FwbpFGoLEazJEdpqNtPNefsadUrimUqma9wSoy4qiS,1230080,10291865,-9061785,409
2022-05-09 11:34:04-04:00,20223,7tFD53kPTqrzjCu1Wji78gUqhoRtCUhsP1pM3DQKT7uG,BJvgPLYBDJrQJdQVowrsMwUGMurq4zTihoFwWoEokfu3,True,57162403,8076391,22937,11468,11469,72FwbpFGoLEazJEdpqNtPNefsadUrimUqma9wSoy4qiS,1623488,17372067,-15748579,284
2022-05-09 11:34:04-04:00,20224,Ejg8vXVsro4jB2fpdUUXCRfKTiE5TUwfRXhHeR8qtrEi,GnF7xwsjzso48ZEAdYYuxNkJso7ug3s46uogi4XDbs1,True,189560121,47390030,128472,64236,64236,C4UnXuShCvjSMgBAgVNMy1oakxCNk1et27A82fywU112,5138914,53309759,-48170845,271
2022-05-09 11:34:04-04:00,20225,HeyRAEkqGTtCj2cMfGR6pbeY5nu4qERFmZSovsfhUtaq,5MDbdhQUt3USB1RFmdLsrAc5UUXZ1n8jXRQFtJ6ibj9B,True,62598289,4100189,18881,9440,9441,C4UnXuShCvjSMgBAgVNMy1oakxCNk1et27A82fywU112,2882660,20284535,-17401875,460
2022-05-09 11:34:05-04:00,20226,DFwXGj2nQLtLWa17ULafmGpXKYVAPLXcA5UsspsJxHHk,EF1TThnkdmwqoq5Z2PHKAcG4pALWnfJv9TUUAzWRw237,False,8962942,8962942,256937,12846,244091,C4UnXuShCvjSMgBAgVNMy1oakxCNk1et27A82fywU112,256937,3439095,-3182158,286
2022-05-09 11:34:09-04:00,20227,442usWu6XpJZvU25bqXeynRrQ15jAzWwU9DWMgHpTn3Q,CtvADKp39bjJf3cPKWNL3wxnhq273fVM4fC5DmEcg5cC,True,35771205,8942801,55860,27930,27930,Hu94aiQWvce6THeGyCFqGRPM1pQrK3ihzkcXo1EpJcJL,2234420,6837172,-4602752,624
2022-05-09 11:34:10-04:00,20228,DSyY2vhRYsrr8nHY851jBrw3vLGU9NbEWp4camZfXsgz,6aTvQYJi3kPFtat6vVG9z7sfeJ9ExAormhmG2KaBJx7o,False,13925584,13925584,410364,20518,389846,3zqXX6kzhkbW3d4TwD2CNjMRwxTbREXySekvq37kfCNk,410364,6550280,-6139916,294
2022-05-09 11:34:18-04:00,20229,AzJddnjvgnB3BbZ6yQrqNdS8LTTAKebgAh34FgNdvRMV,2AA9UbmYUnkwsZvk4nSTxxtE3d2AiPL9d4nSDCUx8jsu,False,44530,44530,1004,50,954,2a35JJeTUW1pm6M3e8DHCjp8qr4vbc2cRPhuzZWyFzYd,1004,18143,-17139,225
2022-05-09 11:34:24-04:00,20230,H7rsFRRhZPe2jLex2NkbYYzVtLobvFiqnCd4BUyJVPBB,8bedwDRfSKLP9vUxoXcpHNJzWQemMaf4QGT2mtHFVJFb,False,26756863,26756863,689858,34492,655366,6L1WYrPiCMyi7XemPww4B4hvpKD1LQKD4RpiSKmrmgSC,689858,3382433,-2692575,257
2022-05-09 11:34:24-04:00,20231,FSonJL6JzKgaZG6C3qp7H8UQYrfWRsuDmbHkrwTHZgYd,6kZCMcaUrPmPQafMUSivWavmDwEmVdvF7N7hyRXb34bw,True,50937023,12734255,38083,19041,19042,72FwbpFGoLEazJEdpqNtPNefsadUrimUqma9wSoy4qiS,1523333,12449188,-10925855,299
2022-05-09 11:34:25-04:00,20232,DLwEaZipqHmVBD5hc5v1NZtDStHyG4hAMwxywDTGGc2e,28GtwJw67UWfrSKxtuvpzoKzPyKXLgP3GKLm3fHdR566,True,46104056,11526014,70886,35443,35443,8sEswn3kzEhnYjAZVvCQnHEUvYd7pFVvc2Xc2Kd1BpbC,2835457,23932927,-21097470,615
2022-05-09 11:34:26-04:00,20233,8T4WK27RvWVGqPuNqY6whk1fmU4vd5qaUQPZG1GJ79bh,DvSz7knS8N3K7L6JhQf1s4mJSyxB8uJXNQXtyjJn8QRL,True,144284497,34637598,106790,53395,53395,72FwbpFGoLEazJEdpqNtPNefsadUrimUqma9wSoy4qiS,4448419,27970488,-23522069,308
2022-05-09 11:34:29-04:00,20234,EEQmHFk3WFNmPfe7ujtP1PK6P5yqV5mmWumNSoTu45P8,FG9DScQDQPrgcmBbRugZ5NfhSTRMnKSWLxcUeTF9MgJZ,True,154008374,38502093,108080,54040,54040,68sueyVfmy5ToEGtLFGDkwebX47xAmzyXE29z8JrmcWv,4323236,28911097,-24587861,280
2022-05-09 11:35:02-04:00,20235,CMVVfXQYALSc58NLD67L8YrJAbDHZ9rFZvYQC7r8Png4,44pytMX14zaEQv6aRQ223CxYB2uTP7VUTQfUY58EkaNB,True,61052521,15263130,45791,22895,22896,68sueyVfmy5ToEGtLFGDkwebX47xAmzyXE29z8JrmcWv,1831653,29900027,-28068374,300
2022-05-09 11:35:12-04:00,20236,4oMasDRj8HWfknmdwt6Mkz3eonr8J2byoiSTRo4sCnFQ,3emcATkEFvDVETiK97eVET2Z2jzkgiiSxX3gu5wsUKPe,True,317794585,38557616,255675,127837,127838,72FwbpFGoLEazJEdpqNtPNefsadUrimUqma9wSoy4qiS,21072964,199672102,-178599138,663
2022-05-09 11:35:12-04:00,20237,BEATjyYuro1xc1kbgBoxBnVEk3usoUk9qwmdRndXdYW5,9RGBffhSMgab1KCM6dMvwiBENbnp5pERfCEjw4q5ckFS,True,111863380,27965845,194778,97389,97389,C4UnXuShCvjSMgBAgVNMy1oakxCNk1et27A82fywU112,7791156,36844263,-29053107,696
2022-05-09 11:35:12-04:00,20238,4hZG7dM716SxDagiFGwt1gSC99B2QK1emGLV9TJmmuR8,7vjfUWySkyx4Z5qAaRr2VWnVvxHHNsvPj1PirGNSjM6,True,19587193,4896798,29980,14990,14990,47z82br5WdW2DZajdnPDPSSRRKsyAggqXqK6oPUwTaLf,1199230,19323190,-18123960,612
2022-05-09 11:35:52-04:00,20239,4Siq98BDakELWP5BzVoEN5tcg1ywRxTYs1aUcfW8spCt,2EBXLTVz1Gk9gS5JcVqCKAP5PatFGw1Vnww65Moz3SUn,True,17409188,4352297,27199,13599,13600,8sEswn3kzEhnYjAZVvCQnHEUvYd7pFVvc2Xc2Kd1BpbC,1087984,10485814,-9397830,624
2022-05-09 11:36:33-04:00,20240,Fn6J1eMQJoA5rXCwX2HjAF86AowsJfULLuYXVfzgb8aX,6Ett2WPmz4HoWVSVEZD73UzFetd3oFSh7C676MEVYd36,True,26078096,6519524,39744,19872,19872,2a35JJeTUW1pm6M3e8DHCjp8qr4vbc2cRPhuzZWyFzYd,1589771,16429703,-14839932,609
2022-05-09 11:36:39-04:00,20241,Gw37fsD8M3AaZ22tSx9WeszxsAkWQ6Ap2XV3zXYhe3EJ,FbKeJsWR5ggVBy1R5sxNiWz5GAsxeyZD8nmyk5yCBqSz,True,33664230,8416057,59854,29927,29927,C5o4TfkUfECutAWsDELjhsZX6PYyYgK3XeKvx6p4FphM,2394196,14955288,-12561092,711
2022-05-09 11:36:50-04:00,20242,CXppCp4b4npkAzw175YNy6Ei8nF7jCmNbqsbVosHS6fE,FSEchHNYxt7WdBYjyuS2Ft2yUnfk56TCkY8SXdSs8hfe,True,27283721,6820930,42404,21202,21202,C4UnXuShCvjSMgBAgVNMy1oakxCNk1et27A82fywU112,1696176,20361050,-18664874,621
2022-05-09 11:43:09-04:00,20243,6HtdpTubfGUuwW6rympMFLyUsdELKDpYagmkErBdLGc6,7e6N7pnwFYx9kU2TXJWt9gCsCpUZTxnFKzjDNZeyWQyq,True,32327489,8081872,49966,24983,24983,8sEswn3kzEhnYjAZVvCQnHEUvYd7pFVvc2Xc2Kd1BpbC,1998660,9003307,-7004647,618
2022-05-09 11:44:01-04:00,20244,532MfQR1PzPn6cmC1kpZsz9MyBWSamSeieh1F6GqVY33,6sJ8XXMZzGbHjVU1vWNW8unWoBZhJa54GguYJQhcb8PA,True,1064804662,150772621,1000286,500143,500143,8sEswn3kzEhnYjAZVvCQnHEUvYd7pFVvc2Xc2Kd1BpbC,70643459,219815963,-149172504,663
2022-05-09 11:44:29-04:00,20245,7GpG8k6hM27vK1R5Sx1v5xUBuF6vybP41dcymjXDi5P7,7Aip6HDcbZ5mvoSucNupRS9enRdGx37F8L432K7V81do,True,57508205,14377051,89292,44646,44646,2a35JJeTUW1pm6M3e8DHCjp8qr4vbc2cRPhuzZWyFzYd,3571690,42075903,-38504213,621
2022-05-09 11:49:54-04:00,20246,4oMasDRj8HWfknmdwt6Mkz3eonr8J2byoiSTRo4sCnFQ,3emcATkEFvDVETiK97eVET2Z2jzkgiiSxX3gu5wsUKPe,True,276633718,40253404,265034,132517,132517,8sEswn3kzEhnYjAZVvCQnHEUvYd7pFVvc2Xc2Kd1BpbC,18214038,176862742,-158648704,658
2022-05-09 11:50:02-04:00,20247,648dg79UazWHnwQ9p4kxQdcRXPhc21377kEQnSPssvfz,3d12WWiYbtie5eEyJjqTiLfyR82oQPdaQV2HdVH5d4AK,True,16117847,4029461,25104,12552,12552,Hu94aiQWvce6THeGyCFqGRPM1pQrK3ihzkcXo1EpJcJL,1004194,16527186,-15522992,623
2022-05-09 11:50:23-04:00,20248,EVMrznfJS54BZiywDD2WhUtxzicDtbEpm2a5yLrtCgRF,CpzsMYVYvKg8ihrX1cKRw7TDEYwD3kAyiX92hsf2KiTz,True,217792691,14456591,67698,33849,33849,Hu94aiQWvce6THeGyCFqGRPM1pQrK3ihzkcXo1EpJcJL,10198992,161819881,-151620889,468
2022-05-09 11:50:29-04:00,20249,532MfQR1PzPn6cmC1kpZsz9MyBWSamSeieh1F6GqVY33,6sJ8XXMZzGbHjVU1vWNW8unWoBZhJa54GguYJQhcb8PA,True,904004985,114077788,752304,376152,376152,A9TwRM1BMxqb8DCC7YNAMV6zPenEJm3HTZBy7wJKK58U,59616117,195746991,-136130874,659
2022-05-09 11:50:57-04:00,20250,HooxSzasW3HMoFJ6sAvRQ75Char1J5aBdJtsqfDV6myp,BCmsWwpGeV4NNfeKZKKydty2uueLGHYTJDk1WErpXsVT,True,70592202,17648050,108856,54428,54428,8sEswn3kzEhnYjAZVvCQnHEUvYd7pFVvc2Xc2Kd1BpbC,4354272,26697825,-22343553,616
2022-05-09 12:03:59-04:00,20251,8sQzUoiFfBUsfVKdUjUh3xUjwnaCP1Qmw9BGwtH768ZR,8wZxijgcyRwqxiRKMMZhoREAb6iHhRGCgjgZRd5Yp6RP,True,251027122,62756780,444562,222281,222281,2a35JJeTUW1pm6M3e8DHCjp8qr4vbc2cRPhuzZWyFzYd,17782495,113640462,-95857967,708
2022-05-09 12:04:15-04:00,20252,9Ngb4UJjvSm9zbTN4RYRFWBzTPVWQh7C2hFiDvwPsDBd,EamTKaoTYJo9RUMQC7MjS1HJrVPYipR2cv6nYpgBLnPr,False,24321665,24321665,735714,36785,698929,2a35JJeTUW1pm6M3e8DHCjp8qr4vbc2cRPhuzZWyFzYd,735715,16250394,-15514679,302
2022-05-09 12:04:15-04:00,20253,GCweck6iuscBsVbXW9ZYfMytdgwSYWwNifTWLaUbaSmA,6HwGWKGduMGvLnHmTJo6ZioZ3EMUZYHo2pG4tBFXgB4Y,True,21831901,5457975,38798,19399,19399,C4UnXuShCvjSMgBAgVNMy1oakxCNk1et27A82fywU112,1551931,10455887,-8903956,710
2022-05-09 12:04:15-04:00,20254,7qEVqFr1naSPCDV9q3xx6KMZn1yCHvkHZJkaA46NLmSE,8Mohcixq2L9PYrHpb95vuEsXqJ18JhEHi3RA83VM9cLv,True,50576567,12644141,37962,18981,18981,C4UnXuShCvjSMgBAgVNMy1oakxCNk1et27A82fywU112,1518502,20513494,-18994992,300
2022-05-09 12:04:49-04:00,20255,EHLV9s6E1s5SUbzZVzsGWH2vVRGHyxynM4GDJtfKEuYe,4hAx9osegpeocSSmJbMVBYMKCwo5WY3QVJuK7cuzz4b4,True,21796859,5449214,38340,19170,19170,2a35JJeTUW1pm6M3e8DHCjp8qr4vbc2cRPhuzZWyFzYd,1533622,10472710,-8939088,703
2022-05-09 12:04:56-04:00,20256,4oMasDRj8HWfknmdwt6Mkz3eonr8J2byoiSTRo4sCnFQ,3emcATkEFvDVETiK97eVET2Z2jzkgiiSxX3gu5wsUKPe,True,234073896,28378011,189417,94708,94709,8sEswn3kzEhnYjAZVvCQnHEUvYd7pFVvc2Xc2Kd1BpbC,15623980,153849541,-138225561,667
2022-05-09 12:06:17-04:00,20257,62q4KpVd3UXPomDaqpTF7recRAEh2ZKgWRgT92ztmda4,8xRdV8nWLb3CiCcHt2ZXEJv3NSfaa178zarhUkKv2rP9,True,27209565,2436412,9554,4777,4777,2a35JJeTUW1pm6M3e8DHCjp8qr4vbc2cRPhuzZWyFzYd,1067095,9110549,-8043454,392
2022-05-09 12:06:18-04:00,20258,DRVtEzZs9u9ysrcANZLEjrvbuuGqYn77v2h4cDFKuNUx,Fv9qiMZhuSBL2cs9AWUYbDLQjB46W2ZwrhxaNXtPLDpC,True,4689672703,1172418175,3530413,1765206,1765207,AmTrMPzuTp2BjnjqGNKqz9FTTCdpoKcPAJLwFc8ozcbh,141216532,513184908,-371968376,301
2022-05-09 12:10:02-04:00,20259,DLwEaZipqHmVBD5hc5v1NZtDStHyG4hAMwxywDTGGc2e,28GtwJw67UWfrSKxtuvpzoKzPyKXLgP3GKLm3fHdR566,True,33921347,8480336,52639,26319,26320,68sueyVfmy5ToEGtLFGDkwebX47xAmzyXE29z8JrmcWv,2105576,18585400,-16479824,620
2022-05-09 12:10:21-04:00,20260,442usWu6XpJZvU25bqXeynRrQ15jAzWwU9DWMgHpTn3Q,CtvADKp39bjJf3cPKWNL3wxnhq273fVM4fC5DmEcg5cC,True,26292954,6573238,41033,20516,20517,Hu94aiQWvce6THeGyCFqGRPM1pQrK3ihzkcXo1EpJcJL,1641327,5628854,-3987527,624
2022-05-09 12:26:11-04:00,20261,BEATjyYuro1xc1kbgBoxBnVEk3usoUk9qwmdRndXdYW5,9RGBffhSMgab1KCM6dMvwiBENbnp5pERfCEjw4q5ckFS,True,82065021,20516255,143907,71953,71954,8sEswn3kzEhnYjAZVvCQnHEUvYd7pFVvc2Xc2Kd1BpbC,5756288,29380232,-23623944,701
2022-05-09 12:26:14-04:00,20262,Gw37fsD8M3AaZ22tSx9WeszxsAkWQ6Ap2XV3zXYhe3EJ,FbKeJsWR5ggVBy1R5sxNiWz5GAsxeyZD8nmyk5yCBqSz,True,24649675,6162418,43339,21669,21670,6L1WYrPiCMyi7XemPww4B4hvpKD1LQKD4RpiSKmrmgSC,1733569,11753045,-10019476,703
2022-05-09 12:28:11-04:00,20263,532MfQR1PzPn6cmC1kpZsz9MyBWSamSeieh1F6GqVY33,6sJ8XXMZzGbHjVU1vWNW8unWoBZhJa54GguYJQhcb8PA,True,783016325,111864738,741341,370670,370671,A9TwRM1BMxqb8DCC7YNAMV6zPenEJm3HTZBy7wJKK58U,51891498,179385614,-127494116,662
2022-05-09 12:30:28-04:00,20264,7qxGLMg6ZAxkVjhuj2PY6a5F36k4Efo3aCa99kvTpSKw,wgWcmEebBLbcm9a2jyCiw8nzqbGbfj6zRou4ZZhfWp7,True,57112376,5541644,25519,12759,12760,2a35JJeTUW1pm6M3e8DHCjp8qr4vbc2cRPhuzZWyFzYd,2630097,6039713,-3409616,460
2022-05-09 12:31:03-04:00,20265,Fn6J1eMQJoA5rXCwX2HjAF86AowsJfULLuYXVfzgb8aX,6Ett2WPmz4HoWVSVEZD73UzFetd3oFSh7C676MEVYd36,True,19210377,4802594,30013,15006,15007,Hu94aiQWvce6THeGyCFqGRPM1pQrK3ihzkcXo1EpJcJL,1200528,12678682,-11478154,624
2022-05-09 12:31:04-04:00,20266,4Siq98BDakELWP5BzVoEN5tcg1ywRxTYs1aUcfW8spCt,2EBXLTVz1Gk9gS5JcVqCKAP5PatFGw1Vnww65Moz3SUn,False,12796628,12796628,799654,39982,759672,Hu94aiQWvce6THeGyCFqGRPM1pQrK3ihzkcXo1EpJcJL,799654,8108294,-7308640,624
2022-05-09 12:32:18-04:00,20267,8sQzUoiFfBUsfVKdUjUh3xUjwnaCP1Qmw9BGwtH768ZR,8wZxijgcyRwqxiRKMMZhoREAb6iHhRGCgjgZRd5Yp6RP,True,183983993,45995998,326289,163144,163145,2a35JJeTUW1pm6M3e8DHCjp8qr4vbc2cRPhuzZWyFzYd,13051584,89240305,-76188721,709
2022-05-09 12:32:19-04:00,20268,4oMasDRj8HWfknmdwt6Mkz3eonr8J2byoiSTRo4sCnFQ,3emcATkEFvDVETiK97eVET2Z2jzkgiiSxX3gu5wsUKPe,True,203639080,30004267,197107,98553,98554,Hu94aiQWvce6THeGyCFqGRPM1pQrK3ihzkcXo1EpJcJL,13377758,136202966,-122825208,656
2022-05-09 12:32:55-04:00,20269,CXppCp4b4npkAzw175YNy6Ei8nF7jCmNbqsbVosHS6fE,FSEchHNYxt7WdBYjyuS2Ft2yUnfk56TCkY8SXdSs8hfe,True,20044398,5011099,30850,15425,15425,6L1WYrPiCMyi7XemPww4B4hvpKD1LQKD4RpiSKmrmgSC,1234014,15651074,-14417060,615
2022-05-09 12:34:08-04:00,20270,6HtdpTubfGUuwW6rympMFLyUsdELKDpYagmkErBdLGc6,7e6N7pnwFYx9kU2TXJWt9gCsCpUZTxnFKzjDNZeyWQyq,True,23780537,5945134,37049,18524,18525,2a35JJeTUW1pm6M3e8DHCjp8qr4vbc2cRPhuzZWyFzYd,1481990,7200566,-5718576,623
2022-05-09 12:34:31-04:00,20271,7GpG8k6hM27vK1R5Sx1v5xUBuF6vybP41dcymjXDi5P7,7Aip6HDcbZ5mvoSucNupRS9enRdGx37F8L432K7V81do,True,42279678,10569919,65700,32850,32850,Hu94aiQWvce6THeGyCFqGRPM1pQrK3ihzkcXo1EpJcJL,2628028,32357711,-29729683,621
2022-05-09 12:34:50-04:00,20272,532MfQR1PzPn6cmC1kpZsz9MyBWSamSeieh1F6GqVY33,6sJ8XXMZzGbHjVU1vWNW8unWoBZhJa54GguYJQhcb8PA,True,664476059,83123666,556361,278180,278181,6L1WYrPiCMyi7XemPww4B4hvpKD1LQKD4RpiSKmrmgSC,44474629,160126498,-115651869,669
2022-05-09 12:36:13-04:00,20273,3AaMzK9WAbD9m27szcJYnucnSPQ4W7tk8EztgWv4vqUo,8oUBQUKo9wHLu1tUEF1AeCUa7oRYyDSoFNRMqQAqKMbH,True,28603590,1288975,5220,2610,2610,C4UnXuShCvjSMgBAgVNMy1oakxCNk1et27A82fywU112,1158505,9471287,-8312782,405
2022-05-09 12:36:16-04:00,20274,H8P77smmiLj1vtt7hoSjf2vmcnBdW4rsgCtagtXZg6yy,3FxygrzNpSWivjLU3CumYif6rXhSzyjLqdKiyvphDnnc,True,28596857,1288319,5240,2620,2620,8sEswn3kzEhnYjAZVvCQnHEUvYd7pFVvc2Xc2Kd1BpbC,1163185,9486307,-8323122,406
2022-05-09 12:36:19-04:00,20275,5euvq1j9LCJWT1K7xKAE2TjwzbrWA5t6j2SxtnWsEPeU,GKDnouGNzg5JkjWG7Qs4nmka6qUMdYrk1fKwrmj8TvdH,True,28557881,1288968,5176,2588,2588,68sueyVfmy5ToEGtLFGDkwebX47xAmzyXE29z8JrmcWv,1146850,9503101,-8356251,401
2022-05-09 12:36:26-04:00,20276,3Xbsek5MsEGoWr3G9yhuohREr26B2vSQcjqXdspTFHta,2rPxkUiMo9wGDq8EvAiwY3ngRpKmL223cBWWNTYoBmFp,True,192085555,48021388,145129,72564,72565,5HnvdJnCCcmRsm4GkXnYWd4q9RpwuvYDGEUMPkYR3Ts9,5805166,25956342,-20151176,302
2022-05-09 12:36:35-04:00,20277,62q4KpVd3UXPomDaqpTF7recRAEh2ZKgWRgT92ztmda4,8xRdV8nWLb3CiCcHt2ZXEJv3NSfaa178zarhUkKv2rP9,True,24719214,2352259,9550,4775,4775,8sEswn3kzEhnYjAZVvCQnHEUvYd7pFVvc2Xc2Kd1BpbC,1003602,8584280,-7580678,406
2022-05-09 12:36:45-04:00,20278,GCweck6iuscBsVbXW9ZYfMytdgwSYWwNifTWLaUbaSmA,6HwGWKGduMGvLnHmTJo6ZioZ3EMUZYHo2pG4tBFXgB4Y,True,15990839,3997709,28251,14125,14126,68sueyVfmy5ToEGtLFGDkwebX47xAmzyXE29z8JrmcWv,1130046,8191170,-7061124,706
2022-05-09 12:36:51-04:00,20279,DAawvqmcjnThXxJzsp7ExW1bhGaRGRxLgG6h85HpGAN5,2KRCBiCQoQd2fDSS1e2U19WVddWAqM6EPkqK8rZwaRNh,False,28608574,28608574,855804,42790,813014,5HnvdJnCCcmRsm4GkXnYWd4q9RpwuvYDGEUMPkYR3Ts9,855804,34098434,-33242630,299
2022-05-09 12:37:04-04:00,20280,GNohZMtk1VAuhLAgNGT8J3HYCKDCiyjvLeAWr64d7Duy,6soTLVj9DzFht8DzvjRfNPAWhZuiDBS5fDE1fpeuDSSz,False,11952548,11952548,737790,36889,700901,Hu94aiQWvce6THeGyCFqGRPM1pQrK3ihzkcXo1EpJcJL,737790,9432024,-8694234,617
2022-05-09 12:37:12-04:00,20281,5xkW7wHTcF5WadNtBBqKPKctVwyQtTqqscivAmxzseCk,7m31ZMZdCn5Gz2q5sETWA7uKA5LsKD7pJHBBqU3g7tCn,True,278103851,69525962,209118,104559,104559,8sEswn3kzEhnYjAZVvCQnHEUvYd7pFVvc2Xc2Kd1BpbC,8364751,51891900,-43527149,300
2022-05-09 12:37:23-04:00,20282,HXQXfEQe7aCpr6WKh37XaDZsjZcuQPk5t8tWNFgEoK6U,5ufXkCEDwgiXwtyPye4wYVVA3oLW54JVzz4tnXFofto4,True,188398461,47099615,140341,70170,70171,68sueyVfmy5ToEGtLFGDkwebX47xAmzyXE29z8JrmcWv,5613675,94981838,-89368163,297
2022-05-09 12:37:29-04:00,20283,EVMrznfJS54BZiywDD2WhUtxzicDtbEpm2a5yLrtCgRF,CpzsMYVYvKg8ihrX1cKRw7TDEYwD3kAyiX92hsf2KiTz,True,202267894,13566023,60625,30312,30313,2a35JJeTUW1pm6M3e8DHCjp8qr4vbc2cRPhuzZWyFzYd,9039157,146771791,-137732634,446
2022-05-09 12:37:29-04:00,20284,8L2s5h1hSU79naWcS7cvT3oxiPL6ofTDWmqTK1S4F99g,32DYf6ArTTcNwokJrbhHT1QGe4pZ9z29oPdw97aDR7AQ,True,68625550,17156387,48037,24018,24019,Hu94aiQWvce6THeGyCFqGRPM1pQrK3ihzkcXo1EpJcJL,1921498,68034188,-66112690,279
2022-05-09 12:37:29-04:00,20285,9L2rA8qtfvjKMzqtLn9Cc9Y3ih1e8Z3w9huDzyZXg1xk,GopCtogALLkVyW1T3FGofVWMmjnsdG6EkpJUWob3svaP,True,117825023,29456255,83189,41594,41595,8sEswn3kzEhnYjAZVvCQnHEUvYd7pFVvc2Xc2Kd1BpbC,3327573,24643219,-21315646,282
2022-05-09 12:37:31-04:00,20286,3wGWQm5bPRFaZ4Uhp3N2PYowdQx5FE8iHMXicCZFNTTD,FyZSncTmnYZA5oRZihMRwnP9mLaWai9mRQ5BseNpiQXJ,True,53199021,13299755,38113,19056,19057,Hu94aiQWvce6THeGyCFqGRPM1pQrK3ihzkcXo1EpJcJL,1524538,28325517,-26800979,286
2022-05-09 12:37:33-04:00,20287,5g5EaEMiM2WQcfDpL3R3caYziX9xvGCFs9eVmmQdcgzS,J71CftCqiK1873fkVx9NGc7v7nvRZMYVBkGN3GhSPyeX,False,10447492,10447492,740057,37002,703055,2a35JJeTUW1pm6M3e8DHCjp8qr4vbc2cRPhuzZWyFzYd,740057,4923871,-4183814,708
2022-05-09 12:37:34-04:00,20288,5euvq1j9LCJWT1K7xKAE2TjwzbrWA5t6j2SxtnWsEPeU,GKDnouGNzg5JkjWG7Qs4nmka6qUMdYrk1fKwrmj8TvdH,True,27192936,2437013,9550,4775,4775,8sEswn3kzEhnYjAZVvCQnHEUvYd7pFVvc2Xc2Kd1BpbC,1065697,9125754,-8060057,391
2022-05-09 12:37:34-04:00,20289,A7j77tzgnQVGtHTa65VtVZqJRYeJvQk7am8NW6e66379,4vJGwEvXU2tGWoWWGwbsYcfKQAMCHbrBMRk4ZVFzneLs,True,151033304,37758326,112096,56048,56048,C4UnXuShCvjSMgBAgVNMy1oakxCNk1et27A82fywU112,4483846,53953357,-49469511,296
2022-05-09 12:37:37-04:00,20290,4rVW5SPBGcoxE3wAnjbULgZm4xdHXtqhivrszp9W4YP7,Fzu9D4KRKhAF7p22sNqMybe11zGwuXVe58iSt32MbfYX,True,36703090,9175772,26905,13452,13453,C4UnXuShCvjSMgBAgVNMy1oakxCNk1et27A82fywU112,1076203,12150647,-11074444,293
2022-05-09 12:37:37-04:00,20291,BAkPsWHtpVcEGqUgKTKjwZ6d5aaUcaUhdgYxBnpSTDW2,BDwDmVaZnXh22sf8nsDtjVfgxMAswbM3PW3si3k4nbRK,True,41531868,10382967,29888,14944,14944,8sEswn3kzEhnYjAZVvCQnHEUvYd7pFVvc2Xc2Kd1BpbC,1195536,20022118,-18826582,287
2022-05-09 12:37:37-04:00,20292,3AaMzK9WAbD9m27szcJYnucnSPQ4W7tk8EztgWv4vqUo,8oUBQUKo9wHLu1tUEF1AeCUa7oRYyDSoFNRMqQAqKMbH,True,27221768,2442283,9513,4756,4757,Hu94aiQWvce6THeGyCFqGRPM1pQrK3ihzkcXo1EpJcJL,1060438,9093903,-8033465,389
2022-05-09 12:37:38-04:00,20293,Ejg8vXVsro4jB2fpdUUXCRfKTiE5TUwfRXhHeR8qtrEi,GnF7xwsjzso48ZEAdYYuxNkJso7ug3s46uogi4XDbs1,True,141353363,35338340,104610,52305,52305,C4UnXuShCvjSMgBAgVNMy1oakxCNk1et27A82fywU112,4184405,41129679,-36945274,296
2022-05-09 12:37:41-04:00,20294,62q4KpVd3UXPomDaqpTF7recRAEh2ZKgWRgT92ztmda4,8xRdV8nWLb3CiCcHt2ZXEJv3NSfaa178zarhUkKv2rP9,False,22302163,22302163,929258,46462,882796,6L1WYrPiCMyi7XemPww4B4hvpKD1LQKD4RpiSKmrmgSC,929260,7973858,-7044598,416
2022-05-09 12:37:41-04:00,20295,BTXpvCdmYEmg5fB2Hsjc6Wked2sky4oQpGu7r8KuPau4,CaEwxQQds9f44npaSrYAsC6WpE3T6MpAGr9jgXZeqWjA,True,44879498,4180290,16821,8410,8411,8sEswn3kzEhnYjAZVvCQnHEUvYd7pFVvc2Xc2Kd1BpbC,1806006,14408179,-12602173,402
2022-05-09 12:37:41-04:00,20296,H8P77smmiLj1vtt7hoSjf2vmcnBdW4rsgCtagtXZg6yy,3FxygrzNpSWivjLU3CumYif6rXhSzyjLqdKiyvphDnnc,True,27222067,2439550,9601,4800,4801,8sEswn3kzEhnYjAZVvCQnHEUvYd7pFVvc2Xc2Kd1BpbC,1071474,9108075,-8036601,393
2022-05-09 12:37:43-04:00,20297,CMVVfXQYALSc58NLD67L8YrJAbDHZ9rFZvYQC7r8Png4,44pytMX14zaEQv6aRQ223CxYB2uTP7VUTQfUY58EkaNB,True,45311764,11327941,32631,16315,16316,Hu94aiQWvce6THeGyCFqGRPM1pQrK3ihzkcXo1EpJcJL,1305250,22834208,-21528958,288
2022-05-09 12:37:43-04:00,20298,9W8Yg4m3sZdftPxmdoccuQetkc785sNY54WwAZYJ21rC,8Dzp1tYVTyvZJioXEfh57LVHz4a7HwcGnwdgqTjGgRhX,False,27674631,27674631,837278,41863,795415,8sEswn3kzEhnYjAZVvCQnHEUvYd7pFVvc2Xc2Kd1BpbC,837278,6240225,-5402947,302
2022-05-09 12:37:48-04:00,20299,GCNi25P1Ywvfx5JpyxFVV68sRkio7LEhFgY85ZqveKR3,34mxz8fCss7KNAbEi2Wj9z5dTgXCGxuq2vyqzBPChtmq,True,2078323987,519580996,1566305,783152,783153,5HnvdJnCCcmRsm4GkXnYWd4q9RpwuvYDGEUMPkYR3Ts9,62652205,788899116,-726246911,301
2022-05-09 12:37:48-04:00,20300,2tPYXtNrw134ACVhkYdnG9FGT4iHm61PuX8L7AfG9aAT,EyyPLVdjgewzVDKePQUj85BBttWy4MixVr9CSD8JVbrP,True,145287008,36321752,108952,54476,54476,8sEswn3kzEhnYjAZVvCQnHEUvYd7pFVvc2Xc2Kd1BpbC,4358098,72627454,-68269356,299
2022-05-09 12:37:56-04:00,20301,A2gRXnnsmLvMSzZray4DJdn7dgsrZwwK8uxqnajnyZHs,Gtwdm7MT23sMC9bucL12YD9LLjWftjzGso887FsatiuN,True,686136713,171534178,514842,257421,257421,6UQfSsLooL4pQKQfLtXCutQS2BnF7A7F7ewJopDLmUpc,20593699,92919062,-72325363,300
2022-05-09 12:37:58-04:00,20302,FU3fRyQxk6rwtD9Db1nTvTAjSwgSW9vi1q7SjZ92ijyM,7c3maBK3hpb1exxqcvnwiUfhhUBgLgCs5exANSZ7m494,True,58423758,14605939,43007,21503,21504,Hu94aiQWvce6THeGyCFqGRPM1pQrK3ihzkcXo1EpJcJL,1720289,10008942,-8288653,294
2022-05-09 12:38:04-04:00,20303,6pUtYz474QrpATEZnfb3iFbTKYA65pNyKAo4TQZAjtqe,8dipRUXvxJiDLdHEtCPkso4vErbVwshHQiRfvSngBS9J,True,167715056,13749336,47005,23502,23503,6L1WYrPiCMyi7XemPww4B4hvpKD1LQKD4RpiSKmrmgSC,5733814,122503814,-116770000,341
2022-05-09 12:38:05-04:00,20304,4oMasDRj8HWfknmdwt6Mkz3eonr8J2byoiSTRo4sCnFQ,3emcATkEFvDVETiK97eVET2Z2jzkgiiSxX3gu5wsUKPe,True,171889407,20849308,138703,69351,69352,Hu94aiQWvce6THeGyCFqGRPM1pQrK3ihzkcXo1EpJcJL,11435245,118772755,-107337510,665
2022-05-09 12:38:06-04:00,20305,EHLV9s6E1s5SUbzZVzsGWH2vVRGHyxynM4GDJtfKEuYe,4hAx9osegpeocSSmJbMVBYMKCwo5WY3QVJuK7cuzz4b4,True,15994106,3998526,28543,14271,14272,2a35JJeTUW1pm6M3e8DHCjp8qr4vbc2cRPhuzZWyFzYd,1141743,8199667,-7057924,713
2022-05-09 12:38:07-04:00,20306,EHi1UBG8wMUFZECktsFUZkGjJPaBNEedswS62hyYn6jC,Drx9ErQhAjnPuJ83LPYFnY5ZV5XDzGuXDuSf16VqWayp,True,223135153,12065112,44894,22447,22447,3zqXX6kzhkbW3d4TwD2CNjMRwxTbREXySekvq37kfCNk,8302961,160669229,-152366268,372
2022-05-09 12:38:11-04:00,20307,3AaMzK9WAbD9m27szcJYnucnSPQ4W7tk8EztgWv4vqUo,8oUBQUKo9wHLu1tUEF1AeCUa7oRYyDSoFNRMqQAqKMbH,False,24720948,24720948,992386,49619,942767,8sEswn3kzEhnYjAZVvCQnHEUvYd7pFVvc2Xc2Kd1BpbC,992388,8573545,-7581157,401
2022-05-09 12:38:11-04:00,20308,6xeNr9LhAfC6FRV62dALYdgx3bsoUpUpmEBiUPYCV5fz,8GP5cEpfNTEjvqm9usBUXs7jPCK5RciqjVJqtvX9fuGs,True,2102294854,525573713,1523704,761852,761852,8HQmsTbxhLhy25fvfCb16HudTGQ9wkHoEBRz5WYeqiZw,60948180,375091301,-314143121,289
2022-05-09 12:38:12-04:00,20309,5euvq1j9LCJWT1K7xKAE2TjwzbrWA5t6j2SxtnWsEPeU,GKDnouGNzg5JkjWG7Qs4nmka6qUMdYrk1fKwrmj8TvdH,False,24696450,24696450,996672,49833,946839,2a35JJeTUW1pm6M3e8DHCjp8qr4vbc2cRPhuzZWyFzYd,996674,8600091,-7603417,403
2022-05-09 12:38:14-04:00,20310,7qEVqFr1naSPCDV9q3xx6KMZn1yCHvkHZJkaA46NLmSE,8Mohcixq2L9PYrHpb95vuEsXqJ18JhEHi3RA83VM9cLv,True,37549803,9387450,27447,13723,13724,Hu94aiQWvce6THeGyCFqGRPM1pQrK3ihzkcXo1EpJcJL,1097917,15726817,-14628900,292
2022-05-09 12:38:16-04:00,20311,DLwEaZipqHmVBD5hc5v1NZtDStHyG4hAMwxywDTGGc2e,28GtwJw67UWfrSKxtuvpzoKzPyKXLgP3GKLm3fHdR566,True,24941167,6235291,38827,19413,19414,5HnvdJnCCcmRsm4GkXnYWd4q9RpwuvYDGEUMPkYR3Ts9,1553093,14412820,-12859727,622
2022-05-09 12:38:24-04:00,20312,GVCkrRYqcNoAj5ZvagTV8qkDpENZTvQXRNmwYY3RiLVq,XMybQNMD93SgC1hMynwVaUUEkn2NEB9UMAgx4fsfgtY,False,28148,28148,826,41,785,2a35JJeTUW1pm6M3e8DHCjp8qr4vbc2cRPhuzZWyFzYd,826,10056,-9230,293
2022-05-09 12:38:26-04:00,20313,442usWu6XpJZvU25bqXeynRrQ15jAzWwU9DWMgHpTn3Q,CtvADKp39bjJf3cPKWNL3wxnhq273fVM4fC5DmEcg5cC,True,19319988,4829997,30014,15007,15007,6L1WYrPiCMyi7XemPww4B4hvpKD1LQKD4RpiSKmrmgSC,1200566,4590947,-3390381,621
2022-05-09 12:38:28-04:00,20314,FSonJL6JzKgaZG6C3qp7H8UQYrfWRsuDmbHkrwTHZgYd,6kZCMcaUrPmPQafMUSivWavmDwEmVdvF7N7hyRXb34bw,True,37796764,9449191,26918,13459,13459,C4UnXuShCvjSMgBAgVNMy1oakxCNk1et27A82fywU112,1076749,9677174,-8600425,284
2022-05-09 12:38:28-04:00,20315,Eo5LYLiUCspbrK13ker5skq9kMjnpUJEJPSbRDWjH6V4,GefeNAw5BdDkibatZknZVGsLhkfc8wfxriEfjHNpvMPm,True,2478558278,619639569,1854495,927247,927248,8HQmsTbxhLhy25fvfCb16HudTGQ9wkHoEBRz5WYeqiZw,74179839,799097998,-724918159,299
2022-05-09 12:38:36-04:00,20316,7tFD53kPTqrzjCu1Wji78gUqhoRtCUhsP1pM3DQKT7uG,BJvgPLYBDJrQJdQVowrsMwUGMurq4zTihoFwWoEokfu3,True,48946692,6157432,18351,9175,9176,Hu94aiQWvce6THeGyCFqGRPM1pQrK3ihzkcXo1EpJcJL,1458798,15424041,-13965243,298
2022-05-09 12:38:41-04:00,20317,Fn6J1eMQJoA5rXCwX2HjAF86AowsJfULLuYXVfzgb8aX,6Ett2WPmz4HoWVSVEZD73UzFetd3oFSh7C676MEVYd36,False,14087565,14087565,850297,42514,807783,Hu94aiQWvce6THeGyCFqGRPM1pQrK3ihzkcXo1EpJcJL,850297,9779136,-8928839,603
2022-05-09 12:39:03-04:00,20318,BTXpvCdmYEmg5fB2Hsjc6Wked2sky4oQpGu7r8KuPau4,CaEwxQQds9f44npaSrYAsC6WpE3T6MpAGr9jgXZeqWjA,True,40595601,1827045,7586,3793,3793,6L1WYrPiCMyi7XemPww4B4hvpKD1LQKD4RpiSKmrmgSC,1685578,13309433,-11623855,415
2022-05-09 12:39:04-04:00,20319,5FewDaMC9U7n5EHcto98GaAmDVxDh5SYimuTP6AtfakM,7DAULUoqV7f9hsBzKEhjQPnWaHSqiMWcBqWcdcadaQv4,True,147938631,36984657,230510,115255,115255,8sEswn3kzEhnYjAZVvCQnHEUvYd7pFVvc2Xc2Kd1BpbC,9220425,34454106,-25233681,623
2022-05-09 12:39:05-04:00,20320,CXppCp4b4npkAzw175YNy6Ei8nF7jCmNbqsbVosHS6fE,FSEchHNYxt7WdBYjyuS2Ft2yUnfk56TCkY8SXdSs8hfe,False,14748156,14748156,918021,45901,872120,2a35JJeTUW1pm6M3e8DHCjp8qr4vbc2cRPhuzZWyFzYd,918021,12015966,-11097945,622
2022-05-09 12:39:07-04:00,20321,85gxgPczGaY9xtDwEvNrWLPhsJFqHPCG1DbbedtFwsVK,AhZjmArZneA5QoTrL8TxzLni6aUxQYZbTYym1YcY4Qhz,True,175703583,43925895,273020,136510,136510,8sEswn3kzEhnYjAZVvCQnHEUvYd7pFVvc2Xc2Kd1BpbC,10920824,49388310,-38467486,621
2022-05-09 12:39:17-04:00,20322,BEATjyYuro1xc1kbgBoxBnVEk3usoUk9qwmdRndXdYW5,9RGBffhSMgab1KCM6dMvwiBENbnp5pERfCEjw4q5ckFS,True,60215835,15053958,106986,53493,53493,Hu94aiQWvce6THeGyCFqGRPM1pQrK3ihzkcXo1EpJcJL,4279450,23331229,-19051779,710
2022-05-09 12:39:18-04:00,20323,532MfQR1PzPn6cmC1kpZsz9MyBWSamSeieh1F6GqVY33,6sJ8XXMZzGbHjVU1vWNW8unWoBZhJa54GguYJQhcb8PA,True,574877001,81911174,533503,266751,266752,2a35JJeTUW1pm6M3e8DHCjp8qr4vbc2cRPhuzZWyFzYd,37442876,145464010,-108021134,651
2022-05-09 12:39:18-04:00,20324,H8P77smmiLj1vtt7hoSjf2vmcnBdW4rsgCtagtXZg6yy,3FxygrzNpSWivjLU3CumYif6rXhSzyjLqdKiyvphDnnc,False,24708994,24708994,988348,49417,938931,Hu94aiQWvce6THeGyCFqGRPM1pQrK3ihzkcXo1EpJcJL,988350,8584896,-7596546,399
2022-05-09 12:39:35-04:00,20325,Gw37fsD8M3AaZ22tSx9WeszxsAkWQ6Ap2XV3zXYhe3EJ,FbKeJsWR5ggVBy1R5sxNiWz5GAsxeyZD8nmyk5yCBqSz,True,18083582,4520895,32163,16081,16082,5HnvdJnCCcmRsm4GkXnYWd4q9RpwuvYDGEUMPkYR3Ts9,1286555,9204926,-7918371,711
2022-05-09 12:39:35-04:00,20326,6pUtYz474QrpATEZnfb3iFbTKYA65pNyKAo4TQZAjtqe,8dipRUXvxJiDLdHEtCPkso4vErbVwshHQiRfvSngBS9J,True,153588301,11733082,40559,20279,20280,6L1WYrPiCMyi7XemPww4B4hvpKD1LQKD4RpiSKmrmgSC,5309390,106083651,-100774261,345
2022-05-09 12:39:39-04:00,20327,EVMrznfJS54BZiywDD2WhUtxzicDtbEpm2a5yLrtCgRF,CpzsMYVYvKg8ihrX1cKRw7TDEYwD3kAyiX92hsf2KiTz,True,187841668,26094952,112779,56389,56390,5HnvdJnCCcmRsm4GkXnYWd4q9RpwuvYDGEUMPkYR3Ts9,8118329,134881237,-126762908,432
2022-05-09 12:39:40-04:00,20328,8uoS53t92hUWWx6mZHGhpKs3dkYJYyiRufnp4H1anBJH,E1Nc6fTaZ7EFFJqVDnEfV3odtasBRhEzbtg4JDFDzJ3k,True,68477631,17119407,106889,53444,53445,2a35JJeTUW1pm6M3e8DHCjp8qr4vbc2cRPhuzZWyFzYd,4275565,59535834,-55260269,624
2022-05-09 12:39:45-04:00,20329,4nqsW3XCJxzSsDdQzvE3zeM9nqBv8xVdUG8GxFWn6Edf,6eVvNs2rckFeTGkXZgPEGLYg4rmz3MFtoVNPRNmktcrY,True,247285596,61821399,436733,218366,218367,8sEswn3kzEhnYjAZVvCQnHEUvYd7pFVvc2Xc2Kd1BpbC,17469343,56224788,-38755445,706
2022-05-09 12:40:07-04:00,20330,DRVtEzZs9u9ysrcANZLEjrvbuuGqYn77v2h4cDFKuNUx,Fv9qiMZhuSBL2cs9AWUYbDLQjB46W2ZwrhxaNXtPLDpC,True,3482051094,870512773,2562067,1281033,1281034,A2p75MbAbeUdHkPLkAjgGeiwuu9WPrkMHzjCkDXF1Xr3,102482685,416879031,-314396346,294
2022-05-09 12:40:09-04:00,20331,EHi1UBG8wMUFZECktsFUZkGjJPaBNEedswS62hyYn6jC,Drx9ErQhAjnPuJ83LPYFnY5ZV5XDzGuXDuSf16VqWayp,True,210345960,22676975,81222,40611,40611,2a35JJeTUW1pm6M3e8DHCjp8qr4vbc2cRPhuzZWyFzYd,7533986,147659684,-140125698,358
2022-05-09 12:40:09-04:00,20332,3Xbsek5MsEGoWr3G9yhuohREr26B2vSQcjqXdspTFHta,2rPxkUiMo9wGDq8EvAiwY3ngRpKmL223cBWWNTYoBmFp,True,142587904,35646976,104594,52297,52297,Hu94aiQWvce6THeGyCFqGRPM1pQrK3ihzkcXo1EpJcJL,4183774,20773792,-16590018,293
2022-05-09 12:40:49-04:00,20333,9eWpSyu71Z6dmx7yTh7WrbVScdrrZN14d5tfmqEGFgXt,2r89PFKSD9zmSp2Wyx4CQ75HAtmUgwhAS2oG5MuYuiV6,True,203348612,17507825,72183,36091,36092,68sueyVfmy5ToEGtLFGDkwebX47xAmzyXE29z8JrmcWv,8383955,104124109,-95740154,412
2022-05-09 12:40:53-04:00,20334,4oMasDRj8HWfknmdwt6Mkz3eonr8J2byoiSTRo4sCnFQ,3emcATkEFvDVETiK97eVET2Z2jzkgiiSxX3gu5wsUKPe,True,149583581,21952133,144406,72203,72203,Hu94aiQWvce6THeGyCFqGRPM1pQrK3ihzkcXo1EpJcJL,9840024,105106039,-95266015,657
2022-05-09 12:40:55-04:00,20335,6HtdpTubfGUuwW6rympMFLyUsdELKDpYagmkErBdLGc6,7e6N7pnwFYx9kU2TXJWt9gCsCpUZTxnFKzjDNZeyWQyq,True,17481054,4370263,27264,13632,13632,C4UnXuShCvjSMgBAgVNMy1oakxCNk1et27A82fywU112,1090592,5733880,-4643288,623
2022-05-09 12:41:25-04:00,20336,5xkW7wHTcF5WadNtBBqKPKctVwyQtTqqscivAmxzseCk,7m31ZMZdCn5Gz2q5sETWA7uKA5LsKD7pJHBBqU3g7tCn,True,206636135,51659033,155346,77673,77673,6L1WYrPiCMyi7XemPww4B4hvpKD1LQKD4RpiSKmrmgSC,6213879,40801813,-34587934,300
2022-05-09 12:41:25-04:00,20337,4bKT3PGcDbmsf3GEMuiJXPHGgVm2LNWn8NgaeLAsYNNQ,2Edaj5sBbgn7DqSMkfzXvL6pgiXbf1hmrMhs9SxaAHDJ,False,8380114,8380114,253106,12655,240451,Hu94aiQWvce6THeGyCFqGRPM1pQrK3ihzkcXo1EpJcJL,253106,13559200,-13306094,302
2022-05-09 12:41:35-04:00,20338,F4hN7ecndZ8Gr5KQNSFaSrMGawMasz7jfWTLTMpk7gaB,AJ23FpXSGjipcqywk88WGsKfqfiiUjPzZLsvLtBAhB12,True,464341444,78952984,296854,148427,148427,8sEswn3kzEhnYjAZVvCQnHEUvYd7pFVvc2Xc2Kd1BpbC,17458796,2145499,15313297,375
2022-05-09 12:41:43-04:00,20339,8L2s5h1hSU79naWcS7cvT3oxiPL6ofTDWmqTK1S4F99g,32DYf6ArTTcNwokJrbhHT1QGe4pZ9z29oPdw97aDR7AQ,True,51143896,12785974,38704,19352,19352,8sEswn3kzEhnYjAZVvCQnHEUvYd7pFVvc2Xc2Kd1BpbC,1548194,51458065,-49909871,302
2022-05-09 12:41:47-04:00,20340,HXQXfEQe7aCpr6WKh37XaDZsjZcuQPk5t8tWNFgEoK6U,5ufXkCEDwgiXwtyPye4wYVVA3oLW54JVzz4tnXFofto4,True,140060030,35015007,105862,52931,52931,2a35JJeTUW1pm6M3e8DHCjp8qr4vbc2cRPhuzZWyFzYd,4234518,72499935,-68265417,302
2022-05-09 12:42:29-04:00,20341,9L2rA8qtfvjKMzqtLn9Cc9Y3ih1e8Z3w9huDzyZXg1xk,GopCtogALLkVyW1T3FGofVWMmjnsdG6EkpJUWob3svaP,True,87747965,21936991,65589,32794,32795,Hu94aiQWvce6THeGyCFqGRPM1pQrK3ihzkcXo1EpJcJL,2623581,19231269,-16607688,298
2022-05-09 12:42:29-04:00,20342,EVMrznfJS54BZiywDD2WhUtxzicDtbEpm2a5yLrtCgRF,CpzsMYVYvKg8ihrX1cKRw7TDEYwD3kAyiX92hsf2KiTz,True,161309532,10728041,50334,25167,25167,68sueyVfmy5ToEGtLFGDkwebX47xAmzyXE29z8JrmcWv,7568366,123319376,-115751010,469
2022-05-09 12:42:40-04:00,20343,6pUtYz474QrpATEZnfb3iFbTKYA65pNyKAo4TQZAjtqe,8dipRUXvxJiDLdHEtCPkso4vErbVwshHQiRfvSngBS9J,True,141521287,11231146,39163,19581,19582,5HnvdJnCCcmRsm4GkXnYWd4q9RpwuvYDGEUMPkYR3Ts9,4934899,102262096,-97327197,348
2022-05-09 12:42:55-04:00,20344,7tFD53kPTqrzjCu1Wji78gUqhoRtCUhsP1pM3DQKT7uG,BJvgPLYBDJrQJdQVowrsMwUGMurq4zTihoFwWoEokfu3,True,42623499,6056398,18112,9056,9056,Hu94aiQWvce6THeGyCFqGRPM1pQrK3ihzkcXo1EpJcJL,1274686,13334451,-12059765,299
2022-05-09 12:42:56-04:00,20345,3wGWQm5bPRFaZ4Uhp3N2PYowdQx5FE8iHMXicCZFNTTD,FyZSncTmnYZA5oRZihMRwnP9mLaWai9mRQ5BseNpiQXJ,True,39602938,9900734,29752,14876,14876,Hu94aiQWvce6THeGyCFqGRPM1pQrK3ihzkcXo1EpJcJL,1190097,21587199,-20397102,300
2022-05-09 12:42:56-04:00,20346,7KfkiubVVGHekg5W5NW1QqxnbudXQroe8tCBsx4GgXAC,5j5yEzQKUmQi7dFM89QTYSRpBca2y5S5EvvLC8ZNuDgM,False,15809942,15809942,987111,49355,937756,C4UnXuShCvjSMgBAgVNMy1oakxCNk1et27A82fywU112,987111,16817995,-15830884,624
2022-05-09 12:43:05-04:00,20347,CcF6hxiDEMSeWm2iXeSuHGxq45X6qembv6FZ7ECQYSJF,9D8ckwVzCmNzowMfsAez2haRo3mLtXUXT8LKAykxcpaL,False,14361141,14361141,424211,21210,403001,2a35JJeTUW1pm6M3e8DHCjp8qr4vbc2cRPhuzZWyFzYd,424211,5498170,-5073959,295
2022-05-09 12:43:12-04:00,20348,F2AU2PjaSmHxWWhkz8XxMggkCMWbMVgawt89tSnYS6RL,ET9febRJiW197DYMaJbgk3kWsAeFv5f4peQ4vFCVppK6,True,677500071,169375017,1058039,529019,529020,A2p75MbAbeUdHkPLkAjgGeiwuu9WPrkMHzjCkDXF1Xr3,42321581,99196591,-56875010,624
2022-05-09 12:43:12-04:00,20349,BJUNK2orMVx6mYsD9pnQzmsEh95ZF2NWPm9KJ1ZM67Qn,FpxLa3DwWrspYvHVsScSDcscHB2eBHGxRrQ4gVvn4VW,True,36674053,9168513,26951,13475,13476,Hu94aiQWvce6THeGyCFqGRPM1pQrK3ihzkcXo1EpJcJL,1078042,13333221,-12255179,293
2022-05-09 12:43:12-04:00,20350,7pSnDcmWQwSn6MfHFoAVEwgo7tZvrg2YkToH1hgSr4sT,5jj8izGNSZDY6S7sR5sWp8npcgXPTcTLjeU7mkhtBmqs,True,309808068,77452017,202193,101096,101097,C5o4TfkUfECutAWsDELjhsZX6PYyYgK3XeKvx6p4FphM,8087788,11100045,-3012257,261
2022-05-09 12:43:14-04:00,20351,BAkPsWHtpVcEGqUgKTKjwZ6d5aaUcaUhdgYxBnpSTDW2,BDwDmVaZnXh22sf8nsDtjVfgxMAswbM3PW3si3k4nbRK,False,30917573,30917573,934320,46716,887604,Hu94aiQWvce6THeGyCFqGRPM1pQrK3ihzkcXo1EpJcJL,934320,15285608,-14351288,302
2022-05-09 12:43:16-04:00,20352,EyNCsqWu8zLyuRnXSbzJWnWZg7ZLjb4oJSZFdDSkbXmT,6rMMMkZibUHXYs8hXY3FmG4rgBx6gWDRGJwR2bP2t6ZD,True,22115151558,4651026976,16254810,8127405,8127405,A9TwRM1BMxqb8DCC7YNAMV6zPenEJm3HTZBy7wJKK58U,772899410,5023231645,-4250332235,349
2022-05-09 12:43:18-04:00,20353,AL8JFS4gjaQx89f9j8wtaNJgV76K8bw1ugvNtgvhgAnb,HJYvG2kGKe8kXgtZSWTWwTmSjxA3XUeCvyT7acoKtS1C,True,8902885864,2225721466,6361686,3180843,3180843,CGtKBgcWZ6HKE3tFNLPUM9khDv2Rc7d6BrPtxz7J1aY,254467445,2640966023,-2386498578,285
2022-05-09 12:43:22-04:00,20354,4DefHiAxdxdjH4zQAhP24GMEJ53JsTYFcJ4QnDiKFqPe,3szkAGxkxdKCQsxFEBDhGGmZVdpc3vzFKm9vzGR1QCSs,False,27076281,27076281,751628,37581,714047,C4UnXuShCvjSMgBAgVNMy1oakxCNk1et27A82fywU112,751628,14782042,-14030414,277
2022-05-09 12:43:24-04:00,20355,EHi1UBG8wMUFZECktsFUZkGjJPaBNEedswS62hyYn6jC,Drx9ErQhAjnPuJ83LPYFnY5ZV5XDzGuXDuSf16VqWayp,True,186990655,20834565,75480,37740,37740,3zqXX6kzhkbW3d4TwD2CNjMRwxTbREXySekvq37kfCNk,6774434,137828794,-131054360,362
2022-05-09 12:43:24-04:00,20356,8e3Du79eCAvuNc6ZX44quJRCuCxmjVDNhRHr1eTB3wqr,3Lb3b9ikztneijmjUzNgHKzCBBfFNKbpjAyc7DQ8pE2M,True,323471235,80867808,223940,111970,111970,3zqXX6kzhkbW3d4TwD2CNjMRwxTbREXySekvq37kfCNk,8957609,185435874,-176478265,276
2022-05-09 12:43:24-04:00,20357,BTXpvCdmYEmg5fB2Hsjc6Wked2sky4oQpGu7r8KuPau4,CaEwxQQds9f44npaSrYAsC6WpE3T6MpAGr9jgXZeqWjA,True,38575035,1707112,6569,3284,3285,8sEswn3kzEhnYjAZVvCQnHEUvYd7pFVvc2Xc2Kd1BpbC,1484471,12175765,-10691294,384
2022-05-09 12:43:26-04:00,20358,4YPn7VhWcrtecLaCBiVmXdmHwNmfR8qf2kzEtivmWrmK,EoEKgrmC6Xx6Ln8fWttD7wEtAkZtUbNifmv2mSHqV1Mf,False,26144330,26144330,712593,35629,676964,47z82br5WdW2DZajdnPDPSSRRKsyAggqXqK6oPUwTaLf,712593,4787374,-4074781,272
2022-05-09 12:43:28-04:00,20359,E17GuUpNNTyonDV7dtuit35hwQXtZ8fowHpHFHWSiiG3,GZ5DboskwBDP5fgYvp6djKFVFCo3MJkurtCY6cA8XVHr,False,15804279,15804279,986466,49323,937143,8sEswn3kzEhnYjAZVvCQnHEUvYd7pFVvc2Xc2Kd1BpbC,986466,16823007,-15836541,624
2022-05-09 12:43:28-04:00,20360,71v9zUJUko4hnP9Taadbuw9cwq2Pb986eMqRFeHSW4LH,6JRSySd8jwX3hrd3UzyT8jqjcBRDr4jm75BqWEXq54yT,False,28560897,28560897,787403,39370,748033,68sueyVfmy5ToEGtLFGDkwebX47xAmzyXE29z8JrmcWv,787403,15597743,-14810340,275
2022-05-09 12:43:51-04:00,20361,FncFHJooh1hy9Gc2y5sKdcYkZ5uHzsxHG4vHT9cVZGcK,BkFa4b5Jyv4ZJCCpwDYv355ezVFiZfAtn18AV7kstd2v,True,48082261,12020565,33402,16701,16701,5HnvdJnCCcmRsm4GkXnYWd4q9RpwuvYDGEUMPkYR3Ts9,1336101,12508004,-11171903,277
2022-05-09 12:43:57-04:00,20362,CMVVfXQYALSc58NLD67L8YrJAbDHZ9rFZvYQC7r8Png4,44pytMX14zaEQv6aRQ223CxYB2uTP7VUTQfUY58EkaNB,False,33673214,33673214,962010,48100,913910,8sEswn3kzEhnYjAZVvCQnHEUvYd7pFVvc2Xc2Kd1BpbC,962010,17419366,-16457356,285
2022-05-09 12:43:57-04:00,20363,4rVW5SPBGcoxE3wAnjbULgZm4xdHXtqhivrszp9W4YP7,Fzu9D4KRKhAF7p22sNqMybe11zGwuXVe58iSt32MbfYX,False,27261801,27261801,783781,39189,744592,C4UnXuShCvjSMgBAgVNMy1oakxCNk1et27A82fywU112,783781,9355148,-8571367,287
2022-05-09 12:43:58-04:00,20364,A2gRXnnsmLvMSzZray4DJdn7dgsrZwwK8uxqnajnyZHs,Gtwdm7MT23sMC9bucL12YD9LLjWftjzGso887FsatiuN,True,509484640,127371160,374024,187012,187012,A9TwRM1BMxqb8DCC7YNAMV6zPenEJm3HTZBy7wJKK58U,14960962,74327643,-59366681,293
2022-05-09 12:44:01-04:00,20365,6pUtYz474QrpATEZnfb3iFbTKYA65pNyKAo4TQZAjtqe,8dipRUXvxJiDLdHEtCPkso4vErbVwshHQiRfvSngBS9J,True,129863842,5108368,17580,8790,8790,8sEswn3kzEhnYjAZVvCQnHEUvYd7pFVvc2Xc2Kd1BpbC,4469437,97881166,-93411729,344
2022-05-09 12:44:01-04:00,20366,6v2KNGc2fG2d6gej4197zgxpPZHY8cdd7wXxyceEPowK,3u6LAZVkQRKaxNkTwACrDMXMf5fEY3VZmrUr4t2pAyE9,True,304086670,76021667,211556,105778,105778,3zqXX6kzhkbW3d4TwD2CNjMRwxTbREXySekvq37kfCNk,8462246,97263893,-88801647,278
2022-05-09 12:44:06-04:00,20367,6xeNr9LhAfC6FRV62dALYdgx3bsoUpUpmEBiUPYCV5fz,8GP5cEpfNTEjvqm9usBUXs7jPCK5RciqjVJqtvX9fuGs,True,1564138563,391034640,1171047,585523,585524,C4UnXuShCvjSMgBAgVNMy1oakxCNk1et27A82fywU112,46841898,295078363,-248236465,299
2022-05-09 12:44:11-04:00,20368,GcwFXxcxRF2xwbgFbQZoYEDreimd3J3UJ9sPfuwYVKtS,7uXjmKS8RxP2qSS7ataBH5hkfpgsFcpSBWUEBuV5zgyZ,True,51639038,12909759,39059,19529,19530,5HnvdJnCCcmRsm4GkXnYWd4q9RpwuvYDGEUMPkYR3Ts9,1562366,16563661,-15001295,302
2022-05-09 12:44:11-04:00,20369,EimqbbHPEHj1rpnmJZcpVQm6qBcVJVVwziXQknaBSBR9,72J8g5q3iesb6ysaCeLhk183x8GTwNchHTyqC3dgGPh7,False,15956856,15956856,483425,24171,459254,C4UnXuShCvjSMgBAgVNMy1oakxCNk1et27A82fywU112,483425,6211669,-5728244,302
2022-05-09 12:44:14-04:00,20370,GCNi25P1Ywvfx5JpyxFVV68sRkio7LEhFgY85ZqveKR3,34mxz8fCss7KNAbEi2Wj9z5dTgXCGxuq2vyqzBPChtmq,True,1542578950,385644737,1123046,561523,561523,A2p75MbAbeUdHkPLkAjgGeiwuu9WPrkMHzjCkDXF1Xr3,44921859,605824427,-560902568,291
2022-05-09 12:44:20-04:00,20371,FSonJL6JzKgaZG6C3qp7H8UQYrfWRsuDmbHkrwTHZgYd,6kZCMcaUrPmPQafMUSivWavmDwEmVdvF7N7hyRXb34bw,False,28131671,28131671,833929,41696,792233,C4UnXuShCvjSMgBAgVNMy1oakxCNk1et27A82fywU112,833929,7500167,-6666238,296
2022-05-09 12:44:20-04:00,20372,2PPgqogXBahpsHU9DecWX1gbyN8NNF5v3ECg6uYu4NZ4,FVGmdT3EZtD6b1ed5jXiUQGAZZy68QVrG8gd1LRvHWaD,False,1614969,1614969,47824,2391,45433,3zqXX6kzhkbW3d4TwD2CNjMRwxTbREXySekvq37kfCNk,47824,927855,-880031,296
2022-05-09 12:44:20-04:00,20373,Ejg8vXVsro4jB2fpdUUXCRfKTiE5TUwfRXhHeR8qtrEi,GnF7xwsjzso48ZEAdYYuxNkJso7ug3s46uogi4XDbs1,True,104849029,26212257,72845,36422,36423,47z82br5WdW2DZajdnPDPSSRRKsyAggqXqK6oPUwTaLf,2913801,31788982,-28875181,277
2022-05-09 12:44:21-04:00,20374,FU3fRyQxk6rwtD9Db1nTvTAjSwgSW9vi1q7SjZ92ijyM,7c3maBK3hpb1exxqcvnwiUfhhUBgLgCs5exANSZ7m494,True,43374080,10843520,30838,15419,15419,47z82br5WdW2DZajdnPDPSSRRKsyAggqXqK6oPUwTaLf,1233543,7893808,-6660265,284
2022-05-09 12:44:31-04:00,20375,7GpG8k6hM27vK1R5Sx1v5xUBuF6vybP41dcymjXDi5P7,7Aip6HDcbZ5mvoSucNupRS9enRdGx37F8L432K7V81do,True,31086739,7771684,48482,24241,24241,8sEswn3kzEhnYjAZVvCQnHEUvYd7pFVvc2Xc2Kd1BpbC,1939308,24859617,-22920309,623
2022-05-09 12:44:31-04:00,20376,57UJpBg8pjTxWp9LVwVGjCDm9zgYnzs4ru49BdZrG62a,Dor96mgsM5EroCmZUAnuDPiAiLn7nNgGeZDbwHxpHxzw,False,26235518,26235518,772968,38648,734320,2a35JJeTUW1pm6M3e8DHCjp8qr4vbc2cRPhuzZWyFzYd,772968,4844995,-4072027,294
2022-05-09 12:44:36-04:00,20377,5wLjwv4kc3PpfNRyv2YfzrBxkt8rNmRSAksKeoMZd2uP,7A6PfL7d7V5dcQx1ZpGdovb998bawoszRP7yyBCKokiw,False,4446288,4446288,123963,6198,117765,68sueyVfmy5ToEGtLFGDkwebX47xAmzyXE29z8JrmcWv,123963,1788706,-1664743,278
2022-05-09 12:44:40-04:00,20378,H9pFRayNBHTAhsbtGyfs1XXUWGxAbw7SgpT1xdrSRWEY,9LNreyXuhgyLCDYViNyA1jUw6h1nv4GmDtTYMoUQBqCG,True,2210757952,279948441,845375,422687,422688,72XWPCtRYEDZbddP7d6dHtUBRRDLSJsB2xZTAfefoEVZ,66759507,998168613,-931409106,301
2022-05-09 12:44:41-04:00,20379,2tPYXtNrw134ACVhkYdnG9FGT4iHm61PuX8L7AfG9aAT,EyyPLVdjgewzVDKePQUj85BBttWy4MixVr9CSD8JVbrP,True,107737214,26934303,75527,37763,37764,68sueyVfmy5ToEGtLFGDkwebX47xAmzyXE29z8JrmcWv,3021104,55451448,-52430344,280
2022-05-09 12:44:45-04:00,20380,BTXpvCdmYEmg5fB2Hsjc6Wked2sky4oQpGu7r8KuPau4,CaEwxQQds9f44npaSrYAsC6WpE3T6MpAGr9jgXZeqWjA,True,36839742,3458033,13608,6804,6804,47z82br5WdW2DZajdnPDPSSRRKsyAggqXqK6oPUwTaLf,1449721,11661460,-10211739,393
2022-05-09 12:44:56-04:00,20381,7u5HTmBPLyaLwQiDmB8ws6Q1NYwHRq4ebzWieYctAw4p,6ZTVy75qPD9cPjkCprpHiAQbutizE5d6nQZcdb3H91xp,False,7087351,7087351,213487,10674,202813,3zqXX6kzhkbW3d4TwD2CNjMRwxTbREXySekvq37kfCNk,213487,2761236,-2547749,301
2022-05-09 12:45:06-04:00,20382,8KzrbHiup39X7Zw9grvh7gS9ZcA1zuhLGqgYguSjwnD6,A2EPmTs73YiS15ZKcjom55huNYaJY3WeP7NBDar1VE3R,True,1189188474,297297118,1847773,923886,923887,2xTUy2RS74GJMMDnmFaegMzFLn19RVfYG4CibhBmjP1i,73910957,1583608580,-1509697623,621
2022-05-09 12:45:07-04:00,20383,A7j77tzgnQVGtHTa65VtVZqJRYeJvQk7am8NW6e66379,4vJGwEvXU2tGWoWWGwbsYcfKQAMCHbrBMRk4ZVFzneLs,True,111915386,27978846,75303,37651,37652,47z82br5WdW2DZajdnPDPSSRRKsyAggqXqK6oPUwTaLf,3012158,41474161,-38462003,269
2022-05-09 12:45:07-04:00,20384,7zuFEyLQFHkAjm3mAuxN42VenwF6fZcqM81mmR8sBnmY,CSnQxjc4Jn8iP4JSxj5wsrvxGsLoAYQn1bKC8naY7YZP,True,3306230747,826557686,2500264,1250132,1250132,AmTrMPzuTp2BjnjqGNKqz9FTTCdpoKcPAJLwFc8ozcbh,100010569,358514300,-258503731,302
2022-05-09 12:45:10-04:00,20385,4nycLWt9WG6pndn1t2cumXqmC7HZruLH1WUm9DQdCoMH,5pwELxNpkDShzWyHRP6KVszwFQurRMDFoYMo987EXXnX,False,1928075,1928075,57114,2855,54259,5HnvdJnCCcmRsm4GkXnYWd4q9RpwuvYDGEUMPkYR3Ts9,57114,703839,-646725,296
2022-05-09 12:45:14-04:00,20386,Aog11AwpgWF7UgvLLJbV5kn3UrJURYQUhnBFnAFSqbp8,2WXYGpuib3fK3BCXDQVQsoktEnASPuZfcnmC2AZ7KTQK,True,48591268,12147817,36640,18320,18320,2a35JJeTUW1pm6M3e8DHCjp8qr4vbc2cRPhuzZWyFzYd,1465630,12023055,-10557425,301
2022-05-09 12:45:15-04:00,20387,5CgYtJiSW6yWmqiKwc6X1xU1bzUXtGdNDY18BtyfaWQp,74h9456mjEUNDW59wUkXb1dk1TLKUTJAgYLqFzHk1MPR,False,27721096,27721096,795480,39774,755706,47z82br5WdW2DZajdnPDPSSRRKsyAggqXqK6oPUwTaLf,795480,15090128,-14294648,286
2022-05-09 12:45:15-04:00,20388,m7gf1jAYXBZjRZEY9w4MjPfhzLwgDKaXyaCVhRD6C5E,Aa2aTZnpPux1i5K2MT4i1TsVM8vR7qR7rZGijQW4zpwd,True,378364390,69957051,264764,132382,132382,47z82br5WdW2DZajdnPDPSSRRKsyAggqXqK6oPUwTaLf,14319844,191908716,-177588872,378
2022-05-09 12:45:16-04:00,20389,BQYbbwd1MLtj6fBuBiTncAaXdAqKWa1JbcbGkZbLA728,2Wsyr6KoMbSVSvFy3YzutuEQ6skGUZyVHGM42SN4eU98,True,10483643605,441423385,1565759,782879,782880,A2p75MbAbeUdHkPLkAjgGeiwuu9WPrkMHzjCkDXF1Xr3,371862248,13248348082,-12876485834,354
2022-05-09 12:45:16-04:00,20390,Eo5LYLiUCspbrK13ker5skq9kMjnpUJEJPSbRDWjH6V4,GefeNAw5BdDkibatZknZVGsLhkfc8wfxriEfjHNpvMPm,True,1841908011,460477002,1382866,691433,691433,A9TwRM1BMxqb8DCC7YNAMV6zPenEJm3HTZBy7wJKK58U,55314646,616086733,-560772087,300
2022-05-09 12:45:16-04:00,20391,EVMrznfJS54BZiywDD2WhUtxzicDtbEpm2a5yLrtCgRF,CpzsMYVYvKg8ihrX1cKRw7TDEYwD3kAyiX92hsf2KiTz,True,149742203,10047003,44811,22405,22406,C5o4TfkUfECutAWsDELjhsZX6PYyYgK3XeKvx6p4FphM,6678744,111937229,-105258485,446
2022-05-09 12:45:17-04:00,20392,AZq9LHFskHUujKDJZTpWhpP9LRaDjQKcrf2Bz2eY6TtN,EtStidHXHYYQJ6E1h7LHmgewtiK7AjMAsDBw4XBCrdQs,True,213634092,53408523,310844,155422,155422,C4UnXuShCvjSMgBAgVNMy1oakxCNk1et27A82fywU112,12433775,138783487,-126349712,582
2022-05-09 12:45:39-04:00,20393,532MfQR1PzPn6cmC1kpZsz9MyBWSamSeieh1F6GqVY33,6sJ8XXMZzGbHjVU1vWNW8unWoBZhJa54GguYJQhcb8PA,True,488579490,61074338,406550,203275,203275,5HnvdJnCCcmRsm4GkXnYWd4q9RpwuvYDGEUMPkYR3Ts9,32523036,129053934,-96530898,665
2022-05-09 12:45:53-04:00,20394,7qEVqFr1naSPCDV9q3xx6KMZn1yCHvkHZJkaA46NLmSE,8Mohcixq2L9PYrHpb95vuEsXqJ18JhEHi3RA83VM9cLv,False,27887876,27887876,795993,39799,756194,72FwbpFGoLEazJEdpqNtPNefsadUrimUqma9wSoy4qiS,795993,12042164,-11246171,285
2022-05-09 12:45:55-04:00,20395,9BRXkk9UScH5tH1LFNUcDJjHiJTtjz4tkiMKt8sWK2vG,5NJRoua5rRqKUobCsNn9Pemoz5SC12P1gyvQ3BQcqspm,False,1604596,1604596,47787,2389,45398,72FwbpFGoLEazJEdpqNtPNefsadUrimUqma9wSoy4qiS,47787,928191,-880404,297
2022-05-09 12:46:13-04:00,20396,35cVu72E1AiTr4jJSgXE4Hgzy3mJ5LrxNSgNCc5p11ot,2JnKXCadz8KNddE4rXAsQven7SMDgxwtQiYSrqB5StA3,False,4259458,4259458,128479,6423,122056,3zqXX6kzhkbW3d4TwD2CNjMRwxTbREXySekvq37kfCNk,128479,7067889,-6939410,301
2022-05-09 12:46:18-04:00,20397,D7dQmfuiK31BHRG4Y9wpkRu7sChiZhTYes47YPNGvnpF,AN5jjtJp7d9DG3xJo3DnDRmGmzj5pKKy1owwVuREpReQ,True,182427382,45606845,274945,137472,137473,C4UnXuShCvjSMgBAgVNMy1oakxCNk1et27A82fywU112,10997834,26116994,-15119160,602
2022-05-09 12:46:33-04:00,20398,DRVtEzZs9u9ysrcANZLEjrvbuuGqYn77v2h4cDFKuNUx,Fv9qiMZhuSBL2cs9AWUYbDLQjB46W2ZwrhxaNXtPLDpC,True,2589059607,647264901,1936047,968023,968024,8HQmsTbxhLhy25fvfCb16HudTGQ9wkHoEBRz5WYeqiZw,77441904,335839133,-258397229,299
2022-05-09 12:46:43-04:00,20399,6pUtYz474QrpATEZnfb3iFbTKYA65pNyKAo4TQZAjtqe,8dipRUXvxJiDLdHEtCPkso4vErbVwshHQiRfvSngBS9J,True,124559055,10179813,34778,17389,17389,Hu94aiQWvce6THeGyCFqGRPM1pQrK3ihzkcXo1EpJcJL,4255438,93060386,-88804948,341
2022-05-09 12:46:44-04:00,20400,7tFD53kPTqrzjCu1Wji78gUqhoRtCUhsP1pM3DQKT7uG,BJvgPLYBDJrQJdQVowrsMwUGMurq4zTihoFwWoEokfu3,True,36399078,4570204,13667,6833,6834,5HnvdJnCCcmRsm4GkXnYWd4q9RpwuvYDGEUMPkYR3Ts9,1088551,11873443,-10784892,299
2022-05-09 12:47:03-04:00,20401,EsrB27T54Kg4Q9FwFnSC8ekemCKbFMa9MxSs7vmmqQGh,4FsndGgA3E3XpVE6pxxbdehzCU9a6eLTa6yCzfXGPtWW,False,8799894,8799894,265529,13276,252253,5HnvdJnCCcmRsm4GkXnYWd4q9RpwuvYDGEUMPkYR3Ts9,265529,3460735,-3195206,301
2022-05-09 12:47:16-04:00,20402,3Xbsek5MsEGoWr3G9yhuohREr26B2vSQcjqXdspTFHta,2rPxkUiMo9wGDq8EvAiwY3ngRpKmL223cBWWNTYoBmFp,True,105915797,26478949,76351,38175,38176,47z82br5WdW2DZajdnPDPSSRRKsyAggqXqK6oPUwTaLf,3054049,16521902,-13467853,288
2022-05-09 12:47:17-04:00,20403,EHi1UBG8wMUFZECktsFUZkGjJPaBNEedswS62hyYn6jC,Drx9ErQhAjnPuJ83LPYFnY5ZV5XDzGuXDuSf16VqWayp,True,165549202,8953307,32947,16473,16474,3zqXX6kzhkbW3d4TwD2CNjMRwxTbREXySekvq37kfCNk,6092066,122169254,-116077188,367
2022-05-09 12:47:33-04:00,20404,Ejg8vXVsro4jB2fpdUUXCRfKTiE5TUwfRXhHeR8qtrEi,GnF7xwsjzso48ZEAdYYuxNkJso7ug3s46uogi4XDbs1,True,78110408,19527602,57864,28932,28932,Hu94aiQWvce6THeGyCFqGRPM1pQrK3ihzkcXo1EpJcJL,2314592,24497471,-22182879,296
2022-05-09 12:47:33-04:00,20405,92cQnCMBkPL8DmE4xYQXJVAQ8EXk3moXXVHaM2zQT4uj,A5MAQitMT3yojsCtjyq9pypZQP9Df6m95X5srsEXaxr6,True,3024750131,756187532,2131472,1065736,1065736,72XWPCtRYEDZbddP7d6dHtUBRRDLSJsB2xZTAfefoEVZ,85258916,3353625364,-3268366448,281
2022-05-09 12:47:34-04:00,20406,cXqFkCF4gaT9vAcZYMgwLXmmuD5w4hwgxT8YXE8JuBw,5Wtf4ZBL6R1afLeC4WfhFGkfi42TagtNAg6EZWn7gKhg,False,32180144,32180144,969982,48499,921483,8sEswn3kzEhnYjAZVvCQnHEUvYd7pFVvc2Xc2Kd1BpbC,969982,11022604,-10052622,301
2022-05-09 12:47:35-04:00,20407,A7j77tzgnQVGtHTa65VtVZqJRYeJvQk7am8NW6e66379,4vJGwEvXU2tGWoWWGwbsYcfKQAMCHbrBMRk4ZVFzneLs,True,83452617,20863154,61323,30661,30662,2a35JJeTUW1pm6M3e8DHCjp8qr4vbc2cRPhuzZWyFzYd,2452932,31783513,-29330581,293
2022-05-09 12:47:35-04:00,20408,3wGWQm5bPRFaZ4Uhp3N2PYowdQx5FE8iHMXicCZFNTTD,FyZSncTmnYZA5oRZihMRwnP9mLaWai9mRQ5BseNpiQXJ,False,29394597,29394597,852738,42636,810102,3zqXX6kzhkbW3d4TwD2CNjMRwxTbREXySekvq37kfCNk,852738,16458194,-15605456,290
2022-05-09 12:47:39-04:00,20409,EVMrznfJS54BZiywDD2WhUtxzicDtbEpm2a5yLrtCgRF,CpzsMYVYvKg8ihrX1cKRw7TDEYwD3kAyiX92hsf2KiTz,True,139221631,19300647,85402,42701,42701,2a35JJeTUW1pm6M3e8DHCjp8qr4vbc2cRPhuzZWyFzYd,6160364,102892429,-96732065,442
2022-05-09 12:47:52-04:00,20410,2tPYXtNrw134ACVhkYdnG9FGT4iHm61PuX8L7AfG9aAT,EyyPLVdjgewzVDKePQUj85BBttWy4MixVr9CSD8JVbrP,True,80247632,20061908,59757,29878,29879,2a35JJeTUW1pm6M3e8DHCjp8qr4vbc2cRPhuzZWyFzYd,2390298,42268495,-39878197,297
2022-05-09 12:47:59-04:00,20411,FU3fRyQxk6rwtD9Db1nTvTAjSwgSW9vi1q7SjZ92ijyM,7c3maBK3hpb1exxqcvnwiUfhhUBgLgCs5exANSZ7m494,False,32279694,32279694,951839,47591,904248,8sEswn3kzEhnYjAZVvCQnHEUvYd7pFVvc2Xc2Kd1BpbC,951839,6197924,-5246085,294
2022-05-09 12:48:02-04:00,20412,8L2s5h1hSU79naWcS7cvT3oxiPL6ofTDWmqTK1S4F99g,32DYf6ArTTcNwokJrbhHT1QGe4pZ9z29oPdw97aDR7AQ,True,37882172,9470543,25843,12921,12922,47z82br5WdW2DZajdnPDPSSRRKsyAggqXqK6oPUwTaLf,1033740,38941942,-37908202,272
2022-05-09 12:48:04-04:00,20413,HXQXfEQe7aCpr6WKh37XaDZsjZcuQPk5t8tWNFgEoK6U,5ufXkCEDwgiXwtyPye4wYVVA3oLW54JVzz4tnXFofto4,True,103750902,25937725,70863,35431,35432,47z82br5WdW2DZajdnPDPSSRRKsyAggqXqK6oPUwTaLf,2834535,55327988,-52493453,273
2022-05-09 12:48:04-04:00,20414,6v2KNGc2fG2d6gej4197zgxpPZHY8cdd7wXxyceEPowK,3u6LAZVkQRKaxNkTwACrDMXMf5fEY3VZmrUr4t2pAyE9,True,226267006,56566751,161317,80658,80659,47z82br5WdW2DZajdnPDPSSRRKsyAggqXqK6oPUwTaLf,6452693,74853025,-68400332,285
2022-05-09 12:48:05-04:00,20415,5xkW7wHTcF5WadNtBBqKPKctVwyQtTqqscivAmxzseCk,7m31ZMZdCn5Gz2q5sETWA7uKA5LsKD7pJHBBqU3g7tCn,True,153043950,38260987,103134,51567,51567,47z82br5WdW2DZajdnPDPSSRRKsyAggqXqK6oPUwTaLf,4125381,31999942,-27874561,269
2022-05-09 12:48:13-04:00,20416,6wGzqSWYjB1nukhDwLdgXDzMNSeasuRur3FVZAkVF4pM,HTcJjvQNFJQEewRf8iCcsZgFcfHoUXzpbb7WscqdK4kS,True,43212842,10803210,67381,33690,33691,47z82br5WdW2DZajdnPDPSSRRKsyAggqXqK6oPUwTaLf,2695250,13809653,-11114403,623
2022-05-09 12:48:23-04:00,20417,BQYbbwd1MLtj6fBuBiTncAaXdAqKWa1JbcbGkZbLA728,2Wsyr6KoMbSVSvFy3YzutuEQ6skGUZyVHGM42SN4eU98,True,10018091521,860293039,2972679,1486339,1486340,A9TwRM1BMxqb8DCC7YNAMV6zPenEJm3HTZBy7wJKK58U,346167790,12688284364,-12342116574,345
2022-05-09 12:48:33-04:00,20418,9L2rA8qtfvjKMzqtLn9Cc9Y3ih1e8Z3w9huDzyZXg1xk,GopCtogALLkVyW1T3FGofVWMmjnsdG6EkpJUWob3svaP,True,65031761,16257940,44469,22234,22235,47z82br5WdW2DZajdnPDPSSRRKsyAggqXqK6oPUwTaLf,1778779,15013843,-13235064,273
2022-05-09 12:48:36-04:00,20419,9eWpSyu71Z6dmx7yTh7WrbVScdrrZN14d5tfmqEGFgXt,2r89PFKSD9zmSp2Wyx4CQ75HAtmUgwhAS2oG5MuYuiV6,True,184631074,33151880,127522,63761,63761,72FwbpFGoLEazJEdpqNtPNefsadUrimUqma9wSoy4qiS,7102059,84456987,-77354928,384
2022-05-09 12:48:39-04:00,20420,GCNi25P1Ywvfx5JpyxFVV68sRkio7LEhFgY85ZqveKR3,34mxz8fCss7KNAbEi2Wj9z5dTgXCGxuq2vyqzBPChtmq,True,1147789931,286947482,866363,433181,433182,47z82br5WdW2DZajdnPDPSSRRKsyAggqXqK6oPUwTaLf,34654531,464505590,-429851059,301
2022-05-09 12:48:52-04:00,20421,8J4BZXZzkK4SmWxc2YoaJRg9ivuuXbdVe5XpEhVds1ZM,3pirVwiye9NftvMpX5F7WpfcGZy5uV3c11xCdkkZbL9D,True,261386041,65346510,197973,98986,98987,Hu94aiQWvce6THeGyCFqGRPM1pQrK3ihzkcXo1EpJcJL,7918950,51635251,-43716301,302
2022-05-09 12:49:06-04:00,20422,8sQzUoiFfBUsfVKdUjUh3xUjwnaCP1Qmw9BGwtH768ZR,8wZxijgcyRwqxiRKMMZhoREAb6iHhRGCgjgZRd5Yp6RP,True,134887719,33721929,240625,120312,120313,72FwbpFGoLEazJEdpqNtPNefsadUrimUqma9wSoy4qiS,9625019,69871784,-60246765,713
2022-05-09 12:49:10-04:00,20423,FRbeFwhUYCiHW5oP26mad8KND7CCYDbfnoNxX7GuXVp8,GrzXKxPX2WDka8i2D8sunMUsrsThKasQi8NYLwuCGygV,True,103237362,17717552,71325,35662,35663,Hu94aiQWvce6THeGyCFqGRPM1pQrK3ihzkcXo1EpJcJL,4156023,50362204,-46206181,402
2022-05-09 12:49:19-04:00,20424,A2gRXnnsmLvMSzZray4DJdn7dgsrZwwK8uxqnajnyZHs,Gtwdm7MT23sMC9bucL12YD9LLjWftjzGso887FsatiuN,True,378729546,94682386,280075,140037,140038,A2p75MbAbeUdHkPLkAjgGeiwuu9WPrkMHzjCkDXF1Xr3,11203004,59114615,-47911611,295
2022-05-09 12:49:20-04:00,20425,26wo1RqwKXrNnfgMdZEmkGhnDbURpZcp2hasB5EA5QtD,34gwTVGRrdoaBzLUG6SBwRwBovkjBjCebqVUBan6GDnB,True,395226048,98806512,700344,350172,350172,DQCvC9mR68hJ3tJsUiddh6JwcBJAmntqGJR2nUsEq7yj,28013786,324706546,-296692760,708
2022-05-09 12:49:28-04:00,20426,6pUtYz474QrpATEZnfb3iFbTKYA65pNyKAo4TQZAjtqe,8dipRUXvxJiDLdHEtCPkso4vErbVwshHQiRfvSngBS9J,True,114081825,8731949,30028,15014,15014,72FwbpFGoLEazJEdpqNtPNefsadUrimUqma9wSoy4qiS,3923243,80613522,-76690279,343
2022-05-09 12:49:31-04:00,20427,djW9rVm1v4nW64QiVqgFUCRza24VqthDcSfVEyRHPed,EsXvQmXVXECqZPtmSdiuwieHPP5jsmyn67p78vHaJcqq,True,46080120,11520030,34025,17012,17013,2a35JJeTUW1pm6M3e8DHCjp8qr4vbc2cRPhuzZWyFzYd,1361019,7666444,-6305425,295
2022-05-09 12:49:31-04:00,20428,7tFD53kPTqrzjCu1Wji78gUqhoRtCUhsP1pM3DQKT7uG,BJvgPLYBDJrQJdQVowrsMwUGMurq4zTihoFwWoEokfu3,False,31711805,31711805,957814,47890,909924,8sEswn3kzEhnYjAZVvCQnHEUvYd7pFVvc2Xc2Kd1BpbC,957815,10258473,-9300658,302
2022-05-09 12:49:42-04:00,20429,Bzp3ZUxzRWqW4QoLq9PtKN1HQeSaKXFQrX1G3a4ocrre,H12B3p4v1ZtZ9gaSgpxCJsKXmmEjiqaRZQzexjzAhevo,True,1021814764,140665796,616148,308074,308074,A2p75MbAbeUdHkPLkAjgGeiwuu9WPrkMHzjCkDXF1Xr3,44757831,579793083,-535035252,438
2022-05-09 12:49:44-04:00,20430,HeyRAEkqGTtCj2cMfGR6pbeY5nu4qERFmZSovsfhUtaq,5MDbdhQUt3USB1RFmdLsrAc5UUXZ1n8jXRQFtJ6ibj9B,True,58229892,3616317,16089,8044,8045,3zqXX6kzhkbW3d4TwD2CNjMRwxTbREXySekvq37kfCNk,2590709,19360983,-16770274,444
2022-05-09 12:49:45-04:00,20431,GtDk7DkAB2jvQynR57z8mjg6UoaTqYDr8Z4wsFX6KGSr,tAPvp4fscJZySZUVG2GZWZwSRVhfnNvkjCC6ZvmxqDQ,True,64559911,16139977,47835,23917,23918,72FwbpFGoLEazJEdpqNtPNefsadUrimUqma9wSoy4qiS,1913419,12743057,-10829638,296
2022-05-09 12:49:45-04:00,20432,BSUa3ArsftaRgVww5eEU9bFsq7bYRfRsdAWc1PY9Tqwp,4rtPyGw8SrDEZfLF7NZhKKp6opuBi5jxxwCb4CKtb4AR,True,56616175,3528323,15783,7891,7892,C4UnXuShCvjSMgBAgVNMy1oakxCNk1et27A82fywU112,2532728,25910496,-23377768,447
2022-05-09 12:49:51-04:00,20433,GCweck6iuscBsVbXW9ZYfMytdgwSYWwNifTWLaUbaSmA,6HwGWKGduMGvLnHmTJo6ZioZ3EMUZYHo2pG4tBFXgB4Y,False,11652247,11652247,760912,38045,722867,72FwbpFGoLEazJEdpqNtPNefsadUrimUqma9wSoy4qiS,760912,6397677,-5636765,653
2022-05-09 12:49:55-04:00,20434,6xeNr9LhAfC6FRV62dALYdgx3bsoUpUpmEBiUPYCV5fz,8GP5cEpfNTEjvqm9usBUXs7jPCK5RciqjVJqtvX9fuGs,True,1161791780,290447945,858967,429483,429484,2py1FiYeL2f7J3HU36qiJz6TD6HCmiTN36RyxYtapQCZ,34358708,231874279,-197515571,295
2022-05-09 12:49:56-04:00,20435,EHLV9s6E1s5SUbzZVzsGWH2vVRGHyxynM4GDJtfKEuYe,4hAx9osegpeocSSmJbMVBYMKCwo5WY3QVJuK7cuzz4b4,False,11666458,11666458,784078,39203,744875,72FwbpFGoLEazJEdpqNtPNefsadUrimUqma9wSoy4qiS,784078,6406682,-5622604,672
2022-05-09 12:50:02-04:00,20436,EHi1UBG8wMUFZECktsFUZkGjJPaBNEedswS62hyYn6jC,Drx9ErQhAjnPuJ83LPYFnY5ZV5XDzGuXDuSf16VqWayp,True,156126958,16893250,60486,30243,30243,8sEswn3kzEhnYjAZVvCQnHEUvYd7pFVvc2Xc2Kd1BpbC,5590182,112317266,-106727084,358
2022-05-09 12:50:03-04:00,20437,4oMasDRj8HWfknmdwt6Mkz3eonr8J2byoiSTRo4sCnFQ,3emcATkEFvDVETiK97eVET2Z2jzkgiiSxX3gu5wsUKPe,True,126319603,15207691,100932,50466,50466,C4UnXuShCvjSMgBAgVNMy1oakxCNk1et27A82fywU112,8383773,91485653,-83101880,663
2022-05-09 12:50:21-04:00,20438,EEQmHFk3WFNmPfe7ujtP1PK6P5yqV5mmWumNSoTu45P8,FG9DScQDQPrgcmBbRugZ5NfhSTRMnKSWLxcUeTF9MgJZ,True,114732582,28683145,85940,42970,42970,72FwbpFGoLEazJEdpqNtPNefsadUrimUqma9wSoy4qiS,3437620,22652573,-19214953,299
2022-05-09 12:50:22-04:00,20439,HV3BVN9zLURqQBJyUFFeytFvjhhoYYJ3VXTCDYpML7Fd,ZCesJgyYoyWb3wfUP6BusxEBtVAYb2AAe94QbxVkFsb,False,26437941,26437941,799297,39964,759333,47z82br5WdW2DZajdnPDPSSRRKsyAggqXqK6oPUwTaLf,799297,6749191,-5949894,302
2022-05-09 12:50:22-04:00,20440,BEATjyYuro1xc1kbgBoxBnVEk3usoUk9qwmdRndXdYW5,9RGBffhSMgab1KCM6dMvwiBENbnp5pERfCEjw4q5ckFS,True,44120987,11030246,78289,39144,39145,72FwbpFGoLEazJEdpqNtPNefsadUrimUqma9wSoy4qiS,3131574,18461794,-15330220,709
2022-05-09 12:50:35-04:00,20441,Gw37fsD8M3AaZ22tSx9WeszxsAkWQ6Ap2XV3zXYhe3EJ,FbKeJsWR5ggVBy1R5sxNiWz5GAsxeyZD8nmyk5yCBqSz,False,13252282,13252282,943987,47199,896788,72FwbpFGoLEazJEdpqNtPNefsadUrimUqma9wSoy4qiS,943987,7193220,-6249233,712
2022-05-09 12:50:36-04:00,20442,68gVM4kjmSYxT1uJW13rYSway8uVLUdcLa7sJuqHQaAf,DshroBQ3da7BcAiQpiFREsLKWbUDrBRmmZRw3Zu2Qfs9,True,51023102,12755775,37610,18805,18805,47z82br5WdW2DZajdnPDPSSRRKsyAggqXqK6oPUwTaLf,1504431,15521040,-14016609,294
2022-05-09 12:50:41-04:00,20443,BTXpvCdmYEmg5fB2Hsjc6Wked2sky4oQpGu7r8KuPau4,CaEwxQQds9f44npaSrYAsC6WpE3T6MpAGr9jgXZeqWjA,True,33282242,3101928,12457,6228,6229,C4UnXuShCvjSMgBAgVNMy1oakxCNk1et27A82fywU112,1336646,11165676,-9829030,401
2022-05-09 12:50:42-04:00,20444,GMpoV2jRyLdf2V3Gb5TQZ5gEs5ftMjD3JhFUzkA6fWVz,5bi814d5gdToTLVWCmbdB6J15kMdsTQk74cZTRd62p81,True,135118747,33779686,239974,119987,119987,72FwbpFGoLEazJEdpqNtPNefsadUrimUqma9wSoy4qiS,9598975,53229172,-43630197,710
2022-05-09 12:50:54-04:00,20445,85gxgPczGaY9xtDwEvNrWLPhsJFqHPCG1DbbedtFwsVK,AhZjmArZneA5QoTrL8TxzLni6aUxQYZbTYym1YcY4Qhz,True,128787070,32196767,191429,95714,95715,C4UnXuShCvjSMgBAgVNMy1oakxCNk1et27A82fywU112,7657186,39499370,-31842184,594
2022-05-09 12:51:07-04:00,20446,3Xbsek5MsEGoWr3G9yhuohREr26B2vSQcjqXdspTFHta,2rPxkUiMo9wGDq8EvAiwY3ngRpKmL223cBWWNTYoBmFp,True,78786978,19696744,58195,29097,29098,Hu94aiQWvce6THeGyCFqGRPM1pQrK3ihzkcXo1EpJcJL,2327828,13078705,-10750877,295
2022-05-09 12:51:10-04:00,20447,BQYbbwd1MLtj6fBuBiTncAaXdAqKWa1JbcbGkZbLA728,2Wsyr6KoMbSVSvFy3YzutuEQ6skGUZyVHGM42SN4eU98,True,9133648769,723289289,2526504,1263252,1263252,2xTUy2RS74GJMMDnmFaegMzFLn19RVfYG4CibhBmjP1i,319045398,11045922558,-10726877160,349
2022-05-09 12:51:10-04:00,20448,DRVtEzZs9u9ysrcANZLEjrvbuuGqYn77v2h4cDFKuNUx,Fv9qiMZhuSBL2cs9AWUYbDLQjB46W2ZwrhxaNXtPLDpC,True,1924116827,481029206,1445699,722849,722850,DA18qE9qesbBqpwNv1M4befYcNQkbSBSeLPTmQzrmbJw,57827978,269371696,-211543718,300
2022-05-09 12:51:12-04:00,20449,Eo5LYLiUCspbrK13ker5skq9kMjnpUJEJPSbRDWjH6V4,GefeNAw5BdDkibatZknZVGsLhkfc8wfxriEfjHNpvMPm,True,1367259178,341814794,993998,496999,496999,3zqXX6kzhkbW3d4TwD2CNjMRwxTbREXySekvq37kfCNk,39759949,474551593,-434791644,290
2022-05-09 12:51:15-04:00,20450,D5VZNThkv6XD6bimPshD2J3PvbPXgCbivZuPfkVxgdjc,8C77LmMk4C3KvyEb1N3scdbAgwN7J45nAcv9tkL5namB,True,122261935,30565483,190327,95163,95164,6L1WYrPiCMyi7XemPww4B4hvpKD1LQKD4RpiSKmrmgSC,7613118,64539806,-56926688,622
2022-05-09 12:51:15-04:00,20451,H9pFRayNBHTAhsbtGyfs1XXUWGxAbw7SgpT1xdrSRWEY,9LNreyXuhgyLCDYViNyA1jUw6h1nv4GmDtTYMoUQBqCG,True,1922091487,271417605,807663,403831,403832,A9TwRM1BMxqb8DCC7YNAMV6zPenEJm3HTZBy7wJKK58U,57196108,862289656,-805093548,297
2022-05-09 12:51:31-04:00,20452,2BtRzBie97hsFBLgu4X4dTGCtv8We7npaXM9MmcqdWvf,C2hEQdUE3nFGJB3e6pHx8JZguZfdW9FYDHi9PGXkakm,True,397642264,62600402,183834,91917,91917,Hu94aiQWvce6THeGyCFqGRPM1pQrK3ihzkcXo1EpJcJL,11677359,33347546,-21670187,293
2022-05-09 12:51:33-04:00,20453,6pUtYz474QrpATEZnfb3iFbTKYA65pNyKAo4TQZAjtqe,8dipRUXvxJiDLdHEtCPkso4vErbVwshHQiRfvSngBS9J,True,105055469,8356042,28624,14312,14312,2a35JJeTUW1pm6M3e8DHCjp8qr4vbc2cRPhuzZWyFzYd,3598808,77679867,-74081059,342
2022-05-09 12:51:51-04:00,20454,9ancY5Fso8pUktKpRj3qc1YPQA6thy5n4f7uvNnsqMWR,CLUi9rvU9NTi7h4sNwqfr8aqChyGDbVJA1aKvKMWQv2r,True,378226003,94556500,282815,141407,141408,DA18qE9qesbBqpwNv1M4befYcNQkbSBSeLPTmQzrmbJw,11312639,101382377,-90069738,299
2022-05-09 12:51:51-04:00,20455,7PzGZgzieFyyFs1dbajkNQgVxooFUNZrj1bUsQvrSwbp,A2gDREmSmJTBPPw3sbKVY3smC9wbHMDdv87gr4Tr2ES7,True,102792843,25698210,73782,36891,36891,72FwbpFGoLEazJEdpqNtPNefsadUrimUqma9wSoy4qiS,2951291,17994374,-15043083,287
2022-05-09 12:51:51-04:00,20456,8T4WK27RvWVGqPuNqY6whk1fmU4vd5qaUQPZG1GJ79bh,DvSz7knS8N3K7L6JhQf1s4mJSyxB8uJXNQXtyjJn8QRL,True,108517780,25723236,76044,38022,38022,72FwbpFGoLEazJEdpqNtPNefsadUrimUqma9wSoy4qiS,3208100,23295528,-20087428,295
2022-05-09 12:51:51-04:00,20457,EVMrznfJS54BZiywDD2WhUtxzicDtbEpm2a5yLrtCgRF,CpzsMYVYvKg8ihrX1cKRw7TDEYwD3kAyiX92hsf2KiTz,True,119403539,7927154,36895,18447,18448,72FwbpFGoLEazJEdpqNtPNefsadUrimUqma9wSoy4qiS,5557517,93949585,-88392068,465
2022-05-09 12:52:02-04:00,20458,CvR57tmtnHbMmPivvJR6VenXivQaWue7z77N81WPpzfv,B4ASc8cUjrzuchv2SHwPrnjKvZgZpwvcLArsdYmMAqBQ,True,83621566,20905391,60551,30275,30276,72FwbpFGoLEazJEdpqNtPNefsadUrimUqma9wSoy4qiS,2422076,26485468,-24063392,289
2022-05-09 12:52:27-04:00,20459,F9s8a7Cpiw5dw3a2aNFMofqwyDWNXvDLnSdJzoj1gRiV,GpKsQKJD79KBRWdCTkyi4zX7NaoCWsLUjrKxAwJB6o6s,True,9612692102,2402146579,7181128,3590564,3590564,3zqXX6kzhkbW3d4TwD2CNjMRwxTbREXySekvq37kfCNk,287367887,943344770,-655976883,298
2022-05-09 12:52:34-04:00,20460,9eWpSyu71Z6dmx7yTh7WrbVScdrrZN14d5tfmqEGFgXt,2r89PFKSD9zmSp2Wyx4CQ75HAtmUgwhAS2oG5MuYuiV6,True,150607325,12932460,52402,26201,26201,72FwbpFGoLEazJEdpqNtPNefsadUrimUqma9wSoy4qiS,6102668,79812407,-73709739,405
2022-05-09 12:52:36-04:00,20461,fAJK1wrBhSW297AtFWX2U4rUBf2gkzfQ6UrQL9yHEYW,5pyTFpanSyUCHxeMhJMKtpdrcMSAWc8bFadbyM7q4q4B,True,119043808,29760952,86864,43432,43432,72FwbpFGoLEazJEdpqNtPNefsadUrimUqma9wSoy4qiS,3474586,14148397,-10673811,291
2022-05-09 12:52:39-04:00,20462,8e3Du79eCAvuNc6ZX44quJRCuCxmjVDNhRHr1eTB3wqr,3Lb3b9ikztneijmjUzNgHKzCBBfFNKbpjAyc7DQ8pE2M,True,240962767,60240691,177325,88662,88663,3zqXX6kzhkbW3d4TwD2CNjMRwxTbREXySekvq37kfCNk,7093009,141094476,-134001467,294
2022-05-09 12:52:39-04:00,20463,EyNCsqWu8zLyuRnXSbzJWnWZg7ZLjb4oJSZFdDSkbXmT,6rMMMkZibUHXYs8hXY3FmG4rgBx6gWDRGJwR2bP2t6ZD,True,17345292395,3463297640,12735064,6367532,6367532,8HQmsTbxhLhy25fvfCb16HudTGQ9wkHoEBRz5WYeqiZw,637812413,4207730761,-3569918348,367
2022-05-09 12:52:43-04:00,20464,6pUtYz474QrpATEZnfb3iFbTKYA65pNyKAo4TQZAjtqe,8dipRUXvxJiDLdHEtCPkso4vErbVwshHQiRfvSngBS9J,True,96542175,3813494,13481,6740,6741,2a35JJeTUW1pm6M3e8DHCjp8qr4vbc2cRPhuzZWyFzYd,3412932,74327558,-70914626,353
2022-05-09 12:52:45-04:00,20465,BQYbbwd1MLtj6fBuBiTncAaXdAqKWa1JbcbGkZbLA728,2Wsyr6KoMbSVSvFy3YzutuEQ6skGUZyVHGM42SN4eU98,True,8390369767,330239297,1167118,583559,583559,A9TwRM1BMxqb8DCC7YNAMV6zPenEJm3HTZBy7wJKK58U,296529181,10516874151,-10220344970,353
2022-05-09 12:52:46-04:00,20466,AL8JFS4gjaQx89f9j8wtaNJgV76K8bw1ugvNtgvhgAnb,HJYvG2kGKe8kXgtZSWTWwTmSjxA3XUeCvyT7acoKtS1C,True,6628660955,1657165238,4990057,2495028,2495029,72XWPCtRYEDZbddP7d6dHtUBRRDLSJsB2xZTAfefoEVZ,199602316,2039289494,-1839687178,301
2022-05-09 12:52:54-04:00,20467,DBT4GeddD8Ve8v7kerU1xrdJyy5moqUedcjYgM2jWESV,FVdbkwTpM3U6E4qQ9E2T9rTJ4dFYdkixsibnEiZqNUsA,True,284392302,71098075,211787,105893,105894,3zqXX6kzhkbW3d4TwD2CNjMRwxTbREXySekvq37kfCNk,8471504,89994942,-81523438,297
2022-05-09 12:52:58-04:00,20468,BJUNK2orMVx6mYsD9pnQzmsEh95ZF2NWPm9KJ1ZM67Qn,FpxLa3DwWrspYvHVsScSDcscHB2eBHGxRrQ4gVvn4VW,False,27221306,27221306,766857,38342,728515,72FwbpFGoLEazJEdpqNtPNefsadUrimUqma9wSoy4qiS,766857,10242499,-9475642,281
2022-05-09 12:53:00-04:00,20469,E3Tv8DA7HAQjNtMJ5GDaVvGj3RSsuqLGA99oV14vyrPU,2Bhtp9jmtvyj2FjK2M8RUKezH1gmV1RYCAzbDepzrrFS,True,62919177,3446304,14572,7286,7286,3zqXX6kzhkbW3d4TwD2CNjMRwxTbREXySekvq37kfCNk,2660540,29741930,-27081390,422
2022-05-09 12:53:01-04:00,20470,4hZG7dM716SxDagiFGwt1gSC99B2QK1emGLV9TJmmuR8,7vjfUWySkyx4Z5qAaRr2VWnVvxHHNsvPj1PirGNSjM6,False,14421213,14421213,897609,44880,852729,Hu94aiQWvce6THeGyCFqGRPM1pQrK3ihzkcXo1EpJcJL,897609,14759770,-13862161,622
2022-05-09 12:53:07-04:00,20471,BTXpvCdmYEmg5fB2Hsjc6Wked2sky4oQpGu7r8KuPau4,CaEwxQQds9f44npaSrYAsC6WpE3T6MpAGr9jgXZeqWjA,True,30086904,1353443,5536,2768,2768,C5o4TfkUfECutAWsDELjhsZX6PYyYgK3XeKvx6p4FphM,1230779,10308484,-9077705,409
2022-05-09 12:53:08-04:00,20472,BSUa3ArsftaRgVww5eEU9bFsq7bYRfRsdAWc1PY9Tqwp,4rtPyGw8SrDEZfLF7NZhKKp6opuBi5jxxwCb4CKtb4AR,True,52890654,2946683,12923,6461,6462,8sEswn3kzEhnYjAZVvCQnHEUvYd7pFVvc2Xc2Kd1BpbC,2319747,24423036,-22103289,438
2022-05-09 12:53:24-04:00,20473,EHi1UBG8wMUFZECktsFUZkGjJPaBNEedswS62hyYn6jC,Drx9ErQhAjnPuJ83LPYFnY5ZV5XDzGuXDuSf16VqWayp,True,138740645,15386826,55857,27928,27929,3zqXX6kzhkbW3d4TwD2CNjMRwxTbREXySekvq37kfCNk,5036633,104829980,-99793347,363
2022-05-09 12:53:24-04:00,20474,Bzp3ZUxzRWqW4QoLq9PtKN1HQeSaKXFQrX1G3a4ocrre,H12B3p4v1ZtZ9gaSgpxCJsKXmmEjiqaRZQzexjzAhevo,True,876573076,57252542,260763,130381,130382,A9TwRM1BMxqb8DCC7YNAMV6zPenEJm3HTZBy7wJKK58U,39924615,522057775,-482133160,455
2022-05-09 12:53:26-04:00,20475,42h4NteqFpLjgjMS4gTTFoLvrEMpEP4sbGRd7SM5YCZR,AasJCLP5qsGzxkQs5jWysSarwoJTuZ6ZDeabNJNimWAX,True,1010294847,252573711,737876,368938,368938,DA18qE9qesbBqpwNv1M4befYcNQkbSBSeLPTmQzrmbJw,29515059,130694667,-101179608,292
2022-05-09 12:53:28-04:00,20476,HeyRAEkqGTtCj2cMfGR6pbeY5nu4qERFmZSovsfhUtaq,5MDbdhQUt3USB1RFmdLsrAc5UUXZ1n8jXRQFtJ6ibj9B,True,54413436,3051521,13316,6658,6658,3zqXX6kzhkbW3d4TwD2CNjMRwxTbREXySekvq37kfCNk,2374481,17961212,-15586731,436
2022-05-09 12:53:35-04:00,20477,FncFHJooh1hy9Gc2y5sKdcYkZ5uHzsxHG4vHT9cVZGcK,BkFa4b5Jyv4ZJCCpwDYv355ezVFiZfAtn18AV7kstd2v,True,35789276,8947319,25756,12878,12878,72FwbpFGoLEazJEdpqNtPNefsadUrimUqma9wSoy4qiS,1030279,9681664,-8651385,287
2022-05-09 12:53:38-04:00,20478,E4VzeJLsf5Y6t3yNi8VpS8QxhJbJGPhnkNBmU2XoCBs9,63CXyYfevXtrL1QcfQtAhz29xeea5BwWcj6d6BWb4qiB,True,549878358,137469589,399304,199652,199652,A9TwRM1BMxqb8DCC7YNAMV6zPenEJm3HTZBy7wJKK58U,15972170,274147596,-258175426,290
2022-05-09 12:53:43-04:00,20479,H9pFRayNBHTAhsbtGyfs1XXUWGxAbw7SgpT1xdrSRWEY,9LNreyXuhgyLCDYViNyA1jUw6h1nv4GmDtTYMoUQBqCG,True,1644084302,207952454,629881,314940,314941,A9TwRM1BMxqb8DCC7YNAMV6zPenEJm3HTZBy7wJKK58U,49798865,762425604,-712626739,302
2022-05-09 12:53:43-04:00,20480,532MfQR1PzPn6cmC1kpZsz9MyBWSamSeieh1F6GqVY33,6sJ8XXMZzGbHjVU1vWNW8unWoBZhJa54GguYJQhcb8PA,True,422683235,60583543,391215,195607,195608,72FwbpFGoLEazJEdpqNtPNefsadUrimUqma9wSoy4qiS,27294569,116793457,-89498888,645
