ts,record_id,user_authority,user,partial,base_asset_value,base_asset_value_closed,liquidation_fee,fee_to_liquidator,fee_to_insurance_fund,liquidator,total_collateral,collateral,unrealized_pnl,margin_ratio
2022-02-07 09:07:06-05:00,11265,Dztk7aGAPGgmyQ4kF9s5bVJ3zFPjXm6wLirhFMG1UQCw,sDX9hCP4LjF1tsfbfAcvRrUre3TsTn5RUqHsUeEHjbW,True,2360995615,590248901,3687553,1843776,1843777,DddJ7EWCmYEEZETCBNgAUSg81Ls6fZtiAaY5ekJ5sXx1,147502157,356867069,-209364912,624
2022-02-07 09:16:19-05:00,11266,4Siq98BDakELWP5BzVoEN5tcg1ywRxTYs1aUcfW8spCt,2EBXLTVz1Gk9gS5JcVqCKAP5PatFGw1Vnww65Moz3SUn,True,3719202148,929800535,5806535,2903267,2903268,HfEnetJ7uBSmZWCjBNxdvv9HEC5nsW4wDV7wu6WnhWan,232261428,1012164973,-779903545,624
2022-02-07 09:16:52-05:00,11267,GJmom1dyridk7QkcvxYr1jUeQr6sT5yMnmQ6LJEqSq22,6tSYWuTpo57phZVwLZ4jEAod4w4dKfAwRVitjzGKXq9y,True,264075323448,66018830861,413102193,206551096,206551097,3zqXX6kzhkbW3d4TwD2CNjMRwxTbREXySekvq37kfCNk,16524087730,51773664075,-35249576345,625
2022-02-07 09:26:13-05:00,11268,Dztk7aGAPGgmyQ4kF9s5bVJ3zFPjXm6wLirhFMG1UQCw,sDX9hCP4LjF1tsfbfAcvRrUre3TsTn5RUqHsUeEHjbW,True,1802629999,450657497,2799043,1399521,1399522,HfEnetJ7uBSmZWCjBNxdvv9HEC5nsW4wDV7wu6WnhWan,111961731,300863670,-188901939,621
2022-02-07 09:27:33-05:00,11269,4Siq98BDakELWP5BzVoEN5tcg1ywRxTYs1aUcfW8spCt,2EBXLTVz1Gk9gS5JcVqCKAP5PatFGw1Vnww65Moz3SUn,True,2838187906,709546975,4441715,2220857,2220858,DddJ7EWCmYEEZETCBNgAUSg81Ls6fZtiAaY5ekJ5sXx1,177668600,811445453,-633776853,625
2022-02-07 09:32:40-05:00,11270,EeztHR1M4PPacJEZ6c5arCRVCuu8aN7eGdpY1u4bev79,9Twdc9Xrzv2oeJ9Fbd8mRvzjbFi7mkGopFS37SMabeAK,True,5709881,1427470,8914,4457,4457,2BPYaeCXY4BCFSGFSfiGtqmhzJ4fkhYLxGjqFvLCB6hG,356567,1065879,-709312,624
2022-02-07 09:32:42-05:00,11271,8fSFsWaVRYHg5fdFQFQ89aBTjqsodGyc4sinV5UbWxtc,8evZpC24viqM8NaVFRjR91jLjXHLkW6GYAdywY8h2wys,True,319684651,79921161,499265,249632,249633,3zqXX6kzhkbW3d4TwD2CNjMRwxTbREXySekvq37kfCNk,19970613,79520164,-59549551,624
2022-02-07 09:38:40-05:00,11272,GJmom1dyridk7QkcvxYr1jUeQr6sT5yMnmQ6LJEqSq22,6tSYWuTpo57phZVwLZ4jEAod4w4dKfAwRVitjzGKXq9y,True,201571591090,50392897771,314897216,157448608,157448608,2BPYaeCXY4BCFSGFSfiGtqmhzJ4fkhYLxGjqFvLCB6hG,12595888670,43345166963,-30749278293,624
2022-02-07 09:44:50-05:00,11273,CvR57tmtnHbMmPivvJR6VenXivQaWue7z77N81WPpzfv,B4ASc8cUjrzuchv2SHwPrnjKvZgZpwvcLArsdYmMAqBQ,True,2031768476,507942119,3165530,1582765,1582765,3zqXX6kzhkbW3d4TwD2CNjMRwxTbREXySekvq37kfCNk,126621226,389045090,-262423864,623
2022-02-07 09:50:25-05:00,11274,2Cjv6suZGsbRtv4TNSYksWKwMEKEf8vGQhGPbVVM1BMP,BHakHWmqzwqzq7i3a7VmXySPMMit58aQn7z4fqorcBHD,True,139622,34905,217,108,109,2BPYaeCXY4BCFSGFSfiGtqmhzJ4fkhYLxGjqFvLCB6hG,8692,41691,-32999,622
2022-02-07 09:50:42-05:00,11275,7SBSVWCWENfJpg3Rd61kHjvj7rf5RchHeWChE42jdfk2,GNgZk4pw4cyetbovfqLtjdD5eEJTvJmrNbk572XnBeeN,True,506434,126608,792,396,396,DddJ7EWCmYEEZETCBNgAUSg81Ls6fZtiAaY5ekJ5sXx1,31680,151948,-120268,625
2022-02-07 09:51:01-05:00,11276,AcYBSWf2zG931K8WHncTWcNZhjrsJVWB9KQcTKhCoDw6,82Bw7jathCEZbRn9dExCPGpZAmxxdHkhVZ9hu7rQ3ZKY,True,12936823,3234205,19937,9968,9969,DddJ7EWCmYEEZETCBNgAUSg81Ls6fZtiAaY5ekJ5sXx1,797493,3244039,-2446546,616
2022-02-07 09:51:02-05:00,11277,HcGtTcpuxex2eQyz6GjJHrjDgThU2ZWSjjnzNEf7tNXy,XuFuE8RxTusW8BYDczgzvWrD5YbDseACo2edd2K4tVv,True,35549,8887,55,27,28,HfEnetJ7uBSmZWCjBNxdvv9HEC5nsW4wDV7wu6WnhWan,2217,9956,-7739,623
2022-02-07 09:51:02-05:00,11278,6Z21rKncoJkLt4pkCrfiWw4m9bmkbF3ZNgocQ6WxViKf,14bbVwC4hEJMKRHM2v6N416HMQcr9fmTnt5anBGYTM5L,True,5963957,1490989,9216,4608,4608,HfEnetJ7uBSmZWCjBNxdvv9HEC5nsW4wDV7wu6WnhWan,368641,1828277,-1459636,618
2022-02-07 09:51:05-05:00,11279,4v6CPCxRjQfBAnHQT1yD9ZN87xf2fsrg9Qq2TBk8uwnw,4vw7teF227NahBhsX4z7k8UnSjVtkx6dhk4YFQXap9Qh,True,72329,18082,112,56,56,DddJ7EWCmYEEZETCBNgAUSg81Ls6fZtiAaY5ekJ5sXx1,4504,20346,-15842,622
2022-02-07 09:52:42-05:00,11280,Fqv7VT7nfxUGb18xwFJLTo8gsdjhpAJpMveqDK4aRw83,Ha9N6X6oL8kkoDpXtrybq2ocSPJUEeYHwqoAjxiTJ7rV,True,18960144,4740036,29647,14823,14824,DddJ7EWCmYEEZETCBNgAUSg81Ls6fZtiAaY5ekJ5sXx1,1185894,5780679,-4594785,625
2022-02-07 09:57:16-05:00,11281,Ar1byxam88MXtpNKFNK28ar8reMDEJE7vdg3KGJHeZwt,Gv2D2eMAA3YgfhBg8kbtqWgM7as3RJGiY9oyTjPH8j8P,True,138156,34539,216,108,108,DddJ7EWCmYEEZETCBNgAUSg81Ls6fZtiAaY5ekJ5sXx1,8644,41310,-32666,625
2022-02-07 09:57:27-05:00,11282,DE8c5VWwgCqQnUMSyMZEbKazQAsSjY52L85yojCr57X5,6ycUU1Tc7HG3J8hE6jwkRFCkdbEqyU95ZKY6HbfnYcGo,True,41828,10457,65,32,33,DddJ7EWCmYEEZETCBNgAUSg81Ls6fZtiAaY5ekJ5sXx1,2611,12059,-9448,624
2022-02-07 09:57:28-05:00,11283,6xeNr9LhAfC6FRV62dALYdgx3bsoUpUpmEBiUPYCV5fz,8GP5cEpfNTEjvqm9usBUXs7jPCK5RciqjVJqtvX9fuGs,True,67687766,16921941,105912,52956,52956,DddJ7EWCmYEEZETCBNgAUSg81Ls6fZtiAaY5ekJ5sXx1,4236484,16050363,-11813879,625
2022-02-07 09:59:19-05:00,11284,Dztk7aGAPGgmyQ4kF9s5bVJ3zFPjXm6wLirhFMG1UQCw,sDX9hCP4LjF1tsfbfAcvRrUre3TsTn5RUqHsUeEHjbW,True,1375740905,343935225,2137232,1068616,1068616,HfEnetJ7uBSmZWCjBNxdvv9HEC5nsW4wDV7wu6WnhWan,85489309,250853586,-165364277,621
2022-02-07 10:02:08-05:00,11285,74jAYqk5kSPvKZrF85t9Mh4a5vNVQB2o3udEmzrkYVe1,6Db3pdLC94Vy4N34SutNyXjmJjtbef2sYxiWFiWD97Va,True,6435717896,1608929474,10069647,5034823,5034824,DddJ7EWCmYEEZETCBNgAUSg81Ls6fZtiAaY5ekJ5sXx1,402785913,1138833810,-736047897,625
2022-02-07 10:10:12-05:00,11286,4Siq98BDakELWP5BzVoEN5tcg1ywRxTYs1aUcfW8spCt,2EBXLTVz1Gk9gS5JcVqCKAP5PatFGw1Vnww65Moz3SUn,True,2166622254,541655561,3379903,1689951,1689952,HfEnetJ7uBSmZWCjBNxdvv9HEC5nsW4wDV7wu6WnhWan,135196149,648545916,-513349767,623
2022-02-07 10:38:26-05:00,11287,53ePCviKDQrvrk285FVrHhxmN3avWEzLqWsSk5w3PkGT,Ax59hjzmP64tGFd5msTyh1ueeVNhHAhtKkyymC6HpfAK,True,150870,37717,235,117,118,DddJ7EWCmYEEZETCBNgAUSg81Ls6fZtiAaY5ekJ5sXx1,9414,45208,-35794,623
2022-02-07 10:38:39-05:00,11288,winXxFA6HNBu1BTxfeecCfFfYrgQd9JHrF67zU5Xake,H8kGL9rpbEjDZitZfyezJ9bfaEDXe3teAvnb62iLFFVr,True,1534081,383520,2390,1195,1195,DddJ7EWCmYEEZETCBNgAUSg81Ls6fZtiAaY5ekJ5sXx1,95633,428794,-333161,623
2022-02-07 10:46:35-05:00,11289,GJmom1dyridk7QkcvxYr1jUeQr6sT5yMnmQ6LJEqSq22,6tSYWuTpo57phZVwLZ4jEAod4w4dKfAwRVitjzGKXq9y,True,153848702673,38462175667,240177441,120088720,120088721,DddJ7EWCmYEEZETCBNgAUSg81Ls6fZtiAaY5ekJ5sXx1,9607097658,35787662891,-26180565233,624
2022-02-07 10:50:22-05:00,11290,2uEPjuysyi2H75brTSXi8Ca5z3GhgNht14wskXJrUbk6,EhZ2URGbAjrVPnJ92MLLpbMRNPF6ctYnX34S2wjU81Va,True,3435696546,858924136,5360266,2680133,2680133,HfEnetJ7uBSmZWCjBNxdvv9HEC5nsW4wDV7wu6WnhWan,214410677,1105089388,-890678711,624
2022-02-07 10:52:20-05:00,11291,8fSFsWaVRYHg5fdFQFQ89aBTjqsodGyc4sinV5UbWxtc,8evZpC24viqM8NaVFRjR91jLjXHLkW6GYAdywY8h2wys,True,243983869,60995966,381100,190550,190550,DddJ7EWCmYEEZETCBNgAUSg81Ls6fZtiAaY5ekJ5sXx1,15244005,64126896,-48882891,624
2022-02-07 10:59:01-05:00,11292,EeztHR1M4PPacJEZ6c5arCRVCuu8aN7eGdpY1u4bev79,9Twdc9Xrzv2oeJ9Fbd8mRvzjbFi7mkGopFS37SMabeAK,True,4363541,1090885,6658,3329,3329,DddJ7EWCmYEEZETCBNgAUSg81Ls6fZtiAaY5ekJ5sXx1,266344,879458,-613114,610
2022-02-07 11:36:00-05:00,11293,54rcQUxBXFfoNq8n9RxsxH1Lp4VHR2CfE71vCCVy6rPQ,4exavmUP5CfqEmqVusSNuW9Ha2rhPBAy2gg6rP2d5tvu,True,454006687,113501671,709816,354908,354908,DddJ7EWCmYEEZETCBNgAUSg81Ls6fZtiAaY5ekJ5sXx1,28392657,168556219,-140163562,625
2022-02-07 11:36:03-05:00,11294,CBL2NbekJrXvBiAcoj4fzQ4PfLDwTntW7Zt4nruHFYEw,59EvfgYTdKkfjUJz5LddLUAqbEdLaihcMzjcrTZsyzyS,True,55526,13881,86,43,43,HfEnetJ7uBSmZWCjBNxdvv9HEC5nsW4wDV7wu6WnhWan,3462,17308,-13846,623
2022-02-07 12:47:54-05:00,11295,FbHy7WdYB5Ts5pqRr2U4y9iU6F5rCSEqU7Sy6VfQgyzs,J5FCc8PHmihewwiYcnb6mikTEyTKrVhb7R51yNkr1gfW,True,65819825,16454956,102859,51429,51430,DddJ7EWCmYEEZETCBNgAUSg81Ls6fZtiAaY5ekJ5sXx1,4114387,13946313,-9831926,625
2022-02-07 12:56:20-05:00,11296,74jAYqk5kSPvKZrF85t9Mh4a5vNVQB2o3udEmzrkYVe1,6Db3pdLC94Vy4N34SutNyXjmJjtbef2sYxiWFiWD97Va,True,4911626942,1227906735,7684374,3842187,3842187,3zqXX6kzhkbW3d4TwD2CNjMRwxTbREXySekvq37kfCNk,307374989,944680563,-637305574,625
2022-02-07 14:39:59-05:00,11297,Dztk7aGAPGgmyQ4kF9s5bVJ3zFPjXm6wLirhFMG1UQCw,sDX9hCP4LjF1tsfbfAcvRrUre3TsTn5RUqHsUeEHjbW,True,1050383908,262595975,1616409,808204,808205,3zqXX6kzhkbW3d4TwD2CNjMRwxTbREXySekvq37kfCNk,64656385,207283884,-142627499,615
2022-02-07 14:40:00-05:00,11298,4Siq98BDakELWP5BzVoEN5tcg1ywRxTYs1aUcfW8spCt,2EBXLTVz1Gk9gS5JcVqCKAP5PatFGw1Vnww65Moz3SUn,True,1654609837,413652458,2550160,1275080,1275080,2BPYaeCXY4BCFSGFSfiGtqmhzJ4fkhYLxGjqFvLCB6hG,102006400,516682203,-414675803,616
2022-02-07 14:54:33-05:00,11299,4Siq98BDakELWP5BzVoEN5tcg1ywRxTYs1aUcfW8spCt,2EBXLTVz1Gk9gS5JcVqCKAP5PatFGw1Vnww65Moz3SUn,True,1261472042,315368009,1973539,986769,986770,DddJ7EWCmYEEZETCBNgAUSg81Ls6fZtiAaY5ekJ5sXx1,78941577,410474678,-331533101,625
2022-02-07 20:57:54-05:00,11300,BZxJ6CtrVoiU86DMMieMeDFLNWtMpHGTvZfM7nyay6o4,6CRxRR8bisRLHFJBFWjyumYuy7j4C4PkjYH1K8gXhdWD,True,78810568,19702642,123322,61661,61661,3zqXX6kzhkbW3d4TwD2CNjMRwxTbREXySekvq37kfCNk,4932889,13753458,-8820569,625
2022-02-07 23:00:41-05:00,11301,2uEPjuysyi2H75brTSXi8Ca5z3GhgNht14wskXJrUbk6,EhZ2URGbAjrVPnJ92MLLpbMRNPF6ctYnX34S2wjU81Va,True,2644381526,661095381,3520942,1760471,1760471,HfEnetJ7uBSmZWCjBNxdvv9HEC5nsW4wDV7wu6WnhWan,140837697,876543973,-735706276,532
2022-02-07 23:00:43-05:00,11302,2uEPjuysyi2H75brTSXi8Ca5z3GhgNht14wskXJrUbk6,EhZ2URGbAjrVPnJ92MLLpbMRNPF6ctYnX34S2wjU81Va,True,1996725097,499181274,3096945,1548472,1548473,HfEnetJ7uBSmZWCjBNxdvv9HEC5nsW4wDV7wu6WnhWan,123877803,689146676,-565268873,620
2022-02-07 23:00:53-05:00,11303,8fSFsWaVRYHg5fdFQFQ89aBTjqsodGyc4sinV5UbWxtc,8evZpC24viqM8NaVFRjR91jLjXHLkW6GYAdywY8h2wys,True,187094629,46773656,268095,134047,134048,HfEnetJ7uBSmZWCjBNxdvv9HEC5nsW4wDV7wu6WnhWan,10723836,51492928,-40769092,573
2022-02-07 23:00:53-05:00,11304,2uEPjuysyi2H75brTSXi8Ca5z3GhgNht14wskXJrUbk6,EhZ2URGbAjrVPnJ92MLLpbMRNPF6ctYnX34S2wjU81Va,True,1528102849,382025712,2255545,1127772,1127773,DddJ7EWCmYEEZETCBNgAUSg81Ls6fZtiAaY5ekJ5sXx1,90221832,544760851,-454539019,590
2022-02-07 23:01:02-05:00,11305,2uEPjuysyi2H75brTSXi8Ca5z3GhgNht14wskXJrUbk6,EhZ2URGbAjrVPnJ92MLLpbMRNPF6ctYnX34S2wjU81Va,True,1163790975,290947743,1756311,878155,878156,3zqXX6kzhkbW3d4TwD2CNjMRwxTbREXySekvq37kfCNk,70252449,428886653,-358634204,603
2022-02-07 23:01:04-05:00,11306,8fSFsWaVRYHg5fdFQFQ89aBTjqsodGyc4sinV5UbWxtc,8evZpC24viqM8NaVFRjR91jLjXHLkW6GYAdywY8h2wys,True,142118106,35529525,216465,108232,108233,3zqXX6kzhkbW3d4TwD2CNjMRwxTbREXySekvq37kfCNk,8658608,41032673,-32374065,609
2022-02-07 23:01:10-05:00,11307,2uEPjuysyi2H75brTSXi8Ca5z3GhgNht14wskXJrUbk6,EhZ2URGbAjrVPnJ92MLLpbMRNPF6ctYnX34S2wjU81Va,True,886609493,221652373,1368246,684123,684123,DddJ7EWCmYEEZETCBNgAUSg81Ls6fZtiAaY5ekJ5sXx1,54729877,337480918,-282751041,617
2022-02-07 23:01:14-05:00,11308,5jdnNir8fdbQPjFvUxNJsXEKL25Z5FnzGv3aWGDVSwZr,9xBDrqNefNRGx4oxmsqu7xngt7RDqWpWihJ7yaXVvJ2U,True,415248,103811,617,308,309,2BPYaeCXY4BCFSGFSfiGtqmhzJ4fkhYLxGjqFvLCB6hG,24702,119933,-95231,594
2022-02-08 00:46:25-05:00,11309,EeztHR1M4PPacJEZ6c5arCRVCuu8aN7eGdpY1u4bev79,9Twdc9Xrzv2oeJ9Fbd8mRvzjbFi7mkGopFS37SMabeAK,True,3323538,830884,5185,2592,2593,3zqXX6kzhkbW3d4TwD2CNjMRwxTbREXySekvq37kfCNk,207428,718145,-510717,624
2022-02-08 00:50:28-05:00,11310,FbHy7WdYB5Ts5pqRr2U4y9iU6F5rCSEqU7Sy6VfQgyzs,J5FCc8PHmihewwiYcnb6mikTEyTKrVhb7R51yNkr1gfW,True,50228441,12557110,78308,39154,39154,3zqXX6kzhkbW3d4TwD2CNjMRwxTbREXySekvq37kfCNk,3132331,11369890,-8237559,623
2022-02-08 01:08:36-05:00,11311,74jAYqk5kSPvKZrF85t9Mh4a5vNVQB2o3udEmzrkYVe1,6Db3pdLC94Vy4N34SutNyXjmJjtbef2sYxiWFiWD97Va,True,3749392039,937348009,5816909,2908454,2908455,2BPYaeCXY4BCFSGFSfiGtqmhzJ4fkhYLxGjqFvLCB6hG,232676360,776571963,-543895603,620
2022-02-08 01:12:09-05:00,11312,CvR57tmtnHbMmPivvJR6VenXivQaWue7z77N81WPpzfv,B4ASc8cUjrzuchv2SHwPrnjKvZgZpwvcLArsdYmMAqBQ,True,1550052581,387513145,2423455,1211727,1211728,3zqXX6kzhkbW3d4TwD2CNjMRwxTbREXySekvq37kfCNk,96938222,320035055,-223096833,625
2022-02-08 01:18:38-05:00,11313,BZxJ6CtrVoiU86DMMieMeDFLNWtMpHGTvZfM7nyay6o4,6CRxRR8bisRLHFJBFWjyumYuy7j4C4PkjYH1K8gXhdWD,True,60146364,15036591,93755,46877,46878,DddJ7EWCmYEEZETCBNgAUSg81Ls6fZtiAaY5ekJ5sXx1,3750229,11404210,-7653981,623
2022-02-08 01:18:57-05:00,11314,EeztHR1M4PPacJEZ6c5arCRVCuu8aN7eGdpY1u4bev79,9Twdc9Xrzv2oeJ9Fbd8mRvzjbFi7mkGopFS37SMabeAK,True,2538719,634679,3901,1950,1951,2BPYaeCXY4BCFSGFSfiGtqmhzJ4fkhYLxGjqFvLCB6hG,156056,585159,-429103,614
2022-02-08 01:19:30-05:00,11315,64Diz8zzEv1jDWnBQPTHPpXwaWf7vjM19RyJmkPy1viQ,G8wkGHRHMtT3mvXBkH3zgsKNs8wbpdiPUS17y4cozhkZ,True,132606200,33151550,207312,103656,103656,3zqXX6kzhkbW3d4TwD2CNjMRwxTbREXySekvq37kfCNk,8292489,23328690,-15036201,625
2022-02-10 11:04:46-05:00,11316,5jdnNir8fdbQPjFvUxNJsXEKL25Z5FnzGv3aWGDVSwZr,9xBDrqNefNRGx4oxmsqu7xngt7RDqWpWihJ7yaXVvJ2U,True,306007,76500,478,239,239,DddJ7EWCmYEEZETCBNgAUSg81Ls6fZtiAaY5ekJ5sXx1,19150,95228,-76078,625
2022-02-10 12:17:35-05:00,11317,2uEPjuysyi2H75brTSXi8Ca5z3GhgNht14wskXJrUbk6,EhZ2URGbAjrVPnJ92MLLpbMRNPF6ctYnX34S2wjU81Va,True,674813621,168703405,1053465,526732,526733,3zqXX6kzhkbW3d4TwD2CNjMRwxTbREXySekvq37kfCNk,42138632,264063587,-221924955,624
2022-02-10 12:18:07-05:00,11318,74jAYqk5kSPvKZrF85t9Mh4a5vNVQB2o3udEmzrkYVe1,6Db3pdLC94Vy4N34SutNyXjmJjtbef2sYxiWFiWD97Va,True,2865672286,716418071,4381099,2190549,2190550,HfEnetJ7uBSmZWCjBNxdvv9HEC5nsW4wDV7wu6WnhWan,175243984,636932726,-461688742,611
2022-02-10 12:26:11-05:00,11319,8fSFsWaVRYHg5fdFQFQ89aBTjqsodGyc4sinV5UbWxtc,8evZpC24viqM8NaVFRjR91jLjXHLkW6GYAdywY8h2wys,True,108156540,27039134,169121,84560,84561,3zqXX6kzhkbW3d4TwD2CNjMRwxTbREXySekvq37kfCNk,6764866,32613437,-25848571,625
2022-02-10 14:25:05-05:00,11320,CPsnF5SkVCnFkFXhLwzpp6H7rBrTumCuYJCyVSeT8cFZ,BMV1AyAxyTuXTfwddphdRc3nwbySVbhqUZau8oatdTEJ,True,504341533,126085382,789281,394640,394641,3zqXX6kzhkbW3d4TwD2CNjMRwxTbREXySekvq37kfCNk,31571272,78701357,-47130085,625
2022-02-10 16:02:15-05:00,11321,5jdnNir8fdbQPjFvUxNJsXEKL25Z5FnzGv3aWGDVSwZr,9xBDrqNefNRGx4oxmsqu7xngt7RDqWpWihJ7yaXVvJ2U,True,223184,55794,348,174,174,DddJ7EWCmYEEZETCBNgAUSg81Ls6fZtiAaY5ekJ5sXx1,13929,75702,-61773,624
2022-02-11 13:43:55-05:00,11322,EYt1Pzqfwnd4iXSmcpw4T3Edmm1y3GnRhCjcQEEK4Atj,EHqporfvvfg7UQPsjv5tsgZE8u9yyRuEU2DdLpQeXy85,True,1743134806,435783701,2725321,1362660,1362661,3zqXX6kzhkbW3d4TwD2CNjMRwxTbREXySekvq37kfCNk,109012869,401348063,-292335194,625
2022-02-11 13:44:30-05:00,11323,3jJxvfbyc9KvECkLWTGptkezCLZfiums7GgfANyCULF3,C7fXi4upWW22F2Ak7AzsYVASjjdfZZtPmkQ9pBB2bJXZ,True,207574038,51893509,321673,160836,160837,2BPYaeCXY4BCFSGFSfiGtqmhzJ4fkhYLxGjqFvLCB6hG,12866920,71205171,-58338251,619
2022-02-11 13:45:50-05:00,11324,H8PYPdoedHZnHSaSrgtAE82Wyjh59MS6x5tJAFj4YVuW,AZw4V8JvQVsh3gPXSR9r6jqC1U2AGCdSLeM512zjtQac,True,125945540,31486385,195355,97677,97678,HfEnetJ7uBSmZWCjBNxdvv9HEC5nsW4wDV7wu6WnhWan,7814225,29018685,-21204460,620
2022-02-11 13:58:00-05:00,11325,EYt1Pzqfwnd4iXSmcpw4T3Edmm1y3GnRhCjcQEEK4Atj,EHqporfvvfg7UQPsjv5tsgZE8u9yyRuEU2DdLpQeXy85,True,1280866008,320216502,1995061,997530,997531,3zqXX6kzhkbW3d4TwD2CNjMRwxTbREXySekvq37kfCNk,79802451,325565561,-245763110,623
2022-02-11 13:59:42-05:00,11326,3jJxvfbyc9KvECkLWTGptkezCLZfiums7GgfANyCULF3,C7fXi4upWW22F2Ak7AzsYVASjjdfZZtPmkQ9pBB2bJXZ,True,152568739,38142184,235836,117918,117918,3zqXX6kzhkbW3d4TwD2CNjMRwxTbREXySekvq37kfCNk,9433457,56299351,-46865894,618
2022-02-11 13:59:43-05:00,11327,HN8L8AywaWrDWN6WFFjA74SPAAPUoWfLjFk18h1LmD1p,3ytiHFC1HDZaee9wTXr4oRmnJgpHHDBFLCZP8BQiXbLz,True,67269092339,16817273084,104170003,52085001,52085002,3zqXX6kzhkbW3d4TwD2CNjMRwxTbREXySekvq37kfCNk,4166800123,15494767784,-11327967661,619
2022-02-11 14:06:12-05:00,11328,H8PYPdoedHZnHSaSrgtAE82Wyjh59MS6x5tJAFj4YVuW,AZw4V8JvQVsh3gPXSR9r6jqC1U2AGCdSLeM512zjtQac,True,92597697,23149424,143808,71904,71904,HfEnetJ7uBSmZWCjBNxdvv9HEC5nsW4wDV7wu6WnhWan,5752355,23517299,-17764944,621
2022-02-11 15:05:45-05:00,11329,EYt1Pzqfwnd4iXSmcpw4T3Edmm1y3GnRhCjcQEEK4Atj,EHqporfvvfg7UQPsjv5tsgZE8u9yyRuEU2DdLpQeXy85,True,941169044,235292261,1455356,727678,727678,3zqXX6kzhkbW3d4TwD2CNjMRwxTbREXySekvq37kfCNk,58214241,262031856,-203817615,618
2022-02-11 15:05:53-05:00,11330,3jJxvfbyc9KvECkLWTGptkezCLZfiums7GgfANyCULF3,C7fXi4upWW22F2Ak7AzsYVASjjdfZZtPmkQ9pBB2bJXZ,True,112219130,28054782,174418,87209,87209,3zqXX6kzhkbW3d4TwD2CNjMRwxTbREXySekvq37kfCNk,6976738,44333815,-37357077,621
2022-02-11 15:06:08-05:00,11331,HN8L8AywaWrDWN6WFFjA74SPAAPUoWfLjFk18h1LmD1p,3ytiHFC1HDZaee9wTXr4oRmnJgpHHDBFLCZP8BQiXbLz,True,49446837672,12361709418,76292305,38146152,38146153,3zqXX6kzhkbW3d4TwD2CNjMRwxTbREXySekvq37kfCNk,3051692219,12592808820,-9541116601,617
2022-02-11 15:10:47-05:00,11332,6bMu9G5S9o2CSgHegDAymE4UcxrnKH9UfPE5iUmUJ6Aa,ACG6V3LfAH3JtJbBhiumrx7c4QciavNmGWKfBFt7eRz7,True,64197843,16049460,99231,49615,49616,3zqXX6kzhkbW3d4TwD2CNjMRwxTbREXySekvq37kfCNk,3969242,14761399,-10792157,618
2022-02-11 15:10:58-05:00,11333,F5KeSVqcP3C5G7SLQypv4G89gH5eCyoapPDxhyJdhm1L,CCYEZ6ttzu5PxK2yDg26ATDjMWmthLJo6Sbi7iGgExjY,True,598847059,149711764,929452,464726,464726,3zqXX6kzhkbW3d4TwD2CNjMRwxTbREXySekvq37kfCNk,37178106,138251047,-101072941,620
2022-02-11 15:11:03-05:00,11334,H8PYPdoedHZnHSaSrgtAE82Wyjh59MS6x5tJAFj4YVuW,AZw4V8JvQVsh3gPXSR9r6jqC1U2AGCdSLeM512zjtQac,True,68057303,17014325,105327,52663,52664,3zqXX6kzhkbW3d4TwD2CNjMRwxTbREXySekvq37kfCNk,4213115,18927872,-14714757,619
2022-02-11 15:22:45-05:00,11335,9Ngb4UJjvSm9zbTN4RYRFWBzTPVWQh7C2hFiDvwPsDBd,EamTKaoTYJo9RUMQC7MjS1HJrVPYipR2cv6nYpgBLnPr,True,137587451,34396862,214715,107357,107358,3zqXX6kzhkbW3d4TwD2CNjMRwxTbREXySekvq37kfCNk,8588633,57810905,-49222272,624
2022-02-11 15:23:05-05:00,11336,EYt1Pzqfwnd4iXSmcpw4T3Edmm1y3GnRhCjcQEEK4Atj,EHqporfvvfg7UQPsjv5tsgZE8u9yyRuEU2DdLpQeXy85,True,692409931,173102482,1082300,541150,541150,3zqXX6kzhkbW3d4TwD2CNjMRwxTbREXySekvq37kfCNk,43292033,209630348,-166338315,625
2022-02-11 15:24:36-05:00,11337,3jJxvfbyc9KvECkLWTGptkezCLZfiums7GgfANyCULF3,C7fXi4upWW22F2Ak7AzsYVASjjdfZZtPmkQ9pBB2bJXZ,True,82521275,20630318,128981,64490,64491,3zqXX6kzhkbW3d4TwD2CNjMRwxTbREXySekvq37kfCNk,5159247,34820257,-29661010,625
2022-02-11 15:24:47-05:00,11338,CiomzdJ9g2bCskudk28cEU4aTgF6jYaerkiazbB7E3DA,9rxtTBmKoxPzhR4xoRH65Kmi7f3pEp1RanoeQq9V9RU5,True,638265219,159566304,998328,499164,499164,3zqXX6kzhkbW3d4TwD2CNjMRwxTbREXySekvq37kfCNk,39933135,145377916,-105444781,625
2022-02-11 15:24:54-05:00,11339,HN8L8AywaWrDWN6WFFjA74SPAAPUoWfLjFk18h1LmD1p,3ytiHFC1HDZaee9wTXr4oRmnJgpHHDBFLCZP8BQiXbLz,True,36375800072,9093950018,56651793,28325896,28325897,3zqXX6kzhkbW3d4TwD2CNjMRwxTbREXySekvq37kfCNk,2266071732,10153627626,-7887555894,622
2022-02-11 17:13:30-05:00,11340,6bMu9G5S9o2CSgHegDAymE4UcxrnKH9UfPE5iUmUJ6Aa,ACG6V3LfAH3JtJbBhiumrx7c4QciavNmGWKfBFt7eRz7,True,47240844,11810211,73870,36935,36935,3zqXX6kzhkbW3d4TwD2CNjMRwxTbREXySekvq37kfCNk,2954836,11956531,-9001695,625
2022-02-11 17:16:54-05:00,11341,F5KeSVqcP3C5G7SLQypv4G89gH5eCyoapPDxhyJdhm1L,CCYEZ6ttzu5PxK2yDg26ATDjMWmthLJo6Sbi7iGgExjY,True,440391249,110097812,685830,342915,342915,3zqXX6kzhkbW3d4TwD2CNjMRwxTbREXySekvq37kfCNk,27433219,111985199,-84551980,622
2022-02-11 17:26:52-05:00,11342,H8PYPdoedHZnHSaSrgtAE82Wyjh59MS6x5tJAFj4YVuW,AZw4V8JvQVsh3gPXSR9r6jqC1U2AGCdSLeM512zjtQac,True,50059569,12514892,77906,38953,38953,3zqXX6kzhkbW3d4TwD2CNjMRwxTbREXySekvq37kfCNk,3116251,15135772,-12019521,622
2022-02-11 17:26:58-05:00,11343,GdfY68PQzNyTjnd7Ex4fG7mkmhF2gBnTBMPpyD1Qkh9S,DSGr1DQruEnNrGCCYTEpKmBb71RSwdw9eJHFoYWnCGyS,True,42736173,10684043,65583,32791,32792,3zqXX6kzhkbW3d4TwD2CNjMRwxTbREXySekvq37kfCNk,2623355,9877182,-7253827,613
2022-02-11 17:26:58-05:00,11344,ESoDMPSSLWdp6Fr9R6HhJqr7MngDXp37pRXscqT3MY2X,6mEZ1GV1rQPNvuUC8cwsWJ8CMbm4E15MukXUnYrCA96G,True,7056771832,1764192958,10837503,5418751,5418752,3zqXX6kzhkbW3d4TwD2CNjMRwxTbREXySekvq37kfCNk,433500143,1624508311,-1191008168,614
2022-02-11 17:52:49-05:00,11345,CiomzdJ9g2bCskudk28cEU4aTgF6jYaerkiazbB7E3DA,9rxtTBmKoxPzhR4xoRH65Kmi7f3pEp1RanoeQq9V9RU5,True,469171414,117292853,732353,366176,366177,3zqXX6kzhkbW3d4TwD2CNjMRwxTbREXySekvq37kfCNk,29294153,117912678,-88618525,624
2022-02-11 18:05:28-05:00,11346,FtF3PVw8YNJseWPMcA2GEuQZ6nni1mq5kYPa2LrSzfkW,4yr1TM2dXrBvLNMpSaoryuGU2P8D3WG1ZCkvVzWFiQRH,True,22507689575,5626922392,35141195,17570597,17570598,3zqXX6kzhkbW3d4TwD2CNjMRwxTbREXySekvq37kfCNk,1405647817,5318957221,-3913309404,624
2022-02-11 18:10:09-05:00,11347,C4gsZ5khrrXW5yTeg54ypJt2p67hky5G4MacSYMQL8up,CdUsbKY2zjWvVnfiW98cnGpqW9Szw9HR5XfC9Wk9tjvG,True,74830055,18707513,117013,58506,58507,3zqXX6kzhkbW3d4TwD2CNjMRwxTbREXySekvq37kfCNk,4680551,17840496,-13159945,625
2022-02-11 18:10:51-05:00,11348,EYt1Pzqfwnd4iXSmcpw4T3Edmm1y3GnRhCjcQEEK4Atj,EHqporfvvfg7UQPsjv5tsgZE8u9yyRuEU2DdLpQeXy85,True,508985567,127246391,794016,397008,397008,3zqXX6kzhkbW3d4TwD2CNjMRwxTbREXySekvq37kfCNk,31760641,166840857,-135080216,623
2022-02-11 20:01:36-05:00,11349,CiomzdJ9g2bCskudk28cEU4aTgF6jYaerkiazbB7E3DA,9rxtTBmKoxPzhR4xoRH65Kmi7f3pEp1RanoeQq9V9RU5,True,344610032,86152508,526524,263262,263262,3zqXX6kzhkbW3d4TwD2CNjMRwxTbREXySekvq37kfCNk,21060981,94797546,-73736565,611
2022-02-12 01:13:58-05:00,11350,A2HGni6R2NbypSzdh59T6Mm4kVNAbM4fJLSnS4obxYVL,72mqYVyi3n7nVZcJwjPtb9K5vbxoT8idfsQw7At9sRuk,True,157480316,39370079,245891,122945,122946,3zqXX6kzhkbW3d4TwD2CNjMRwxTbREXySekvq37kfCNk,9835641,36275225,-26439584,624
2022-02-12 01:29:17-05:00,11351,xmtC4H2kCjvFBaW9v3NvMTjW42eVsstqwEDLoMSPHUy,5a4r2smUxCk64bduiEy4zYBpjuTrsyGiHG1MSYrRtPUo,True,883657842,220914460,1380524,690262,690262,3zqXX6kzhkbW3d4TwD2CNjMRwxTbREXySekvq37kfCNk,55220960,203463118,-148242158,624
2022-02-12 01:29:22-05:00,11352,3jJxvfbyc9KvECkLWTGptkezCLZfiums7GgfANyCULF3,C7fXi4upWW22F2Ak7AzsYVASjjdfZZtPmkQ9pBB2bJXZ,True,60688224,15172056,94891,47445,47446,DddJ7EWCmYEEZETCBNgAUSg81Ls6fZtiAaY5ekJ5sXx1,3795670,27244233,-23448563,625
2022-02-12 01:29:24-05:00,11353,DwoQXrbwHmfnkWvYaHbPjir3WLmq3oSpSrAjnPdDqgtL,Hv6r5uYpyyn8B4PTzrki6mj5hdF64yaa564Zi277tANU,True,8357482459,2089370614,13047064,6523532,6523532,3zqXX6kzhkbW3d4TwD2CNjMRwxTbREXySekvq37kfCNk,521882597,1961464611,-1439582014,624
2022-02-12 01:34:02-05:00,11354,4q5tGJYhKAyUCLkFdAajtrE9KCvZohCEFqGp5XkqAHwD,8a913NCjVRW6F4DzwaxijQ4URD4AkpCDhts2MJUBYPWs,True,4270325,1067581,6666,3333,3333,3zqXX6kzhkbW3d4TwD2CNjMRwxTbREXySekvq37kfCNk,266647,986322,-719675,624
2022-02-12 01:36:56-05:00,11355,6bMu9G5S9o2CSgHegDAymE4UcxrnKH9UfPE5iUmUJ6Aa,ACG6V3LfAH3JtJbBhiumrx7c4QciavNmGWKfBFt7eRz7,True,34736476,8684119,54354,27177,27177,2BPYaeCXY4BCFSGFSfiGtqmhzJ4fkhYLxGjqFvLCB6hG,2174174,9619624,-7445450,625
2022-02-12 01:41:37-05:00,11356,35fGWTvLNPGis3n61p82posza8zihaUKxzDr2DaXHd3e,4Ycwk6fEwQKevFhiUjx4Ys4euw1DLVfYqxQk2MmMjHkh,True,188328141,47082035,293820,146910,146910,3zqXX6kzhkbW3d4TwD2CNjMRwxTbREXySekvq37kfCNk,11752827,43394686,-31641859,624
2022-02-12 01:41:38-05:00,11357,7Dm3syN4P2mbBLFKyHTrtnSWY4hadGXiKB9EekTdT68S,HF97QS1dqarPMWgNmtcoaq6z3rpJnzAAAfc1PP4FwRhV,True,497647,124411,771,385,386,2BPYaeCXY4BCFSGFSfiGtqmhzJ4fkhYLxGjqFvLCB6hG,30873,113226,-82353,620
2022-02-12 01:42:30-05:00,11358,F5KeSVqcP3C5G7SLQypv4G89gH5eCyoapPDxhyJdhm1L,CCYEZ6ttzu5PxK2yDg26ATDjMWmthLJo6Sbi7iGgExjY,True,323834889,80958722,504267,252133,252134,3zqXX6kzhkbW3d4TwD2CNjMRwxTbREXySekvq37kfCNk,20170718,90045049,-69874331,622
2022-02-12 01:42:45-05:00,11359,H8PYPdoedHZnHSaSrgtAE82Wyjh59MS6x5tJAFj4YVuW,AZw4V8JvQVsh3gPXSR9r6jqC1U2AGCdSLeM512zjtQac,True,36824803,9206200,57625,28812,28813,3zqXX6kzhkbW3d4TwD2CNjMRwxTbREXySekvq37kfCNk,2305022,12039562,-9734540,625
2022-02-12 01:42:51-05:00,11360,GdfY68PQzNyTjnd7Ex4fG7mkmhF2gBnTBMPpyD1Qkh9S,DSGr1DQruEnNrGCCYTEpKmBb71RSwdw9eJHFoYWnCGyS,True,31469777,7867444,49098,24549,24549,3zqXX6kzhkbW3d4TwD2CNjMRwxTbREXySekvq37kfCNk,1963920,7986661,-6022741,624
2022-02-12 01:42:51-05:00,11361,CYcgATWjZUXrqxJyVTEMkDBv1eyUjb1TZi2raTd1ujvU,7jefj3noz9JDDnJ74YZL946EPJtywSnPsi7ZpgU4Wj1G,True,333746613,83436653,518839,259419,259420,3zqXX6kzhkbW3d4TwD2CNjMRwxTbREXySekvq37kfCNk,20753588,80290575,-59536987,621
2022-02-12 01:42:56-05:00,11362,ESoDMPSSLWdp6Fr9R6HhJqr7MngDXp37pRXscqT3MY2X,6mEZ1GV1rQPNvuUC8cwsWJ8CMbm4E15MukXUnYrCA96G,True,5196551177,1299137794,8118378,4059189,4059189,3zqXX6kzhkbW3d4TwD2CNjMRwxTbREXySekvq37kfCNk,324735126,1314472330,-989737204,624
2022-02-12 01:43:06-05:00,11363,AjWfwwad4vf9c4M2N43AaU6KhLqPL7qXpyXmq22Mw4pX,93FW4JdWdq6eaAzZk9MnrMCCryK4Q5VPnejWQtWvwLc,True,4259451,1064862,6394,3197,3197,2BPYaeCXY4BCFSGFSfiGtqmhzJ4fkhYLxGjqFvLCB6hG,255786,986335,-730549,600
2022-02-12 01:43:09-05:00,11364,9Ngb4UJjvSm9zbTN4RYRFWBzTPVWQh7C2hFiDvwPsDBd,EamTKaoTYJo9RUMQC7MjS1HJrVPYipR2cv6nYpgBLnPr,True,99709181,24927294,155474,77737,77737,3zqXX6kzhkbW3d4TwD2CNjMRwxTbREXySekvq37kfCNk,6218996,45298912,-39079916,623
2022-02-12 01:43:09-05:00,11365,6K4ZBJDMWeKYHHHSouBVGb95qjKPNKyu62ahgMyhaPSS,ErHUBFxH7pTmeVDg3W6RcGQYoXJpcb1HhssGzANWfPmq,True,25632376,6408094,38999,19499,19500,3zqXX6kzhkbW3d4TwD2CNjMRwxTbREXySekvq37kfCNk,1559990,5917614,-4357624,608
2022-02-12 01:43:10-05:00,11366,EYt1Pzqfwnd4iXSmcpw4T3Edmm1y3GnRhCjcQEEK4Atj,EHqporfvvfg7UQPsjv5tsgZE8u9yyRuEU2DdLpQeXy85,True,373808751,93452187,573287,286643,286644,3zqXX6kzhkbW3d4TwD2CNjMRwxTbREXySekvq37kfCNk,22931512,132174660,-109243148,613
2022-02-12 01:43:12-05:00,11367,A2HGni6R2NbypSzdh59T6Mm4kVNAbM4fJLSnS4obxYVL,72mqYVyi3n7nVZcJwjPtb9K5vbxoT8idfsQw7At9sRuk,True,115667881,28916970,178684,89342,89342,HfEnetJ7uBSmZWCjBNxdvv9HEC5nsW4wDV7wu6WnhWan,7147394,29419665,-22272271,617
2022-02-12 01:43:13-05:00,11368,xmtC4H2kCjvFBaW9v3NvMTjW42eVsstqwEDLoMSPHUy,5a4r2smUxCk64bduiEy4zYBpjuTrsyGiHG1MSYrRtPUo,True,648937979,162234494,1000875,500437,500438,3zqXX6kzhkbW3d4TwD2CNjMRwxTbREXySekvq37kfCNk,40035033,165029182,-124994149,616
2022-02-12 01:43:15-05:00,11369,3jJxvfbyc9KvECkLWTGptkezCLZfiums7GgfANyCULF3,C7fXi4upWW22F2Ak7AzsYVASjjdfZZtPmkQ9pBB2bJXZ,True,44598730,11149682,69583,34791,34792,3zqXX6kzhkbW3d4TwD2CNjMRwxTbREXySekvq37kfCNk,2783341,21287242,-18503901,624
2022-02-12 01:46:46-05:00,11370,FtF3PVw8YNJseWPMcA2GEuQZ6nni1mq5kYPa2LrSzfkW,4yr1TM2dXrBvLNMpSaoryuGU2P8D3WG1ZCkvVzWFiQRH,True,16560643166,4140160790,25882394,12941197,12941197,3zqXX6kzhkbW3d4TwD2CNjMRwxTbREXySekvq37kfCNk,1035295767,4299301427,-3264005660,625
2022-02-13 12:03:07-05:00,11371,E3VXmcpGHFLMaoEB76WUMUWkaHNGhwQyG88uoRhryniB,9388AsZ75Uh6KpyhPRQeJUJGw8EoGSTGfBsdWzMByKar,True,4155320,1038830,6467,3233,3234,HfEnetJ7uBSmZWCjBNxdvv9HEC5nsW4wDV7wu6WnhWan,258698,983578,-724880,622
2022-02-13 12:03:08-05:00,11372,DwoQXrbwHmfnkWvYaHbPjir3WLmq3oSpSrAjnPdDqgtL,Hv6r5uYpyyn8B4PTzrki6mj5hdF64yaa564Zi277tANU,True,6145003410,1536250852,9530555,4765277,4765278,HfEnetJ7uBSmZWCjBNxdvv9HEC5nsW4wDV7wu6WnhWan,381222204,1584657389,-1203435185,620
2022-02-13 12:03:12-05:00,11373,6cFZnfMvgTWsb1hwvmToqoXm8U7sBVKWBk4zJURpFjE4,GgTG1AWnSP9KGk9j8ZnrjN6S74ihGnrnTJSKg9MR8z3Q,True,42830494,10707623,66783,33391,33392,HfEnetJ7uBSmZWCjBNxdvv9HEC5nsW4wDV7wu6WnhWan,2671347,9830853,-7159506,623
2022-02-13 12:16:24-05:00,11374,4q5tGJYhKAyUCLkFdAajtrE9KCvZohCEFqGp5XkqAHwD,8a913NCjVRW6F4DzwaxijQ4URD4AkpCDhts2MJUBYPWs,True,3139920,784980,4871,2435,2436,HfEnetJ7uBSmZWCjBNxdvv9HEC5nsW4wDV7wu6WnhWan,194852,797433,-602581,620
2022-02-13 13:38:57-05:00,11375,6bMu9G5S9o2CSgHegDAymE4UcxrnKH9UfPE5iUmUJ6Aa,ACG6V3LfAH3JtJbBhiumrx7c4QciavNmGWKfBFt7eRz7,True,25513984,6378496,39057,19528,19529,3zqXX6kzhkbW3d4TwD2CNjMRwxTbREXySekvq37kfCNk,1562288,7684761,-6122473,612
2022-02-13 13:39:00-05:00,11376,35fGWTvLNPGis3n61p82posza8zihaUKxzDr2DaXHd3e,4Ycwk6fEwQKevFhiUjx4Ys4euw1DLVfYqxQk2MmMjHkh,True,138313793,34578448,210566,105283,105283,2BPYaeCXY4BCFSGFSfiGtqmhzJ4fkhYLxGjqFvLCB6hG,8422658,35086691,-26664033,608
2022-02-13 13:39:02-05:00,11377,F5KeSVqcP3C5G7SLQypv4G89gH5eCyoapPDxhyJdhm1L,CCYEZ6ttzu5PxK2yDg26ATDjMWmthLJo6Sbi7iGgExjY,True,237976239,59494059,364685,182342,182343,3zqXX6kzhkbW3d4TwD2CNjMRwxTbREXySekvq37kfCNk,14587409,71894087,-57306678,612
2022-02-13 13:39:04-05:00,11378,7Dm3syN4P2mbBLFKyHTrtnSWY4hadGXiKB9EekTdT68S,HF97QS1dqarPMWgNmtcoaq6z3rpJnzAAAfc1PP4FwRhV,True,364393,91098,524,262,262,HfEnetJ7uBSmZWCjBNxdvv9HEC5nsW4wDV7wu6WnhWan,20985,91593,-70608,575
2022-02-13 13:39:05-05:00,11379,GdfY68PQzNyTjnd7Ex4fG7mkmhF2gBnTBMPpyD1Qkh9S,DSGr1DQruEnNrGCCYTEpKmBb71RSwdw9eJHFoYWnCGyS,True,23113564,5778391,35215,17607,17608,3zqXX6kzhkbW3d4TwD2CNjMRwxTbREXySekvq37kfCNk,1408616,6414451,-5005835,609
2022-02-13 13:39:05-05:00,11380,H8PYPdoedHZnHSaSrgtAE82Wyjh59MS6x5tJAFj4YVuW,AZw4V8JvQVsh3gPXSR9r6jqC1U2AGCdSLeM512zjtQac,True,27031790,6757947,41004,20502,20502,3zqXX6kzhkbW3d4TwD2CNjMRwxTbREXySekvq37kfCNk,1640191,9527923,-7887732,606
2022-02-13 13:39:06-05:00,11381,ESoDMPSSLWdp6Fr9R6HhJqr7MngDXp37pRXscqT3MY2X,6mEZ1GV1rQPNvuUC8cwsWJ8CMbm4E15MukXUnYrCA96G,True,3818016086,954504021,5858463,2929231,2929232,3zqXX6kzhkbW3d4TwD2CNjMRwxTbREXySekvq37kfCNk,234338553,1056291489,-821952936,613
2022-02-13 13:39:06-05:00,11382,AjWfwwad4vf9c4M2N43AaU6KhLqPL7qXpyXmq22Mw4pX,93FW4JdWdq6eaAzZk9MnrMCCryK4Q5VPnejWQtWvwLc,True,3141453,785363,4847,2423,2424,3zqXX6kzhkbW3d4TwD2CNjMRwxTbREXySekvq37kfCNk,193886,794935,-601049,617
2022-02-13 13:40:04-05:00,11383,AeKNHJsY5gWwZZZPvgqZb7TAoS25fQ3pW81QFNeA992E,4ja9TG6tRbQ1xNquFNWdpHWaqdqzbNuZJdu9SyKXB5wV,True,29942275,7485568,46773,23386,23387,3zqXX6kzhkbW3d4TwD2CNjMRwxTbREXySekvq37kfCNk,1870926,6918651,-5047725,624
2022-02-13 13:40:38-05:00,11384,AwT3pH9dHjECDnuUiazbD6tZxZHdNwgJ4vBMmxLHMiLo,AjybksvjMT1QT6KvryXCG47pQGT8v9jxM34VkveGPQrs,True,1499039077,374759769,2315061,1157530,1157531,HfEnetJ7uBSmZWCjBNxdvv9HEC5nsW4wDV7wu6WnhWan,92602472,502118395,-409515923,617
2022-02-13 13:41:47-05:00,11385,6K4ZBJDMWeKYHHHSouBVGb95qjKPNKyu62ahgMyhaPSS,ErHUBFxH7pTmeVDg3W6RcGQYoXJpcb1HhssGzANWfPmq,True,18889379,4722344,29294,14647,14647,3zqXX6kzhkbW3d4TwD2CNjMRwxTbREXySekvq37kfCNk,1171773,4774901,-3603128,620
2022-02-13 13:41:48-05:00,11386,Cd9Ve6KzV4wi965kEL74etsebNZBPwpJgFjgDTvmEfkn,E5EFQLWZ7dJ2BpRT7MXdKjnSb1b8WU3eXwC4zKVpshxT,True,17103280,4275820,26667,13333,13334,HfEnetJ7uBSmZWCjBNxdvv9HEC5nsW4wDV7wu6WnhWan,1066716,3953436,-2886720,623
2022-02-13 13:52:15-05:00,11387,EbScW49FqTmK83BKPFVZWdrJ4XAfoATRT7bbZQZC1anL,3tfG6ocjfFsr7u53NRhcnhNvRqRbmyEa5t37rMhtLyY1,True,4754036899,1188509224,7433096,3716548,3716548,HfEnetJ7uBSmZWCjBNxdvv9HEC5nsW4wDV7wu6WnhWan,297323861,1457926962,-1160603101,625
2022-02-13 13:52:15-05:00,11388,EYt1Pzqfwnd4iXSmcpw4T3Edmm1y3GnRhCjcQEEK4Atj,EHqporfvvfg7UQPsjv5tsgZE8u9yyRuEU2DdLpQeXy85,True,275407738,68851934,430015,215007,215008,3zqXX6kzhkbW3d4TwD2CNjMRwxTbREXySekvq37kfCNk,17200621,104083234,-86882613,624
2022-02-13 13:52:22-05:00,11389,A2HGni6R2NbypSzdh59T6Mm4kVNAbM4fJLSnS4obxYVL,72mqYVyi3n7nVZcJwjPtb9K5vbxoT8idfsQw7At9sRuk,True,85141063,21285265,132355,66177,66178,3zqXX6kzhkbW3d4TwD2CNjMRwxTbREXySekvq37kfCNk,5294220,23608398,-18314178,621
2022-02-13 13:59:03-05:00,11390,xmtC4H2kCjvFBaW9v3NvMTjW42eVsstqwEDLoMSPHUy,5a4r2smUxCk64bduiEy4zYBpjuTrsyGiHG1MSYrRtPUo,True,477874936,119468734,746064,373032,373032,DddJ7EWCmYEEZETCBNgAUSg81Ls6fZtiAaY5ekJ5sXx1,29842560,132420688,-102578128,624
2022-02-13 13:59:06-05:00,11391,3jJxvfbyc9KvECkLWTGptkezCLZfiums7GgfANyCULF3,C7fXi4upWW22F2Ak7AzsYVASjjdfZZtPmkQ9pBB2bJXZ,True,32802204,8200551,51049,25524,25525,3zqXX6kzhkbW3d4TwD2CNjMRwxTbREXySekvq37kfCNk,2041980,16566773,-14524793,622
2022-02-13 13:59:09-05:00,11392,E3VXmcpGHFLMaoEB76WUMUWkaHNGhwQyG88uoRhryniB,9388AsZ75Uh6KpyhPRQeJUJGw8EoGSTGfBsdWzMByKar,True,3052424,763106,4703,2351,2352,HfEnetJ7uBSmZWCjBNxdvv9HEC5nsW4wDV7wu6WnhWan,188125,795852,-607727,616
2022-02-13 13:59:11-05:00,11393,DwoQXrbwHmfnkWvYaHbPjir3WLmq3oSpSrAjnPdDqgtL,Hv6r5uYpyyn8B4PTzrki6mj5hdF64yaa564Zi277tANU,True,4517780008,1129445002,7016496,3508248,3508248,3zqXX6kzhkbW3d4TwD2CNjMRwxTbREXySekvq37kfCNk,280659867,1274565441,-993905574,621
2022-02-13 20:28:40-05:00,11394,CYcgATWjZUXrqxJyVTEMkDBv1eyUjb1TZi2raTd1ujvU,7jefj3noz9JDDnJ74YZL946EPJtywSnPsi7ZpgU4Wj1G,True,245915800,61478950,384162,192081,192081,3zqXX6kzhkbW3d4TwD2CNjMRwxTbREXySekvq37kfCNk,15366513,64415447,-49048934,624
2022-02-13 20:32:05-05:00,11395,5BJnMHFSiQjHRGFJDW1jnqCfkHHYWnQzmmccy9eA4jNj,9517JGYsPmvgPUM9pFRD2vipHmdgE578F7jA7Qq6jorm,True,5797367,1449341,8998,4499,4499,HfEnetJ7uBSmZWCjBNxdvv9HEC5nsW4wDV7wu6WnhWan,359929,3075960,-2716031,620
2022-02-13 20:32:14-05:00,11396,6cFZnfMvgTWsb1hwvmToqoXm8U7sBVKWBk4zJURpFjE4,GgTG1AWnSP9KGk9j8ZnrjN6S74ihGnrnTJSKg9MR8z3Q,True,31412091,7853022,47276,23638,23638,3zqXX6kzhkbW3d4TwD2CNjMRwxTbREXySekvq37kfCNk,1891054,7971481,-6080427,602
2022-02-13 20:32:14-05:00,11397,4q5tGJYhKAyUCLkFdAajtrE9KCvZohCEFqGp5XkqAHwD,8a913NCjVRW6F4DzwaxijQ4URD4AkpCDhts2MJUBYPWs,True,2305235,576308,3501,1750,1751,HfEnetJ7uBSmZWCjBNxdvv9HEC5nsW4wDV7wu6WnhWan,140076,641717,-501641,607
2022-02-13 20:32:21-05:00,11398,7Dm3syN4P2mbBLFKyHTrtnSWY4hadGXiKB9EekTdT68S,HF97QS1dqarPMWgNmtcoaq6z3rpJnzAAAfc1PP4FwRhV,True,269376,67344,413,206,207,DddJ7EWCmYEEZETCBNgAUSg81Ls6fZtiAaY5ekJ5sXx1,16523,73399,-56876,613
2022-02-13 20:32:23-05:00,11399,6bMu9G5S9o2CSgHegDAymE4UcxrnKH9UfPE5iUmUJ6Aa,ACG6V3LfAH3JtJbBhiumrx7c4QciavNmGWKfBFt7eRz7,True,18755340,4688835,28542,14271,14271,3zqXX6kzhkbW3d4TwD2CNjMRwxTbREXySekvq37kfCNk,1141694,6113704,-4972010,608
2022-02-13 20:32:24-05:00,11400,AQr9mVmcXCNQhBVCfx63MwR6c4WqDSC9K2BZqr7N8LCx,CB7TWUaL381ounsLw6neAUaKRxJL9P1HC9uGX5e1Uxod,True,155522008,38880502,238204,119102,119102,3zqXX6kzhkbW3d4TwD2CNjMRwxTbREXySekvq37kfCNk,9528184,44816568,-35288384,612
2022-02-13 20:32:25-05:00,11401,CiomzdJ9g2bCskudk28cEU4aTgF6jYaerkiazbB7E3DA,9rxtTBmKoxPzhR4xoRH65Kmi7f3pEp1RanoeQq9V9RU5,True,254087196,63521799,389332,194666,194666,3zqXX6kzhkbW3d4TwD2CNjMRwxTbREXySekvq37kfCNk,15573313,75248371,-59675058,612
2022-02-13 20:32:26-05:00,11402,F5KeSVqcP3C5G7SLQypv4G89gH5eCyoapPDxhyJdhm1L,CCYEZ6ttzu5PxK2yDg26ATDjMWmthLJo6Sbi7iGgExjY,True,175204941,43801235,273312,136656,136656,2BPYaeCXY4BCFSGFSfiGtqmhzJ4fkhYLxGjqFvLCB6hG,10932499,57190305,-46257806,623
2022-02-13 21:45:47-05:00,11403,9Wzu7BWPgx9JRwuituo7vxNXVkpRA7C5W62CATnPpy6Q,GYPiAfGtfkMjDKdi6MrM7VXzpSwPnp2qWwwCX4iFGVtq,True,299101133,74775283,467193,233596,233597,3zqXX6kzhkbW3d4TwD2CNjMRwxTbREXySekvq37kfCNk,18687734,187211875,-168524141,624
2022-02-13 21:49:52-05:00,11404,BCGTaPQxGEMjD7xUxwfwmVVYJ9CEGH33yJRi3QjwyiLE,JBct1cZ9a959UKwABBEefwxZnGTAAGLzyUdXrXqGGCZd,True,1815361,453840,2839,1419,1420,DddJ7EWCmYEEZETCBNgAUSg81Ls6fZtiAaY5ekJ5sXx1,113568,801355,-687787,625
2022-02-13 21:50:30-05:00,11405,2rLWe1XADCU93guPU6WgSW6x56gYNfif9bm11V93mJnv,BEGhQRm3fgSHeBtk2DYrXEBPKPRvS3sHyTNopmoBJxMs,True,488979380,122244845,763831,381915,381916,3zqXX6kzhkbW3d4TwD2CNjMRwxTbREXySekvq37kfCNk,30553254,337458049,-306904795,624
2022-02-13 21:50:31-05:00,11406,FtF3PVw8YNJseWPMcA2GEuQZ6nni1mq5kYPa2LrSzfkW,4yr1TM2dXrBvLNMpSaoryuGU2P8D3WG1ZCkvVzWFiQRH,True,12195828002,3048956999,19019914,9509957,9509957,3zqXX6kzhkbW3d4TwD2CNjMRwxTbREXySekvq37kfCNk,760796573,3438417357,-2677620784,623
2022-02-13 21:50:41-05:00,11407,5BJnMHFSiQjHRGFJDW1jnqCfkHHYWnQzmmccy9eA4jNj,9517JGYsPmvgPUM9pFRD2vipHmdgE578F7jA7Qq6jorm,True,4260964,1065241,6590,3295,3295,DddJ7EWCmYEEZETCBNgAUSg81Ls6fZtiAaY5ekJ5sXx1,263602,2387689,-2124087,618
2022-02-14 04:06:10-05:00,11408,CYcgATWjZUXrqxJyVTEMkDBv1eyUjb1TZi2raTd1ujvU,7jefj3noz9JDDnJ74YZL946EPJtywSnPsi7ZpgU4Wj1G,True,180908057,45227014,282155,141077,141078,3zqXX6kzhkbW3d4TwD2CNjMRwxTbREXySekvq37kfCNk,11286220,51602847,-40316627,623
2022-02-15 17:40:41-05:00,11409,CuP5X3SN8cnyHzNL5XEJRRaYhzEvUP35aF17jazsiy1W,HrDVLsQ6gN8oKDSr4G872aFB9xuv8MG7KEkNyhytPkn,True,2120341837,530085458,3303762,1651881,1651881,3zqXX6kzhkbW3d4TwD2CNjMRwxTbREXySekvq37kfCNk,132150494,374905811,-242755317,623
2022-02-15 18:27:18-05:00,11410,CuP5X3SN8cnyHzNL5XEJRRaYhzEvUP35aF17jazsiy1W,HrDVLsQ6gN8oKDSr4G872aFB9xuv8MG7KEkNyhytPkn,True,1617911046,404477761,2528377,1264188,1264189,3zqXX6kzhkbW3d4TwD2CNjMRwxTbREXySekvq37kfCNk,101135100,310887188,-209752088,625
2022-02-15 22:33:11-05:00,11411,5jdnNir8fdbQPjFvUxNJsXEKL25Z5FnzGv3aWGDVSwZr,9xBDrqNefNRGx4oxmsqu7xngt7RDqWpWihJ7yaXVvJ2U,True,168954,42237,255,127,128,2BPYaeCXY4BCFSGFSfiGtqmhzJ4fkhYLxGjqFvLCB6hG,10239,59597,-49358,606
2022-02-16 01:32:52-05:00,11412,CuP5X3SN8cnyHzNL5XEJRRaYhzEvUP35aF17jazsiy1W,HrDVLsQ6gN8oKDSr4G872aFB9xuv8MG7KEkNyhytPkn,True,1234427495,308606873,1931272,965636,965636,DddJ7EWCmYEEZETCBNgAUSg81Ls6fZtiAaY5ekJ5sXx1,77250896,255576734,-178325838,625
2022-02-16 01:44:15-05:00,11413,2uEPjuysyi2H75brTSXi8Ca5z3GhgNht14wskXJrUbk6,EhZ2URGbAjrVPnJ92MLLpbMRNPF6ctYnX34S2wjU81Va,True,514377875,128594468,803166,401583,401583,HfEnetJ7uBSmZWCjBNxdvv9HEC5nsW4wDV7wu6WnhWan,32126651,206840958,-174714307,624
2022-02-16 02:35:06-05:00,11414,CuP5X3SN8cnyHzNL5XEJRRaYhzEvUP35aF17jazsiy1W,HrDVLsQ6gN8oKDSr4G872aFB9xuv8MG7KEkNyhytPkn,True,942160757,235540188,1473363,736681,736682,HfEnetJ7uBSmZWCjBNxdvv9HEC5nsW4wDV7wu6WnhWan,58934528,209029014,-150094486,625
2022-02-16 02:35:17-05:00,11415,2uEPjuysyi2H75brTSXi8Ca5z3GhgNht14wskXJrUbk6,EhZ2URGbAjrVPnJ92MLLpbMRNPF6ctYnX34S2wjU81Va,True,392614370,98153592,611792,305896,305896,DddJ7EWCmYEEZETCBNgAUSg81Ls6fZtiAaY5ekJ5sXx1,24471719,162340075,-137868356,623
2022-02-16 19:21:09-05:00,11416,2uEPjuysyi2H75brTSXi8Ca5z3GhgNht14wskXJrUbk6,EhZ2URGbAjrVPnJ92MLLpbMRNPF6ctYnX34S2wjU81Va,True,299571033,74892758,466382,233191,233191,3zqXX6kzhkbW3d4TwD2CNjMRwxTbREXySekvq37kfCNk,18655289,127167754,-108512465,622
2022-02-16 19:49:05-05:00,11417,CuP5X3SN8cnyHzNL5XEJRRaYhzEvUP35aF17jazsiy1W,HrDVLsQ6gN8oKDSr4G872aFB9xuv8MG7KEkNyhytPkn,True,718906796,179726698,1124904,562452,562452,3zqXX6kzhkbW3d4TwD2CNjMRwxTbREXySekvq37kfCNk,44996166,169858921,-124862755,625
2022-02-16 23:27:57-05:00,11418,EdaXk8Ex919yvA4gPhqBVK6egLsfxbaGyGAFz9L5PnsC,F3by1o4Z2VpQVCmdorWwFFwt6AvTC2R1xAN8q8nPwQVQ,True,12564866487,3141216621,19513487,9756743,9756744,3zqXX6kzhkbW3d4TwD2CNjMRwxTbREXySekvq37kfCNk,780539508,1713876922,-933337414,621
2022-02-17 00:07:12-05:00,11419,EdaXk8Ex919yvA4gPhqBVK6egLsfxbaGyGAFz9L5PnsC,F3by1o4Z2VpQVCmdorWwFFwt6AvTC2R1xAN8q8nPwQVQ,True,9591627676,2397906919,14805462,7402731,7402731,HfEnetJ7uBSmZWCjBNxdvv9HEC5nsW4wDV7wu6WnhWan,592218485,1462393664,-870175179,617
2022-02-18 09:44:34-05:00,11420,C4gsZ5khrrXW5yTeg54ypJt2p67hky5G4MacSYMQL8up,CdUsbKY2zjWvVnfiW98cnGpqW9Szw9HR5XfC9Wk9tjvG,True,55188902,13797225,86363,43181,43182,DddJ7EWCmYEEZETCBNgAUSg81Ls6fZtiAaY5ekJ5sXx1,3454552,14258217,-10803665,625
2022-02-18 10:49:12-05:00,11421,H8PYPdoedHZnHSaSrgtAE82Wyjh59MS6x5tJAFj4YVuW,AZw4V8JvQVsh3gPXSR9r6jqC1U2AGCdSLeM512zjtQac,True,19935960,4983990,30785,15392,15393,3zqXX6kzhkbW3d4TwD2CNjMRwxTbREXySekvq37kfCNk,1231430,7485120,-6253690,617
2022-02-18 10:49:14-05:00,11422,GdfY68PQzNyTjnd7Ex4fG7mkmhF2gBnTBMPpyD1Qkh9S,DSGr1DQruEnNrGCCYTEpKmBb71RSwdw9eJHFoYWnCGyS,True,17046248,4261562,26473,13236,13237,HfEnetJ7uBSmZWCjBNxdvv9HEC5nsW4wDV7wu6WnhWan,1058932,5102239,-4043307,621
2022-02-18 10:49:20-05:00,11423,ESoDMPSSLWdp6Fr9R6HhJqr7MngDXp37pRXscqT3MY2X,6mEZ1GV1rQPNvuUC8cwsWJ8CMbm4E15MukXUnYrCA96G,True,2814988320,703747080,4393398,2196699,2196699,DddJ7EWCmYEEZETCBNgAUSg81Ls6fZtiAaY5ekJ5sXx1,175735927,840865096,-665129169,624
2022-02-18 10:49:34-05:00,11424,AjWfwwad4vf9c4M2N43AaU6KhLqPL7qXpyXmq22Mw4pX,93FW4JdWdq6eaAzZk9MnrMCCryK4Q5VPnejWQtWvwLc,True,2315179,578794,3616,1808,1808,DddJ7EWCmYEEZETCBNgAUSg81Ls6fZtiAaY5ekJ5sXx1,144656,636355,-491699,624
2022-02-18 10:49:48-05:00,11425,AeKNHJsY5gWwZZZPvgqZb7TAoS25fQ3pW81QFNeA992E,4ja9TG6tRbQ1xNquFNWdpHWaqdqzbNuZJdu9SyKXB5wV,True,22038564,5509641,34322,17161,17161,3zqXX6kzhkbW3d4TwD2CNjMRwxTbREXySekvq37kfCNk,1372883,5576829,-4203946,622
2022-02-18 11:05:35-05:00,11426,Ew46nMa9TojSd6MHZjJm79LbLKzF2RbheniWUyBHuXvn,FjzRjSD6qiXcwwFXsFfmKGZbfmfZEYPpqrjc4RAX2Tt,True,1209606205,302401551,1878494,939247,939247,3zqXX6kzhkbW3d4TwD2CNjMRwxTbREXySekvq37kfCNk,75139775,276063570,-200923795,621
2022-02-18 11:05:50-05:00,11427,9bvCk8TP3xSu52mvCGrhL2UtCYvJqXqrU2sEEkqusvqc,FZXwdLW4Gyb6HGCJdTX18FbhPDVU7Hdk88hQrvMu8k4t,True,1953821,488455,3036,1518,1518,DddJ7EWCmYEEZETCBNgAUSg81Ls6fZtiAaY5ekJ5sXx1,121477,167656,-46179,621
2022-02-18 13:06:43-05:00,11428,6K4ZBJDMWeKYHHHSouBVGb95qjKPNKyu62ahgMyhaPSS,ErHUBFxH7pTmeVDg3W6RcGQYoXJpcb1HhssGzANWfPmq,True,13918386,3479596,21734,10867,10867,HfEnetJ7uBSmZWCjBNxdvv9HEC5nsW4wDV7wu6WnhWan,869393,3820392,-2950999,624
2022-02-18 13:07:35-05:00,11429,HQFH65hxhAwbGbP4pSCV4PJj2Ec2cyrk6c8XmShJaHp2,DQ9hhWS4FBCZytmfjdAh3Fo15Vkz9hQ4NRuLXF9Y6XTn,True,8564420,2141105,13339,6669,6670,HfEnetJ7uBSmZWCjBNxdvv9HEC5nsW4wDV7wu6WnhWan,533565,1969145,-1435580,623
2022-02-18 13:07:35-05:00,11430,Cd9Ve6KzV4wi965kEL74etsebNZBPwpJgFjgDTvmEfkn,E5EFQLWZ7dJ2BpRT7MXdKjnSb1b8WU3eXwC4zKVpshxT,True,12596586,3149146,19676,9838,9838,HfEnetJ7uBSmZWCjBNxdvv9HEC5nsW4wDV7wu6WnhWan,787046,3182963,-2395917,624
2022-02-18 13:07:35-05:00,11431,EYt1Pzqfwnd4iXSmcpw4T3Edmm1y3GnRhCjcQEEK4Atj,EHqporfvvfg7UQPsjv5tsgZE8u9yyRuEU2DdLpQeXy85,True,202667656,50666914,313151,156575,156576,3zqXX6kzhkbW3d4TwD2CNjMRwxTbREXySekvq37kfCNk,12526053,81576956,-69050903,618
2022-02-18 13:15:21-05:00,11432,A2HGni6R2NbypSzdh59T6Mm4kVNAbM4fJLSnS4obxYVL,72mqYVyi3n7nVZcJwjPtb9K5vbxoT8idfsQw7At9sRuk,True,62687435,15671858,97078,48539,48539,3zqXX6kzhkbW3d4TwD2CNjMRwxTbREXySekvq37kfCNk,3883152,18787220,-14904068,619
2022-02-18 13:16:28-05:00,11433,3jJxvfbyc9KvECkLWTGptkezCLZfiums7GgfANyCULF3,C7fXi4upWW22F2Ak7AzsYVASjjdfZZtPmkQ9pBB2bJXZ,True,24156352,6039088,37576,18788,18788,3zqXX6kzhkbW3d4TwD2CNjMRwxTbREXySekvq37kfCNk,1503065,12841974,-11338909,622
2022-02-18 13:16:30-05:00,11434,E3VXmcpGHFLMaoEB76WUMUWkaHNGhwQyG88uoRhryniB,9388AsZ75Uh6KpyhPRQeJUJGw8EoGSTGfBsdWzMByKar,True,2249806,562451,3498,1749,1749,2BPYaeCXY4BCFSGFSfiGtqmhzJ4fkhYLxGjqFvLCB6hG,139946,635254,-495308,622
2022-02-18 13:17:21-05:00,11435,DwoQXrbwHmfnkWvYaHbPjir3WLmq3oSpSrAjnPdDqgtL,Hv6r5uYpyyn8B4PTzrki6mj5hdF64yaa564Zi277tANU,True,3325176903,831294225,5115394,2557697,2557697,3zqXX6kzhkbW3d4TwD2CNjMRwxTbREXySekvq37kfCNk,204615797,1013401721,-808785924,615
2022-02-18 13:17:27-05:00,11436,4q5tGJYhKAyUCLkFdAajtrE9KCvZohCEFqGp5XkqAHwD,8a913NCjVRW6F4DzwaxijQ4URD4AkpCDhts2MJUBYPWs,True,1700930,425232,2642,1321,1321,2BPYaeCXY4BCFSGFSfiGtqmhzJ4fkhYLxGjqFvLCB6hG,105703,509932,-404229,621
2022-02-19 06:34:03-05:00,11437,7Dm3syN4P2mbBLFKyHTrtnSWY4hadGXiKB9EekTdT68S,HF97QS1dqarPMWgNmtcoaq6z3rpJnzAAAfc1PP4FwRhV,True,198705,49676,307,153,154,HfEnetJ7uBSmZWCjBNxdvv9HEC5nsW4wDV7wu6WnhWan,12281,58266,-45985,618
2022-02-19 06:34:04-05:00,11438,6bMu9G5S9o2CSgHegDAymE4UcxrnKH9UfPE5iUmUJ6Aa,ACG6V3LfAH3JtJbBhiumrx7c4QciavNmGWKfBFt7eRz7,True,13831151,3457787,21070,10535,10535,HfEnetJ7uBSmZWCjBNxdvv9HEC5nsW4wDV7wu6WnhWan,842800,4807166,-3964366,609
2022-02-19 06:34:14-05:00,11439,F5KeSVqcP3C5G7SLQypv4G89gH5eCyoapPDxhyJdhm1L,CCYEZ6ttzu5PxK2yDg26ATDjMWmthLJo6Sbi7iGgExjY,True,128912984,32228246,196031,98015,98016,3zqXX6kzhkbW3d4TwD2CNjMRwxTbREXySekvq37kfCNk,7841276,45025664,-37184388,608
2022-02-19 06:34:16-05:00,11440,GdfY68PQzNyTjnd7Ex4fG7mkmhF2gBnTBMPpyD1Qkh9S,DSGr1DQruEnNrGCCYTEpKmBb71RSwdw9eJHFoYWnCGyS,True,12549688,3137422,19595,9797,9798,2BPYaeCXY4BCFSGFSfiGtqmhzJ4fkhYLxGjqFvLCB6hG,783818,4051300,-3267482,624
2022-02-19 06:35:24-05:00,11441,CYcgATWjZUXrqxJyVTEMkDBv1eyUjb1TZi2raTd1ujvU,7jefj3noz9JDDnJ74YZL946EPJtywSnPsi7ZpgU4Wj1G,True,133473788,33368447,208748,104374,104374,3zqXX6kzhkbW3d4TwD2CNjMRwxTbREXySekvq37kfCNk,8349925,40795282,-32445357,625
2022-02-19 06:35:29-05:00,11442,ESoDMPSSLWdp6Fr9R6HhJqr7MngDXp37pRXscqT3MY2X,6mEZ1GV1rQPNvuUC8cwsWJ8CMbm4E15MukXUnYrCA96G,True,2070539750,517634937,3209671,1604835,1604836,3zqXX6kzhkbW3d4TwD2CNjMRwxTbREXySekvq37kfCNk,128386875,668013730,-539626855,620
2022-02-19 06:35:29-05:00,11443,AjWfwwad4vf9c4M2N43AaU6KhLqPL7qXpyXmq22Mw4pX,93FW4JdWdq6eaAzZk9MnrMCCryK4Q5VPnejWQtWvwLc,True,1703454,425863,2656,1328,1328,HfEnetJ7uBSmZWCjBNxdvv9HEC5nsW4wDV7wu6WnhWan,106255,507961,-401706,623
2022-02-19 22:27:01-05:00,11444,AeKNHJsY5gWwZZZPvgqZb7TAoS25fQ3pW81QFNeA992E,4ja9TG6tRbQ1xNquFNWdpHWaqdqzbNuZJdu9SyKXB5wV,True,16227959,4056989,25156,12578,12578,HfEnetJ7uBSmZWCjBNxdvv9HEC5nsW4wDV7wu6WnhWan,1006261,4460190,-3453929,620
2022-02-19 22:27:05-05:00,11445,5cF5fArh7avaBqRfz8XPrBbn7uMfCkdjVrgAaFXdh7bW,3Wur3gBSbyiuhoNiPGEM18ryxoATHCF9vfn6awt739XS,True,161492,40373,250,125,125,HfEnetJ7uBSmZWCjBNxdvv9HEC5nsW4wDV7wu6WnhWan,10017,41387,-31370,620
2022-02-19 22:27:06-05:00,11446,Ew46nMa9TojSd6MHZjJm79LbLKzF2RbheniWUyBHuXvn,FjzRjSD6qiXcwwFXsFfmKGZbfmfZEYPpqrjc4RAX2Tt,True,890592668,222648167,1374708,687354,687354,3zqXX6kzhkbW3d4TwD2CNjMRwxTbREXySekvq37kfCNk,54988323,222306850,-167318527,617
2022-02-19 22:28:19-05:00,11447,9bvCk8TP3xSu52mvCGrhL2UtCYvJqXqrU2sEEkqusvqc,FZXwdLW4Gyb6HGCJdTX18FbhPDVU7Hdk88hQrvMu8k4t,True,1439016,359754,2235,1117,1118,HfEnetJ7uBSmZWCjBNxdvv9HEC5nsW4wDV7wu6WnhWan,89406,150391,-60985,621
2022-02-19 22:28:37-05:00,11448,6b7Ro2myM4HcUDqyyW9NEqTWPz8BWpH4eNFSQQci37So,7r7j7rSsa6YZcTuRPfs3KP44MVqUA4Q5NeJGmx84wbHq,True,20170,5042,31,15,16,HfEnetJ7uBSmZWCjBNxdvv9HEC5nsW4wDV7wu6WnhWan,1244,22599,-21355,616
2022-02-19 22:28:37-05:00,11449,6K4ZBJDMWeKYHHHSouBVGb95qjKPNKyu62ahgMyhaPSS,ErHUBFxH7pTmeVDg3W6RcGQYoXJpcb1HhssGzANWfPmq,True,10242821,2560705,15861,7930,7931,3zqXX6kzhkbW3d4TwD2CNjMRwxTbREXySekvq37kfCNk,634454,3043675,-2409221,619
2022-02-19 22:28:42-05:00,11450,EYt1Pzqfwnd4iXSmcpw4T3Edmm1y3GnRhCjcQEEK4Atj,EHqporfvvfg7UQPsjv5tsgZE8u9yyRuEU2DdLpQeXy85,True,149384747,37346186,233638,116819,116819,3zqXX6kzhkbW3d4TwD2CNjMRwxTbREXySekvq37kfCNk,9345524,63750140,-54404616,625
2022-02-19 22:28:43-05:00,11451,Cd9Ve6KzV4wi965kEL74etsebNZBPwpJgFjgDTvmEfkn,E5EFQLWZ7dJ2BpRT7MXdKjnSb1b8WU3eXwC4zKVpshxT,True,9275216,2318804,14488,7244,7244,2BPYaeCXY4BCFSGFSfiGtqmhzJ4fkhYLxGjqFvLCB6hG,579538,2548702,-1969164,624
2022-02-19 22:28:44-05:00,11452,HQFH65hxhAwbGbP4pSCV4PJj2Ec2cyrk6c8XmShJaHp2,DQ9hhWS4FBCZytmfjdAh3Fo15Vkz9hQ4NRuLXF9Y6XTn,True,6306217,1576554,9812,4906,4906,3zqXX6kzhkbW3d4TwD2CNjMRwxTbREXySekvq37kfCNk,392516,1586300,-1193784,622
2022-02-19 22:34:30-05:00,11453,A2HGni6R2NbypSzdh59T6Mm4kVNAbM4fJLSnS4obxYVL,72mqYVyi3n7nVZcJwjPtb9K5vbxoT8idfsQw7At9sRuk,True,46196783,11549195,72236,36118,36118,3zqXX6kzhkbW3d4TwD2CNjMRwxTbREXySekvq37kfCNk,2889447,14886332,-11996885,625
2022-02-19 22:34:41-05:00,11454,E3VXmcpGHFLMaoEB76WUMUWkaHNGhwQyG88uoRhryniB,9388AsZ75Uh6KpyhPRQeJUJGw8EoGSTGfBsdWzMByKar,True,1657400,414350,2592,1296,1296,HfEnetJ7uBSmZWCjBNxdvv9HEC5nsW4wDV7wu6WnhWan,103697,505134,-401437,625
2022-02-19 22:34:43-05:00,11455,3jJxvfbyc9KvECkLWTGptkezCLZfiums7GgfANyCULF3,C7fXi4upWW22F2Ak7AzsYVASjjdfZZtPmkQ9pBB2bJXZ,True,17778446,4444611,27416,13708,13708,3zqXX6kzhkbW3d4TwD2CNjMRwxTbREXySekvq37kfCNk,1096649,9939656,-8843007,616
2022-02-19 22:34:44-05:00,11456,DwoQXrbwHmfnkWvYaHbPjir3WLmq3oSpSrAjnPdDqgtL,Hv6r5uYpyyn8B4PTzrki6mj5hdF64yaa564Zi277tANU,True,2451350570,612837642,3820706,1910353,1910353,3zqXX6kzhkbW3d4TwD2CNjMRwxTbREXySekvq37kfCNk,152828248,802060498,-649232250,623
2022-02-19 22:34:52-05:00,11457,4q5tGJYhKAyUCLkFdAajtrE9KCvZohCEFqGp5XkqAHwD,8a913NCjVRW6F4DzwaxijQ4URD4AkpCDhts2MJUBYPWs,True,1251523,312880,1919,959,960,3zqXX6kzhkbW3d4TwD2CNjMRwxTbREXySekvq37kfCNk,76768,404116,-327348,613
2022-02-19 23:32:56-05:00,11458,AQr9mVmcXCNQhBVCfx63MwR6c4WqDSC9K2BZqr7N8LCx,CB7TWUaL381ounsLw6neAUaKRxJL9P1HC9uGX5e1Uxod,True,115007890,28751972,179964,89982,89982,3zqXX6kzhkbW3d4TwD2CNjMRwxTbREXySekvq37kfCNk,7198562,35298653,-28100091,625
2022-02-19 23:34:26-05:00,11459,FSjUzAuFJJDeBerdVPJbWjTyD47GpJRat2h1eCUD1HPH,GT4MarSodCNayJqgVEYMkJQjRvCYYb7S8WJoSaLC144U,True,159939518,39984879,249645,124822,124823,HfEnetJ7uBSmZWCjBNxdvv9HEC5nsW4wDV7wu6WnhWan,9985830,37046312,-27060482,624
2022-02-19 23:34:26-05:00,11460,6bMu9G5S9o2CSgHegDAymE4UcxrnKH9UfPE5iUmUJ6Aa,ACG6V3LfAH3JtJbBhiumrx7c4QciavNmGWKfBFt7eRz7,True,10196890,2549222,15895,7947,7948,HfEnetJ7uBSmZWCjBNxdvv9HEC5nsW4wDV7wu6WnhWan,635835,3785586,-3149751,623
2022-02-19 23:34:26-05:00,11461,7Dm3syN4P2mbBLFKyHTrtnSWY4hadGXiKB9EekTdT68S,HF97QS1dqarPMWgNmtcoaq6z3rpJnzAAAfc1PP4FwRhV,True,146313,36578,228,114,114,HfEnetJ7uBSmZWCjBNxdvv9HEC5nsW4wDV7wu6WnhWan,9123,46328,-37205,623
2022-02-19 23:36:51-05:00,11462,6qDAr9rGtFMeiTx9KfAeu3WBqiZzRzEtMfipFaZ2gQiJ,MGfCsHXhA5C6S28qKoQjeZmn28dehGUJ4MLSaic7CfB,True,2150039138,537509784,3346377,1673188,1673189,3zqXX6kzhkbW3d4TwD2CNjMRwxTbREXySekvq37kfCNk,133855089,483555951,-349700862,622
2022-02-19 23:37:08-05:00,11463,CMVVfXQYALSc58NLD67L8YrJAbDHZ9rFZvYQC7r8Png4,44pytMX14zaEQv6aRQ223CxYB2uTP7VUTQfUY58EkaNB,True,7646598865,1911649716,11956562,5978281,5978281,3zqXX6kzhkbW3d4TwD2CNjMRwxTbREXySekvq37kfCNk,478262516,1720813651,-1242551135,625
2022-02-19 23:59:28-05:00,11464,F5KeSVqcP3C5G7SLQypv4G89gH5eCyoapPDxhyJdhm1L,CCYEZ6ttzu5PxK2yDg26ATDjMWmthLJo6Sbi7iGgExjY,True,95050326,23762581,148068,74034,74034,HfEnetJ7uBSmZWCjBNxdvv9HEC5nsW4wDV7wu6WnhWan,5922754,35445631,-29522877,623
2022-02-19 23:59:28-05:00,11465,AWiBJBpfbsLGrNaofk1wVoY1zZHENpCZG6MvP2C7vwm2,CvPqPboRCx29qMZFt4VkBdi9G2AgLAfGdHM9C171MvWd,True,23924306,5981076,37215,18607,18608,HfEnetJ7uBSmZWCjBNxdvv9HEC5nsW4wDV7wu6WnhWan,1488606,5474300,-3985694,622
2022-02-19 23:59:47-05:00,11466,GdfY68PQzNyTjnd7Ex4fG7mkmhF2gBnTBMPpyD1Qkh9S,DSGr1DQruEnNrGCCYTEpKmBb71RSwdw9eJHFoYWnCGyS,True,9229955,2307488,14333,7166,7167,HfEnetJ7uBSmZWCjBNxdvv9HEC5nsW4wDV7wu6WnhWan,573338,3206263,-2632925,621
2022-02-20 00:35:04-05:00,11467,Gnozx4DHqvFKAWsyuk4BsT6Fsi9ARhijDSz1k9TR2rKq,5zDJ1XARDgS9ZCvWTarrKYNbjWRGEj8AjSUQJFfo8AjX,True,86025845,21506461,134432,67216,67216,HfEnetJ7uBSmZWCjBNxdvv9HEC5nsW4wDV7wu6WnhWan,5377297,19331452,-13954155,625
2022-01-24 07:44:12-05:00,10444,FdYFnEYtFQKcZPmzUqnvNLzozxdR1emtkmvnYcMgYykS,7arWNJQf2cWxerjhLgQh9CJxwTat1efnr5KmhuD7Qnv4,True,122435,30608,187,93,94,3zqXX6kzhkbW3d4TwD2CNjMRwxTbREXySekvq37kfCNk,7485,146635,-139150,611
2022-01-24 07:44:12-05:00,10445,6k9unyyhVTrGhAhBrFjgumRfBtKFRBrVaeWtYB56LgEg,3n9VYUH53fxmwFwdYKT9xAZYDzjodhMsJ5iGAoJTqCt4,True,819974,204993,1278,639,639,3zqXX6kzhkbW3d4TwD2CNjMRwxTbREXySekvq37kfCNk,51138,497908,-446770,623
2022-01-24 07:44:12-05:00,10446,BLJgLzizx2yLgd12pVBAHTMqn9J5JA3JHCF8PnLnPyUk,HhDmwMysBFWhXnd3mrV31w75WBRKBS8wJSiEMZgqdUSp,True,619076,154769,953,476,477,3zqXX6kzhkbW3d4TwD2CNjMRwxTbREXySekvq37kfCNk,38129,756835,-718706,615
2022-01-24 07:44:13-05:00,10447,9gY3X17t7jarkWhnSEHPR51U9nVv8Dv99NqpCi3ewuPf,4Z6TdTW1d4JFRZqZyWA9X7upKhJwVPSfTQjFp14M59uv,True,27363265,6840816,40097,20048,20049,3zqXX6kzhkbW3d4TwD2CNjMRwxTbREXySekvq37kfCNk,1603891,31193963,-29590072,586
2022-01-24 07:44:13-05:00,10448,AvpYg74EBhwAXE8rcdGkpwmbBMRyVidF6zMRSFtWAVC6,4WgpqTp4r9wMpMptYMNbvCaP2faBnVr6FdShCAobetpL,True,156077,39019,240,120,120,3zqXX6kzhkbW3d4TwD2CNjMRwxTbREXySekvq37kfCNk,9637,186872,-177235,617
2022-01-24 07:44:13-05:00,10449,Aop82qT6CwZbomif4QowqP3VaSHKB1837B2yNKqw4tER,65BVa4jrCx9etU5eXBAXT2PVnwVot2HLWGYyNXbVJDFk,True,2164129,541032,3320,1660,1660,3zqXX6kzhkbW3d4TwD2CNjMRwxTbREXySekvq37kfCNk,132825,2529645,-2396820,613
2022-01-24 07:44:13-05:00,10450,As81koHnSP9quoXuUVNHp3VR3Qaks8HLa4sFgJDocYiF,AMVm8dXia5s974VgZSbeE6uPDgyXDHZFyJ2W1J1CWvKW,True,4406306,1101576,6729,3364,3365,HfEnetJ7uBSmZWCjBNxdvv9HEC5nsW4wDV7wu6WnhWan,269196,5153731,-4884535,610
2022-01-24 07:44:14-05:00,10451,FF8rqfM9PTEjYiVFy8jS81weDRwdaYooux2uSa2LexrJ,JBk1JghH1gged1YpDbkczFXP9ka5ivYSkaYoVbbXD4kg,True,113626,28406,176,88,88,3zqXX6kzhkbW3d4TwD2CNjMRwxTbREXySekvq37kfCNk,7075,144278,-137203,622
2022-01-24 07:44:14-05:00,10452,8ARSFh2vPjz7M1pjNqFRsRrHFGwVsUNnD7kLbqhmMrZR,9TGsutLwHv259Le8zfZ75FM4eLZffi6itgWBgYqeKkAy,True,1054054,263513,1615,807,808,HfEnetJ7uBSmZWCjBNxdvv9HEC5nsW4wDV7wu6WnhWan,64630,1252884,-1188254,613
2022-01-24 07:44:14-05:00,10453,5V5gFVMYSwGYfHFecRoHg8G22Rg4bXfVK2FSRTMhPQty,73raXd5MvixmDvJRnVjRL7yQaHZGFRiC9aBxL9ysiRvy,True,17408225,4352056,26751,13375,13376,3zqXX6kzhkbW3d4TwD2CNjMRwxTbREXySekvq37kfCNk,1070063,11344418,-10274355,614
2022-01-24 07:44:14-05:00,10454,3ogBPSRcKfmwzgumVDHBkXLi1eCsEFG2xzSJgD4LQDNy,7TXyqWgJqfe71MSWFA2n7ufZbUdzf7JJoWej8FNNtMXo,True,152998,38249,234,117,117,HfEnetJ7uBSmZWCjBNxdvv9HEC5nsW4wDV7wu6WnhWan,9380,126896,-117516,613
2022-01-24 07:44:14-05:00,10455,95yx3SCWcW9Cp8oSEDV68kGXRKWGyNdYUtNb5UnWMGBD,7PncaFWqW2iKR6EUKf78EW6LLZr7ZWU5b2d2rP22fsU3,True,1984365,496091,3006,1503,1503,HfEnetJ7uBSmZWCjBNxdvv9HEC5nsW4wDV7wu6WnhWan,120244,1695462,-1575218,605
2022-01-24 07:44:14-05:00,10456,8T4WK27RvWVGqPuNqY6whk1fmU4vd5qaUQPZG1GJ79bh,DvSz7knS8N3K7L6JhQf1s4mJSyxB8uJXNQXtyjJn8QRL,True,897703,224425,1298,649,649,HfEnetJ7uBSmZWCjBNxdvv9HEC5nsW4wDV7wu6WnhWan,51944,816211,-764267,578
2022-01-24 07:44:14-05:00,10457,FsMiJiJZibohKoV5QRisWCjzuFd86xSxFb4m73AQmu93,7p3TSKBaG9SV2YNDnhutQKacPKpTTmgsEfzmK51t6sYb,True,2032046,508011,2791,1395,1396,HfEnetJ7uBSmZWCjBNxdvv9HEC5nsW4wDV7wu6WnhWan,111676,1528789,-1417113,549
2022-01-24 07:44:14-05:00,10458,H3394S5wdbwXB4scjGAY8NsXxCdGy1Xebct18s42FM1K,Hz84L1EquzhCvBJP75ScKug46hYGdNMVNH16AdG4y5D8,True,457237,114309,628,314,314,HfEnetJ7uBSmZWCjBNxdvv9HEC5nsW4wDV7wu6WnhWan,25155,380594,-355439,550
2022-01-24 07:44:14-05:00,10459,D58t4uTjFumsUeYFaKnpV8BRTEQEqKXBreFTdwGrott7,67p6kHDfVqQijfcwugvZK59c3aRRH9x3eHxruqH8WEqF,True,1515976,378993,2224,1112,1112,3zqXX6kzhkbW3d4TwD2CNjMRwxTbREXySekvq37kfCNk,88998,914644,-825646,587
2022-01-24 07:44:14-05:00,10460,92vHa65f4WpuqzSCMESDMPxZ2yfLxXJMMPYLof75EiN,3QZvcV1wL2ZYnw9yY9sbhiCP3dYYHeUZB7gcqtSutuLK,True,99950983,24987745,153120,76560,76560,3zqXX6kzhkbW3d4TwD2CNjMRwxTbREXySekvq37kfCNk,6124839,67526815,-61401976,612
2022-01-24 07:44:14-05:00,10461,Bsr6kx1B6BSEd5UnJ7Z61M49iUb3bFrDVhiEtMVtPDF2,3CFd1pUJAJPA9fobwn4Jj2mRju1CWmoop4Mh4znypNWT,True,212621,53155,321,160,161,HfEnetJ7uBSmZWCjBNxdvv9HEC5nsW4wDV7wu6WnhWan,12868,173296,-160428,605
2022-01-24 07:44:14-05:00,10462,F1G1Yb2jhT1hULYuNM9QMuNNA6vHZ2Wg4LhFGWsJmr78,2oF52s77UVwjbZMLmxyNsGRZ36RHqSJiV5VL7FzoWgyB,True,25543869,6385967,38716,19358,19358,HfEnetJ7uBSmZWCjBNxdvv9HEC5nsW4wDV7wu6WnhWan,1548664,14389029,-12840365,606
2022-01-24 07:44:14-05:00,10463,7hTjPRQSYAoWHhtpsVz2oKK5SAuFJd8dPHShKgKJq8dy,6DcHcrtcXR88d8e2KahhAiWTeRznNfF8oXLHmh5wE7wz,True,6940283,1735070,10456,5228,5228,HfEnetJ7uBSmZWCjBNxdvv9HEC5nsW4wDV7wu6WnhWan,418243,5733009,-5314766,602
2022-01-24 07:44:14-05:00,10464,GYgxUfZ19oSyHuovGRA6gBJT32goSxCrKR8hQQdBsrRG,2r8c6SU74hRq7xEmYBJ92WoSB6v6XCAXR3JcDznfCxkN,True,210649995,52662498,307993,153996,153997,HfEnetJ7uBSmZWCjBNxdvv9HEC5nsW4wDV7wu6WnhWan,12319737,181355695,-169035958,584
2022-01-24 07:44:14-05:00,10465,HpDwBPWZHfLzJUvTTABTA6qddyLLJiVTfqBx5gUktSUb,BqXLpaAeTNfNSeevfdazNqTgqEXj6Edgp8txWvCoxEz6,True,6341401,1585350,9309,4654,4655,HfEnetJ7uBSmZWCjBNxdvv9HEC5nsW4wDV7wu6WnhWan,372365,6418984,-6046619,587
2022-01-24 07:44:14-05:00,10466,zLTuMVfVswjMkhyvjaXnvjcKXv5xNk3iSWSjRGpVqXf,J3D8NHUJCiSjvFYfJ5Es4YDhF1KcPZWRUmCQ5L92t8eB,True,3102141,775535,4454,2227,2227,HfEnetJ7uBSmZWCjBNxdvv9HEC5nsW4wDV7wu6WnhWan,178163,1304485,-1126322,574
2022-01-24 07:44:14-05:00,10467,EitU96ThqHErybDn2j1NY6JHkqV1R3mWM1uWH7wYKr1T,2p9eYbLyBqXrhHtRKp1jJb7VGjCmb4LkA6kzqLr1ijet,True,1135898,283974,1617,808,809,3zqXX6kzhkbW3d4TwD2CNjMRwxTbREXySekvq37kfCNk,64695,813764,-749069,569
2022-01-24 07:44:15-05:00,10468,JDeYjCLpfnzcfxDFgHf4aBcHsajwdR14GUaKAA9euzVf,EJbvKoyMZcoCx4vWa61uMbW2vr6mUhrgEuECdteVBuZZ,True,56535,14133,84,42,42,3zqXX6kzhkbW3d4TwD2CNjMRwxTbREXySekvq37kfCNk,3396,62341,-58945,600
2022-01-24 07:44:15-05:00,10469,4MSyrHopFkuaCEEvLAUV9cJfVre6cLAx5sJF5LEMSCTX,6HhLHoswuDKrcixShWCDcquW6PgmbS5FidEnkM3bwuJQ,True,500575,125143,704,352,352,HfEnetJ7uBSmZWCjBNxdvv9HEC5nsW4wDV7wu6WnhWan,28181,260528,-232347,562
2022-01-24 07:44:15-05:00,10470,A36aouot1oFLUtswuBUM4EVcis9chKaSJu53MRoPDjab,33U9gpq1RRFMGWDrWa3ezXXkwgBewdAS6QGgGVPtGvqb,True,2622351,655587,3749,1874,1875,HfEnetJ7uBSmZWCjBNxdvv9HEC5nsW4wDV7wu6WnhWan,149982,1968252,-1818270,571
2022-01-24 07:44:15-05:00,10471,9UKMqQgFYdJb5vXVqPhA8CAMRY1eifgWivANiKQqj3yb,DpE3uNQUZbyYnqjpfHWqp9CHqPBs2uTQLRM6AtzF6Por,True,2410393,602598,3625,1812,1813,HfEnetJ7uBSmZWCjBNxdvv9HEC5nsW4wDV7wu6WnhWan,145030,1200815,-1055785,601
2022-01-24 07:44:15-05:00,10472,G5NLYTLxDZfJFKsJdMeWS8Ez95ZFwR5AX4hKhnfVJvoE,AwrC3pKhTeEDr1HCTWoKWjadteZccvqcisbC7vxTjn7w,True,3888503,972125,5890,2945,2945,HfEnetJ7uBSmZWCjBNxdvv9HEC5nsW4wDV7wu6WnhWan,235617,4158056,-3922439,605
2022-01-24 07:44:15-05:00,10473,8xvLGVeDmhVYQhN2ZpWkVG9jCrukRsNQ4926a4TMiZqa,9ciBySSjvADwp47WkETiFWZKVTFL8Hf1XvK7aSxhcgQS,True,180954,45238,262,131,131,HfEnetJ7uBSmZWCjBNxdvv9HEC5nsW4wDV7wu6WnhWan,10498,157996,-147498,580
2022-01-24 07:44:15-05:00,10474,3VdSA9CED9f5swRwHX2U15U7J6Muaq8VPnCNy9CaGDHe,2YYstfnfdYic5NWmEbcUEHpccNUVd1EhuCkExvMsoMk8,True,48811,12202,67,33,34,HfEnetJ7uBSmZWCjBNxdvv9HEC5nsW4wDV7wu6WnhWan,2691,52592,-49901,551
2022-01-24 07:44:15-05:00,10475,m7gf1jAYXBZjRZEY9w4MjPfhzLwgDKaXyaCVhRD6C5E,Aa2aTZnpPux1i5K2MT4i1TsVM8vR7qR7rZGijQW4zpwd,True,1053293364,263323341,1551476,775738,775738,HfEnetJ7uBSmZWCjBNxdvv9HEC5nsW4wDV7wu6WnhWan,62059041,501689971,-439630930,589
2022-01-24 07:44:15-05:00,10476,78EeyPYzQjrmW6z9VGhRci6ihMUZb5rtpXo3GAxugf55,9AgZ45TMxaqwWGVWSgnEkvio3s6fXtHjAVRVCA7Zgsd2,True,403324,100831,607,303,304,HfEnetJ7uBSmZWCjBNxdvv9HEC5nsW4wDV7wu6WnhWan,24302,298628,-274326,602
2022-01-24 07:44:15-05:00,10477,AWvHDdb2ikqV8wc7qQ8azbvNTZdixMNxhQjhQdhayYtR,9EpgEPBb1nog6aQeFdMXfSRiLSnzGQFQ39mbLdCxgYTv,True,335916,83979,480,240,240,HfEnetJ7uBSmZWCjBNxdvv9HEC5nsW4wDV7wu6WnhWan,19209,243924,-224715,571
2022-01-24 07:44:16-05:00,10478,7CSCMFa9W52tBDVUbXbc3woAy3GByeA1wPJdp3MgznPa,3447ptuVFu6G8B6N63RmS8mRv4n9PfHneypHLvbeaGLn,True,306931,76732,471,235,236,3zqXX6kzhkbW3d4TwD2CNjMRwxTbREXySekvq37kfCNk,18852,323405,-304553,614
2022-01-24 07:44:16-05:00,10479,6VJcr3VAEcEZaHEpt48QL8QxHKABufVp8n2JSEVTLh9U,8naR6kiySKj3vai9dCetdgCnCHgf2oyLjGqKTJ3Lz64Y,True,23574349,5893587,34336,17168,17168,3zqXX6kzhkbW3d4TwD2CNjMRwxTbREXySekvq37kfCNk,1373459,21070778,-19697319,582
2022-01-24 07:44:16-05:00,10480,5eMLdQ4gYA5iqvTXSNdGvctHp7s5VpyFuwtJKqx6chBc,Ckxc5K39nkBNXBTmFTM8J48R7wGqNm3vHKZu4G5baumZ,True,2379548,594887,3537,1768,1769,HfEnetJ7uBSmZWCjBNxdvv9HEC5nsW4wDV7wu6WnhWan,141480,1845350,-1703870,594
2022-01-24 07:44:17-05:00,10481,CyWBZ1xJ9LahUnPesbXLZ4Rr5UyWAHgVFYwfrnhyrkNL,2Lpk87Xth8ZL5J9BfzmMpEE3x76FDrrrmdKiCNkSVip2,True,720736,180183,1104,552,552,3zqXX6kzhkbW3d4TwD2CNjMRwxTbREXySekvq37kfCNk,44191,640269,-596078,613
2022-01-24 07:44:17-05:00,10482,CbhrZUdan1axNDFUrX1ZuEohfNMEGrszKSkk6pppVQuw,DHEAjJNtuEePezYAv77thWabbVxxqQpfuiC6moRSrpG1,True,672013,168003,1016,508,508,3zqXX6kzhkbW3d4TwD2CNjMRwxTbREXySekvq37kfCNk,40677,721622,-680945,605
2022-01-24 07:44:18-05:00,10483,EgpRPHPAC2cPBiar3SUD5PGZnzbCXBzUpa4KVTF5q9XY,2zf7NkfWagBWWts9RgacdRgkSzgJaChpFW5mMZczXa18,True,184391082,46097770,265864,132932,132932,HfEnetJ7uBSmZWCjBNxdvv9HEC5nsW4wDV7wu6WnhWan,10634596,198555558,-187920962,576
2022-01-24 07:44:18-05:00,10484,Fani89KviVFZek4si6YZ3apVuM2kSqVUijDnLBqtvJEH,EpC29dECx1cLC69bj2ncG3jFp7obPaxbH7F6mju27cwL,True,159543,39885,249,124,125,3zqXX6kzhkbW3d4TwD2CNjMRwxTbREXySekvq37kfCNk,9968,83964,-73996,624
2022-01-24 07:44:23-05:00,10485,Cv5oVktxmqbU1SxraxH67NEWMKnjgA18R832Fhe9h74a,Cs7xBD4BDiohyopnaYDDChUtR9vmx7uwot6Qp9beQLzt,True,8798460,2199615,13766,6883,6883,3zqXX6kzhkbW3d4TwD2CNjMRwxTbREXySekvq37kfCNk,550644,4000905,-3450261,625
2022-01-24 07:44:24-05:00,10486,CYkojG4q1SnizNs59qsYTEBU1c11XC8nteMhxRbwhCBq,A9MsPy3aeMzdQUWXK6qmWLiZfKREiBrSVaJAKp2nEcSt,True,163222,40805,243,121,122,HfEnetJ7uBSmZWCjBNxdvv9HEC5nsW4wDV7wu6WnhWan,9727,134324,-124597,595
2022-01-24 07:45:48-05:00,10487,ATS5VRAN1aPKBiATDcUs5yd6yVuTmWqrqqRFNdfz6DZT,7VKq4rZLEtY2dhDFZMTQMvCYyJa1ASM9RHobUaYhHWAe,True,2403080,600770,3738,1869,1869,HfEnetJ7uBSmZWCjBNxdvv9HEC5nsW4wDV7wu6WnhWan,149537,1771285,-1621748,622
2022-01-24 07:45:48-05:00,10488,6pUtYz474QrpATEZnfb3iFbTKYA65pNyKAo4TQZAjtqe,8dipRUXvxJiDLdHEtCPkso4vErbVwshHQiRfvSngBS9J,True,3487306388,871826595,5437281,2718640,2718641,HfEnetJ7uBSmZWCjBNxdvv9HEC5nsW4wDV7wu6WnhWan,217491264,1629416824,-1411925560,623
2022-01-24 07:45:48-05:00,10489,4KMzwWHPeW51cxu4nMpbqCaqo96dMqaHWyRCGQktfQfd,F7q4GNYcbnZa8dJ4qovQwjmxpKpdEmdxQMXRPb9nQupa,True,9432705,2358175,14647,7323,7324,HfEnetJ7uBSmZWCjBNxdvv9HEC5nsW4wDV7wu6WnhWan,585914,4044617,-3458703,621
2022-01-24 07:45:52-05:00,10490,D64rDiWT3YG28fCgXCmbNjYa2JakZbpKQ1D2XuLChUfV,8WmMWq8cTsGQym5pUbHm9dPCpJugBeWUMVERYFGLxWHj,True,259340,64835,405,202,203,3zqXX6kzhkbW3d4TwD2CNjMRwxTbREXySekvq37kfCNk,16229,202808,-186579,625
2022-01-24 07:46:33-05:00,10491,7dmoK7QPki7R66SPQST4veUgVfnJbVToxxBPZveECiwK,4vh4REBDm5zBDmcjRCD9zNsny1HGneu7B2co4dSJNLL6,True,1241451,310362,1935,967,968,3zqXX6kzhkbW3d4TwD2CNjMRwxTbREXySekvq37kfCNk,77421,1302802,-1225381,623
2022-01-24 07:46:34-05:00,10492,9BMHbUs4d3qX49fnroHv2FTPDs4yoDFrvDMqf8p9U4pE,2yL7zwMr7qVG5Sdwkf7z6ppnNqt1ASppBbmxwYjfFY6Z,True,2444945,611236,3820,1910,1910,HfEnetJ7uBSmZWCjBNxdvv9HEC5nsW4wDV7wu6WnhWan,152828,2929384,-2776556,625
2022-01-24 07:46:34-05:00,10493,DMgD2KCEhTGFLUZ5GnfNcwfiiwKYbyVpoWiN6knMkCAf,5KU2vgBkPTNVHsSULjgX7ZkZS56U3Dy3xqLTxL5sUZJ3,True,863402,215850,1347,673,674,HfEnetJ7uBSmZWCjBNxdvv9HEC5nsW4wDV7wu6WnhWan,53907,1257200,-1203293,624
2022-01-24 07:46:34-05:00,10494,4SX2pj4eHRwFMtyDCrMZ8ZT6ASAMi7yfZWZnccw5dGn8,Ads49ZqvTmPHxfzNYm4oJb4HBYhwS6vXQbarqmpUi5VZ,True,128194,32048,199,99,100,HfEnetJ7uBSmZWCjBNxdvv9HEC5nsW4wDV7wu6WnhWan,7973,153550,-145577,621
2022-01-24 07:46:34-05:00,10495,9kYkFDNE3qD6s73fn8kJowgqbDZoDSw22XaUJ7rTD43D,E8zJz8pT2c9aZsxe4kLMNs4bY7skt38SU5wK5JTqbGr6,True,2414171,603542,3752,1876,1876,3zqXX6kzhkbW3d4TwD2CNjMRwxTbREXySekvq37kfCNk,150097,2892460,-2742363,621
2022-01-24 07:46:35-05:00,10496,6Z6y2QLJUZ5s6zdjanJcKprTAotx8tqr9DRNqqycMeS4,JCYwt8MHVaBb14GB2qAvDWwYVMaL7VTxyNEt7Eo5Zy8x,True,129002,32250,201,100,101,3zqXX6kzhkbW3d4TwD2CNjMRwxTbREXySekvq37kfCNk,8075,154170,-146095,625
2022-01-24 07:46:35-05:00,10497,7EvJoetxJVTgpJXqE1VC3fZN1CQ5xdWdv29yCiDuH9gU,6RTEusjGEHNDdMj75qkpzYHjHZ3R2XN5xvptCwkRJz5j,True,176306,44076,274,137,137,HfEnetJ7uBSmZWCjBNxdvv9HEC5nsW4wDV7wu6WnhWan,10982,211198,-200216,622
2022-01-24 07:46:35-05:00,10498,FV9CBGGTbppLnBKh79f2LzD1diTiS5g6u89FcpZHZmnK,Fe7mtmCUziFqbbYTvrhAcAq1Ub7YLfTJRtQ1hG7GzJD1,True,3295,823,5,2,3,HfEnetJ7uBSmZWCjBNxdvv9HEC5nsW4wDV7wu6WnhWan,206,3699,-3493,625
2022-01-24 07:46:35-05:00,10499,3tQBuHwr3V8AZu8Yqhg1UfmnFoxzkUq9UeGeLm41UHy4,9cESwduiHBgrxZK1hN1eAFwnyfxw3FEHezTa8Ue5Kpye,True,12659178,3164794,19764,9882,9882,3zqXX6kzhkbW3d4TwD2CNjMRwxTbREXySekvq37kfCNk,790566,10296610,-9506044,624
2022-01-24 07:46:36-05:00,10500,64Diz8zzEv1jDWnBQPTHPpXwaWf7vjM19RyJmkPy1viQ,G8wkGHRHMtT3mvXBkH3zgsKNs8wbpdiPUS17y4cozhkZ,True,78759714,19689927,123103,61551,61552,HfEnetJ7uBSmZWCjBNxdvv9HEC5nsW4wDV7wu6WnhWan,4924138,33326917,-28402779,625
2022-01-24 07:47:00-05:00,10501,7ayTm4uC5VbtMt9w6g9tFban4fYVwbqCzJZpiFMjmBiB,BvidnEZHHtXVhtgv4qFKThEaFZsFmyAuDVqZQwMppjSg,True,352891796,88222949,552191,276095,276096,3zqXX6kzhkbW3d4TwD2CNjMRwxTbREXySekvq37kfCNk,22087669,282627061,-260539392,625
2022-01-24 07:47:06-05:00,10502,98pwBGgiSDuwuas6WYW2hc9qUxfULwvNE34aixaxbxXY,BLrjKxekjThtJ9rKtQxs1Y4rZ225EE2Q16VkP9TkThyV,True,638436,159609,992,496,496,3zqXX6kzhkbW3d4TwD2CNjMRwxTbREXySekvq37kfCNk,39719,391876,-352157,622
2022-01-24 07:47:10-05:00,10503,3NhNdphQiKwgHTmTJc4qVhp3aWjqnwMTYbRW1y9CZrZg,BNpP1sKPAr7Dk1ymSrupge9KGMVpk4LfjTjawgi9YaC5,True,921677,230419,1432,716,716,3zqXX6kzhkbW3d4TwD2CNjMRwxTbREXySekvq37kfCNk,57298,1078248,-1020950,621
2022-01-24 07:47:10-05:00,10504,BJV5jbowrbELXfDvfMovaQy4PiRf12pLYHimW9bgzW5X,6WXrWso5FvLx7RMCFBzrbzh5qevKkk2LJAihUfWXxXzB,True,13096,3274,20,10,10,3zqXX6kzhkbW3d4TwD2CNjMRwxTbREXySekvq37kfCNk,814,23341,-22527,621
2022-01-24 07:47:10-05:00,10505,73PpLzJmAimmqtjGpRcYHua8t6wx3gYiiXFvQxnSDMJV,CRCpLcS8LNKX22co94spJBXEes9Fnh5rYBvbVEte4JXA,True,18473637,4618409,28879,14439,14440,3zqXX6kzhkbW3d4TwD2CNjMRwxTbREXySekvq37kfCNk,1155173,19878545,-18723372,625
2022-01-24 07:47:10-05:00,10506,Frobc1KZTVcsyfwyKwSpHJobxmiJBomzHhGCLdrzdAz8,HziyKP9uxWCuXddtbRzWMczHNdgyQB5UXQZj4MnMm14,True,739977,184993,1158,579,579,HfEnetJ7uBSmZWCjBNxdvv9HEC5nsW4wDV7wu6WnhWan,46321,516772,-470451,625
2022-01-24 07:47:11-05:00,10507,2FEbsetZMkRqLjSC8GBbgecKgX5T1T1fci2sLQux29p8,H722Fcd6DkTFRZxqQWbPDufBfXEgmFfhiEpQZWhxwYv1,True,2924,731,4,2,2,3zqXX6kzhkbW3d4TwD2CNjMRwxTbREXySekvq37kfCNk,183,3292,-3109,625
2022-01-24 07:47:12-05:00,10508,HGJoZvLakWfSDFwuvShNBc4kCf7nP7VqzyM3mELpbFEf,12Qn5jin7QvsBngXqYAv4UstyG3b6nRf1jsLp9Dp8G7k,True,9812,2453,15,7,8,3zqXX6kzhkbW3d4TwD2CNjMRwxTbREXySekvq37kfCNk,610,11992,-11382,621
2022-01-24 07:47:12-05:00,10509,BjCNaM7YbE9SjFi7tzi4677zg1fKXGJwtecz2GWwWuhd,6rNsSrKZezQrLb2whToNjnizpnurDXrobHqfEK3QqU1M,True,195681755,48920438,305877,152938,152939,3zqXX6kzhkbW3d4TwD2CNjMRwxTbREXySekvq37kfCNk,12235096,114909221,-102674125,625
2022-01-24 07:47:12-05:00,10510,EBnMKbaJEjNXjt14hxssR8wd3Ua37McPQxUZnKxxbgtd,FAALK2LRFhg98ezHEBFrgrzxTg66eZpmo7ctKDEck8q5,True,276591,69147,430,215,215,3zqXX6kzhkbW3d4TwD2CNjMRwxTbREXySekvq37kfCNk,17224,303717,-286493,622
2022-01-24 07:47:21-05:00,10511,3Xbsek5MsEGoWr3G9yhuohREr26B2vSQcjqXdspTFHta,2rPxkUiMo9wGDq8EvAiwY3ngRpKmL223cBWWNTYoBmFp,True,305246,76311,475,237,238,3zqXX6kzhkbW3d4TwD2CNjMRwxTbREXySekvq37kfCNk,19006,237332,-218326,622
2022-01-24 07:47:22-05:00,10512,28JujYG1mbpYSjF7LNqXpup17TXb45VJHhhnFMVXtft2,DAqyVExAtmsovPGrkpkFDxm6T7pKWLztfh9iPjTNDqrd,True,1009458,252364,1572,786,786,HfEnetJ7uBSmZWCjBNxdvv9HEC5nsW4wDV7wu6WnhWan,62895,620819,-557924,623
2022-01-24 07:47:22-05:00,10513,95urWGJ4HN1bTarbDi8Dpj4K4ms7dovs8gwaYdaSLC6e,2THhqxjhXjp2Zui9ML2MzAbGN4dsfa3dkdqzC8LYhnbQ,True,230171,57542,358,179,179,3zqXX6kzhkbW3d4TwD2CNjMRwxTbREXySekvq37kfCNk,14324,267285,-252961,622
2022-01-24 07:47:22-05:00,10514,9rgrRAMcGSarfz8xXckw1LjkemMwwjzJLApPjpfY2XZ3,BRtNdDDtCiNDYDERZTBCefUiYvjShucRX1hxEBLyeggT,True,124147,31036,192,96,96,3zqXX6kzhkbW3d4TwD2CNjMRwxTbREXySekvq37kfCNk,7714,148690,-140976,621
2022-01-24 07:47:22-05:00,10515,9T6bCVf7AshQP1NNbsF3eCdbChKbcfrFUPFWUXRijY5M,4ZFq3kdwaUhiotXCXzDFjVCAP3udzGsx5CicgLLXd4PR,True,88306162,22076540,137991,68995,68996,3zqXX6kzhkbW3d4TwD2CNjMRwxTbREXySekvq37kfCNk,5519665,60292300,-54772635,625
2022-01-24 07:47:22-05:00,10516,HZSJVNb6g4o52N7pAJCLkGjur8evF5Ex1sAx7uUxUDdm,8LQHKhXStrwcd6f4AxaTVcrGdYpGjQz8vWf5JXsAzcsp,True,180825,45206,282,141,141,3zqXX6kzhkbW3d4TwD2CNjMRwxTbREXySekvq37kfCNk,11290,216704,-205414,624
2022-01-24 07:47:22-05:00,10517,BtS853vNEgvkEFhfkBPiHdcfry7SFVTC4hAX14rPhDiE,2LnfhTwvctYdZmmBvVkajF8XPnzGk4ghvZKaTnyHxZLP,True,160522406,40130601,249622,124811,124811,HfEnetJ7uBSmZWCjBNxdvv9HEC5nsW4wDV7wu6WnhWan,9984908,132190502,-122205594,622
2022-01-24 07:47:22-05:00,10518,Fw2e6jxKVeFcJSe9MyVhSz3dUdJQLs3XULHrT1mtMU9U,591U5bexgLRJXygtK5fpCRXcZEq89KgewFTdfPkti8bY,True,18610989,4652747,29022,14511,14511,3zqXX6kzhkbW3d4TwD2CNjMRwxTbREXySekvq37kfCNk,1160898,20046785,-18885887,623
2022-01-24 07:47:23-05:00,10519,E8iuHK2DErFnMAYfWmNoix4jVb4WDG8Sc41hBycLUxbd,77Zoru23JmnK5EJ8eURonQoEpJcLP4edabjD8MR8NKdX,True,2438715,609678,3806,1903,1903,3zqXX6kzhkbW3d4TwD2CNjMRwxTbREXySekvq37kfCNk,152246,2921623,-2769377,624
2022-01-24 07:47:23-05:00,10520,EPWsutEpgpcz776maq552k8QhDKdmkSfAED5E3jgpTdY,CCwGZYDvqoHEBBtSSieAJgy5e3k4jYrpjyDffypwnWxu,True,6538767,1634691,10181,5090,5091,3zqXX6kzhkbW3d4TwD2CNjMRwxTbREXySekvq37kfCNk,407276,7569135,-7161859,622
2022-01-24 07:47:23-05:00,10521,4yhW5mBsFVNgQ5QQc2Yg65guctPsTSXcERbzmYM6rdnL,5uJnMZ6DWA9bMSvHvS5zomwtt1sv7YCWq3GDJh77YC3q,True,154700,38675,241,120,121,3zqXX6kzhkbW3d4TwD2CNjMRwxTbREXySekvq37kfCNk,9667,185644,-175977,624
2022-01-24 07:47:24-05:00,10522,Hqzz5RdbkkmMPCVdxF3Q3sLuh7XVJHEwAP6zpz7pCwTj,TNwXSETgrJGM9S5zbBY3mMWKbPFskbKjPAhBrWFNfuK,True,140582,35145,219,109,110,HfEnetJ7uBSmZWCjBNxdvv9HEC5nsW4wDV7wu6WnhWan,8761,167712,-158951,623
2022-01-24 07:47:24-05:00,10523,43EtYHdVkdBxHTtFR3QWVgvCKj1SqsAf7xLY2yphsv1x,8WJbP4mVJWYuN1dVzHpRg7YR2nBELB4Krkq8Zch8sp4g,True,192341,48085,299,149,150,3zqXX6kzhkbW3d4TwD2CNjMRwxTbREXySekvq37kfCNk,11970,214988,-203018,622
2022-01-24 07:47:24-05:00,10524,43wwd6zLB8yKfXEu7rtbeDFhKBuxFR66MnyhTKW3zqa3,A9t6AMvVNenwWymz3QMtdUuuGYjjTPLaA9bhRjTzNY9h,True,2450633,612658,3811,1905,1906,3zqXX6kzhkbW3d4TwD2CNjMRwxTbREXySekvq37kfCNk,152461,2933340,-2780879,622
2022-01-24 07:47:24-05:00,10525,4nhdidD6SASYzwZ7mUnWKyP4xyWXhdBe2gp5F4qDtLrL,HLk6YPhVidsn3i8HfoASvoim1ztxb4bi8JnioiyvorpV,True,883371,220842,1374,687,687,3zqXX6kzhkbW3d4TwD2CNjMRwxTbREXySekvq37kfCNk,54983,1029777,-974794,622
2022-01-24 07:47:24-05:00,10526,BMawc4jLJMER4ryGcwdm27H3MU8JQCiSfwb9onVfYDpr,5ciaGDuaB3rBKvV7MphT2eMkCUxBzWZc7zYXQM7vbQ46,True,924498,231124,1437,718,719,3zqXX6kzhkbW3d4TwD2CNjMRwxTbREXySekvq37kfCNk,57496,1075626,-1018130,621
2022-01-24 07:47:24-05:00,10527,GcjcaWoMUcGkLaJBx3svxtzwGNn5SLcFrwaLqnpadUZY,Ep9sDjTMMasVjKdshsE88uk3mWYkKuMTVRooVJWvCq9F,True,2391171,597792,3734,1867,1867,HfEnetJ7uBSmZWCjBNxdvv9HEC5nsW4wDV7wu6WnhWan,149388,2861680,-2712292,624
2022-01-24 07:47:24-05:00,10528,446VESPwhh16pG3VcpgraT83MoqWy87qgU36mKZC8BsW,SmUPkPpnnRfSH3tcKUnbpK6HHNJtLfvMiUWk9eUwkNy,True,6499143,1624785,10112,5056,5056,HfEnetJ7uBSmZWCjBNxdvv9HEC5nsW4wDV7wu6WnhWan,404491,7523162,-7118671,622
2022-01-24 07:47:24-05:00,10529,C1tcxAjMzZaFVcF2ke2nSyiCjcLBwsz5yKXShy5MB14h,GYkrJj2zHVZuzPC45MbuevYkRJHdeL4Sqj9SWqZfUdiE,True,8227496,2056874,12832,6416,6416,HfEnetJ7uBSmZWCjBNxdvv9HEC5nsW4wDV7wu6WnhWan,513319,9488369,-8975050,623
2022-01-24 07:47:24-05:00,10530,B4Uc39nKzz9wBRQsCkMR4A7RwTJ8rSuwpR6EQn2AesRb,H49bGZgatRZVpj6QufZRVgYrQtH7LpdbiqKBs23151m,True,15645,3911,24,12,12,HfEnetJ7uBSmZWCjBNxdvv9HEC5nsW4wDV7wu6WnhWan,975,29837,-28862,623
2022-01-24 07:47:24-05:00,10531,4eaXYcx5ayhTq9TmmQFgLDjy6p3z93txUN97v8PTSh1J,J3vgUnjDUy5ngrmrs6FwpZTexxJNxXM1UjsHvsgw9g9y,True,157295,39323,245,122,123,3zqXX6kzhkbW3d4TwD2CNjMRwxTbREXySekvq37kfCNk,9833,188139,-178306,625
2022-01-24 07:47:24-05:00,10532,28YQqynu5oRud5xEcsDvAaGhJhgpiVJSTNeMwkrbpbyv,9zYqRWiRatbohCdBfV3PrAxp8v1kwgbvV9ta4RJRRp68,True,6407276,1601819,9994,4997,4997,HfEnetJ7uBSmZWCjBNxdvv9HEC5nsW4wDV7wu6WnhWan,399795,7416062,-7016267,623
2022-01-24 07:47:24-05:00,10533,DD1a8rMoUCwmEiLKRN43VpdqL8Qgfr5yi92ejQxDVRMo,3vMJVNAuyRhM9jkaEZARhwbR6MerR5UmcgoZ9c5bs1VS,True,2877587,719396,4491,2245,2246,3zqXX6kzhkbW3d4TwD2CNjMRwxTbREXySekvq37kfCNk,179651,3444972,-3265321,624
2022-01-24 07:47:24-05:00,10534,Bt37YbHvD2M8zcGmanksKy8MCi4Qzto7hEnGRJyNvWyg,4WGRnDhpoY4zJi74iJyALasETpJNJMCJtf9aWJUVrHQv,True,200745249,50186312,312995,156497,156498,HfEnetJ7uBSmZWCjBNxdvv9HEC5nsW4wDV7wu6WnhWan,12519823,136954509,-124434686,623
2022-01-24 07:47:24-05:00,10535,5iRLEmB6qBHqkJBPyyubnd9f1TpRr4EY8BTxuHUREeLB,GkY73KL6HJ4ycdggFtYWALBgmTRZVCx66P2ZJ7E8ENwC,True,134251,33562,209,104,105,HfEnetJ7uBSmZWCjBNxdvv9HEC5nsW4wDV7wu6WnhWan,8362,160694,-152332,622
2022-01-24 07:47:33-05:00,10536,DvuRmJkfn6FQczUKgYeaSCqwy2NTMunuAKNrnmxMvnzS,7LpWTX9dgBtW75kfEoB5WuNsDwEdw5s8CYSHh3J4qagM,True,251348,62837,390,195,195,3zqXX6kzhkbW3d4TwD2CNjMRwxTbREXySekvq37kfCNk,15636,269158,-253522,622
2022-01-24 07:47:34-05:00,10537,FV3G5EsSmyiLAAoREhgDXwvzbxoyDeq4Mwfj4jK5fJ7U,5nhzbJmm5JAwGDpTZoenkM1u3XtMY4uN7Qsm3vFGtRJE,True,244585,61146,382,191,191,HfEnetJ7uBSmZWCjBNxdvv9HEC5nsW4wDV7wu6WnhWan,15303,151833,-136530,625
2022-01-24 07:47:34-05:00,10538,4hZG7dM716SxDagiFGwt1gSC99B2QK1emGLV9TJmmuR8,7vjfUWySkyx4Z5qAaRr2VWnVvxHHNsvPj1PirGNSjM6,True,746988331,186747082,1160049,580024,580025,HfEnetJ7uBSmZWCjBNxdvv9HEC5nsW4wDV7wu6WnhWan,46401987,489879327,-443477340,621
2022-01-24 07:47:34-05:00,10539,5FgPU7KpsDnx4Xc1UdQoLPR7MDd5cBkJXW2Q8ctopMZR,9GWzAZFVfTY8WjTYvDAE2YcAjgeKiDXgToK76KBZF7Rv,True,207726,51931,320,160,160,3zqXX6kzhkbW3d4TwD2CNjMRwxTbREXySekvq37kfCNk,12825,241052,-228227,617
2022-01-24 07:47:34-05:00,10540,EmXaq1sxmAZUiwYW6LXpKtKFZXu5MzQ3sK4MEAojDK1h,HuAsa5G2wJi8Ah9stxEmggwcB5zW1QjBsP3Ndgke7r8X,True,210359,52589,325,162,163,HfEnetJ7uBSmZWCjBNxdvv9HEC5nsW4wDV7wu6WnhWan,13038,251515,-238477,619
2022-01-24 07:47:34-05:00,10541,9wsQcvpqPp8c9q42RntWDNbqNCnmJeW4GMG2AtKAHkBu,EMqRbzGvXTU1LtmoSw9uSrpTX2L4tpJQAMJJJ4duvzf5,True,22300561,5575140,34488,17244,17244,3zqXX6kzhkbW3d4TwD2CNjMRwxTbREXySekvq37kfCNk,1379526,15263307,-13883781,618
2022-01-24 07:47:35-05:00,10542,5zCfNUARbvDrkdkf8rKNnf6D7HXn7Wz6D61jQGTGpw3N,6T76MLTxS5vnRuodEgADt3iXMx8WUFLQzoyKh7f2uPFy,True,284468404,71117101,439561,219780,219781,3zqXX6kzhkbW3d4TwD2CNjMRwxTbREXySekvq37kfCNk,17582447,195591289,-178008842,618
2022-01-24 07:47:35-05:00,10543,96StvqZyFUPtyMr4o9s7K4V29RSNyRpVi76vNwxG5rUf,GZKXFSFq4aGiTaqovtxqNCCVGkAFNXPh4Hep1ZMwdZ8g,True,13948,3487,21,10,11,3zqXX6kzhkbW3d4TwD2CNjMRwxTbREXySekvq37kfCNk,861,25942,-25081,617
2022-01-24 07:47:35-05:00,10544,C1CsbgQFvEvSXzuVHTr39tQHr3drDhjxeYiotd8eNocF,4rAaTCAMj5VpgNVKiYizabH7cMLhEA12seu2QXQNTyV3,True,861168,215291,1345,672,673,3zqXX6kzhkbW3d4TwD2CNjMRwxTbREXySekvq37kfCNk,53839,450045,-396206,625
2022-01-24 07:47:35-05:00,10545,5acohGZShYQVNGZEfy7pTyX7E8MzqRDwByhFL1H53UNv,4Z454ZseKbWGEtdrE9eotbDZ7o9VHhooMYriTfSFHiGt,True,57690637,14422658,90196,45098,45098,3zqXX6kzhkbW3d4TwD2CNjMRwxTbREXySekvq37kfCNk,3607868,23886541,-20278673,625
2022-01-24 07:47:35-05:00,10546,8xjstKJD2RopRxxRP8JbMYRmpBKgSZivMFRXXRZ5syPh,HUfevkvBsm5SDpxnZ4NBD8Re7LvqBQLrx5UWXCeYTBgK,True,232727,58181,359,179,180,3zqXX6kzhkbW3d4TwD2CNjMRwxTbREXySekvq37kfCNk,14384,270367,-255983,618
2022-01-24 07:47:38-05:00,10547,8YMEydGnQH9W5AEXFGquFkb1bcf3PcxiMvYBSMPXKJyQ,3CmWH8eYtkmHNisqMmMBLff6C6z6ZcSj38KoQ34DPUE7,True,123319,30829,192,96,96,HfEnetJ7uBSmZWCjBNxdvv9HEC5nsW4wDV7wu6WnhWan,7709,137988,-130279,625
2022-01-24 07:47:38-05:00,10548,8GdYhwX26GRmVfGFCbJ3MJrH1UdneN2FNRUexhLsqprN,DpUTHSVucDPyCWoLCdpm8EFRZFiKL88tmnSiWG2TRpS8,True,140926,35231,218,109,109,HfEnetJ7uBSmZWCjBNxdvv9HEC5nsW4wDV7wu6WnhWan,8733,168114,-159381,619
2022-01-24 07:47:38-05:00,10549,GwYr2DmtMVLWxVz6kVSXR6rvxL4x3DXtvNC7taswSWHN,2otMHa7JT1twPSSN6XF9fqGkKrEK8nnuMFZG1TtAgFQk,True,1073,268,1,0,1,HfEnetJ7uBSmZWCjBNxdvv9HEC5nsW4wDV7wu6WnhWan,67,1265,-1198,624
2022-01-24 07:47:38-05:00,10550,6sK2PQyTvStxT9qigrFaPmf9GSe4X4wLb4ig7izrzwaB,6iyTuXdnBiLrKPCat7ajRnUq2245L9bbJrHAvsnyFx8e,True,1073,268,1,0,1,HfEnetJ7uBSmZWCjBNxdvv9HEC5nsW4wDV7wu6WnhWan,67,1266,-1199,624
2022-01-24 07:47:38-05:00,10551,8nXbrdjjaHB73CRPRenGEQj73wbtEFGDwXsehRGMhsap,43pvdcJ6f27wz94D6ZboKwRJYbyvYCrjsJhYsvk7LJCM,True,38946,9736,60,30,30,HfEnetJ7uBSmZWCjBNxdvv9HEC5nsW4wDV7wu6WnhWan,2415,31318,-28903,620
2022-01-24 07:47:38-05:00,10552,6Bq55LtGCEeGqh4JrFLCmmGc2iJfTTBJixivqH78aGSE,DSNrCgWJeNe2P9tAQu5FvCueTzNKDKds7wzuwTQSMRG,True,4151,1037,6,3,3,HfEnetJ7uBSmZWCjBNxdvv9HEC5nsW4wDV7wu6WnhWan,258,4633,-4375,621
2022-01-24 07:47:39-05:00,10553,HpRYrL8HzCPaBJTLFgZmYg2aXBnBQUpf1mikVkzkY56z,8DzHRd8qWcEjnX6cefwYtgRGpQJUaw9QPjyfAsN7j33r,True,1602842,400710,2477,1238,1239,3zqXX6kzhkbW3d4TwD2CNjMRwxTbREXySekvq37kfCNk,99115,1874754,-1775639,618
2022-01-24 07:47:40-05:00,10554,6aW9dhnTNerVd1MPv5GrcYqgjVPE9LsNCGYSJSrNdgS8,8kmJu2UxTk2T37sqxDSrf6pDWhJZRxfRdJB7DLeoWddJ,True,5203497,1300874,8088,4044,4044,3zqXX6kzhkbW3d4TwD2CNjMRwxTbREXySekvq37kfCNk,323548,5939120,-5615572,621
2022-01-24 07:47:40-05:00,10555,Gfe4UgUGqvzcehSbETrWwLRAcqzFnkTrs6vJx8h6kTxi,7exMQ8sLti4Pmb2ZQtZhyuWRuQ6pq7XSXL9sCcWTqCvF,True,12773706,3193426,19869,9934,9935,3zqXX6kzhkbW3d4TwD2CNjMRwxTbREXySekvq37kfCNk,794784,15035599,-14240815,622
2022-01-24 07:47:41-05:00,10556,CEtpqFD4BbeiNfaXyLLYEapY2mWgE26H5q6H34tWwRuD,BVqRyqwGFPzSkk1H2finiyfaL3LScbEiQGk3mihirxqs,True,115724,28931,178,89,89,HfEnetJ7uBSmZWCjBNxdvv9HEC5nsW4wDV7wu6WnhWan,7151,136602,-129451,617
2022-01-24 07:47:41-05:00,10557,G3vArDs7nb18se4xMZ68oMHmTAsYP63x8dfY57jAogwp,EY7J8Hw8jWbryw11CYdPVUSdAoDGGNEfacqghVnJn3JK,True,2357307,589326,3625,1812,1813,HfEnetJ7uBSmZWCjBNxdvv9HEC5nsW4wDV7wu6WnhWan,145004,1451025,-1306021,615
2022-01-24 07:47:41-05:00,10558,EDSf2w1UyGvbgMuxyoXL58ifR1dviZinnLBYnFmgjcNG,DFenkzbL9SUjs9cSCaHJ1eXK75mHfk3GSPRFs8TSzrFV,True,9299735,2324933,14371,7185,7186,HfEnetJ7uBSmZWCjBNxdvv9HEC5nsW4wDV7wu6WnhWan,574874,6281984,-5707110,618
2022-01-24 07:47:42-05:00,10559,4cNmhgaMic1xBiaDJ6phrQuXmm8WfF1qjyYMqZcKG4c9,43vgfXiLTtcs1bkrcDar2iz9M6RMbGqbA6BMkBHdh7T4,True,147667,36916,230,115,115,3zqXX6kzhkbW3d4TwD2CNjMRwxTbREXySekvq37kfCNk,9235,177708,-168473,625
2022-01-24 07:47:43-05:00,10560,BYvjENe16Ta77PqGV7JKEWrsqCTfkMGYwTSG5gXneDvd,EvxAXgvhPC6QkNurbK7vWyTApGo8J2R4EgMAknkHVU3d,True,1868,467,2,1,1,3zqXX6kzhkbW3d4TwD2CNjMRwxTbREXySekvq37kfCNk,116,2775,-2659,620
2022-01-24 07:47:54-05:00,10561,2pMGfXreJV4ZGoQtRyvhdE8TFccLhkguLb7JsjGnyr7p,7FVhyNsmwmSKF8H73YfLmx6ASLw9G13r3LXDnRqKjWKL,True,3678444,919610,5739,2869,2870,HfEnetJ7uBSmZWCjBNxdvv9HEC5nsW4wDV7wu6WnhWan,229599,4460843,-4231244,624
2022-01-24 07:47:57-05:00,10562,GGcsY84pkqUn2xySuLYrUUg8gWMBWgfHaQ7rK42NoZaH,4EyjJvctL9WBQiauD2Eaf2Hus8htYzHxP5GR2HsUfuks,True,31507017,7876753,49260,24630,24630,3zqXX6kzhkbW3d4TwD2CNjMRwxTbREXySekvq37kfCNk,1970433,18878969,-16908536,625
2022-01-24 07:47:57-05:00,10563,4WSiQCTqMvpSYvrbenQGFoV6fuDALSWMwZZ9MgP82fwb,6Y5GdgKErVfXrabSTi89X7xCEsZnoqDqwFD4hZ3FVtfN,True,4044710,1011177,6304,3152,3152,3zqXX6kzhkbW3d4TwD2CNjMRwxTbREXySekvq37kfCNk,252176,2952643,-2700467,623
2022-01-24 07:47:57-05:00,10564,6kt64nJRnYaWMi9GbpZaUuhbToAVRd7FUMTGASAAJrve,2Sdxv9ZtogNcVbJwBPxKmVjwAiKyX5GHEfnRmFcydQ1G,True,18284539,4571134,28563,14281,14282,3zqXX6kzhkbW3d4TwD2CNjMRwxTbREXySekvq37kfCNk,1142554,19738400,-18595846,624
2022-01-24 07:47:58-05:00,10565,C1rjefgArnN3nBn5Wu3yXij2wAyGWFtWdjGNLR9vpjmj,GsLCESLzYGZ1brEh8RJrZttE7hxcpSq7iUqdhwJhnDVB,True,491754,122938,768,384,384,HfEnetJ7uBSmZWCjBNxdvv9HEC5nsW4wDV7wu6WnhWan,30751,438532,-407781,625
2022-01-24 07:48:02-05:00,10566,2DHhfXSzcuSwsKfAYLMuWuD17w84mCwNer9fcBNLTpSc,89BVfDycKjdSkQzFVqCXd5c16DntdND7WsqoZtCafYFH,True,7536661,1884165,11786,5893,5893,HfEnetJ7uBSmZWCjBNxdvv9HEC5nsW4wDV7wu6WnhWan,471446,8771543,-8300097,625
2022-01-24 07:48:02-05:00,10567,4qWzk4JP2gEsTP252Y4SJrjSmfRBxDfE4ZdbPmwavfb2,CAgDhCNVyy61FG2YPMnm9zxgY56s2UqPhvssH5G1LjXP,True,16799480,4199870,26271,13135,13136,HfEnetJ7uBSmZWCjBNxdvv9HEC5nsW4wDV7wu6WnhWan,1050879,18054148,-17003269,625
2022-01-24 07:48:02-05:00,10568,45AiuRBbmupfwYXqsWwKHtmEWN8XNJDUSHwHL3b6PvHc,CfvwVkxYPP3jqK2dpAvSRFA1513E9ti84mEpYgtkzFUt,True,267793,66948,418,209,209,HfEnetJ7uBSmZWCjBNxdvv9HEC5nsW4wDV7wu6WnhWan,16753,309949,-293196,625
2022-01-24 07:48:12-05:00,10569,8xQ3tsWVUe75EG1HmocULJ3kh52utveoFMEPotTGrKno,i3SKW3ywrwYucX9ySEx1C4zaUKGnzLerP3V38437NyV,True,117200,29300,182,91,91,HfEnetJ7uBSmZWCjBNxdvv9HEC5nsW4wDV7wu6WnhWan,7315,148644,-141329,624
2022-01-24 07:48:12-05:00,10570,HxhVxMpFpKzeuC6Z6CpsuUhPHdHUzvpMNYJ8LpQ3NYCp,8KyiipC39iU15zVErVvj6hdhbv89STsexrB8dVw3RcLs,True,164702,41175,251,125,126,3zqXX6kzhkbW3d4TwD2CNjMRwxTbREXySekvq37kfCNk,10076,197615,-187539,611
2022-01-24 07:48:13-05:00,10571,8GhXRNmsEgFgKPhGNNgEPUywVzW3bE7uZRWys2P1yNeJ,Bvi5vD5fhRFNdVhEXsSv9vkJzyQzgEswFHBxowkUEgF,True,1355993,338998,2073,1036,1037,3zqXX6kzhkbW3d4TwD2CNjMRwxTbREXySekvq37kfCNk,82948,1609922,-1526974,611
2022-01-24 07:48:13-05:00,10572,3R2wxFQwjCqUwwxJmp9tNrT6osYFpB5gczq2QYik6QYm,7At5Ej3ZsynfWr56FYrd4P4Y6UtD8FHA4gCFB8TaAyaG,True,157268,39317,241,120,121,3zqXX6kzhkbW3d4TwD2CNjMRwxTbREXySekvq37kfCNk,9671,188500,-178829,614
2022-01-24 07:48:13-05:00,10573,CygwJ5Z1ZP6xfjN1ZGH7yw8b2oYvf6JTpenXx7A5yFdt,59VKgJtBCTb3Pji7BWtqttisBYVVCnWtyEn5Eba5r52Y,True,2731798,682949,4170,2085,2085,3zqXX6kzhkbW3d4TwD2CNjMRwxTbREXySekvq37kfCNk,166801,3065804,-2899003,610
2022-01-24 07:48:13-05:00,10574,G8nRLTWTT5aD7q7TcSa2mw7p12GUuHDVq5ev4vyXbdKi,3DmQyungZMK4T1a1PgXh5shBskwP69tTLmZPh7HZ76vh,True,229787,57446,356,178,178,3zqXX6kzhkbW3d4TwD2CNjMRwxTbREXySekvq37kfCNk,14242,274924,-260682,619
2022-01-24 07:48:13-05:00,10575,8VQ21PFXdHBNmiZiF18LyGvsRSpr13vkyktfembNCe3m,5exbVC7vaGFeHEGAx7epYfMaU932QafqzfhFm5FKAq2H,True,142236,35559,220,110,110,HfEnetJ7uBSmZWCjBNxdvv9HEC5nsW4wDV7wu6WnhWan,8838,170168,-161330,621
2022-01-24 07:48:13-05:00,10576,HZJyrD4eqM4nKnyRh2JAs1sC2TaJxFhNPixBdK7PLMuS,Hycz71z4tEsKUogJnefT2GN3MPCLdTJdv9B6T82Ngw2u,True,676656,169164,1039,519,520,3zqXX6kzhkbW3d4TwD2CNjMRwxTbREXySekvq37kfCNk,41565,816535,-774970,614
2022-01-24 07:48:13-05:00,10577,9WRDBHzD4aNHw5qvrhc6nqXCBLA5D7YYP8TvSrLksXd6,GwxWNmv9XDkqQsx7DfCMccFjVik8asPnFU9gtnb4UVx,True,121652,30413,186,93,93,HfEnetJ7uBSmZWCjBNxdvv9HEC5nsW4wDV7wu6WnhWan,7455,145785,-138330,612
2022-01-24 07:48:13-05:00,10578,7afnF1MkAootZGWc7zsMVLpBuve83hGmvAHkfmwgsq5A,HKdJE8bReznq1Qxqd5iZ4nWQGCk62Vo5TpkRD51bpbGp,True,161436,40359,247,123,124,3zqXX6kzhkbW3d4TwD2CNjMRwxTbREXySekvq37kfCNk,9885,193424,-183539,612
2022-01-24 07:48:13-05:00,10579,6X5por58mMECmNZQEWpo8M8aA1eHJqr5LNeV9vC7GW5e,DPB2C5UB2Ls1kNzbs1GP33junQvhUyFJWP75RoYjqByn,True,8381723,2095430,12978,6489,6489,3zqXX6kzhkbW3d4TwD2CNjMRwxTbREXySekvq37kfCNk,519145,15534061,-15014916,619
2022-01-24 07:48:13-05:00,10580,6TvTxJWSPeyaTVm8PmarVDzxhbTqnkyoabQTgihXyGMj,62ngTMHaRDFjpvzasDgfmgyJ5T6jS9PmYgy97HCkyQS4,True,4444840,1111210,6870,3435,3435,3zqXX6kzhkbW3d4TwD2CNjMRwxTbREXySekvq37kfCNk,274831,1289058,-1014227,618
2022-01-24 07:48:13-05:00,10581,AiLCB8xw3k5FXdJE1T42PLFhHrz1bLTKpNekR61a915N,HB7CNWxLipWAc6MPGq9wV4TT7AYjiELA5T3onYeVqBbU,True,3161510,790377,4930,2465,2465,HfEnetJ7uBSmZWCjBNxdvv9HEC5nsW4wDV7wu6WnhWan,197239,3813822,-3616583,623
2022-01-24 07:48:13-05:00,10582,73Wkg27usHy8knWENTmb9zbikugYh93JvBB2bF855vZ2,J9WaUA7r8ct4ZG8o8ATZjvHUPuCYqY42aTsr9xveW5BX,True,164571219,41142804,251979,125989,125990,3zqXX6kzhkbW3d4TwD2CNjMRwxTbREXySekvq37kfCNk,10079174,241022209,-230943035,612
2022-01-24 07:48:13-05:00,10583,68F35fonSGS1P6LMYmAmeoM8kC6Z78NabMqYLeCZr9GJ,8apmWSZdS8s1ScoNVj4AvSJsbQCj1drU3HL74khuANT2,True,167196,41799,257,128,129,3zqXX6kzhkbW3d4TwD2CNjMRwxTbREXySekvq37kfCNk,10304,200178,-189874,616
2022-01-24 07:48:13-05:00,10584,oTq8BsGLNc2ddcdR7ELnCXgzf4KvtA7REmfbFKo56FT,4PgxGgi2UaB753PFyELQCrJy7phAkYsW4e39J9wGWrcM,True,9877104,2469276,15201,7600,7601,3zqXX6kzhkbW3d4TwD2CNjMRwxTbREXySekvq37kfCNk,608070,18855980,-18247910,615
2022-01-24 07:48:13-05:00,10585,2AAWghW6BUAFBtF3R6hB9uoqMc5oUDkU8FTd2JrXKema,798cfEUZ2YhXwNTNjXMS4Z2J8gAHaK4zZwpMkq2HzWWM,True,844348506,211087126,1290908,645454,645454,HfEnetJ7uBSmZWCjBNxdvv9HEC5nsW4wDV7wu6WnhWan,51636345,697709007,-646072662,611
2022-01-24 07:48:13-05:00,10586,Dqnxcekm1QfxGQ2FSJ6SjFiwmaQRWEjW9WTJQG4AjEpE,9JiMtjm5AJqngosRg787FiN8NyuBPuAPD2jYpRQkAc1d,True,204819,51204,319,159,160,3zqXX6kzhkbW3d4TwD2CNjMRwxTbREXySekvq37kfCNk,12775,245168,-232393,623
2022-01-24 07:48:13-05:00,10587,9QZvB1Gqhk5PKt3MoJMjZL3FaU2bTbTDcVw3nF316zh7,DGJWGr9RCWkzdWn21mWG7NyUN8uuvSQbA53HojFJe1rH,True,2024763,506190,3145,1572,1573,3zqXX6kzhkbW3d4TwD2CNjMRwxTbREXySekvq37kfCNk,125821,2339658,-2213837,621
2022-01-24 07:48:14-05:00,10588,AECUZGm5DjFvbLZEUYhepSPg1Wa7hBjxF9e7ZRBzRPhm,Ar7e1iLKAqa54QiQnXifvnETixDZT1T8KL5YWJA8Ykv1,True,190414,47603,290,145,145,HfEnetJ7uBSmZWCjBNxdvv9HEC5nsW4wDV7wu6WnhWan,11609,227777,-216168,609
2022-01-24 07:48:14-05:00,10589,AzLdwyd8Q4V3iMaSwWgvWwQ9nCs7X7YV2YKpd6CH33nP,BYjeXF5YkcJy3mNMbvfHzXTtyjkc4U53hM5tvfERUH8y,True,156276,39069,241,120,121,3zqXX6kzhkbW3d4TwD2CNjMRwxTbREXySekvq37kfCNk,9650,186977,-177327,617
2022-01-24 07:48:14-05:00,10590,EAUFD16wab8qRMJ4H6updHGt4xFqgRCDeRHVCsLCTSTL,8vkfYSyCyBY9g4TZrp52jUcQj6udy9xAaA4fioRE2RXx,True,94233362,23558340,145861,72930,72931,3zqXX6kzhkbW3d4TwD2CNjMRwxTbREXySekvq37kfCNk,5834447,67262583,-61428136,619
2022-01-24 07:48:14-05:00,10591,ANXYsUNpZ34dBt7cp6HEE7oi2pTKsbj7B5TeFHKPbHBU,2pqeP4fuMREosHcfWUecEBssp1GM4isihNjn7ALUD51d,True,191339,47834,297,148,149,HfEnetJ7uBSmZWCjBNxdvv9HEC5nsW4wDV7wu6WnhWan,11916,228911,-216995,622
2022-01-24 07:48:15-05:00,10592,69byqtDPmgEY1NqKBCR95CEPVHRUxgbNW9Y4P4HjQ7ND,E47T4q4zMGzNL6vDxgWdLn3EQbW3WfVryr8Jsymy1hAL,True,259595,64898,400,200,200,HfEnetJ7uBSmZWCjBNxdvv9HEC5nsW4wDV7wu6WnhWan,16024,284918,-268894,617
2022-01-24 07:48:22-05:00,10593,52pCCDDTo6uQhENab7rCsqS5ZihDDBmMSTQdCj8QLoea,GZh4ev3p6RrDRo98WfQQ7ZzzMBbqWF9gj9WbicU7YWD4,True,56909731,14227432,88857,44428,44429,3zqXX6kzhkbW3d4TwD2CNjMRwxTbREXySekvq37kfCNk,3554287,21644682,-18090395,624
2022-01-24 07:49:54-05:00,10594,3c4tj9J8QwB3exFchWei43nBh5xsYRZxEUfayi3JvYgm,Fyw1TEEDKhLFo16qxDsttsAwSkrfzpDe8Dmm3atEeXyN,True,1189600,297400,1861,930,931,3zqXX6kzhkbW3d4TwD2CNjMRwxTbREXySekvq37kfCNk,74460,1101899,-1027439,625
2022-01-24 07:53:21-05:00,10595,4PZZxNrWLhNCuT5VJ1DQe3XxQVVwMPrjfUpdeAY8qS7U,A7CvKre7y5VbUN1HneNHmuBv7jWtayV78oozAqaVbQrv,True,47050900,11762725,73319,36659,36660,3zqXX6kzhkbW3d4TwD2CNjMRwxTbREXySekvq37kfCNk,2932794,51313080,-48380286,623
2022-01-24 07:54:09-05:00,10596,HwosLQgDY1xtHQRQ4hzroPQHFWssPzTj5vRkP37FcviB,HKTNEYNXrephNkH7apbobK4mcQXcNayQA4W1NgM6sLr8,True,450514,112628,705,352,353,3zqXX6kzhkbW3d4TwD2CNjMRwxTbREXySekvq37kfCNk,28200,316580,-288380,625
2022-01-24 08:00:24-05:00,10597,DC4UVUDFWL3gVtgkX9hPtFgtxaA8DH5p94i4k9U3wyWv,3HCWqVvQQfRgSKitsTjGTduJ82ointZUSNtj13uea4kD,True,5175715,1293928,8014,4007,4007,HfEnetJ7uBSmZWCjBNxdvv9HEC5nsW4wDV7wu6WnhWan,320579,4633032,-4312453,619
2022-01-24 08:00:24-05:00,10598,2sPD4f4d3CCeFSwSC5vAGS3YoTsTGypYKfDeoJczebop,HWCRpcq2sXqJL7Vi8MtipQDwGSViE73bUxS36ETmvnP2,True,530389,132597,826,413,413,HfEnetJ7uBSmZWCjBNxdvv9HEC5nsW4wDV7wu6WnhWan,33053,323538,-290485,623
2022-01-24 08:00:55-05:00,10599,DXEJNyHSCbGZezXHy2xQaSzd37dwJs4dMTgt5VF5UZAG,7fCYM9DWrAX7vgZ11CwQMNd5NU8FB1yrbctxHaPYshpB,True,1584428,396107,2428,1214,1214,HfEnetJ7uBSmZWCjBNxdvv9HEC5nsW4wDV7wu6WnhWan,97149,765042,-667893,613
2022-01-24 08:00:58-05:00,10600,3oCun4gm3k8sXxVxiYM8okGi8iCXH9LvDkHf9PBQWYXR,E1np1dZ7jUm811ddvy1jQerBwGSYb5BbZWnUHeotvrfH,True,485584,121396,753,376,377,HfEnetJ7uBSmZWCjBNxdvv9HEC5nsW4wDV7wu6WnhWan,30127,264038,-233911,620
2022-01-24 08:00:59-05:00,10601,CM95f7KjJuAf1xVTWhu3wrp6BfMz116FbgkxBhcRNs4k,EG55wkH5NcoasfBUYhD5D2dc2uvo11dZ3uTu5wgs4gf2,True,274981,68745,427,213,214,3zqXX6kzhkbW3d4TwD2CNjMRwxTbREXySekvq37kfCNk,17106,316085,-298979,622
2022-01-24 08:00:59-05:00,10602,Bbd196A866Y9rQWQFt4YGg2R6Jqj7WQGXWPDmrNtPcKf,5gmWk1KwLoRHnhkjxps4Ad6aVk4ZpcfC3McZCWDVCUbu,True,150858,37714,235,117,118,3zqXX6kzhkbW3d4TwD2CNjMRwxTbREXySekvq37kfCNk,9407,186685,-177278,623
2022-01-24 08:01:00-05:00,10603,DjbEch16uzdDtujFUeqxjquTTS3JXzEys8e9ogUv3aTy,6N8eKb3kfcbJEUZKZERiFiUR4hubB635D8Sotiji2TU8,True,18949370,4737342,29655,14827,14828,3zqXX6kzhkbW3d4TwD2CNjMRwxTbREXySekvq37kfCNk,1186219,20527392,-19341173,625
2022-01-24 08:01:00-05:00,10604,4eba4qAmwfqmihaYvTWFU9hm4VYrKvNhNywHNyimQJNK,G1DyxJcNQD8u4KGfnwxttyrJMfse1FBAsofioEMdTS9U,True,976833,244208,1527,763,764,HfEnetJ7uBSmZWCjBNxdvv9HEC5nsW4wDV7wu6WnhWan,61109,1174711,-1113602,625
2022-01-24 08:01:00-05:00,10605,GM22yjVoBCzgBcVTT5EcgRhVWiXVV82kSj1dPCbegKWj,CDDy8JmJMwJyx1YAvEPpj8AYxCpngRovf3wWfVzao5Rc,True,93001,23250,144,72,72,3zqXX6kzhkbW3d4TwD2CNjMRwxTbREXySekvq37kfCNk,5792,63035,-57243,622
2022-01-24 08:01:00-05:00,10606,8XcMucCQpWfNtbdCYnKuabk91NQ9wfYp7byk496CwU9n,DLrApDfWcyMqufEFZm9PvddsMoiediT58X8e8pxpnzrk,True,257978,64494,402,201,201,3zqXX6kzhkbW3d4TwD2CNjMRwxTbREXySekvq37kfCNk,16090,297946,-281856,623
2022-01-24 08:01:00-05:00,10607,2ZX5NexeuZq25mAfBFDrwd44UfKhWgzmSwdhWFmo48c7,CpNnhSqg7EHn9g84gHoo831sVrAe5SkwNaEZAash4CXs,True,1064865,266216,1661,830,831,3zqXX6kzhkbW3d4TwD2CNjMRwxTbREXySekvq37kfCNk,66457,1282069,-1215612,624
2022-01-24 08:01:01-05:00,10608,Go3ne58krEsFsZ5yu9EBT7od15VCYmtbs1KhumRMTiXS,HCvwQ7HjmmeDXrguZQPrAbJjcCJzHqVZK2JMSFkFDWfe,True,53916,13479,84,42,42,3zqXX6kzhkbW3d4TwD2CNjMRwxTbREXySekvq37kfCNk,3367,66894,-63527,624
2022-01-24 08:01:01-05:00,10609,D6qMab7uevXTa89ssv4BRyHwrw3FYpNimAmX2VH2uf4B,8ZauZ5dAp7kyawkPdxi4mqfempFHubJebfBenQdDektD,True,86083,21520,134,67,67,HfEnetJ7uBSmZWCjBNxdvv9HEC5nsW4wDV7wu6WnhWan,5377,106732,-101355,624
2022-01-24 08:01:02-05:00,10610,AnqmmhzVDCNq4dE4VvYkPDGB9nMXr4ykqvUhwxhR21pd,CcMeofCvvrDaBzgAGzoPwRt5eQmzdB1z2Y6UiwGqhFbG,True,1811605,452901,2822,1411,1411,3zqXX6kzhkbW3d4TwD2CNjMRwxTbREXySekvq37kfCNk,112910,2627708,-2514798,623
2022-01-24 08:05:04-05:00,10611,HELPNUwAqTX7gfHS4cnJnqXFM6Rb156tYcpsitKR9iDu,3RdfgDvLvsdZG5Cf6hKiKMQMqfidyxHzjYvUx1FZpeHQ,True,1300591,325147,2012,1006,1006,3zqXX6kzhkbW3d4TwD2CNjMRwxTbREXySekvq37kfCNk,80509,1598300,-1517791,619
2022-01-24 08:07:26-05:00,10612,pFCQLWBcx4YmtALBatWXwLR3MErHAxAyq1LVjgZJWbo,Hc3WoJQAV3Ue2yzxFxBdsx47ZsH6Hart62y89WRWCtqT,True,16836093,4209023,26164,13082,13082,HfEnetJ7uBSmZWCjBNxdvv9HEC5nsW4wDV7wu6WnhWan,1046560,7605267,-6558707,621
2022-01-24 08:07:27-05:00,10613,AoPQqPjLPi8fZiLkhMGLRj6oD5k2asrvJtCkpW19DvGr,H5Sgmf1VuY13iHjPuLJ2q9wtSdkXG1AQsEv2eq6zzm8Y,True,18526313,4631578,28987,14493,14494,HfEnetJ7uBSmZWCjBNxdvv9HEC5nsW4wDV7wu6WnhWan,1159486,6360481,-5200995,625
2022-01-24 08:25:47-05:00,10614,243SAnGxchCVB1LQAUF4SsozR86yDwEdg2QQpbWGsMYe,5u8sNkb2oEQjUXJAB3yGStmv3Uwz16gBgExBo5myVK4b,True,482416,120604,746,373,373,HfEnetJ7uBSmZWCjBNxdvv9HEC5nsW4wDV7wu6WnhWan,29856,299352,-269496,618
2022-01-24 08:25:47-05:00,10615,25NUDrsdLhS3fcARLiTMbbmZHvvzvzPj9xAdoN8sJBN3,8baNRGHfYRcLdhbHNuH72ofAWM9UojqhTMLnbBayzGnW,True,1447125,361781,2246,1123,1123,HfEnetJ7uBSmZWCjBNxdvv9HEC5nsW4wDV7wu6WnhWan,89868,914127,-824259,621
2022-01-24 08:36:40-05:00,10616,4SQQdHTJUDv8taPXQRvEVJpUu91iCWQsv9su8tfehaQG,33CJXj1pmmatAofRvgt5in9E6SLEuy7tq4jqSwnUWP2A,True,83082024,20770506,129984,64992,64992,HfEnetJ7uBSmZWCjBNxdvv9HEC5nsW4wDV7wu6WnhWan,5199399,95815874,-90616475,625
2022-01-24 08:38:10-05:00,10617,4Enpw9W2mWGnNYagYQ8WW29RLSs4R5YX4qXCsVqMFeHn,9QwbJmm9QDKXyc4ZViq74BfS35zzewEceXQNnFCgczXu,True,140029650,35007412,216758,108379,108379,HfEnetJ7uBSmZWCjBNxdvv9HEC5nsW4wDV7wu6WnhWan,8670335,56362069,-47691734,619
2022-01-24 08:38:10-05:00,10618,B5CTBTggmGFvGFSunjbB4C9tLKcYcULehmEiEXRihY2J,FX3ebF8P89rZBWfR74PDWUzxnLuDkUDgGcPYCBD5sMUG,True,8659962,2164990,13440,6720,6720,HfEnetJ7uBSmZWCjBNxdvv9HEC5nsW4wDV7wu6WnhWan,537601,5393018,-4855417,620
2022-01-24 08:39:02-05:00,10619,5NVD6QvomTAD35yNxSFZw4DhF2hCtV8drkbnGhBVtK5y,3JzkyPnREvoFZLL9JZuuDEnee3nuKcrqY3xLuXsmHwRo,True,123163,30790,192,96,96,HfEnetJ7uBSmZWCjBNxdvv9HEC5nsW4wDV7wu6WnhWan,7706,135065,-127359,625
2022-01-24 08:41:19-05:00,10620,F9s8a7Cpiw5dw3a2aNFMofqwyDWNXvDLnSdJzoj1gRiV,GpKsQKJD79KBRWdCTkyi4zX7NaoCWsLUjrKxAwJB6o6s,True,61557,15389,96,48,48,HfEnetJ7uBSmZWCjBNxdvv9HEC5nsW4wDV7wu6WnhWan,3846,44372,-40526,624
2022-01-24 08:42:51-05:00,10621,A1VornXbzK5rFgsy9D4qThcPnYVP8AB9RRzWsV1h6L17,9M4dQgz1zWrtKHqZMt9w7PbM9CvmyjhY5ZZ6jjajMzqm,True,1680181,420045,2594,1297,1297,3zqXX6kzhkbW3d4TwD2CNjMRwxTbREXySekvq37kfCNk,103770,790670,-686900,617
2022-01-24 08:42:51-05:00,10622,4vW2Q76fdGmfhU2Tx3R2XQkGcQUi6hSM9ixvK5RWvurJ,w8cGbqVpVr6WHSRJFXv469RMgRB3ty3TGpkVXRs7K7H,True,3335908,833977,4982,2491,2491,3zqXX6kzhkbW3d4TwD2CNjMRwxTbREXySekvq37kfCNk,199319,1460840,-1261521,597
2022-01-24 08:42:51-05:00,10623,56488NdcUy6Hi6X5SLs2GFtW5pG4u5wJpH7vHdxTCx4z,tGgXjJeVr3W2m3T2NXPCqpBEd6HJKE2cRsgCyiDZQy4,True,2423422,605855,3790,1895,1895,3zqXX6kzhkbW3d4TwD2CNjMRwxTbREXySekvq37kfCNk,151605,1737287,-1585682,625
2022-01-24 08:42:51-05:00,10624,2fCreQCCB6cWjyE1eddSBY89YniYavEfEo2QWKS9MWMT,HkpLJPjXUUbWmJ4pJDFHkGfU6NqEow1iRKiJeD428WWp,True,19986513,4996628,30667,15333,15334,3zqXX6kzhkbW3d4TwD2CNjMRwxTbREXySekvq37kfCNk,1226718,8434705,-7207987,613
2022-01-24 08:42:51-05:00,10625,J6jBKPDR6R5cLMqLufw3zoVfheNYs1KF7C4Ft2dakXeA,6wTTLK675Ym6toJRp7tYaUZzisWfgGjSp3X3yJ31xiKt,True,2507203,626800,3804,1902,1902,3zqXX6kzhkbW3d4TwD2CNjMRwxTbREXySekvq37kfCNk,152169,1375882,-1223713,606
2022-01-24 08:42:51-05:00,10626,B9WJfmrYEkVH3L1UWz4qqWpaexHydymbzvEfwNVtB9BV,6mQb4yzGq8jE1NbweKCKSbevnnYVhHYxyc6Gz2a5kJLn,True,11501997,2875499,17640,8820,8820,3zqXX6kzhkbW3d4TwD2CNjMRwxTbREXySekvq37kfCNk,705636,5132765,-4427129,613
2022-01-24 08:42:51-05:00,10627,DDsY5V3F9wnEGBoQFCEf1hvEYuKUaJdysbc7TxhNqe9G,5oBCGzvy8odB8MCxCUvPDqYCnTyteZ4Yy1JDroroygbi,True,2522072,630518,3764,1882,1882,3zqXX6kzhkbW3d4TwD2CNjMRwxTbREXySekvq37kfCNk,150574,1189459,-1038885,597
2022-01-24 08:42:51-05:00,10628,2JXP6KUwPSmCrXT2uQRqSoCwH8RLYWwmqYsj3zXtv9xF,4qcFVgugXsHVQzFRP2he9CVzvv47xqgokJjigee8oPpP,True,85191369,21297842,131797,65898,65899,3zqXX6kzhkbW3d4TwD2CNjMRwxTbREXySekvq37kfCNk,5271890,36020012,-30748122,618
2022-01-24 09:00:09-05:00,10629,6fqbSyhh3PPdgRcLraHb7Jahj9s1oHHeX3SsjNSsGa6t,GpRUow48TYgttdYfsygbgjYQcmHyYjWETUDjDVphEgwq,True,684452883,171113220,1069354,534677,534677,HfEnetJ7uBSmZWCjBNxdvv9HEC5nsW4wDV7wu6WnhWan,42774170,410907028,-368132858,624
2022-01-24 09:00:50-05:00,10630,FS5xx53Bo65G21gJLta7LEEiS132VJM1kGpUzuqyfzoy,2kbTLjdBBA9K1coxKmwmYbjq2heSnuNg4Nh2EfVNYgwj,True,1613421,403354,2494,1247,1247,3zqXX6kzhkbW3d4TwD2CNjMRwxTbREXySekvq37kfCNk,99792,988333,-888541,618
2022-01-24 09:00:50-05:00,10631,GKKRAsYGdcf47eFThG4KwhNv7egeHRuc2wmTh4kqpego,4ippJxgnqCtdtGzCkdZoYwv68fiXNSqQcgrnaHdXZDUa,True,14197615,3549403,22131,11065,11066,3zqXX6kzhkbW3d4TwD2CNjMRwxTbREXySekvq37kfCNk,885273,10565724,-9680451,623
2022-01-24 09:00:51-05:00,10632,4HDEN1Thxm9RbdE8pXnLP4QksVdXfp7Fa9nAnMRzr7oR,8gD3DbF6VhPTCgk3A4G7iA4f3DPH598Hj7TRJ2FebMCq,True,203318,50829,316,158,158,HfEnetJ7uBSmZWCjBNxdvv9HEC5nsW4wDV7wu6WnhWan,12663,234782,-222119,622
2022-01-24 09:00:51-05:00,10633,SCtptafLHdkTiYC3e9sv853xNnusHLpoMPxTc1zUVC8,2HF9ggN6EbkYGz3Ajj7tB8m5YF3Yj77Vy96DMFSz5C7j,True,730844,182711,1141,570,571,3zqXX6kzhkbW3d4TwD2CNjMRwxTbREXySekvq37kfCNk,45675,816231,-770556,624
2022-01-24 09:00:51-05:00,10634,6b7Ro2myM4HcUDqyyW9NEqTWPz8BWpH4eNFSQQci37So,7r7j7rSsa6YZcTuRPfs3KP44MVqUA4Q5NeJGmx84wbHq,True,66234,16558,103,51,52,3zqXX6kzhkbW3d4TwD2CNjMRwxTbREXySekvq37kfCNk,4125,81640,-77515,622
2022-01-24 09:00:51-05:00,10635,9hB3EPuj4SrSrpAzHvExDb6mzh2vNGGVbj7qqfRjeao4,9725jRXGPRUuo1dijvv8mwzvSu1ed4y5hi9FAQNwb8dG,True,2675038,668759,4168,2084,2084,3zqXX6kzhkbW3d4TwD2CNjMRwxTbREXySekvq37kfCNk,166723,3192882,-3026159,623
2022-01-24 09:01:00-05:00,10636,HRN438yBJSX72GV4E3JYLKpwQcnZXgAoB2VkmgXzEKDE,4jEn7ssEM8ZUjAyaKogEb3uyMmbZJ1a7WGCPNgh1Xfty,True,141796,35449,221,110,111,3zqXX6kzhkbW3d4TwD2CNjMRwxTbREXySekvq37kfCNk,8851,147376,-138525,624
2022-01-24 09:01:00-05:00,10637,6kscNwPWgKoW7MHRkB4ajxWF3DXLmXjmx9KjDnzikhfs,D49nf79UmrALDKnAa5kf94nZUffzJW7anLm4hVrFG2b4,True,4513643,1128410,7045,3522,3523,3zqXX6kzhkbW3d4TwD2CNjMRwxTbREXySekvq37kfCNk,281821,5059019,-4777198,624
2022-01-24 09:01:00-05:00,10638,FkZhhccPu4gveq1JHW6euEKoS7SC2VBgVPy1B99x9tim,2f5UVLjutRnnVyCD64tPo5XCwhzAEoXU6YCmgNRH6uyk,True,10905,2726,16,8,8,3zqXX6kzhkbW3d4TwD2CNjMRwxTbREXySekvq37kfCNk,675,12797,-12122,618
2022-01-24 09:01:00-05:00,10639,4ULhASByyNafHdp8HFAu8F7JWU8vZY73gmk11wWGpBH7,5GWVtW86nA33hveEygKzjCqeMkRNb8J6RsGrbzVad8nJ,True,89086030,22271507,130440,65220,65220,3zqXX6kzhkbW3d4TwD2CNjMRwxTbREXySekvq37kfCNk,5217608,55248432,-50030824,585
2022-01-24 09:01:00-05:00,10640,8kJu5aqVSmW8FSZR9h6F75ftn9V2U9uMLBEKeqRaC855,FhVHByujkvwwtjTVpZ4mqSUqoMoBgeLUc5H7rbz3FgAt,True,639469,159867,965,482,483,3zqXX6kzhkbW3d4TwD2CNjMRwxTbREXySekvq37kfCNk,38629,703792,-665163,604
2022-01-24 09:01:00-05:00,10641,8eTH6eJyyVeMno3UQkffeBg32xofKsQfkhLhXdtaf87s,BCFC7CPXrQPsUfJb2eYSht8GhaApWHpc49AeCXqaYq13,True,1619018,404754,2444,1222,1222,3zqXX6kzhkbW3d4TwD2CNjMRwxTbREXySekvq37kfCNk,97767,930195,-832428,603
2022-01-24 09:01:00-05:00,10642,A4tDE948CPFPh1UwHb8sXryfKktbxZ8BCkqXgA5DJHA8,3zXeKMrsEpCe5fQumLNzCgpxcG1kLJFEAtJuqxLsC6ZG,True,626852,156713,945,472,473,3zqXX6kzhkbW3d4TwD2CNjMRwxTbREXySekvq37kfCNk,37815,575700,-537885,603
2022-01-24 09:01:00-05:00,10643,FsMiJiJZibohKoV5QRisWCjzuFd86xSxFb4m73AQmu93,7p3TSKBaG9SV2YNDnhutQKacPKpTTmgsEfzmK51t6sYb,True,1511066,377766,2336,1168,1168,3zqXX6kzhkbW3d4TwD2CNjMRwxTbREXySekvq37kfCNk,93469,1169274,-1075805,618
2022-01-24 09:01:01-05:00,10644,FgQrRo4eGQAonSsFfQgnp8trGGqGZCLeGX6yvJnMnTjd,8KhemHLBY6nGmo3xMDedW2wnCSxQq6LwbTExif4sUSxx,True,9927038,2481759,14207,7103,7104,3zqXX6kzhkbW3d4TwD2CNjMRwxTbREXySekvq37kfCNk,568289,4831738,-4263449,572
2022-01-24 09:01:01-05:00,10645,B2hN3Lt5pFbUyfEUc5s48hkxUJ5rr2SeFxgdGdQ8pDD2,7bZJCCud253j9g411HQUDXUAADcwd5yJWznoTChBdB2H,True,43981102,10995275,67078,33539,33539,3zqXX6kzhkbW3d4TwD2CNjMRwxTbREXySekvq37kfCNk,2683148,21531291,-18848143,610
2022-01-24 09:01:01-05:00,10646,HoJ3Re4BmCYKMJx2RUYtoHfg8ncEy3iFqvWJDGKqfMBV,2qg4FMcurNDVRzXYKwpzEYapxFECnAyU2oGmxQCSf3hf,True,129553,32388,201,100,101,3zqXX6kzhkbW3d4TwD2CNjMRwxTbREXySekvq37kfCNk,8077,160838,-152761,623
2022-01-24 09:01:01-05:00,10647,72L76qDRMK3M7X52zuuB9GVyvFFLDBZwFMpVjWjghXzA,4m2ZVuemUctu1edv4YJVAcjXzKwpbCmBujzoUmLDeA7h,True,2564513,641128,3984,1992,1992,3zqXX6kzhkbW3d4TwD2CNjMRwxTbREXySekvq37kfCNk,159382,1480006,-1320624,621
2022-01-24 09:01:01-05:00,10648,Dcitj55ABpkgXvpnPCssy8GgKF46xd1GLaRMyPWoW6G8,62znTXs74bywWfcXptJkvwYuuTxgen8bhYaCnG8Z7y2B,True,181058656,45264664,261038,130519,130519,3zqXX6kzhkbW3d4TwD2CNjMRwxTbREXySekvq37kfCNk,10441558,107668828,-97227270,576
2022-01-24 09:01:01-05:00,10649,9WJBnVi84E926j7xEd566WzrZJkPJWRgmEnYj9vyjuad,4dLaFS5F7TGyLdwuJLMGkz3bSL53aHzd9ZfpNmhHxXeF,True,111007,27751,159,79,80,3zqXX6kzhkbW3d4TwD2CNjMRwxTbREXySekvq37kfCNk,6373,111792,-105419,574
2022-01-24 09:01:01-05:00,10650,3VdSA9CED9f5swRwHX2U15U7J6Muaq8VPnCNy9CaGDHe,2YYstfnfdYic5NWmEbcUEHpccNUVd1EhuCkExvMsoMk8,True,36297,9074,56,28,28,3zqXX6kzhkbW3d4TwD2CNjMRwxTbREXySekvq37kfCNk,2254,39993,-37739,620
2022-01-24 09:01:01-05:00,10651,CxLFMBDFkoMvpK9YUf7WtCq6hn7k3QACAuetAnGjU6KA,2gE52a1GWQnS6ifV6eVtKQyr13LXP5Jdt3yG9SjGPJPF,True,8781072,2195268,12551,6275,6276,3zqXX6kzhkbW3d4TwD2CNjMRwxTbREXySekvq37kfCNk,502070,5085012,-4582942,571
2022-01-24 09:01:01-05:00,10652,BgN75npBkPws5uiFE9RAujmPuZyAv2MQUPmfmJ1YCCij,78UFLNDn782TY2P4F5kRkMRC2s3gw8ak7sRQZRWNq82D,True,1737300,434325,2610,1305,1305,3zqXX6kzhkbW3d4TwD2CNjMRwxTbREXySekvq37kfCNk,104404,900665,-796261,600
2022-01-24 09:01:01-05:00,10653,FnAT8HKGgisYfeAbxKU2gSbCp8KbZHULRpaJX1NVijHy,2u637Crc2QzfSJmCnRNqeib3aZQVn4NGncpgM3Ph6jvm,True,248138,62034,382,191,191,3zqXX6kzhkbW3d4TwD2CNjMRwxTbREXySekvq37kfCNk,15289,192092,-176803,616
2022-01-24 09:01:01-05:00,10654,4uygLJDk9DFCifJ56YwMrEsvd3oQNq8tYSLnMCyWorS6,GimL4uKGvg3FFmFQSWzAcjstv3Vmk5NMgDGMKTuXYVpB,True,3753165,938291,5677,2838,2839,3zqXX6kzhkbW3d4TwD2CNjMRwxTbREXySekvq37kfCNk,227084,3303356,-3076272,605
2022-01-24 09:01:02-05:00,10655,D9VKhnfLLCrntDGFYSfoxFaY76VnHmYZ1ZbyFXdKdibz,2hRCRH2pMDyQGYcXHa8Y6BZo6FbcGZf5VJC1v8Bp6tGa,True,665400,166350,1013,506,507,3zqXX6kzhkbW3d4TwD2CNjMRwxTbREXySekvq37kfCNk,40550,555906,-515356,609
2022-01-24 09:01:02-05:00,10656,CpxZ136k95cVjGqkJnNpDZKUgrJrfg8HrFDZPL6BgsK4,Fo7HtcrneUTsnGqygsxPQ63G5rayYodYT65xP6B6HusH,True,11269314,2817328,17329,8664,8665,3zqXX6kzhkbW3d4TwD2CNjMRwxTbREXySekvq37kfCNk,693190,5345329,-4652139,615
2022-01-24 09:01:02-05:00,10657,H3394S5wdbwXB4scjGAY8NsXxCdGy1Xebct18s42FM1K,Hz84L1EquzhCvBJP75ScKug46hYGdNMVNH16AdG4y5D8,True,340000,85000,526,263,263,3zqXX6kzhkbW3d4TwD2CNjMRwxTbREXySekvq37kfCNk,21049,290557,-269508,619
2022-01-24 09:01:02-05:00,10658,6mCEvqP1YwHZNUT9orECs4tE3YzfD2Hfa5FTt9TLo8DH,ApWyeUDzPp6TBczuStvXxEAivhVVJrqC1rodNTNKNFR3,True,2322018,580504,3221,1610,1611,HfEnetJ7uBSmZWCjBNxdvv9HEC5nsW4wDV7wu6WnhWan,128850,1521776,-1392926,554
2022-01-24 09:01:05-05:00,10659,6VBYUiLyQXvvsDmq1vh1oJ5VeA89tGgxtkgFfofc372m,35pyoeRA4duKX7njdYny3KffM2xaxuWUZGRUMQJ5iAiu,True,18237988,4559497,28534,14267,14267,3zqXX6kzhkbW3d4TwD2CNjMRwxTbREXySekvq37kfCNk,1141370,19739465,-18598095,625
2022-01-24 09:01:07-05:00,10660,33CE2t84MhG7SMsphhZaxvwFVRbK5wcUMUdEw8UBhoq8,DjNko7SbbK9nQT4K5oBWKiSiXiYS9Rv1k5vT3PNiMyaf,True,576942,144235,899,449,450,3zqXX6kzhkbW3d4TwD2CNjMRwxTbREXySekvq37kfCNk,35960,459484,-423524,623
2022-01-24 09:01:07-05:00,10661,7FB6X8YgiDn7YK9bZZmcFyzhuvVLVWPCfBbenwMXhx5,2EaDCpL9MpAKuiC2bvUCGRfvqYvgVXGFHXt35QdNakfG,True,578632,144658,899,449,450,3zqXX6kzhkbW3d4TwD2CNjMRwxTbREXySekvq37kfCNk,35990,248930,-212940,621
2022-01-24 09:02:05-05:00,10662,CcfycMNGUqZLA6EEqtDdftSbQhTL11SYn3LxQqJ23Xgh,Ce7NW9CpB9qGYLf8XUDW49ERutoxtjZSjs54xrzF1fYN,True,256128,64032,400,200,200,3zqXX6kzhkbW3d4TwD2CNjMRwxTbREXySekvq37kfCNk,16029,295467,-279438,625
2022-01-24 09:06:16-05:00,10663,8trFFwvXKKMwMx952ugCZmqyw29e1HxEKBuQmFn8ZwTf,FsD7gCvHXM3QchQiDcd292ksy5afZMWApneNTat5ndeS,True,10248104,2562026,15880,7940,7940,3zqXX6kzhkbW3d4TwD2CNjMRwxTbREXySekvq37kfCNk,635207,4567710,-3932503,619
2022-01-24 09:08:00-05:00,10664,9otCHuzKcxUCC4EgPJkio8Df5gXWB6DtZQnZvWtPfsh6,8cNPdP8rA9sBpcKpmCNcp4W2AYonYdFNoyVmboT6y1Bb,True,47531489,11882872,73706,36853,36853,HfEnetJ7uBSmZWCjBNxdvv9HEC5nsW4wDV7wu6WnhWan,2948250,23051813,-20103563,620
2022-01-24 09:08:00-05:00,10665,cG5VSSaBpjNdRLMQT7dmotpcWRTfdmJZYdWsrzNzRTE,5RESxV6aZenjAdaqw1jxoYSGttpLrNuZiRJy2WeLAVJv,True,14300365,3575091,22083,11041,11042,HfEnetJ7uBSmZWCjBNxdvv9HEC5nsW4wDV7wu6WnhWan,883333,11047155,-10163822,617
2022-01-24 09:08:00-05:00,10666,4MSyrHopFkuaCEEvLAUV9cJfVre6cLAx5sJF5LEMSCTX,6HhLHoswuDKrcixShWCDcquW6PgmbS5FidEnkM3bwuJQ,True,371763,92940,580,290,290,3zqXX6kzhkbW3d4TwD2CNjMRwxTbREXySekvq37kfCNk,23206,201136,-177930,624
2022-01-24 09:08:01-05:00,10667,AUH6YGBV8tDVX1E1WTo92Mubfx1DGsqfGeyUBqxo4fSr,33QZgMwmW32WuvmxD8XNbmF9ea88bLe3YTtNwHV73Wwu,True,1510287,377571,2357,1178,1179,3zqXX6kzhkbW3d4TwD2CNjMRwxTbREXySekvq37kfCNk,94288,1188662,-1094374,624
2022-01-24 09:08:01-05:00,10668,CK1SjmBjrW7m1QVZbVZsVZgwEcxw8BTkckkzrZDrDdxW,M6vnBg1TPRhLu7sghkxtf5TkSLw5JhgoDmbGoyEYgR9,True,301767,75441,469,234,235,3zqXX6kzhkbW3d4TwD2CNjMRwxTbREXySekvq37kfCNk,18767,347081,-328314,621
2022-01-24 09:08:12-05:00,10669,8jyD7TX1Ht3jVpTtSsec2YM7PAFq9kgop6xoRTFLEFUA,A4YQqSqtcz1MLrr5qQAGyNC564GbVJ1P3nD8hFz8XXMa,True,3763513,940878,5882,2941,2941,HfEnetJ7uBSmZWCjBNxdvv9HEC5nsW4wDV7wu6WnhWan,235288,4570956,-4335668,625
2022-01-24 09:08:23-05:00,10670,BWJeoypk8ctbsFZ5jqc5ajV9qutjCknk4hRxEQobHwVi,GEAiFZAhBe1DnjXCDttq1oqVAUZ2uwRx7E5bhwRZtGJX,True,4747503,1186875,7366,3683,3683,HfEnetJ7uBSmZWCjBNxdvv9HEC5nsW4wDV7wu6WnhWan,294645,3703042,-3408397,620
2022-01-24 09:08:23-05:00,10671,EitU96ThqHErybDn2j1NY6JHkqV1R3mWM1uWH7wYKr1T,2p9eYbLyBqXrhHtRKp1jJb7VGjCmb4LkA6kzqLr1ijet,True,842895,210723,1317,658,659,HfEnetJ7uBSmZWCjBNxdvv9HEC5nsW4wDV7wu6WnhWan,52682,623514,-570832,625
2022-01-24 09:08:23-05:00,10672,4Eh2J8pz6nSz2E2BaPSMbDNhEovGA4QRmNtzAJPw9ZRi,CrHeEQC5KpQFLGhz2EpLYWgk7kWsqLPvEfLsSQvUxv61,True,5095266,1273816,7880,3940,3940,3zqXX6kzhkbW3d4TwD2CNjMRwxTbREXySekvq37kfCNk,315208,4118917,-3803709,618
2022-01-24 09:08:26-05:00,10673,HSF97F9d5EPgx4kGYuG4AfwHnh6bovzyTneYUouszBQp,Bh8fR6QoGS1ykk27256kFb2gjCVbQtu8Nu4Ls7GEKSAs,True,3227208623,806802155,5011468,2505734,2505734,HfEnetJ7uBSmZWCjBNxdvv9HEC5nsW4wDV7wu6WnhWan,200458732,2598411841,-2397953109,621
2022-01-24 09:08:29-05:00,10674,3gdApRPkUGEqmLvTYf4WQJCnmTVmiEU2wCQG26QMpqKf,HpP2yxq3KfYByT4q4p2mLaELnPdW6kmEY9EqZaBZuUNR,True,179677,44919,276,138,138,3zqXX6kzhkbW3d4TwD2CNjMRwxTbREXySekvq37kfCNk,11074,206777,-195703,616
2022-01-24 09:08:29-05:00,10675,HUe9LgGBjMeNxGyeCtmXr2XbWVFhHXrvgc2XSqCwN11D,7Z1nR9GgezBXsDX5wW3BBarfMRMZV28rX6MeLRuWtycG,True,2743668,685917,4240,2120,2120,3zqXX6kzhkbW3d4TwD2CNjMRwxTbREXySekvq37kfCNk,169630,3056763,-2887133,618
2022-01-24 09:08:30-05:00,10676,A36aouot1oFLUtswuBUM4EVcis9chKaSJu53MRoPDjab,33U9gpq1RRFMGWDrWa3ezXXkwgBewdAS6QGgGVPtGvqb,True,1945264,486316,3039,1519,1520,3zqXX6kzhkbW3d4TwD2CNjMRwxTbREXySekvq37kfCNk,121575,1506779,-1385204,624
2022-01-24 09:08:30-05:00,10677,AWvHDdb2ikqV8wc7qQ8azbvNTZdixMNxhQjhQdhayYtR,9EpgEPBb1nog6aQeFdMXfSRiLSnzGQFQ39mbLdCxgYTv,True,249205,62301,389,194,195,HfEnetJ7uBSmZWCjBNxdvv9HEC5nsW4wDV7wu6WnhWan,15593,186862,-171269,625
2022-01-24 09:08:31-05:00,10678,DakevNrDK5fAUGkLdrWHrsLZm8hEZBqkzUiwJouaDPPY,73nFhK7cygPgwKveXrdXcQVte8n1z3iBe4nmUVTGfFmv,True,10661534,2665383,16439,8219,8220,3zqXX6kzhkbW3d4TwD2CNjMRwxTbREXySekvq37kfCNk,657584,8765091,-8107507,616
2022-01-24 09:08:31-05:00,10679,2jDRvE3pQNjWy1NRFa4tzB3KmU5UkbUCHw8sQRFujo66,C4zNi2szDrEEh4coTF3WRUghfP4ZwAVVSYTLWfkejQRu,True,1382091,345522,2158,1079,1079,3zqXX6kzhkbW3d4TwD2CNjMRwxTbREXySekvq37kfCNk,86337,1272040,-1185703,624
2022-01-24 09:08:33-05:00,10680,2YPm4Ex9mNHX4CuNAUjkrXgoLFaZs6r1X6asYYUnvPyj,BatsG1UFq8ryYuFFcdnDyFWFPUV5P6w2VQpRup5oUey5,True,186617,46654,291,145,146,3zqXX6kzhkbW3d4TwD2CNjMRwxTbREXySekvq37kfCNk,11649,215777,-204128,624
2022-01-24 09:08:33-05:00,10681,GqFbV89UYbQ6aEW1bSvGnnsDtTPQfHPTHzisXPhLnaTC,6X7j3nqmugRyVVw83uSzgiPaemEscc8VdsnPEKDz4fg2,True,126139,31534,197,98,99,3zqXX6kzhkbW3d4TwD2CNjMRwxTbREXySekvq37kfCNk,7882,151022,-143140,624
2022-01-24 09:08:34-05:00,10682,DWMxC7PyBcue9RaoZLEEM233PyHeGqMAWqapnw8qM4N2,AVW5hLdQEQut1DqYzKXP8hBQFBx1Df697xkFSu4JR1U7,True,343900,85975,537,268,269,HfEnetJ7uBSmZWCjBNxdvv9HEC5nsW4wDV7wu6WnhWan,21509,102552,-81043,625
2022-01-24 09:08:37-05:00,10683,zLTuMVfVswjMkhyvjaXnvjcKXv5xNk3iSWSjRGpVqXf,J3D8NHUJCiSjvFYfJ5Es4YDhF1KcPZWRUmCQ5L92t8eB,True,2299251,574812,3565,1782,1783,3zqXX6kzhkbW3d4TwD2CNjMRwxTbREXySekvq37kfCNk,142619,1014717,-872098,620
2022-01-24 09:08:37-05:00,10684,EgpRPHPAC2cPBiar3SUD5PGZnzbCXBzUpa4KVTF5q9XY,2zf7NkfWagBWWts9RgacdRgkSzgJaChpFW5mMZczXa18,True,136682398,34170599,213393,106696,106697,3zqXX6kzhkbW3d4TwD2CNjMRwxTbREXySekvq37kfCNk,8535725,151090031,-142554306,624
2022-01-24 09:08:54-05:00,10685,BZn1DDE568UHeL2Qniv9EDT1yAAWvPJcTtSw4K4GQx44,CCaroU4YwKvYgibMsRPdEBxeDbzcNC4s5ZthxrhywSm5,True,311067,77766,486,243,243,HfEnetJ7uBSmZWCjBNxdvv9HEC5nsW4wDV7wu6WnhWan,19466,356487,-337021,625
2022-01-24 09:09:01-05:00,10686,BmLG3dPSnL9hL2okZcNVsHgzuWYCrWLdXW8z5Jd2gyvF,HXwhov5Re9b8D4XHULcVSdgBNfbtZ7KMhMRqSTcQTbno,True,404017,101004,632,316,316,3zqXX6kzhkbW3d4TwD2CNjMRwxTbREXySekvq37kfCNk,25288,486165,-460877,625
2022-01-24 09:09:05-05:00,10687,HdRgh9niYSd3YKCxzGdusYFquiVoFTP2mEGEzJJL5Nii,78C68Gbb1jYFQmYNCHHjL52keEKMXtGukmBwT7ahon4B,True,23517210,5879301,36670,18335,18335,3zqXX6kzhkbW3d4TwD2CNjMRwxTbREXySekvq37kfCNk,1466837,23417367,-21950530,623
2022-01-24 09:09:07-05:00,10688,APbpwRCB9tfma8yoi8upe633XZBtNwc5zVxXVjLwhg8s,BBwryuZZ8msiSFNmGkh13Wgg1PoSutY2Ftgz8odcxPm4,True,1424830,356207,2210,1105,1105,3zqXX6kzhkbW3d4TwD2CNjMRwxTbREXySekvq37kfCNk,88411,1591598,-1503187,620
2022-01-24 09:09:07-05:00,10689,9cRx2sGeqENLrNkvzLSnuD161JshSav6pNg9c7pYLi8f,13ryjUoWLejTLDQKh1m69VFD31onMx8yhzCKhqbeU6s6,True,722436,180609,1118,559,559,3zqXX6kzhkbW3d4TwD2CNjMRwxTbREXySekvq37kfCNk,44757,842639,-797882,619
2022-01-24 09:09:10-05:00,10690,75NA5QiXEHG4caSB9BpafGZPA9eT9S6MhKTFM6eHjz8H,FmoxAVw2zdG6qbyaXKy6gsvi1XY8ZVbSgUNbjsp9EpVd,True,318370,79592,497,248,249,3zqXX6kzhkbW3d4TwD2CNjMRwxTbREXySekvq37kfCNk,19880,351977,-332097,624
2022-01-24 09:09:26-05:00,10691,AgokoeqypXXfMsjAyBXPRrJFGeP7B7D6SXvnGUTwMdap,53zBz3fTZisWQH1v6NHyhCdpLXx5NaPNp7uW9KPXLDan,True,8072475,2018118,12461,6230,6231,3zqXX6kzhkbW3d4TwD2CNjMRwxTbREXySekvq37kfCNk,498458,5079430,-4580972,617
2022-01-24 09:09:40-05:00,10692,57Vsw8jXaaoLriYEkvPAVyq66r4a4zMfLWbDaTBMjFzC,7AVDWUTHa6729UkXgCXASphSmrLvXYGAA9ygTMSqvwvY,True,152411,38102,236,118,118,3zqXX6kzhkbW3d4TwD2CNjMRwxTbREXySekvq37kfCNk,9450,181926,-172476,620
2022-01-24 09:09:40-05:00,10693,51VhgthsxrRRr2PT5gLnDfL1A3soqwCxA1UzH9vRUGTh,4QCcd7hfsydQ63LH7Lqsp8oVXw7HuKamzQf8VMH6Lgu2,True,239097,59774,372,186,186,HfEnetJ7uBSmZWCjBNxdvv9HEC5nsW4wDV7wu6WnhWan,14885,275453,-260568,622
2022-01-24 09:09:41-05:00,10694,JDg1bbHkYeznDUtSBLhagRJ45aSzeSF5V8iDRJCay9wL,8n7ic28zq5PjJtRcM7Fcy5vLW2YVXw4EWMK6UAt2zh3V,True,3476259,869064,5431,2715,2716,3zqXX6kzhkbW3d4TwD2CNjMRwxTbREXySekvq37kfCNk,217270,4004752,-3787482,625
2022-01-24 09:09:41-05:00,10695,CxePQ6ZEn2NCLYgGegSeFX1PyBuczP9j5v131VQSPh1c,9gPk7qTRb5JHqBXRKp3uZfhA2VjQAJDQHTzYXGLUdAUC,True,277979,69494,433,216,217,3zqXX6kzhkbW3d4TwD2CNjMRwxTbREXySekvq37kfCNk,17350,320523,-303173,624
2022-01-24 09:09:46-05:00,10696,yWK6vFZq58uYYiHscQTPSBqTDrWEW1SVbqe8NszoTEN,6H1zT5ifGaMKjdvZmptuDYf4Vou7tntdZQPVzQ4hWyjg,True,3782610,945652,5919,2959,2960,3zqXX6kzhkbW3d4TwD2CNjMRwxTbREXySekvq37kfCNk,236774,2682532,-2445758,625
2022-01-24 09:10:10-05:00,10697,46TNhGwBVzedW8xSb9UY94HNeSom9iGiZzAjrKHiRM2G,7JVTiqNYeKHbyzRkKtvSEpqLPKykZso8cGUr3sX1j7QF,True,1032231,258057,1613,806,807,3zqXX6kzhkbW3d4TwD2CNjMRwxTbREXySekvq37kfCNk,64546,770176,-705630,625
2022-01-24 09:10:20-05:00,10698,8xvLGVeDmhVYQhN2ZpWkVG9jCrukRsNQ4926a4TMiZqa,9ciBySSjvADwp47WkETiFWZKVTFL8Hf1XvK7aSxhcgQS,True,134060,33515,209,104,105,HfEnetJ7uBSmZWCjBNxdvv9HEC5nsW4wDV7wu6WnhWan,8363,120644,-112281,623
2022-01-24 09:11:09-05:00,10699,3EgUBHBeKWegibDcCsTGaGehnwHYvpMbcPaT1UTbwQ49,Hxd4dsnLD8uHnG7KR7GVmKXBcpN1egMUvoTccPvBcaYA,True,5097120,1274280,7912,3956,3956,3zqXX6kzhkbW3d4TwD2CNjMRwxTbREXySekvq37kfCNk,316492,6073618,-5757126,620
2022-01-24 09:11:09-05:00,10700,Fs8MQLaMyr1Q96HsZivKLY7Kjdeu2ZoB2n3VTZ15KbSn,DREfCs5CTVNUUF8H3hD8CWvtxztiYxoLYh8HUWDecMyZ,True,4816653,1204163,7481,3740,3741,HfEnetJ7uBSmZWCjBNxdvv9HEC5nsW4wDV7wu6WnhWan,299275,5746007,-5446732,621
2022-01-24 09:11:09-05:00,10701,7A1v7bFDJwxM7XomePFyRh58SMHxrNSkM3fJygd8pQUN,DL9jCFHaM8BXJ5KE1YJHXNCbXgSdRgt18MHhAgC6TNmg,True,372125,93031,581,290,291,HfEnetJ7uBSmZWCjBNxdvv9HEC5nsW4wDV7wu6WnhWan,23248,412356,-389108,624
2022-01-24 09:11:10-05:00,10702,6kZoofhL5S3U8aQU2VW2TDRZdiBYo1e1o8AUSbSttsAy,4zUpycP3EDmXrC1qjmnHuymGVoBjXQT6yAkvKGW9Gext,True,134996720,33749180,209847,104923,104924,3zqXX6kzhkbW3d4TwD2CNjMRwxTbREXySekvq37kfCNk,8393907,42047134,-33653227,621
2022-01-24 09:11:10-05:00,10703,Gk4mpwDEggypoPjyrZcFDbHT8WBwspC5AbQ5uDgaQufL,GTDi3mKTcw1NfwbYx8s8YCkzqbaJUM8YUwYifNr9sjgH,True,27778118,6944529,43042,21521,21521,3zqXX6kzhkbW3d4TwD2CNjMRwxTbREXySekvq37kfCNk,1721709,21325433,-19603724,619
2022-01-24 09:11:10-05:00,10704,52hhBAuVyifMNFKGQmSitc8smiEgscXQMzVuZj55j7E5,6B5DBJx9NLytR3fkrYqe5W5ek4rUWsR4nPsRTvRfRwzC,True,5130282,1282570,7969,3984,3985,3zqXX6kzhkbW3d4TwD2CNjMRwxTbREXySekvq37kfCNk,318779,6118199,-5799420,621
2022-01-24 09:11:10-05:00,10705,9XHC2Ycm9f56cDYxRPVKYiYWGKA4y7Utpv3e9gpMsZq3,HpqAdpkzWqoJUNqmHEnn4PZwSB6C6jt8FJZQtZtFqXWA,True,1370205,342551,2128,1064,1064,3zqXX6kzhkbW3d4TwD2CNjMRwxTbREXySekvq37kfCNk,85156,1530352,-1445196,621
2022-01-24 09:11:29-05:00,10706,7EtGovzHsbD8cKGqq4R5rvKBbncR4Kc7CDkTjof2QBMf,8ShjeNWM2vcvUF9yYztYCHUQfcGsyg2A1LyWiPbQDDvq,True,29739,7434,46,23,23,3zqXX6kzhkbW3d4TwD2CNjMRwxTbREXySekvq37kfCNk,1844,35458,-33614,620
2022-01-24 09:11:30-05:00,10707,HfwGSiwGiyDFaTS2usYRp82zSmPPQqZukbw2d1BuFs5w,ArtgZbmA33k8Y3EfR6oMJiqT72MUrVBQqifPBdcnrzea,True,92070,23017,143,71,72,3zqXX6kzhkbW3d4TwD2CNjMRwxTbREXySekvq37kfCNk,5731,68775,-63044,622
2022-01-24 09:11:30-05:00,10708,68qWTKE41JPQMbF7zwqoELSVn2XbjcUMA4UTfER4fcz6,HrDYnhxX1Gm72Kq9H9k44xUfxqELLkC2yoEkkR3LEEHM,True,94127971,23531992,146129,73064,73065,3zqXX6kzhkbW3d4TwD2CNjMRwxTbREXySekvq37kfCNk,5845192,66033866,-60188674,620
2022-01-24 09:11:30-05:00,10709,3PPCwAjj8GNphb3cRs7kP1QVghEUX6gWUH3M4JarQsTD,28UR4WKAziiJmPwas5E5JrY3WaUrR2NkYYXCKuxPHTMR,True,41148544,10287136,64120,32060,32060,HfEnetJ7uBSmZWCjBNxdvv9HEC5nsW4wDV7wu6WnhWan,2564834,45881815,-43316981,623
2022-01-24 09:11:30-05:00,10710,8d4LtUwpkNSKRUdFbxhbeeaVc8hABhwjUExt3QgEVQbz,BieULGWXC1yEtuK9y27SMo9ApNDo6jLjxs5egr1Ebsda,True,763442,190860,1186,593,593,HfEnetJ7uBSmZWCjBNxdvv9HEC5nsW4wDV7wu6WnhWan,47468,935505,-888037,621
2022-01-24 09:11:34-05:00,10711,8T4WK27RvWVGqPuNqY6whk1fmU4vd5qaUQPZG1GJ79bh,DvSz7knS8N3K7L6JhQf1s4mJSyxB8uJXNQXtyjJn8QRL,True,665140,166284,1036,518,518,3zqXX6kzhkbW3d4TwD2CNjMRwxTbREXySekvq37kfCNk,41470,622811,-581341,623
2022-01-24 09:11:34-05:00,10712,6VJcr3VAEcEZaHEpt48QL8QxHKABufVp8n2JSEVTLh9U,8naR6kiySKj3vai9dCetdgCnCHgf2oyLjGqKTJ3Lz64Y,True,17459230,4364807,27229,13614,13615,3zqXX6kzhkbW3d4TwD2CNjMRwxTbREXySekvq37kfCNk,1089198,16083760,-14994562,623
2022-01-24 09:11:34-05:00,10713,GYgxUfZ19oSyHuovGRA6gBJT32goSxCrKR8hQQdBsrRG,2r8c6SU74hRq7xEmYBJ92WoSB6v6XCAXR3JcDznfCxkN,True,155993446,38998361,244100,122050,122050,3zqXX6kzhkbW3d4TwD2CNjMRwxTbREXySekvq37kfCNk,9764000,138538130,-128774130,625
2022-01-24 09:11:45-05:00,10714,m7gf1jAYXBZjRZEY9w4MjPfhzLwgDKaXyaCVhRD6C5E,Aa2aTZnpPux1i5K2MT4i1TsVM8vR7qR7rZGijQW4zpwd,True,779445573,194861392,1216869,608434,608435,HfEnetJ7uBSmZWCjBNxdvv9HEC5nsW4wDV7wu6WnhWan,48674786,388960922,-340286136,624
2022-01-24 09:11:45-05:00,10715,HpDwBPWZHfLzJUvTTABTA6qddyLLJiVTfqBx5gUktSUb,BqXLpaAeTNfNSeevfdazNqTgqEXj6Edgp8txWvCoxEz6,True,4691709,1172927,7276,3638,3638,3zqXX6kzhkbW3d4TwD2CNjMRwxTbREXySekvq37kfCNk,291078,4890388,-4599310,620
2022-01-24 09:11:51-05:00,10716,HabA6MLjygaKE6i9Sad4c6B8rnyobMYbtFext51rCmHj,516FG8YJxZmnGfvzWiV3TcwSF7UDdwWefjZkmi3R2SPX,True,24018490,6004622,37558,18779,18779,HfEnetJ7uBSmZWCjBNxdvv9HEC5nsW4wDV7wu6WnhWan,1502359,16227436,-14725077,625
2022-01-24 09:11:51-05:00,10717,6uZobpBuFcQeYgZ4dApFi6iy4DB9GLHP1AAsQcCj6212,SGGFiPjjhscwroiWMqY4jTAHFw8eakpsEv35wNoHUPY,True,2836305,709076,4424,2212,2212,3zqXX6kzhkbW3d4TwD2CNjMRwxTbREXySekvq37kfCNk,176975,1308477,-1131502,623
2022-01-24 09:11:57-05:00,10718,FuoFPNTdYVDkSHaBac6UC1aNJXafSNTvFJuBCdrgQQrH,ApBS1Fx83tcECMzDV6wEzEzEdg4e2hgj3djtjRUoSKK5,True,15878964,3969740,24768,12384,12384,3zqXX6kzhkbW3d4TwD2CNjMRwxTbREXySekvq37kfCNk,990732,12547550,-11556818,623
2022-01-24 09:11:57-05:00,10719,9gY3X17t7jarkWhnSEHPR51U9nVv8Dv99NqpCi3ewuPf,4Z6TdTW1d4JFRZqZyWA9X7upKhJwVPSfTQjFp14M59uv,True,20264817,5066203,31707,15853,15854,3zqXX6kzhkbW3d4TwD2CNjMRwxTbREXySekvq37kfCNk,1268299,23718503,-22450204,625
2022-01-24 09:12:08-05:00,10720,8WHDaiE6LqFFmCVMnPeLEQ99R6ft8b74UfmP9BqzjcE8,CGmoDGsdnjo3zMNrW78n2xxQr1aDPAiBYiXbyciLXYMu,True,15865020,3966254,24715,12357,12358,HfEnetJ7uBSmZWCjBNxdvv9HEC5nsW4wDV7wu6WnhWan,988628,10950386,-9961758,623
2022-01-24 09:12:09-05:00,10721,H1Z83zVoskNuBvYao1FjdLfETfhPpQFQUkniJfGxbaNz,EVqbBRV6Zy1tPLRevxpAykp8Mvv6tDZVTc4RmCKw4Gq1,True,19754493,4938623,30836,15418,15418,3zqXX6kzhkbW3d4TwD2CNjMRwxTbREXySekvq37kfCNk,1233440,16519227,-15285787,624
2022-01-24 09:12:38-05:00,10722,8HWpccoTmPZ9MsrxtvQ5BV5y8a8WBAB1Sxx2WAiYKRLH,9chtr2Nqg77CCCnjC5JqENmUBNxpDHVH6BG3wojn9gHQ,True,171450,42862,265,132,133,3zqXX6kzhkbW3d4TwD2CNjMRwxTbREXySekvq37kfCNk,10623,207557,-196934,619
2022-01-24 09:12:38-05:00,10723,FwTGq3BeMLyRFRa5r4E6nySLgoLNcNdqJsCQxA2i6uh6,88w6ti3WSriyu2FvNjVfrLpGyU5PUvaiJyqrAGPM8TKp,True,147521,36880,228,114,114,3zqXX6kzhkbW3d4TwD2CNjMRwxTbREXySekvq37kfCNk,9146,176229,-167083,619
2022-01-24 09:13:16-05:00,10724,3FF2rhr1RuT7UR7MmmGtrhfYbh6kbc5UXq51KmqFLZnq,AEmSYLt1dQ8suLugC4Lcw4kF3dG9GYcEfX54hEAKfmv5,True,568964,142241,889,444,445,3zqXX6kzhkbW3d4TwD2CNjMRwxTbREXySekvq37kfCNk,35596,357357,-321761,625
2022-01-24 09:20:43-05:00,10725,5gcF5a6vf5iHAnhKHhcfceXicrefXZ9L7PzqjjrzRm48,5VE1AGgChUAW2iR4iKiznUCqtu87q8R2cdWeSuFYXjYo,True,19113936,4778484,29772,14886,14886,HfEnetJ7uBSmZWCjBNxdvv9HEC5nsW4wDV7wu6WnhWan,1190908,8712387,-7521479,623
2022-01-24 09:21:18-05:00,10726,2mfcg17QocKKvDcqDH88TwxHRiS8dAQiJAGoAh1brns9,8aQLELBgaA9eXsxSciMjxWv8B1hpbUPfLwqVjEnasZbe,True,5606851,1401712,8669,4334,4335,HfEnetJ7uBSmZWCjBNxdvv9HEC5nsW4wDV7wu6WnhWan,346762,2757374,-2410612,618
2022-01-24 09:21:18-05:00,10727,GNkEoVMpNAgfyDBZ986MR9BEVc485xpLuZWwSCyZk5zJ,AT2eiaMyZNHZGqgTdie8QjLWCTrWSdkRmQxU2vZNgtDs,True,2016603,504150,3118,1559,1559,3zqXX6kzhkbW3d4TwD2CNjMRwxTbREXySekvq37kfCNk,124751,851504,-726753,618
2022-01-24 09:21:18-05:00,10728,9Ft21UZ66egkMCtZprBPc72WF1aj2fQwLs6XJWPXUbUV,6DGSgHegc23W5MQ6hqSsSSdwNvRqU3piR9GBoZ6fU23f,True,27512561,6878140,43000,21500,21500,HfEnetJ7uBSmZWCjBNxdvv9HEC5nsW4wDV7wu6WnhWan,1720022,13853610,-12133588,625
2022-01-24 09:21:54-05:00,10729,2aK454FrEuA6JQZo2hLUabd4E6wyQtVuJWw2rWz2pGVy,3dJvhEh7kykf8hCCWQRarh2s5ybJUAzbaPdDUmX4XokW,True,41291085,10322771,64356,32178,32178,HfEnetJ7uBSmZWCjBNxdvv9HEC5nsW4wDV7wu6WnhWan,2574258,13832553,-11258295,623
2022-01-24 09:22:41-05:00,10730,8abFwhhZyq3xkvjp4NWDBt7qAPXBbzBxksUk8SAUeVkN,A9u4dhWZbBwthC4WXQg1Dfp3wHYXr67SGs5na1EQ1k3r,True,3444353,861087,5349,2674,2675,3zqXX6kzhkbW3d4TwD2CNjMRwxTbREXySekvq37kfCNk,213960,1345900,-1131940,621
2022-01-24 09:22:41-05:00,10731,GqPZDwm3EWGMiVy7BY6qHM4Vzt2B9vW3Zs1CLScrtjAD,63h2HEdkmc54a8txd4LZ69TUBLR6VphxBoXLx6hjCLg4,True,301601526,75400381,471566,235783,235783,3zqXX6kzhkbW3d4TwD2CNjMRwxTbREXySekvq37kfCNk,18862665,97244943,-78382278,625
2022-01-24 09:24:00-05:00,10732,CLVUzXSNsQnX7n5cvxMuTjyMSjy1pNpPnWejFaeuonvb,BXZzBujr8DAUcGJcHQBaz1ZSwkATAHg3NX3bLnrjQpLh,True,6667898,1666974,10354,5177,5177,HfEnetJ7uBSmZWCjBNxdvv9HEC5nsW4wDV7wu6WnhWan,414172,2259919,-1845747,621
2022-01-24 09:24:00-05:00,10733,CYQr97qwLjGnmEy6vVgs3eL7omwG6UfFbhTv7gBty5z9,DJJ9UqSZUTgyt2yWAkUnGFDuox3xYFQUuorLa7qPdM88,True,9206601,2301650,14183,7091,7092,HfEnetJ7uBSmZWCjBNxdvv9HEC5nsW4wDV7wu6WnhWan,567333,4014465,-3447132,616
2022-01-24 09:24:00-05:00,10734,F6wpqqx576XRuYo8y6XPLYphojrQtK4VvdY79Jk6My5N,38VbNLaQzLFcVqHuSR9zn9UX3Yv9SCVy1mrwmxX9PpVQ,True,24338254,6084563,37578,18789,18789,HfEnetJ7uBSmZWCjBNxdvv9HEC5nsW4wDV7wu6WnhWan,1503121,7324096,-5820975,617
2022-01-24 09:24:02-05:00,10735,H3x9b27yHVdCxvtDf7mmJxkNeubcmQMwfAkLTYADPWNv,HGVCCz23rWx78vrTB2wvm2aesbLZuYFhhNuznGiSSAyA,True,114519903,28629975,177978,88989,88989,HfEnetJ7uBSmZWCjBNxdvv9HEC5nsW4wDV7wu6WnhWan,7119138,51062457,-43943319,621
2022-01-24 09:25:10-05:00,10736,FKQ26ZKSqbYwjUvaddC3h1b5envEXnUvHYinpB1pdqRd,RsEv5qrmgppBATzCDLgh2W91m6hi1bBaUBgdYCQuVGv,True,797503927,199375981,1231678,615839,615839,3zqXX6kzhkbW3d4TwD2CNjMRwxTbREXySekvq37kfCNk,49267131,307178204,-257911073,617
2022-01-24 09:25:10-05:00,10737,H1oYXGZTagwv48FdDe6RNkjNaesedqLKyXxTmPc5k4Fp,Am3rx6XrkrZ4MdeZDyZUv1YW2fBujcz4dLjVCnRQHKZa,True,62800090,15700022,97583,48791,48792,HfEnetJ7uBSmZWCjBNxdvv9HEC5nsW4wDV7wu6WnhWan,3903353,22823870,-18920517,621
2022-01-24 09:26:10-05:00,10738,EToREv5PrDmMUqRH43RdhooZMpmzXdic79KSoBatakPp,4ZTacQQnxq89V64pELPFkmvwJgkVY7m29g2sXfnn3mPD,True,7861408,1965352,12234,6117,6117,HfEnetJ7uBSmZWCjBNxdvv9HEC5nsW4wDV7wu6WnhWan,489379,2792553,-2303174,622
2022-01-24 09:26:10-05:00,10739,7aM6r3HXMKzhj1hoDWjjkVCVy2y1rhDx2QV8Sdgr9DoM,4yBtGoYqo6dX4T3NMVbgMN3731hEnugL1dsR1A5vXF8f,True,7629380,1907345,11930,5965,5965,3zqXX6kzhkbW3d4TwD2CNjMRwxTbREXySekvq37kfCNk,477227,3590611,-3113384,625
2022-01-24 09:26:10-05:00,10740,49hagnoMSB3ozBBMaTgeZ2nwEbKKS3NZWUuPShMBUwp9,6ivAhvY6bUr98jqBp4ye1w8Vz8NesEubqKDSn1jeqxmr,True,13957760,3489440,21841,10920,10921,3zqXX6kzhkbW3d4TwD2CNjMRwxTbREXySekvq37kfCNk,873652,5043577,-4169925,625
2022-01-24 10:12:50-05:00,10741,BgNgALwBEuiumVgiXRmBZRnyFrr9QTDy2maHzsNwNHGf,ag35Ec2uFtqkarizCxFyhM2SPBuUwfmLRhAdFEWFCNa,True,943887,235971,1433,716,717,HfEnetJ7uBSmZWCjBNxdvv9HEC5nsW4wDV7wu6WnhWan,57350,538251,-480901,607
2022-01-24 10:13:14-05:00,10742,7Dm3syN4P2mbBLFKyHTrtnSWY4hadGXiKB9EekTdT68S,HF97QS1dqarPMWgNmtcoaq6z3rpJnzAAAfc1PP4FwRhV,True,957953,239488,1464,732,732,3zqXX6kzhkbW3d4TwD2CNjMRwxTbREXySekvq37kfCNk,58584,383834,-325250,611
2022-01-25 13:33:04-05:00,10743,GJmom1dyridk7QkcvxYr1jUeQr6sT5yMnmQ6LJEqSq22,6tSYWuTpo57phZVwLZ4jEAod4w4dKfAwRVitjzGKXq9y,True,652496062537,163124015632,1013561142,506780571,506780571,HfEnetJ7uBSmZWCjBNxdvv9HEC5nsW4wDV7wu6WnhWan,40542445700,9079012319,31463433381,621
2022-01-25 13:52:45-05:00,10744,96StvqZyFUPtyMr4o9s7K4V29RSNyRpVi76vNwxG5rUf,GZKXFSFq4aGiTaqovtxqNCCVGkAFNXPh4Hep1ZMwdZ8g,False,7363,7363,0,0,0,HfEnetJ7uBSmZWCjBNxdvv9HEC5nsW4wDV7wu6WnhWan,0,19546,-21909,0
2022-01-25 14:22:54-05:00,10745,B4Uc39nKzz9wBRQsCkMR4A7RwTJ8rSuwpR6EQn2AesRb,H49bGZgatRZVpj6QufZRVgYrQtH7LpdbiqKBs23151m,False,8936,8936,0,0,0,HfEnetJ7uBSmZWCjBNxdvv9HEC5nsW4wDV7wu6WnhWan,0,22481,-24446,0
2022-01-26 08:47:59-05:00,10746,4Siq98BDakELWP5BzVoEN5tcg1ywRxTYs1aUcfW8spCt,2EBXLTVz1Gk9gS5JcVqCKAP5PatFGw1Vnww65Moz3SUn,True,24389095065,6097273765,37969761,18984880,18984881,HfEnetJ7uBSmZWCjBNxdvv9HEC5nsW4wDV7wu6WnhWan,1518790452,3872330621,-2353540169,622
2022-01-26 09:05:51-05:00,10747,4Siq98BDakELWP5BzVoEN5tcg1ywRxTYs1aUcfW8spCt,2EBXLTVz1Gk9gS5JcVqCKAP5PatFGw1Vnww65Moz3SUn,True,18611965841,4652991459,29023257,14511628,14511629,HfEnetJ7uBSmZWCjBNxdvv9HEC5nsW4wDV7wu6WnhWan,1160930291,3249565584,-2088635293,623
2022-01-26 14:03:01-05:00,10748,4Siq98BDakELWP5BzVoEN5tcg1ywRxTYs1aUcfW8spCt,2EBXLTVz1Gk9gS5JcVqCKAP5PatFGw1Vnww65Moz3SUn,True,14210389508,3552597375,22105100,11052550,11052550,HfEnetJ7uBSmZWCjBNxdvv9HEC5nsW4wDV7wu6WnhWan,884204020,2703989306,-1819785286,622
2022-01-26 14:06:31-05:00,10749,4Siq98BDakELWP5BzVoEN5tcg1ywRxTYs1aUcfW8spCt,2EBXLTVz1Gk9gS5JcVqCKAP5PatFGw1Vnww65Moz3SUn,True,10844123766,2711030940,16894182,8447091,8447091,HfEnetJ7uBSmZWCjBNxdvv9HEC5nsW4wDV7wu6WnhWan,675767287,2228014487,-1552247200,623
2022-01-26 14:07:13-05:00,10750,5wRQzyabqtB45KPmnsEBRJQkYDjnoWoPeSLkGx4qS5oh,8DrFp1BLznHCQX1isSkwzUEv9YLKuvcxvtjBLJfjNdpR,True,633776744429,158444186105,964041968,482020984,482020984,3zqXX6kzhkbW3d4TwD2CNjMRwxTbREXySekvq37kfCNk,38561678731,106704553277,-68142874546,608
2022-01-26 14:08:24-05:00,10751,CBL2NbekJrXvBiAcoj4fzQ4PfLDwTntW7Zt4nruHFYEw,59EvfgYTdKkfjUJz5LddLUAqbEdLaihcMzjcrTZsyzyS,True,628615,157153,965,482,483,3zqXX6kzhkbW3d4TwD2CNjMRwxTbREXySekvq37kfCNk,38605,112140,-73535,614
2022-01-26 14:08:50-05:00,10752,2Cjv6suZGsbRtv4TNSYksWKwMEKEf8vGQhGPbVVM1BMP,BHakHWmqzwqzq7i3a7VmXySPMMit58aQn7z4fqorcBHD,True,1205286,301321,1883,941,942,3zqXX6kzhkbW3d4TwD2CNjMRwxTbREXySekvq37kfCNk,75355,215640,-140285,625
2022-01-26 14:08:56-05:00,10753,7SBSVWCWENfJpg3Rd61kHjvj7rf5RchHeWChE42jdfk2,GNgZk4pw4cyetbovfqLtjdD5eEJTvJmrNbk572XnBeeN,True,4372628,1093157,6802,3401,3401,HfEnetJ7uBSmZWCjBNxdvv9HEC5nsW4wDV7wu6WnhWan,272091,787435,-515344,622
2022-01-26 14:08:59-05:00,10754,4Siq98BDakELWP5BzVoEN5tcg1ywRxTYs1aUcfW8spCt,2EBXLTVz1Gk9gS5JcVqCKAP5PatFGw1Vnww65Moz3SUn,True,8278131109,2069532776,12845870,6422935,6422935,HfEnetJ7uBSmZWCjBNxdvv9HEC5nsW4wDV7wu6WnhWan,513834822,1823670272,-1309835450,620
2022-01-26 16:47:54-05:00,10755,Br1j5Ftafei7ysu5SmqVZSoRe4uS4qCPeKSPHg55pyiE,G8fc7QvXjfkgBFvAVUgJFQS3VaF1biL9rktBExGa87Ks,True,42497384,10624346,65971,32985,32986,HfEnetJ7uBSmZWCjBNxdvv9HEC5nsW4wDV7wu6WnhWan,2638848,9891464,-7252616,620
2022-01-26 16:57:43-05:00,10756,6b7Ro2myM4HcUDqyyW9NEqTWPz8BWpH4eNFSQQci37So,7r7j7rSsa6YZcTuRPfs3KP44MVqUA4Q5NeJGmx84wbHq,True,49094,12273,70,35,35,HfEnetJ7uBSmZWCjBNxdvv9HEC5nsW4wDV7wu6WnhWan,2811,61530,-58719,572
2022-01-26 17:00:19-05:00,10757,9psSuFHBGqCvcgNMc7aTMhKMMFwBDmW7v5Wkn22KtTHj,7zi9LSfuEhXccQXSRukRRwgQUaiQVVgfsGaRYLP2JvwB,True,586688636,146672159,912292,456146,456146,HfEnetJ7uBSmZWCjBNxdvv9HEC5nsW4wDV7wu6WnhWan,36491694,240736725,-204245031,621
2022-01-26 17:00:19-05:00,10758,4ytoBUwuhAL4YYSCa6AgwrpeVF4eeU8H9NfDxMPZKxPo,Pby2szzsxDrXt4gnbmmaMccXxctZALr8miRtKhGKjsD,True,1973387,493346,3076,1538,1538,HfEnetJ7uBSmZWCjBNxdvv9HEC5nsW4wDV7wu6WnhWan,123053,1246192,-1123139,623
2022-01-26 20:36:46-05:00,10759,Br1j5Ftafei7ysu5SmqVZSoRe4uS4qCPeKSPHg55pyiE,G8fc7QvXjfkgBFvAVUgJFQS3VaF1biL9rktBExGa87Ks,True,31221037,7805259,47589,23794,23795,HfEnetJ7uBSmZWCjBNxdvv9HEC5nsW4wDV7wu6WnhWan,1903597,7995080,-6091483,609
2022-01-26 20:36:46-05:00,10760,Dv1BABsN7amhjmGBpMQsnMkRLx7MuCVwsnuyTQeZ6uum,BCjscxVo1h16teND6KKiAUy1ftNGTMy1vEEEyAW4ttVG,True,3260658,815164,4931,2465,2466,HfEnetJ7uBSmZWCjBNxdvv9HEC5nsW4wDV7wu6WnhWan,197261,1243691,-1046430,604
2022-01-26 20:39:35-05:00,10761,GXfjQr2ihTfLRys1DMetVGocd1sU97KdoCJ6x4HxdW1U,9GHvjJJXjbVz5D3RBfP3njcdRRXnFsXZ68jFa2LiGwsy,True,38697915,9674478,60503,30251,30252,HfEnetJ7uBSmZWCjBNxdvv9HEC5nsW4wDV7wu6WnhWan,2420157,23605054,-21184897,625
2022-01-26 20:39:46-05:00,10762,CCP5P6U4xBjea3snWgwBb5rtaounEAsNHpWzTUeNtVf9,GE2Bxc837ybP7sNR487U4bVbx68qyX2HtwPBLfEd4BDj,True,151631990,37907997,236403,118201,118202,HfEnetJ7uBSmZWCjBNxdvv9HEC5nsW4wDV7wu6WnhWan,9456148,62619616,-53163468,623
2022-01-26 20:39:46-05:00,10763,BHpLpoGQ27T6Q4CT8H4dzqS8KF8Vj5rqmqfcodoBzpgR,Akn3tG2hQBfBVtNYCeXchfzfcsyCuSpkGpFoMLEKwcBF,True,2445361,611340,3808,1904,1904,HfEnetJ7uBSmZWCjBNxdvv9HEC5nsW4wDV7wu6WnhWan,152336,1560454,-1408118,622
2022-01-26 20:44:24-05:00,10764,E5biUzKn2s5frKseCmfWriWjrYMGVtmLrhR9nYhAkVvR,BDHzqefisuGoMGcpML8t6KAC7rcErvhLcfV8KQC7oHAH,True,9534524,2383631,14690,7345,7345,HfEnetJ7uBSmZWCjBNxdvv9HEC5nsW4wDV7wu6WnhWan,587616,4559115,-3971499,616
2022-01-26 20:52:23-05:00,10765,GXSysysoV8Z4xBrQsaKUsSrpoWeTTUsbFmgfZDaQu4ZM,6FJyraiLgG3tb9B7pi4YFsJNtRVBNaghnm1ajzneVv7b,True,243629754,60907438,376128,188064,188064,HfEnetJ7uBSmZWCjBNxdvv9HEC5nsW4wDV7wu6WnhWan,15045145,106482564,-91437419,617
2022-01-26 20:52:55-05:00,10766,9aQrdyfAvcBbBj7iKQB17eAS4zBqymdd3kzkTkuRhdLU,BDHhukMF5rALuSwCxaw8g73m2MN4oX1D4e7uNmx3SiVt,True,34255980,8563995,53322,26661,26661,3zqXX6kzhkbW3d4TwD2CNjMRwxTbREXySekvq37kfCNk,2132906,14562848,-12429942,622
2022-01-26 20:53:08-05:00,10767,9psSuFHBGqCvcgNMc7aTMhKMMFwBDmW7v5Wkn22KtTHj,7zi9LSfuEhXccQXSRukRRwgQUaiQVVgfsGaRYLP2JvwB,True,431530134,107882533,673992,336996,336996,3zqXX6kzhkbW3d4TwD2CNjMRwxTbREXySekvq37kfCNk,26959696,188634103,-161674407,624
2022-01-26 20:53:12-05:00,10768,4ytoBUwuhAL4YYSCa6AgwrpeVF4eeU8H9NfDxMPZKxPo,Pby2szzsxDrXt4gnbmmaMccXxctZALr8miRtKhGKjsD,True,1450908,362727,2259,1129,1130,3zqXX6kzhkbW3d4TwD2CNjMRwxTbREXySekvq37kfCNk,90396,961885,-871489,623
2022-01-26 20:54:25-05:00,10769,EF6H6aW1p3qcAtiLFU9rbFYfsKfD683meHXDw8hLdaZK,8vfJbpnK7SQcjpEBCzZJRW8JosNbsmTeJ2YXZCbM225c,True,7769998,1942499,12134,6067,6067,HfEnetJ7uBSmZWCjBNxdvv9HEC5nsW4wDV7wu6WnhWan,485370,4825158,-4339788,624
2022-01-26 20:56:10-05:00,10770,6b7Ro2myM4HcUDqyyW9NEqTWPz8BWpH4eNFSQQci37So,7r7j7rSsa6YZcTuRPfs3KP44MVqUA4Q5NeJGmx84wbHq,True,36365,9091,56,28,28,HfEnetJ7uBSmZWCjBNxdvv9HEC5nsW4wDV7wu6WnhWan,2255,39708,-37453,620
2022-01-26 20:56:58-05:00,10771,Dv1BABsN7amhjmGBpMQsnMkRLx7MuCVwsnuyTQeZ6uum,BCjscxVo1h16teND6KKiAUy1ftNGTMy1vEEEyAW4ttVG,True,2403146,600786,3749,1874,1875,HfEnetJ7uBSmZWCjBNxdvv9HEC5nsW4wDV7wu6WnhWan,149982,977153,-827171,624
2022-01-26 20:57:02-05:00,10772,HGAFdundf5voDqeh9g7d6Q9mgMf8eEg898QMRBqwPZ6C,deanBuZXWBHEe2TGfP37S9aMBEnEgmZoyRJjAvruzfA,True,456405,114100,712,356,356,3zqXX6kzhkbW3d4TwD2CNjMRwxTbREXySekvq37kfCNk,28506,481794,-453288,624
2022-01-26 20:57:24-05:00,10773,Br1j5Ftafei7ysu5SmqVZSoRe4uS4qCPeKSPHg55pyiE,G8fc7QvXjfkgBFvAVUgJFQS3VaF1biL9rktBExGa87Ks,True,22998273,5749568,35962,17981,17981,HfEnetJ7uBSmZWCjBNxdvv9HEC5nsW4wDV7wu6WnhWan,1438503,6424632,-4986129,625
2022-01-26 20:59:00-05:00,10774,46TNhGwBVzedW8xSb9UY94HNeSom9iGiZzAjrKHiRM2G,7JVTiqNYeKHbyzRkKtvSEpqLPKykZso8cGUr3sX1j7QF,True,762164,190540,1170,585,585,HfEnetJ7uBSmZWCjBNxdvv9HEC5nsW4wDV7wu6WnhWan,46822,588056,-541234,614
2022-01-26 20:59:00-05:00,10775,GXfjQr2ihTfLRys1DMetVGocd1sU97KdoCJ6x4HxdW1U,9GHvjJJXjbVz5D3RBfP3njcdRRXnFsXZ68jFa2LiGwsy,True,28392073,7098018,43207,21603,21604,3zqXX6kzhkbW3d4TwD2CNjMRwxTbREXySekvq37kfCNk,1728290,18248349,-16520059,608
2022-01-26 20:59:00-05:00,10776,BHpLpoGQ27T6Q4CT8H4dzqS8KF8Vj5rqmqfcodoBzpgR,Akn3tG2hQBfBVtNYCeXchfzfcsyCuSpkGpFoMLEKwcBF,True,1795431,448857,2748,1374,1374,HfEnetJ7uBSmZWCjBNxdvv9HEC5nsW4wDV7wu6WnhWan,109938,1204617,-1094679,612
2022-01-26 20:59:00-05:00,10777,CCP5P6U4xBjea3snWgwBb5rtaounEAsNHpWzTUeNtVf9,GE2Bxc837ybP7sNR487U4bVbx68qyX2HtwPBLfEd4BDj,True,111331146,27832786,170672,85336,85336,HfEnetJ7uBSmZWCjBNxdvv9HEC5nsW4wDV7wu6WnhWan,6826898,49092636,-42265738,613
2022-01-26 20:59:05-05:00,10778,E5biUzKn2s5frKseCmfWriWjrYMGVtmLrhR9nYhAkVvR,BDHzqefisuGoMGcpML8t6KAC7rcErvhLcfV8KQC7oHAH,True,7016366,1754091,10959,5479,5480,HfEnetJ7uBSmZWCjBNxdvv9HEC5nsW4wDV7wu6WnhWan,438399,3551552,-3113153,624
2022-01-26 21:10:50-05:00,10779,6b7Ro2myM4HcUDqyyW9NEqTWPz8BWpH4eNFSQQci37So,7r7j7rSsa6YZcTuRPfs3KP44MVqUA4Q5NeJGmx84wbHq,True,26736,6684,41,20,21,HfEnetJ7uBSmZWCjBNxdvv9HEC5nsW4wDV7wu6WnhWan,1654,30283,-28629,618
2022-01-26 21:11:56-05:00,10780,9Ngb4UJjvSm9zbTN4RYRFWBzTPVWQh7C2hFiDvwPsDBd,EamTKaoTYJo9RUMQC7MjS1HJrVPYipR2cv6nYpgBLnPr,True,159073533,39768382,247483,123741,123742,3zqXX6kzhkbW3d4TwD2CNjMRwxTbREXySekvq37kfCNk,9899334,75634705,-65735371,622
2022-01-26 22:47:25-05:00,10781,GXSysysoV8Z4xBrQsaKUsSrpoWeTTUsbFmgfZDaQu4ZM,6FJyraiLgG3tb9B7pi4YFsJNtRVBNaghnm1ajzneVv7b,True,179330014,44832503,279547,139773,139774,2BPYaeCXY4BCFSGFSfiGtqmhzJ4fkhYLxGjqFvLCB6hG,11181906,83153034,-71971128,623
2022-01-26 22:47:47-05:00,10782,HGAFdundf5voDqeh9g7d6Q9mgMf8eEg898QMRBqwPZ6C,deanBuZXWBHEe2TGfP37S9aMBEnEgmZoyRJjAvruzfA,True,335716,83928,525,262,263,2BPYaeCXY4BCFSGFSfiGtqmhzJ4fkhYLxGjqFvLCB6hG,21008,367566,-346558,625
2022-01-26 22:49:05-05:00,10783,2r64Rnbu3ZjmJTHHUxxV9TWWGzwpAepA4ySbtKivBXCj,6RRzx6KLkMiFK9JSuznrSJGiPgkHwatBSskudHqbfKJ5,True,141105572,35276392,220386,110193,110193,2BPYaeCXY4BCFSGFSfiGtqmhzJ4fkhYLxGjqFvLCB6hG,8815449,93220200,-84404751,624
2022-01-26 22:50:55-05:00,10784,BH36ueAULprzjj6WabTgvivEcrx3VdDn8DTxSoro8Zym,6yydJKEmtZjUwURrs9gQ7EGkB86nK28ZDJQqNMgbPosA,True,87203144,21800786,136360,68180,68180,HfEnetJ7uBSmZWCjBNxdvv9HEC5nsW4wDV7wu6WnhWan,5454430,47384331,-41929901,625
2022-01-26 22:53:39-05:00,10785,BCGTaPQxGEMjD7xUxwfwmVVYJ9CEGH33yJRi3QjwyiLE,JBct1cZ9a959UKwABBEefwxZnGTAAGLzyUdXrXqGGCZd,True,38138339,9534584,58935,29467,29468,2BPYaeCXY4BCFSGFSfiGtqmhzJ4fkhYLxGjqFvLCB6hG,2357407,8669068,-6311661,618
2022-01-27 14:38:43-05:00,10786,9aQrdyfAvcBbBj7iKQB17eAS4zBqymdd3kzkTkuRhdLU,BDHhukMF5rALuSwCxaw8g73m2MN4oX1D4e7uNmx3SiVt,True,25218375,6304593,39392,19696,19696,HfEnetJ7uBSmZWCjBNxdvv9HEC5nsW4wDV7wu6WnhWan,1575701,11371783,-9796082,624
2022-01-27 14:39:49-05:00,10787,9psSuFHBGqCvcgNMc7aTMhKMMFwBDmW7v5Wkn22KtTHj,7zi9LSfuEhXccQXSRukRRwgQUaiQVVgfsGaRYLP2JvwB,True,317593935,79398483,496258,248129,248129,2BPYaeCXY4BCFSGFSfiGtqmhzJ4fkhYLxGjqFvLCB6hG,19850353,147162215,-127311862,625
2022-01-27 14:40:02-05:00,10788,4ytoBUwuhAL4YYSCa6AgwrpeVF4eeU8H9NfDxMPZKxPo,Pby2szzsxDrXt4gnbmmaMccXxctZALr8miRtKhGKjsD,True,1068121,267030,1669,834,835,2BPYaeCXY4BCFSGFSfiGtqmhzJ4fkhYLxGjqFvLCB6hG,66794,740471,-673677,625
2022-01-27 14:40:13-05:00,10789,442usWu6XpJZvU25bqXeynRrQ15jAzWwU9DWMgHpTn3Q,CtvADKp39bjJf3cPKWNL3wxnhq273fVM4fC5DmEcg5cC,True,814345124,203586281,1273994,636997,636997,3zqXX6kzhkbW3d4TwD2CNjMRwxTbREXySekvq37kfCNk,50959788,161704564,-110744776,625
2022-01-27 14:55:23-05:00,10790,Dv1BABsN7amhjmGBpMQsnMkRLx7MuCVwsnuyTQeZ6uum,BCjscxVo1h16teND6KKiAUy1ftNGTMy1vEEEyAW4ttVG,True,1768858,442214,2764,1382,1382,HfEnetJ7uBSmZWCjBNxdvv9HEC5nsW4wDV7wu6WnhWan,110592,764473,-653881,625
2022-01-27 14:55:58-05:00,10791,Br1j5Ftafei7ysu5SmqVZSoRe4uS4qCPeKSPHg55pyiE,G8fc7QvXjfkgBFvAVUgJFQS3VaF1biL9rktBExGa87Ks,True,16916915,4229228,26256,13128,13128,2BPYaeCXY4BCFSGFSfiGtqmhzJ4fkhYLxGjqFvLCB6hG,1050267,5121660,-4071393,620
2022-01-27 14:58:53-05:00,10792,GXfjQr2ihTfLRys1DMetVGocd1sU97KdoCJ6x4HxdW1U,9GHvjJJXjbVz5D3RBfP3njcdRRXnFsXZ68jFa2LiGwsy,True,20940213,5235053,32645,16322,16323,2BPYaeCXY4BCFSGFSfiGtqmhzJ4fkhYLxGjqFvLCB6hG,1305822,14049721,-12743899,623
2022-01-27 15:13:49-05:00,10793,EF6H6aW1p3qcAtiLFU9rbFYfsKfD683meHXDw8hLdaZK,8vfJbpnK7SQcjpEBCzZJRW8JosNbsmTeJ2YXZCbM225c,True,5726962,1431740,8957,4478,4479,HfEnetJ7uBSmZWCjBNxdvv9HEC5nsW4wDV7wu6WnhWan,358287,3713668,-3355381,625
2022-01-27 15:14:16-05:00,10794,BHpLpoGQ27T6Q4CT8H4dzqS8KF8Vj5rqmqfcodoBzpgR,Akn3tG2hQBfBVtNYCeXchfzfcsyCuSpkGpFoMLEKwcBF,True,1324297,331074,2072,1036,1036,2BPYaeCXY4BCFSGFSfiGtqmhzJ4fkhYLxGjqFvLCB6hG,82891,926179,-843288,625
2022-01-27 15:14:39-05:00,10795,CCP5P6U4xBjea3snWgwBb5rtaounEAsNHpWzTUeNtVf9,GE2Bxc837ybP7sNR487U4bVbx68qyX2HtwPBLfEd4BDj,True,82065913,20516478,127459,63729,63730,HfEnetJ7uBSmZWCjBNxdvv9HEC5nsW4wDV7wu6WnhWan,5098375,38230287,-33131912,621
2022-01-27 15:14:40-05:00,10796,8WHDaiE6LqFFmCVMnPeLEQ99R6ft8b74UfmP9BqzjcE8,CGmoDGsdnjo3zMNrW78n2xxQr1aDPAiBYiXbyciLXYMu,True,11743064,2935764,18243,9121,9122,HfEnetJ7uBSmZWCjBNxdvv9HEC5nsW4wDV7wu6WnhWan,729747,8356772,-7627025,621
2022-01-27 15:15:02-05:00,10797,E5biUzKn2s5frKseCmfWriWjrYMGVtmLrhR9nYhAkVvR,BDHzqefisuGoMGcpML8t6KAC7rcErvhLcfV8KQC7oHAH,True,5164780,1291195,8050,4025,4025,HfEnetJ7uBSmZWCjBNxdvv9HEC5nsW4wDV7wu6WnhWan,322034,2754395,-2432361,623
2022-01-27 15:18:12-05:00,10798,GXSysysoV8Z4xBrQsaKUsSrpoWeTTUsbFmgfZDaQu4ZM,6FJyraiLgG3tb9B7pi4YFsJNtRVBNaghnm1ajzneVv7b,True,131784230,32946057,201432,100716,100716,2BPYaeCXY4BCFSGFSfiGtqmhzJ4fkhYLxGjqFvLCB6hG,8057302,64749354,-56692052,611
2022-01-27 15:19:23-05:00,10799,9aQrdyfAvcBbBj7iKQB17eAS4zBqymdd3kzkTkuRhdLU,BDHhukMF5rALuSwCxaw8g73m2MN4oX1D4e7uNmx3SiVt,True,18541784,4635446,28961,14480,14481,2BPYaeCXY4BCFSGFSfiGtqmhzJ4fkhYLxGjqFvLCB6hG,1158450,8877519,-7719069,624
2022-01-27 15:21:30-05:00,10800,442usWu6XpJZvU25bqXeynRrQ15jAzWwU9DWMgHpTn3Q,CtvADKp39bjJf3cPKWNL3wxnhq273fVM4fC5DmEcg5cC,True,598608293,149652073,933642,466821,466821,3zqXX6kzhkbW3d4TwD2CNjMRwxTbREXySekvq37kfCNk,37345681,132561915,-95216234,623
2022-01-27 15:21:36-05:00,10801,9psSuFHBGqCvcgNMc7aTMhKMMFwBDmW7v5Wkn22KtTHj,7zi9LSfuEhXccQXSRukRRwgQUaiQVVgfsGaRYLP2JvwB,True,233356414,58339103,361029,180514,180515,2BPYaeCXY4BCFSGFSfiGtqmhzJ4fkhYLxGjqFvLCB6hG,14441160,114765427,-100324267,618
2022-01-27 15:21:38-05:00,10802,4ytoBUwuhAL4YYSCa6AgwrpeVF4eeU8H9NfDxMPZKxPo,Pby2szzsxDrXt4gnbmmaMccXxctZALr8miRtKhGKjsD,True,784899,196224,1217,608,609,3zqXX6kzhkbW3d4TwD2CNjMRwxTbREXySekvq37kfCNk,48685,570136,-521451,620
2022-01-27 15:24:51-05:00,10803,46TNhGwBVzedW8xSb9UY94HNeSom9iGiZzAjrKHiRM2G,7JVTiqNYeKHbyzRkKtvSEpqLPKykZso8cGUr3sX1j7QF,True,562410,140602,878,439,439,2BPYaeCXY4BCFSGFSfiGtqmhzJ4fkhYLxGjqFvLCB6hG,35126,450267,-415141,624
2022-01-27 15:32:15-05:00,10804,Dv1BABsN7amhjmGBpMQsnMkRLx7MuCVwsnuyTQeZ6uum,BCjscxVo1h16teND6KKiAUy1ftNGTMy1vEEEyAW4ttVG,True,1298817,324704,1989,994,995,HfEnetJ7uBSmZWCjBNxdvv9HEC5nsW4wDV7wu6WnhWan,79587,597826,-518239,612
2022-01-27 15:32:15-05:00,10805,Br1j5Ftafei7ysu5SmqVZSoRe4uS4qCPeKSPHg55pyiE,G8fc7QvXjfkgBFvAVUgJFQS3VaF1biL9rktBExGa87Ks,True,12436264,3109066,19215,9607,9608,2BPYaeCXY4BCFSGFSfiGtqmhzJ4fkhYLxGjqFvLCB6hG,768622,4073594,-3304972,618
2022-01-27 15:32:15-05:00,10806,BH36ueAULprzjj6WabTgvivEcrx3VdDn8DTxSoro8Zym,6yydJKEmtZjUwURrs9gQ7EGkB86nK28ZDJQqNMgbPosA,True,64206721,16051679,99803,49901,49902,2BPYaeCXY4BCFSGFSfiGtqmhzJ4fkhYLxGjqFvLCB6hG,3992135,36635267,-32643132,621
2022-01-27 15:34:38-05:00,10807,GXfjQr2ihTfLRys1DMetVGocd1sU97KdoCJ6x4HxdW1U,9GHvjJJXjbVz5D3RBfP3njcdRRXnFsXZ68jFa2LiGwsy,True,15397564,3849391,24016,12008,12008,HfEnetJ7uBSmZWCjBNxdvv9HEC5nsW4wDV7wu6WnhWan,960660,10826188,-9865528,623
2022-01-27 15:36:52-05:00,10808,CCP5P6U4xBjea3snWgwBb5rtaounEAsNHpWzTUeNtVf9,GE2Bxc837ybP7sNR487U4bVbx68qyX2HtwPBLfEd4BDj,True,60334434,15083608,93897,46948,46949,HfEnetJ7uBSmZWCjBNxdvv9HEC5nsW4wDV7wu6WnhWan,3755915,29819940,-26064025,622
2022-01-27 15:36:54-05:00,10809,BHpLpoGQ27T6Q4CT8H4dzqS8KF8Vj5rqmqfcodoBzpgR,Akn3tG2hQBfBVtNYCeXchfzfcsyCuSpkGpFoMLEKwcBF,True,972938,243234,1513,756,757,2BPYaeCXY4BCFSGFSfiGtqmhzJ4fkhYLxGjqFvLCB6hG,60534,713286,-652752,622
2022-01-27 15:37:33-05:00,10810,E5biUzKn2s5frKseCmfWriWjrYMGVtmLrhR9nYhAkVvR,BDHzqefisuGoMGcpML8t6KAC7rcErvhLcfV8KQC7oHAH,True,3796821,949205,5930,2965,2965,2BPYaeCXY4BCFSGFSfiGtqmhzJ4fkhYLxGjqFvLCB6hG,237220,2138256,-1901036,624
2022-01-27 15:38:00-05:00,10811,BCGTaPQxGEMjD7xUxwfwmVVYJ9CEGH33yJRi3QjwyiLE,JBct1cZ9a959UKwABBEefwxZnGTAAGLzyUdXrXqGGCZd,True,28094996,7023749,42706,21353,21353,2BPYaeCXY4BCFSGFSfiGtqmhzJ4fkhYLxGjqFvLCB6hG,1708253,6950784,-5242531,608
2022-01-27 15:38:01-05:00,10812,CQsFSBGcVgtmbzuvUkkSDtPuHFVSuFFaHVcNCM4tuXBs,8nJdA3thwEhzwvvtoAZ7mzMxuRjzp8uGRdDEWMHaDmKA,True,23085752,5771438,35332,17666,17666,HfEnetJ7uBSmZWCjBNxdvv9HEC5nsW4wDV7wu6WnhWan,1413315,8320063,-6906748,612
2022-01-27 15:38:03-05:00,10813,EF6H6aW1p3qcAtiLFU9rbFYfsKfD683meHXDw8hLdaZK,8vfJbpnK7SQcjpEBCzZJRW8JosNbsmTeJ2YXZCbM225c,True,4209044,1052260,6578,3289,3289,HfEnetJ7uBSmZWCjBNxdvv9HEC5nsW4wDV7wu6WnhWan,263152,2865868,-2602716,625
2022-01-27 15:38:12-05:00,10814,8WHDaiE6LqFFmCVMnPeLEQ99R6ft8b74UfmP9BqzjcE8,CGmoDGsdnjo3zMNrW78n2xxQr1aDPAiBYiXbyciLXYMu,True,8634308,2158576,13462,6731,6731,HfEnetJ7uBSmZWCjBNxdvv9HEC5nsW4wDV7wu6WnhWan,538512,6431777,-5893265,623
2022-01-27 15:38:31-05:00,10815,2r64Rnbu3ZjmJTHHUxxV9TWWGzwpAepA4ySbtKivBXCj,6RRzx6KLkMiFK9JSuznrSJGiPgkHwatBSskudHqbfKJ5,True,103840682,25960169,159723,79861,79862,2BPYaeCXY4BCFSGFSfiGtqmhzJ4fkhYLxGjqFvLCB6hG,6388928,71681157,-65292229,615
2022-01-27 15:38:31-05:00,10816,CaAzPATicBzeb4mPpf7r7FLcLVV2V2jchT7QUFKs9enb,2z9rfVSTk8qG7f8b5S3FrJWidPKidaWw2X8vDiRETQqW,True,334400909,83600227,489277,244638,244639,2BPYaeCXY4BCFSGFSfiGtqmhzJ4fkhYLxGjqFvLCB6hG,19571089,147358780,-127787691,585
2022-01-27 15:38:31-05:00,10817,GXSysysoV8Z4xBrQsaKUsSrpoWeTTUsbFmgfZDaQu4ZM,6FJyraiLgG3tb9B7pi4YFsJNtRVBNaghnm1ajzneVv7b,True,96547534,24136883,139130,69565,69565,HfEnetJ7uBSmZWCjBNxdvv9HEC5nsW4wDV7wu6WnhWan,5565231,50375146,-44809915,576
2022-01-27 15:38:31-05:00,10818,9psSuFHBGqCvcgNMc7aTMhKMMFwBDmW7v5Wkn22KtTHj,7zi9LSfuEhXccQXSRukRRwgQUaiQVVgfsGaRYLP2JvwB,True,171391817,42847954,261365,130682,130683,2BPYaeCXY4BCFSGFSfiGtqmhzJ4fkhYLxGjqFvLCB6hG,10454637,89324074,-78869437,609
2022-01-27 15:38:31-05:00,10819,4ytoBUwuhAL4YYSCa6AgwrpeVF4eeU8H9NfDxMPZKxPo,Pby2szzsxDrXt4gnbmmaMccXxctZALr8miRtKhGKjsD,True,576478,144119,881,440,441,2BPYaeCXY4BCFSGFSfiGtqmhzJ4fkhYLxGjqFvLCB6hG,35271,438558,-403287,611
2022-01-27 15:38:31-05:00,10820,9aQrdyfAvcBbBj7iKQB17eAS4zBqymdd3kzkTkuRhdLU,BDHhukMF5rALuSwCxaw8g73m2MN4oX1D4e7uNmx3SiVt,True,13593783,3398445,20423,10211,10212,3zqXX6kzhkbW3d4TwD2CNjMRwxTbREXySekvq37kfCNk,816934,6918796,-6101862,600
2022-01-27 15:38:31-05:00,10821,442usWu6XpJZvU25bqXeynRrQ15jAzWwU9DWMgHpTn3Q,CtvADKp39bjJf3cPKWNL3wxnhq273fVM4fC5DmEcg5cC,True,439651430,109912857,677681,338840,338841,3zqXX6kzhkbW3d4TwD2CNjMRwxTbREXySekvq37kfCNk,27107249,107828169,-80720920,616
2022-01-27 16:00:20-05:00,10822,HEFpdWLZaiQnjftmXgxs6RNzhH72YiMjortxPkKekkvb,5Q8mmxBgVTijNGrWsnoA3VMArLHZEX5MkaigYXHpgXHE,True,7110949,1777737,11125,5562,5563,3zqXX6kzhkbW3d4TwD2CNjMRwxTbREXySekvq37kfCNk,445034,3116089,-2671055,625
2022-01-27 16:11:34-05:00,10823,BCGTaPQxGEMjD7xUxwfwmVVYJ9CEGH33yJRi3QjwyiLE,JBct1cZ9a959UKwABBEefwxZnGTAAGLzyUdXrXqGGCZd,True,20659151,5164787,31150,15575,15575,HfEnetJ7uBSmZWCjBNxdvv9HEC5nsW4wDV7wu6WnhWan,1246037,5590046,-4344009,603
2022-01-27 16:11:58-05:00,10824,BH36ueAULprzjj6WabTgvivEcrx3VdDn8DTxSoro8Zym,6yydJKEmtZjUwURrs9gQ7EGkB86nK28ZDJQqNMgbPosA,True,47230088,11807521,73792,36896,36896,3zqXX6kzhkbW3d4TwD2CNjMRwxTbREXySekvq37kfCNk,2951683,28359026,-25407343,624
2022-01-27 16:21:46-05:00,10825,HGAFdundf5voDqeh9g7d6Q9mgMf8eEg898QMRBqwPZ6C,deanBuZXWBHEe2TGfP37S9aMBEnEgmZoyRJjAvruzfA,True,247329,61831,386,193,193,HfEnetJ7uBSmZWCjBNxdvv9HEC5nsW4wDV7wu6WnhWan,15478,279858,-264380,625
2022-01-27 16:38:07-05:00,10826,BjCNaM7YbE9SjFi7tzi4677zg1fKXGJwtecz2GWwWuhd,6rNsSrKZezQrLb2whToNjnizpnurDXrobHqfEK3QqU1M,True,146238149,36559537,228686,114343,114343,2BPYaeCXY4BCFSGFSfiGtqmhzJ4fkhYLxGjqFvLCB6hG,9147469,86676555,-77529086,625
2022-01-27 16:51:10-05:00,10827,Dv1BABsN7amhjmGBpMQsnMkRLx7MuCVwsnuyTQeZ6uum,BCjscxVo1h16teND6KKiAUy1ftNGTMy1vEEEyAW4ttVG,True,956476,239119,1491,745,746,2BPYaeCXY4BCFSGFSfiGtqmhzJ4fkhYLxGjqFvLCB6hG,59671,465988,-406317,623
2022-01-27 16:53:59-05:00,10828,3HuYXkGL9jnp7iLZ6dMmC5dNcmTxPdpAEGZhPzxCDD1F,DeoJsUX13b9HjDU2RMWq5wgQEVriEho9cDEqBbRKLRn9,True,559435182,139858795,874795,437397,437398,2BPYaeCXY4BCFSGFSfiGtqmhzJ4fkhYLxGjqFvLCB6hG,34991801,380223898,-345232097,625
2022-01-27 16:54:19-05:00,10829,Br1j5Ftafei7ysu5SmqVZSoRe4uS4qCPeKSPHg55pyiE,G8fc7QvXjfkgBFvAVUgJFQS3VaF1biL9rktBExGa87Ks,True,9150198,2287549,14240,7120,7120,2BPYaeCXY4BCFSGFSfiGtqmhzJ4fkhYLxGjqFvLCB6hG,569622,3225354,-2655732,622
2022-01-27 16:54:47-05:00,10830,46TNhGwBVzedW8xSb9UY94HNeSom9iGiZzAjrKHiRM2G,7JVTiqNYeKHbyzRkKtvSEpqLPKykZso8cGUr3sX1j7QF,True,413408,103352,643,321,322,HfEnetJ7uBSmZWCjBNxdvv9HEC5nsW4wDV7wu6WnhWan,25738,345496,-319758,622
2022-01-27 16:54:50-05:00,10831,GXfjQr2ihTfLRys1DMetVGocd1sU97KdoCJ6x4HxdW1U,9GHvjJJXjbVz5D3RBfP3njcdRRXnFsXZ68jFa2LiGwsy,True,11319921,2829980,17623,8811,8812,2BPYaeCXY4BCFSGFSfiGtqmhzJ4fkhYLxGjqFvLCB6hG,704937,8332339,-7627402,622
2022-01-27 16:54:56-05:00,10832,CCP5P6U4xBjea3snWgwBb5rtaounEAsNHpWzTUeNtVf9,GE2Bxc837ybP7sNR487U4bVbx68qyX2HtwPBLfEd4BDj,True,44344610,11086152,68556,34278,34278,2BPYaeCXY4BCFSGFSfiGtqmhzJ4fkhYLxGjqFvLCB6hG,2742251,23196537,-20454286,618
2022-01-27 16:54:57-05:00,10833,BHpLpoGQ27T6Q4CT8H4dzqS8KF8Vj5rqmqfcodoBzpgR,Akn3tG2hQBfBVtNYCeXchfzfcsyCuSpkGpFoMLEKwcBF,True,715038,178759,1103,551,552,2BPYaeCXY4BCFSGFSfiGtqmhzJ4fkhYLxGjqFvLCB6hG,44137,548368,-504231,617
2022-01-27 17:01:18-05:00,10834,E5biUzKn2s5frKseCmfWriWjrYMGVtmLrhR9nYhAkVvR,BDHzqefisuGoMGcpML8t6KAC7rcErvhLcfV8KQC7oHAH,True,2792825,698206,4370,2185,2185,2BPYaeCXY4BCFSGFSfiGtqmhzJ4fkhYLxGjqFvLCB6hG,174809,1655378,-1480569,625
2022-01-27 17:02:01-05:00,10835,CQsFSBGcVgtmbzuvUkkSDtPuHFVSuFFaHVcNCM4tuXBs,8nJdA3thwEhzwvvtoAZ7mzMxuRjzp8uGRdDEWMHaDmKA,True,17010436,4252609,26595,13297,13298,HfEnetJ7uBSmZWCjBNxdvv9HEC5nsW4wDV7wu6WnhWan,1063810,6547756,-5483946,625
2022-01-27 17:05:49-05:00,10836,3wr6taSTMEdDKUej5NWod2uGUC4wutem5dKJjEgEZntD,E3cAAUyuDQT2hSxLG6fhyCxkPPUAMp2xyaDLFtbnxBzQ,True,816991967,204247991,1276363,638181,638182,2BPYaeCXY4BCFSGFSfiGtqmhzJ4fkhYLxGjqFvLCB6hG,51054530,432160346,-381105816,624
2022-01-27 17:07:04-05:00,10837,GXSysysoV8Z4xBrQsaKUsSrpoWeTTUsbFmgfZDaQu4ZM,6FJyraiLgG3tb9B7pi4YFsJNtRVBNaghnm1ajzneVv7b,True,71475229,17868807,111183,55591,55592,2BPYaeCXY4BCFSGFSfiGtqmhzJ4fkhYLxGjqFvLCB6hG,4447338,38990329,-34542991,622
2022-01-27 17:07:07-05:00,10838,9JNezn7M3xZF3GSVXYXQCH48HjURRvEQNon36ieFnRf9,4up5vAdJztB5GvdtuM6gvDHjBkrGM8DAW4EPaptDqCVC,True,52855310,13213827,82234,41117,41117,3zqXX6kzhkbW3d4TwD2CNjMRwxTbREXySekvq37kfCNk,3289385,34904075,-31614690,622
2022-01-27 17:07:11-05:00,10839,ARB1q7bNcQ7grwFEZC6nk9Pfrrg7yZ2WK8zVqq5CEE8F,53e8mUYrWzQnCm9XQyp18CL9owyPqJcYyxZANYhRypPx,True,15083449,3770862,23264,11632,11632,2BPYaeCXY4BCFSGFSfiGtqmhzJ4fkhYLxGjqFvLCB6hG,930575,3547126,-2616551,616
2022-01-27 17:07:11-05:00,10840,CaAzPATicBzeb4mPpf7r7FLcLVV2V2jchT7QUFKs9enb,2z9rfVSTk8qG7f8b5S3FrJWidPKidaWw2X8vDiRETQqW,True,247056350,61764087,379684,189842,189842,2BPYaeCXY4BCFSGFSfiGtqmhzJ4fkhYLxGjqFvLCB6hG,15187361,114773949,-99586588,614
2022-01-27 17:07:18-05:00,10841,FuoFPNTdYVDkSHaBac6UC1aNJXafSNTvFJuBCdrgQQrH,ApBS1Fx83tcECMzDV6wEzEzEdg4e2hgj3djtjRUoSKK5,True,11806179,2951543,18463,9231,9232,2BPYaeCXY4BCFSGFSfiGtqmhzJ4fkhYLxGjqFvLCB6hG,738549,9509211,-8770662,625
2022-01-27 17:07:20-05:00,10842,9aQrdyfAvcBbBj7iKQB17eAS4zBqymdd3kzkTkuRhdLU,BDHhukMF5rALuSwCxaw8g73m2MN4oX1D4e7uNmx3SiVt,True,10031719,2507929,15669,7834,7835,2BPYaeCXY4BCFSGFSfiGtqmhzJ4fkhYLxGjqFvLCB6hG,626790,5366809,-4740019,624
2022-01-27 17:08:06-05:00,10843,9psSuFHBGqCvcgNMc7aTMhKMMFwBDmW7v5Wkn22KtTHj,7zi9LSfuEhXccQXSRukRRwgQUaiQVVgfsGaRYLP2JvwB,True,126334758,31583689,197680,98840,98840,3zqXX6kzhkbW3d4TwD2CNjMRwxTbREXySekvq37kfCNk,7907226,69268822,-61361596,625
2022-01-27 17:08:42-05:00,10844,4ytoBUwuhAL4YYSCa6AgwrpeVF4eeU8H9NfDxMPZKxPo,Pby2szzsxDrXt4gnbmmaMccXxctZALr8miRtKhGKjsD,True,424720,106180,662,331,331,2BPYaeCXY4BCFSGFSfiGtqmhzJ4fkhYLxGjqFvLCB6hG,26493,336598,-310105,623
2022-01-27 17:08:48-05:00,10845,442usWu6XpJZvU25bqXeynRrQ15jAzWwU9DWMgHpTn3Q,CtvADKp39bjJf3cPKWNL3wxnhq273fVM4fC5DmEcg5cC,True,323740112,80935028,505843,252921,252922,2BPYaeCXY4BCFSGFSfiGtqmhzJ4fkhYLxGjqFvLCB6hG,20233735,86775088,-66541353,624
2022-01-27 17:09:21-05:00,10846,EF6H6aW1p3qcAtiLFU9rbFYfsKfD683meHXDw8hLdaZK,8vfJbpnK7SQcjpEBCzZJRW8JosNbsmTeJ2YXZCbM225c,True,3094845,773711,4821,2410,2411,3zqXX6kzhkbW3d4TwD2CNjMRwxTbREXySekvq37kfCNk,192855,2206833,-2013978,623
2022-01-27 17:09:30-05:00,10847,8WHDaiE6LqFFmCVMnPeLEQ99R6ft8b74UfmP9BqzjcE8,CGmoDGsdnjo3zMNrW78n2xxQr1aDPAiBYiXbyciLXYMu,True,6351885,1587970,9930,4965,4965,2BPYaeCXY4BCFSGFSfiGtqmhzJ4fkhYLxGjqFvLCB6hG,397226,4941026,-4543800,625
2022-01-27 17:09:51-05:00,10848,Dv1BABsN7amhjmGBpMQsnMkRLx7MuCVwsnuyTQeZ6uum,BCjscxVo1h16teND6KKiAUy1ftNGTMy1vEEEyAW4ttVG,True,703106,175776,1092,546,546,2BPYaeCXY4BCFSGFSfiGtqmhzJ4fkhYLxGjqFvLCB6hG,43716,362705,-318989,621
2022-01-27 17:09:59-05:00,10849,Br1j5Ftafei7ysu5SmqVZSoRe4uS4qCPeKSPHg55pyiE,G8fc7QvXjfkgBFvAVUgJFQS3VaF1biL9rktBExGa87Ks,True,6729509,1682377,10505,5252,5253,2BPYaeCXY4BCFSGFSfiGtqmhzJ4fkhYLxGjqFvLCB6hG,420202,2545143,-2124941,624
2022-01-27 17:11:10-05:00,10850,3HuYXkGL9jnp7iLZ6dMmC5dNcmTxPdpAEGZhPzxCDD1F,DeoJsUX13b9HjDU2RMWq5wgQEVriEho9cDEqBbRKLRn9,True,411184303,102796075,639962,319981,319981,2BPYaeCXY4BCFSGFSfiGtqmhzJ4fkhYLxGjqFvLCB6hG,25598482,292917843,-267319361,622
2022-01-27 17:11:10-05:00,10851,GXfjQr2ihTfLRys1DMetVGocd1sU97KdoCJ6x4HxdW1U,9GHvjJJXjbVz5D3RBfP3njcdRRXnFsXZ68jFa2LiGwsy,True,8323753,2080938,12964,6482,6482,2BPYaeCXY4BCFSGFSfiGtqmhzJ4fkhYLxGjqFvLCB6hG,518594,6405336,-5886742,623
2022-01-27 17:11:14-05:00,10852,BHpLpoGQ27T6Q4CT8H4dzqS8KF8Vj5rqmqfcodoBzpgR,Akn3tG2hQBfBVtNYCeXchfzfcsyCuSpkGpFoMLEKwcBF,True,526086,131521,817,408,409,2BPYaeCXY4BCFSGFSfiGtqmhzJ4fkhYLxGjqFvLCB6hG,32681,421049,-388368,621
2022-01-27 17:11:14-05:00,10853,CCP5P6U4xBjea3snWgwBb5rtaounEAsNHpWzTUeNtVf9,GE2Bxc837ybP7sNR487U4bVbx68qyX2HtwPBLfEd4BDj,True,32621729,8155432,50675,25337,25338,2BPYaeCXY4BCFSGFSfiGtqmhzJ4fkhYLxGjqFvLCB6hG,2027038,18004510,-15977472,621
2022-01-27 17:11:28-05:00,10854,2r64Rnbu3ZjmJTHHUxxV9TWWGzwpAepA4ySbtKivBXCj,6RRzx6KLkMiFK9JSuznrSJGiPgkHwatBSskudHqbfKJ5,True,76448089,19112022,118589,59294,59295,2BPYaeCXY4BCFSGFSfiGtqmhzJ4fkhYLxGjqFvLCB6hG,4743572,55145262,-50401690,620
2022-01-27 17:11:30-05:00,10855,E5biUzKn2s5frKseCmfWriWjrYMGVtmLrhR9nYhAkVvR,BDHzqefisuGoMGcpML8t6KAC7rcErvhLcfV8KQC7oHAH,True,2051652,512913,3186,1593,1593,2BPYaeCXY4BCFSGFSfiGtqmhzJ4fkhYLxGjqFvLCB6hG,127472,1280867,-1153395,621
2022-01-27 17:11:30-05:00,10856,CQsFSBGcVgtmbzuvUkkSDtPuHFVSuFFaHVcNCM4tuXBs,8nJdA3thwEhzwvvtoAZ7mzMxuRjzp8uGRdDEWMHaDmKA,True,12497551,3124387,19423,9711,9712,2BPYaeCXY4BCFSGFSfiGtqmhzJ4fkhYLxGjqFvLCB6hG,776939,5150179,-4373240,621
2022-01-27 17:11:53-05:00,10857,GXSysysoV8Z4xBrQsaKUsSrpoWeTTUsbFmgfZDaQu4ZM,6FJyraiLgG3tb9B7pi4YFsJNtRVBNaghnm1ajzneVv7b,True,52542917,13135729,81816,40908,40908,2BPYaeCXY4BCFSGFSfiGtqmhzJ4fkhYLxGjqFvLCB6hG,3272650,30243472,-26970822,622
2022-01-27 17:11:53-05:00,10858,3wr6taSTMEdDKUej5NWod2uGUC4wutem5dKJjEgEZntD,E3cAAUyuDQT2hSxLG6fhyCxkPPUAMp2xyaDLFtbnxBzQ,True,600450388,150112596,937114,468557,468557,2BPYaeCXY4BCFSGFSfiGtqmhzJ4fkhYLxGjqFvLCB6hG,37484579,335615442,-298130863,624
2022-01-27 17:12:00-05:00,10859,9JNezn7M3xZF3GSVXYXQCH48HjURRvEQNon36ieFnRf9,4up5vAdJztB5GvdtuM6gvDHjBkrGM8DAW4EPaptDqCVC,True,38851760,9712940,60435,30217,30218,2BPYaeCXY4BCFSGFSfiGtqmhzJ4fkhYLxGjqFvLCB6hG,2417428,26918213,-24500785,622
2022-01-27 17:12:06-05:00,10860,CaAzPATicBzeb4mPpf7r7FLcLVV2V2jchT7QUFKs9enb,2z9rfVSTk8qG7f8b5S3FrJWidPKidaWw2X8vDiRETQqW,True,181846534,45461633,284048,142024,142024,2BPYaeCXY4BCFSGFSfiGtqmhzJ4fkhYLxGjqFvLCB6hG,11361948,89498449,-78136501,624
2022-01-27 17:12:23-05:00,10861,ARB1q7bNcQ7grwFEZC6nk9Pfrrg7yZ2WK8zVqq5CEE8F,53e8mUYrWzQnCm9XQyp18CL9owyPqJcYyxZANYhRypPx,True,11097406,2774351,17303,8651,8652,HfEnetJ7uBSmZWCjBNxdvv9HEC5nsW4wDV7wu6WnhWan,692130,2869728,-2177598,623
2022-01-27 17:12:27-05:00,10862,46TNhGwBVzedW8xSb9UY94HNeSom9iGiZzAjrKHiRM2G,7JVTiqNYeKHbyzRkKtvSEpqLPKykZso8cGUr3sX1j7QF,True,304038,76009,474,237,237,2BPYaeCXY4BCFSGFSfiGtqmhzJ4fkhYLxGjqFvLCB6hG,18980,264818,-245838,624
2022-01-27 17:12:36-05:00,10863,BH36ueAULprzjj6WabTgvivEcrx3VdDn8DTxSoro8Zym,6yydJKEmtZjUwURrs9gQ7EGkB86nK28ZDJQqNMgbPosA,True,34722009,8680501,54155,27077,27078,2BPYaeCXY4BCFSGFSfiGtqmhzJ4fkhYLxGjqFvLCB6hG,2166232,21922321,-19756089,623
2022-01-27 17:12:42-05:00,10864,9aQrdyfAvcBbBj7iKQB17eAS4zBqymdd3kzkTkuRhdLU,BDHhukMF5rALuSwCxaw8g73m2MN4oX1D4e7uNmx3SiVt,True,7373838,1843459,11529,5764,5765,2BPYaeCXY4BCFSGFSfiGtqmhzJ4fkhYLxGjqFvLCB6hG,461169,4166138,-3704969,625
2022-01-27 17:12:46-05:00,10865,Fn6J1eMQJoA5rXCwX2HjAF86AowsJfULLuYXVfzgb8aX,6Ett2WPmz4HoWVSVEZD73UzFetd3oFSh7C676MEVYd36,True,3710631915,927657978,5779342,2889671,2889671,3zqXX6kzhkbW3d4TwD2CNjMRwxTbREXySekvq37kfCNk,231173695,2294973161,-2063799466,623
2022-01-27 17:12:49-05:00,10866,HGAFdundf5voDqeh9g7d6Q9mgMf8eEg898QMRBqwPZ6C,deanBuZXWBHEe2TGfP37S9aMBEnEgmZoyRJjAvruzfA,True,181786,45445,283,141,142,3zqXX6kzhkbW3d4TwD2CNjMRwxTbREXySekvq37kfCNk,11322,213322,-202000,622
2022-01-27 17:12:53-05:00,10867,4ytoBUwuhAL4YYSCa6AgwrpeVF4eeU8H9NfDxMPZKxPo,Pby2szzsxDrXt4gnbmmaMccXxctZALr8miRtKhGKjsD,True,312086,78021,484,242,242,2BPYaeCXY4BCFSGFSfiGtqmhzJ4fkhYLxGjqFvLCB6hG,19377,258410,-239033,620
2022-01-27 17:12:54-05:00,10868,9psSuFHBGqCvcgNMc7aTMhKMMFwBDmW7v5Wkn22KtTHj,7zi9LSfuEhXccQXSRukRRwgQUaiQVVgfsGaRYLP2JvwB,True,92745716,23186429,142604,71302,71302,2BPYaeCXY4BCFSGFSfiGtqmhzJ4fkhYLxGjqFvLCB6hG,5704193,53730974,-48026781,615
2022-01-27 17:12:56-05:00,10869,H1Z83zVoskNuBvYao1FjdLfETfhPpQFQUkniJfGxbaNz,EVqbBRV6Zy1tPLRevxpAykp8Mvv6tDZVTc4RmCKw4Gq1,True,14699405,3674850,22923,11461,11462,2BPYaeCXY4BCFSGFSfiGtqmhzJ4fkhYLxGjqFvLCB6hG,916933,12497752,-11580819,623
2022-01-27 17:12:57-05:00,10870,442usWu6XpJZvU25bqXeynRrQ15jAzWwU9DWMgHpTn3Q,CtvADKp39bjJf3cPKWNL3wxnhq273fVM4fC5DmEcg5cC,True,237846392,59461598,369230,184615,184615,3zqXX6kzhkbW3d4TwD2CNjMRwxTbREXySekvq37kfCNk,14769200,69635134,-54865934,620
2022-01-27 17:13:14-05:00,10871,Ew46nMa9TojSd6MHZjJm79LbLKzF2RbheniWUyBHuXvn,FjzRjSD6qiXcwwFXsFfmKGZbfmfZEYPpqrjc4RAX2Tt,True,3242673526,810668381,5035358,2517679,2517679,2BPYaeCXY4BCFSGFSfiGtqmhzJ4fkhYLxGjqFvLCB6hG,201414359,749880833,-548466474,621
2022-01-27 17:13:19-05:00,10872,6K2m4zFPFjecwWFiNFYXKzwuEXV8GKxYHsq6Kcq4S4xW,GxaHi77G2tXJzhL77GiH7pgiW76H7AeBhziu6YYtU6xc,True,755121483,188780370,1180691,590345,590346,2BPYaeCXY4BCFSGFSfiGtqmhzJ4fkhYLxGjqFvLCB6hG,47227666,522134246,-474906580,625
2022-01-27 17:14:06-05:00,10873,5BJnMHFSiQjHRGFJDW1jnqCfkHHYWnQzmmccy9eA4jNj,9517JGYsPmvgPUM9pFRD2vipHmdgE578F7jA7Qq6jorm,True,48656416,12164104,75987,37993,37994,2BPYaeCXY4BCFSGFSfiGtqmhzJ4fkhYLxGjqFvLCB6hG,3039510,18161326,-15121816,624
2022-01-27 17:14:41-05:00,10874,Dv1BABsN7amhjmGBpMQsnMkRLx7MuCVwsnuyTQeZ6uum,BCjscxVo1h16teND6KKiAUy1ftNGTMy1vEEEyAW4ttVG,True,517006,129251,807,403,404,2BPYaeCXY4BCFSGFSfiGtqmhzJ4fkhYLxGjqFvLCB6hG,32300,281867,-249567,624
2022-01-27 17:15:03-05:00,10875,Br1j5Ftafei7ysu5SmqVZSoRe4uS4qCPeKSPHg55pyiE,G8fc7QvXjfkgBFvAVUgJFQS3VaF1biL9rktBExGa87Ks,True,4944644,1236161,7680,3840,3840,2BPYaeCXY4BCFSGFSfiGtqmhzJ4fkhYLxGjqFvLCB6hG,307209,2003404,-1696195,621
2022-01-28 04:11:13-05:00,10876,BCGTaPQxGEMjD7xUxwfwmVVYJ9CEGH33yJRi3QjwyiLE,JBct1cZ9a959UKwABBEefwxZnGTAAGLzyUdXrXqGGCZd,True,15268882,3817220,23850,11925,11925,2BPYaeCXY4BCFSGFSfiGtqmhzJ4fkhYLxGjqFvLCB6hG,954008,4437505,-3483497,624
2022-01-28 05:08:41-05:00,10877,2rLWe1XADCU93guPU6WgSW6x56gYNfif9bm11V93mJnv,BEGhQRm3fgSHeBtk2DYrXEBPKPRvS3sHyTNopmoBJxMs,True,4111871858,1027967964,6423966,3211983,3211983,2BPYaeCXY4BCFSGFSfiGtqmhzJ4fkhYLxGjqFvLCB6hG,256958660,2105783672,-1848825012,624
2022-01-28 05:08:41-05:00,10878,BHpLpoGQ27T6Q4CT8H4dzqS8KF8Vj5rqmqfcodoBzpgR,Akn3tG2hQBfBVtNYCeXchfzfcsyCuSpkGpFoMLEKwcBF,True,387141,96785,590,295,295,2BPYaeCXY4BCFSGFSfiGtqmhzJ4fkhYLxGjqFvLCB6hG,23617,322318,-298701,610
2022-01-28 05:08:42-05:00,10879,GXfjQr2ihTfLRys1DMetVGocd1sU97KdoCJ6x4HxdW1U,9GHvjJJXjbVz5D3RBfP3njcdRRXnFsXZ68jFa2LiGwsy,True,6121730,1530432,9288,4644,4644,3zqXX6kzhkbW3d4TwD2CNjMRwxTbREXySekvq37kfCNk,371530,4907673,-4536143,606
2022-01-28 05:08:43-05:00,10880,CCP5P6U4xBjea3snWgwBb5rtaounEAsNHpWzTUeNtVf9,GE2Bxc837ybP7sNR487U4bVbx68qyX2HtwPBLfEd4BDj,True,24002889,6000722,36547,18273,18274,2BPYaeCXY4BCFSGFSfiGtqmhzJ4fkhYLxGjqFvLCB6hG,1461919,13908447,-12446528,609
2022-01-28 05:51:23-05:00,10881,5BJnMHFSiQjHRGFJDW1jnqCfkHHYWnQzmmccy9eA4jNj,9517JGYsPmvgPUM9pFRD2vipHmdgE578F7jA7Qq6jorm,True,35825581,8956395,55430,27715,27715,HfEnetJ7uBSmZWCjBNxdvv9HEC5nsW4wDV7wu6WnhWan,2217210,14225351,-12008141,618
2022-01-28 05:51:44-05:00,10882,AQr9mVmcXCNQhBVCfx63MwR6c4WqDSC9K2BZqr7N8LCx,CB7TWUaL381ounsLw6neAUaKRxJL9P1HC9uGX5e1Uxod,True,384071225,96017806,599327,299663,299664,HfEnetJ7uBSmZWCjBNxdvv9HEC5nsW4wDV7wu6WnhWan,23973107,92189882,-68216775,624
2022-01-28 06:08:37-05:00,10883,HEFpdWLZaiQnjftmXgxs6RNzhH72YiMjortxPkKekkvb,5Q8mmxBgVTijNGrWsnoA3VMArLHZEX5MkaigYXHpgXHE,True,5242040,1310509,8203,4101,4102,3zqXX6kzhkbW3d4TwD2CNjMRwxTbREXySekvq37kfCNk,328138,2422604,-2094466,625
2022-01-28 06:11:58-05:00,10884,BH36ueAULprzjj6WabTgvivEcrx3VdDn8DTxSoro8Zym,6yydJKEmtZjUwURrs9gQ7EGkB86nK28ZDJQqNMgbPosA,True,25591707,6397926,40018,20009,20009,2BPYaeCXY4BCFSGFSfiGtqmhzJ4fkhYLxGjqFvLCB6hG,1600724,16867606,-15266882,625
2022-01-28 06:18:35-05:00,10885,CQsFSBGcVgtmbzuvUkkSDtPuHFVSuFFaHVcNCM4tuXBs,8nJdA3thwEhzwvvtoAZ7mzMxuRjzp8uGRdDEWMHaDmKA,True,9198995,2299748,14046,7023,7023,HfEnetJ7uBSmZWCjBNxdvv9HEC5nsW4wDV7wu6WnhWan,561858,4015960,-3454102,610
2022-01-28 06:18:35-05:00,10886,E5biUzKn2s5frKseCmfWriWjrYMGVtmLrhR9nYhAkVvR,BDHzqefisuGoMGcpML8t6KAC7rcErvhLcfV8KQC7oHAH,True,1510123,377530,2303,1151,1152,3zqXX6kzhkbW3d4TwD2CNjMRwxTbREXySekvq37kfCNk,92143,985806,-893663,610
2022-01-28 06:18:36-05:00,10887,CZsnNXD5oC348mWZeawVj4K2bGxpTiXZzkpm8QtXLbBW,FmBXczLq7hkauf7C4JoxH5TY8HHJ83U5xqGXK3j6t5Fw,True,608726152,152181538,919474,459737,459737,2BPYaeCXY4BCFSGFSfiGtqmhzJ4fkhYLxGjqFvLCB6hG,36778969,598684804,-561905835,604
2022-01-28 06:18:36-05:00,10888,GXSysysoV8Z4xBrQsaKUsSrpoWeTTUsbFmgfZDaQu4ZM,6FJyraiLgG3tb9B7pi4YFsJNtRVBNaghnm1ajzneVv7b,True,38647692,9661923,58521,29260,29261,2BPYaeCXY4BCFSGFSfiGtqmhzJ4fkhYLxGjqFvLCB6hG,2340870,23328524,-20987654,605
2022-01-28 06:18:37-05:00,10889,9JNezn7M3xZF3GSVXYXQCH48HjURRvEQNon36ieFnRf9,4up5vAdJztB5GvdtuM6gvDHjBkrGM8DAW4EPaptDqCVC,True,28590617,7147654,43546,21773,21773,2BPYaeCXY4BCFSGFSfiGtqmhzJ4fkhYLxGjqFvLCB6hG,1741853,20665670,-18923817,609
2022-01-28 06:18:37-05:00,10890,CaAzPATicBzeb4mPpf7r7FLcLVV2V2jchT7QUFKs9enb,2z9rfVSTk8qG7f8b5S3FrJWidPKidaWw2X8vDiRETQqW,True,133742842,33435710,203062,101531,101531,2BPYaeCXY4BCFSGFSfiGtqmhzJ4fkhYLxGjqFvLCB6hG,8122492,69367390,-61244898,607
2022-01-28 06:18:38-05:00,10891,ARB1q7bNcQ7grwFEZC6nk9Pfrrg7yZ2WK8zVqq5CEE8F,53e8mUYrWzQnCm9XQyp18CL9owyPqJcYyxZANYhRypPx,True,8164809,2041202,12436,6218,6218,2BPYaeCXY4BCFSGFSfiGtqmhzJ4fkhYLxGjqFvLCB6hG,497451,2288898,-1791447,609
2022-01-28 06:18:44-05:00,10892,3wr6taSTMEdDKUej5NWod2uGUC4wutem5dKJjEgEZntD,E3cAAUyuDQT2hSxLG6fhyCxkPPUAMp2xyaDLFtbnxBzQ,True,441306256,110326563,662504,331252,331252,HfEnetJ7uBSmZWCjBNxdvv9HEC5nsW4wDV7wu6WnhWan,26500169,259134257,-232634088,600
2022-01-28 06:18:45-05:00,10893,Fn6J1eMQJoA5rXCwX2HjAF86AowsJfULLuYXVfzgb8aX,6Ett2WPmz4HoWVSVEZD73UzFetd3oFSh7C676MEVYd36,True,2725553878,681388469,4038961,2019480,2019481,HfEnetJ7uBSmZWCjBNxdvv9HEC5nsW4wDV7wu6WnhWan,161558448,1767038118,-1605479670,592
2022-01-28 06:18:45-05:00,10894,9psSuFHBGqCvcgNMc7aTMhKMMFwBDmW7v5Wkn22KtTHj,7zi9LSfuEhXccQXSRukRRwgQUaiQVVgfsGaRYLP2JvwB,True,68231019,17057754,101817,50908,50909,HfEnetJ7uBSmZWCjBNxdvv9HEC5nsW4wDV7wu6WnhWan,4072719,41421201,-37348482,596
2022-01-28 06:18:46-05:00,10895,9aQrdyfAvcBbBj7iKQB17eAS4zBqymdd3kzkTkuRhdLU,BDHhukMF5rALuSwCxaw8g73m2MN4oX1D4e7uNmx3SiVt,True,5410878,1352719,7935,3967,3968,3zqXX6kzhkbW3d4TwD2CNjMRwxTbREXySekvq37kfCNk,317402,3215631,-2898229,586
2022-01-28 06:18:47-05:00,10896,4ytoBUwuhAL4YYSCa6AgwrpeVF4eeU8H9NfDxMPZKxPo,Pby2szzsxDrXt4gnbmmaMccXxctZALr8miRtKhGKjsD,True,229462,57365,343,171,172,3zqXX6kzhkbW3d4TwD2CNjMRwxTbREXySekvq37kfCNk,13750,197629,-183879,599
2022-01-28 06:18:47-05:00,10897,442usWu6XpJZvU25bqXeynRrQ15jAzWwU9DWMgHpTn3Q,CtvADKp39bjJf3cPKWNL3wxnhq273fVM4fC5DmEcg5cC,True,175003588,43750897,265169,132584,132585,3zqXX6kzhkbW3d4TwD2CNjMRwxTbREXySekvq37kfCNk,10606780,55138120,-44531340,606
2022-01-28 06:18:49-05:00,10898,Dv1BABsN7amhjmGBpMQsnMkRLx7MuCVwsnuyTQeZ6uum,BCjscxVo1h16teND6KKiAUy1ftNGTMy1vEEEyAW4ttVG,True,380668,95167,587,293,294,HfEnetJ7uBSmZWCjBNxdvv9HEC5nsW4wDV7wu6WnhWan,23506,217769,-194263,617
2022-01-28 06:18:51-05:00,10899,EF6H6aW1p3qcAtiLFU9rbFYfsKfD683meHXDw8hLdaZK,8vfJbpnK7SQcjpEBCzZJRW8JosNbsmTeJ2YXZCbM225c,True,2280124,570030,3538,1769,1769,2BPYaeCXY4BCFSGFSfiGtqmhzJ4fkhYLxGjqFvLCB6hG,141527,1693022,-1551495,620
2022-01-28 06:18:51-05:00,10900,8WHDaiE6LqFFmCVMnPeLEQ99R6ft8b74UfmP9BqzjcE8,CGmoDGsdnjo3zMNrW78n2xxQr1aDPAiBYiXbyciLXYMu,True,4671390,1167847,7110,3555,3555,HfEnetJ7uBSmZWCjBNxdvv9HEC5nsW4wDV7wu6WnhWan,284433,3784811,-3500378,608
2022-01-28 06:18:51-05:00,10901,Ew46nMa9TojSd6MHZjJm79LbLKzF2RbheniWUyBHuXvn,FjzRjSD6qiXcwwFXsFfmKGZbfmfZEYPpqrjc4RAX2Tt,True,2376837699,594209424,3389516,1694758,1694758,3zqXX6kzhkbW3d4TwD2CNjMRwxTbREXySekvq37kfCNk,135580669,602218723,-466638054,570
2022-01-28 06:18:52-05:00,10902,Br1j5Ftafei7ysu5SmqVZSoRe4uS4qCPeKSPHg55pyiE,G8fc7QvXjfkgBFvAVUgJFQS3VaF1biL9rktBExGa87Ks,True,3636011,909002,5460,2730,2730,3zqXX6kzhkbW3d4TwD2CNjMRwxTbREXySekvq37kfCNk,218438,1563057,-1344619,600
2022-01-28 06:18:55-05:00,10903,GXfjQr2ihTfLRys1DMetVGocd1sU97KdoCJ6x4HxdW1U,9GHvjJJXjbVz5D3RBfP3njcdRRXnFsXZ68jFa2LiGwsy,True,4500690,1125172,6767,3383,3384,2BPYaeCXY4BCFSGFSfiGtqmhzJ4fkhYLxGjqFvLCB6hG,270700,3763417,-3492717,601
2022-01-28 06:18:55-05:00,10904,CQsFSBGcVgtmbzuvUkkSDtPuHFVSuFFaHVcNCM4tuXBs,8nJdA3thwEhzwvvtoAZ7mzMxuRjzp8uGRdDEWMHaDmKA,True,6771125,1692781,10492,5246,5246,HfEnetJ7uBSmZWCjBNxdvv9HEC5nsW4wDV7wu6WnhWan,419690,3138390,-2718700,619
2022-01-28 06:18:57-05:00,10905,2r64Rnbu3ZjmJTHHUxxV9TWWGzwpAepA4ySbtKivBXCj,6RRzx6KLkMiFK9JSuznrSJGiPgkHwatBSskudHqbfKJ5,True,56193730,14048432,84327,42163,42164,3zqXX6kzhkbW3d4TwD2CNjMRwxTbREXySekvq37kfCNk,3373104,42316762,-38943658,600
2022-01-28 06:18:57-05:00,10906,CCP5P6U4xBjea3snWgwBb5rtaounEAsNHpWzTUeNtVf9,GE2Bxc837ybP7sNR487U4bVbx68qyX2HtwPBLfEd4BDj,True,17588483,4397120,25200,12600,12600,3zqXX6kzhkbW3d4TwD2CNjMRwxTbREXySekvq37kfCNk,1008026,10756615,-9748589,573
2022-01-28 06:18:57-05:00,10907,6K2m4zFPFjecwWFiNFYXKzwuEXV8GKxYHsq6Kcq4S4xW,GxaHi77G2tXJzhL77GiH7pgiW76H7AeBhziu6YYtU6xc,True,554605812,138651452,824484,412242,412242,2BPYaeCXY4BCFSGFSfiGtqmhzJ4fkhYLxGjqFvLCB6hG,32979377,400901859,-367922482,594
2022-01-28 06:18:57-05:00,10908,9JNezn7M3xZF3GSVXYXQCH48HjURRvEQNon36ieFnRf9,4up5vAdJztB5GvdtuM6gvDHjBkrGM8DAW4EPaptDqCVC,True,21053630,5263407,32724,16362,16362,HfEnetJ7uBSmZWCjBNxdvv9HEC5nsW4wDV7wu6WnhWan,1308974,15891184,-14582210,621
2022-01-28 06:18:58-05:00,10909,3HuYXkGL9jnp7iLZ6dMmC5dNcmTxPdpAEGZhPzxCDD1F,DeoJsUX13b9HjDU2RMWq5wgQEVriEho9cDEqBbRKLRn9,True,302442964,75610741,460446,230223,230223,2BPYaeCXY4BCFSGFSfiGtqmhzJ4fkhYLxGjqFvLCB6hG,18417871,224854440,-206436569,608
2022-01-28 06:18:58-05:00,10910,BHpLpoGQ27T6Q4CT8H4dzqS8KF8Vj5rqmqfcodoBzpgR,Akn3tG2hQBfBVtNYCeXchfzfcsyCuSpkGpFoMLEKwcBF,True,283454,70863,401,200,201,3zqXX6kzhkbW3d4TwD2CNjMRwxTbREXySekvq37kfCNk,16066,246995,-230929,566
2022-01-28 06:18:59-05:00,10911,CZsnNXD5oC348mWZeawVj4K2bGxpTiXZzkpm8QtXLbBW,FmBXczLq7hkauf7C4JoxH5TY8HHJ83U5xqGXK3j6t5Fw,True,447885191,111971297,680001,340000,340001,3zqXX6kzhkbW3d4TwD2CNjMRwxTbREXySekvq37kfCNk,27200072,457295910,-430095838,607
2022-01-28 06:18:59-05:00,10912,E5biUzKn2s5frKseCmfWriWjrYMGVtmLrhR9nYhAkVvR,BDHzqefisuGoMGcpML8t6KAC7rcErvhLcfV8KQC7oHAH,True,1108843,277210,1652,826,826,3zqXX6kzhkbW3d4TwD2CNjMRwxTbREXySekvq37kfCNk,66090,760088,-693998,596
2022-01-28 06:18:59-05:00,10913,GXSysysoV8Z4xBrQsaKUsSrpoWeTTUsbFmgfZDaQu4ZM,6FJyraiLgG3tb9B7pi4YFsJNtRVBNaghnm1ajzneVv7b,True,28437192,7109298,43344,21672,21672,HfEnetJ7uBSmZWCjBNxdvv9HEC5nsW4wDV7wu6WnhWan,1733772,18023113,-16289341,609
2022-01-28 06:19:01-05:00,10914,ARB1q7bNcQ7grwFEZC6nk9Pfrrg7yZ2WK8zVqq5CEE8F,53e8mUYrWzQnCm9XQyp18CL9owyPqJcYyxZANYhRypPx,True,6013964,1503491,9384,4692,4692,HfEnetJ7uBSmZWCjBNxdvv9HEC5nsW4wDV7wu6WnhWan,375372,1828602,-1453230,624
2022-01-28 06:19:01-05:00,10915,CaAzPATicBzeb4mPpf7r7FLcLVV2V2jchT7QUFKs9enb,2z9rfVSTk8qG7f8b5S3FrJWidPKidaWw2X8vDiRETQqW,True,98505921,24626480,152955,76477,76478,3zqXX6kzhkbW3d4TwD2CNjMRwxTbREXySekvq37kfCNk,6118219,53853362,-47735143,621
2022-01-28 06:19:06-05:00,10916,9aQrdyfAvcBbBj7iKQB17eAS4zBqymdd3kzkTkuRhdLU,BDHhukMF5rALuSwCxaw8g73m2MN4oX1D4e7uNmx3SiVt,True,3992389,998097,6092,3046,3046,3zqXX6kzhkbW3d4TwD2CNjMRwxTbREXySekvq37kfCNk,243697,2483140,-2239443,610
2022-01-28 06:19:07-05:00,10917,3wr6taSTMEdDKUej5NWod2uGUC4wutem5dKJjEgEZntD,E3cAAUyuDQT2hSxLG6fhyCxkPPUAMp2xyaDLFtbnxBzQ,True,325392378,81348094,506258,253129,253129,3zqXX6kzhkbW3d4TwD2CNjMRwxTbREXySekvq37kfCNk,20250350,200315681,-180065331,622
2022-01-28 06:19:07-05:00,10918,Fn6J1eMQJoA5rXCwX2HjAF86AowsJfULLuYXVfzgb8aX,6Ett2WPmz4HoWVSVEZD73UzFetd3oFSh7C676MEVYd36,True,2010595013,502648753,3098727,1549363,1549364,HfEnetJ7uBSmZWCjBNxdvv9HEC5nsW4wDV7wu6WnhWan,123949091,1361746156,-1237797065,616
2022-01-28 06:19:09-05:00,10919,9psSuFHBGqCvcgNMc7aTMhKMMFwBDmW7v5Wkn22KtTHj,7zi9LSfuEhXccQXSRukRRwgQUaiQVVgfsGaRYLP2JvwB,True,50319414,12579853,77926,38963,38963,HfEnetJ7uBSmZWCjBNxdvv9HEC5nsW4wDV7wu6WnhWan,3117051,31982336,-28865285,619
2022-01-28 06:19:13-05:00,10920,442usWu6XpJZvU25bqXeynRrQ15jAzWwU9DWMgHpTn3Q,CtvADKp39bjJf3cPKWNL3wxnhq273fVM4fC5DmEcg5cC,True,128949916,32237479,200970,100485,100485,HfEnetJ7uBSmZWCjBNxdvv9HEC5nsW4wDV7wu6WnhWan,8038836,43740497,-35701661,623
2022-01-28 06:19:19-05:00,10921,4ytoBUwuhAL4YYSCa6AgwrpeVF4eeU8H9NfDxMPZKxPo,Pby2szzsxDrXt4gnbmmaMccXxctZALr8miRtKhGKjsD,True,168892,42223,255,127,128,HfEnetJ7uBSmZWCjBNxdvv9HEC5nsW4wDV7wu6WnhWan,10202,151317,-141115,604
2022-01-28 06:19:22-05:00,10922,FuoFPNTdYVDkSHaBac6UC1aNJXafSNTvFJuBCdrgQQrH,ApBS1Fx83tcECMzDV6wEzEzEdg4e2hgj3djtjRUoSKK5,True,8691884,2172970,13525,6762,6763,3zqXX6kzhkbW3d4TwD2CNjMRwxTbREXySekvq37kfCNk,541023,7281776,-6740753,622
2022-01-28 06:19:26-05:00,10923,Ew46nMa9TojSd6MHZjJm79LbLKzF2RbheniWUyBHuXvn,FjzRjSD6qiXcwwFXsFfmKGZbfmfZEYPpqrjc4RAX2Tt,True,1758348497,439587124,2697784,1348892,1348892,3zqXX6kzhkbW3d4TwD2CNjMRwxTbREXySekvq37kfCNk,107911375,482236848,-374325473,613
2022-01-28 06:27:09-05:00,10924,9Wzu7BWPgx9JRwuituo7vxNXVkpRA7C5W62CATnPpy6Q,GYPiAfGtfkMjDKdi6MrM7VXzpSwPnp2qWwwCX4iFGVtq,True,1850511309,462627827,2891442,1445721,1445721,2BPYaeCXY4BCFSGFSfiGtqmhzJ4fkhYLxGjqFvLCB6hG,115657681,892248072,-776590391,625
2022-01-28 06:39:59-05:00,10925,BH36ueAULprzjj6WabTgvivEcrx3VdDn8DTxSoro8Zym,6yydJKEmtZjUwURrs9gQ7EGkB86nK28ZDJQqNMgbPosA,True,18808312,4702077,29380,14690,14690,2BPYaeCXY4BCFSGFSfiGtqmhzJ4fkhYLxGjqFvLCB6hG,1175237,13010876,-11835639,624
2022-01-28 06:40:20-05:00,10926,46TNhGwBVzedW8xSb9UY94HNeSom9iGiZzAjrKHiRM2G,7JVTiqNYeKHbyzRkKtvSEpqLPKykZso8cGUr3sX1j7QF,True,223997,55998,350,175,175,3zqXX6kzhkbW3d4TwD2CNjMRwxTbREXySekvq37kfCNk,14008,202421,-188413,625
2022-01-28 06:41:55-05:00,10927,Dv1BABsN7amhjmGBpMQsnMkRLx7MuCVwsnuyTQeZ6uum,BCjscxVo1h16teND6KKiAUy1ftNGTMy1vEEEyAW4ttVG,True,280028,70007,436,218,218,2BPYaeCXY4BCFSGFSfiGtqmhzJ4fkhYLxGjqFvLCB6hG,17446,168617,-151171,623
2022-01-28 06:41:55-05:00,10928,Br1j5Ftafei7ysu5SmqVZSoRe4uS4qCPeKSPHg55pyiE,G8fc7QvXjfkgBFvAVUgJFQS3VaF1biL9rktBExGa87Ks,True,2681087,670271,4176,2088,2088,2BPYaeCXY4BCFSGFSfiGtqmhzJ4fkhYLxGjqFvLCB6hG,167056,1221444,-1054388,623
2022-01-28 06:42:38-05:00,10929,BHpLpoGQ27T6Q4CT8H4dzqS8KF8Vj5rqmqfcodoBzpgR,Akn3tG2hQBfBVtNYCeXchfzfcsyCuSpkGpFoMLEKwcBF,True,210013,52503,327,163,164,HfEnetJ7uBSmZWCjBNxdvv9HEC5nsW4wDV7wu6WnhWan,13087,188863,-175776,623
2022-01-28 06:42:38-05:00,10930,CCP5P6U4xBjea3snWgwBb5rtaounEAsNHpWzTUeNtVf9,GE2Bxc837ybP7sNR487U4bVbx68qyX2HtwPBLfEd4BDj,True,13022536,3255634,20349,10174,10175,3zqXX6kzhkbW3d4TwD2CNjMRwxTbREXySekvq37kfCNk,813999,8294274,-7480275,625
2022-01-28 06:42:51-05:00,10931,GXfjQr2ihTfLRys1DMetVGocd1sU97KdoCJ6x4HxdW1U,9GHvjJJXjbVz5D3RBfP3njcdRRXnFsXZ68jFa2LiGwsy,True,3319006,829751,5185,2592,2593,2BPYaeCXY4BCFSGFSfiGtqmhzJ4fkhYLxGjqFvLCB6hG,207421,2883472,-2676051,624
2022-01-28 06:43:17-05:00,10932,BCGTaPQxGEMjD7xUxwfwmVVYJ9CEGH33yJRi3QjwyiLE,JBct1cZ9a959UKwABBEefwxZnGTAAGLzyUdXrXqGGCZd,True,11228494,2807123,17542,8771,8771,2BPYaeCXY4BCFSGFSfiGtqmhzJ4fkhYLxGjqFvLCB6hG,701701,3537497,-2835796,624
2022-01-28 06:54:55-05:00,10933,E5biUzKn2s5frKseCmfWriWjrYMGVtmLrhR9nYhAkVvR,BDHzqefisuGoMGcpML8t6KAC7rcErvhLcfV8KQC7oHAH,True,818338,204584,1278,639,639,3zqXX6kzhkbW3d4TwD2CNjMRwxTbREXySekvq37kfCNk,51143,584938,-533795,624
2022-01-28 06:55:03-05:00,10934,CQsFSBGcVgtmbzuvUkkSDtPuHFVSuFFaHVcNCM4tuXBs,8nJdA3thwEhzwvvtoAZ7mzMxuRjzp8uGRdDEWMHaDmKA,True,4979892,1244973,7768,3884,3884,HfEnetJ7uBSmZWCjBNxdvv9HEC5nsW4wDV7wu6WnhWan,310746,2448224,-2137478,624
2022-01-28 06:55:21-05:00,10935,CZsnNXD5oC348mWZeawVj4K2bGxpTiXZzkpm8QtXLbBW,FmBXczLq7hkauf7C4JoxH5TY8HHJ83U5xqGXK3j6t5Fw,True,330035145,82508786,516033,258016,258017,HfEnetJ7uBSmZWCjBNxdvv9HEC5nsW4wDV7wu6WnhWan,20641322,349095872,-328454550,625
2022-01-28 06:55:28-05:00,10936,GXSysysoV8Z4xBrQsaKUsSrpoWeTTUsbFmgfZDaQu4ZM,6FJyraiLgG3tb9B7pi4YFsJNtRVBNaghnm1ajzneVv7b,True,20945578,5236394,32702,16351,16351,HfEnetJ7uBSmZWCjBNxdvv9HEC5nsW4wDV7wu6WnhWan,1308112,13907447,-12599335,624
2022-01-28 07:20:42-05:00,10937,9JNezn7M3xZF3GSVXYXQCH48HjURRvEQNon36ieFnRf9,4up5vAdJztB5GvdtuM6gvDHjBkrGM8DAW4EPaptDqCVC,True,15484901,3871225,24184,12092,12092,2BPYaeCXY4BCFSGFSfiGtqmhzJ4fkhYLxGjqFvLCB6hG,967397,12209385,-11241988,624
2022-01-28 07:20:55-05:00,10938,CaAzPATicBzeb4mPpf7r7FLcLVV2V2jchT7QUFKs9enb,2z9rfVSTk8qG7f8b5S3FrJWidPKidaWw2X8vDiRETQqW,True,72461915,18115478,113280,56640,56640,HfEnetJ7uBSmZWCjBNxdvv9HEC5nsW4wDV7wu6WnhWan,4531206,41750234,-37219028,625
2022-01-28 07:20:59-05:00,10939,ARB1q7bNcQ7grwFEZC6nk9Pfrrg7yZ2WK8zVqq5CEE8F,53e8mUYrWzQnCm9XQyp18CL9owyPqJcYyxZANYhRypPx,True,4422208,1105552,6917,3458,3459,2BPYaeCXY4BCFSGFSfiGtqmhzJ4fkhYLxGjqFvLCB6hG,276714,1454903,-1178189,625
2022-01-28 07:21:09-05:00,10940,6K2m4zFPFjecwWFiNFYXKzwuEXV8GKxYHsq6Kcq4S4xW,GxaHi77G2tXJzhL77GiH7pgiW76H7AeBhziu6YYtU6xc,True,409222316,102305578,633317,316658,316659,HfEnetJ7uBSmZWCjBNxdvv9HEC5nsW4wDV7wu6WnhWan,25332714,308010653,-282677939,619
2022-01-28 07:21:10-05:00,10941,9aQrdyfAvcBbBj7iKQB17eAS4zBqymdd3kzkTkuRhdLU,BDHhukMF5rALuSwCxaw8g73m2MN4oX1D4e7uNmx3SiVt,True,2940142,735035,4569,2284,2285,HfEnetJ7uBSmZWCjBNxdvv9HEC5nsW4wDV7wu6WnhWan,182783,1916516,-1733733,621
2022-01-28 07:21:33-05:00,10942,Fn6J1eMQJoA5rXCwX2HjAF86AowsJfULLuYXVfzgb8aX,6Ett2WPmz4HoWVSVEZD73UzFetd3oFSh7C676MEVYd36,True,1479750511,369937627,2307902,1153951,1153951,HfEnetJ7uBSmZWCjBNxdvv9HEC5nsW4wDV7wu6WnhWan,92316084,1048924860,-956608776,623
2022-01-28 07:21:47-05:00,10943,9psSuFHBGqCvcgNMc7aTMhKMMFwBDmW7v5Wkn22KtTHj,7zi9LSfuEhXccQXSRukRRwgQUaiQVVgfsGaRYLP2JvwB,True,37026645,9256661,57943,28971,28972,2BPYaeCXY4BCFSGFSfiGtqmhzJ4fkhYLxGjqFvLCB6hG,2317736,24679657,-22361921,625
2022-01-28 07:21:47-05:00,10944,4ytoBUwuhAL4YYSCa6AgwrpeVF4eeU8H9NfDxMPZKxPo,Pby2szzsxDrXt4gnbmmaMccXxctZALr8miRtKhGKjsD,True,124539,31134,194,97,97,HfEnetJ7uBSmZWCjBNxdvv9HEC5nsW4wDV7wu6WnhWan,7789,115756,-107967,625
2022-01-28 07:22:21-05:00,10945,8WHDaiE6LqFFmCVMnPeLEQ99R6ft8b74UfmP9BqzjcE8,CGmoDGsdnjo3zMNrW78n2xxQr1aDPAiBYiXbyciLXYMu,True,3441823,860455,5370,2685,2685,2BPYaeCXY4BCFSGFSfiGtqmhzJ4fkhYLxGjqFvLCB6hG,214825,2901831,-2687006,624
2022-01-28 07:22:33-05:00,10946,EF6H6aW1p3qcAtiLFU9rbFYfsKfD683meHXDw8hLdaZK,8vfJbpnK7SQcjpEBCzZJRW8JosNbsmTeJ2YXZCbM225c,True,1676954,419238,2612,1306,1306,2BPYaeCXY4BCFSGFSfiGtqmhzJ4fkhYLxGjqFvLCB6hG,104495,1301259,-1196764,623
2022-01-28 07:22:33-05:00,10947,3HuYXkGL9jnp7iLZ6dMmC5dNcmTxPdpAEGZhPzxCDD1F,DeoJsUX13b9HjDU2RMWq5wgQEVriEho9cDEqBbRKLRn9,True,222824879,55706219,347522,173761,173761,3zqXX6kzhkbW3d4TwD2CNjMRwxTbREXySekvq37kfCNk,13900884,172736645,-158835761,623
2022-01-28 07:22:38-05:00,10948,3wr6taSTMEdDKUej5NWod2uGUC4wutem5dKJjEgEZntD,E3cAAUyuDQT2hSxLG6fhyCxkPPUAMp2xyaDLFtbnxBzQ,True,239270626,59817656,372882,186441,186441,2BPYaeCXY4BCFSGFSfiGtqmhzJ4fkhYLxGjqFvLCB6hG,14915306,154739328,-139824022,623
2022-01-28 07:22:42-05:00,10949,Ew46nMa9TojSd6MHZjJm79LbLKzF2RbheniWUyBHuXvn,FjzRjSD6qiXcwwFXsFfmKGZbfmfZEYPpqrjc4RAX2Tt,True,1294422628,323605657,2014443,1007221,1007222,2BPYaeCXY4BCFSGFSfiGtqmhzJ4fkhYLxGjqFvLCB6hG,80577736,385698104,-305120368,622
2022-01-28 07:22:47-05:00,10950,9fTuwsgtFHkUNTTeRR1DWYTno8bbdvNLvqjxLymzbnTe,DacYn36aCNRJmYKiP697yGJTPZDK1nCq7Q1Y7KiXW7Jq,True,48927311,12231827,75838,37919,37919,2BPYaeCXY4BCFSGFSfiGtqmhzJ4fkhYLxGjqFvLCB6hG,3033537,18649075,-15615538,620
2022-01-28 07:24:54-05:00,10951,Dng7By2saPu5TVxcvXidBe71ggBo8tiHkAXPi4kKL1tk,75ufEJmHbLHffphL7tvAXhGyftKLr1z2PXXoB2GGY5fG,True,13245085,3311271,20688,10344,10344,3zqXX6kzhkbW3d4TwD2CNjMRwxTbREXySekvq37kfCNk,827559,4939068,-4111509,624
2022-01-28 07:25:40-05:00,10952,8NRrJkrYDgMdG9zeU7YJv9FzRBHC4mBiErjhj1zyYKD5,H3N5FgK2Zb4iXGCfEDcDxdrwb5TCqjqzjz8UE1w6S34W,True,542268104,135567026,846379,423189,423190,2BPYaeCXY4BCFSGFSfiGtqmhzJ4fkhYLxGjqFvLCB6hG,33855164,140649060,-106793896,624
2022-01-28 07:25:51-05:00,10953,2r64Rnbu3ZjmJTHHUxxV9TWWGzwpAepA4ySbtKivBXCj,6RRzx6KLkMiFK9JSuznrSJGiPgkHwatBSskudHqbfKJ5,True,41460235,10365058,64837,32418,32419,HfEnetJ7uBSmZWCjBNxdvv9HEC5nsW4wDV7wu6WnhWan,2593501,32486338,-29892837,625
2022-01-28 07:26:30-05:00,10954,HGAFdundf5voDqeh9g7d6Q9mgMf8eEg898QMRBqwPZ6C,deanBuZXWBHEe2TGfP37S9aMBEnEgmZoyRJjAvruzfA,True,133970,33492,209,104,105,2BPYaeCXY4BCFSGFSfiGtqmhzJ4fkhYLxGjqFvLCB6hG,8365,162239,-153874,624
2022-01-28 07:26:47-05:00,10955,Dv1BABsN7amhjmGBpMQsnMkRLx7MuCVwsnuyTQeZ6uum,BCjscxVo1h16teND6KKiAUy1ftNGTMy1vEEEyAW4ttVG,True,205835,51458,319,159,160,2BPYaeCXY4BCFSGFSfiGtqmhzJ4fkhYLxGjqFvLCB6hG,12777,130342,-117565,620
2022-01-28 07:26:49-05:00,10956,Br1j5Ftafei7ysu5SmqVZSoRe4uS4qCPeKSPHg55pyiE,G8fc7QvXjfkgBFvAVUgJFQS3VaF1biL9rktBExGa87Ks,True,1970881,492720,3062,1531,1531,3zqXX6kzhkbW3d4TwD2CNjMRwxTbREXySekvq37kfCNk,122491,953218,-830727,621
2022-01-28 07:33:52-05:00,10957,CCP5P6U4xBjea3snWgwBb5rtaounEAsNHpWzTUeNtVf9,GE2Bxc837ybP7sNR487U4bVbx68qyX2HtwPBLfEd4BDj,True,9574788,2393697,14983,7491,7492,2BPYaeCXY4BCFSGFSfiGtqmhzJ4fkhYLxGjqFvLCB6hG,599324,6401648,-5802324,625
2022-01-28 07:33:52-05:00,10958,BHpLpoGQ27T6Q4CT8H4dzqS8KF8Vj5rqmqfcodoBzpgR,Akn3tG2hQBfBVtNYCeXchfzfcsyCuSpkGpFoMLEKwcBF,True,154412,38603,240,120,120,2BPYaeCXY4BCFSGFSfiGtqmhzJ4fkhYLxGjqFvLCB6hG,9627,144558,-134931,623
2022-01-28 07:34:23-05:00,10959,GXfjQr2ihTfLRys1DMetVGocd1sU97KdoCJ6x4HxdW1U,9GHvjJJXjbVz5D3RBfP3njcdRRXnFsXZ68jFa2LiGwsy,True,2440063,610015,3812,1906,1906,2BPYaeCXY4BCFSGFSfiGtqmhzJ4fkhYLxGjqFvLCB6hG,152480,2208712,-2056232,624
2022-01-28 07:37:56-05:00,10960,E5biUzKn2s5frKseCmfWriWjrYMGVtmLrhR9nYhAkVvR,BDHzqefisuGoMGcpML8t6KAC7rcErvhLcfV8KQC7oHAH,True,601586,150396,938,469,469,3zqXX6kzhkbW3d4TwD2CNjMRwxTbREXySekvq37kfCNk,37558,450073,-412515,624
2022-01-28 07:38:04-05:00,10961,2rLWe1XADCU93guPU6WgSW6x56gYNfif9bm11V93mJnv,BEGhQRm3fgSHeBtk2DYrXEBPKPRvS3sHyTNopmoBJxMs,True,3023032439,755758109,4703198,2351599,2351599,2BPYaeCXY4BCFSGFSfiGtqmhzJ4fkhYLxGjqFvLCB6hG,188127928,1635992791,-1447864863,622
2022-01-28 07:38:09-05:00,10962,CQsFSBGcVgtmbzuvUkkSDtPuHFVSuFFaHVcNCM4tuXBs,8nJdA3thwEhzwvvtoAZ7mzMxuRjzp8uGRdDEWMHaDmKA,True,3661588,915397,5719,2859,2860,2BPYaeCXY4BCFSGFSfiGtqmhzJ4fkhYLxGjqFvLCB6hG,228797,1905238,-1676441,624
2022-01-28 07:38:36-05:00,10963,CZsnNXD5oC348mWZeawVj4K2bGxpTiXZzkpm8QtXLbBW,FmBXczLq7hkauf7C4JoxH5TY8HHJ83U5xqGXK3j6t5Fw,True,242561486,60640371,377600,188800,188800,3zqXX6kzhkbW3d4TwD2CNjMRwxTbREXySekvq37kfCNk,15104028,266412001,-251307973,622
2022-01-28 07:38:40-05:00,10964,GXSysysoV8Z4xBrQsaKUsSrpoWeTTUsbFmgfZDaQu4ZM,6FJyraiLgG3tb9B7pi4YFsJNtRVBNaghnm1ajzneVv7b,True,15395471,3848867,23952,11976,11976,3zqXX6kzhkbW3d4TwD2CNjMRwxTbREXySekvq37kfCNk,958118,10721340,-9763222,622
2022-01-28 07:38:56-05:00,10965,9JNezn7M3xZF3GSVXYXQCH48HjURRvEQNon36ieFnRf9,4up5vAdJztB5GvdtuM6gvDHjBkrGM8DAW4EPaptDqCVC,True,11375759,2843939,17632,8816,8816,HfEnetJ7uBSmZWCjBNxdvv9HEC5nsW4wDV7wu6WnhWan,705296,9374709,-8669413,619
2022-01-28 07:38:58-05:00,10966,CyWBZ1xJ9LahUnPesbXLZ4Rr5UyWAHgVFYwfrnhyrkNL,2Lpk87Xth8ZL5J9BfzmMpEE3x76FDrrrmdKiCNkSVip2,True,541035,135258,846,423,423,2BPYaeCXY4BCFSGFSfiGtqmhzJ4fkhYLxGjqFvLCB6hG,33865,480445,-446580,625
2022-01-28 07:38:58-05:00,10967,CaAzPATicBzeb4mPpf7r7FLcLVV2V2jchT7QUFKs9enb,2z9rfVSTk8qG7f8b5S3FrJWidPKidaWw2X8vDiRETQqW,True,53251043,13312760,83063,41531,41532,3zqXX6kzhkbW3d4TwD2CNjMRwxTbREXySekvq37kfCNk,3322532,32332278,-29009746,623
2022-01-28 07:39:41-05:00,10968,H1Z83zVoskNuBvYao1FjdLfETfhPpQFQUkniJfGxbaNz,EVqbBRV6Zy1tPLRevxpAykp8Mvv6tDZVTc4RmCKw4Gq1,True,10832543,2708135,16822,8411,8411,2BPYaeCXY4BCFSGFSfiGtqmhzJ4fkhYLxGjqFvLCB6hG,672896,9550532,-8877636,621
2022-01-28 07:39:50-05:00,10969,ARB1q7bNcQ7grwFEZC6nk9Pfrrg7yZ2WK8zVqq5CEE8F,53e8mUYrWzQnCm9XQyp18CL9owyPqJcYyxZANYhRypPx,True,3249491,812372,5065,2532,2533,2BPYaeCXY4BCFSGFSfiGtqmhzJ4fkhYLxGjqFvLCB6hG,202632,1153440,-950808,623
2022-01-28 07:51:00-05:00,10970,5BJnMHFSiQjHRGFJDW1jnqCfkHHYWnQzmmccy9eA4jNj,9517JGYsPmvgPUM9pFRD2vipHmdgE578F7jA7Qq6jorm,True,26368785,6592196,41197,20598,20599,2BPYaeCXY4BCFSGFSfiGtqmhzJ4fkhYLxGjqFvLCB6hG,1647899,11154433,-9506534,624
2022-01-28 13:01:59-05:00,10971,9aQrdyfAvcBbBj7iKQB17eAS4zBqymdd3kzkTkuRhdLU,BDHhukMF5rALuSwCxaw8g73m2MN4oX1D4e7uNmx3SiVt,True,2164549,541137,3374,1687,1687,2BPYaeCXY4BCFSGFSfiGtqmhzJ4fkhYLxGjqFvLCB6hG,134976,1475835,-1340859,623
2022-01-28 13:02:15-05:00,10972,Fn6J1eMQJoA5rXCwX2HjAF86AowsJfULLuYXVfzgb8aX,6Ett2WPmz4HoWVSVEZD73UzFetd3oFSh7C676MEVYd36,True,1088725136,272181284,1689260,844630,844630,3zqXX6kzhkbW3d4TwD2CNjMRwxTbREXySekvq37kfCNk,67570400,806151078,-738580678,620
2022-01-28 13:02:18-05:00,10973,9psSuFHBGqCvcgNMc7aTMhKMMFwBDmW7v5Wkn22KtTHj,7zi9LSfuEhXccQXSRukRRwgQUaiQVVgfsGaRYLP2JvwB,True,27241431,6810357,42436,21218,21218,HfEnetJ7uBSmZWCjBNxdvv9HEC5nsW4wDV7wu6WnhWan,1697449,18997466,-17300017,623
2022-01-28 13:02:18-05:00,10974,4ytoBUwuhAL4YYSCa6AgwrpeVF4eeU8H9NfDxMPZKxPo,Pby2szzsxDrXt4gnbmmaMccXxctZALr8miRtKhGKjsD,True,91627,22906,142,71,71,2BPYaeCXY4BCFSGFSfiGtqmhzJ4fkhYLxGjqFvLCB6hG,5704,88459,-82755,622
2022-01-28 14:31:20-05:00,10975,BH36ueAULprzjj6WabTgvivEcrx3VdDn8DTxSoro8Zym,6yydJKEmtZjUwURrs9gQ7EGkB86nK28ZDJQqNMgbPosA,True,13841516,3460379,21495,10747,10748,2BPYaeCXY4BCFSGFSfiGtqmhzJ4fkhYLxGjqFvLCB6hG,859824,10001278,-9141454,621
2022-01-30 07:53:45-05:00,10976,9Wzu7BWPgx9JRwuituo7vxNXVkpRA7C5W62CATnPpy6Q,GYPiAfGtfkMjDKdi6MrM7VXzpSwPnp2qWwwCX4iFGVtq,True,1368330388,342082597,2132593,1066296,1066297,2BPYaeCXY4BCFSGFSfiGtqmhzJ4fkhYLxGjqFvLCB6hG,85303731,687374535,-602070804,623
2022-01-30 07:53:47-05:00,10977,BCGTaPQxGEMjD7xUxwfwmVVYJ9CEGH33yJRi3QjwyiLE,JBct1cZ9a959UKwABBEefwxZnGTAAGLzyUdXrXqGGCZd,True,8302615,2075653,12934,6467,6467,HfEnetJ7uBSmZWCjBNxdvv9HEC5nsW4wDV7wu6WnhWan,517370,2762976,-2245606,623
2022-01-30 09:21:39-05:00,10978,2rLWe1XADCU93guPU6WgSW6x56gYNfif9bm11V93mJnv,BEGhQRm3fgSHeBtk2DYrXEBPKPRvS3sHyTNopmoBJxMs,True,2233982517,558495629,3430583,1715291,1715292,HfEnetJ7uBSmZWCjBNxdvv9HEC5nsW4wDV7wu6WnhWan,137223359,1256622501,-1119399142,614
2022-01-30 09:21:55-05:00,10979,5BJnMHFSiQjHRGFJDW1jnqCfkHHYWnQzmmccy9eA4jNj,9517JGYsPmvgPUM9pFRD2vipHmdgE578F7jA7Qq6jorm,True,19470476,4867619,29681,14840,14841,HfEnetJ7uBSmZWCjBNxdvv9HEC5nsW4wDV7wu6WnhWan,1187248,8623277,-7436029,609
2022-01-30 14:06:05-05:00,10980,9fTuwsgtFHkUNTTeRR1DWYTno8bbdvNLvqjxLymzbnTe,DacYn36aCNRJmYKiP697yGJTPZDK1nCq7Q1Y7KiXW7Jq,True,36257973,9064493,56536,28268,28268,HfEnetJ7uBSmZWCjBNxdvv9HEC5nsW4wDV7wu6WnhWan,2261474,14410671,-12149197,623
2022-01-30 14:08:39-05:00,10981,9Wzu7BWPgx9JRwuituo7vxNXVkpRA7C5W62CATnPpy6Q,GYPiAfGtfkMjDKdi6MrM7VXzpSwPnp2qWwwCX4iFGVtq,True,1006248293,251562073,1560572,780286,780286,HfEnetJ7uBSmZWCjBNxdvv9HEC5nsW4wDV7wu6WnhWan,62422895,534017342,-471594447,620
2022-01-30 14:08:45-05:00,10982,BH36ueAULprzjj6WabTgvivEcrx3VdDn8DTxSoro8Zym,6yydJKEmtZjUwURrs9gQ7EGkB86nK28ZDJQqNMgbPosA,True,10234124,2558530,15898,7949,7949,HfEnetJ7uBSmZWCjBNxdvv9HEC5nsW4wDV7wu6WnhWan,635922,7639029,-7003107,621
2022-01-30 14:08:45-05:00,10983,BCGTaPQxGEMjD7xUxwfwmVVYJ9CEGH33yJRi3QjwyiLE,JBct1cZ9a959UKwABBEefwxZnGTAAGLzyUdXrXqGGCZd,True,6104460,1526115,9434,4717,4717,HfEnetJ7uBSmZWCjBNxdvv9HEC5nsW4wDV7wu6WnhWan,377387,2184096,-1806709,618
2022-01-30 14:08:47-05:00,10984,8NRrJkrYDgMdG9zeU7YJv9FzRBHC4mBiErjhj1zyYKD5,H3N5FgK2Zb4iXGCfEDcDxdrwb5TCqjqzjz8UE1w6S34W,True,401028044,100257011,611576,305788,305788,HfEnetJ7uBSmZWCjBNxdvv9HEC5nsW4wDV7wu6WnhWan,24463061,110235077,-85772016,610
2022-01-30 14:08:50-05:00,10985,2rLWe1XADCU93guPU6WgSW6x56gYNfif9bm11V93mJnv,BEGhQRm3fgSHeBtk2DYrXEBPKPRvS3sHyTNopmoBJxMs,True,1642801744,410700436,2506666,1253333,1253333,2BPYaeCXY4BCFSGFSfiGtqmhzJ4fkhYLxGjqFvLCB6hG,100266669,972617701,-872351032,610
2022-01-30 14:08:50-05:00,10986,3HuYXkGL9jnp7iLZ6dMmC5dNcmTxPdpAEGZhPzxCDD1F,DeoJsUX13b9HjDU2RMWq5wgQEVriEho9cDEqBbRKLRn9,True,164773561,41193390,254592,127296,127296,2BPYaeCXY4BCFSGFSfiGtqmhzJ4fkhYLxGjqFvLCB6hG,10183707,131656178,-121472471,618
2022-01-30 14:08:52-05:00,10987,Br1j5Ftafei7ysu5SmqVZSoRe4uS4qCPeKSPHg55pyiE,G8fc7QvXjfkgBFvAVUgJFQS3VaF1biL9rktBExGa87Ks,True,1459739,364934,2263,1131,1132,HfEnetJ7uBSmZWCjBNxdvv9HEC5nsW4wDV7wu6WnhWan,90538,732006,-641468,620
2022-01-30 14:08:52-05:00,10988,3wr6taSTMEdDKUej5NWod2uGUC4wutem5dKJjEgEZntD,E3cAAUyuDQT2hSxLG6fhyCxkPPUAMp2xyaDLFtbnxBzQ,True,177104842,44276210,274122,137061,137061,2BPYaeCXY4BCFSGFSfiGtqmhzJ4fkhYLxGjqFvLCB6hG,10964909,118181815,-107216906,619
2022-01-30 14:08:52-05:00,10989,Dv1BABsN7amhjmGBpMQsnMkRLx7MuCVwsnuyTQeZ6uum,BCjscxVo1h16teND6KKiAUy1ftNGTMy1vEEEyAW4ttVG,True,152452,38113,236,118,118,2BPYaeCXY4BCFSGFSfiGtqmhzJ4fkhYLxGjqFvLCB6hG,9440,99540,-90100,619
2022-01-30 14:09:00-05:00,10990,F2AU2PjaSmHxWWhkz8XxMggkCMWbMVgawt89tSnYS6RL,ET9febRJiW197DYMaJbgk3kWsAeFv5f4peQ4vFCVppK6,True,5656685170,1414171292,8453153,4226576,4226577,HfEnetJ7uBSmZWCjBNxdvv9HEC5nsW4wDV7wu6WnhWan,338126143,1245140973,-907014830,597
2022-01-30 14:09:01-05:00,10991,5BJnMHFSiQjHRGFJDW1jnqCfkHHYWnQzmmccy9eA4jNj,9517JGYsPmvgPUM9pFRD2vipHmdgE578F7jA7Qq6jorm,True,14339640,3584910,22174,11087,11087,2BPYaeCXY4BCFSGFSfiGtqmhzJ4fkhYLxGjqFvLCB6hG,886967,6727215,-5840248,618
2022-01-30 14:09:10-05:00,10992,BHpLpoGQ27T6Q4CT8H4dzqS8KF8Vj5rqmqfcodoBzpgR,Akn3tG2hQBfBVtNYCeXchfzfcsyCuSpkGpFoMLEKwcBF,True,114401,28600,178,89,89,3zqXX6kzhkbW3d4TwD2CNjMRwxTbREXySekvq37kfCNk,7158,109765,-102607,625
2022-01-30 14:09:27-05:00,10993,CCP5P6U4xBjea3snWgwBb5rtaounEAsNHpWzTUeNtVf9,GE2Bxc837ybP7sNR487U4bVbx68qyX2HtwPBLfEd4BDj,True,7089608,1772402,11047,5523,5524,HfEnetJ7uBSmZWCjBNxdvv9HEC5nsW4wDV7wu6WnhWan,441917,4885145,-4443228,623
2022-01-30 14:09:35-05:00,10994,GXfjQr2ihTfLRys1DMetVGocd1sU97KdoCJ6x4HxdW1U,9GHvjJJXjbVz5D3RBfP3njcdRRXnFsXZ68jFa2LiGwsy,True,1807454,451863,2827,1413,1414,3zqXX6kzhkbW3d4TwD2CNjMRwxTbREXySekvq37kfCNk,113083,1677852,-1564769,625
2022-01-30 14:11:07-05:00,10995,C1RsUofKYFm9hwXTmNidJp1W7CexbxggaBcEA4dQrAUs,86w25xgPrB6oQocGHRjHVjyen6xWg78W6ji52aLzcFAc,True,223490462,55872615,349272,174636,174636,HfEnetJ7uBSmZWCjBNxdvv9HEC5nsW4wDV7wu6WnhWan,13970900,118314137,-104343237,625
2022-01-30 14:11:35-05:00,10996,E5biUzKn2s5frKseCmfWriWjrYMGVtmLrhR9nYhAkVvR,BDHzqefisuGoMGcpML8t6KAC7rcErvhLcfV8KQC7oHAH,True,445265,111316,687,343,344,2BPYaeCXY4BCFSGFSfiGtqmhzJ4fkhYLxGjqFvLCB6hG,27482,342794,-315312,617
2022-01-30 14:11:37-05:00,10997,CQsFSBGcVgtmbzuvUkkSDtPuHFVSuFFaHVcNCM4tuXBs,8nJdA3thwEhzwvvtoAZ7mzMxuRjzp8uGRdDEWMHaDmKA,True,2708214,677053,4138,2069,2069,HfEnetJ7uBSmZWCjBNxdvv9HEC5nsW4wDV7wu6WnhWan,165525,1460834,-1295309,611
2022-01-30 14:11:40-05:00,10998,GXSysysoV8Z4xBrQsaKUsSrpoWeTTUsbFmgfZDaQu4ZM,6FJyraiLgG3tb9B7pi4YFsJNtRVBNaghnm1ajzneVv7b,True,11387527,2846881,17316,8658,8658,2BPYaeCXY4BCFSGFSfiGtqmhzJ4fkhYLxGjqFvLCB6hG,692674,8174173,-7481499,608
2022-01-30 14:11:40-05:00,10999,CZsnNXD5oC348mWZeawVj4K2bGxpTiXZzkpm8QtXLbBW,FmBXczLq7hkauf7C4JoxH5TY8HHJ83U5xqGXK3j6t5Fw,True,179365355,44841338,271813,135906,135907,2BPYaeCXY4BCFSGFSfiGtqmhzJ4fkhYLxGjqFvLCB6hG,10872528,201910487,-191037959,606
2022-01-30 14:11:42-05:00,11000,9JNezn7M3xZF3GSVXYXQCH48HjURRvEQNon36ieFnRf9,4up5vAdJztB5GvdtuM6gvDHjBkrGM8DAW4EPaptDqCVC,True,8421164,2105291,12900,6450,6450,HfEnetJ7uBSmZWCjBNxdvv9HEC5nsW4wDV7wu6WnhWan,516030,7128749,-6612719,612
2022-01-30 14:11:42-05:00,11001,2A7ZobmSAddaDW7xJUbXKCKnPmnCd9hMV5UtzSbdgBMg,9aXtTVwGPwJoPL5V16y5T4SnAg8cAoF5YT5VsKcfS5GD,True,239254032,59813508,362941,181470,181471,HfEnetJ7uBSmZWCjBNxdvv9HEC5nsW4wDV7wu6WnhWan,14517640,203597408,-189079768,606
2022-01-30 14:11:43-05:00,11002,ARB1q7bNcQ7grwFEZC6nk9Pfrrg7yZ2WK8zVqq5CEE8F,53e8mUYrWzQnCm9XQyp18CL9owyPqJcYyxZANYhRypPx,True,2405324,601331,3708,1854,1854,3zqXX6kzhkbW3d4TwD2CNjMRwxTbREXySekvq37kfCNk,148345,893247,-744902,616
2022-01-30 14:11:43-05:00,11003,CaAzPATicBzeb4mPpf7r7FLcLVV2V2jchT7QUFKs9enb,2z9rfVSTk8qG7f8b5S3FrJWidPKidaWw2X8vDiRETQqW,True,39398306,9849576,60350,30175,30175,2BPYaeCXY4BCFSGFSfiGtqmhzJ4fkhYLxGjqFvLCB6hG,2414035,24711367,-22297332,612
2022-01-30 14:11:45-05:00,11004,9aQrdyfAvcBbBj7iKQB17eAS4zBqymdd3kzkTkuRhdLU,BDHhukMF5rALuSwCxaw8g73m2MN4oX1D4e7uNmx3SiVt,True,1601162,400290,2493,1246,1247,HfEnetJ7uBSmZWCjBNxdvv9HEC5nsW4wDV7wu6WnhWan,99759,1127654,-1027895,623
2022-01-30 14:11:50-05:00,11005,Fn6J1eMQJoA5rXCwX2HjAF86AowsJfULLuYXVfzgb8aX,6Ett2WPmz4HoWVSVEZD73UzFetd3oFSh7C676MEVYd36,True,804860512,201215128,1234126,617063,617063,HfEnetJ7uBSmZWCjBNxdvv9HEC5nsW4wDV7wu6WnhWan,49365063,615004163,-565639100,613
2022-01-30 14:11:53-05:00,11006,9psSuFHBGqCvcgNMc7aTMhKMMFwBDmW7v5Wkn22KtTHj,7zi9LSfuEhXccQXSRukRRwgQUaiQVVgfsGaRYLP2JvwB,True,20145862,5036465,31220,15610,15610,HfEnetJ7uBSmZWCjBNxdvv9HEC5nsW4wDV7wu6WnhWan,1248839,14509077,-13260238,619
2022-01-30 14:11:54-05:00,11007,4ytoBUwuhAL4YYSCa6AgwrpeVF4eeU8H9NfDxMPZKxPo,Pby2szzsxDrXt4gnbmmaMccXxctZALr8miRtKhGKjsD,True,67707,16926,103,51,52,3zqXX6kzhkbW3d4TwD2CNjMRwxTbREXySekvq37kfCNk,4142,67224,-63082,611
2022-01-30 14:11:54-05:00,11008,6K2m4zFPFjecwWFiNFYXKzwuEXV8GKxYHsq6Kcq4S4xW,GxaHi77G2tXJzhL77GiH7pgiW76H7AeBhziu6YYtU6xc,True,302851372,75712842,467351,233675,233676,3zqXX6kzhkbW3d4TwD2CNjMRwxTbREXySekvq37kfCNk,18694057,234770129,-216076072,617
2022-01-30 14:12:21-05:00,11009,9fTuwsgtFHkUNTTeRR1DWYTno8bbdvNLvqjxLymzbnTe,DacYn36aCNRJmYKiP697yGJTPZDK1nCq7Q1Y7KiXW7Jq,True,26644183,6661045,41391,20695,20696,2BPYaeCXY4BCFSGFSfiGtqmhzJ4fkhYLxGjqFvLCB6hG,1655641,11316854,-9661213,621
2022-01-30 14:28:25-05:00,11010,8NRrJkrYDgMdG9zeU7YJv9FzRBHC4mBiErjhj1zyYKD5,H3N5FgK2Zb4iXGCfEDcDxdrwb5TCqjqzjz8UE1w6S34W,True,295064897,73766224,453633,226816,226817,2BPYaeCXY4BCFSGFSfiGtqmhzJ4fkhYLxGjqFvLCB6hG,18145349,88182486,-70037137,614
2022-01-30 14:28:27-05:00,11011,BoLEXVRQVMhhS61LjPH61nwnqpyJyP9XcLNpPdHvjPGi,4bvLe6LQWHt4k6YvKqG3WWi4KdjDc5ZsCHd63787S52S,True,11998020,2999505,18258,9129,9129,2BPYaeCXY4BCFSGFSfiGtqmhzJ4fkhYLxGjqFvLCB6hG,730340,3730805,-3000465,608
2022-01-30 14:28:29-05:00,11012,Br1j5Ftafei7ysu5SmqVZSoRe4uS4qCPeKSPHg55pyiE,G8fc7QvXjfkgBFvAVUgJFQS3VaF1biL9rktBExGa87Ks,True,1072447,268111,1647,823,824,3zqXX6kzhkbW3d4TwD2CNjMRwxTbREXySekvq37kfCNk,65917,569377,-503460,614
2022-01-30 14:28:29-05:00,11013,Dv1BABsN7amhjmGBpMQsnMkRLx7MuCVwsnuyTQeZ6uum,BCjscxVo1h16teND6KKiAUy1ftNGTMy1vEEEyAW4ttVG,True,111979,27994,171,85,86,3zqXX6kzhkbW3d4TwD2CNjMRwxTbREXySekvq37kfCNk,6844,76780,-69936,611
2022-01-30 14:28:33-05:00,11014,BH36ueAULprzjj6WabTgvivEcrx3VdDn8DTxSoro8Zym,6yydJKEmtZjUwURrs9gQ7EGkB86nK28ZDJQqNMgbPosA,True,7517154,1879288,11539,5769,5770,2BPYaeCXY4BCFSGFSfiGtqmhzJ4fkhYLxGjqFvLCB6hG,461584,5872357,-5410773,614
2022-01-30 14:28:33-05:00,11015,3wr6taSTMEdDKUej5NWod2uGUC4wutem5dKJjEgEZntD,E3cAAUyuDQT2hSxLG6fhyCxkPPUAMp2xyaDLFtbnxBzQ,True,130074031,32518507,198404,99202,99202,HfEnetJ7uBSmZWCjBNxdvv9HEC5nsW4wDV7wu6WnhWan,7936186,91103892,-83167706,610
2022-01-30 14:28:33-05:00,11016,BHpLpoGQ27T6Q4CT8H4dzqS8KF8Vj5rqmqfcodoBzpgR,Akn3tG2hQBfBVtNYCeXchfzfcsyCuSpkGpFoMLEKwcBF,True,83964,20991,128,64,64,HfEnetJ7uBSmZWCjBNxdvv9HEC5nsW4wDV7wu6WnhWan,5143,83936,-78793,612
2022-01-30 14:28:34-05:00,11017,GXfjQr2ihTfLRys1DMetVGocd1sU97KdoCJ6x4HxdW1U,9GHvjJJXjbVz5D3RBfP3njcdRRXnFsXZ68jFa2LiGwsy,True,1327427,331856,2052,1026,1026,3zqXX6kzhkbW3d4TwD2CNjMRwxTbREXySekvq37kfCNk,82092,1283834,-1201742,618
2022-01-30 14:28:34-05:00,11018,CCP5P6U4xBjea3snWgwBb5rtaounEAsNHpWzTUeNtVf9,GE2Bxc837ybP7sNR487U4bVbx68qyX2HtwPBLfEd4BDj,True,5205151,1301287,7970,3985,3985,3zqXX6kzhkbW3d4TwD2CNjMRwxTbREXySekvq37kfCNk,318815,3763293,-3444478,612
2022-01-30 14:28:40-05:00,11019,C1RsUofKYFm9hwXTmNidJp1W7CexbxggaBcEA4dQrAUs,86w25xgPrB6oQocGHRjHVjyen6xWg78W6ji52aLzcFAc,True,164123446,41030861,253180,126590,126590,2BPYaeCXY4BCFSGFSfiGtqmhzJ4fkhYLxGjqFvLCB6hG,10127227,91879804,-81752577,617
2022-01-30 14:28:50-05:00,11020,E5biUzKn2s5frKseCmfWriWjrYMGVtmLrhR9nYhAkVvR,BDHzqefisuGoMGcpML8t6KAC7rcErvhLcfV8KQC7oHAH,True,327549,81887,509,254,255,2BPYaeCXY4BCFSGFSfiGtqmhzJ4fkhYLxGjqFvLCB6hG,20395,263280,-242885,622
2022-01-30 14:29:09-05:00,11021,CQsFSBGcVgtmbzuvUkkSDtPuHFVSuFFaHVcNCM4tuXBs,8nJdA3thwEhzwvvtoAZ7mzMxuRjzp8uGRdDEWMHaDmKA,True,1993238,498309,3086,1543,1543,2BPYaeCXY4BCFSGFSfiGtqmhzJ4fkhYLxGjqFvLCB6hG,123464,1132870,-1009406,619
2022-01-30 14:29:09-05:00,11022,3HuYXkGL9jnp7iLZ6dMmC5dNcmTxPdpAEGZhPzxCDD1F,DeoJsUX13b9HjDU2RMWq5wgQEVriEho9cDEqBbRKLRn9,True,121165951,30291487,187872,93936,93936,3zqXX6kzhkbW3d4TwD2CNjMRwxTbREXySekvq37kfCNk,7514895,101033777,-93518882,620
2022-01-30 14:29:10-05:00,11023,CZsnNXD5oC348mWZeawVj4K2bGxpTiXZzkpm8QtXLbBW,FmBXczLq7hkauf7C4JoxH5TY8HHJ83U5xqGXK3j6t5Fw,True,132125963,33031490,205066,102533,102533,2BPYaeCXY4BCFSGFSfiGtqmhzJ4fkhYLxGjqFvLCB6hG,8202661,153879866,-145677205,620
2022-01-30 14:29:13-05:00,11024,GXSysysoV8Z4xBrQsaKUsSrpoWeTTUsbFmgfZDaQu4ZM,6FJyraiLgG3tb9B7pi4YFsJNtRVBNaghnm1ajzneVv7b,True,8385304,2096326,13000,6500,6500,3zqXX6kzhkbW3d4TwD2CNjMRwxTbREXySekvq37kfCNk,520016,6286486,-5766470,620
2022-01-30 14:34:54-05:00,11025,9Wzu7BWPgx9JRwuituo7vxNXVkpRA7C5W62CATnPpy6Q,GYPiAfGtfkMjDKdi6MrM7VXzpSwPnp2qWwwCX4iFGVtq,True,740063478,185015869,1155989,577994,577995,3zqXX6kzhkbW3d4TwD2CNjMRwxTbREXySekvq37kfCNk,46239581,414581468,-368341887,624
2022-01-30 14:37:00-05:00,11026,BCGTaPQxGEMjD7xUxwfwmVVYJ9CEGH33yJRi3QjwyiLE,JBct1cZ9a959UKwABBEefwxZnGTAAGLzyUdXrXqGGCZd,True,4488823,1122205,6960,3480,3480,3zqXX6kzhkbW3d4TwD2CNjMRwxTbREXySekvq37kfCNk,278431,1722986,-1444555,620
2022-01-30 14:50:39-05:00,11027,AQr9mVmcXCNQhBVCfx63MwR6c4WqDSC9K2BZqr7N8LCx,CB7TWUaL381ounsLw6neAUaKRxJL9P1HC9uGX5e1Uxod,True,284035536,71008883,441482,220741,220741,2BPYaeCXY4BCFSGFSfiGtqmhzJ4fkhYLxGjqFvLCB6hG,17659282,72840826,-55181544,621
2022-01-30 14:51:04-05:00,11028,2rLWe1XADCU93guPU6WgSW6x56gYNfif9bm11V93mJnv,BEGhQRm3fgSHeBtk2DYrXEBPKPRvS3sHyTNopmoBJxMs,True,1209946264,302486566,1890123,945061,945062,HfEnetJ7uBSmZWCjBNxdvv9HEC5nsW4wDV7wu6WnhWan,75604959,752088189,-676483230,624
2022-01-30 15:04:43-05:00,11029,Dng7By2saPu5TVxcvXidBe71ggBo8tiHkAXPi4kKL1tk,75ufEJmHbLHffphL7tvAXhGyftKLr1z2PXXoB2GGY5fG,True,9786258,2446564,15222,7611,7611,HfEnetJ7uBSmZWCjBNxdvv9HEC5nsW4wDV7wu6WnhWan,608916,3840107,-3231191,622
2022-01-30 15:05:02-05:00,11030,9JNezn7M3xZF3GSVXYXQCH48HjURRvEQNon36ieFnRf9,4up5vAdJztB5GvdtuM6gvDHjBkrGM8DAW4EPaptDqCVC,True,6198015,1549503,9608,4804,4804,2BPYaeCXY4BCFSGFSfiGtqmhzJ4fkhYLxGjqFvLCB6hG,384333,5461732,-5077399,620
2022-01-30 15:05:02-05:00,11031,2A7ZobmSAddaDW7xJUbXKCKnPmnCd9hMV5UtzSbdgBMg,9aXtTVwGPwJoPL5V16y5T4SnAg8cAoF5YT5VsKcfS5GD,True,176177898,44044474,271634,135817,135817,2BPYaeCXY4BCFSGFSfiGtqmhzJ4fkhYLxGjqFvLCB6hG,10865371,155938873,-145073502,616
2022-01-30 15:05:04-05:00,11032,CaAzPATicBzeb4mPpf7r7FLcLVV2V2jchT7QUFKs9enb,2z9rfVSTk8qG7f8b5S3FrJWidPKidaWw2X8vDiRETQqW,True,28995900,7248975,44911,22455,22456,2BPYaeCXY4BCFSGFSfiGtqmhzJ4fkhYLxGjqFvLCB6hG,1796458,19072313,-17275855,619
2022-01-30 15:05:07-05:00,11033,46TNhGwBVzedW8xSb9UY94HNeSom9iGiZzAjrKHiRM2G,7JVTiqNYeKHbyzRkKtvSEpqLPKykZso8cGUr3sX1j7QF,True,165705,41426,257,128,129,HfEnetJ7uBSmZWCjBNxdvv9HEC5nsW4wDV7wu6WnhWan,10313,153919,-143606,622
2022-01-30 15:05:08-05:00,11034,ARB1q7bNcQ7grwFEZC6nk9Pfrrg7yZ2WK8zVqq5CEE8F,53e8mUYrWzQnCm9XQyp18CL9owyPqJcYyxZANYhRypPx,True,1769715,442428,2752,1376,1376,2BPYaeCXY4BCFSGFSfiGtqmhzJ4fkhYLxGjqFvLCB6hG,110091,703046,-592955,622
2022-01-30 15:05:22-05:00,11035,F2AU2PjaSmHxWWhkz8XxMggkCMWbMVgawt89tSnYS6RL,ET9febRJiW197DYMaJbgk3kWsAeFv5f4peQ4vFCVppK6,True,4170466653,1042616663,6426290,3213145,3213145,2BPYaeCXY4BCFSGFSfiGtqmhzJ4fkhYLxGjqFvLCB6hG,257051624,1009944959,-752893335,616
2022-01-30 16:13:23-05:00,11036,9aQrdyfAvcBbBj7iKQB17eAS4zBqymdd3kzkTkuRhdLU,BDHhukMF5rALuSwCxaw8g73m2MN4oX1D4e7uNmx3SiVt,True,1177543,294385,1839,919,920,2BPYaeCXY4BCFSGFSfiGtqmhzJ4fkhYLxGjqFvLCB6hG,73579,867830,-794251,624
2022-01-30 16:14:08-05:00,11037,Fn6J1eMQJoA5rXCwX2HjAF86AowsJfULLuYXVfzgb8aX,6Ett2WPmz4HoWVSVEZD73UzFetd3oFSh7C676MEVYd36,True,592252953,148063238,913952,456976,456976,2BPYaeCXY4BCFSGFSfiGtqmhzJ4fkhYLxGjqFvLCB6hG,36558119,472191185,-435633066,617
2022-01-30 16:14:10-05:00,11038,4ytoBUwuhAL4YYSCa6AgwrpeVF4eeU8H9NfDxMPZKxPo,Pby2szzsxDrXt4gnbmmaMccXxctZALr8miRtKhGKjsD,True,49847,12461,77,38,39,2BPYaeCXY4BCFSGFSfiGtqmhzJ4fkhYLxGjqFvLCB6hG,3090,51337,-48247,619
2022-01-30 16:14:10-05:00,11039,9psSuFHBGqCvcgNMc7aTMhKMMFwBDmW7v5Wkn22KtTHj,7zi9LSfuEhXccQXSRukRRwgQUaiQVVgfsGaRYLP2JvwB,True,14819535,3704883,23081,11540,11541,2BPYaeCXY4BCFSGFSfiGtqmhzJ4fkhYLxGjqFvLCB6hG,923243,11158292,-10235049,622
2022-01-30 16:14:18-05:00,11040,9fTuwsgtFHkUNTTeRR1DWYTno8bbdvNLvqjxLymzbnTe,DacYn36aCNRJmYKiP697yGJTPZDK1nCq7Q1Y7KiXW7Jq,True,19576099,4894024,30030,15015,15015,2BPYaeCXY4BCFSGFSfiGtqmhzJ4fkhYLxGjqFvLCB6hG,1201224,8854183,-7652959,613
2022-01-30 16:14:21-05:00,11041,8NRrJkrYDgMdG9zeU7YJv9FzRBHC4mBiErjhj1zyYKD5,H3N5FgK2Zb4iXGCfEDcDxdrwb5TCqjqzjz8UE1w6S34W,True,217230945,54307736,338937,169468,169469,2BPYaeCXY4BCFSGFSfiGtqmhzJ4fkhYLxGjqFvLCB6hG,13557499,70154188,-56596689,624
2022-01-30 16:20:07-05:00,11042,5BJnMHFSiQjHRGFJDW1jnqCfkHHYWnQzmmccy9eA4jNj,9517JGYsPmvgPUM9pFRD2vipHmdgE578F7jA7Qq6jorm,True,10549292,2637323,16406,8203,8203,HfEnetJ7uBSmZWCjBNxdvv9HEC5nsW4wDV7wu6WnhWan,656276,5241905,-4585629,622
2022-01-30 16:20:07-05:00,11043,BoLEXVRQVMhhS61LjPH61nwnqpyJyP9XcLNpPdHvjPGi,4bvLe6LQWHt4k6YvKqG3WWi4KdjDc5ZsCHd63787S52S,True,8838581,2209645,13736,6868,6868,3zqXX6kzhkbW3d4TwD2CNjMRwxTbREXySekvq37kfCNk,549441,2959726,-2410285,621
2022-01-30 16:20:07-05:00,11044,6K2m4zFPFjecwWFiNFYXKzwuEXV8GKxYHsq6Kcq4S4xW,GxaHi77G2tXJzhL77GiH7pgiW76H7AeBhziu6YYtU6xc,True,222812039,55703009,345889,172944,172945,3zqXX6kzhkbW3d4TwD2CNjMRwxTbREXySekvq37kfCNk,13835574,180220377,-166384803,620
2022-01-30 16:20:22-05:00,11045,Br1j5Ftafei7ysu5SmqVZSoRe4uS4qCPeKSPHg55pyiE,G8fc7QvXjfkgBFvAVUgJFQS3VaF1biL9rktBExGa87Ks,True,789320,197330,1225,612,613,3zqXX6kzhkbW3d4TwD2CNjMRwxTbREXySekvq37kfCNk,49012,441624,-392612,620
2022-01-30 16:20:22-05:00,11046,Dv1BABsN7amhjmGBpMQsnMkRLx7MuCVwsnuyTQeZ6uum,BCjscxVo1h16teND6KKiAUy1ftNGTMy1vEEEyAW4ttVG,True,82436,20609,127,63,64,3zqXX6kzhkbW3d4TwD2CNjMRwxTbREXySekvq37kfCNk,5099,59101,-54002,618
2022-01-30 16:36:39-05:00,11047,5iNS1n7r2cqRVanvvEfr8VpJuudLLNXqyw6fWBChBAZT,563A2HKnc198UHYSkj4XTp9FKLBr9MEnCv38cHXpVhH2,True,9933589,2483397,15404,7702,7702,2BPYaeCXY4BCFSGFSfiGtqmhzJ4fkhYLxGjqFvLCB6hG,616185,9310714,-8694529,620
2022-01-30 16:36:40-05:00,11048,CCP5P6U4xBjea3snWgwBb5rtaounEAsNHpWzTUeNtVf9,GE2Bxc837ybP7sNR487U4bVbx68qyX2HtwPBLfEd4BDj,True,3832685,958171,5962,2981,2981,2BPYaeCXY4BCFSGFSfiGtqmhzJ4fkhYLxGjqFvLCB6hG,238487,2893026,-2654539,622
2022-01-30 16:36:40-05:00,11049,BHpLpoGQ27T6Q4CT8H4dzqS8KF8Vj5rqmqfcodoBzpgR,Akn3tG2hQBfBVtNYCeXchfzfcsyCuSpkGpFoMLEKwcBF,True,61810,15452,95,47,48,HfEnetJ7uBSmZWCjBNxdvv9HEC5nsW4wDV7wu6WnhWan,3833,64092,-60259,620
2022-01-30 16:36:44-05:00,11050,3wr6taSTMEdDKUej5NWod2uGUC4wutem5dKJjEgEZntD,E3cAAUyuDQT2hSxLG6fhyCxkPPUAMp2xyaDLFtbnxBzQ,True,95818827,23954706,149268,74634,74634,2BPYaeCXY4BCFSGFSfiGtqmhzJ4fkhYLxGjqFvLCB6hG,5970744,70083459,-64112715,623
2022-01-30 16:36:46-05:00,11051,GXfjQr2ihTfLRys1DMetVGocd1sU97KdoCJ6x4HxdW1U,9GHvjJJXjbVz5D3RBfP3njcdRRXnFsXZ68jFa2LiGwsy,True,976935,244233,1527,763,764,HfEnetJ7uBSmZWCjBNxdvv9HEC5nsW4wDV7wu6WnhWan,61104,981048,-919944,625
2022-01-30 16:50:37-05:00,11052,C1RsUofKYFm9hwXTmNidJp1W7CexbxggaBcEA4dQrAUs,86w25xgPrB6oQocGHRjHVjyen6xWg78W6ji52aLzcFAc,True,120762134,30190533,187659,93829,93830,HfEnetJ7uBSmZWCjBNxdvv9HEC5nsW4wDV7wu6WnhWan,7506372,71151673,-63645301,621
2022-01-30 19:36:35-05:00,11053,E5biUzKn2s5frKseCmfWriWjrYMGVtmLrhR9nYhAkVvR,BDHzqefisuGoMGcpML8t6KAC7rcErvhLcfV8KQC7oHAH,True,241027,60256,376,188,188,HfEnetJ7uBSmZWCjBNxdvv9HEC5nsW4wDV7wu6WnhWan,15046,201846,-186800,624
2022-01-30 19:37:28-05:00,11054,CQsFSBGcVgtmbzuvUkkSDtPuHFVSuFFaHVcNCM4tuXBs,8nJdA3thwEhzwvvtoAZ7mzMxuRjzp8uGRdDEWMHaDmKA,True,1467659,366914,2296,1148,1148,2BPYaeCXY4BCFSGFSfiGtqmhzJ4fkhYLxGjqFvLCB6hG,91854,876180,-784326,625
2022-01-30 19:42:38-05:00,11055,CZsnNXD5oC348mWZeawVj4K2bGxpTiXZzkpm8QtXLbBW,FmBXczLq7hkauf7C4JoxH5TY8HHJ83U5xqGXK3j6t5Fw,True,97131778,24282944,148793,74396,74397,2BPYaeCXY4BCFSGFSfiGtqmhzJ4fkhYLxGjqFvLCB6hG,5951744,117172723,-111220979,612
2022-01-30 19:42:40-05:00,11056,GXSysysoV8Z4xBrQsaKUsSrpoWeTTUsbFmgfZDaQu4ZM,6FJyraiLgG3tb9B7pi4YFsJNtRVBNaghnm1ajzneVv7b,True,6164098,1541024,9421,4710,4711,HfEnetJ7uBSmZWCjBNxdvv9HEC5nsW4wDV7wu6WnhWan,376857,4826592,-4449735,611
2022-01-30 19:42:41-05:00,11057,2A7ZobmSAddaDW7xJUbXKCKnPmnCd9hMV5UtzSbdgBMg,9aXtTVwGPwJoPL5V16y5T4SnAg8cAoF5YT5VsKcfS5GD,True,129588723,32397180,198950,99475,99475,2BPYaeCXY4BCFSGFSfiGtqmhzJ4fkhYLxGjqFvLCB6hG,7958031,119308445,-111350414,614
2022-01-30 19:42:42-05:00,11058,9JNezn7M3xZF3GSVXYXQCH48HjURRvEQNon36ieFnRf9,4up5vAdJztB5GvdtuM6gvDHjBkrGM8DAW4EPaptDqCVC,True,4558950,1139737,7049,3524,3525,3zqXX6kzhkbW3d4TwD2CNjMRwxTbREXySekvq37kfCNk,281962,4179575,-3897613,618
2022-01-30 19:42:43-05:00,11059,CaAzPATicBzeb4mPpf7r7FLcLVV2V2jchT7QUFKs9enb,2z9rfVSTk8qG7f8b5S3FrJWidPKidaWw2X8vDiRETQqW,True,21340341,5335085,33249,16624,16625,3zqXX6kzhkbW3d4TwD2CNjMRwxTbREXySekvq37kfCNk,1329976,14693466,-13363490,623
2022-01-30 19:42:48-05:00,11060,4YnbP4eceiKXGJrnsdMQJ65DkLuUWYotVSsUvovrpQkx,DAb3fCkTyKZtcBLxYepX8iG3h9evVfqxrQzvqvME61tq,True,42379156,10594789,65551,32775,32776,3zqXX6kzhkbW3d4TwD2CNjMRwxTbREXySekvq37kfCNk,2622076,23035221,-20413145,618
2022-01-30 19:42:49-05:00,11061,ARB1q7bNcQ7grwFEZC6nk9Pfrrg7yZ2WK8zVqq5CEE8F,53e8mUYrWzQnCm9XQyp18CL9owyPqJcYyxZANYhRypPx,True,1301414,325353,2013,1006,1007,3zqXX6kzhkbW3d4TwD2CNjMRwxTbREXySekvq37kfCNk,80551,551141,-470590,618
2022-01-30 19:42:53-05:00,11062,3HuYXkGL9jnp7iLZ6dMmC5dNcmTxPdpAEGZhPzxCDD1F,DeoJsUX13b9HjDU2RMWq5wgQEVriEho9cDEqBbRKLRn9,True,89183375,22295843,139170,69585,69585,2BPYaeCXY4BCFSGFSfiGtqmhzJ4fkhYLxGjqFvLCB6hG,5566823,77397246,-71830423,624
2022-01-30 19:42:53-05:00,11063,9aQrdyfAvcBbBj7iKQB17eAS4zBqymdd3kzkTkuRhdLU,BDHhukMF5rALuSwCxaw8g73m2MN4oX1D4e7uNmx3SiVt,True,865747,216436,1346,673,673,2BPYaeCXY4BCFSGFSfiGtqmhzJ4fkhYLxGjqFvLCB6hG,53855,666956,-613101,622
2022-01-30 19:42:56-05:00,11064,Fn6J1eMQJoA5rXCwX2HjAF86AowsJfULLuYXVfzgb8aX,6Ett2WPmz4HoWVSVEZD73UzFetd3oFSh7C676MEVYd36,True,435982853,108995713,679953,339976,339977,3zqXX6kzhkbW3d4TwD2CNjMRwxTbREXySekvq37kfCNk,27198155,362136119,-334937964,623
2022-01-30 19:43:04-05:00,11065,4ytoBUwuhAL4YYSCa6AgwrpeVF4eeU8H9NfDxMPZKxPo,Pby2szzsxDrXt4gnbmmaMccXxctZALr8miRtKhGKjsD,True,36686,9171,57,28,29,3zqXX6kzhkbW3d4TwD2CNjMRwxTbREXySekvq37kfCNk,2293,39180,-36887,625
2022-01-30 19:43:09-05:00,11066,9psSuFHBGqCvcgNMc7aTMhKMMFwBDmW7v5Wkn22KtTHj,7zi9LSfuEhXccQXSRukRRwgQUaiQVVgfsGaRYLP2JvwB,True,10902285,2725571,17045,8522,8523,HfEnetJ7uBSmZWCjBNxdvv9HEC5nsW4wDV7wu6WnhWan,681810,8570469,-7888659,625
2022-01-30 19:43:59-05:00,11067,BH36ueAULprzjj6WabTgvivEcrx3VdDn8DTxSoro8Zym,6yydJKEmtZjUwURrs9gQ7EGkB86nK28ZDJQqNMgbPosA,True,5535833,1383958,8593,4296,4297,2BPYaeCXY4BCFSGFSfiGtqmhzJ4fkhYLxGjqFvLCB6hG,343728,4503843,-4160115,620
2022-01-30 19:44:13-05:00,11068,9fTuwsgtFHkUNTTeRR1DWYTno8bbdvNLvqjxLymzbnTe,DacYn36aCNRJmYKiP697yGJTPZDK1nCq7Q1Y7KiXW7Jq,True,14419762,3604940,22523,11261,11262,2BPYaeCXY4BCFSGFSfiGtqmhzJ4fkhYLxGjqFvLCB6hG,900943,6902982,-6002039,624
2022-01-30 19:44:52-05:00,11069,8NRrJkrYDgMdG9zeU7YJv9FzRBHC4mBiErjhj1zyYKD5,H3N5FgK2Zb4iXGCfEDcDxdrwb5TCqjqzjz8UE1w6S34W,True,159603957,39900989,245279,122639,122640,2BPYaeCXY4BCFSGFSfiGtqmhzJ4fkhYLxGjqFvLCB6hG,9811162,55578549,-45767387,614
2022-01-30 19:44:52-05:00,11070,BoLEXVRQVMhhS61LjPH61nwnqpyJyP9XcLNpPdHvjPGi,4bvLe6LQWHt4k6YvKqG3WWi4KdjDc5ZsCHd63787S52S,True,6498892,1624723,10051,5025,5026,HfEnetJ7uBSmZWCjBNxdvv9HEC5nsW4wDV7wu6WnhWan,402072,2339832,-1937760,618
2022-01-30 19:44:57-05:00,11071,BjCNaM7YbE9SjFi7tzi4677zg1fKXGJwtecz2GWwWuhd,6rNsSrKZezQrLb2whToNjnizpnurDXrobHqfEK3QqU1M,True,108360318,27090079,166073,83036,83037,2BPYaeCXY4BCFSGFSfiGtqmhzJ4fkhYLxGjqFvLCB6hG,6642945,66108234,-59465289,613
2022-01-30 19:45:01-05:00,11072,8WHDaiE6LqFFmCVMnPeLEQ99R6ft8b74UfmP9BqzjcE8,CGmoDGsdnjo3zMNrW78n2xxQr1aDPAiBYiXbyciLXYMu,True,2547407,636850,3971,1985,1986,2BPYaeCXY4BCFSGFSfiGtqmhzJ4fkhYLxGjqFvLCB6hG,158858,2208077,-2049219,623
2022-01-30 19:45:52-05:00,11073,Dv1BABsN7amhjmGBpMQsnMkRLx7MuCVwsnuyTQeZ6uum,BCjscxVo1h16teND6KKiAUy1ftNGTMy1vEEEyAW4ttVG,True,60668,15167,94,47,47,HfEnetJ7uBSmZWCjBNxdvv9HEC5nsW4wDV7wu6WnhWan,3780,45441,-41661,623
2022-01-30 19:45:57-05:00,11074,Br1j5Ftafei7ysu5SmqVZSoRe4uS4qCPeKSPHg55pyiE,G8fc7QvXjfkgBFvAVUgJFQS3VaF1biL9rktBExGa87Ks,True,580774,145193,906,453,453,HfEnetJ7uBSmZWCjBNxdvv9HEC5nsW4wDV7wu6WnhWan,36250,341926,-305676,624
2022-01-30 19:46:17-05:00,11075,6K2m4zFPFjecwWFiNFYXKzwuEXV8GKxYHsq6Kcq4S4xW,GxaHi77G2tXJzhL77GiH7pgiW76H7AeBhziu6YYtU6xc,True,163793698,40948424,252063,126031,126032,HfEnetJ7uBSmZWCjBNxdvv9HEC5nsW4wDV7wu6WnhWan,10082547,138187182,-128104635,615
2022-01-30 19:46:18-05:00,11076,5iNS1n7r2cqRVanvvEfr8VpJuudLLNXqyw6fWBChBAZT,563A2HKnc198UHYSkj4XTp9FKLBr9MEnCv38cHXpVhH2,True,7300168,1825042,11167,5583,5584,2BPYaeCXY4BCFSGFSfiGtqmhzJ4fkhYLxGjqFvLCB6hG,446706,7117630,-6670924,611
2022-01-30 19:46:18-05:00,11077,BHpLpoGQ27T6Q4CT8H4dzqS8KF8Vj5rqmqfcodoBzpgR,Akn3tG2hQBfBVtNYCeXchfzfcsyCuSpkGpFoMLEKwcBF,True,45423,11355,69,34,35,3zqXX6kzhkbW3d4TwD2CNjMRwxTbREXySekvq37kfCNk,2778,48908,-46130,611
2022-01-30 19:46:18-05:00,11078,46TNhGwBVzedW8xSb9UY94HNeSom9iGiZzAjrKHiRM2G,7JVTiqNYeKHbyzRkKtvSEpqLPKykZso8cGUr3sX1j7QF,True,121907,30476,189,94,95,2BPYaeCXY4BCFSGFSfiGtqmhzJ4fkhYLxGjqFvLCB6hG,7594,117672,-110078,622
2022-01-30 19:46:18-05:00,11079,2r64Rnbu3ZjmJTHHUxxV9TWWGzwpAepA4ySbtKivBXCj,6RRzx6KLkMiFK9JSuznrSJGiPgkHwatBSskudHqbfKJ5,True,30662486,7665621,47371,23685,23686,3zqXX6kzhkbW3d4TwD2CNjMRwxTbREXySekvq37kfCNk,1894841,24747178,-22852337,617
2022-01-30 19:46:18-05:00,11080,GXfjQr2ihTfLRys1DMetVGocd1sU97KdoCJ6x4HxdW1U,9GHvjJJXjbVz5D3RBfP3njcdRRXnFsXZ68jFa2LiGwsy,True,718298,179574,1119,559,560,HfEnetJ7uBSmZWCjBNxdvv9HEC5nsW4wDV7wu6WnhWan,44775,749138,-704363,623
2022-01-30 19:46:18-05:00,11081,CCP5P6U4xBjea3snWgwBb5rtaounEAsNHpWzTUeNtVf9,GE2Bxc837ybP7sNR487U4bVbx68qyX2HtwPBLfEd4BDj,True,2816611,704152,4326,2163,2163,HfEnetJ7uBSmZWCjBNxdvv9HEC5nsW4wDV7wu6WnhWan,173059,2221867,-2048808,614
2022-01-30 19:46:18-05:00,11082,HGAFdundf5voDqeh9g7d6Q9mgMf8eEg898QMRBqwPZ6C,deanBuZXWBHEe2TGfP37S9aMBEnEgmZoyRJjAvruzfA,True,99180,24794,154,77,77,HfEnetJ7uBSmZWCjBNxdvv9HEC5nsW4wDV7wu6WnhWan,6197,122903,-116706,624
2022-01-30 19:46:22-05:00,11083,3wr6taSTMEdDKUej5NWod2uGUC4wutem5dKJjEgEZntD,E3cAAUyuDQT2hSxLG6fhyCxkPPUAMp2xyaDLFtbnxBzQ,True,70480246,17620061,109960,54980,54980,3zqXX6kzhkbW3d4TwD2CNjMRwxTbREXySekvq37kfCNk,4398430,53866975,-49468545,624
2022-01-30 19:47:12-05:00,11084,C1RsUofKYFm9hwXTmNidJp1W7CexbxggaBcEA4dQrAUs,86w25xgPrB6oQocGHRjHVjyen6xWg78W6ji52aLzcFAc,True,88836044,22209011,138345,69172,69173,2BPYaeCXY4BCFSGFSfiGtqmhzJ4fkhYLxGjqFvLCB6hG,5533806,55003572,-49469766,622
2022-01-30 19:47:16-05:00,11085,EF6H6aW1p3qcAtiLFU9rbFYfsKfD683meHXDw8hLdaZK,8vfJbpnK7SQcjpEBCzZJRW8JosNbsmTeJ2YXZCbM225c,True,1241460,310364,1940,970,970,HfEnetJ7uBSmZWCjBNxdvv9HEC5nsW4wDV7wu6WnhWan,77630,991461,-913831,625
2022-01-30 19:48:04-05:00,11086,E5biUzKn2s5frKseCmfWriWjrYMGVtmLrhR9nYhAkVvR,BDHzqefisuGoMGcpML8t6KAC7rcErvhLcfV8KQC7oHAH,True,176937,44234,270,135,135,HfEnetJ7uBSmZWCjBNxdvv9HEC5nsW4wDV7wu6WnhWan,10836,154771,-143935,612
2022-01-30 19:48:06-05:00,11087,CQsFSBGcVgtmbzuvUkkSDtPuHFVSuFFaHVcNCM4tuXBs,8nJdA3thwEhzwvvtoAZ7mzMxuRjzp8uGRdDEWMHaDmKA,True,1077575,269393,1659,829,830,2BPYaeCXY4BCFSGFSfiGtqmhzJ4fkhYLxGjqFvLCB6hG,66388,677803,-611415,616
2022-01-30 19:48:06-05:00,11088,CPsnF5SkVCnFkFXhLwzpp6H7rBrTumCuYJCyVSeT8cFZ,BMV1AyAxyTuXTfwddphdRc3nwbySVbhqUZau8oatdTEJ,True,560496375,140124093,869672,434836,434836,3zqXX6kzhkbW3d4TwD2CNjMRwxTbREXySekvq37kfCNk,34786890,95696040,-60909150,620
2022-01-30 19:48:06-05:00,11089,CZsnNXD5oC348mWZeawVj4K2bGxpTiXZzkpm8QtXLbBW,FmBXczLq7hkauf7C4JoxH5TY8HHJ83U5xqGXK3j6t5Fw,True,71453574,17863393,110192,55096,55096,2BPYaeCXY4BCFSGFSfiGtqmhzJ4fkhYLxGjqFvLCB6hG,4407691,89218898,-84811207,616
2022-01-30 19:48:06-05:00,11090,GXSysysoV8Z4xBrQsaKUsSrpoWeTTUsbFmgfZDaQu4ZM,6FJyraiLgG3tb9B7pi4YFsJNtRVBNaghnm1ajzneVv7b,True,4535939,1133984,7007,3503,3504,HfEnetJ7uBSmZWCjBNxdvv9HEC5nsW4wDV7wu6WnhWan,280301,3704739,-3424438,617
2022-01-30 19:48:08-05:00,11091,2A7ZobmSAddaDW7xJUbXKCKnPmnCd9hMV5UtzSbdgBMg,9aXtTVwGPwJoPL5V16y5T4SnAg8cAoF5YT5VsKcfS5GD,True,95380642,23845160,148704,74352,74352,2BPYaeCXY4BCFSGFSfiGtqmhzJ4fkhYLxGjqFvLCB6hG,5948180,91272219,-85324039,623
2022-01-30 19:48:26-05:00,11092,CaAzPATicBzeb4mPpf7r7FLcLVV2V2jchT7QUFKs9enb,2z9rfVSTk8qG7f8b5S3FrJWidPKidaWw2X8vDiRETQqW,True,15685307,3921326,24419,12209,12210,3zqXX6kzhkbW3d4TwD2CNjMRwxTbREXySekvq37kfCNk,976778,11319353,-10342575,622
2022-01-30 19:48:26-05:00,11093,9JNezn7M3xZF3GSVXYXQCH48HjURRvEQNon36ieFnRf9,4up5vAdJztB5GvdtuM6gvDHjBkrGM8DAW4EPaptDqCVC,True,3350644,837661,5158,2579,2579,HfEnetJ7uBSmZWCjBNxdvv9HEC5nsW4wDV7wu6WnhWan,206344,3198124,-2991780,615
2022-01-30 19:48:26-05:00,11094,4YnbP4eceiKXGJrnsdMQJ65DkLuUWYotVSsUvovrpQkx,DAb3fCkTyKZtcBLxYepX8iG3h9evVfqxrQzvqvME61tq,True,31178304,7794576,48761,24380,24381,3zqXX6kzhkbW3d4TwD2CNjMRwxTbREXySekvq37kfCNk,1950462,17866412,-15915950,625
2022-01-30 19:49:50-05:00,11095,9Wzu7BWPgx9JRwuituo7vxNXVkpRA7C5W62CATnPpy6Q,GYPiAfGtfkMjDKdi6MrM7VXzpSwPnp2qWwwCX4iFGVtq,True,544346328,136086582,849832,424916,424916,2BPYaeCXY4BCFSGFSfiGtqmhzJ4fkhYLxGjqFvLCB6hG,33993315,320963996,-286970681,624
2022-01-30 19:50:03-05:00,11096,BCGTaPQxGEMjD7xUxwfwmVVYJ9CEGH33yJRi3QjwyiLE,JBct1cZ9a959UKwABBEefwxZnGTAAGLzyUdXrXqGGCZd,True,3304291,826072,5169,2584,2585,3zqXX6kzhkbW3d4TwD2CNjMRwxTbREXySekvq37kfCNk,206782,1352526,-1145744,625
2022-01-30 19:56:14-05:00,11097,ARB1q7bNcQ7grwFEZC6nk9Pfrrg7yZ2WK8zVqq5CEE8F,53e8mUYrWzQnCm9XQyp18CL9owyPqJcYyxZANYhRypPx,True,956883,239220,1484,742,742,HfEnetJ7uBSmZWCjBNxdvv9HEC5nsW4wDV7wu6WnhWan,59360,431481,-372121,620
2022-01-30 19:56:31-05:00,11098,HEFpdWLZaiQnjftmXgxs6RNzhH72YiMjortxPkKekkvb,5Q8mmxBgVTijNGrWsnoA3VMArLHZEX5MkaigYXHpgXHE,True,3877477,969368,6061,3030,3031,2BPYaeCXY4BCFSGFSfiGtqmhzJ4fkhYLxGjqFvLCB6hG,242471,1867377,-1624906,625
2022-01-30 19:56:47-05:00,11099,9aQrdyfAvcBbBj7iKQB17eAS4zBqymdd3kzkTkuRhdLU,BDHhukMF5rALuSwCxaw8g73m2MN4oX1D4e7uNmx3SiVt,True,636340,159085,988,494,494,HfEnetJ7uBSmZWCjBNxdvv9HEC5nsW4wDV7wu6WnhWan,39538,512336,-472798,621
2022-01-30 20:00:07-05:00,11100,56488NdcUy6Hi6X5SLs2GFtW5pG4u5wJpH7vHdxTCx4z,tGgXjJeVr3W2m3T2NXPCqpBEd6HJKE2cRsgCyiDZQy4,True,1817484,454370,2843,1421,1422,2BPYaeCXY4BCFSGFSfiGtqmhzJ4fkhYLxGjqFvLCB6hG,113720,1303066,-1189346,625
2022-01-30 20:00:15-05:00,11101,2rLWe1XADCU93guPU6WgSW6x56gYNfif9bm11V93mJnv,BEGhQRm3fgSHeBtk2DYrXEBPKPRvS3sHyTNopmoBJxMs,True,890111803,222527950,1389104,694552,694552,2BPYaeCXY4BCFSGFSfiGtqmhzJ4fkhYLxGjqFvLCB6hG,55564175,580310678,-524746503,624
2022-01-30 20:15:48-05:00,11102,AQr9mVmcXCNQhBVCfx63MwR6c4WqDSC9K2BZqr7N8LCx,CB7TWUaL381ounsLw6neAUaKRxJL9P1HC9uGX5e1Uxod,True,209106625,52276655,327006,163503,163503,2BPYaeCXY4BCFSGFSfiGtqmhzJ4fkhYLxGjqFvLCB6hG,13080277,58387061,-45306784,625
2022-01-30 20:15:48-05:00,11103,Fn6J1eMQJoA5rXCwX2HjAF86AowsJfULLuYXVfzgb8aX,6Ett2WPmz4HoWVSVEZD73UzFetd3oFSh7C676MEVYd36,True,320531525,80132881,499905,249952,249953,3zqXX6kzhkbW3d4TwD2CNjMRwxTbREXySekvq37kfCNk,19996213,277658814,-257662601,623
2022-01-30 20:15:59-05:00,11104,FuoFPNTdYVDkSHaBac6UC1aNJXafSNTvFJuBCdrgQQrH,ApBS1Fx83tcECMzDV6wEzEzEdg4e2hgj3djtjRUoSKK5,True,6435323,1608829,10027,5013,5014,3zqXX6kzhkbW3d4TwD2CNjMRwxTbREXySekvq37kfCNk,401081,5540240,-5139159,623
2022-01-30 20:15:59-05:00,11105,4ytoBUwuhAL4YYSCa6AgwrpeVF4eeU8H9NfDxMPZKxPo,Pby2szzsxDrXt4gnbmmaMccXxctZALr8miRtKhGKjsD,True,26964,6741,42,21,21,3zqXX6kzhkbW3d4TwD2CNjMRwxTbREXySekvq37kfCNk,1680,29898,-28218,623
2022-01-30 20:16:06-05:00,11106,9psSuFHBGqCvcgNMc7aTMhKMMFwBDmW7v5Wkn22KtTHj,7zi9LSfuEhXccQXSRukRRwgQUaiQVVgfsGaRYLP2JvwB,True,8006485,2001621,12321,6160,6161,3zqXX6kzhkbW3d4TwD2CNjMRwxTbREXySekvq37kfCNk,492875,6579601,-6086726,615
2022-01-30 20:16:12-05:00,11107,3HuYXkGL9jnp7iLZ6dMmC5dNcmTxPdpAEGZhPzxCDD1F,DeoJsUX13b9HjDU2RMWq5wgQEVriEho9cDEqBbRKLRn9,True,65571705,16392926,102468,51234,51234,3zqXX6kzhkbW3d4TwD2CNjMRwxTbREXySekvq37kfCNk,4098743,59287484,-55188741,625
2022-01-30 20:20:56-05:00,11108,9fTuwsgtFHkUNTTeRR1DWYTno8bbdvNLvqjxLymzbnTe,DacYn36aCNRJmYKiP697yGJTPZDK1nCq7Q1Y7KiXW7Jq,True,10597354,2649338,16468,8234,8234,2BPYaeCXY4BCFSGFSfiGtqmhzJ4fkhYLxGjqFvLCB6hG,658749,5377750,-4719001,621
2022-01-30 20:22:16-05:00,11109,8NRrJkrYDgMdG9zeU7YJv9FzRBHC4mBiErjhj1zyYKD5,H3N5FgK2Zb4iXGCfEDcDxdrwb5TCqjqzjz8UE1w6S34W,True,117492141,29373035,183264,91632,91632,HfEnetJ7uBSmZWCjBNxdvv9HEC5nsW4wDV7wu6WnhWan,7330592,43867304,-36536712,623
2022-01-30 20:24:21-05:00,11110,BoLEXVRQVMhhS61LjPH61nwnqpyJyP9XcLNpPdHvjPGi,4bvLe6LQWHt4k6YvKqG3WWi4KdjDc5ZsCHd63787S52S,True,4781797,1195449,7466,3733,3733,2BPYaeCXY4BCFSGFSfiGtqmhzJ4fkhYLxGjqFvLCB6hG,298653,1844346,-1545693,624
2022-01-30 20:26:17-05:00,11111,BH36ueAULprzjj6WabTgvivEcrx3VdDn8DTxSoro8Zym,6yydJKEmtZjUwURrs9gQ7EGkB86nK28ZDJQqNMgbPosA,True,4071789,1017946,6356,3178,3178,2BPYaeCXY4BCFSGFSfiGtqmhzJ4fkhYLxGjqFvLCB6hG,254254,3454428,-3200174,624
2022-01-30 20:26:41-05:00,11112,Br1j5Ftafei7ysu5SmqVZSoRe4uS4qCPeKSPHg55pyiE,G8fc7QvXjfkgBFvAVUgJFQS3VaF1biL9rktBExGa87Ks,True,426835,106708,662,331,331,HfEnetJ7uBSmZWCjBNxdvv9HEC5nsW4wDV7wu6WnhWan,26509,264513,-238004,621
2022-01-30 20:26:41-05:00,11113,Dv1BABsN7amhjmGBpMQsnMkRLx7MuCVwsnuyTQeZ6uum,BCjscxVo1h16teND6KKiAUy1ftNGTMy1vEEEyAW4ttVG,True,44578,11144,68,34,34,HfEnetJ7uBSmZWCjBNxdvv9HEC5nsW4wDV7wu6WnhWan,2754,34923,-32169,617
2022-01-30 21:00:40-05:00,11114,F2AU2PjaSmHxWWhkz8XxMggkCMWbMVgawt89tSnYS6RL,ET9febRJiW197DYMaJbgk3kWsAeFv5f4peQ4vFCVppK6,True,3071368452,767842113,4778080,2389040,2389040,2BPYaeCXY4BCFSGFSfiGtqmhzJ4fkhYLxGjqFvLCB6hG,191123239,812601096,-621477857,622
2022-01-30 21:00:46-05:00,11115,Dng7By2saPu5TVxcvXidBe71ggBo8tiHkAXPi4kKL1tk,75ufEJmHbLHffphL7tvAXhGyftKLr1z2PXXoB2GGY5fG,True,7202740,1800684,11209,5604,5605,2BPYaeCXY4BCFSGFSfiGtqmhzJ4fkhYLxGjqFvLCB6hG,448370,3008720,-2560350,622
2022-01-30 21:00:57-05:00,11116,5BJnMHFSiQjHRGFJDW1jnqCfkHHYWnQzmmccy9eA4jNj,9517JGYsPmvgPUM9pFRD2vipHmdgE578F7jA7Qq6jorm,True,7763040,1940760,12112,6056,6056,HfEnetJ7uBSmZWCjBNxdvv9HEC5nsW4wDV7wu6WnhWan,484506,4072660,-3588154,624
2022-01-30 21:01:25-05:00,11117,BjCNaM7YbE9SjFi7tzi4677zg1fKXGJwtecz2GWwWuhd,6rNsSrKZezQrLb2whToNjnizpnurDXrobHqfEK3QqU1M,True,79808365,19952090,124550,62275,62275,HfEnetJ7uBSmZWCjBNxdvv9HEC5nsW4wDV7wu6WnhWan,4982004,51042946,-46060942,624
2022-01-30 21:01:47-05:00,11118,Fkm1PUcwZy3YLH28Xr6Ch7wP9CLpLEuZVxTFS1BcQUi4,FMe7RmFSyratCnpE4mmk5DbRQuusf2NgnxuXticqhGvP,True,371140,92784,578,289,289,3zqXX6kzhkbW3d4TwD2CNjMRwxTbREXySekvq37kfCNk,23156,139312,-116156,623
2022-01-30 21:02:08-05:00,11119,8WHDaiE6LqFFmCVMnPeLEQ99R6ft8b74UfmP9BqzjcE8,CGmoDGsdnjo3zMNrW78n2xxQr1aDPAiBYiXbyciLXYMu,True,1873480,468368,2925,1462,1463,3zqXX6kzhkbW3d4TwD2CNjMRwxTbREXySekvq37kfCNk,117028,1691022,-1573994,624
2022-01-30 22:32:16-05:00,11120,5iNS1n7r2cqRVanvvEfr8VpJuudLLNXqyw6fWBChBAZT,563A2HKnc198UHYSkj4XTp9FKLBr9MEnCv38cHXpVhH2,True,5378373,1344593,8387,4193,4194,HfEnetJ7uBSmZWCjBNxdvv9HEC5nsW4wDV7wu6WnhWan,335498,5435446,-5099948,623
2022-01-30 22:32:16-05:00,11121,BHpLpoGQ27T6Q4CT8H4dzqS8KF8Vj5rqmqfcodoBzpgR,Akn3tG2hQBfBVtNYCeXchfzfcsyCuSpkGpFoMLEKwcBF,True,33467,8366,52,26,26,2BPYaeCXY4BCFSGFSfiGtqmhzJ4fkhYLxGjqFvLCB6hG,2088,37288,-35200,623
2022-01-30 22:32:18-05:00,11122,CCP5P6U4xBjea3snWgwBb5rtaounEAsNHpWzTUeNtVf9,GE2Bxc837ybP7sNR487U4bVbx68qyX2HtwPBLfEd4BDj,True,2072961,518240,3199,1599,1600,3zqXX6kzhkbW3d4TwD2CNjMRwxTbREXySekvq37kfCNk,127967,1704073,-1576106,617
2022-01-30 22:32:21-05:00,11123,GXfjQr2ihTfLRys1DMetVGocd1sU97KdoCJ6x4HxdW1U,9GHvjJJXjbVz5D3RBfP3njcdRRXnFsXZ68jFa2LiGwsy,True,528217,132054,820,410,410,2BPYaeCXY4BCFSGFSfiGtqmhzJ4fkhYLxGjqFvLCB6hG,32826,571607,-538781,621
2022-01-30 22:32:28-05:00,11124,6K2m4zFPFjecwWFiNFYXKzwuEXV8GKxYHsq6Kcq4S4xW,GxaHi77G2tXJzhL77GiH7pgiW76H7AeBhziu6YYtU6xc,True,120635838,30158958,188649,94324,94325,2BPYaeCXY4BCFSGFSfiGtqmhzJ4fkhYLxGjqFvLCB6hG,7545963,105834266,-98288303,625
2022-01-30 22:32:28-05:00,11125,C1RsUofKYFm9hwXTmNidJp1W7CexbxggaBcEA4dQrAUs,86w25xgPrB6oQocGHRjHVjyen6xWg78W6ji52aLzcFAc,True,65362841,16340710,102280,51140,51140,2BPYaeCXY4BCFSGFSfiGtqmhzJ4fkhYLxGjqFvLCB6hG,4091212,42457858,-38366646,625
2022-01-30 22:32:41-05:00,11126,3wr6taSTMEdDKUej5NWod2uGUC4wutem5dKJjEgEZntD,E3cAAUyuDQT2hSxLG6fhyCxkPPUAMp2xyaDLFtbnxBzQ,True,51839719,12959929,80900,40450,40450,3zqXX6kzhkbW3d4TwD2CNjMRwxTbREXySekvq37kfCNk,3236036,41357986,-38121950,624
2022-01-30 23:22:00-05:00,11127,E5biUzKn2s5frKseCmfWriWjrYMGVtmLrhR9nYhAkVvR,BDHzqefisuGoMGcpML8t6KAC7rcErvhLcfV8KQC7oHAH,True,130338,32584,202,101,101,2BPYaeCXY4BCFSGFSfiGtqmhzJ4fkhYLxGjqFvLCB6hG,8099,118416,-110317,621
2022-01-30 23:22:02-05:00,11128,CZsnNXD5oC348mWZeawVj4K2bGxpTiXZzkpm8QtXLbBW,FmBXczLq7hkauf7C4JoxH5TY8HHJ83U5xqGXK3j6t5Fw,True,52577973,13144493,81093,40546,40547,2BPYaeCXY4BCFSGFSfiGtqmhzJ4fkhYLxGjqFvLCB6hG,3243732,67864464,-64620732,616
2022-01-30 23:22:02-05:00,11129,CQsFSBGcVgtmbzuvUkkSDtPuHFVSuFFaHVcNCM4tuXBs,8nJdA3thwEhzwvvtoAZ7mzMxuRjzp8uGRdDEWMHaDmKA,True,792909,198227,1220,610,610,2BPYaeCXY4BCFSGFSfiGtqmhzJ4fkhYLxGjqFvLCB6hG,48830,522665,-473835,615
2022-01-30 23:22:03-05:00,11130,GXSysysoV8Z4xBrQsaKUsSrpoWeTTUsbFmgfZDaQu4ZM,6FJyraiLgG3tb9B7pi4YFsJNtRVBNaghnm1ajzneVv7b,True,3338018,834504,5167,2583,2584,2BPYaeCXY4BCFSGFSfiGtqmhzJ4fkhYLxGjqFvLCB6hG,206719,2838986,-2632267,619
2022-01-30 23:22:23-05:00,11131,2A7ZobmSAddaDW7xJUbXKCKnPmnCd9hMV5UtzSbdgBMg,9aXtTVwGPwJoPL5V16y5T4SnAg8cAoF5YT5VsKcfS5GD,True,70166916,17541729,109385,54692,54693,3zqXX6kzhkbW3d4TwD2CNjMRwxTbREXySekvq37kfCNk,4375419,69737197,-65361778,623
2022-01-30 23:22:30-05:00,11132,9JNezn7M3xZF3GSVXYXQCH48HjURRvEQNon36ieFnRf9,4up5vAdJztB5GvdtuM6gvDHjBkrGM8DAW4EPaptDqCVC,True,2467527,616881,3844,1922,1922,2BPYaeCXY4BCFSGFSfiGtqmhzJ4fkhYLxGjqFvLCB6hG,153778,2443070,-2289292,623
2022-01-30 23:23:00-05:00,11133,46TNhGwBVzedW8xSb9UY94HNeSom9iGiZzAjrKHiRM2G,7JVTiqNYeKHbyzRkKtvSEpqLPKykZso8cGUr3sX1j7QF,True,89716,22428,140,70,70,2BPYaeCXY4BCFSGFSfiGtqmhzJ4fkhYLxGjqFvLCB6hG,5615,89890,-84275,625
2022-01-30 23:23:01-05:00,11134,EF6H6aW1p3qcAtiLFU9rbFYfsKfD683meHXDw8hLdaZK,8vfJbpnK7SQcjpEBCzZJRW8JosNbsmTeJ2YXZCbM225c,True,912781,228194,1414,707,707,2BPYaeCXY4BCFSGFSfiGtqmhzJ4fkhYLxGjqFvLCB6hG,56587,760277,-703690,619
2022-01-30 23:23:13-05:00,11135,2r64Rnbu3ZjmJTHHUxxV9TWWGzwpAepA4ySbtKivBXCj,6RRzx6KLkMiFK9JSuznrSJGiPgkHwatBSskudHqbfKJ5,True,22578242,5644560,35247,17623,17624,2BPYaeCXY4BCFSGFSfiGtqmhzJ4fkhYLxGjqFvLCB6hG,1409902,18967789,-17557887,624
2022-01-30 23:23:15-05:00,11136,CaAzPATicBzeb4mPpf7r7FLcLVV2V2jchT7QUFKs9enb,2z9rfVSTk8qG7f8b5S3FrJWidPKidaWw2X8vDiRETQqW,True,11541291,2885322,18013,9006,9007,HfEnetJ7uBSmZWCjBNxdvv9HEC5nsW4wDV7wu6WnhWan,720531,8700158,-7979627,624
2022-01-30 23:23:59-05:00,11137,4YnbP4eceiKXGJrnsdMQJ65DkLuUWYotVSsUvovrpQkx,DAb3fCkTyKZtcBLxYepX8iG3h9evVfqxrQzvqvME61tq,True,22935346,5733836,35878,17939,17939,2BPYaeCXY4BCFSGFSfiGtqmhzJ4fkhYLxGjqFvLCB6hG,1435154,13820515,-12385361,625
2022-01-30 23:23:59-05:00,11138,ARB1q7bNcQ7grwFEZC6nk9Pfrrg7yZ2WK8zVqq5CEE8F,53e8mUYrWzQnCm9XQyp18CL9owyPqJcYyxZANYhRypPx,True,704435,176108,1102,551,551,2BPYaeCXY4BCFSGFSfiGtqmhzJ4fkhYLxGjqFvLCB6hG,44091,336411,-292320,625
2022-01-30 23:29:55-05:00,11139,9Wzu7BWPgx9JRwuituo7vxNXVkpRA7C5W62CATnPpy6Q,GYPiAfGtfkMjDKdi6MrM7VXzpSwPnp2qWwwCX4iFGVtq,True,400438631,100109657,625104,312552,312552,2BPYaeCXY4BCFSGFSfiGtqmhzJ4fkhYLxGjqFvLCB6hG,25004178,248060537,-223056359,624
2022-01-30 23:31:19-05:00,11140,HGAFdundf5voDqeh9g7d6Q9mgMf8eEg898QMRBqwPZ6C,deanBuZXWBHEe2TGfP37S9aMBEnEgmZoyRJjAvruzfA,True,72961,18240,113,56,57,2BPYaeCXY4BCFSGFSfiGtqmhzJ4fkhYLxGjqFvLCB6hG,4556,93514,-88958,624
2022-01-30 23:31:28-05:00,11141,BCGTaPQxGEMjD7xUxwfwmVVYJ9CEGH33yJRi3QjwyiLE,JBct1cZ9a959UKwABBEefwxZnGTAAGLzyUdXrXqGGCZd,True,2430602,607650,3801,1900,1901,HfEnetJ7uBSmZWCjBNxdvv9HEC5nsW4wDV7wu6WnhWan,152064,1058990,-906926,625
2022-01-30 23:32:09-05:00,11142,9aQrdyfAvcBbBj7iKQB17eAS4zBqymdd3kzkTkuRhdLU,BDHhukMF5rALuSwCxaw8g73m2MN4oX1D4e7uNmx3SiVt,True,468345,117086,731,365,366,HfEnetJ7uBSmZWCjBNxdvv9HEC5nsW4wDV7wu6WnhWan,29269,392778,-363509,624
2022-01-30 23:32:16-05:00,11143,Fn6J1eMQJoA5rXCwX2HjAF86AowsJfULLuYXVfzgb8aX,6Ett2WPmz4HoWVSVEZD73UzFetd3oFSh7C676MEVYd36,True,235726138,58931534,367161,183580,183581,2BPYaeCXY4BCFSGFSfiGtqmhzJ4fkhYLxGjqFvLCB6hG,14686445,212607858,-197921413,623
2022-01-30 23:32:26-05:00,11144,4ytoBUwuhAL4YYSCa6AgwrpeVF4eeU8H9NfDxMPZKxPo,Pby2szzsxDrXt4gnbmmaMccXxctZALr8miRtKhGKjsD,True,19830,4957,30,15,15,HfEnetJ7uBSmZWCjBNxdvv9HEC5nsW4wDV7wu6WnhWan,1234,22791,-21557,622
2022-01-30 23:32:26-05:00,11145,9psSuFHBGqCvcgNMc7aTMhKMMFwBDmW7v5Wkn22KtTHj,7zi9LSfuEhXccQXSRukRRwgQUaiQVVgfsGaRYLP2JvwB,True,5895286,1473821,9188,4594,4594,HfEnetJ7uBSmZWCjBNxdvv9HEC5nsW4wDV7wu6WnhWan,367539,5042163,-4674624,623
2022-01-31 00:10:13-05:00,11146,9fTuwsgtFHkUNTTeRR1DWYTno8bbdvNLvqjxLymzbnTe,DacYn36aCNRJmYKiP697yGJTPZDK1nCq7Q1Y7KiXW7Jq,True,7791579,1947894,11981,5990,5991,3zqXX6kzhkbW3d4TwD2CNjMRwxTbREXySekvq37kfCNk,479250,4174941,-3695691,615
2022-01-31 20:29:37-05:00,11147,6Z21rKncoJkLt4pkCrfiWw4m9bmkbF3ZNgocQ6WxViKf,14bbVwC4hEJMKRHM2v6N416HMQcr9fmTnt5anBGYTM5L,True,67877606,16969401,104329,52164,52165,HfEnetJ7uBSmZWCjBNxdvv9HEC5nsW4wDV7wu6WnhWan,4173166,12060773,-7887607,614
2022-01-31 22:22:16-05:00,11148,6Z21rKncoJkLt4pkCrfiWw4m9bmkbF3ZNgocQ6WxViKf,14bbVwC4hEJMKRHM2v6N416HMQcr9fmTnt5anBGYTM5L,True,51808999,12952249,79239,39619,39620,HfEnetJ7uBSmZWCjBNxdvv9HEC5nsW4wDV7wu6WnhWan,3169564,9986094,-6816530,611
2022-01-31 22:22:52-05:00,11149,4Bi1PEYPfA5VEoBqzGbt5fSd6PwuVsrF5SfLWXtpNxFA,3aApRXGYkRs9AZXchR5i7HnWXiRvBQgg3fz1bb4gMx2U,True,182737780,45684444,285451,142725,142726,2BPYaeCXY4BCFSGFSfiGtqmhzJ4fkhYLxGjqFvLCB6hG,11418072,37206501,-25788429,624
2022-01-31 22:34:31-05:00,11150,Fqv7VT7nfxUGb18xwFJLTo8gsdjhpAJpMveqDK4aRw83,Ha9N6X6oL8kkoDpXtrybq2ocSPJUEeYHwqoAjxiTJ7rV,True,164684574,41171143,255677,127838,127839,2BPYaeCXY4BCFSGFSfiGtqmhzJ4fkhYLxGjqFvLCB6hG,10227096,31419271,-21192175,621
2022-01-31 22:35:43-05:00,11151,Ar1byxam88MXtpNKFNK28ar8reMDEJE7vdg3KGJHeZwt,Gv2D2eMAA3YgfhBg8kbtqWgM7as3RJGiY9oyTjPH8j8P,True,1199929,299982,1876,938,938,HfEnetJ7uBSmZWCjBNxdvv9HEC5nsW4wDV7wu6WnhWan,75055,221297,-146242,625
2022-01-31 22:36:55-05:00,11152,53ePCviKDQrvrk285FVrHhxmN3avWEzLqWsSk5w3PkGT,Ax59hjzmP64tGFd5msTyh1ueeVNhHAhtKkyymC6HpfAK,True,1309060,327265,2035,1017,1018,3zqXX6kzhkbW3d4TwD2CNjMRwxTbREXySekvq37kfCNk,81431,241061,-159630,622
2022-01-31 22:37:58-05:00,11153,CBL2NbekJrXvBiAcoj4fzQ4PfLDwTntW7Zt4nruHFYEw,59EvfgYTdKkfjUJz5LddLUAqbEdLaihcMzjcrTZsyzyS,True,481541,120385,749,374,375,2BPYaeCXY4BCFSGFSfiGtqmhzJ4fkhYLxGjqFvLCB6hG,29962,95192,-65230,622
2022-01-31 22:41:34-05:00,11154,7SBSVWCWENfJpg3Rd61kHjvj7rf5RchHeWChE42jdfk2,GNgZk4pw4cyetbovfqLtjdD5eEJTvJmrNbk572XnBeeN,True,3352714,838178,5217,2608,2609,3zqXX6kzhkbW3d4TwD2CNjMRwxTbREXySekvq37kfCNk,208684,668435,-459751,622
2022-01-31 22:41:36-05:00,11155,2Cjv6suZGsbRtv4TNSYksWKwMEKEf8vGQhGPbVVM1BMP,BHakHWmqzwqzq7i3a7VmXySPMMit58aQn7z4fqorcBHD,True,924993,231248,1425,712,713,3zqXX6kzhkbW3d4TwD2CNjMRwxTbREXySekvq37kfCNk,57032,183273,-126241,616
2022-01-31 22:41:41-05:00,11156,6Z21rKncoJkLt4pkCrfiWw4m9bmkbF3ZNgocQ6WxViKf,14bbVwC4hEJMKRHM2v6N416HMQcr9fmTnt5anBGYTM5L,True,39542215,9885553,60121,30060,30061,HfEnetJ7uBSmZWCjBNxdvv9HEC5nsW4wDV7wu6WnhWan,2404860,8202740,-5797880,608
2022-01-31 22:48:07-05:00,11157,Fqv7VT7nfxUGb18xwFJLTo8gsdjhpAJpMveqDK4aRw83,Ha9N6X6oL8kkoDpXtrybq2ocSPJUEeYHwqoAjxiTJ7rV,True,125640537,31410134,196107,98053,98054,HfEnetJ7uBSmZWCjBNxdvv9HEC5nsW4wDV7wu6WnhWan,7844313,25865726,-18021413,624
2022-01-31 22:48:19-05:00,11158,Ar1byxam88MXtpNKFNK28ar8reMDEJE7vdg3KGJHeZwt,Gv2D2eMAA3YgfhBg8kbtqWgM7as3RJGiY9oyTjPH8j8P,True,917003,229250,1403,701,702,2BPYaeCXY4BCFSGFSfiGtqmhzJ4fkhYLxGjqFvLCB6hG,56123,182860,-126737,612
2022-01-31 22:49:05-05:00,11159,53ePCviKDQrvrk285FVrHhxmN3avWEzLqWsSk5w3PkGT,Ax59hjzmP64tGFd5msTyh1ueeVNhHAhtKkyymC6HpfAK,True,998754,249688,1560,780,780,HfEnetJ7uBSmZWCjBNxdvv9HEC5nsW4wDV7wu6WnhWan,62437,199118,-136681,625
2022-01-31 22:50:07-05:00,11160,CBL2NbekJrXvBiAcoj4fzQ4PfLDwTntW7Zt4nruHFYEw,59EvfgYTdKkfjUJz5LddLUAqbEdLaihcMzjcrTZsyzyS,True,367383,91845,574,287,287,2BPYaeCXY4BCFSGFSfiGtqmhzJ4fkhYLxGjqFvLCB6hG,22986,78135,-55149,625
2022-02-01 04:04:18-05:00,11161,7SBSVWCWENfJpg3Rd61kHjvj7rf5RchHeWChE42jdfk2,GNgZk4pw4cyetbovfqLtjdD5eEJTvJmrNbk572XnBeeN,True,2559552,639888,3970,1985,1985,3zqXX6kzhkbW3d4TwD2CNjMRwxTbREXySekvq37kfCNk,158814,548643,-389829,620
2022-02-01 04:04:18-05:00,11162,2Cjv6suZGsbRtv4TNSYksWKwMEKEf8vGQhGPbVVM1BMP,BHakHWmqzwqzq7i3a7VmXySPMMit58aQn7z4fqorcBHD,True,706049,176512,1085,542,543,3zqXX6kzhkbW3d4TwD2CNjMRwxTbREXySekvq37kfCNk,43403,150387,-106984,614
2022-02-01 04:04:23-05:00,11163,4v6CPCxRjQfBAnHQT1yD9ZN87xf2fsrg9Qq2TBk8uwnw,4vw7teF227NahBhsX4z7k8UnSjVtkx6dhk4YFQXap9Qh,True,365587,91396,565,282,283,3zqXX6kzhkbW3d4TwD2CNjMRwxTbREXySekvq37kfCNk,22605,70825,-48220,618
2022-02-01 04:04:24-05:00,11164,6Z21rKncoJkLt4pkCrfiWw4m9bmkbF3ZNgocQ6WxViKf,14bbVwC4hEJMKRHM2v6N416HMQcr9fmTnt5anBGYTM5L,True,30159422,7539855,46156,23078,23078,HfEnetJ7uBSmZWCjBNxdvv9HEC5nsW4wDV7wu6WnhWan,1846254,6697434,-4851180,612
2022-02-01 04:04:38-05:00,11165,Fqv7VT7nfxUGb18xwFJLTo8gsdjhpAJpMveqDK4aRw83,Ha9N6X6oL8kkoDpXtrybq2ocSPJUEeYHwqoAjxiTJ7rV,True,95989192,23997298,147574,73787,73787,HfEnetJ7uBSmZWCjBNxdvv9HEC5nsW4wDV7wu6WnhWan,5902983,21177931,-15274948,614
2022-02-01 04:04:38-05:00,11166,Ar1byxam88MXtpNKFNK28ar8reMDEJE7vdg3KGJHeZwt,Gv2D2eMAA3YgfhBg8kbtqWgM7as3RJGiY9oyTjPH8j8P,True,698865,174716,1092,546,546,2BPYaeCXY4BCFSGFSfiGtqmhzJ4fkhYLxGjqFvLCB6hG,43706,149870,-106164,625
2022-02-01 08:53:02-05:00,11167,4Bi1PEYPfA5VEoBqzGbt5fSd6PwuVsrF5SfLWXtpNxFA,3aApRXGYkRs9AZXchR5i7HnWXiRvBQgg3fz1bb4gMx2U,True,140203083,35050770,216035,108017,108018,2BPYaeCXY4BCFSGFSfiGtqmhzJ4fkhYLxGjqFvLCB6hG,8641428,30482179,-21840751,616
2022-02-01 09:03:53-05:00,11168,53ePCviKDQrvrk285FVrHhxmN3avWEzLqWsSk5w3PkGT,Ax59hjzmP64tGFd5msTyh1ueeVNhHAhtKkyymC6HpfAK,True,763145,190786,1173,586,587,2BPYaeCXY4BCFSGFSfiGtqmhzJ4fkhYLxGjqFvLCB6hG,46951,163540,-116589,615
2022-02-01 09:03:59-05:00,11169,CBL2NbekJrXvBiAcoj4fzQ4PfLDwTntW7Zt4nruHFYEw,59EvfgYTdKkfjUJz5LddLUAqbEdLaihcMzjcrTZsyzyS,True,280639,70159,434,217,217,2BPYaeCXY4BCFSGFSfiGtqmhzJ4fkhYLxGjqFvLCB6hG,17367,63830,-46463,618
2022-02-01 09:24:40-05:00,11170,2Cjv6suZGsbRtv4TNSYksWKwMEKEf8vGQhGPbVVM1BMP,BHakHWmqzwqzq7i3a7VmXySPMMit58aQn7z4fqorcBHD,True,538293,134573,839,419,420,3zqXX6kzhkbW3d4TwD2CNjMRwxTbREXySekvq37kfCNk,33594,122588,-88994,624
2022-02-01 09:24:50-05:00,11171,7SBSVWCWENfJpg3Rd61kHjvj7rf5RchHeWChE42jdfk2,GNgZk4pw4cyetbovfqLtjdD5eEJTvJmrNbk572XnBeeN,True,1952684,488171,3048,1524,1524,3zqXX6kzhkbW3d4TwD2CNjMRwxTbREXySekvq37kfCNk,121941,447332,-325391,624
2022-02-01 09:25:05-05:00,11172,DmrkajG3SrTXnYSYxGRfkzfvhkevD6RdtFk4SdLC2G6Q,5r7vkWH985E2mGSDBtznduhuu5PbZJ7d4zxjzhzEEZG1,True,63960152393,15990038097,99201965,49600982,49600983,3zqXX6kzhkbW3d4TwD2CNjMRwxTbREXySekvq37kfCNk,3968078612,12835443423,-8867364811,620
2022-02-01 09:25:08-05:00,11173,HcGtTcpuxex2eQyz6GjJHrjDgThU2ZWSjjnzNEf7tNXy,XuFuE8RxTusW8BYDczgzvWrD5YbDseACo2edd2K4tVv,True,137110,34277,212,106,106,HfEnetJ7uBSmZWCjBNxdvv9HEC5nsW4wDV7wu6WnhWan,8505,28432,-19927,620
2022-02-01 09:25:08-05:00,11174,6Z21rKncoJkLt4pkCrfiWw4m9bmkbF3ZNgocQ6WxViKf,14bbVwC4hEJMKRHM2v6N416HMQcr9fmTnt5anBGYTM5L,True,23003176,5750794,35446,17723,17723,2BPYaeCXY4BCFSGFSfiGtqmhzJ4fkhYLxGjqFvLCB6hG,1417865,5439864,-4021999,616
2022-02-01 09:25:08-05:00,11175,AcYBSWf2zG931K8WHncTWcNZhjrsJVWB9KQcTKhCoDw6,82Bw7jathCEZbRn9dExCPGpZAmxxdHkhVZ9hu7rQ3ZKY,True,49897864,12474466,76772,38386,38386,2BPYaeCXY4BCFSGFSfiGtqmhzJ4fkhYLxGjqFvLCB6hG,3070906,8762770,-5691864,615
2022-02-01 09:25:10-05:00,11176,4v6CPCxRjQfBAnHQT1yD9ZN87xf2fsrg9Qq2TBk8uwnw,4vw7teF227NahBhsX4z7k8UnSjVtkx6dhk4YFQXap9Qh,True,278875,69718,434,217,217,HfEnetJ7uBSmZWCjBNxdvv9HEC5nsW4wDV7wu6WnhWan,17372,58221,-40849,622
2022-02-01 09:25:28-05:00,11177,Fqv7VT7nfxUGb18xwFJLTo8gsdjhpAJpMveqDK4aRw83,Ha9N6X6oL8kkoDpXtrybq2ocSPJUEeYHwqoAjxiTJ7rV,True,73371565,18342891,109502,54751,54751,HfEnetJ7uBSmZWCjBNxdvv9HEC5nsW4wDV7wu6WnhWan,4380106,17216044,-12835938,596
2022-02-01 09:25:31-05:00,11178,53ePCviKDQrvrk285FVrHhxmN3avWEzLqWsSk5w3PkGT,Ax59hjzmP64tGFd5msTyh1ueeVNhHAhtKkyymC6HpfAK,True,581769,145442,909,454,455,DddJ7EWCmYEEZETCBNgAUSg81Ls6fZtiAaY5ekJ5sXx1,36368,133219,-96851,625
2022-02-01 09:25:32-05:00,11179,Ar1byxam88MXtpNKFNK28ar8reMDEJE7vdg3KGJHeZwt,Gv2D2eMAA3YgfhBg8kbtqWgM7as3RJGiY9oyTjPH8j8P,True,534745,133686,801,400,401,2BPYaeCXY4BCFSGFSfiGtqmhzJ4fkhYLxGjqFvLCB6hG,32049,122268,-90219,599
2022-02-01 11:34:39-05:00,11180,4Bi1PEYPfA5VEoBqzGbt5fSd6PwuVsrF5SfLWXtpNxFA,3aApRXGYkRs9AZXchR5i7HnWXiRvBQgg3fz1bb4gMx2U,True,106399238,26599808,163715,81857,81858,3zqXX6kzhkbW3d4TwD2CNjMRwxTbREXySekvq37kfCNk,6548612,24799534,-18250922,615
2022-02-01 11:34:41-05:00,11181,54rcQUxBXFfoNq8n9RxsxH1Lp4VHR2CfE71vCCVy6rPQ,4exavmUP5CfqEmqVusSNuW9Ha2rhPBAy2gg6rP2d5tvu,True,1751459004,437864751,2723518,1361759,1361759,HfEnetJ7uBSmZWCjBNxdvv9HEC5nsW4wDV7wu6WnhWan,108940753,537798335,-428857582,622
2022-02-01 11:34:42-05:00,11182,CBL2NbekJrXvBiAcoj4fzQ4PfLDwTntW7Zt4nruHFYEw,59EvfgYTdKkfjUJz5LddLUAqbEdLaihcMzjcrTZsyzyS,True,214053,53513,333,166,167,3zqXX6kzhkbW3d4TwD2CNjMRwxTbREXySekvq37kfCNk,13359,51779,-38420,624
2022-02-01 11:35:02-05:00,11183,2Cjv6suZGsbRtv4TNSYksWKwMEKEf8vGQhGPbVVM1BMP,BHakHWmqzwqzq7i3a7VmXySPMMit58aQn7z4fqorcBHD,True,411085,102771,634,317,317,2BPYaeCXY4BCFSGFSfiGtqmhzJ4fkhYLxGjqFvLCB6hG,25388,99498,-74110,617
2022-02-01 11:35:05-05:00,11184,7SBSVWCWENfJpg3Rd61kHjvj7rf5RchHeWChE42jdfk2,GNgZk4pw4cyetbovfqLtjdD5eEJTvJmrNbk572XnBeeN,True,1490621,372655,2319,1159,1160,3zqXX6kzhkbW3d4TwD2CNjMRwxTbREXySekvq37kfCNk,92777,362928,-270151,622
2022-02-01 11:49:21-05:00,11185,AcYBSWf2zG931K8WHncTWcNZhjrsJVWB9KQcTKhCoDw6,82Bw7jathCEZbRn9dExCPGpZAmxxdHkhVZ9hu7rQ3ZKY,True,38044121,9511030,59329,29664,29665,2BPYaeCXY4BCFSGFSfiGtqmhzJ4fkhYLxGjqFvLCB6hG,2373190,7262827,-4889637,623
2022-02-01 11:49:22-05:00,11186,6Z21rKncoJkLt4pkCrfiWw4m9bmkbF3ZNgocQ6WxViKf,14bbVwC4hEJMKRHM2v6N416HMQcr9fmTnt5anBGYTM5L,True,17541150,4385287,27338,13669,13669,2BPYaeCXY4BCFSGFSfiGtqmhzJ4fkhYLxGjqFvLCB6hG,1093549,4398819,-3305270,623
2022-02-01 11:50:45-05:00,11187,HcGtTcpuxex2eQyz6GjJHrjDgThU2ZWSjjnzNEf7tNXy,XuFuE8RxTusW8BYDczgzvWrD5YbDseACo2edd2K4tVv,True,104591,26147,163,81,82,2BPYaeCXY4BCFSGFSfiGtqmhzJ4fkhYLxGjqFvLCB6hG,6535,23238,-16703,624
2022-02-01 11:51:09-05:00,11188,4v6CPCxRjQfBAnHQT1yD9ZN87xf2fsrg9Qq2TBk8uwnw,4vw7teF227NahBhsX4z7k8UnSjVtkx6dhk4YFQXap9Qh,True,212899,53224,329,164,165,HfEnetJ7uBSmZWCjBNxdvv9HEC5nsW4wDV7wu6WnhWan,13195,47574,-34379,619
2022-02-01 11:57:42-05:00,11189,Fqv7VT7nfxUGb18xwFJLTo8gsdjhpAJpMveqDK4aRw83,Ha9N6X6oL8kkoDpXtrybq2ocSPJUEeYHwqoAjxiTJ7rV,True,55851270,13962817,86192,43096,43096,3zqXX6kzhkbW3d4TwD2CNjMRwxTbREXySekvq37kfCNk,3447684,13897265,-10449581,617
2022-02-01 11:57:44-05:00,11190,DmrkajG3SrTXnYSYxGRfkzfvhkevD6RdtFk4SdLC2G6Q,5r7vkWH985E2mGSDBtznduhuu5PbZJ7d4zxjzhzEEZG1,True,48850385202,12212596299,75721916,37860958,37860958,HfEnetJ7uBSmZWCjBNxdvv9HEC5nsW4wDV7wu6WnhWan,3028876669,10534812869,-7505936200,620
2022-02-01 11:57:47-05:00,11191,Ar1byxam88MXtpNKFNK28ar8reMDEJE7vdg3KGJHeZwt,Gv2D2eMAA3YgfhBg8kbtqWgM7as3RJGiY9oyTjPH8j8P,True,407252,101813,626,313,313,2BPYaeCXY4BCFSGFSfiGtqmhzJ4fkhYLxGjqFvLCB6hG,25053,98910,-73857,615
2022-02-01 11:57:50-05:00,11192,6xeNr9LhAfC6FRV62dALYdgx3bsoUpUpmEBiUPYCV5fz,8GP5cEpfNTEjvqm9usBUXs7jPCK5RciqjVJqtvX9fuGs,True,199507057,49876764,306711,153355,153356,3zqXX6kzhkbW3d4TwD2CNjMRwxTbREXySekvq37kfCNk,12268478,35185536,-22917058,614
2022-02-01 11:57:51-05:00,11193,DE8c5VWwgCqQnUMSyMZEbKazQAsSjY52L85yojCr57X5,6ycUU1Tc7HG3J8hE6jwkRFCkdbEqyU95ZKY6HbfnYcGo,True,123292,30823,188,94,94,3zqXX6kzhkbW3d4TwD2CNjMRwxTbREXySekvq37kfCNk,7552,28513,-20961,612
2022-02-01 11:58:06-05:00,11194,53ePCviKDQrvrk285FVrHhxmN3avWEzLqWsSk5w3PkGT,Ax59hjzmP64tGFd5msTyh1ueeVNhHAhtKkyymC6HpfAK,True,444131,111032,691,345,346,2BPYaeCXY4BCFSGFSfiGtqmhzJ4fkhYLxGjqFvLCB6hG,27653,108095,-80442,622
2022-02-01 11:58:15-05:00,11195,winXxFA6HNBu1BTxfeecCfFfYrgQd9JHrF67zU5Xake,H8kGL9rpbEjDZitZfyezJ9bfaEDXe3teAvnb62iLFFVr,True,4519012,1129753,6944,3472,3472,3zqXX6kzhkbW3d4TwD2CNjMRwxTbREXySekvq37kfCNk,277776,1001292,-723516,614
2022-02-01 11:58:28-05:00,11196,CBL2NbekJrXvBiAcoj4fzQ4PfLDwTntW7Zt4nruHFYEw,59EvfgYTdKkfjUJz5LddLUAqbEdLaihcMzjcrTZsyzyS,True,163374,40843,254,127,127,2BPYaeCXY4BCFSGFSfiGtqmhzJ4fkhYLxGjqFvLCB6hG,10192,41841,-31649,623
2022-02-01 11:58:28-05:00,11197,54rcQUxBXFfoNq8n9RxsxH1Lp4VHR2CfE71vCCVy6rPQ,4exavmUP5CfqEmqVusSNuW9Ha2rhPBAy2gg6rP2d5tvu,True,1336833605,334208401,2074447,1037223,1037224,2BPYaeCXY4BCFSGFSfiGtqmhzJ4fkhYLxGjqFvLCB6hG,82977883,427877186,-344899303,620
2022-02-02 14:34:56-05:00,11198,4Bi1PEYPfA5VEoBqzGbt5fSd6PwuVsrF5SfLWXtpNxFA,3aApRXGYkRs9AZXchR5i7HnWXiRvBQgg3fz1bb4gMx2U,True,78323931,19580982,122250,61125,61125,2BPYaeCXY4BCFSGFSfiGtqmhzJ4fkhYLxGjqFvLCB6hG,4890014,20053130,-15163116,624
2022-02-02 20:52:02-05:00,11199,2rLWe1XADCU93guPU6WgSW6x56gYNfif9bm11V93mJnv,BEGhQRm3fgSHeBtk2DYrXEBPKPRvS3sHyTNopmoBJxMs,True,657651670,164412917,1027763,513881,513882,2BPYaeCXY4BCFSGFSfiGtqmhzJ4fkhYLxGjqFvLCB6hG,41110551,444622772,-403512221,625
2022-02-02 21:07:31-05:00,11200,F2AU2PjaSmHxWWhkz8XxMggkCMWbMVgawt89tSnYS6RL,ET9febRJiW197DYMaJbgk3kWsAeFv5f4peQ4vFCVppK6,True,2269697712,567424428,3544831,1772415,1772416,HfEnetJ7uBSmZWCjBNxdvv9HEC5nsW4wDV7wu6WnhWan,141793260,641912197,-500118937,624
2022-02-03 04:58:15-05:00,11201,3jJxvfbyc9KvECkLWTGptkezCLZfiums7GgfANyCULF3,C7fXi4upWW22F2Ak7AzsYVASjjdfZZtPmkQ9pBB2bJXZ,True,191714616,47928654,295247,147623,147624,HfEnetJ7uBSmZWCjBNxdvv9HEC5nsW4wDV7wu6WnhWan,11809883,92226843,-80416960,616
2022-02-04 11:56:26-05:00,11202,9u17v94ue2ShRM9gW4ZMq9GPeYLg3ZP4RioVmkqtSeMc,53Dr7QDS2wDNMnhHHXhxNV9gpSFkAGwsaqrrpZF3oRKq,True,38631076929,9657769231,58974403,29487201,29487202,2BPYaeCXY4BCFSGFSfiGtqmhzJ4fkhYLxGjqFvLCB6hG,2358976154,3722369689,-1363393535,610
2022-02-04 18:49:09-05:00,11203,63a7SaSJr3AKiHEWJjfqZMQjshZpa2AKeSLN6JAnNRnq,2KkuFUWtLo53MPiVBKyPETAaZuf1xvxzy1ZwbEYdnf2a,True,4685958643,1171489660,7279296,3639648,3639648,HfEnetJ7uBSmZWCjBNxdvv9HEC5nsW4wDV7wu6WnhWan,291171841,842550485,-551378644,621
2022-02-04 18:51:31-05:00,11204,EeztHR1M4PPacJEZ6c5arCRVCuu8aN7eGdpY1u4bev79,9Twdc9Xrzv2oeJ9Fbd8mRvzjbFi7mkGopFS37SMabeAK,True,9799690,2449922,15307,7653,7654,DddJ7EWCmYEEZETCBNgAUSg81Ls6fZtiAaY5ekJ5sXx1,612284,1522075,-909791,624
2022-02-04 22:58:36-05:00,11205,2GdkcQGpbeyY168AZsiVnw2FFSv7SJikveN5ux2b6DPJ,B8fAPFAAu75P8HCFftLFEXGvHYJtGAeJWjtdxgvdZKzz,True,14296423,3574105,22348,11174,11174,DddJ7EWCmYEEZETCBNgAUSg81Ls6fZtiAaY5ekJ5sXx1,893950,200352,693598,625
2022-02-04 23:01:37-05:00,11206,2Cjv6suZGsbRtv4TNSYksWKwMEKEf8vGQhGPbVVM1BMP,BHakHWmqzwqzq7i3a7VmXySPMMit58aQn7z4fqorcBHD,True,313952,78488,491,245,246,DddJ7EWCmYEEZETCBNgAUSg81Ls6fZtiAaY5ekJ5sXx1,19640,80860,-61220,625
2022-02-04 23:01:42-05:00,11207,7SBSVWCWENfJpg3Rd61kHjvj7rf5RchHeWChE42jdfk2,GNgZk4pw4cyetbovfqLtjdD5eEJTvJmrNbk572XnBeeN,True,1139186,284796,1778,889,889,DddJ7EWCmYEEZETCBNgAUSg81Ls6fZtiAaY5ekJ5sXx1,71139,294972,-223833,624
2022-02-04 23:02:23-05:00,11208,Dztk7aGAPGgmyQ4kF9s5bVJ3zFPjXm6wLirhFMG1UQCw,sDX9hCP4LjF1tsfbfAcvRrUre3TsTn5RUqHsUeEHjbW,True,5307726732,1326931681,8302836,4151418,4151418,DddJ7EWCmYEEZETCBNgAUSg81Ls6fZtiAaY5ekJ5sXx1,332113467,539375503,-207262036,625
2022-02-04 23:04:19-05:00,11209,AcYBSWf2zG931K8WHncTWcNZhjrsJVWB9KQcTKhCoDw6,82Bw7jathCEZbRn9dExCPGpZAmxxdHkhVZ9hu7rQ3ZKY,True,29084256,7271064,45278,22639,22639,DddJ7EWCmYEEZETCBNgAUSg81Ls6fZtiAaY5ekJ5sXx1,1811152,6029554,-4218402,622
2022-02-04 23:04:22-05:00,11210,6Z21rKncoJkLt4pkCrfiWw4m9bmkbF3ZNgocQ6WxViKf,14bbVwC4hEJMKRHM2v6N416HMQcr9fmTnt5anBGYTM5L,True,13408830,3352207,20889,10444,10445,DddJ7EWCmYEEZETCBNgAUSg81Ls6fZtiAaY5ekJ5sXx1,835582,3567503,-2731921,623
2022-02-04 23:04:29-05:00,11211,HcGtTcpuxex2eQyz6GjJHrjDgThU2ZWSjjnzNEf7tNXy,XuFuE8RxTusW8BYDczgzvWrD5YbDseACo2edd2K4tVv,True,79973,19993,124,62,62,2BPYaeCXY4BCFSGFSfiGtqmhzJ4fkhYLxGjqFvLCB6hG,4976,19032,-14056,622
2022-02-04 23:04:29-05:00,11212,4v6CPCxRjQfBAnHQT1yD9ZN87xf2fsrg9Qq2TBk8uwnw,4vw7teF227NahBhsX4z7k8UnSjVtkx6dhk4YFQXap9Qh,True,162645,40661,254,127,127,2BPYaeCXY4BCFSGFSfiGtqmhzJ4fkhYLxGjqFvLCB6hG,10166,38920,-28754,625
2022-02-04 23:10:58-05:00,11213,Fqv7VT7nfxUGb18xwFJLTo8gsdjhpAJpMveqDK4aRw83,Ha9N6X6oL8kkoDpXtrybq2ocSPJUEeYHwqoAjxiTJ7rV,True,42681425,10670356,65985,32992,32993,DddJ7EWCmYEEZETCBNgAUSg81Ls6fZtiAaY5ekJ5sXx1,2639407,11269583,-8630176,618
2022-02-04 23:11:01-05:00,11214,Ar1byxam88MXtpNKFNK28ar8reMDEJE7vdg3KGJHeZwt,Gv2D2eMAA3YgfhBg8kbtqWgM7as3RJGiY9oyTjPH8j8P,True,310936,77734,486,243,243,2BPYaeCXY4BCFSGFSfiGtqmhzJ4fkhYLxGjqFvLCB6hG,19446,80335,-60889,625
2022-02-04 23:19:26-05:00,11215,DE8c5VWwgCqQnUMSyMZEbKazQAsSjY52L85yojCr57X5,6ycUU1Tc7HG3J8hE6jwkRFCkdbEqyU95ZKY6HbfnYcGo,True,94102,23525,147,73,74,DddJ7EWCmYEEZETCBNgAUSg81Ls6fZtiAaY5ekJ5sXx1,5887,23240,-17353,625
2022-02-04 23:19:42-05:00,11216,6xeNr9LhAfC6FRV62dALYdgx3bsoUpUpmEBiUPYCV5fz,8GP5cEpfNTEjvqm9usBUXs7jPCK5RciqjVJqtvX9fuGs,True,152359695,38089923,237124,118562,118562,DddJ7EWCmYEEZETCBNgAUSg81Ls6fZtiAaY5ekJ5sXx1,9484984,29402432,-19917448,622
2022-02-04 23:19:46-05:00,11217,DmrkajG3SrTXnYSYxGRfkzfvhkevD6RdtFk4SdLC2G6Q,5r7vkWH985E2mGSDBtznduhuu5PbZJ7d4zxjzhzEEZG1,True,37883950458,9470987613,58793353,29396676,29396677,3zqXX6kzhkbW3d4TwD2CNjMRwxTbREXySekvq37kfCNk,2351734122,8625264965,-6273530843,620
2022-02-04 23:19:49-05:00,11218,53ePCviKDQrvrk285FVrHhxmN3avWEzLqWsSk5w3PkGT,Ax59hjzmP64tGFd5msTyh1ueeVNhHAhtKkyymC6HpfAK,True,339598,84899,525,262,263,3zqXX6kzhkbW3d4TwD2CNjMRwxTbREXySekvq37kfCNk,21024,87854,-66830,619
2022-02-04 23:20:21-05:00,11219,winXxFA6HNBu1BTxfeecCfFfYrgQd9JHrF67zU5Xake,H8kGL9rpbEjDZitZfyezJ9bfaEDXe3teAvnb62iLFFVr,True,3450949,862737,5371,2685,2686,HfEnetJ7uBSmZWCjBNxdvv9HEC5nsW4wDV7wu6WnhWan,214848,819175,-604327,622
2022-02-04 23:28:06-05:00,11220,54rcQUxBXFfoNq8n9RxsxH1Lp4VHR2CfE71vCCVy6rPQ,4exavmUP5CfqEmqVusSNuW9Ha2rhPBAy2gg6rP2d5tvu,True,1021848438,255462109,1584103,792051,792052,DddJ7EWCmYEEZETCBNgAUSg81Ls6fZtiAaY5ekJ5sXx1,63364121,341271345,-277907224,620
2022-02-04 23:28:08-05:00,11221,CBL2NbekJrXvBiAcoj4fzQ4PfLDwTntW7Zt4nruHFYEw,59EvfgYTdKkfjUJz5LddLUAqbEdLaihcMzjcrTZsyzyS,True,124896,31224,194,97,97,DddJ7EWCmYEEZETCBNgAUSg81Ls6fZtiAaY5ekJ5sXx1,7778,33879,-26101,622
2022-02-04 23:57:25-05:00,11222,2GdkcQGpbeyY168AZsiVnw2FFSv7SJikveN5ux2b6DPJ,B8fAPFAAu75P8HCFftLFEXGvHYJtGAeJWjtdxgvdZKzz,True,10911168,2727792,17059,8529,8530,DddJ7EWCmYEEZETCBNgAUSg81Ls6fZtiAaY5ekJ5sXx1,682396,351049,331347,625
2022-02-05 00:24:29-05:00,11223,Dztk7aGAPGgmyQ4kF9s5bVJ3zFPjXm6wLirhFMG1UQCw,sDX9hCP4LjF1tsfbfAcvRrUre3TsTn5RUqHsUeEHjbW,True,4051523632,1012880906,6320746,3160373,3160373,DddJ7EWCmYEEZETCBNgAUSg81Ls6fZtiAaY5ekJ5sXx1,252829859,479155594,-226325735,624
2022-02-05 00:25:14-05:00,11224,2Cjv6suZGsbRtv4TNSYksWKwMEKEf8vGQhGPbVVM1BMP,BHakHWmqzwqzq7i3a7VmXySPMMit58aQn7z4fqorcBHD,True,239667,59916,373,186,187,DddJ7EWCmYEEZETCBNgAUSg81Ls6fZtiAaY5ekJ5sXx1,14936,65054,-50118,623
2022-02-05 00:25:22-05:00,11225,7SBSVWCWENfJpg3Rd61kHjvj7rf5RchHeWChE42jdfk2,GNgZk4pw4cyetbovfqLtjdD5eEJTvJmrNbk572XnBeeN,True,869351,217337,1359,679,680,DddJ7EWCmYEEZETCBNgAUSg81Ls6fZtiAaY5ekJ5sXx1,54363,237198,-182835,625
2022-02-05 00:26:25-05:00,11226,6Z21rKncoJkLt4pkCrfiWw4m9bmkbF3ZNgocQ6WxViKf,14bbVwC4hEJMKRHM2v6N416HMQcr9fmTnt5anBGYTM5L,True,10234071,2558517,15920,7960,7960,HfEnetJ7uBSmZWCjBNxdvv9HEC5nsW4wDV7wu6WnhWan,636803,2863193,-2226390,622
2022-02-05 00:26:25-05:00,11227,AcYBSWf2zG931K8WHncTWcNZhjrsJVWB9KQcTKhCoDw6,82Bw7jathCEZbRn9dExCPGpZAmxxdHkhVZ9hu7rQ3ZKY,True,22199434,5549858,34466,17233,17233,HfEnetJ7uBSmZWCjBNxdvv9HEC5nsW4wDV7wu6WnhWan,1378672,4928720,-3550048,621
2022-02-05 00:26:32-05:00,11228,HcGtTcpuxex2eQyz6GjJHrjDgThU2ZWSjjnzNEf7tNXy,XuFuE8RxTusW8BYDczgzvWrD5YbDseACo2edd2K4tVv,True,61022,15255,95,47,48,DddJ7EWCmYEEZETCBNgAUSg81Ls6fZtiAaY5ekJ5sXx1,3808,15392,-11584,624
2022-02-05 00:31:43-05:00,11229,4v6CPCxRjQfBAnHQT1yD9ZN87xf2fsrg9Qq2TBk8uwnw,4vw7teF227NahBhsX4z7k8UnSjVtkx6dhk4YFQXap9Qh,True,124138,31034,193,96,97,DddJ7EWCmYEEZETCBNgAUSg81Ls6fZtiAaY5ekJ5sXx1,7753,31472,-23719,624
2022-02-05 00:39:28-05:00,11230,Fqv7VT7nfxUGb18xwFJLTo8gsdjhpAJpMveqDK4aRw83,Ha9N6X6oL8kkoDpXtrybq2ocSPJUEeYHwqoAjxiTJ7rV,True,32555831,8138957,50681,25340,25341,DddJ7EWCmYEEZETCBNgAUSg81Ls6fZtiAaY5ekJ5sXx1,2027255,9044659,-7017404,622
2022-02-05 00:46:19-05:00,11231,Ar1byxam88MXtpNKFNK28ar8reMDEJE7vdg3KGJHeZwt,Gv2D2eMAA3YgfhBg8kbtqWgM7as3RJGiY9oyTjPH8j8P,True,237344,59336,370,185,185,DddJ7EWCmYEEZETCBNgAUSg81Ls6fZtiAaY5ekJ5sXx1,14808,64616,-49808,623
2022-02-05 00:46:27-05:00,11232,DE8c5VWwgCqQnUMSyMZEbKazQAsSjY52L85yojCr57X5,6ycUU1Tc7HG3J8hE6jwkRFCkdbEqyU95ZKY6HbfnYcGo,True,71826,17956,112,56,56,DddJ7EWCmYEEZETCBNgAUSg81Ls6fZtiAaY5ekJ5sXx1,4488,18751,-14263,624
2022-02-05 00:46:44-05:00,11233,6xeNr9LhAfC6FRV62dALYdgx3bsoUpUpmEBiUPYCV5fz,8GP5cEpfNTEjvqm9usBUXs7jPCK5RciqjVJqtvX9fuGs,True,116249551,29062387,181576,90788,90788,DddJ7EWCmYEEZETCBNgAUSg81Ls6fZtiAaY5ekJ5sXx1,7263074,24181082,-16918008,624
2022-02-05 00:48:01-05:00,11234,53ePCviKDQrvrk285FVrHhxmN3avWEzLqWsSk5w3PkGT,Ax59hjzmP64tGFd5msTyh1ueeVNhHAhtKkyymC6HpfAK,True,259038,64759,403,201,202,DddJ7EWCmYEEZETCBNgAUSg81Ls6fZtiAaY5ekJ5sXx1,16149,70610,-54461,623
2022-02-05 00:48:07-05:00,11235,winXxFA6HNBu1BTxfeecCfFfYrgQd9JHrF67zU5Xake,H8kGL9rpbEjDZitZfyezJ9bfaEDXe3teAvnb62iLFFVr,True,2633382,658345,4104,2052,2052,DddJ7EWCmYEEZETCBNgAUSg81Ls6fZtiAaY5ekJ5sXx1,164194,662609,-498415,623
2022-02-05 00:48:31-05:00,11236,DmrkajG3SrTXnYSYxGRfkzfvhkevD6RdtFk4SdLC2G6Q,5r7vkWH985E2mGSDBtznduhuu5PbZJ7d4zxjzhzEEZG1,True,28906693547,7226673385,45118786,22559393,22559393,DddJ7EWCmYEEZETCBNgAUSg81Ls6fZtiAaY5ekJ5sXx1,1804751455,7001755070,-5197003615,624
2022-02-05 00:48:36-05:00,11237,54rcQUxBXFfoNq8n9RxsxH1Lp4VHR2CfE71vCCVy6rPQ,4exavmUP5CfqEmqVusSNuW9Ha2rhPBAy2gg6rP2d5tvu,True,779586263,194896565,1213667,606833,606834,2BPYaeCXY4BCFSGFSfiGtqmhzJ4fkhYLxGjqFvLCB6hG,48546706,270182460,-221635754,622
2022-02-05 00:48:40-05:00,11238,CBL2NbekJrXvBiAcoj4fzQ4PfLDwTntW7Zt4nruHFYEw,59EvfgYTdKkfjUJz5LddLUAqbEdLaihcMzjcrTZsyzyS,True,95296,23824,148,74,74,HfEnetJ7uBSmZWCjBNxdvv9HEC5nsW4wDV7wu6WnhWan,5956,27155,-21199,625
2022-02-05 00:54:14-05:00,11239,CvR57tmtnHbMmPivvJR6VenXivQaWue7z77N81WPpzfv,B4ASc8cUjrzuchv2SHwPrnjKvZgZpwvcLArsdYmMAqBQ,True,2661292812,665323203,4145922,2072961,2072961,3zqXX6kzhkbW3d4TwD2CNjMRwxTbREXySekvq37kfCNk,165836892,467879705,-302042813,623
2022-02-05 01:26:22-05:00,11240,5XoMaFny1TovLRJe7cXZt5pzJ9ptQKLm4cLstdNDZhFA,ExGHaJpqzRVMqG59McEpsa7Zfg12bjLAu4KRpR4ThQsZ,True,16583073,4145768,25870,12935,12935,DddJ7EWCmYEEZETCBNgAUSg81Ls6fZtiAaY5ekJ5sXx1,1034838,2914649,-1879811,624
2022-02-05 01:26:29-05:00,11241,2GdkcQGpbeyY168AZsiVnw2FFSv7SJikveN5ux2b6DPJ,B8fAPFAAu75P8HCFftLFEXGvHYJtGAeJWjtdxgvdZKzz,True,8331179,2082794,12915,6457,6458,2BPYaeCXY4BCFSGFSfiGtqmhzJ4fkhYLxGjqFvLCB6hG,516628,415921,100707,620
2022-02-05 01:27:00-05:00,11242,4Siq98BDakELWP5BzVoEN5tcg1ywRxTYs1aUcfW8spCt,2EBXLTVz1Gk9gS5JcVqCKAP5PatFGw1Vnww65Moz3SUn,True,6382480918,1595620228,9988578,4994289,4994289,DddJ7EWCmYEEZETCBNgAUSg81Ls6fZtiAaY5ekJ5sXx1,399543156,1556149607,-1156606451,625
2022-02-05 01:28:14-05:00,11243,2Cjv6suZGsbRtv4TNSYksWKwMEKEf8vGQhGPbVVM1BMP,BHakHWmqzwqzq7i3a7VmXySPMMit58aQn7z4fqorcBHD,True,182889,45722,285,142,143,DddJ7EWCmYEEZETCBNgAUSg81Ls6fZtiAaY5ekJ5sXx1,11413,52139,-40726,624
2022-02-05 01:28:18-05:00,11244,7SBSVWCWENfJpg3Rd61kHjvj7rf5RchHeWChE42jdfk2,GNgZk4pw4cyetbovfqLtjdD5eEJTvJmrNbk572XnBeeN,True,663584,165896,1034,517,517,DddJ7EWCmYEEZETCBNgAUSg81Ls6fZtiAaY5ekJ5sXx1,41391,190087,-148696,623
2022-02-05 01:29:06-05:00,11245,AcYBSWf2zG931K8WHncTWcNZhjrsJVWB9KQcTKhCoDw6,82Bw7jathCEZbRn9dExCPGpZAmxxdHkhVZ9hu7rQ3ZKY,True,16934746,4233686,26448,13224,13224,2BPYaeCXY4BCFSGFSfiGtqmhzJ4fkhYLxGjqFvLCB6hG,1057921,4005630,-2947709,624
2022-02-05 01:29:09-05:00,11246,6Z21rKncoJkLt4pkCrfiWw4m9bmkbF3ZNgocQ6WxViKf,14bbVwC4hEJMKRHM2v6N416HMQcr9fmTnt5anBGYTM5L,True,7807776,1951944,12203,6101,6102,3zqXX6kzhkbW3d4TwD2CNjMRwxTbREXySekvq37kfCNk,488147,2290162,-1802015,625
2022-02-05 01:29:20-05:00,11247,HcGtTcpuxex2eQyz6GjJHrjDgThU2ZWSjjnzNEf7tNXy,XuFuE8RxTusW8BYDczgzvWrD5YbDseACo2edd2K4tVv,True,46573,11643,72,36,36,DddJ7EWCmYEEZETCBNgAUSg81Ls6fZtiAaY5ekJ5sXx1,2904,12398,-9494,623
2022-02-05 01:29:25-05:00,11248,4v6CPCxRjQfBAnHQT1yD9ZN87xf2fsrg9Qq2TBk8uwnw,4vw7teF227NahBhsX4z7k8UnSjVtkx6dhk4YFQXap9Qh,True,94748,23687,147,73,74,DddJ7EWCmYEEZETCBNgAUSg81Ls6fZtiAaY5ekJ5sXx1,5910,25343,-19433,623
2022-02-06 18:20:48-05:00,11249,EeztHR1M4PPacJEZ6c5arCRVCuu8aN7eGdpY1u4bev79,9Twdc9Xrzv2oeJ9Fbd8mRvzjbFi7mkGopFS37SMabeAK,True,7482143,1870535,11703,5851,5852,DddJ7EWCmYEEZETCBNgAUSg81Ls6fZtiAaY5ekJ5sXx1,468141,1282860,-814719,625
2022-02-06 22:39:16-05:00,11250,Fqv7VT7nfxUGb18xwFJLTo8gsdjhpAJpMveqDK4aRw83,Ha9N6X6oL8kkoDpXtrybq2ocSPJUEeYHwqoAjxiTJ7rV,True,24841743,6210435,38840,19420,19420,3zqXX6kzhkbW3d4TwD2CNjMRwxTbREXySekvq37kfCNk,1553618,7241546,-5687928,625
2022-02-06 22:41:14-05:00,11251,DE8c5VWwgCqQnUMSyMZEbKazQAsSjY52L85yojCr57X5,6ycUU1Tc7HG3J8hE6jwkRFCkdbEqyU95ZKY6HbfnYcGo,True,54913,13728,83,41,42,2BPYaeCXY4BCFSGFSfiGtqmhzJ4fkhYLxGjqFvLCB6hG,3337,15077,-11740,607
2022-02-06 22:41:14-05:00,11252,6xeNr9LhAfC6FRV62dALYdgx3bsoUpUpmEBiUPYCV5fz,8GP5cEpfNTEjvqm9usBUXs7jPCK5RciqjVJqtvX9fuGs,True,88862972,22215743,135312,67656,67656,2BPYaeCXY4BCFSGFSfiGtqmhzJ4fkhYLxGjqFvLCB6hG,5412507,19776902,-14364395,609
2022-02-06 22:41:14-05:00,11253,Ar1byxam88MXtpNKFNK28ar8reMDEJE7vdg3KGJHeZwt,Gv2D2eMAA3YgfhBg8kbtqWgM7as3RJGiY9oyTjPH8j8P,True,181549,45387,272,136,136,HfEnetJ7uBSmZWCjBNxdvv9HEC5nsW4wDV7wu6WnhWan,10910,51807,-40897,600
2022-02-06 22:41:54-05:00,11254,53ePCviKDQrvrk285FVrHhxmN3avWEzLqWsSk5w3PkGT,Ax59hjzmP64tGFd5msTyh1ueeVNhHAhtKkyymC6HpfAK,True,197799,49449,306,153,153,2BPYaeCXY4BCFSGFSfiGtqmhzJ4fkhYLxGjqFvLCB6hG,12241,56607,-44366,618
2022-02-06 22:52:50-05:00,11255,8fSFsWaVRYHg5fdFQFQ89aBTjqsodGyc4sinV5UbWxtc,8evZpC24viqM8NaVFRjR91jLjXHLkW6GYAdywY8h2wys,True,419405077,104851267,645278,322639,322639,DddJ7EWCmYEEZETCBNgAUSg81Ls6fZtiAaY5ekJ5sXx1,25811126,98368587,-72557461,615
2022-02-06 22:53:29-05:00,11256,Dztk7aGAPGgmyQ4kF9s5bVJ3zFPjXm6wLirhFMG1UQCw,sDX9hCP4LjF1tsfbfAcvRrUre3TsTn5RUqHsUeEHjbW,True,3093087139,773271783,4840476,2420238,2420238,DddJ7EWCmYEEZETCBNgAUSg81Ls6fZtiAaY5ekJ5sXx1,193619054,418004159,-224385105,625
2022-02-06 22:56:04-05:00,11257,winXxFA6HNBu1BTxfeecCfFfYrgQd9JHrF67zU5Xake,H8kGL9rpbEjDZitZfyezJ9bfaEDXe3teAvnb62iLFFVr,True,2009642,502410,3140,1570,1570,DddJ7EWCmYEEZETCBNgAUSg81Ls6fZtiAaY5ekJ5sXx1,125639,534055,-408416,625
2022-02-06 22:59:16-05:00,11258,54rcQUxBXFfoNq8n9RxsxH1Lp4VHR2CfE71vCCVy6rPQ,4exavmUP5CfqEmqVusSNuW9Ha2rhPBAy2gg6rP2d5tvu,True,594909116,148727279,928976,464488,464488,DddJ7EWCmYEEZETCBNgAUSg81Ls6fZtiAaY5ekJ5sXx1,37159066,213608364,-176449298,624
2022-02-06 23:02:48-05:00,11259,CBL2NbekJrXvBiAcoj4fzQ4PfLDwTntW7Zt4nruHFYEw,59EvfgYTdKkfjUJz5LddLUAqbEdLaihcMzjcrTZsyzyS,True,72733,18183,113,56,57,3zqXX6kzhkbW3d4TwD2CNjMRwxTbREXySekvq37kfCNk,4551,21711,-17160,625
2022-02-06 23:19:58-05:00,11260,2uEPjuysyi2H75brTSXi8Ca5z3GhgNht14wskXJrUbk6,EhZ2URGbAjrVPnJ92MLLpbMRNPF6ctYnX34S2wjU81Va,True,5902264820,1475566205,9165116,4582558,4582558,HfEnetJ7uBSmZWCjBNxdvv9HEC5nsW4wDV7wu6WnhWan,366604679,1743752000,-1377147321,621
2022-02-06 23:23:29-05:00,11261,5XoMaFny1TovLRJe7cXZt5pzJ9ptQKLm4cLstdNDZhFA,ExGHaJpqzRVMqG59McEpsa7Zfg12bjLAu4KRpR4ThQsZ,True,12658666,3164666,19729,9864,9865,DddJ7EWCmYEEZETCBNgAUSg81Ls6fZtiAaY5ekJ5sXx1,789171,2420392,-1631221,623
2022-02-06 23:24:13-05:00,11262,2GdkcQGpbeyY168AZsiVnw2FFSv7SJikveN5ux2b6DPJ,B8fAPFAAu75P8HCFftLFEXGvHYJtGAeJWjtdxgvdZKzz,True,6365242,1591310,9691,4845,4846,DddJ7EWCmYEEZETCBNgAUSg81Ls6fZtiAaY5ekJ5sXx1,387640,428967,-41327,608
2022-02-06 23:42:43-05:00,11263,4Siq98BDakELWP5BzVoEN5tcg1ywRxTYs1aUcfW8spCt,2EBXLTVz1Gk9gS5JcVqCKAP5PatFGw1Vnww65Moz3SUn,True,4873701588,1218425395,7615367,3807683,3807684,DddJ7EWCmYEEZETCBNgAUSg81Ls6fZtiAaY5ekJ5sXx1,304614692,1259104446,-954489754,625
2022-02-07 01:19:12-05:00,11264,2uEPjuysyi2H75brTSXi8Ca5z3GhgNht14wskXJrUbk6,EhZ2URGbAjrVPnJ92MLLpbMRNPF6ctYnX34S2wjU81Va,True,4503676783,1125919195,7003700,3501850,3501850,2BPYaeCXY4BCFSGFSfiGtqmhzJ4fkhYLxGjqFvLCB6hG,280148036,1390260559,-1110112523,622
