ts,record_id,user_authority,user,partial,base_asset_value,base_asset_value_closed,liquidation_fee,fee_to_liquidator,fee_to_insurance_fund,liquidator,total_collateral,collateral,unrealized_pnl,margin_ratio
2022-01-21 16:37:24-05:00,5121,CpxZ136k95cVjGqkJnNpDZKUgrJrfg8HrFDZPL6BgsK4,Fo7HtcrneUTsnGqygsxPQ63G5rayYodYT65xP6B6HusH,True,322869800,80717450,498512,249256,249256,3zqXX6kzhkbW3d4TwD2CNjMRwxTbREXySekvq37kfCNk,19940481,74020681,-54080200,617
2022-01-21 16:37:24-05:00,5122,8T4WK27RvWVGqPuNqY6whk1fmU4vd5qaUQPZG1GJ79bh,DvSz7knS8N3K7L6JhQf1s4mJSyxB8uJXNQXtyjJn8QRL,True,19072392,4768097,29337,14668,14669,HfEnetJ7uBSmZWCjBNxdvv9HEC5nsW4wDV7wu6WnhWan,1173498,11613576,-10440078,615
2022-01-21 16:37:24-05:00,5123,EF6H6aW1p3qcAtiLFU9rbFYfsKfD683meHXDw8hLdaZK,8vfJbpnK7SQcjpEBCzZJRW8JosNbsmTeJ2YXZCbM225c,True,89535149,22383787,138535,69267,69268,3zqXX6kzhkbW3d4TwD2CNjMRwxTbREXySekvq37kfCNk,5541414,36966905,-31425491,618
2022-01-21 16:37:24-05:00,5124,8kJu5aqVSmW8FSZR9h6F75ftn9V2U9uMLBEKeqRaC855,FhVHByujkvwwtjTVpZ4mqSUqoMoBgeLUc5H7rbz3FgAt,True,18321880,4580470,27831,13915,13916,3zqXX6kzhkbW3d4TwD2CNjMRwxTbREXySekvq37kfCNk,1113260,13680890,-12567630,607
2022-01-21 16:37:24-05:00,5125,9KD2AifD5wFD4QkHYuawXbJgLWHrfj2QPF3fT8jhGVA5,Ga9gAqmkuHbqrr31sUFPqa1xa5WNxLWJWGPUaMxQqLdj,True,201863,50465,313,156,157,3zqXX6kzhkbW3d4TwD2CNjMRwxTbREXySekvq37kfCNk,12525,152636,-140111,620
2022-01-21 16:37:25-05:00,5126,FsMiJiJZibohKoV5QRisWCjzuFd86xSxFb4m73AQmu93,7p3TSKBaG9SV2YNDnhutQKacPKpTTmgsEfzmK51t6sYb,True,43294151,10823537,67653,33826,33827,DddJ7EWCmYEEZETCBNgAUSg81Ls6fZtiAaY5ekJ5sXx1,2706158,20660697,-17954539,625
2022-01-21 16:37:28-05:00,5127,FnAT8HKGgisYfeAbxKU2gSbCp8KbZHULRpaJX1NVijHy,2u637Crc2QzfSJmCnRNqeib3aZQVn4NGncpgM3Ph6jvm,True,7109715,1777428,10834,5417,5417,3zqXX6kzhkbW3d4TwD2CNjMRwxTbREXySekvq37kfCNk,433382,3384848,-2951466,609
2022-01-21 16:37:31-05:00,5128,AUH6YGBV8tDVX1E1WTo92Mubfx1DGsqfGeyUBqxo4fSr,33QZgMwmW32WuvmxD8XNbmF9ea88bLe3YTtNwHV73Wwu,True,43327898,10831974,67336,33668,33668,3zqXX6kzhkbW3d4TwD2CNjMRwxTbREXySekvq37kfCNk,2693460,21035444,-18341984,621
2022-01-21 16:37:43-05:00,5129,3VdSA9CED9f5swRwHX2U15U7J6Muaq8VPnCNy9CaGDHe,2YYstfnfdYic5NWmEbcUEHpccNUVd1EhuCkExvMsoMk8,True,1037834,259458,1587,793,794,3zqXX6kzhkbW3d4TwD2CNjMRwxTbREXySekvq37kfCNk,63489,778486,-714997,611
2022-01-21 16:37:49-05:00,5130,A36aouot1oFLUtswuBUM4EVcis9chKaSJu53MRoPDjab,33U9gpq1RRFMGWDrWa3ezXXkwgBewdAS6QGgGVPtGvqb,True,55757740,13939435,85635,42817,42818,3uL2NSR2ZdDqCiKfzA5SwwpddAnit22DBJo6uvvz1rRs,3425429,26522164,-23096735,614
2022-01-21 16:37:49-05:00,5131,H3394S5wdbwXB4scjGAY8NsXxCdGy1Xebct18s42FM1K,Hz84L1EquzhCvBJP75ScKug46hYGdNMVNH16AdG4y5D8,True,9721839,2430459,14836,7418,7418,DddJ7EWCmYEEZETCBNgAUSg81Ls6fZtiAaY5ekJ5sXx1,593474,5302799,-4709325,610
2022-01-21 16:37:49-05:00,5132,GKKRAsYGdcf47eFThG4KwhNv7egeHRuc2wmTh4kqpego,4ippJxgnqCtdtGzCkdZoYwv68fiXNSqQcgrnaHdXZDUa,True,219353022,54838254,343091,171545,171546,HfEnetJ7uBSmZWCjBNxdvv9HEC5nsW4wDV7wu6WnhWan,13723647,112382258,-98658611,625
2022-01-21 16:38:27-05:00,5133,2SNV9Q6vzQP5XxxqSrwXpQdRvk45FPiqLXmhNZzbLt1k,6dLG3ojK5Unm1mBh9aDZfryvoT2a6cSuWA8CxXy3oi7n,True,390961047,97740260,611461,305730,305731,3zqXX6kzhkbW3d4TwD2CNjMRwxTbREXySekvq37kfCNk,24458456,195998683,-171540227,625
2022-01-21 16:39:56-05:00,5134,Frobc1KZTVcsyfwyKwSpHJobxmiJBomzHhGCLdrzdAz8,HziyKP9uxWCuXddtbRzWMczHNdgyQB5UXQZj4MnMm14,True,72185726,18046431,112946,56473,56473,3zqXX6kzhkbW3d4TwD2CNjMRwxTbREXySekvq37kfCNk,4517875,22908572,-18390697,625
2022-01-21 16:40:16-05:00,5135,8WHDaiE6LqFFmCVMnPeLEQ99R6ft8b74UfmP9BqzjcE8,CGmoDGsdnjo3zMNrW78n2xxQr1aDPAiBYiXbyciLXYMu,True,183322474,45830617,283319,141659,141660,3zqXX6kzhkbW3d4TwD2CNjMRwxTbREXySekvq37kfCNk,11332799,85985083,-74652284,618
2022-01-21 16:40:19-05:00,5136,H1Z83zVoskNuBvYao1FjdLfETfhPpQFQUkniJfGxbaNz,EVqbBRV6Zy1tPLRevxpAykp8Mvv6tDZVTc4RmCKw4Gq1,True,308988082,77247020,473429,236714,236715,3zqXX6kzhkbW3d4TwD2CNjMRwxTbREXySekvq37kfCNk,18937170,176613859,-157676689,612
2022-01-21 16:40:19-05:00,5137,DYCYiQFH9QHzCo3eAw1pFoDu7pzwFMo1E2WDZjVFRz5w,CPh4FWsGak1kd1WFEH9qBjNhnun3R2tHtZA57zW8ugn5,True,10416088,2604021,16292,8146,8146,3zqXX6kzhkbW3d4TwD2CNjMRwxTbREXySekvq37kfCNk,651682,7001874,-6350192,625
2022-01-21 16:40:44-05:00,5138,5Rxuqgs4CaSKbfDXqBMFXkLTQ9dxrUjThXzoy3ouYVtK,BgvbKru66ebrGUcFFymGTmsaQv6GgcGMybiWaXqzBtwX,True,32005,8001,49,24,25,3zqXX6kzhkbW3d4TwD2CNjMRwxTbREXySekvq37kfCNk,1961,25163,-23202,612
2022-01-21 16:40:44-05:00,5139,3ogBPSRcKfmwzgumVDHBkXLi1eCsEFG2xzSJgD4LQDNy,7TXyqWgJqfe71MSWFA2n7ufZbUdzf7JJoWej8FNNtMXo,True,3245932,811483,5024,2512,2512,3zqXX6kzhkbW3d4TwD2CNjMRwxTbREXySekvq37kfCNk,200960,1758649,-1557689,619
2022-01-21 16:40:44-05:00,5140,5kwvkEtRFFD84j4ntVgxkacadgJaFvQ9JLhJqzLR7Y3G,GpMMkTv9T7y8DTiizuoJUsWvnSk3GSxADjRMGyYpryxm,True,4858702,1214675,7426,3713,3713,3zqXX6kzhkbW3d4TwD2CNjMRwxTbREXySekvq37kfCNk,297047,2243736,-1946689,611
2022-01-21 16:40:51-05:00,5141,C1CsbgQFvEvSXzuVHTr39tQHr3drDhjxeYiotd8eNocF,4rAaTCAMj5VpgNVKiYizabH7cMLhEA12seu2QXQNTyV3,True,18004213,4501052,28085,14042,14043,3zqXX6kzhkbW3d4TwD2CNjMRwxTbREXySekvq37kfCNk,1123434,5447111,-4323677,623
2022-01-21 16:41:21-05:00,5142,DXEJNyHSCbGZezXHy2xQaSzd37dwJs4dMTgt5VF5UZAG,7fCYM9DWrAX7vgZ11CwQMNd5NU8FB1yrbctxHaPYshpB,True,13183400,3295850,20559,10279,10280,HfEnetJ7uBSmZWCjBNxdvv9HEC5nsW4wDV7wu6WnhWan,822367,4512277,-3689910,623
2022-01-21 16:41:54-05:00,5143,A1j2G5FZRyWSjFt6dK87WHhLkQrPUVqHaM3KhSzhAKDT,2fMiHLYm4pL3YCd8aveTR4mT9uVxztQeMwb5eRZb4wUW,True,107754,26938,167,83,84,3zqXX6kzhkbW3d4TwD2CNjMRwxTbREXySekvq37kfCNk,6713,67888,-61175,622
2022-01-21 16:41:54-05:00,5144,8xvLGVeDmhVYQhN2ZpWkVG9jCrukRsNQ4926a4TMiZqa,9ciBySSjvADwp47WkETiFWZKVTFL8Hf1XvK7aSxhcgQS,True,3836669,959167,5973,2986,2987,3zqXX6kzhkbW3d4TwD2CNjMRwxTbREXySekvq37kfCNk,238948,2234736,-1995788,622
2022-01-21 16:41:54-05:00,5145,7CSCMFa9W52tBDVUbXbc3woAy3GByeA1wPJdp3MgznPa,3447ptuVFu6G8B6N63RmS8mRv4n9PfHneypHLvbeaGLn,True,22117867,5529466,34479,17239,17240,3zqXX6kzhkbW3d4TwD2CNjMRwxTbREXySekvq37kfCNk,1379160,13578695,-12199535,623
2022-01-21 16:42:01-05:00,5146,HpDwBPWZHfLzJUvTTABTA6qddyLLJiVTfqBx5gUktSUb,BqXLpaAeTNfNSeevfdazNqTgqEXj6Edgp8txWvCoxEz6,True,134174417,33543604,209762,104881,104881,3zqXX6kzhkbW3d4TwD2CNjMRwxTbREXySekvq37kfCNk,8390510,94193873,-85803363,625
2022-01-21 16:42:01-05:00,5147,78EeyPYzQjrmW6z9VGhRci6ihMUZb5rtpXo3GAxugf55,9AgZ45TMxaqwWGVWSgnEkvio3s6fXtHjAVRVCA7Zgsd2,True,8534736,2133684,13096,6548,6548,3zqXX6kzhkbW3d4TwD2CNjMRwxTbREXySekvq37kfCNk,523875,4022563,-3498688,613
2022-01-21 16:42:01-05:00,5148,Gbxc51WERLLeCtiHv7rDvE52aqF541RoQWG5n5aqErq6,4ngBoHbfXijLMqGKxFMNht9sbmxy2g5eqBmn8QsBmbx1,True,111083349,27770835,173751,86875,86876,3zqXX6kzhkbW3d4TwD2CNjMRwxTbREXySekvq37kfCNk,6950075,29452532,-22502457,625
2022-01-21 16:42:03-05:00,5149,2jDRvE3pQNjWy1NRFa4tzB3KmU5UkbUCHw8sQRFujo66,C4zNi2szDrEEh4coTF3WRUghfP4ZwAVVSYTLWfkejQRu,True,99656735,24914183,155051,77525,77526,3uL2NSR2ZdDqCiKfzA5SwwpddAnit22DBJo6uvvz1rRs,6202050,50656565,-44454515,622
2022-01-21 16:42:04-05:00,5150,7hTjPRQSYAoWHhtpsVz2oKK5SAuFJd8dPHShKgKJq8dy,6DcHcrtcXR88d8e2KahhAiWTeRznNfF8oXLHmh5wE7wz,True,146838242,36709560,225974,112987,112987,3zqXX6kzhkbW3d4TwD2CNjMRwxTbREXySekvq37kfCNk,9038991,79816861,-70777870,615
2022-01-21 16:42:05-05:00,5151,53LQyY375e9D9Lt5KCueA28GwzeBeb53W4V9Qszcd6D,9kG7BrpuFUgF1CkqBfUEJgyVwK338eHMFAJfqvBy63E2,False,680172168,680172168,33661197,1683059,31978138,3zqXX6kzhkbW3d4TwD2CNjMRwxTbREXySekvq37kfCNk,33661197,232694226,-199033029,494
2022-01-21 16:42:05-05:00,5152,CbhrZUdan1axNDFUrX1ZuEohfNMEGrszKSkk6pppVQuw,DHEAjJNtuEePezYAv77thWabbVxxqQpfuiC6moRSrpG1,True,14217687,3554421,21952,10976,10976,3zqXX6kzhkbW3d4TwD2CNjMRwxTbREXySekvq37kfCNk,878085,10685712,-9807627,617
2022-01-21 16:42:11-05:00,5153,8trkirSQNdMmAcJdeswxs5cPjH8dD6U4eJtWiAdMsrDB,HaSzpQ45x2MipfN17U6jGBxX8tXboomVDhXNSrnEfLDr,True,687876,171968,1068,534,534,3zqXX6kzhkbW3d4TwD2CNjMRwxTbREXySekvq37kfCNk,42755,392015,-349260,621
2022-01-21 16:42:11-05:00,5154,CYkojG4q1SnizNs59qsYTEBU1c11XC8nteMhxRbwhCBq,A9MsPy3aeMzdQUWXK6qmWLiZfKREiBrSVaJAKp2nEcSt,True,3453324,863331,5388,2694,2694,3zqXX6kzhkbW3d4TwD2CNjMRwxTbREXySekvq37kfCNk,215527,1873133,-1657606,624
2022-01-21 16:42:30-05:00,5155,JDeYjCLpfnzcfxDFgHf4aBcHsajwdR14GUaKAA9euzVf,EJbvKoyMZcoCx4vWa61uMbW2vr6mUhrgEuECdteVBuZZ,True,1193559,298389,1836,918,918,3zqXX6kzhkbW3d4TwD2CNjMRwxTbREXySekvq37kfCNk,73468,930467,-856999,615
2022-01-21 16:42:30-05:00,5156,G25vsB3sDqRhHoSK4KwR1TywfrJDtpejVbbevEG9sQ9a,5xFC3Hm13magnAA9GD1EnwC9PrPoEfQ7omEa9p9zCrB1,True,45813813,11453453,69610,34805,34805,3zqXX6kzhkbW3d4TwD2CNjMRwxTbREXySekvq37kfCNk,2784408,15074319,-12289911,607
2022-01-21 16:42:33-05:00,5157,5eMLdQ4gYA5iqvTXSNdGvctHp7s5VpyFuwtJKqx6chBc,Ckxc5K39nkBNXBTmFTM8J48R7wGqNm3vHKZu4G5baumZ,True,50240785,12560196,77953,38976,38977,HfEnetJ7uBSmZWCjBNxdvv9HEC5nsW4wDV7wu6WnhWan,3118158,25388859,-22270701,620
2022-01-21 16:42:33-05:00,5158,AWvHDdb2ikqV8wc7qQ8azbvNTZdixMNxhQjhQdhayYtR,9EpgEPBb1nog6aQeFdMXfSRiLSnzGQFQ39mbLdCxgYTv,True,7092438,1773109,10959,5479,5480,HfEnetJ7uBSmZWCjBNxdvv9HEC5nsW4wDV7wu6WnhWan,438367,3301380,-2863013,618
2022-01-21 16:42:35-05:00,5159,DDsY5V3F9wnEGBoQFCEf1hvEYuKUaJdysbc7TxhNqe9G,5oBCGzvy8odB8MCxCUvPDqYCnTyteZ4Yy1JDroroygbi,True,21049801,5262450,32733,16366,16367,3zqXX6kzhkbW3d4TwD2CNjMRwxTbREXySekvq37kfCNk,1309327,6936531,-5627204,622
2022-01-21 16:42:36-05:00,5160,J6jBKPDR6R5cLMqLufw3zoVfheNYs1KF7C4Ft2dakXeA,6wTTLK675Ym6toJRp7tYaUZzisWfgGjSp3X3yJ31xiKt,True,20925667,5231416,32701,16350,16351,DddJ7EWCmYEEZETCBNgAUSg81Ls6fZtiAaY5ekJ5sXx1,1308068,8332644,-7024576,625
2022-01-21 16:42:36-05:00,5161,36ByQojnxEckWdQTjqHfxKqCx9yjqWQsPsZyqaN72UWR,AZoirtS1fjX61agRM64tqThVinnJTh3BWgiHyNHPTgZP,True,123051,30762,189,94,95,HfEnetJ7uBSmZWCjBNxdvv9HEC5nsW4wDV7wu6WnhWan,7563,91288,-83725,614
2022-01-21 16:43:32-05:00,5162,GGcsY84pkqUn2xySuLYrUUg8gWMBWgfHaQ7rK42NoZaH,4EyjJvctL9WBQiauD2Eaf2Hus8htYzHxP5GR2HsUfuks,True,358012568,89503141,558497,279248,279249,3zqXX6kzhkbW3d4TwD2CNjMRwxTbREXySekvq37kfCNk,22339892,147928410,-125588518,623
2022-01-21 16:43:43-05:00,5163,B9WJfmrYEkVH3L1UWz4qqWpaexHydymbzvEfwNVtB9BV,6mQb4yzGq8jE1NbweKCKSbevnnYVhHYxyc6Gz2a5kJLn,True,95884350,23971087,148628,74314,74314,3zqXX6kzhkbW3d4TwD2CNjMRwxTbREXySekvq37kfCNk,5945156,29393820,-23448664,620
2022-01-21 16:43:43-05:00,5164,A1VornXbzK5rFgsy9D4qThcPnYVP8AB9RRzWsV1h6L17,9M4dQgz1zWrtKHqZMt9w7PbM9CvmyjhY5ZZ6jjajMzqm,True,14006596,3501649,21734,10867,10867,3zqXX6kzhkbW3d4TwD2CNjMRwxTbREXySekvq37kfCNk,869378,4595814,-3726436,620
2022-01-21 16:43:43-05:00,5165,2JXP6KUwPSmCrXT2uQRqSoCwH8RLYWwmqYsj3zXtv9xF,4qcFVgugXsHVQzFRP2he9CVzvv47xqgokJjigee8oPpP,True,710129697,177532424,1109371,554685,554686,3zqXX6kzhkbW3d4TwD2CNjMRwxTbREXySekvq37kfCNk,44374874,202775177,-158400303,624
2022-01-21 16:44:48-05:00,5166,Bsr6kx1B6BSEd5UnJ7Z61M49iUb3bFrDVhiEtMVtPDF2,3CFd1pUJAJPA9fobwn4Jj2mRju1CWmoop4Mh4znypNWT,True,4480867,1120216,6859,3429,3430,3zqXX6kzhkbW3d4TwD2CNjMRwxTbREXySekvq37kfCNk,274389,2417939,-2143550,612
2022-01-21 16:44:48-05:00,5167,HHHj6EinpgAJeZkDXfsvCo3UXnmAdiAZNvPSUfVPc5Sg,3gx9c31MDtJtByxkUuWcqf1oARnZTjpx3QtxsM1Xb6Gp,True,115046161,28761540,179204,89602,89602,3zqXX6kzhkbW3d4TwD2CNjMRwxTbREXySekvq37kfCNk,7168162,57409589,-50241427,623
2022-01-21 16:44:48-05:00,5168,4KMzwWHPeW51cxu4nMpbqCaqo96dMqaHWyRCGQktfQfd,F7q4GNYcbnZa8dJ4qovQwjmxpKpdEmdxQMXRPb9nQupa,True,107295722,26823930,167346,83673,83673,3zqXX6kzhkbW3d4TwD2CNjMRwxTbREXySekvq37kfCNk,6693852,28166030,-21472178,623
2022-01-21 16:44:50-05:00,5169,6NJFN855M3Q3RLTDNo57gTgAmwPD6G2E3WvMb1m5eNCN,3YpqNnonsvXaRT4nCC3G5FZx1jjVtbDPc36LiR6WK5jR,True,11644754,2911188,18138,9069,9069,3zqXX6kzhkbW3d4TwD2CNjMRwxTbREXySekvq37kfCNk,725534,8934471,-8208937,623
2022-01-21 16:45:15-05:00,5170,9aQrdyfAvcBbBj7iKQB17eAS4zBqymdd3kzkTkuRhdLU,BDHhukMF5rALuSwCxaw8g73m2MN4oX1D4e7uNmx3SiVt,True,399275429,99818857,624376,312188,312188,HfEnetJ7uBSmZWCjBNxdvv9HEC5nsW4wDV7wu6WnhWan,24975059,92019630,-67044571,625
2022-01-21 16:46:30-05:00,5171,EYt1Pzqfwnd4iXSmcpw4T3Edmm1y3GnRhCjcQEEK4Atj,EHqporfvvfg7UQPsjv5tsgZE8u9yyRuEU2DdLpQeXy85,True,16357629643,4089407410,25316472,12658236,12658236,HfEnetJ7uBSmZWCjBNxdvv9HEC5nsW4wDV7wu6WnhWan,1012658904,4238744934,-3226086030,619
2022-01-21 16:46:32-05:00,5172,DRVtEzZs9u9ysrcANZLEjrvbuuGqYn77v2h4cDFKuNUx,Fv9qiMZhuSBL2cs9AWUYbDLQjB46W2ZwrhxaNXtPLDpC,True,18364895,4591223,28258,14129,14129,3zqXX6kzhkbW3d4TwD2CNjMRwxTbREXySekvq37kfCNk,1130321,4329631,-3199310,615
2022-01-21 16:46:52-05:00,5173,DWTaeNeq5x83cBvKUz2jZfXDz5z4F5wbSZLNv7smnjvd,9pQGArZnJV4Fu8tBVEfknmmfmrRv5RKV2u58BJBuhzpF,True,14315049,3578762,22388,11194,11194,3zqXX6kzhkbW3d4TwD2CNjMRwxTbREXySekvq37kfCNk,895525,7674310,-6778785,625
2022-01-20 20:51:13-05:00,4150,6xikA6d7sjCBnSfqkFwrL4nPrtQUNWdRhXB7i1AccnxC,G8t7u2R9qjRfdTdULs74v3nVrTM2WeKvc4dK4FFAvuG1,True,13862796,3465699,21624,10812,10812,3zqXX6kzhkbW3d4TwD2CNjMRwxTbREXySekvq37kfCNk,864964,4195705,-3330741,623
2022-01-20 20:51:17-05:00,4151,AM5fwZR9BUW8AFkhdGWXW4PHd2cy8ora63kDf2z2eknw,E7ru6hg4MchnRG5zcr5YazwX8Snt55r5Xq9zCHCGaYZT,True,353678,88419,551,275,276,3zqXX6kzhkbW3d4TwD2CNjMRwxTbREXySekvq37kfCNk,22045,202252,-180207,623
2022-01-20 20:51:17-05:00,4152,2FrqGFZjbiNykJyo9BZ5S9FguQJPJiTi681rJJsQ5dta,3QUncYP92NKrfpaTvuF9iQg11PXKgZAgEngwh6BbnCCj,True,305738,76434,476,238,238,3uL2NSR2ZdDqCiKfzA5SwwpddAnit22DBJo6uvvz1rRs,19042,153162,-134120,622
2022-01-20 20:51:17-05:00,4153,8xvLGVeDmhVYQhN2ZpWkVG9jCrukRsNQ4926a4TMiZqa,9ciBySSjvADwp47WkETiFWZKVTFL8Hf1XvK7aSxhcgQS,True,17822519,4455629,27669,13834,13835,3zqXX6kzhkbW3d4TwD2CNjMRwxTbREXySekvq37kfCNk,1106786,7862113,-6755327,621
2022-01-20 20:51:20-05:00,4154,2QStaRnbSnDhA891Lb1bxjVeMYpJUpNdqaVkw3rqU45V,DakRWPnttPoRcjY5V7WLwiwBx39BapCo9Atog8dL17Ku,True,838025,209506,1311,655,656,3zqXX6kzhkbW3d4TwD2CNjMRwxTbREXySekvq37kfCNk,52458,340706,-288248,625
2022-01-20 20:51:20-05:00,4155,Ayx8dFsVzUBb9b7QKxw7YHJuhptdSitBXFEczXTaxe85,EvU1VLChnowi6ccSPeJRSk65njrqZfYouAN7SHePxsxf,True,8659,2164,13,6,7,3zqXX6kzhkbW3d4TwD2CNjMRwxTbREXySekvq37kfCNk,542,5187,-4645,625
2022-01-20 20:51:20-05:00,4156,6u6bPgAmK8ufACrQV99A1Y5nhGkue3KEUHmQQkcNkxwP,7636yXT5w4DcVpc7LJdN46aiggzSq6U2GXHXL5kyy9F3,True,43898036,10974509,68558,34279,34279,3zqXX6kzhkbW3d4TwD2CNjMRwxTbREXySekvq37kfCNk,2742358,25565906,-22823548,624
2022-01-20 20:51:31-05:00,4157,3Lv2XpiD4KBUHq7Zx6u3zNhpXoySodXHH8o8f5yaaPxG,H6TN4rhpBXkEH3mZnymYNcKfmnxRH2uzfwzeLH2q6ahP,True,69115,17278,108,54,54,3zqXX6kzhkbW3d4TwD2CNjMRwxTbREXySekvq37kfCNk,4326,36093,-31767,625
2022-01-20 20:51:37-05:00,4158,8hpAXzimCw2bTwLXoRFAbqNW8qoj5VV3JDYCuJwqHpHm,DkfsL2M7oRBX6grAfy15C4urwL6ToMJ7TWJEFAGhWjYX,True,3420503,855125,5290,2645,2645,3zqXX6kzhkbW3d4TwD2CNjMRwxTbREXySekvq37kfCNk,211623,1005655,-794032,618
2022-01-20 20:51:38-05:00,4159,6CeKxTJvFqhyNEyzySiBBKEwYVMe7j3A6nkMes4BW6o2,DzDR9XvwY1z7ygQ8YrCXrwDGHSf67JZF8BzUnuFE2fxQ,True,1618162,404540,2497,1248,1249,3zqXX6kzhkbW3d4TwD2CNjMRwxTbREXySekvq37kfCNk,99902,733723,-633821,617
2022-01-20 20:51:38-05:00,4160,CbhrZUdan1axNDFUrX1ZuEohfNMEGrszKSkk6pppVQuw,DHEAjJNtuEePezYAv77thWabbVxxqQpfuiC6moRSrpG1,True,66156975,16539243,103418,51709,51709,3zqXX6kzhkbW3d4TwD2CNjMRwxTbREXySekvq37kfCNk,4136745,39221312,-35084567,625
2022-01-20 20:51:38-05:00,4161,5SskSWkRPP5BNaqvHkJCbTAgHPUkHEwFh5pFr4t8PoBr,EqdX8Sdm9LCfdrzVKzisKaFcP2YEdSRNZYmev5RWjGqb,True,1448791,362197,2261,1130,1131,3zqXX6kzhkbW3d4TwD2CNjMRwxTbREXySekvq37kfCNk,90470,434468,-343998,624
2022-01-20 20:51:38-05:00,4162,8VnGmfop6qcUezAJ2M15jz2Nn6mPQgehDcJPvypq4XJn,6F6sqXNhgkW9ev8QNMm4ydywUUmemhwgydRQYNeqyUmi,True,3915173,978793,6061,3030,3031,3zqXX6kzhkbW3d4TwD2CNjMRwxTbREXySekvq37kfCNk,242440,3835754,-3593314,619
2022-01-20 20:51:38-05:00,4163,GjQQ2fQ7mrGjWZwjVYFUKp9NM1LmfkhEo675ovU5SPa8,ECgVUMRY5nB4MALs5drDyipF7YohCPuJpj2UegCs7HMn,True,11364287,2841071,17754,8877,8877,DddJ7EWCmYEEZETCBNgAUSg81Ls6fZtiAaY5ekJ5sXx1,710163,5389478,-4679315,624
2022-01-20 20:51:40-05:00,4164,Fd2HrzBAr4JobRPARZwpQHHVoSCEoog32A6tKMWAC1sK,BYappsar5sQf8VLem4wrLuTtrDFH9y8pEx1aMxfuU4Pq,True,11135227,2783806,17334,8667,8667,3zqXX6kzhkbW3d4TwD2CNjMRwxTbREXySekvq37kfCNk,693377,6480462,-5787085,622
2022-01-20 20:51:40-05:00,4165,Ftuj53jKP3Z8mvuTE1CEypdw2eZrCn5x8ktMWRdJo2gU,9JNUFRLrPNAh3DgKvMdaNvLCAeUtiS9FGWmDcMvcSe7J,True,94385079,23596269,146125,73062,73063,3zqXX6kzhkbW3d4TwD2CNjMRwxTbREXySekvq37kfCNk,5845002,41897981,-36052979,619
2022-01-20 20:51:41-05:00,4166,AHm7zF4rpaxaayBLn5QDHgJSp8KAr647s4cNvQ9wLgd7,FDM33WngED24pukBvSDpPAzinW6afVAeGReum5nyLRiC,True,306251,76562,474,237,237,3zqXX6kzhkbW3d4TwD2CNjMRwxTbREXySekvq37kfCNk,18960,183732,-164772,619
2022-01-20 20:51:46-05:00,4167,F2v1YwVAwXLiUgsJ5uwn4qAAkTXitn1E75fJcPnGuAcy,5rdJ4H5GxPg4Juu77mGc7uya5LwEqLzDSRyG8mQ2mDbK,True,7129503,1782375,11010,5505,5505,3zqXX6kzhkbW3d4TwD2CNjMRwxTbREXySekvq37kfCNk,440431,4149907,-3709476,617
2022-01-20 20:51:46-05:00,4168,6yw4GPvkqUbakcEWtqSCfjVLukty11xqjDpGxtEN9Km2,5ppEx7wkpqbG5nApCWMdRja3oRSheFmAAsNHUX7h2w2Y,True,610603,152650,950,475,475,3zqXX6kzhkbW3d4TwD2CNjMRwxTbREXySekvq37kfCNk,38009,608474,-570465,622
2022-01-20 20:51:46-05:00,4169,6tFQaTqqffino9kwMZTL2xVNBG8k9VREFhXqVi2si3A3,3w3wGxBbS4bmXeqmvd595SAWFeXekVpnH4UdbeEs8Sx5,True,1620538,405134,2519,1259,1260,3zqXX6kzhkbW3d4TwD2CNjMRwxTbREXySekvq37kfCNk,100796,732242,-631446,621
2022-01-20 20:51:48-05:00,4170,7hTjPRQSYAoWHhtpsVz2oKK5SAuFJd8dPHShKgKJq8dy,6DcHcrtcXR88d8e2KahhAiWTeRznNfF8oXLHmh5wE7wz,True,682393026,170598256,1052061,526030,526031,3zqXX6kzhkbW3d4TwD2CNjMRwxTbREXySekvq37kfCNk,42082469,276636480,-234554011,616
2022-01-20 20:51:50-05:00,4171,EmGW2aAG69ssWqCtbfDocRaM2u3TJsczn2HHP9jdmRvD,aypkDKsp9uqAB4F6mwvm5LofpsrFBuZT2MMWtE2eHdB,True,238706,59676,372,186,186,3zqXX6kzhkbW3d4TwD2CNjMRwxTbREXySekvq37kfCNk,14907,132528,-117621,624
2022-01-20 20:51:50-05:00,4172,F9s8a7Cpiw5dw3a2aNFMofqwyDWNXvDLnSdJzoj1gRiV,GpKsQKJD79KBRWdCTkyi4zX7NaoCWsLUjrKxAwJB6o6s,True,15014688,3753672,23474,11737,11737,3zqXX6kzhkbW3d4TwD2CNjMRwxTbREXySekvq37kfCNk,938960,4030420,-3091460,625
2022-01-20 20:52:27-05:00,4173,JDeYjCLpfnzcfxDFgHf4aBcHsajwdR14GUaKAA9euzVf,EJbvKoyMZcoCx4vWa61uMbW2vr6mUhrgEuECdteVBuZZ,True,5554711,1388677,8676,4338,4338,3zqXX6kzhkbW3d4TwD2CNjMRwxTbREXySekvq37kfCNk,347052,3433347,-3086295,624
2022-01-20 20:52:49-05:00,4174,WMUVFELv3C3KdMKJ5ZL4rG7o1YrV1qTP6Mmp2S5Rp8S,7UNzS3zDqT1oeq9a7eJGU8cgf8eUzEAZubSBQvNmK6uJ,True,6708508,1677127,10491,5245,5246,3uL2NSR2ZdDqCiKfzA5SwwpddAnit22DBJo6uvvz1rRs,419640,1869044,-1449404,625
2022-01-20 20:53:08-05:00,4175,E8ifvhmyJGBGVQomo3AnZw2UcaLHcpGsTtuoCid8voU3,FMQUWTbTAfSLfrc6GTrz4DM2ZSgoxF3KtqGn8AyjVtsf,True,2629175,657293,4085,2042,2043,3uL2NSR2ZdDqCiKfzA5SwwpddAnit22DBJo6uvvz1rRs,163432,1174024,-1010592,621
2022-01-20 20:53:09-05:00,4176,AATMHH4e4B6SL9bThnXGktzWuqWkPdx3JbRXk8HwkbPW,6F3u2yLx7P9gtpAAXASx7uF8xNyVBgJiKosMKUrgpicA,True,92461050,23115262,143497,71748,71749,3zqXX6kzhkbW3d4TwD2CNjMRwxTbREXySekvq37kfCNk,5739881,47083954,-41344073,620
2022-01-20 20:53:09-05:00,4177,9zpPiboHF5HW7NfCx7hYdmJGwUomVMTiUFc4Um5KrDi3,8q3eBpuwV6dMNkib9N8XQAq2tBUcjSANRe5SXpd4dFhZ,True,3032969,758242,4721,2360,2361,3zqXX6kzhkbW3d4TwD2CNjMRwxTbREXySekvq37kfCNk,188877,1284824,-1095947,622
2022-01-20 20:53:10-05:00,4178,6Y1UoGwrKyKsScZQm9ng1rNrXXykKT82V7kUopc43kAy,8YtWQTTKymCESbPMWCP9TMehbMU25zJMtxt9grqrpbD4,True,14092352,3523088,22021,11010,11011,3zqXX6kzhkbW3d4TwD2CNjMRwxTbREXySekvq37kfCNk,880855,13785776,-12904921,625
2022-01-20 20:53:13-05:00,4179,3oCun4gm3k8sXxVxiYM8okGi8iCXH9LvDkHf9PBQWYXR,E1np1dZ7jUm811ddvy1jQerBwGSYb5BbZWnUHeotvrfH,True,157567116,39391779,246273,123136,123137,3zqXX6kzhkbW3d4TwD2CNjMRwxTbREXySekvq37kfCNk,9850957,39094203,-29243246,625
2022-01-20 20:53:13-05:00,4180,GxFxvEUdWofneMmVvhCSScH9V6Zia5WJ2J9q6CpPnaq3,ATLykiHDii3Lw53MoZXwqu1FbBNPJbVNVGe2SoQMjVmY,True,2282679,570669,3571,1785,1786,3zqXX6kzhkbW3d4TwD2CNjMRwxTbREXySekvq37kfCNk,142874,1238270,-1095396,625
2022-01-20 20:53:18-05:00,4181,AWvHDdb2ikqV8wc7qQ8azbvNTZdixMNxhQjhQdhayYtR,9EpgEPBb1nog6aQeFdMXfSRiLSnzGQFQ39mbLdCxgYTv,True,32971647,8242911,51545,25772,25773,3zqXX6kzhkbW3d4TwD2CNjMRwxTbREXySekvq37kfCNk,2061812,11042150,-8980338,625
2022-01-20 20:53:27-05:00,4182,5dM6X7DVy28oznuB7mhJjdDNte6mcTZ31HLF7DqFDGsR,9UwrfQNmyeymmtrJEabKd3yWVKGP6UbNCRqKe9cLT3N9,True,5448342721,1362085680,8504691,4252345,4252346,3zqXX6kzhkbW3d4TwD2CNjMRwxTbREXySekvq37kfCNk,340187669,1620744948,-1280557279,624
2022-01-20 20:53:28-05:00,4183,BZxJ6CtrVoiU86DMMieMeDFLNWtMpHGTvZfM7nyay6o4,6CRxRR8bisRLHFJBFWjyumYuy7j4C4PkjYH1K8gXhdWD,True,2673800,668449,4095,2047,2048,3zqXX6kzhkbW3d4TwD2CNjMRwxTbREXySekvq37kfCNk,163813,893871,-730058,612
2022-01-20 20:53:30-05:00,4184,9UyQC8vc6zJJaSdnjvTAzgmcsw4fC3xFBBiCC1w9Sbjx,3ppBfboe6FPmt7f6WrivspMUoAznZKWQMeh3rCgw7vjQ,True,3309158,827289,5156,2578,2578,3zqXX6kzhkbW3d4TwD2CNjMRwxTbREXySekvq37kfCNk,206264,1401747,-1195483,623
2022-01-20 20:53:30-05:00,4185,2F45BX9mRmtNCHPejKFknN5aNgGvR4vVLFjMaY1a7dR8,ALdSutsvEFRUEQGGBbi31QywTL1pdXSDWrNJzvNTaoXL,True,9257779,2314444,14442,7221,7221,3zqXX6kzhkbW3d4TwD2CNjMRwxTbREXySekvq37kfCNk,577717,5222864,-4645147,624
2022-01-20 20:53:47-05:00,4186,5eMLdQ4gYA5iqvTXSNdGvctHp7s5VpyFuwtJKqx6chBc,Ckxc5K39nkBNXBTmFTM8J48R7wGqNm3vHKZu4G5baumZ,True,233506607,58376651,364752,182376,182376,3zqXX6kzhkbW3d4TwD2CNjMRwxTbREXySekvq37kfCNk,14590102,86636535,-72046433,624
2022-01-20 20:54:02-05:00,4187,J4krKPBBTMVLZRgrSeYJAMyHQs2FkNm5TXk7nQWwDB43,ASmLbfNbhTD2HHeV7qzAqiHjUx5a8Traj8oPDwbkMdFg,True,10496602,2624150,16424,8212,8212,3zqXX6kzhkbW3d4TwD2CNjMRwxTbREXySekvq37kfCNk,656976,4840962,-4183986,625
2022-01-20 20:54:02-05:00,4188,H1LftKtj94Zs6PG2A7gJt9rPurBkXkTy2hbbArQwAehi,8bANmhgdnPYa3PqdPnk5BA2xhvqJmPyaMF77mrBePJ13,True,14141,3535,22,11,11,3zqXX6kzhkbW3d4TwD2CNjMRwxTbREXySekvq37kfCNk,884,12880,-11996,625
2022-01-20 20:54:15-05:00,4189,3Xbsek5MsEGoWr3G9yhuohREr26B2vSQcjqXdspTFHta,2rPxkUiMo9wGDq8EvAiwY3ngRpKmL223cBWWNTYoBmFp,True,138809689,34702422,216270,108135,108135,3zqXX6kzhkbW3d4TwD2CNjMRwxTbREXySekvq37kfCNk,8650831,34939230,-26288399,623
2022-01-20 20:54:22-05:00,4190,pgzvXpnUYiY7hLrfjmwScqLd8oj9vYcXpFvpm4y4JvG,GdqdQgoyBAFuXdbvoZyDhB3jyqJzVo4nkGh7EPFxkBF2,True,782440,195610,1222,611,611,3zqXX6kzhkbW3d4TwD2CNjMRwxTbREXySekvq37kfCNk,48892,785281,-736389,624
2022-01-20 20:54:44-05:00,4191,CvZssqscu2dm35mwcE3zg9zedavbRjVJjWD59Py5ExUK,7pXaoR6aHKYofCmg1eHipygNYDteEaf8rbbS8BDYGQK6,True,259723,64930,406,203,203,HfEnetJ7uBSmZWCjBNxdvv9HEC5nsW4wDV7wu6WnhWan,16256,117724,-101468,625
2022-01-20 20:55:19-05:00,4192,3EmGvYu72cR4Ta3wLA5HKZBEqgfChCyiRanwj5hGLJXc,6NEWPFaKi5uLsrj4n6RM1DBhQTcGFE9TwYeJ12pC7yyp,True,14713,3678,23,11,12,3zqXX6kzhkbW3d4TwD2CNjMRwxTbREXySekvq37kfCNk,920,7398,-6478,625
2022-01-20 20:55:20-05:00,4193,51yPLtXTgL9oLKs1cCf5TjL54Ld5vuVxat2NNtwZVsZG,7UjtM7Z1tiXEQMMiorQyncgi9SKu3v46DhVdgXbWqSiF,True,131613305,32903326,205931,102965,102966,3zqXX6kzhkbW3d4TwD2CNjMRwxTbREXySekvq37kfCNk,8237254,127330485,-119093231,625
2022-01-20 20:55:27-05:00,4194,67Z7ZGhNu5xxEh9BYKWcXp9m1T4tFiE1o1M16hCzUWQA,CT7YKWixz7BhTbvg5F6M5HCyPGnHoFLNFuDV9GhoLTo3,True,1205491,301372,1885,942,943,3zqXX6kzhkbW3d4TwD2CNjMRwxTbREXySekvq37kfCNk,75423,814772,-739349,625
2022-01-20 20:55:33-05:00,4195,brCL9pzP6q4b6rKgAH1AJbMoqffBWyXLX8oAnZDoi77,Dx4G5UP9jTb47JQypWJnv48mPTzhJvqPD1BtBtDT7TJF,True,2997667,749416,4686,2343,2343,3zqXX6kzhkbW3d4TwD2CNjMRwxTbREXySekvq37kfCNk,187462,689795,-502333,625
2022-01-20 20:56:05-05:00,4196,ApAgbKGyEYXRonGM33w56ZxHQNAGSd9ji4K3zAGN2yA8,FZAhAUDtEaNsFmh4fP8uXNjoHneNkpZ2wQCfEeU4RYRM,True,37476750,9369187,58603,29301,29302,3zqXX6kzhkbW3d4TwD2CNjMRwxTbREXySekvq37kfCNk,2344135,17174661,-14830526,625
2022-01-20 20:56:09-05:00,4197,HcGtTcpuxex2eQyz6GjJHrjDgThU2ZWSjjnzNEf7tNXy,XuFuE8RxTusW8BYDczgzvWrD5YbDseACo2edd2K4tVv,True,29419,7354,46,23,23,3zqXX6kzhkbW3d4TwD2CNjMRwxTbREXySekvq37kfCNk,1840,10645,-8805,625
2022-01-20 20:56:29-05:00,4198,72woixtGAuGazCMfsYfYBYLP7FuRj8Fwz9fynFo4MCE4,5237BmWkKf58PBeTUEiu3Ld5uKXEe8wcrJRmCnUoWWku,True,495496139,123874034,771274,385637,385637,3uL2NSR2ZdDqCiKfzA5SwwpddAnit22DBJo6uvvz1rRs,30850989,131066739,-100215750,622
2022-01-20 20:56:35-05:00,4199,Bsr6kx1B6BSEd5UnJ7Z61M49iUb3bFrDVhiEtMVtPDF2,3CFd1pUJAJPA9fobwn4Jj2mRju1CWmoop4Mh4znypNWT,True,20823852,5205963,32357,16178,16179,DddJ7EWCmYEEZETCBNgAUSg81Ls6fZtiAaY5ekJ5sXx1,1294299,8385592,-7091293,621
2022-01-20 20:56:37-05:00,4200,CyWBZ1xJ9LahUnPesbXLZ4Rr5UyWAHgVFYwfrnhyrkNL,2Lpk87Xth8ZL5J9BfzmMpEE3x76FDrrrmdKiCNkSVip2,True,130966482,32741618,204733,102366,102367,HfEnetJ7uBSmZWCjBNxdvv9HEC5nsW4wDV7wu6WnhWan,8189348,52398684,-44209336,625
2022-01-20 20:56:47-05:00,4201,6NJFN855M3Q3RLTDNo57gTgAmwPD6G2E3WvMb1m5eNCN,3YpqNnonsvXaRT4nCC3G5FZx1jjVtbDPc36LiR6WK5jR,True,54106676,13526669,84665,42332,42333,HfEnetJ7uBSmZWCjBNxdvv9HEC5nsW4wDV7wu6WnhWan,3386614,32942594,-29555980,625
2022-01-20 20:56:47-05:00,4202,DGAQzgZhS2yioeZmG3cbacM3hdz4F1aZn1PWRwgiFukc,48KUtJaNCPNxkLXJBtWAdDxY4b9vZzLgbGxTNdwMqmjz,True,193868838,48467209,303222,151611,151611,3zqXX6kzhkbW3d4TwD2CNjMRwxTbREXySekvq37kfCNk,12128913,107374915,-95246002,625
2022-01-20 20:56:47-05:00,4203,3VYtHvoT9wi4K1PBjg6JjCf6U9fVPDf6tX9jyRRvLxcg,Ba5fjpVyAxLbiP6hYJmrxzougi7JUEDfDLKBxSbbTL7q,True,166820811,41705202,260776,130388,130388,3zqXX6kzhkbW3d4TwD2CNjMRwxTbREXySekvq37kfCNk,10431040,45144365,-34713325,625
2022-01-20 20:56:50-05:00,4204,CRaKcudjkQiSw5YPVjTLVdXvJskeGiHSYtq5ZcMPJhgQ,AgqTg3b3bAcaBmRidhNC4Uf9ZwNbeH52RQEqumWyuUs7,True,321147,80286,501,250,251,3zqXX6kzhkbW3d4TwD2CNjMRwxTbREXySekvq37kfCNk,20059,227403,-207344,624
2022-01-20 20:56:54-05:00,4205,9vcKW1GfrDZ3KLPh2pEVFF8ZyKqD1pJW1hiE8H98Av7S,C6Ki27mo4sCHu6u8UnR1p7WSgsTjFQxGGR9Lk9n5Rhjq,True,1030459,257614,1611,805,806,3zqXX6kzhkbW3d4TwD2CNjMRwxTbREXySekvq37kfCNk,64465,593987,-529522,625
2022-01-20 20:56:55-05:00,4206,BJaaH1SK1pF2kZQzmYpLFfDtm52CR9a5rd39RAPtLe8q,HUsT5FVxaisdnCvG1BQxX6zffjfL2Rwx5mMo5y8SDV7e,True,37284291,9321072,58285,29142,29143,3zqXX6kzhkbW3d4TwD2CNjMRwxTbREXySekvq37kfCNk,2331428,11730835,-9399407,625
2022-01-20 20:56:55-05:00,4207,6nJyqvFKprwaVCE1gAa2P4RHKc6Pa6XFSJymx654zZ9K,4e7iJmdwzAPxp1Zi8Azo38YyPQdPKqqY4VLJyQ5rpdYP,True,924039,231009,1442,721,721,3zqXX6kzhkbW3d4TwD2CNjMRwxTbREXySekvq37kfCNk,57714,561002,-503288,624
2022-01-20 20:57:01-05:00,4208,4cKgCTttVp8pzJnp43PP7uLLUXNcU7YGPJ3cCGHaUFe7,BBQqjwTpVEgpDzMk4wDDH8rCjaSxCRPWVhtFxERSujTD,True,15003664,3750916,23479,11739,11740,3zqXX6kzhkbW3d4TwD2CNjMRwxTbREXySekvq37kfCNk,939188,7765379,-6826191,625
2022-01-20 20:57:39-05:00,4209,CBL2NbekJrXvBiAcoj4fzQ4PfLDwTntW7Zt4nruHFYEw,59EvfgYTdKkfjUJz5LddLUAqbEdLaihcMzjcrTZsyzyS,True,3467,866,5,2,3,3zqXX6kzhkbW3d4TwD2CNjMRwxTbREXySekvq37kfCNk,217,1779,-1562,625
2022-01-20 20:57:39-05:00,4210,o2aCmkxsxSiyUX8soTEjwUCbJeXmCZsEaf8CWwxDT5n,3pvS2bTsUuiQyqZp5rdnTpq4cqWGgtv4E5rN9HsBxpRt,True,8852,2213,13,6,7,3zqXX6kzhkbW3d4TwD2CNjMRwxTbREXySekvq37kfCNk,547,3285,-2738,617
2022-01-20 20:57:39-05:00,4211,DdYgcyV1T2CDYiQVr4VL9Ym8RdKm93a7SKy8HxuyaoMW,GPdAeqeXb1UJ56AttcwwY1CyFhRyfptDC4BAX2Tc8MpE,True,194755,48688,300,150,150,3zqXX6kzhkbW3d4TwD2CNjMRwxTbREXySekvq37kfCNk,12019,117576,-105557,617
2022-01-20 20:57:39-05:00,4212,M69XSefqeum2arinvHEqmA3L2XHWNFN17p4msRhRZXf,2vK15yYUANLSbAoiBfgJ9VLyqsmtEpd2iNytQjms8GaQ,True,100397036,25099259,155717,77858,77859,3zqXX6kzhkbW3d4TwD2CNjMRwxTbREXySekvq37kfCNk,6228686,74276440,-68047754,620
2022-01-20 20:57:40-05:00,4213,2s9VGesQYbKr3LwuraMEa9sXbXz7f8299HPPAHgSaUdp,8uMS2GDsbmygjbRnc2gjwNkXKogmJX1i8nchmqt8ixCe,True,16581841990,4145460497,25807202,12903601,12903601,72FwbpFGoLEazJEdpqNtPNefsadUrimUqma9wSoy4qiS,1032288109,8719376848,-7687088739,622
2022-01-20 20:57:40-05:00,4214,7jvKp6onXyWgwsFrFWj4hYTXJsYYD6ot5mn6rPFuJriy,J7N6HiozevJVTiY9hDEUs2ud5BwT5QSE7wnMBS1w5ie2,True,22387379,5596844,34749,17374,17375,3zqXX6kzhkbW3d4TwD2CNjMRwxTbREXySekvq37kfCNk,1389975,12834606,-11444631,620
2022-01-20 20:57:40-05:00,4215,DdAPWdHnb7ocaYtcwwwYnppsH39sZpmzMyANeoJbCV7s,3BVmC39L8dEypPN1BZhsf9bx9Ge2sXCZR8Y6RH4eBNMJ,True,389705130,97426282,599518,299759,299759,3zqXX6kzhkbW3d4TwD2CNjMRwxTbREXySekvq37kfCNk,23980733,325818571,-301837838,615
2022-01-20 20:57:40-05:00,4216,6oroGB3mvzK3tDfiB9X2NJuL3x476pxhgRnt7VxqhdLo,2SoK8tKkLn2ppKURpTVazKsCEis4uahkHMsac1m85J4r,True,663552,165888,1032,516,516,3zqXX6kzhkbW3d4TwD2CNjMRwxTbREXySekvq37kfCNk,41285,644665,-603380,622
2022-01-20 20:57:40-05:00,4217,8sneA6wAg6geVDJ1g7YWg4R1PfjuRVzeHp1nUBJinhZa,14i1uWtmcTjrdbg3DSr9vzd5NBnxqsn1A4QdgFBZqeYM,True,111612,27902,172,86,86,3zqXX6kzhkbW3d4TwD2CNjMRwxTbREXySekvq37kfCNk,6909,51375,-44466,619
2022-01-20 20:57:40-05:00,4218,Ckqos6cdncPKj13DnCmDVZsZTqp6eS7277CRrT9WhcEr,AtUV8m7VQJvZq7GLCAHMf3jV7iamKEPnWVZHWuuVZQp1,True,459875,114968,708,354,354,3zqXX6kzhkbW3d4TwD2CNjMRwxTbREXySekvq37kfCNk,28336,326025,-297689,616
2022-01-20 20:57:44-05:00,4219,5sN3cfz4hZjwy2HkAStKWeL8wHhdbkW8F7USzwCzmggh,Fme7U7QY92biAsV3RR2Fj7rJPnpdcov13mmFhVDFuyYG,True,264983504,66245876,414087,207043,207044,3zqXX6kzhkbW3d4TwD2CNjMRwxTbREXySekvq37kfCNk,16563495,129523650,-112960155,625
2022-01-20 20:57:48-05:00,4220,HVZkXeDR3mc8oB9qFFwCK4RXpPojdcHk9tRGep6xtKGK,Bh3py7awPejWqeTMxtAgF7mPotL2Asxf8YrYJykq9nBt,True,2442604,610651,3819,1909,1910,3zqXX6kzhkbW3d4TwD2CNjMRwxTbREXySekvq37kfCNk,152775,1274034,-1121259,625
2022-01-20 20:59:03-05:00,4221,2jPxG5FL6D6XEJsRszJ9cmQ54AWSpZyPFSbn3DpWBSuM,3toQou4UVNvyWYvMvkuv379RVEF2aN2TzCpKKBUqeQV6,True,71525979,17881494,111921,55960,55961,3zqXX6kzhkbW3d4TwD2CNjMRwxTbREXySekvq37kfCNk,4476846,36746742,-32269896,625
2022-01-20 20:59:21-05:00,4222,GufVttJatW8NLeztT1NRQSLZpQNRk45kaG41p3QcWhx7,GTJUsWoWRyeafYJVhx2aRo8NE94U5UrBjaehmJ4PRUhn,True,19943927,4985981,31123,15561,15562,3zqXX6kzhkbW3d4TwD2CNjMRwxTbREXySekvq37kfCNk,1244944,6607925,-5362981,624
2022-01-20 20:59:40-05:00,4223,D64rDiWT3YG28fCgXCmbNjYa2JakZbpKQ1D2XuLChUfV,8WmMWq8cTsGQym5pUbHm9dPCpJugBeWUMVERYFGLxWHj,True,25395864,6348966,39666,19833,19833,3zqXX6kzhkbW3d4TwD2CNjMRwxTbREXySekvq37kfCNk,1586654,9558853,-7972199,624
2022-01-20 20:59:59-05:00,4224,8MGEQ1KEMv9WSgVifjN7CQ7tDbJBJbWgGYu71dTDKEPQ,mQY2X9KYVXf9JmGY8XwMK4G8odM4HmWkgEmYYqKnkvF,True,63707291,15926822,99669,49834,49835,3zqXX6kzhkbW3d4TwD2CNjMRwxTbREXySekvq37kfCNk,3986775,38355837,-34369062,625
2022-01-20 20:59:59-05:00,4225,CagSUfZLwXuCdypC4KzU6FSNdmCj9dKDroPcNeaRtsyt,yxw5d1ztZuEUY2QjL7eLpr72QJAj5rJd6ERvg91cy1m,True,599081,149770,935,467,468,3uL2NSR2ZdDqCiKfzA5SwwpddAnit22DBJo6uvvz1rRs,37424,282624,-245200,624
2022-01-20 21:00:00-05:00,4226,GqAS41YJssg9aaEp3hs3sG98APCsXhiQBQszXaSjZ2bN,2wodJ3AhrXdE1T4oVL95KvoBND7PubG5Wd5GWiLCMZJU,True,70351045,17587761,110009,55004,55005,3zqXX6kzhkbW3d4TwD2CNjMRwxTbREXySekvq37kfCNk,4400385,65388892,-60988507,625
2022-01-20 21:00:00-05:00,4227,3qnPsgqW11AcDEmyjmJquPcPLyE3EdJQuVLJ5kinDrd3,86rZadBB7emKio76aFTahpbrFtxd9tqZ4Mxgzaavq2xU,True,58512,14628,91,45,46,3zqXX6kzhkbW3d4TwD2CNjMRwxTbREXySekvq37kfCNk,3658,30677,-27019,625
2022-01-20 21:00:25-05:00,4228,BrHRMouGRz3LBNzd9anfdYMhWfg8yUPHL4PqJ8WdEDFS,4uzoLa3mC2VYHAPBoHLX4gTjPTC28rPf2fvEGtJWPYc,True,22537568,5634392,35239,17619,17620,3zqXX6kzhkbW3d4TwD2CNjMRwxTbREXySekvq37kfCNk,1409594,20825360,-19415766,625
2022-01-20 21:00:28-05:00,4229,5rW9kqXB9feGSKSvSMNJF1FCsBYV3vGmTmc8MvzaZ3pi,7AjnjcfPJevW5521hXw4VtgRCfHSsAqyzyArukKfNcHo,True,4072882,1018220,6355,3177,3178,3zqXX6kzhkbW3d4TwD2CNjMRwxTbREXySekvq37kfCNk,254224,2487832,-2233608,624
2022-01-20 21:00:28-05:00,4230,8627qmFevGS1LSDyCgoJjbURcf8CjVFCcxE7U9mWVP5f,3sgQuNcZuGV59Q9apxSBQcV1XAa6og6xa8FLpumvN7iZ,True,14848,3712,23,11,12,3zqXX6kzhkbW3d4TwD2CNjMRwxTbREXySekvq37kfCNk,929,7583,-6654,625
2022-01-20 21:00:28-05:00,4231,3C2MZQKh9x4zNTCMbhhvoafGaFMwUooqfy9MCgPyXs6E,AHjgWKpYPWe6ketjDHDKFBFsKQiRJ41jnkuo39MVYxZo,True,78408741,19602185,122297,61148,61149,3zqXX6kzhkbW3d4TwD2CNjMRwxTbREXySekvq37kfCNk,4891913,52871329,-47979416,623
2022-01-20 21:00:28-05:00,4232,HGJoZvLakWfSDFwuvShNBc4kCf7nP7VqzyM3mELpbFEf,12Qn5jin7QvsBngXqYAv4UstyG3b6nRf1jsLp9Dp8G7k,True,6006567,1501641,9375,4687,4688,3zqXX6kzhkbW3d4TwD2CNjMRwxTbREXySekvq37kfCNk,375021,3276653,-2901632,624
2022-01-20 21:00:28-05:00,4233,FKQVm9RsteDe7dQmwx4NGYhz3Wrvwh7TCp9rFbTgAomx,Dbwox8eRCdmH5KXyi5sBaqWzhxtaVPo1teWXJ2kRFT1f,True,255549302,63887325,398436,199218,199218,HfEnetJ7uBSmZWCjBNxdvv9HEC5nsW4wDV7wu6WnhWan,15937462,229542156,-213604694,623
2022-01-20 21:00:31-05:00,4234,BLJgLzizx2yLgd12pVBAHTMqn9J5JA3JHCF8PnLnPyUk,HhDmwMysBFWhXnd3mrV31w75WBRKBS8wJSiEMZgqdUSp,True,378545318,94636329,591088,295544,295544,3zqXX6kzhkbW3d4TwD2CNjMRwxTbREXySekvq37kfCNk,23643538,207557958,-183914420,624
2022-01-20 21:00:35-05:00,4235,4ne6vC7qdxQYHJCsaeFAKZrKdFt2SwXGHQ3jrMHqt4DL,Cf1dLHY2WXH9rXbRKq5TT8THbdo9SdNUZq4rYhRCF9z,True,50615322,12653830,76467,38233,38234,3zqXX6kzhkbW3d4TwD2CNjMRwxTbREXySekvq37kfCNk,3058692,14307312,-11248620,604
2022-01-20 21:00:51-05:00,4236,D7XummfEc3NTK4qMvZegV3FrYuqc8mNgnQu3ujwemZtg,HHiRcecqzW7sGFTio7Ph6TYv3dGt64KWv4DEKgKm84fQ,True,3958713,989678,6019,3009,3010,3zqXX6kzhkbW3d4TwD2CNjMRwxTbREXySekvq37kfCNk,240796,2189794,-1948998,608
2022-01-20 21:00:57-05:00,4237,5hJereyPSCNUrGW7TdYXHKjhXMWTbGZzc2GF9MWksLJE,AUE3NpqaeamHGBKUVuKnUhnBb4Lzt7xWU1FHMu1Hq5dC,True,490153967,122538491,766575,383287,383288,3zqXX6kzhkbW3d4TwD2CNjMRwxTbREXySekvq37kfCNk,30663030,139389063,-108726033,625
2022-01-20 21:02:24-05:00,4238,DDsY5V3F9wnEGBoQFCEf1hvEYuKUaJdysbc7TxhNqe9G,5oBCGzvy8odB8MCxCUvPDqYCnTyteZ4Yy1JDroroygbi,True,52777161,13194290,82130,41065,41065,3zqXX6kzhkbW3d4TwD2CNjMRwxTbREXySekvq37kfCNk,3285222,13742313,-10457091,622
2022-01-20 21:02:50-05:00,4239,DvuRmJkfn6FQczUKgYeaSCqwy2NTMunuAKNrnmxMvnzS,7LpWTX9dgBtW75kfEoB5WuNsDwEdw5s8CYSHh3J4qagM,True,44759580,11189895,67637,33818,33819,3zqXX6kzhkbW3d4TwD2CNjMRwxTbREXySekvq37kfCNk,2705515,25109318,-22403803,604
2022-01-20 21:02:50-05:00,4240,FV3G5EsSmyiLAAoREhgDXwvzbxoyDeq4Mwfj4jK5fJ7U,5nhzbJmm5JAwGDpTZoenkM1u3XtMY4uN7Qsm3vFGtRJE,True,43555114,10888778,65807,32903,32904,3zqXX6kzhkbW3d4TwD2CNjMRwxTbREXySekvq37kfCNk,2632308,9777194,-7144886,604
2022-01-20 21:02:54-05:00,4241,DkvR2xUPMyXWGGkUSmDSfhp7RtvMkfbT1ThKCS3TwrXd,F7jYV6TtT1LZ5XCNn1zkbUfNMo4gGcQUczAQy1jLHpaW,True,431961543,107990385,653652,326826,326826,72FwbpFGoLEazJEdpqNtPNefsadUrimUqma9wSoy4qiS,26146102,199568873,-173422771,605
2022-01-20 21:02:54-05:00,4242,DY6k3Dkwe18iLneaT8Xo3VpJWB6V4jWwQQjoDvEzdg2j,3GGV7S9FpRQGbARBXkvGFVqLrmw8JvYAcpnR1aKVUY2f,True,8782424,2195606,13376,6688,6688,3zqXX6kzhkbW3d4TwD2CNjMRwxTbREXySekvq37kfCNk,535047,5396343,-4861296,609
2022-01-20 21:02:54-05:00,4243,BgnsCfJ54ReunUtwPJLzkW4PWnqpBDWGNYxsW5PvDrbK,KpMqEkQ9dKMgCevsEK895wHd3fCLRPSzDmJSv3tKU4u,True,10279578765,2569894691,15431298,7715649,7715649,3zqXX6kzhkbW3d4TwD2CNjMRwxTbREXySekvq37kfCNk,617251921,4186048647,-3568796726,600
2022-01-20 21:02:54-05:00,4244,9WJBnVi84E926j7xEd566WzrZJkPJWRgmEnYj9vyjuad,4dLaFS5F7TGyLdwuJLMGkz3bSL53aHzd9ZfpNmhHxXeF,True,10904693,2726173,16761,8380,8381,3zqXX6kzhkbW3d4TwD2CNjMRwxTbREXySekvq37kfCNk,670463,5960736,-5290273,614
2022-01-20 21:02:54-05:00,4245,8swGZMrPrLAxZd7MxTbkCL13k3DmAJUw41jCp6Xo6awW,3fKnX7yTNXAT4uMmXVdTy47ALJT8h8YSD3WiBb4BGuzH,True,164447554,41111888,246084,123042,123042,3zqXX6kzhkbW3d4TwD2CNjMRwxTbREXySekvq37kfCNk,9843390,77917093,-68073703,598
2022-01-20 21:03:00-05:00,4246,CxLFMBDFkoMvpK9YUf7WtCq6hn7k3QACAuetAnGjU6KA,2gE52a1GWQnS6ifV6eVtKQyr13LXP5Jdt3yG9SjGPJPF,True,862635459,215658864,1347347,673673,673674,3zqXX6kzhkbW3d4TwD2CNjMRwxTbREXySekvq37kfCNk,53893889,191148430,-137254541,624
2022-01-20 21:14:30-05:00,4247,B9WJfmrYEkVH3L1UWz4qqWpaexHydymbzvEfwNVtB9BV,6mQb4yzGq8jE1NbweKCKSbevnnYVhHYxyc6Gz2a5kJLn,True,240070070,60017517,368937,184468,184469,3zqXX6kzhkbW3d4TwD2CNjMRwxTbREXySekvq37kfCNk,14757493,57548305,-42790812,614
2022-01-20 21:14:35-05:00,4248,8trFFwvXKKMwMx952ugCZmqyw29e1HxEKBuQmFn8ZwTf,FsD7gCvHXM3QchQiDcd292ksy5afZMWApneNTat5ndeS,True,214076341,53519085,334401,167200,167201,3zqXX6kzhkbW3d4TwD2CNjMRwxTbREXySekvq37kfCNk,13376053,51111732,-37735679,624
2022-01-20 21:14:52-05:00,4249,2mfcg17QocKKvDcqDH88TwxHRiS8dAQiJAGoAh1brns9,8aQLELBgaA9eXsxSciMjxWv8B1hpbUPfLwqVjEnasZbe,True,117257018,29314254,183297,91648,91649,3zqXX6kzhkbW3d4TwD2CNjMRwxTbREXySekvq37kfCNk,7331911,32445726,-25113815,625
2022-01-20 21:21:37-05:00,4250,8abFwhhZyq3xkvjp4NWDBt7qAPXBbzBxksUk8SAUeVkN,A9u4dhWZbBwthC4WXQg1Dfp3wHYXr67SGs5na1EQ1k3r,True,41036806,10259201,63283,31641,31642,3zqXX6kzhkbW3d4TwD2CNjMRwxTbREXySekvq37kfCNk,2531334,9022225,-6490891,616
2022-01-20 21:22:33-05:00,4251,AvwHizRhHUSahmvSg4jmTUErc7vAFSmkRAEsiKhXfW1m,3UrWYx8y9N5o9GYneSe6zyyHRTZzxwvcipQfHHYh7tEs,True,1357376,339344,2081,1040,1041,4BnQKPLuE3DMTtxp8MjUBytgnhvxqq3ZTqZHTVZo4JJh,83248,602238,-518990,613
2022-01-20 21:22:33-05:00,4252,DC4UVUDFWL3gVtgkX9hPtFgtxaA8DH5p94i4k9U3wyWv,3HCWqVvQQfRgSKitsTjGTduJ82ointZUSNtj13uea4kD,True,922343452,230585863,1397497,698748,698749,HfEnetJ7uBSmZWCjBNxdvv9HEC5nsW4wDV7wu6WnhWan,55899890,395728862,-339828972,606
2022-01-20 21:24:39-05:00,4253,H3x9b27yHVdCxvtDf7mmJxkNeubcmQMwfAkLTYADPWNv,HGVCCz23rWx78vrTB2wvm2aesbLZuYFhhNuznGiSSAyA,True,2393369482,598342370,3744393,1872196,1872197,HfEnetJ7uBSmZWCjBNxdvv9HEC5nsW4wDV7wu6WnhWan,149775754,569944590,-420168836,625
2022-01-20 21:46:26-05:00,4254,3Xbsek5MsEGoWr3G9yhuohREr26B2vSQcjqXdspTFHta,2rPxkUiMo9wGDq8EvAiwY3ngRpKmL223cBWWNTYoBmFp,True,102092991,25523247,159308,79654,79654,HfEnetJ7uBSmZWCjBNxdvv9HEC5nsW4wDV7wu6WnhWan,6372346,28103249,-21730903,624
2022-01-20 21:59:29-05:00,4255,3XZLp6JyrQYnufa1obczXqmK6cNR29ZMW1FdCYbWNTCP,8kUTi1Prio14m9LjCj6Mari6pXwJTYkE1mp21LMn235p,True,138259,34563,215,107,108,4BnQKPLuE3DMTtxp8MjUBytgnhvxqq3ZTqZHTVZo4JJh,8625,47056,-38431,623
2022-01-20 22:07:10-05:00,4256,J3ggP7ZxL8HRh3CBp5iYG2WgjLyNSAWYT46uC9VYDLCz,2FqTRiRPiLvdAH2BS5vroVntpsSXvTJEn5UHWmtKHzh9,True,20867802,5216950,32483,16241,16242,3zqXX6kzhkbW3d4TwD2CNjMRwxTbREXySekvq37kfCNk,1299328,7360801,-6061473,622
2022-01-20 22:08:41-05:00,4257,D9VKhnfLLCrntDGFYSfoxFaY76VnHmYZ1ZbyFXdKdibz,2hRCRH2pMDyQGYcXHa8Y6BZo6FbcGZf5VJC1v8Bp6tGa,True,65273478,16318369,102020,51010,51010,HfEnetJ7uBSmZWCjBNxdvv9HEC5nsW4wDV7wu6WnhWan,4080806,27162898,-23082092,625
2022-01-20 22:08:41-05:00,4258,A4tDE948CPFPh1UwHb8sXryfKktbxZ8BCkqXgA5DJHA8,3zXeKMrsEpCe5fQumLNzCgpxcG1kLJFEAtJuqxLsC6ZG,True,61490325,15372581,95547,47773,47774,3zqXX6kzhkbW3d4TwD2CNjMRwxTbREXySekvq37kfCNk,3821907,29488653,-25666746,621
2022-01-20 22:08:41-05:00,4259,399591e8XgY52yCMorCQ2WL6dQZTC485ZooHtmGuirhZ,JCiXAooFmKmEPQ2S7C8iSk6CLcTyrPEe1SsPSLyUGySe,True,759674,189918,1177,588,589,3zqXX6kzhkbW3d4TwD2CNjMRwxTbREXySekvq37kfCNk,47105,469904,-422799,620
2022-01-20 22:08:41-05:00,4260,4uygLJDk9DFCifJ56YwMrEsvd3oQNq8tYSLnMCyWorS6,GimL4uKGvg3FFmFQSWzAcjstv3Vmk5NMgDGMKTuXYVpB,True,368129873,92032468,571400,285700,285700,3zqXX6kzhkbW3d4TwD2CNjMRwxTbREXySekvq37kfCNk,22856024,165745795,-142889771,620
2022-01-20 22:08:43-05:00,4261,8E3K7vCHJ2xjdFofPRGLbMxrkm8UYEi926QmXPAFwsqe,4qHUDA1c43Dg4qi1ZPKqmpGYiEMUZ6r4UuzB5ftHCEhW,True,1006111488,251527872,1553942,776971,776971,3zqXX6kzhkbW3d4TwD2CNjMRwxTbREXySekvq37kfCNk,62157684,557602131,-495444447,617
2022-01-20 22:09:03-05:00,4262,8kJu5aqVSmW8FSZR9h6F75ftn9V2U9uMLBEKeqRaC855,FhVHByujkvwwtjTVpZ4mqSUqoMoBgeLUc5H7rbz3FgAt,True,62708272,15677068,97929,48964,48965,72FwbpFGoLEazJEdpqNtPNefsadUrimUqma9wSoy4qiS,3917177,38834242,-34917065,624
2022-01-20 22:09:19-05:00,4263,FnAT8HKGgisYfeAbxKU2gSbCp8KbZHULRpaJX1NVijHy,2u637Crc2QzfSJmCnRNqeib3aZQVn4NGncpgM3Ph6jvm,True,24308070,6077017,37566,18783,18783,3zqXX6kzhkbW3d4TwD2CNjMRwxTbREXySekvq37kfCNk,1502643,8992770,-7490127,618
2022-01-20 22:09:19-05:00,4264,9KD2AifD5wFD4QkHYuawXbJgLWHrfj2QPF3fT8jhGVA5,Ga9gAqmkuHbqrr31sUFPqa1xa5WNxLWJWGPUaMxQqLdj,True,690166,172541,1074,537,537,3zqXX6kzhkbW3d4TwD2CNjMRwxTbREXySekvq37kfCNk,42981,433612,-390631,622
2022-01-20 22:10:16-05:00,4265,H3394S5wdbwXB4scjGAY8NsXxCdGy1Xebct18s42FM1K,Hz84L1EquzhCvBJP75ScKug46hYGdNMVNH16AdG4y5D8,True,33271718,8317929,51627,25813,25814,4BnQKPLuE3DMTtxp8MjUBytgnhvxqq3ZTqZHTVZo4JJh,2065085,14402775,-12337690,620
2022-01-20 22:10:16-05:00,4266,FsMiJiJZibohKoV5QRisWCjzuFd86xSxFb4m73AQmu93,7p3TSKBaG9SV2YNDnhutQKacPKpTTmgsEfzmK51t6sYb,True,147859636,36964909,228826,114413,114413,4BnQKPLuE3DMTtxp8MjUBytgnhvxqq3ZTqZHTVZo4JJh,9153072,54866001,-45712929,619
2022-01-20 22:10:16-05:00,4267,HwosLQgDY1xtHQRQ4hzroPQHFWssPzTj5vRkP37FcviB,HKTNEYNXrephNkH7apbobK4mcQXcNayQA4W1NgM6sLr8,True,32322609,8080652,49692,24846,24846,HfEnetJ7uBSmZWCjBNxdvv9HEC5nsW4wDV7wu6WnhWan,1987698,11133467,-9145769,614
2022-01-20 22:10:16-05:00,4268,A36aouot1oFLUtswuBUM4EVcis9chKaSJu53MRoPDjab,33U9gpq1RRFMGWDrWa3ezXXkwgBewdAS6QGgGVPtGvqb,True,190609383,47652345,293428,146714,146714,4BnQKPLuE3DMTtxp8MjUBytgnhvxqq3ZTqZHTVZo4JJh,11737134,70340949,-58603815,615
2022-01-20 22:10:20-05:00,4269,AUH6YGBV8tDVX1E1WTo92Mubfx1DGsqfGeyUBqxo4fSr,33QZgMwmW32WuvmxD8XNbmF9ea88bLe3YTtNwHV73Wwu,True,147814014,36953503,225197,112598,112599,4BnQKPLuE3DMTtxp8MjUBytgnhvxqq3ZTqZHTVZo4JJh,9007888,56097581,-47089693,609
2022-01-20 22:10:20-05:00,4270,3VdSA9CED9f5swRwHX2U15U7J6Muaq8VPnCNy9CaGDHe,2YYstfnfdYic5NWmEbcUEHpccNUVd1EhuCkExvMsoMk8,True,3547919,886979,5439,2719,2720,4BnQKPLuE3DMTtxp8MjUBytgnhvxqq3ZTqZHTVZo4JJh,217560,2209437,-1991877,613
2022-01-20 22:10:29-05:00,4271,36ByQojnxEckWdQTjqHfxKqCx9yjqWQsPsZyqaN72UWR,AZoirtS1fjX61agRM64tqThVinnJTh3BWgiHyNHPTgZP,True,421080,105269,656,328,328,3zqXX6kzhkbW3d4TwD2CNjMRwxTbREXySekvq37kfCNk,26251,258663,-232412,623
2022-01-20 22:10:51-05:00,4272,5kwvkEtRFFD84j4ntVgxkacadgJaFvQ9JLhJqzLR7Y3G,GpMMkTv9T7y8DTiizuoJUsWvnSk3GSxADjRMGyYpryxm,True,16628743,4157185,25828,12914,12914,HfEnetJ7uBSmZWCjBNxdvv9HEC5nsW4wDV7wu6WnhWan,1033129,5912724,-4879595,621
2022-01-20 22:11:19-05:00,4273,5Rxuqgs4CaSKbfDXqBMFXkLTQ9dxrUjThXzoy3ouYVtK,BgvbKru66ebrGUcFFymGTmsaQv6GgcGMybiWaXqzBtwX,True,109310,27327,166,83,83,4BnQKPLuE3DMTtxp8MjUBytgnhvxqq3ZTqZHTVZo4JJh,6664,71823,-65159,609
2022-01-20 22:11:23-05:00,4274,3ogBPSRcKfmwzgumVDHBkXLi1eCsEFG2xzSJgD4LQDNy,7TXyqWgJqfe71MSWFA2n7ufZbUdzf7JJoWej8FNNtMXo,True,11084501,2771125,17004,8502,8502,4BnQKPLuE3DMTtxp8MjUBytgnhvxqq3ZTqZHTVZo4JJh,680196,4777482,-4097286,613
2022-01-20 22:11:25-05:00,4275,8xvLGVeDmhVYQhN2ZpWkVG9jCrukRsNQ4926a4TMiZqa,9ciBySSjvADwp47WkETiFWZKVTFL8Hf1XvK7aSxhcgQS,True,13096348,3274087,20112,10056,10056,4BnQKPLuE3DMTtxp8MjUBytgnhvxqq3ZTqZHTVZo4JJh,804489,6141542,-5337053,614
2022-01-20 22:11:27-05:00,4276,8T4WK27RvWVGqPuNqY6whk1fmU4vd5qaUQPZG1GJ79bh,DvSz7knS8N3K7L6JhQf1s4mJSyxB8uJXNQXtyjJn8QRL,True,65176025,16294005,100333,50166,50167,4BnQKPLuE3DMTtxp8MjUBytgnhvxqq3ZTqZHTVZo4JJh,4013336,32110798,-28097462,615
2022-01-20 22:11:30-05:00,4277,A1j2G5FZRyWSjFt6dK87WHhLkQrPUVqHaM3KhSzhAKDT,2fMiHLYm4pL3YCd8aveTR4mT9uVxztQeMwb5eRZb4wUW,True,367809,91952,561,280,281,3uL2NSR2ZdDqCiKfzA5SwwpddAnit22DBJo6uvvz1rRs,22472,188549,-166077,610
2022-01-20 22:11:31-05:00,4278,7hTjPRQSYAoWHhtpsVz2oKK5SAuFJd8dPHShKgKJq8dy,6DcHcrtcXR88d8e2KahhAiWTeRznNfF8oXLHmh5wE7wz,True,502141158,125535289,780501,390250,390251,4BnQKPLuE3DMTtxp8MjUBytgnhvxqq3ZTqZHTVZo4JJh,31220079,216810501,-185590422,621
2022-01-20 22:11:31-05:00,4279,CbhrZUdan1axNDFUrX1ZuEohfNMEGrszKSkk6pppVQuw,DHEAjJNtuEePezYAv77thWabbVxxqQpfuiC6moRSrpG1,True,48632377,12158094,75819,37909,37910,4BnQKPLuE3DMTtxp8MjUBytgnhvxqq3ZTqZHTVZo4JJh,3032795,30331804,-27299009,623
2022-01-20 22:11:52-05:00,4280,7ptPfZnqDCvTWotn8wPGyzERTJYLBgk47j7qf8Ciq941,AfAGcFqFFPi6LCQXydgsPWidN35c7NbhBa7RLEaDQQCu,True,5400112,1350026,8439,4219,4220,4BnQKPLuE3DMTtxp8MjUBytgnhvxqq3ZTqZHTVZo4JJh,337582,1835586,-1498004,625
2022-01-20 22:12:29-05:00,4281,JDeYjCLpfnzcfxDFgHf4aBcHsajwdR14GUaKAA9euzVf,EJbvKoyMZcoCx4vWa61uMbW2vr6mUhrgEuECdteVBuZZ,True,4079841,1019960,6272,3136,3136,HfEnetJ7uBSmZWCjBNxdvv9HEC5nsW4wDV7wu6WnhWan,250907,2651824,-2400917,614
2022-01-20 22:12:38-05:00,4282,6VJcr3VAEcEZaHEpt48QL8QxHKABufVp8n2JSEVTLh9U,8naR6kiySKj3vai9dCetdgCnCHgf2oyLjGqKTJ3Lz64Y,True,909380752,227345187,1422379,711189,711190,3zqXX6kzhkbW3d4TwD2CNjMRwxTbREXySekvq37kfCNk,56895185,461073558,-404178373,625
2022-01-20 22:12:38-05:00,4283,AWvHDdb2ikqV8wc7qQ8azbvNTZdixMNxhQjhQdhayYtR,9EpgEPBb1nog6aQeFdMXfSRiLSnzGQFQ39mbLdCxgYTv,True,24242395,6060598,37908,18954,18954,3zqXX6kzhkbW3d4TwD2CNjMRwxTbREXySekvq37kfCNk,1516340,8737982,-7221642,625
2022-01-20 22:21:46-05:00,4284,4ne6vC7qdxQYHJCsaeFAKZrKdFt2SwXGHQ3jrMHqt4DL,Cf1dLHY2WXH9rXbRKq5TT8THbdo9SdNUZq4rYhRCF9z,True,37328022,9332005,58390,29195,29195,3zqXX6kzhkbW3d4TwD2CNjMRwxTbREXySekvq37kfCNk,2335610,11405591,-9069981,625
2022-01-20 22:22:43-05:00,4285,GjQQ2fQ7mrGjWZwjVYFUKp9NM1LmfkhEo675ovU5SPa8,ECgVUMRY5nB4MALs5drDyipF7YohCPuJpj2UegCs7HMn,True,8357988,2089497,13078,6539,6539,3zqXX6kzhkbW3d4TwD2CNjMRwxTbREXySekvq37kfCNk,523123,4197840,-3674717,625
2022-01-20 22:23:01-05:00,4286,5eMLdQ4gYA5iqvTXSNdGvctHp7s5VpyFuwtJKqx6chBc,Ckxc5K39nkBNXBTmFTM8J48R7wGqNm3vHKZu4G5baumZ,True,171683498,42920874,268128,134064,134064,3uL2NSR2ZdDqCiKfzA5SwwpddAnit22DBJo6uvvz1rRs,10725151,68208866,-57483715,624
2022-01-20 22:25:29-05:00,4287,F9s8a7Cpiw5dw3a2aNFMofqwyDWNXvDLnSdJzoj1gRiV,GpKsQKJD79KBRWdCTkyi4zX7NaoCWsLUjrKxAwJB6o6s,True,11042042,2760510,17278,8639,8639,3zqXX6kzhkbW3d4TwD2CNjMRwxTbREXySekvq37kfCNk,691149,3228721,-2537572,625
2022-01-20 22:26:22-05:00,4288,Bsr6kx1B6BSEd5UnJ7Z61M49iUb3bFrDVhiEtMVtPDF2,3CFd1pUJAJPA9fobwn4Jj2mRju1CWmoop4Mh4znypNWT,True,15275136,3818784,22859,11429,11430,3uL2NSR2ZdDqCiKfzA5SwwpddAnit22DBJo6uvvz1rRs,914388,6575631,-5661243,598
2022-01-20 22:26:22-05:00,4289,6NJFN855M3Q3RLTDNo57gTgAmwPD6G2E3WvMb1m5eNCN,3YpqNnonsvXaRT4nCC3G5FZx1jjVtbDPc36LiR6WK5jR,True,39696926,9924231,60159,30079,30080,3uL2NSR2ZdDqCiKfzA5SwwpddAnit22DBJo6uvvz1rRs,2406390,25456611,-23050221,606
2022-01-20 22:26:22-05:00,4290,DYCYiQFH9QHzCo3eAw1pFoDu7pzwFMo1E2WDZjVFRz5w,CPh4FWsGak1kd1WFEH9qBjNhnun3R2tHtZA57zW8ugn5,True,26145250,6536312,40460,20230,20230,3uL2NSR2ZdDqCiKfzA5SwwpddAnit22DBJo6uvvz1rRs,1618434,15215424,-13596990,619
2022-01-20 22:26:22-05:00,4291,DkvR2xUPMyXWGGkUSmDSfhp7RtvMkfbT1ThKCS3TwrXd,F7jYV6TtT1LZ5XCNn1zkbUfNMo4gGcQUczAQy1jLHpaW,True,318403551,79600887,496843,248421,248422,3uL2NSR2ZdDqCiKfzA5SwwpddAnit22DBJo6uvvz1rRs,19873725,155517353,-135643628,624
2022-01-20 22:26:25-05:00,4292,8swGZMrPrLAxZd7MxTbkCL13k3DmAJUw41jCp6Xo6awW,3fKnX7yTNXAT4uMmXVdTy47ALJT8h8YSD3WiBb4BGuzH,True,121298127,30324531,188507,94253,94254,3zqXX6kzhkbW3d4TwD2CNjMRwxTbREXySekvq37kfCNk,7540294,60634419,-53094125,621
2022-01-20 22:26:25-05:00,4293,7CSCMFa9W52tBDVUbXbc3woAy3GByeA1wPJdp3MgznPa,3447ptuVFu6G8B6N63RmS8mRv4n9PfHneypHLvbeaGLn,True,55557290,13889322,86547,43273,43274,3zqXX6kzhkbW3d4TwD2CNjMRwxTbREXySekvq37kfCNk,3461892,29249433,-25787541,623
2022-01-20 22:26:25-05:00,4294,D64rDiWT3YG28fCgXCmbNjYa2JakZbpKQ1D2XuLChUfV,8WmMWq8cTsGQym5pUbHm9dPCpJugBeWUMVERYFGLxWHj,True,18646559,4661639,28519,14259,14260,3zqXX6kzhkbW3d4TwD2CNjMRwxTbREXySekvq37kfCNk,1140788,7520306,-6379518,611
2022-01-20 22:26:25-05:00,4295,GufVttJatW8NLeztT1NRQSLZpQNRk45kaG41p3QcWhx7,GTJUsWoWRyeafYJVhx2aRo8NE94U5UrBjaehmJ4PRUhn,True,14640828,3660207,22302,11151,11151,3uL2NSR2ZdDqCiKfzA5SwwpddAnit22DBJo6uvvz1rRs,892101,5231473,-4339372,609
2022-01-20 22:27:22-05:00,4296,GxFxvEUdWofneMmVvhCSScH9V6Zia5WJ2J9q6CpPnaq3,ATLykiHDii3Lw53MoZXwqu1FbBNPJbVNVGe2SoQMjVmY,True,1677137,419284,2590,1295,1295,3zqXX6kzhkbW3d4TwD2CNjMRwxTbREXySekvq37kfCNk,103614,960035,-856421,617
2022-01-20 22:28:19-05:00,4297,J1sBDjpdBZcsSBS5eg95SSRjRqmQUR9cXJCsLJu8yCUt,F5wRpD2senMkGbL8Uquqo8W9x5NQDDa268dHuVFAZCww,True,2518351,629587,3885,1942,1943,3uL2NSR2ZdDqCiKfzA5SwwpddAnit22DBJo6uvvz1rRs,155420,1247003,-1091583,617
2022-01-20 22:28:23-05:00,4298,9E97vZ6evPgg1Ao8KwvjjZhBFW6dXZrrJENk1HvZ3SU,D7U38PB8BXLwUVKbRNv9po7VcFdnn7Y4tWY9xpRiNJsT,True,36258704,9064676,56727,28363,28364,3uL2NSR2ZdDqCiKfzA5SwwpddAnit22DBJo6uvvz1rRs,2269087,10689233,-8420146,625
2022-01-20 22:28:24-05:00,4299,3idUQDMPAN9f6F6BipHAYFZyhG5JADey1y7JcFYx5BRh,D6UMk8WsSRahs4nGyi9DLt2HyZQy4wAywDwL31sL8BVj,True,26849993,6712498,41598,20799,20799,HfEnetJ7uBSmZWCjBNxdvv9HEC5nsW4wDV7wu6WnhWan,1663941,6907518,-5243577,619
2022-01-20 22:28:27-05:00,4300,5hJereyPSCNUrGW7TdYXHKjhXMWTbGZzc2GF9MWksLJE,AUE3NpqaeamHGBKUVuKnUhnBb4Lzt7xWU1FHMu1Hq5dC,True,359974864,89993716,553213,276606,276607,3uL2NSR2ZdDqCiKfzA5SwwpddAnit22DBJo6uvvz1rRs,22128523,111317876,-89189353,614
2022-01-20 22:29:36-05:00,4301,C33hfnDHzVwKXxr6AwFAXhd1vJYrPKhtqc75Qpjm19Zt,2WYBMSyrHQEYZqxEtxBMe2xn7eioJEGsudqdCmGvssGh,True,34277460,8569365,53584,26792,26792,3zqXX6kzhkbW3d4TwD2CNjMRwxTbREXySekvq37kfCNk,2143367,7940113,-5796746,625
2022-01-20 22:29:50-05:00,4302,HmspGdpobjC5Vbmo3FcKdw4RLPN7wJKxv3uKqDjVhLee,3YEX8TzdyJyuHo76Kw76imVCJjzrC9m188YuRKvwwSwD,True,222771491,55692872,348214,174107,174107,3zqXX6kzhkbW3d4TwD2CNjMRwxTbREXySekvq37kfCNk,13928583,54756240,-40827657,625
2022-01-20 22:30:05-05:00,4303,BgnsCfJ54ReunUtwPJLzkW4PWnqpBDWGNYxsW5PvDrbK,KpMqEkQ9dKMgCevsEK895wHd3fCLRPSzDmJSv3tKU4u,True,7578336857,1894584214,11731353,5865676,5865677,3uL2NSR2ZdDqCiKfzA5SwwpddAnit22DBJo6uvvz1rRs,469254137,3282068941,-2812814804,619
2022-01-20 22:30:05-05:00,4304,DY6k3Dkwe18iLneaT8Xo3VpJWB6V4jWwQQjoDvEzdg2j,3GGV7S9FpRQGbARBXkvGFVqLrmw8JvYAcpnR1aKVUY2f,True,6463945,1615986,9943,4971,4972,3zqXX6kzhkbW3d4TwD2CNjMRwxTbREXySekvq37kfCNk,397759,4166609,-3768850,615
2022-01-20 22:30:06-05:00,4305,3MEiFqy4F9nBW8gHxvGjv7norSBHwxhbzzNKngPk1RHq,2tcsJ4NUJegcEfHNwWPh979yKjKmq568CpNm5iWGbuoR,True,17375175,4343793,26615,13307,13308,3uL2NSR2ZdDqCiKfzA5SwwpddAnit22DBJo6uvvz1rRs,1064627,6939460,-5874833,612
2022-01-20 22:30:47-05:00,4306,3Xbsek5MsEGoWr3G9yhuohREr26B2vSQcjqXdspTFHta,2rPxkUiMo9wGDq8EvAiwY3ngRpKmL223cBWWNTYoBmFp,True,75038735,18759683,116384,58192,58192,HfEnetJ7uBSmZWCjBNxdvv9HEC5nsW4wDV7wu6WnhWan,4655372,22484741,-17829369,620
2022-01-20 22:31:03-05:00,4307,GKCeRcHQYMhcTwEm5wu1SbkXAT19gjGUGji43HS36B5N,EYQKX5sWsmXoge5xbTcMYAjvRbSUTXXpHEzckPY2LV8W,True,1283093,320773,2005,1002,1003,3zqXX6kzhkbW3d4TwD2CNjMRwxTbREXySekvq37kfCNk,80239,379020,-298781,625
2022-01-20 22:31:33-05:00,4308,9WJBnVi84E926j7xEd566WzrZJkPJWRgmEnYj9vyjuad,4dLaFS5F7TGyLdwuJLMGkz3bSL53aHzd9ZfpNmhHxXeF,True,8022201,2005550,12402,6201,6201,4BnQKPLuE3DMTtxp8MjUBytgnhvxqq3ZTqZHTVZo4JJh,496092,4620123,-4124031,618
2022-01-20 22:31:46-05:00,4309,72woixtGAuGazCMfsYfYBYLP7FuRj8Fwz9fynFo4MCE4,5237BmWkKf58PBeTUEiu3Ld5uKXEe8wcrJRmCnUoWWku,True,364487768,91121942,569176,284588,284588,3zqXX6kzhkbW3d4TwD2CNjMRwxTbREXySekvq37kfCNk,22767041,105066308,-82299267,624
2022-01-20 22:32:12-05:00,4310,8trkirSQNdMmAcJdeswxs5cPjH8dD6U4eJtWiAdMsrDB,HaSzpQ45x2MipfN17U6jGBxX8tXboomVDhXNSrnEfLDr,True,1728281,432070,2701,1350,1351,3zqXX6kzhkbW3d4TwD2CNjMRwxTbREXySekvq37kfCNk,108059,838163,-730104,625
2022-01-20 22:32:48-05:00,4311,Br1j5Ftafei7ysu5SmqVZSoRe4uS4qCPeKSPHg55pyiE,G8fc7QvXjfkgBFvAVUgJFQS3VaF1biL9rktBExGa87Ks,True,3619126798,904781698,5647676,2823838,2823838,HfEnetJ7uBSmZWCjBNxdvv9HEC5nsW4wDV7wu6WnhWan,225907067,1460488843,-1234581776,624
2022-01-20 22:32:50-05:00,4312,DXEJNyHSCbGZezXHy2xQaSzd37dwJs4dMTgt5VF5UZAG,7fCYM9DWrAX7vgZ11CwQMNd5NU8FB1yrbctxHaPYshpB,True,24302566,6075641,37966,18983,18983,4BnQKPLuE3DMTtxp8MjUBytgnhvxqq3ZTqZHTVZo4JJh,1518677,7213081,-5694404,624
2022-01-20 22:32:59-05:00,4313,FnAT8HKGgisYfeAbxKU2gSbCp8KbZHULRpaJX1NVijHy,2u637Crc2QzfSJmCnRNqeib3aZQVn4NGncpgM3Ph6jvm,True,17847328,4461832,27033,13516,13517,3zqXX6kzhkbW3d4TwD2CNjMRwxTbREXySekvq37kfCNk,1081352,7082700,-6001348,605
2022-01-20 22:32:59-05:00,4314,A36aouot1oFLUtswuBUM4EVcis9chKaSJu53MRoPDjab,33U9gpq1RRFMGWDrWa3ezXXkwgBewdAS6QGgGVPtGvqb,True,140249897,35062474,218414,109207,109207,4BnQKPLuE3DMTtxp8MjUBytgnhvxqq3ZTqZHTVZo4JJh,8736565,55398197,-46661632,622
2022-01-20 22:32:59-05:00,4315,8kJu5aqVSmW8FSZR9h6F75ftn9V2U9uMLBEKeqRaC855,FhVHByujkvwwtjTVpZ4mqSUqoMoBgeLUc5H7rbz3FgAt,True,45991706,11497926,69493,34746,34747,3zqXX6kzhkbW3d4TwD2CNjMRwxTbREXySekvq37kfCNk,2779750,30007257,-27227507,604
2022-01-20 22:33:01-05:00,4316,H3394S5wdbwXB4scjGAY8NsXxCdGy1Xebct18s42FM1K,Hz84L1EquzhCvBJP75ScKug46hYGdNMVNH16AdG4y5D8,True,24454087,6113521,37843,18921,18922,3uL2NSR2ZdDqCiKfzA5SwwpddAnit22DBJo6uvvz1rRs,1513756,11266778,-9753022,619
2022-01-20 22:33:01-05:00,4317,4uygLJDk9DFCifJ56YwMrEsvd3oQNq8tYSLnMCyWorS6,GimL4uKGvg3FFmFQSWzAcjstv3Vmk5NMgDGMKTuXYVpB,True,269917762,67479440,402624,201312,201312,3zqXX6kzhkbW3d4TwD2CNjMRwxTbREXySekvq37kfCNk,16104981,129458393,-113353412,596
2022-01-20 22:33:01-05:00,4318,2jDRvE3pQNjWy1NRFa4tzB3KmU5UkbUCHw8sQRFujo66,C4zNi2szDrEEh4coTF3WRUghfP4ZwAVVSYTLWfkejQRu,True,249872488,62468121,379703,189851,189852,3zqXX6kzhkbW3d4TwD2CNjMRwxTbREXySekvq37kfCNk,15188154,106909096,-91720942,607
2022-01-20 22:33:01-05:00,4319,A4tDE948CPFPh1UwHb8sXryfKktbxZ8BCkqXgA5DJHA8,3zXeKMrsEpCe5fQumLNzCgpxcG1kLJFEAtJuqxLsC6ZG,True,45082234,11270558,67271,33635,33636,3zqXX6kzhkbW3d4TwD2CNjMRwxTbREXySekvq37kfCNk,2690850,22976604,-20285754,596
2022-01-20 22:33:01-05:00,4320,8E3K7vCHJ2xjdFofPRGLbMxrkm8UYEi926QmXPAFwsqe,4qHUDA1c43Dg4qi1ZPKqmpGYiEMUZ6r4UuzB5ftHCEhW,True,737731089,184432772,1093780,546890,546890,3zqXX6kzhkbW3d4TwD2CNjMRwxTbREXySekvq37kfCNk,43751215,432238794,-388487579,593
2022-01-20 22:33:01-05:00,4321,AUH6YGBV8tDVX1E1WTo92Mubfx1DGsqfGeyUBqxo4fSr,33QZgMwmW32WuvmxD8XNbmF9ea88bLe3YTtNwHV73Wwu,True,108748422,27187105,166765,83382,83383,3zqXX6kzhkbW3d4TwD2CNjMRwxTbREXySekvq37kfCNk,6670602,44100949,-37430347,613
2022-01-20 22:33:01-05:00,4322,J3ggP7ZxL8HRh3CBp5iYG2WgjLyNSAWYT46uC9VYDLCz,2FqTRiRPiLvdAH2BS5vroVntpsSXvTJEn5UHWmtKHzh9,True,15278938,3819734,22373,11186,11187,3zqXX6kzhkbW3d4TwD2CNjMRwxTbREXySekvq37kfCNk,894931,5812970,-4918039,585
2022-01-20 22:33:01-05:00,4323,CxLFMBDFkoMvpK9YUf7WtCq6hn7k3QACAuetAnGjU6KA,2gE52a1GWQnS6ifV6eVtKQyr13LXP5Jdt3yG9SjGPJPF,True,631351654,157837913,920486,460243,460243,3zqXX6kzhkbW3d4TwD2CNjMRwxTbREXySekvq37kfCNk,36819467,155414815,-118595348,583
2022-01-20 22:33:01-05:00,4324,FsMiJiJZibohKoV5QRisWCjzuFd86xSxFb4m73AQmu93,7p3TSKBaG9SV2YNDnhutQKacPKpTTmgsEfzmK51t6sYb,True,108655625,27163906,167128,83564,83564,3zqXX6kzhkbW3d4TwD2CNjMRwxTbREXySekvq37kfCNk,6685144,43209924,-36524780,615
2022-01-20 22:33:01-05:00,4325,399591e8XgY52yCMorCQ2WL6dQZTC485ZooHtmGuirhZ,JCiXAooFmKmEPQ2S7C8iSk6CLcTyrPEe1SsPSLyUGySe,True,556878,139219,826,413,413,3zqXX6kzhkbW3d4TwD2CNjMRwxTbREXySekvq37kfCNk,33050,363028,-329978,593
2022-01-20 22:33:01-05:00,4326,3VdSA9CED9f5swRwHX2U15U7J6Muaq8VPnCNy9CaGDHe,2YYstfnfdYic5NWmEbcUEHpccNUVd1EhuCkExvMsoMk8,True,2610630,652657,4045,2022,2023,3zqXX6kzhkbW3d4TwD2CNjMRwxTbREXySekvq37kfCNk,161811,1706030,-1544219,619
2022-01-20 22:33:02-05:00,4327,D9VKhnfLLCrntDGFYSfoxFaY76VnHmYZ1ZbyFXdKdibz,2hRCRH2pMDyQGYcXHa8Y6BZo6FbcGZf5VJC1v8Bp6tGa,True,47859219,11964804,72072,36036,36036,4BnQKPLuE3DMTtxp8MjUBytgnhvxqq3ZTqZHTVZo4JJh,2882896,21290553,-18407657,602
2022-01-20 22:33:03-05:00,4328,9KD2AifD5wFD4QkHYuawXbJgLWHrfj2QPF3fT8jhGVA5,Ga9gAqmkuHbqrr31sUFPqa1xa5WNxLWJWGPUaMxQqLdj,True,506735,126683,775,387,388,4BnQKPLuE3DMTtxp8MjUBytgnhvxqq3ZTqZHTVZo4JJh,31017,334881,-303864,612
2022-01-20 22:33:25-05:00,4329,yU8LyPdpD2gV6KBQDfm6Kc55BrUdM63R98Bo3im6okB,7ZmFdy9nbZMDScyzeMZF3ANqRyxrr5qmNYPmwTv1M14v,True,213919742,53479935,332656,166328,166328,HfEnetJ7uBSmZWCjBNxdvv9HEC5nsW4wDV7wu6WnhWan,13306271,48894029,-35587758,622
2022-01-20 22:33:44-05:00,4330,C1CsbgQFvEvSXzuVHTr39tQHr3drDhjxeYiotd8eNocF,4rAaTCAMj5VpgNVKiYizabH7cMLhEA12seu2QXQNTyV3,True,33222337,8305584,51934,25967,25967,72FwbpFGoLEazJEdpqNtPNefsadUrimUqma9wSoy4qiS,2077372,8549035,-6471663,625
2022-01-20 22:34:06-05:00,4331,DDsY5V3F9wnEGBoQFCEf1hvEYuKUaJdysbc7TxhNqe9G,5oBCGzvy8odB8MCxCUvPDqYCnTyteZ4Yy1JDroroygbi,True,38799613,9699903,60276,30138,30138,HfEnetJ7uBSmZWCjBNxdvv9HEC5nsW4wDV7wu6WnhWan,2411044,11037162,-8626118,621
2022-01-20 22:34:09-05:00,4332,D7XummfEc3NTK4qMvZegV3FrYuqc8mNgnQu3ujwemZtg,HHiRcecqzW7sGFTio7Ph6TYv3dGt64KWv4DEKgKm84fQ,True,2917304,729326,4560,2280,2280,4BnQKPLuE3DMTtxp8MjUBytgnhvxqq3ZTqZHTVZo4JJh,182424,1695904,-1513480,625
2022-01-20 22:34:27-05:00,4333,8trFFwvXKKMwMx952ugCZmqyw29e1HxEKBuQmFn8ZwTf,FsD7gCvHXM3QchQiDcd292ksy5afZMWApneNTat5ndeS,True,157265097,39316274,242843,121421,121422,3uL2NSR2ZdDqCiKfzA5SwwpddAnit22DBJo6uvvz1rRs,9713746,41308327,-31594581,617
2022-01-20 22:34:37-05:00,4334,2mfcg17QocKKvDcqDH88TwxHRiS8dAQiJAGoAh1brns9,8aQLELBgaA9eXsxSciMjxWv8B1hpbUPfLwqVjEnasZbe,True,86139006,21534751,133131,66565,66566,3zqXX6kzhkbW3d4TwD2CNjMRwxTbREXySekvq37kfCNk,5325268,25964593,-20639325,618
2022-01-20 22:34:40-05:00,4335,B9WJfmrYEkVH3L1UWz4qqWpaexHydymbzvEfwNVtB9BV,6mQb4yzGq8jE1NbweKCKSbevnnYVhHYxyc6Gz2a5kJLn,True,176277322,44069330,264330,132165,132165,3zqXX6kzhkbW3d4TwD2CNjMRwxTbREXySekvq37kfCNk,10573238,46442413,-35869175,599
2022-01-20 22:35:18-05:00,4336,GNkEoVMpNAgfyDBZ986MR9BEVc485xpLuZWwSCyZk5zJ,AT2eiaMyZNHZGqgTdie8QjLWCTrWSdkRmQxU2vZNgtDs,True,30936647,7734161,47714,23857,23857,3zqXX6kzhkbW3d4TwD2CNjMRwxTbREXySekvq37kfCNk,1908594,7508647,-5600053,616
2022-01-20 22:35:18-05:00,4337,8abFwhhZyq3xkvjp4NWDBt7qAPXBbzBxksUk8SAUeVkN,A9u4dhWZbBwthC4WXQg1Dfp3wHYXr67SGs5na1EQ1k3r,True,30192404,7548099,47061,23530,23531,3zqXX6kzhkbW3d4TwD2CNjMRwxTbREXySekvq37kfCNk,1882476,7330180,-5447704,623
2022-01-20 22:35:22-05:00,4338,H3x9b27yHVdCxvtDf7mmJxkNeubcmQMwfAkLTYADPWNv,HGVCCz23rWx78vrTB2wvm2aesbLZuYFhhNuznGiSSAyA,True,1759128599,439782149,2743293,1371646,1371647,HfEnetJ7uBSmZWCjBNxdvv9HEC5nsW4wDV7wu6WnhWan,109731731,460839751,-351108020,623
2022-01-20 22:35:22-05:00,4339,4xn9vTtLZyNtCbBLLpcXUMWU8AnnZCov9rJaY6rew16T,5UNWdFw2CP44qS8oc4uPt8zxw6zFg8oXz8SUCedZLLEC,True,12386483,3096620,19381,9690,9691,HfEnetJ7uBSmZWCjBNxdvv9HEC5nsW4wDV7wu6WnhWan,775249,3368868,-2593619,625
2022-01-20 22:35:34-05:00,4340,FS5xx53Bo65G21gJLta7LEEiS132VJM1kGpUzuqyfzoy,2kbTLjdBBA9K1coxKmwmYbjq2heSnuNg4Nh2EfVNYgwj,True,156062435,39015608,244099,122049,122050,3zqXX6kzhkbW3d4TwD2CNjMRwxTbREXySekvq37kfCNk,9763962,40924282,-31160320,625
2022-01-20 22:36:11-05:00,4341,DBqRWp8dv3VLQC2dNAriLMVVAqSEpeXGoFRbcPW9busY,EM9N5ybnQdbRcSLdm7jY5zNyogYNkPD3BykBNaT6cvco,False,214663,214663,10140,507,9633,3zqXX6kzhkbW3d4TwD2CNjMRwxTbREXySekvq37kfCNk,10140,72877,-62737,472
2022-01-20 22:36:15-05:00,4342,2MbNCikBC3fdwqJKfMK1FjPg7wT3xWMXmN88XuikJ8r9,5eG6U5x63YYMpE7iwwu1TPcZapvQMyKczvtnFfST1BH3,True,99244,24811,151,75,76,HfEnetJ7uBSmZWCjBNxdvv9HEC5nsW4wDV7wu6WnhWan,6068,34013,-27945,611
2022-01-20 22:36:46-05:00,4343,FV3G5EsSmyiLAAoREhgDXwvzbxoyDeq4Mwfj4jK5fJ7U,5nhzbJmm5JAwGDpTZoenkM1u3XtMY4uN7Qsm3vFGtRJE,True,32115570,8028892,50221,25110,25111,HfEnetJ7uBSmZWCjBNxdvv9HEC5nsW4wDV7wu6WnhWan,2008862,7918317,-5909455,625
2022-01-20 22:36:47-05:00,4344,DvuRmJkfn6FQczUKgYeaSCqwy2NTMunuAKNrnmxMvnzS,7LpWTX9dgBtW75kfEoB5WuNsDwEdw5s8CYSHh3J4qagM,True,33003617,8250904,51618,25809,25809,HfEnetJ7uBSmZWCjBNxdvv9HEC5nsW4wDV7wu6WnhWan,2064747,19433700,-17368953,625
2022-01-20 22:56:01-05:00,4345,J1sBDjpdBZcsSBS5eg95SSRjRqmQUR9cXJCsLJu8yCUt,F5wRpD2senMkGbL8Uquqo8W9x5NQDDa268dHuVFAZCww,True,1852177,463044,2873,1436,1437,3zqXX6kzhkbW3d4TwD2CNjMRwxTbREXySekvq37kfCNk,114948,970223,-855275,620
2022-01-20 22:56:01-05:00,4346,DMACzuFBuj2vGqxZ3FV7QAo24jMV3EHKL8MrDrGbRkaJ,EnLfmDVW4ba2uqZKhj3X1TFnx8AHv7xwSWrMbVBYwcu9,True,47579420,11894855,73562,36781,36781,3zqXX6kzhkbW3d4TwD2CNjMRwxTbREXySekvq37kfCNk,2942500,17751267,-14808767,618
2022-01-20 22:56:01-05:00,4347,3idUQDMPAN9f6F6BipHAYFZyhG5JADey1y7JcFYx5BRh,D6UMk8WsSRahs4nGyi9DLt2HyZQy4wAywDwL31sL8BVj,True,19747420,4936855,30806,15403,15403,3zqXX6kzhkbW3d4TwD2CNjMRwxTbREXySekvq37kfCNk,1232268,5555037,-4322769,624
2022-01-20 22:59:16-05:00,4348,BZxJ6CtrVoiU86DMMieMeDFLNWtMpHGTvZfM7nyay6o4,6CRxRR8bisRLHFJBFWjyumYuy7j4C4PkjYH1K8gXhdWD,True,1969645,492411,3080,1540,1540,4BnQKPLuE3DMTtxp8MjUBytgnhvxqq3ZTqZHTVZo4JJh,123212,706465,-583253,625
2022-01-20 22:59:35-05:00,4349,9E97vZ6evPgg1Ao8KwvjjZhBFW6dXZrrJENk1HvZ3SU,D7U38PB8BXLwUVKbRNv9po7VcFdnn7Y4tWY9xpRiNJsT,True,26639831,6659957,41454,20727,20727,HfEnetJ7uBSmZWCjBNxdvv9HEC5nsW4wDV7wu6WnhWan,1658163,8527491,-6869328,622
2022-01-20 23:01:47-05:00,4350,FfpzVu4rcnwxNbx9EoNpZ4LmCYTjhYTkhwrUGCpnSJvh,5rRoUEuDVtaXQBH9xvq4vUvPWJDytFoEByNrcWfiq1E8,True,158260,39563,246,123,123,3zqXX6kzhkbW3d4TwD2CNjMRwxTbREXySekvq37kfCNk,9866,46997,-37131,623
2022-01-21 01:47:25-05:00,4351,Gs3WP18hbzNpbBgiU39e6tfkggfCKRyNqPqJQcthuHFD,4XAY25YUma6gUdG2GdbXeivum3t21g93ZagfWGTZYkWZ,True,5084037,1271008,7940,3970,3970,3zqXX6kzhkbW3d4TwD2CNjMRwxTbREXySekvq37kfCNk,317611,2830360,-2512749,624
2022-01-21 02:03:00-05:00,4352,DkKumyFA6dGw77wcwd16nWzTEC9McvmasAbmGfQXLkB7,9u6QyrruYFjhyLV5AXYUKkrBggzrxXfNH57smUAap5Ro,True,23070583,5767645,35924,17962,17962,HfEnetJ7uBSmZWCjBNxdvv9HEC5nsW4wDV7wu6WnhWan,1436975,8621237,-7184262,622
2022-01-21 02:03:00-05:00,4353,HmspGdpobjC5Vbmo3FcKdw4RLPN7wJKxv3uKqDjVhLee,3YEX8TzdyJyuHo76Kw76imVCJjzrC9m188YuRKvwwSwD,True,163915218,40978804,256279,128139,128140,4BnQKPLuE3DMTtxp8MjUBytgnhvxqq3ZTqZHTVZo4JJh,10251172,44036042,-33784870,625
2022-01-21 02:03:02-05:00,4354,C33hfnDHzVwKXxr6AwFAXhd1vJYrPKhtqc75Qpjm19Zt,2WYBMSyrHQEYZqxEtxBMe2xn7eioJEGsudqdCmGvssGh,True,25214377,6303594,39264,19632,19632,3zqXX6kzhkbW3d4TwD2CNjMRwxTbREXySekvq37kfCNk,1570562,6411857,-4841295,622
2022-01-21 02:04:02-05:00,4355,GKCeRcHQYMhcTwEm5wu1SbkXAT19gjGUGji43HS36B5N,EYQKX5sWsmXoge5xbTcMYAjvRbSUTXXpHEzckPY2LV8W,True,944103,236025,1476,738,738,HfEnetJ7uBSmZWCjBNxdvv9HEC5nsW4wDV7wu6WnhWan,59062,301365,-242303,625
2022-01-21 02:04:09-05:00,4356,HdRgh9niYSd3YKCxzGdusYFquiVoFTP2mEGEzJJL5Nii,78C68Gbb1jYFQmYNCHHjL52keEKMXtGukmBwT7ahon4B,True,7826975822,1956743955,12212357,6106178,6106179,HfEnetJ7uBSmZWCjBNxdvv9HEC5nsW4wDV7wu6WnhWan,488494290,3411620377,-2923126087,624
2022-01-21 06:20:05-05:00,4357,E1CShgy7M9998q9jyzpnHZxHJR6z5hvnshUJt37kVPtG,96f1nYW4S9APCJS3TXTGSb9UcJDdxJuoBR3pLYqcNz2b,True,65482958,16370739,102227,51113,51114,HfEnetJ7uBSmZWCjBNxdvv9HEC5nsW4wDV7wu6WnhWan,4089095,33518931,-29429836,624
2022-01-21 06:20:05-05:00,4358,2FEbsetZMkRqLjSC8GBbgecKgX5T1T1fci2sLQux29p8,H722Fcd6DkTFRZxqQWbPDufBfXEgmFfhiEpQZWhxwYv1,True,1789925,447481,2779,1389,1390,3zqXX6kzhkbW3d4TwD2CNjMRwxTbREXySekvq37kfCNk,111161,854930,-743769,621
2022-01-21 06:20:05-05:00,4359,6BQVtmNsxihi4PcA7MurtguTwa6SmbmKyP14RHyjVZkf,7ZFv5ms4HzVKiw7KgE8RUoKxW9rB6JUD7ujZxMx4DwnM,True,1228188,307047,1912,956,956,4BnQKPLuE3DMTtxp8MjUBytgnhvxqq3ZTqZHTVZo4JJh,76480,535623,-459143,622
2022-01-21 06:20:05-05:00,4360,U3vvMQ4X4aKzVYfhMw1V1p58HRqaLnuXozqmmefYeD9,7JA94MArkNCFRhBq8f5a32DgMF6aPdFsoC5HvXDQ6NuR,True,116359060,29089765,181433,90716,90717,3zqXX6kzhkbW3d4TwD2CNjMRwxTbREXySekvq37kfCNk,7257329,71983492,-64726163,623
2022-01-21 06:20:06-05:00,4361,8nXbrdjjaHB73CRPRenGEQj73wbtEFGDwXsehRGMhsap,43pvdcJ6f27wz94D6ZboKwRJYbyvYCrjsJhYsvk7LJCM,True,23892642,5973160,37384,18692,18692,HfEnetJ7uBSmZWCjBNxdvv9HEC5nsW4wDV7wu6WnhWan,1495376,6127518,-4632142,625
2022-01-21 06:20:06-05:00,4362,9Hz4p7gcfDbXBJp8KzhaBBPh9i7xe9kun7zLfDtqPe6c,2bJ43Lep6kp6WY7Ct56oiscKnAbdtC265G5yRvRPFThU,True,351907455,87976863,548095,274047,274048,4BnQKPLuE3DMTtxp8MjUBytgnhvxqq3ZTqZHTVZo4JJh,21923826,94213174,-72289348,622
2022-01-21 06:20:06-05:00,4363,ymyzGH4Qc7HH5PbKpVphCbsQgLLXyGkPcXamQJuNj5C,8oTLHaV2XzbKXNWRuUjCfHjUn61Pw93LYK14m9q2VDpZ,True,5095668,1273917,7958,3979,3979,3zqXX6kzhkbW3d4TwD2CNjMRwxTbREXySekvq37kfCNk,318339,2401836,-2083497,624
2022-01-21 06:20:19-05:00,4364,BYvjENe16Ta77PqGV7JKEWrsqCTfkMGYwTSG5gXneDvd,EvxAXgvhPC6QkNurbK7vWyTApGo8J2R4EgMAknkHVU3d,True,1144536,286134,1772,886,886,4BnQKPLuE3DMTtxp8MjUBytgnhvxqq3ZTqZHTVZo4JJh,70888,826750,-755862,619
2022-01-21 06:20:20-05:00,4365,6rb3fRVWJ5cSzFcmuC1YwdrNxiNctvboDF7HwsfyGoCA,H6JaYfFZkRk6iSJrA4nVeuFpMVQtVwQZHVgK1TyaupTE,True,16069,4017,24,12,12,DddJ7EWCmYEEZETCBNgAUSg81Ls6fZtiAaY5ekJ5sXx1,995,14343,-13348,619
2022-01-21 06:20:20-05:00,4366,FF8rqfM9PTEjYiVFy8jS81weDRwdaYooux2uSa2LexrJ,JBk1JghH1gged1YpDbkczFXP9ka5ivYSkaYoVbbXD4kg,True,69448331,17362082,107342,53671,53671,72FwbpFGoLEazJEdpqNtPNefsadUrimUqma9wSoy4qiS,4293703,40303848,-36010145,618
2022-01-21 06:20:20-05:00,4367,B4Uc39nKzz9wBRQsCkMR4A7RwTJ8rSuwpR6EQn2AesRb,H49bGZgatRZVpj6QufZRVgYrQtH7LpdbiqKBs23151m,True,9580256,2395064,14810,7405,7405,DddJ7EWCmYEEZETCBNgAUSg81Ls6fZtiAaY5ekJ5sXx1,592403,9721990,-9129587,618
2022-01-21 06:20:20-05:00,4368,Cs2YxkuqBK1kjoYZbUZdUcxapPbv8oC75trwGgWoCPfG,2PgHQM1GhHykE4bQ1ggueAw2Zs1BFUW5hxvMvr8DojKM,True,21041999,5260499,32772,16386,16386,HfEnetJ7uBSmZWCjBNxdvv9HEC5nsW4wDV7wu6WnhWan,1310895,14054062,-12743167,622
2022-01-21 06:20:20-05:00,4369,6Bq55LtGCEeGqh4JrFLCmmGc2iJfTTBJixivqH78aGSE,DSNrCgWJeNe2P9tAQu5FvCueTzNKDKds7wzuwTQSMRG,True,2543206,635801,3945,1972,1973,3zqXX6kzhkbW3d4TwD2CNjMRwxTbREXySekvq37kfCNk,157814,1197004,-1039190,620
2022-01-21 06:20:20-05:00,4370,54grbLQHZsNK4qTyXb8kXAU12Af9QUNFMujuzLLHHHef,3Ua1LDmZfPxvpaCp45RJ5xn3ovNuMxyWGrxnLcsK2ko3,True,592369942,148092485,922761,461380,461381,3zqXX6kzhkbW3d4TwD2CNjMRwxTbREXySekvq37kfCNk,36910478,288304939,-251394461,623
2022-01-21 06:20:20-05:00,4371,DMgD2KCEhTGFLUZ5GnfNcwfiiwKYbyVpoWiN6knMkCAf,5KU2vgBkPTNVHsSULjgX7ZkZS56U3Dy3xqLTxL5sUZJ3,True,527981659,131995414,817368,408684,408684,3zqXX6kzhkbW3d4TwD2CNjMRwxTbREXySekvq37kfCNk,32694755,373634674,-340939919,619
2022-01-21 06:20:20-05:00,4372,BJV5jbowrbELXfDvfMovaQy4PiRf12pLYHimW9bgzW5X,6WXrWso5FvLx7RMCFBzrbzh5qevKkk2LJAihUfWXxXzB,True,8013252,2003313,12384,6192,6192,DddJ7EWCmYEEZETCBNgAUSg81Ls6fZtiAaY5ekJ5sXx1,495360,7456980,-6961620,618
2022-01-21 06:20:20-05:00,4373,96StvqZyFUPtyMr4o9s7K4V29RSNyRpVi76vNwxG5rUf,GZKXFSFq4aGiTaqovtxqNCCVGkAFNXPh4Hep1ZMwdZ8g,True,8548759,2137189,13241,6620,6621,3zqXX6kzhkbW3d4TwD2CNjMRwxTbREXySekvq37kfCNk,529642,8387956,-7858314,619
2022-01-21 06:20:20-05:00,4374,BPsM1um9ZJf7eNoVMsQCRSwgARMuLCGGSDxf9tZeNeEy,BpzDdXfxVygiSYSmsHV6uPxQMeTFtrURMCCqhswQjd5X,True,446322,111580,689,344,345,3zqXX6kzhkbW3d4TwD2CNjMRwxTbREXySekvq37kfCNk,27579,214724,-187145,617
2022-01-21 06:20:20-05:00,4375,FV9CBGGTbppLnBKh79f2LzD1diTiS5g6u89FcpZHZmnK,Fe7mtmCUziFqbbYTvrhAcAq1Ub7YLfTJRtQ1hG7GzJD1,True,2014285,503571,3117,1558,1559,3zqXX6kzhkbW3d4TwD2CNjMRwxTbREXySekvq37kfCNk,124687,962128,-837441,619
2022-01-21 06:20:20-05:00,4376,3WcJUt8jQ1ngL3ZCGo6dFrc3GmTMTYtzeDva7mri2Tqx,HeG1Pz2oMjqtkfsRMsbqP3VpatnVEQzcWmKDVoFp4Htr,True,6010380,1502595,9339,4669,4670,HfEnetJ7uBSmZWCjBNxdvv9HEC5nsW4wDV7wu6WnhWan,373574,3271392,-2897818,621
2022-01-21 06:20:20-05:00,4377,CwTus4FyoXYqyTKAYDp69NLhA1joYZ3tarzY6FFTr6fn,6ivuvYWU6i25MzJSY8rG9rPDKiq38E6QtrV1jvRubLGr,True,3877,969,6,3,3,3zqXX6kzhkbW3d4TwD2CNjMRwxTbREXySekvq37kfCNk,240,2061,-1821,619
2022-01-21 06:20:26-05:00,4378,9ebpuMtXee3DSx4qWiEYEtTT1gK5FqCY2H5yQVWWtTts,9b71dTsTYD1bx6KsjFs5h6d3Jj4T9eX3nqmS7RQj3HS5,True,111995468,27998867,173191,86595,86596,DddJ7EWCmYEEZETCBNgAUSg81Ls6fZtiAaY5ekJ5sXx1,6927654,57205584,-50277930,618
2022-01-21 06:20:32-05:00,4379,2iG781tfP9H77hcFimqp5X9KB9QsbVkQVS9q7emJAJXX,5XDdJMfPSs8WwZZgEtv22RQXEbg748ia4gGfZCy1n4jy,True,4460278,1115069,6968,3484,3484,DddJ7EWCmYEEZETCBNgAUSg81Ls6fZtiAaY5ekJ5sXx1,278745,1065017,-786272,624
2022-01-21 06:20:32-05:00,4380,3REbHhGGpn5b2GH67yQy2Dn7ZLNGLfM6hkBNU8UE1BRm,FBeCamJw884cPNpzbzhjSF7CFXyyhjnj3qWWCdBCK1NP,True,1773024,443256,2772,1386,1386,3zqXX6kzhkbW3d4TwD2CNjMRwxTbREXySekvq37kfCNk,110916,489457,-378541,625
2022-01-21 06:20:32-05:00,4381,DH6W3oB22rPJj7PPrey3Rgtn8Tz8kFKQjftajzUFBeKK,5gNsQSAUq8yFVt3FtU854NfuvFQaaCDC6oAqKA6hoZ3F,True,15265892,3816473,23867,11933,11934,DddJ7EWCmYEEZETCBNgAUSg81Ls6fZtiAaY5ekJ5sXx1,954708,7061662,-6106954,625
2022-01-21 06:20:32-05:00,4382,CP2qcTSw1Y5J7jZiEgbtsvJoigRbJ4m9oHGQS8Fiai2x,7Zd1uX1thbuGkp9H4r1t8aLTu9W8MxvUBNjji2FNJa8E,True,15009813,3752453,23296,11648,11648,3zqXX6kzhkbW3d4TwD2CNjMRwxTbREXySekvq37kfCNk,931862,7751904,-6820042,620
2022-01-21 06:20:32-05:00,4383,Cb4zhnvig11U4GcC4kqKrnDicGgPhUpfDQB1U7hP3nPa,DiRAMrKqaevGXeXg38KnhaYBERj8tNKU7oWFJvhS32kw,True,60245,15061,94,47,47,DddJ7EWCmYEEZETCBNgAUSg81Ls6fZtiAaY5ekJ5sXx1,3764,27993,-24229,624
2022-01-21 06:20:32-05:00,4384,8W9NJfM6cqCsvR1FC8Ab8YZPSQF7bz7inxJZxWnF7GsX,3exfPuVcTnPxs8GwCtS3ruKUGveYymwGV7RXQssPiizJ,True,117572330,29393082,183668,91834,91834,3zqXX6kzhkbW3d4TwD2CNjMRwxTbREXySekvq37kfCNk,7346731,108707497,-101360766,624
2022-01-21 06:20:33-05:00,4385,2PzBAkdXkrwH9VuoMALumQz86qkW7sSBQtCrHw14JUp3,D5vwWAMHVooobG2sCWv9EwtJrAFZG6cwKH4dfmA98tbt,True,776862,194215,1213,606,607,DddJ7EWCmYEEZETCBNgAUSg81Ls6fZtiAaY5ekJ5sXx1,48531,411908,-363377,624
2022-01-21 06:20:33-05:00,4386,7vKmhLV45Q5etXhJL5ng8rxWhYSiUCDmAbGnwBPr7zcx,cP6xPeuHLnjr858QK1F9qYn7rJpEbPy7wEJHoju6oV7,True,12927588,3231897,20186,10093,10093,4BnQKPLuE3DMTtxp8MjUBytgnhvxqq3ZTqZHTVZo4JJh,807460,6793200,-5985740,624
2022-01-21 06:20:33-05:00,4387,89CkXnSZnr52Zsoh48efv9MQacrkB6GMtrbEpNJSyA2H,HcvRBS4Z22CpYgDNgm4TVF4AVXFDuYzBUAFcdHAwdpg4,True,895883,223970,1397,698,699,4BnQKPLuE3DMTtxp8MjUBytgnhvxqq3ZTqZHTVZo4JJh,55897,465122,-409225,623
2022-01-21 06:20:34-05:00,4388,AA6QgBaH9F8QfPT9xjztv9uELcADPxwUuXofkBV8dYg4,FCMXozSstTNA74FVCJ5hpYvNJamjutnoakHoBVnzwcWj,True,7944,1986,12,6,6,DddJ7EWCmYEEZETCBNgAUSg81Ls6fZtiAaY5ekJ5sXx1,494,4451,-3957,621
2022-01-21 06:20:34-05:00,4389,Ar5QB4VBcUyzSCG23z2QNAbrWY55NbHCr1MNN6P2GAmh,BusFGTiDrJmxzwGUxWz9b3SFF3eseqtgh2DRHqyAwyVe,True,138240,34560,215,107,108,4BnQKPLuE3DMTtxp8MjUBytgnhvxqq3ZTqZHTVZo4JJh,8621,75111,-66490,623
2022-01-21 06:20:38-05:00,4390,EhANPABkSw9x9WnsDEi8pCg67iQTX2UGTTUpyjADTwdN,4FKLi98hyg9ZjM4MY6ctJsv7B6vPUnTYWdhrnNoYsztX,True,2996341,749085,4683,2341,2342,3zqXX6kzhkbW3d4TwD2CNjMRwxTbREXySekvq37kfCNk,187354,1915203,-1727849,625
2022-01-21 06:20:39-05:00,4391,i7TcF4weYcqgrRdH3GpndbEYxCxfcSfr9JWYrAUg1CF,BkDfknUir7PnSEW8auoB87PytycEFwyX5kT2GY4SGJJL,True,1579177,394794,2469,1234,1235,3zqXX6kzhkbW3d4TwD2CNjMRwxTbREXySekvq37kfCNk,98790,1488994,-1390204,625
2022-01-21 06:20:48-05:00,4392,7D4rFmGMPKNAF75VRPxHAhSn2wTjiW8jmth1UD22Xqq9,GQ7BrT6vsXu8tHCMm75YdxFR2r9QTCrCUbdPEZBSAg9w,True,14314554,3578638,22365,11182,11183,3zqXX6kzhkbW3d4TwD2CNjMRwxTbREXySekvq37kfCNk,894604,6515279,-5620675,624
2022-01-21 06:20:48-05:00,4393,5Z3ZFCA65WoWhm3okRuuziEMi7ajGAEHWUFchzBNba5S,FcomdrWidygkxMKzcsY5xELbmwC652uMci648LMTv7AB,True,3713,928,5,2,3,DddJ7EWCmYEEZETCBNgAUSg81Ls6fZtiAaY5ekJ5sXx1,230,1916,-1686,619
2022-01-21 06:20:49-05:00,4394,FX5sizQGZcDCaETDyJ3HbLxFwhu4t9bX6YyQM7cVEo9Z,6EqnCsv1JPjz6JX1yLNcf74rmkuhAUx6Sf35QMYGuuF6,True,65406541,16351635,101317,50658,50659,HfEnetJ7uBSmZWCjBNxdvv9HEC5nsW4wDV7wu6WnhWan,4052717,33748797,-29696080,619
2022-01-21 06:20:49-05:00,4395,EYt1Pzqfwnd4iXSmcpw4T3Edmm1y3GnRhCjcQEEK4Atj,EHqporfvvfg7UQPsjv5tsgZE8u9yyRuEU2DdLpQeXy85,True,30207335886,7551833971,46745675,23372837,23372838,HfEnetJ7uBSmZWCjBNxdvv9HEC5nsW4wDV7wu6WnhWan,1869827038,6461323824,-4591496786,618
2022-01-21 06:20:50-05:00,4396,X5SF9srgzDgBRBhv8xUWyszYYSQiqFF6cVnVLWzQgp1,7rTqnMkPuUUJFt5px1DxwsUK8U5fQUtnx9N4v6dA4vGb,True,9869,2467,15,7,8,HfEnetJ7uBSmZWCjBNxdvv9HEC5nsW4wDV7wu6WnhWan,608,5225,-4617,616
2022-01-21 06:20:50-05:00,4397,CK3ocyWzXQkJJZQmM6bBK4Nv6Rh3UEufjY6DvNU6gJZy,C924o4GY3p2BHLeAbFbe9SEysXqCUyD8sFu2d4NzkAV7,True,1944212,486053,2997,1498,1499,3zqXX6kzhkbW3d4TwD2CNjMRwxTbREXySekvq37kfCNk,119898,920557,-800659,616
2022-01-21 06:20:51-05:00,4398,GaEpNGa8jnwSRvjzzEMYkZe1pKcr2eiZtePrqFxpABjB,5CFZHuyWbJv14zPdX5dSQDREgHrCb4vsFvB6hLiEe3Ji,True,45466,11366,69,34,35,3zqXX6kzhkbW3d4TwD2CNjMRwxTbREXySekvq37kfCNk,2798,23857,-21059,615
2022-01-21 06:20:51-05:00,4399,GhV3DChNShu8mGwUUy7VLidabCV6Y2aKdp7cqPynd6Ci,8R8QkgruGRCeE1pjXmn3WjdVDiawNbXFid8gU8BfabZA,True,5319,1329,8,4,4,DddJ7EWCmYEEZETCBNgAUSg81Ls6fZtiAaY5ekJ5sXx1,329,2715,-2386,618
2022-01-21 06:20:51-05:00,4400,2BH44k4TYoQSqsSs5EASqJhxpH17Fr8Ahxbg2MAkWa72,HwvvVWpqfN7NDsVYdxbCSbqxSrLCThwnJiZQHh2w2zJb,True,5354,1338,8,4,4,DddJ7EWCmYEEZETCBNgAUSg81Ls6fZtiAaY5ekJ5sXx1,330,2744,-2414,616
2022-01-21 06:20:53-05:00,4401,3y34hmyz6rsVnpp7d6a9s2Xw9GdezLU1H44HfieG6SGG,9DCz2eyYsrk1Hd5zsSVBhKTV9QD6beym5zB5fH3aA4hE,True,308239595,77059898,476654,238327,238327,3zqXX6kzhkbW3d4TwD2CNjMRwxTbREXySekvq37kfCNk,19066181,274998513,-255932332,618
2022-01-21 06:20:55-05:00,4402,2NHv3c4ufYGo3xNr6KXymAZJdpfURrNiCKbXZ7s82Vwo,E4NYpYgHTvSG6LqH2bBV9Q1XJ6pAzCp9FLSKMzJmYRrQ,True,7718213,1929553,11957,5978,5979,DddJ7EWCmYEEZETCBNgAUSg81Ls6fZtiAaY5ekJ5sXx1,478305,5028122,-4549817,619
2022-01-21 06:20:55-05:00,4403,2rCRdyfi65rpxRRmg7knaSb8t55FuPt3h8wF4Fzhy8MM,CLVY5nSG3jTdRo7tRSKgK9DJgW6aswfWKe4tLxzsENmb,True,188040,47010,290,145,145,3zqXX6kzhkbW3d4TwD2CNjMRwxTbREXySekvq37kfCNk,11605,88806,-77201,617
2022-01-21 06:20:55-05:00,4404,EHJXCJ4ZxPY7F1CeDQkXxVCLyTBXAY2ouWMJfKic9EcK,3yxXBa3sJhUhK9auop8niypnuWiasge5waVTM1zzuhU7,True,329610488,82402622,513596,256798,256798,3zqXX6kzhkbW3d4TwD2CNjMRwxTbREXySekvq37kfCNk,20543873,96189123,-75645250,623
2022-01-21 06:20:55-05:00,4405,E1wp3bmkcY3eiEYyGYwhTCsr7BZ7RfPa5DJTZFupcFwj,452hVdYkD5SDDrA6hv6DLPFvyS8PvR2P6DPNScGxWTsW,True,240506,60126,369,184,185,DddJ7EWCmYEEZETCBNgAUSg81Ls6fZtiAaY5ekJ5sXx1,14793,130615,-115822,615
2022-01-21 06:20:55-05:00,4406,9rfebymEFqy2SoBoDKKUppZVRPr1zNh6gkFYkmVsqbqz,6pQ3MsewzM8jzKEQG5zJDry8iEMUjGA1UDJPEQjFWTgR,True,2468629,617157,3833,1916,1917,4BnQKPLuE3DMTtxp8MjUBytgnhvxqq3ZTqZHTVZo4JJh,153353,680039,-526686,621
2022-01-21 06:20:55-05:00,4407,DrzTARa7RK8RXoxHZPKCBqYtMC8TAUHRw8SznXRKTa5M,FYANet92VhyXkKZqqBJR4sFxuCftWb68sgQU9VHCdTJk,True,9851,2462,15,7,8,72FwbpFGoLEazJEdpqNtPNefsadUrimUqma9wSoy4qiS,607,5017,-4410,616
2022-01-21 06:20:55-05:00,4408,75ycx5sUFBxDhY1uwuPCW22s2C6BydkJTje7q7zEQFGT,FpEgrVFRubjGK4DRjTqdVbxSECURpn16zfpoC31NbwnN,True,1902260,475565,2957,1478,1479,3zqXX6kzhkbW3d4TwD2CNjMRwxTbREXySekvq37kfCNk,118289,1219120,-1100831,621
2022-01-21 06:20:55-05:00,4409,F1JT1p2VuwK4L7zj7NNnZtYiZiNUCcTGKDkgdoX3BZdZ,3BKe4yzTwnnBnvTWP3britpPJ4oAWL7JZJzNLCxjUufS,True,1937,484,2,1,1,3zqXX6kzhkbW3d4TwD2CNjMRwxTbREXySekvq37kfCNk,118,649,-531,609
2022-01-21 06:20:55-05:00,4410,6h43GsVT3TjtLa5nRpsXp15GDpAY4smWCYHgcq58dSPM,CTgbWridYWnfE5Emwr7qiCEb3LcXHupqeB9zwmddoEqB,True,47292268,11823067,71863,35931,35932,3zqXX6kzhkbW3d4TwD2CNjMRwxTbREXySekvq37kfCNk,2874526,42281780,-39407254,607
2022-01-21 06:20:56-05:00,4411,HutRztBianNUgm9sJDWKUQBmoVyy8y7CfnNk4hHjSkEW,EtVfvPyiy5bizbCZxR19TNUgETf3QcmziBvMtc6o5zjr,True,73504866,18376216,112641,56320,56321,3zqXX6kzhkbW3d4TwD2CNjMRwxTbREXySekvq37kfCNk,4505659,72030169,-67524510,612
2022-01-21 06:20:56-05:00,4412,9ydHRjDWvWV2XqbXKKpeLDh2RV7WnQZWDTi4ahgDjGNh,AiJQBv4a1Z4w2rsRog5WTaKb4dTjAXfAvXcWoW4DztSW,True,18661047,4665261,28599,14299,14300,3zqXX6kzhkbW3d4TwD2CNjMRwxTbREXySekvq37kfCNk,1143966,4982934,-3838968,613
2022-01-21 06:20:59-05:00,4413,AKxRtcdpi7gWhAuL8ENj7zhgeQezzEXe9TSANE6bQoRA,2YH4vrU9deP8Cu6E8Hzf8GqKG1yVjv5pdz4FE7r5YKir,True,2039644,509911,3111,1555,1556,3zqXX6kzhkbW3d4TwD2CNjMRwxTbREXySekvq37kfCNk,124470,1063729,-939259,610
2022-01-21 06:20:59-05:00,4414,6tWqNUhr9XZVB1sc33W8VEo7gbptDtnKzGVvMZ4Xh68n,8NdrSzU8Tc6Ng2o1RWKfXyZb7i8jm6waYTBomq24F8wZ,True,977949,244487,1493,746,747,3zqXX6kzhkbW3d4TwD2CNjMRwxTbREXySekvq37kfCNk,59731,230292,-170561,610
2022-01-21 06:20:59-05:00,4415,9TL17gjvWFdhSJkpXgfnX7fKF9c2hfw59k3g8WUqm8Cb,7TyxFBKG4z5Xv3js3n1gbEWWj1M9KBF7dEmFxjCPGidC,True,55111747,13777936,84068,42034,42034,3zqXX6kzhkbW3d4TwD2CNjMRwxTbREXySekvq37kfCNk,3362722,24158442,-20795720,610
2022-01-21 06:20:59-05:00,4416,9YEzjb49Awvedv9yNc6LG54SkGBug2RYiJwiUV13mGsS,3H8w5WCD187NWWoZMNUCzUDdxTgqrRJLga8gDzUVXBgZ,True,326991,81747,505,252,253,4BnQKPLuE3DMTtxp8MjUBytgnhvxqq3ZTqZHTVZo4JJh,20200,236588,-216388,617
2022-01-21 06:20:59-05:00,4417,4MmpDGUTyMcYEqJ1RoZ46AN2BhrBUseHaHqF8AmiTPyD,7HW2YZpYM349HMfW7u4h9ESZ1AXkwN8JcVDTNFzp9aTz,True,35795330,8948832,55331,27665,27666,4BnQKPLuE3DMTtxp8MjUBytgnhvxqq3ZTqZHTVZo4JJh,2213278,22824304,-20611026,618
2022-01-21 06:21:00-05:00,4418,8BMDSWFtzq9fu1ubVGtSFw8fEaMg1uvJiECuJnN8e1pd,FwkETAXL296CirvQ2AJuSHHtdKsxkZkmXSwZVVHXVDhA,True,38815364,9703841,60191,30095,30096,3zqXX6kzhkbW3d4TwD2CNjMRwxTbREXySekvq37kfCNk,2407660,19906861,-17499201,620
2022-01-21 06:21:00-05:00,4419,4j19AEcDwhtAZrnoDc4epNPmEL1jPpVUMeg7RmQ72Qkb,84WB42AAGbczVE9txZPwXrx4FD5jP87r8QdDzEABTm5G,True,19604961323,4901240330,30126295,15063147,15063148,DddJ7EWCmYEEZETCBNgAUSg81Ls6fZtiAaY5ekJ5sXx1,1205051813,13287784406,-12082732593,614
2022-01-21 06:21:00-05:00,4420,EV21gv8jEvXtmGDoGRNm5LJEvTBccLMZyVDCLsp54jP3,DGxxoU52aQNoUQcxdvQtv2H5q2PhK6TGkLgNSaFgnZrb,True,1329745,332436,2033,1016,1017,4BnQKPLuE3DMTtxp8MjUBytgnhvxqq3ZTqZHTVZo4JJh,81322,722916,-641594,611
2022-01-21 06:21:00-05:00,4421,BzSJ77zKaqtBk2cEL1XqFL97zTXXMRHmxtkgtXwCc3C,2g4KXTwy2MPSRQ2khNp1o1rn7CradEr9H4ySYKDoSWN9,True,3011004,752751,4626,2313,2313,3zqXX6kzhkbW3d4TwD2CNjMRwxTbREXySekvq37kfCNk,185071,3309926,-3124855,614
2022-01-21 06:21:00-05:00,4422,96DzqyUxsB1FKWrhLdTdjDcokuus6rbx83gLsghqPPwt,74CWb7SVoSy3ADysEzFEeMiS2fxHJ9gdUF9pzM3E52Gj,True,5771,1442,8,4,4,4BnQKPLuE3DMTtxp8MjUBytgnhvxqq3ZTqZHTVZo4JJh,353,2987,-2634,611
2022-01-21 06:21:03-05:00,4423,D3mXrJzhHf8qRaoCKLschUxAFoijFCFuT6bmNZH4W7Cj,9E3Xtqw7TncXWnbhAbFJMtuNmP6WS3ooGuptzyzw7UpA,True,17238,4309,26,13,13,3zqXX6kzhkbW3d4TwD2CNjMRwxTbREXySekvq37kfCNk,1043,11713,-10670,605
2022-01-21 06:21:03-05:00,4424,EeUACm9TkjHKES5U7Yj1oPhYmcp7R3tvesGBiP8txEzq,3qkmm4aS6EDirEDejmbm5PDw2jpYkC7zKqrMkmgeE5BA,True,68868,17217,105,52,53,3zqXX6kzhkbW3d4TwD2CNjMRwxTbREXySekvq37kfCNk,4220,31686,-27466,612
2022-01-21 06:21:03-05:00,4425,GABCjRvhnVZwwR9aZLhkTfaH9xdp2hJK7J6h4kD5VzkC,JabV7oy3dp6jshtccn89ybinAuaf9dHVmKuiEjXDPT9,True,17249148,4312287,26199,13099,13100,3zqXX6kzhkbW3d4TwD2CNjMRwxTbREXySekvq37kfCNk,1047991,9243779,-8195788,607
2022-01-21 06:21:03-05:00,4426,7nByfyoLmMrzzVHsjxL2FRF72tfW3KiRT27BRGUp4PhP,36SF6NBnUc5wK41yfGCnujpCaCwExR3iRXJQx1WNakyM,True,11860576,2965144,18357,9178,9179,3zqXX6kzhkbW3d4TwD2CNjMRwxTbREXySekvq37kfCNk,734298,3161228,-2426930,619
2022-01-21 06:21:05-05:00,4427,6XHt7CrURSomkQrtVXV5JuKSZY4tQRpUyQKfCDaSTYaD,GCgcmPSDDBsn2smYbpiX3PJybDkQWtufPu4YRsbEEU8X,True,100575293,25143823,155397,77698,77699,DddJ7EWCmYEEZETCBNgAUSg81Ls6fZtiAaY5ekJ5sXx1,6215886,74085425,-67869539,618
2022-01-21 06:21:05-05:00,4428,6WNPf4rFCX74PuyvdmzRFqbxWhguuxTQqBSdnaTVBd5D,9N7a9aiHGQsxFMgVbmWoCF9w95d12xyT7XFAwpHGkTLA,True,448911,112227,695,347,348,DddJ7EWCmYEEZETCBNgAUSg81Ls6fZtiAaY5ekJ5sXx1,27832,169591,-141759,619
2022-01-21 06:21:06-05:00,4429,44iCXTAbcJMVscvvJQfTuVqj88V9QDgwXJDmVk7YcFBS,Dz3doggGiqe6rpazVjeA2j3XpRFmqesx7CRKsPAGKEVf,True,16897,4224,26,13,13,DddJ7EWCmYEEZETCBNgAUSg81Ls6fZtiAaY5ekJ5sXx1,1048,8794,-7746,620
2022-01-21 06:21:06-05:00,4430,99NHcwD1iaf5FXM3UNb91SjNiiT3HwyQFQMhkGd5ASts,8syAydy52vSQQLzsLXW24BFw4VPeK66Vp3BmAbnHfgod,True,14754745,3688686,23028,11514,11514,4BnQKPLuE3DMTtxp8MjUBytgnhvxqq3ZTqZHTVZo4JJh,921157,8093610,-7172453,624
2022-01-21 06:21:06-05:00,4431,Mcbzp1LhZwpfmXTv1pqe9D1jCKHw443j9QKp6tUpzgM,8uforSMAKEih5jHfHp3gCqCvaugtCmhzVfVHA63Akz7F,True,594814,148703,928,464,464,DddJ7EWCmYEEZETCBNgAUSg81Ls6fZtiAaY5ekJ5sXx1,37135,381853,-344718,624
2022-01-21 06:21:07-05:00,4432,KoCscQ9Q8TZHhmya5KaXBrwUEMTdCkEMRtrhvtgEmiZ,6aZ5AFMFoqf1X64RwAt1J4Yrx4WGGe2JMiEjqnQ2gEtk,True,140547,35136,215,107,108,3zqXX6kzhkbW3d4TwD2CNjMRwxTbREXySekvq37kfCNk,8637,46072,-37435,614
2022-01-21 06:21:07-05:00,4433,9jdfc9GFTecsdRuTjWFGX13niKKmeBxRgtv5j86uhSnU,HLWMShobjSkaLyXrNjgwVaUGVtbtdUSnr1XjqpXn1bLR,True,87297,21824,133,66,67,HfEnetJ7uBSmZWCjBNxdvv9HEC5nsW4wDV7wu6WnhWan,5333,49995,-44662,610
2022-01-21 06:21:07-05:00,4434,CAkknoa9UFPMEZ1KWSfqtmnL7ArVNV3HRETLwecuuXP,4cHJYv3dxA6qjcuxUkGRuL7STWobGPKtoHFD4ACUbiWq,True,3121546,780386,4837,2418,2419,DddJ7EWCmYEEZETCBNgAUSg81Ls6fZtiAaY5ekJ5sXx1,193487,1611778,-1418291,619
2022-01-21 06:21:07-05:00,4435,C3k34T2x8fW171coEG9YvoUePvxtHmrQMjVsX1Cb5ZbU,4mh5Tp4Jjh5X3GDERpSMAFgsfYJvysRdd1Nu5oJQ1Dhw,True,6800,1700,10,5,5,HfEnetJ7uBSmZWCjBNxdvv9HEC5nsW4wDV7wu6WnhWan,421,3466,-3045,619
2022-01-21 06:21:09-05:00,4436,2NdwSLxsGok8PczpCZj9CVX2BymNU5MvHt7hWfGetg2M,8AQbDXeA6mD9QoZBFJcYbnHvZwKNxzA9CCHLAgdSfTA3,True,3176,794,4,2,2,DddJ7EWCmYEEZETCBNgAUSg81Ls6fZtiAaY5ekJ5sXx1,198,2036,-1838,623
2022-01-21 06:21:12-05:00,4437,7LRBswSEDBjJzQ4YurfTxLydh7tFS2jVn5V95Z6wL7ci,fD41VYGmk66MW46KKb23vAqQvUSDScgXnVdsHhJBZzu,True,35128,8782,54,27,27,3zqXX6kzhkbW3d4TwD2CNjMRwxTbREXySekvq37kfCNk,2177,21176,-18999,619
2022-01-21 06:21:27-05:00,4438,AtKuDfcFXqWUMnRqQpjedUMTb5CQKLc2zoqEAcQpysKQ,9bPFLYp5TDZruLLDXDYYCiPYcD982iF8xt5rfTkqwNsL,True,3316,829,5,2,3,HfEnetJ7uBSmZWCjBNxdvv9HEC5nsW4wDV7wu6WnhWan,205,1693,-1488,618
2022-01-21 06:21:28-05:00,4439,6AHFxqjtpMsrCJ9E4ofrq4DVbaZSpDqyVMp6bznPqMg9,F3EauaowTvSs4NZ1EpUVonpNMmpMijcWHNi1AiKFZVxY,True,93937843,23484460,145545,72772,72773,3zqXX6kzhkbW3d4TwD2CNjMRwxTbREXySekvq37kfCNk,5821820,21244077,-15422257,619
2022-01-21 06:21:29-05:00,4440,8VT2nxz5ZYDJFd9uL2XZwEXxChd9pjuMJNMAcutZubL1,EhAkiRbouzUAWtqQFsN8HEEfi46UVN8H8tyBP7CbgeLe,True,2733,683,4,2,2,HfEnetJ7uBSmZWCjBNxdvv9HEC5nsW4wDV7wu6WnhWan,171,1605,-1434,625
2022-01-21 06:21:29-05:00,4441,Grw2snBvSDMa7ev2nWZo81WoLfyavmXXxCV1ugHGk5Xe,AF1WVCQcBmXCnWbDx2s62vU99zW1AdhNoqbWvdrbiQVm,True,4617403,1154350,7173,3586,3587,DddJ7EWCmYEEZETCBNgAUSg81Ls6fZtiAaY5ekJ5sXx1,286941,2313404,-2026463,621
2022-01-21 06:21:29-05:00,4442,BmDwvPUjxBakng8ARj7cfjgYJUYCJhLeVnRYXcLDMy4G,8YVEshruc7LMMPf7vrPK9x5eLQGwe7py6bhZoxb9yfkz,True,109504294,27376073,171020,85510,85510,3zqXX6kzhkbW3d4TwD2CNjMRwxTbREXySekvq37kfCNk,6840800,22736506,-15895706,624
2022-01-21 06:21:30-05:00,4443,C7a8BtMjuLXkzxZBC4Wk2gjkGBmucLmDjokf9pyA1Mu6,GxwYNWwYTtFMUxuZvNC5qrEYuJzYiEURQVuBxssfCJzr,True,456610,114152,713,356,357,4BnQKPLuE3DMTtxp8MjUBytgnhvxqq3ZTqZHTVZo4JJh,28534,172606,-144072,624
2022-01-21 06:21:31-05:00,4444,2RZPBo8Z2BgZmsASo14ySTSwqqgqmfVEjPkiAwQ1VTgf,BRS5cYtEoPRoSvTAiQaT1svWRdLJWVfy8LUb4SCudCjS,True,1458838,364709,2280,1140,1140,DddJ7EWCmYEEZETCBNgAUSg81Ls6fZtiAaY5ekJ5sXx1,91217,763804,-672587,625
2022-01-21 06:26:53-05:00,4445,FLQcLhAsRBKnLcSYkK94Za6NhGudrCGhGGxFTdDhVC6L,7vr92sRGp6DopaDv3wJr7gw4BFmxY74K8kFheKyxZdLX,True,142080,35519,222,111,111,HfEnetJ7uBSmZWCjBNxdvv9HEC5nsW4wDV7wu6WnhWan,8893,55415,-46522,625
2022-01-21 06:26:54-05:00,4446,A7HnmwpMzu9yYuvURa1Zct5JUoFujFybc6Ympjciuz99,E41s3xNbU4haxQQjR8nXZwTpJCoLiJ2BJSncHDfc6HzS,True,165511339,41377834,258724,129362,129362,HfEnetJ7uBSmZWCjBNxdvv9HEC5nsW4wDV7wu6WnhWan,10348965,69815360,-59466395,625
2022-01-21 06:27:11-05:00,4447,AVon82fTHT5KeqJkdoG4KkbGoVF3ocK4rqz52umUeEBy,LdgtwakPuhGZCh47WNERa6op7z2YtouJFv4mhFLtVgs,True,37932845,9483211,59330,29665,29665,4BnQKPLuE3DMTtxp8MjUBytgnhvxqq3ZTqZHTVZo4JJh,2373221,30433710,-28060489,625
2022-01-21 06:33:40-05:00,4448,4hrm69kAKNcfBkiP2YgtW94Pbip6FLfQAwnDRAAack69,BjbZRdGMoC7Mfoa4H19UvE2eQafgKD5rqnK7BSGwqS1s,True,10086,2521,15,7,8,HfEnetJ7uBSmZWCjBNxdvv9HEC5nsW4wDV7wu6WnhWan,623,5356,-4733,617
2022-01-21 06:33:40-05:00,4449,8DSiP9CwJm3AEcH6uuAYFpArRRDLYpDQgjHEvjkUgfg2,ERJ8kuhPRRmUAhSM4oxUheh39YUVVYNgaTt6AdMXcCvL,True,438479094,109619773,676382,338191,338191,HfEnetJ7uBSmZWCjBNxdvv9HEC5nsW4wDV7wu6WnhWan,27055301,101116206,-74060905,617
2022-01-21 06:33:40-05:00,4450,6BPPDj3BVgBPD3agd8b4B12d9Gvp4bFPXRWjzbtsmtRF,8VZnAwXPyKK2AHoMTZxKXthAiFMrL6b5EXAGqsAMTdhm,True,8647,2161,13,6,7,HfEnetJ7uBSmZWCjBNxdvv9HEC5nsW4wDV7wu6WnhWan,537,4446,-3909,621
2022-01-21 06:33:40-05:00,4451,3JzquEXUqphLYNmaVQLUTyrD6mJKXDcSSu9m39YCYvHf,Dk8mswH5HnCUmTEFvX4xHhUPk2m8VmgZW344BiNqg819,True,1414264557,353566139,2177669,1088834,1088835,3zqXX6kzhkbW3d4TwD2CNjMRwxTbREXySekvq37kfCNk,87106785,636904893,-549798108,615
2022-01-21 06:33:40-05:00,4452,3axqGcX5yuJ2vGxRjtNguefXUvSQHDQmn2zskhyCuQkf,EYrZo9zZDaHqFdc1fam63W3jvqqmbU67wzp6yFcppwsL,True,7995922,1998980,12234,6117,6117,DddJ7EWCmYEEZETCBNgAUSg81Ls6fZtiAaY5ekJ5sXx1,489392,7679455,-7190063,612
2022-01-21 06:33:40-05:00,4453,C4dbwF9mioaBkZnyBFvFs6Cqd362VuGPBGPbTY9CAnAk,CcUqBfu1hbWm5VVxbtF2Xm6HUz4CLFzuDsjUi6KtnZQg,True,487321,121830,750,375,375,3zqXX6kzhkbW3d4TwD2CNjMRwxTbREXySekvq37kfCNk,30035,183441,-153406,616
2022-01-21 06:33:42-05:00,4454,Buioe5v3DyFwD9nquW5XdYeVYbSABCyg79eUHEvtvfaW,7T9gi7prCcZJkYJMSB5Ef6Bu4pAuBw4XLvumSFnqKDSi,True,193842,48460,298,149,149,4BnQKPLuE3DMTtxp8MjUBytgnhvxqq3ZTqZHTVZo4JJh,11927,130560,-118633,615
2022-01-21 06:33:42-05:00,4455,7jvKp6onXyWgwsFrFWj4hYTXJsYYD6ot5mn6rPFuJriy,J7N6HiozevJVTiY9hDEUs2ud5BwT5QSE7wnMBS1w5ie2,True,16480445,4120111,25538,12769,12769,3zqXX6kzhkbW3d4TwD2CNjMRwxTbREXySekvq37kfCNk,1021558,9915126,-8893568,619
2022-01-21 06:33:42-05:00,4456,ZoNjrSjYh4NJLW38LUPcf7jtEBxdaaM7T1zp795qjHE,FZx6v8cU25NwEosbKJ2n141o9uFAWURZB7NeCeX1trEn,True,418534,104633,643,321,322,HfEnetJ7uBSmZWCjBNxdvv9HEC5nsW4wDV7wu6WnhWan,25747,157838,-132091,615
2022-01-21 06:33:43-05:00,4457,CEbGTNX6WpaoKp4RBGSn9LzYM6yAYyeiMrgVYgJxA4zb,AiXUcGAFFm4tc7vKBscSNjZawV5YJqbv7D1KpxD3Zufg,True,5430633,1357658,8376,4188,4188,HfEnetJ7uBSmZWCjBNxdvv9HEC5nsW4wDV7wu6WnhWan,335065,3650569,-3315504,616
2022-01-21 06:33:44-05:00,4458,GZZ8WePhKCrJLhXXvRD21rp79pFiaJeGykVsyeKAYe9W,6P1C9RDFQoFqZ5eFo59UwVnNrnyAWaNnACNQMqR3uJhs,True,423482111,105870527,651612,325806,325806,3zqXX6kzhkbW3d4TwD2CNjMRwxTbREXySekvq37kfCNk,26064492,92532381,-66467889,615
2022-01-21 06:33:45-05:00,4459,DiB9SeCFXjioNGPJM3GuZ3FCG9KBZhHK27zCSN5b6gkq,GtK8UtKDQy9jgtTXvam4jja9N7c4EFuDQr4TKHgNyhXT,True,1203547,300886,1850,925,925,DddJ7EWCmYEEZETCBNgAUSg81Ls6fZtiAaY5ekJ5sXx1,74007,686166,-612159,614
2022-01-21 06:33:45-05:00,4460,FjDp4bWCtqehFD7FunCrjrcdxMezTJj5aqh2VnBvHDQU,HRYeZqcqhP1RPiAGXziR1qCWwk4sF6c5ZYbvSDhX7foN,True,2196706,549176,3387,1693,1694,3zqXX6kzhkbW3d4TwD2CNjMRwxTbREXySekvq37kfCNk,135491,1106117,-970626,616
2022-01-21 06:33:45-05:00,4461,91tPxdvLhrVtytKuNkf33XocRnpEqA1x3jDb1Je6xeui,2ByoMpaZg1uzkA48vMufvcx8BLYxWLXUK3tXAJcupanF,True,8643,2160,13,6,7,3zqXX6kzhkbW3d4TwD2CNjMRwxTbREXySekvq37kfCNk,532,4447,-3915,615
2022-01-21 06:33:46-05:00,4462,8mbMH9EKd9kQDyFrYiDJCV9VaWxWCzpZBQZLyYN2yNVx,J9gT39dF1egMeQvweXYWeRAX3kpmBABijYZhfj6M2UqU,True,6679860,1669965,10241,5120,5121,3zqXX6kzhkbW3d4TwD2CNjMRwxTbREXySekvq37kfCNk,409647,3020435,-2610788,613
2022-01-21 06:33:46-05:00,4463,5hUZ9uQFcYnjAQVVaGLJWdKyg7y1XMpoo8osQ9DeY7Xd,BdYiKWsjuzJLcHh3814mJ4xQ9JxoQKKcr7AHZ7Vxoavq,True,12053,3013,18,9,9,DddJ7EWCmYEEZETCBNgAUSg81Ls6fZtiAaY5ekJ5sXx1,735,6502,-5767,609
2022-01-21 06:33:47-05:00,4464,5BjBPqumCb9KC82ZNNch3dcRzbpGdRLJneru7o9a1D9R,FuZtBWKktxFu4yoiLVMzxq8fMhQyN8SGzGPz49xs3m6P,True,40352318,10088079,63010,31505,31505,3zqXX6kzhkbW3d4TwD2CNjMRwxTbREXySekvq37kfCNk,2520430,24611376,-22090946,624
2022-01-21 06:33:47-05:00,4465,EgU9hX6VK7YXeCgCHVaJAMekCcyZa2MVWdKra5pN7Gwv,7y8Ad9XY34bqREvheXHT2tr8Jy11D6X3pu7yLVtjU4QV,True,2712801,678200,4224,2112,2112,DddJ7EWCmYEEZETCBNgAUSg81Ls6fZtiAaY5ekJ5sXx1,168996,1656381,-1487385,622
2022-01-21 06:33:47-05:00,4466,DiPSJvnnEwg1En7HJfEsKrUbBgtUf4KzGMyMCZDQSYgp,s8UVC6vPBofuXUS6RW1aQmZ8C35PrC5r4A6ugmvzLGB,True,532728,133182,829,414,415,3zqXX6kzhkbW3d4TwD2CNjMRwxTbREXySekvq37kfCNk,33171,201238,-168067,622
2022-01-21 06:33:49-05:00,4467,EuvK7bsc3hbxqeJjJkLELCvS7kruCMAGDctn5u7Q7BnP,Dv4XTdwnp6Sv5zxkSwRwsdSzxApDtBr4A13x4vvzTVjm,True,14265522,3566380,22123,11061,11062,3zqXX6kzhkbW3d4TwD2CNjMRwxTbREXySekvq37kfCNk,884941,7713187,-6828246,620
2022-01-21 06:33:49-05:00,4468,EEcTbsFTUEifcdbPyjBLkS943daEx1RpR8F3uZxKRZbT,8V3JzDQ1VWYQLas8fxUsWJZZHe4gEmn74RehtUwLw3k5,True,1465849,366462,2271,1135,1136,4BnQKPLuE3DMTtxp8MjUBytgnhvxqq3ZTqZHTVZo4JJh,90856,888705,-797849,619
2022-01-21 06:33:49-05:00,4469,2ce2v2TCbjNH635NgbwTG3sqiRWYrRRaBpxPxBZJ929q,9cnoebT43FkWDFhidndGCVNiFD4NErv8DuL1Va4Jv9S8,True,1647840,411960,2564,1282,1282,DddJ7EWCmYEEZETCBNgAUSg81Ls6fZtiAaY5ekJ5sXx1,102569,1491644,-1389075,622
2022-01-21 06:33:51-05:00,4470,7MSzV5yy5FmrM4j1BcYSRiTGWfit1AJahheRUaXzz349,aPSTZLxBpVr3sucjbj95emRV2J1GrUWr7wbARYqJkQZ,True,1219521,304880,1907,953,954,4BnQKPLuE3DMTtxp8MjUBytgnhvxqq3ZTqZHTVZo4JJh,76287,548431,-472144,625
2022-01-21 06:34:07-05:00,4471,4FazDUgfQ3AKoFcnWHr8E9Ht8jLA3tkxf75yrGZVHdmF,HzRMH6mbgEKydRCnnMvSsKgTEVNQi6nuzoR1xutYFdzg,True,16784,4196,26,13,13,3zqXX6kzhkbW3d4TwD2CNjMRwxTbREXySekvq37kfCNk,1048,14313,-13265,624
2022-01-21 06:34:07-05:00,4472,87R8o8xLjHw2GpunYkm7pX7uJ8hjM4B1y4Qm7aQf6Yh4,48aSVPQoFYdncF5NtJ114urbdTzVjTgYLgPzMfpJbZB3,True,17499456,4374864,27363,13681,13682,3zqXX6kzhkbW3d4TwD2CNjMRwxTbREXySekvq37kfCNk,1094547,18834771,-17740224,625
2022-01-21 06:34:09-05:00,4473,3zH1b58jqbNU37y9kDTZZrotSeT8XzS1tuyAHPKWrbah,4trxDWV16x6sVcz7bxHehYHkjjyKebh3S9fyJf8txzK5,True,2073,518,3,1,2,HfEnetJ7uBSmZWCjBNxdvv9HEC5nsW4wDV7wu6WnhWan,129,1069,-940,622
2022-01-21 06:34:09-05:00,4474,93ho4cgnpAJiJsG6uu2udkLVNU7rkz4QjCYfsqvpbPA5,45ouQn9gGwXqnTGfaP5CvU8fCKadBRA5kPwtfvJzykRU,True,17372894,4343223,27099,13549,13550,3zqXX6kzhkbW3d4TwD2CNjMRwxTbREXySekvq37kfCNk,1083977,8027523,-6943546,623
2022-01-21 06:34:12-05:00,4475,9gYrMXAGmGSV4VFjXzYP5WwH2aFpB1TxA6CqpYsosKLv,Dh8aH6RK48wu4fkT9xKw5XL7itxnPDuw3SDwPwvL5sva,True,7251,1812,11,5,6,3uL2NSR2ZdDqCiKfzA5SwwpddAnit22DBJo6uvvz1rRs,453,3788,-3335,624
2022-01-21 06:34:32-05:00,4476,E9FFPvygPSF22u7gqFq4w6yE5kV15zbeGDXFQc349RsG,yi1REPVUwKhr5ss5YJc56crYz8LVfkqNVMpKcdSfwfY,True,457344,114336,715,357,358,HfEnetJ7uBSmZWCjBNxdvv9HEC5nsW4wDV7wu6WnhWan,28627,171966,-143339,625
2022-01-21 06:35:01-05:00,4477,2kqN3TbCDgM4x8XfZvKgqJvDAHqvZxtT89NcfmQSQa5b,8fEx56PjuPAP61CBnrsnnnQnZmt8cw6KVjhYDK1mWJzP,True,156117836,39029459,244234,122117,122117,4BnQKPLuE3DMTtxp8MjUBytgnhvxqq3ZTqZHTVZo4JJh,9769379,42982124,-33212745,625
2022-01-21 06:35:11-05:00,4478,AQr9mVmcXCNQhBVCfx63MwR6c4WqDSC9K2BZqr7N8LCx,CB7TWUaL381ounsLw6neAUaKRxJL9P1HC9uGX5e1Uxod,True,157478812,39369703,246239,123119,123120,4BnQKPLuE3DMTtxp8MjUBytgnhvxqq3ZTqZHTVZo4JJh,9849589,124694905,-114845316,625
2022-01-21 06:35:16-05:00,4479,ioPHEVyheRnHYomVS7PmP6Coyhjk6LCs7hMD5Mq9Ngv,DYTpFmZ4yXVghKwkaovgCdpv3jfWkjtXRzxsZjKJfXNN,True,6577,1644,10,5,5,DddJ7EWCmYEEZETCBNgAUSg81Ls6fZtiAaY5ekJ5sXx1,411,3465,-3054,624
2022-01-21 06:35:41-05:00,4480,3g1debT8Z2efQPuMNSDPUNZzDqarBG2acErsZ4HP7QGA,42wDHagxr5Nno3mUx6kyYGDjwR98aedRbh3ByB468agB,True,5176,1294,8,4,4,3zqXX6kzhkbW3d4TwD2CNjMRwxTbREXySekvq37kfCNk,324,2723,-2399,625
2022-01-21 07:06:01-05:00,4481,9LZ3rShLfzErXsGkh4dYfAm58GNPWhK6ohDy5RrLJhc,41tLyuvuJ5M7YctkSASD2R7RGGetD7FmKaZUdkTdgXgt,True,395694,98923,617,308,309,HfEnetJ7uBSmZWCjBNxdvv9HEC5nsW4wDV7wu6WnhWan,24700,149598,-124898,624
2022-01-21 07:06:01-05:00,4482,ECuu1L4QGdemZ7FjAjVAAxYN6piinweY7Fuk5csVovfT,Amd8WGcpdtB8yoA83R1BUT5uryuqoKbcBexYacbrbGVX,True,834966,208741,1301,650,651,HfEnetJ7uBSmZWCjBNxdvv9HEC5nsW4wDV7wu6WnhWan,52076,400467,-348391,623
2022-01-21 07:06:07-05:00,4483,6osqTNxgZv1Y1EjnVR7D1G4cywof1CrWswj87tAnktWV,Fah93R9W7SFuajFif4AbXDdxouWA5rrLz29vzVRGsMxv,True,3414186,853546,5321,2660,2661,DddJ7EWCmYEEZETCBNgAUSg81Ls6fZtiAaY5ekJ5sXx1,212850,3443202,-3230352,623
2022-01-21 07:06:09-05:00,4484,2p2fGXdKrmxjomLSnyaNg84J82cBBBNympZ6qQc8UZgU,HKAM8bazuLMUY6yapZJqYsgaWkTBqKHyMs1hSfpYsZGi,True,221794050,55448512,346149,173074,173075,4BnQKPLuE3DMTtxp8MjUBytgnhvxqq3ZTqZHTVZo4JJh,13845979,141453177,-127607198,624
2022-01-21 07:06:09-05:00,4485,DJiXXW7sjNsAAxWupDKBUsFhXSgPoerVYaAtJqqNgVbn,2MsqvNuJw1xQhJ3UnXt9i7oNHDuZpR9w7iE1WQcGqt5m,True,40032,10008,62,31,31,4BnQKPLuE3DMTtxp8MjUBytgnhvxqq3ZTqZHTVZo4JJh,2502,18225,-15723,625
2022-01-21 07:06:10-05:00,4486,HhwiZPKZBGa16oVi739s4qtMDMTwzWXc7iwNfX63t2UP,5AnbMbAFKy85yHt5y2M5S38nNkA1vT4ejY5NjGbRNUqn,True,377929,94482,585,292,293,4BnQKPLuE3DMTtxp8MjUBytgnhvxqq3ZTqZHTVZo4JJh,23412,279672,-256260,619
2022-01-21 07:06:10-05:00,4487,6gFbxvPafnpqZjWW94MMmL8mGp2FHZGqoJC5fWqgwNxS,C6WcDycp3Ff3xYmb81i8JbD39Xv1o5G2AdtPs1FdXtr4,True,628579743,157144935,973601,486800,486801,DddJ7EWCmYEEZETCBNgAUSg81Ls6fZtiAaY5ekJ5sXx1,38944061,169674337,-130730276,619
2022-01-21 07:06:10-05:00,4488,6d6HN8LWikwW2HYdy3BABWuxKHt1sgv4DcneACR133sE,4eKvzmfFvX96XbujKBhUauAvWP4yQYwZH3pd7gXzbCvJ,True,455968,113992,704,352,352,4BnQKPLuE3DMTtxp8MjUBytgnhvxqq3ZTqZHTVZo4JJh,28198,172912,-144714,618
2022-01-21 07:06:15-05:00,4489,2bikYf33ZxxDmvkMNjWDGGqEpbYJPvWv5At3hzyeLEQK,5FtirUBjRAZ3k5arFFVwKz42ixWzhkEBLkaK9PraRZ78,True,40008,10002,62,31,31,HfEnetJ7uBSmZWCjBNxdvv9HEC5nsW4wDV7wu6WnhWan,2482,18230,-15748,620
2022-01-21 07:06:15-05:00,4490,921FBgLS3A1wA77uWitsnTvW737Q2jY7tzvgWtWLXNC7,E4eJ9H7cqP9zNpMH5xRBTAp9yaBCBihuJBNd6pqzteDG,True,40007,10001,62,31,31,DddJ7EWCmYEEZETCBNgAUSg81Ls6fZtiAaY5ekJ5sXx1,2482,18229,-15747,620
2022-01-21 07:06:18-05:00,4491,BPRoaqrDs8vhqv2T7d9qV2oPU33pi1K1LUaotM7yuD2i,6qo8uQGAEwBfYQR36v6nRiqA2xGV6SjJAsXsdzy5bqNH,True,282875088,70718772,436824,218412,218412,HfEnetJ7uBSmZWCjBNxdvv9HEC5nsW4wDV7wu6WnhWan,17472967,161767613,-144294646,617
2022-01-21 07:06:18-05:00,4492,9k5YHTFCHczFg6KAZXf2ostkFLH7WdVAxiA9zCGRprg3,2b52r1TA8dkJsnuMuM9cNfGxKEynd42WjQUuzcQTRcD9,True,17391,4347,26,13,13,4BnQKPLuE3DMTtxp8MjUBytgnhvxqq3ZTqZHTVZo4JJh,1072,9204,-8132,616
2022-01-21 07:06:18-05:00,4493,7W6ih2ZGXaE6tvuQFUPCvc7NvEJHy7UffgoVX3ZPdLXt,6uQCkeMjEXHBQxE2HD33RM1zyTsSko1fYZA1mWUggJ5B,True,7021,1755,10,5,5,HfEnetJ7uBSmZWCjBNxdvv9HEC5nsW4wDV7wu6WnhWan,437,3802,-3365,622
2022-01-21 07:06:18-05:00,4494,4kbcrzH6o2LvLUCNphyL52i8uGzVD8wcUNEqoQ14z3VG,5Q1atmEBs2AqaDZsiZFG5stHzj1fE6ZvypgfkEc9LYqE,True,48676605,12169151,75720,37860,37860,72FwbpFGoLEazJEdpqNtPNefsadUrimUqma9wSoy4qiS,3028801,33061177,-30032376,622
2022-01-21 07:06:21-05:00,4495,7g4NJBHwDTRm58GqX7Tz1JzqwbAhF6EWJUQH3SoDxSf7,82Ypv7STZeSCBPf3HckWdyatELpvaDaWxFXhD5dNSML4,True,6354,1588,9,4,5,3uL2NSR2ZdDqCiKfzA5SwwpddAnit22DBJo6uvvz1rRs,393,3358,-2965,618
2022-01-21 07:06:21-05:00,4496,duKo8riX1qpX1K1qpgwZniMtUeWqu2eYgchTu5n7Rbu,9vAVwfVtdsaZMbeZvoymjHqwASeuM38gfEJkbTVwDqya,True,18287517,4571879,28299,14149,14150,3uL2NSR2ZdDqCiKfzA5SwwpddAnit22DBJo6uvvz1rRs,1131993,9419960,-8287967,618
2022-01-21 07:06:22-05:00,4497,CCHzYXr5zMXFu8MMZNkfUWGyUcF8xy7Vvhq7tNCtZg2L,AuEXkCJTTJ3HK8iP4qTWpQr4vp6HPRJZyZwfRjF8zjfp,True,39965,9991,60,30,30,3uL2NSR2ZdDqCiKfzA5SwwpddAnit22DBJo6uvvz1rRs,2439,18230,-15791,610
2022-01-21 07:06:22-05:00,4498,FLTW9fwjWqGPm5PiE3C9LFzwZxtDh8c2MnEoRq8W7MfQ,GKsfzKBP2QkmoEWvTaUN1h4nqrT3kAcwYRC9WxW9bB3h,True,3363255,840813,5131,2565,2566,4BnQKPLuE3DMTtxp8MjUBytgnhvxqq3ZTqZHTVZo4JJh,205260,1534238,-1328978,610
2022-01-21 07:06:25-05:00,4499,4D7mDXe7SdmbAx7kaD1mBNuEa7DzMi6TAwXURxtLEazk,5pSnT91PHoLdN6uhPnUtoD7cboLmndn26y1XouPx8vwW,True,404446,101111,628,314,314,DddJ7EWCmYEEZETCBNgAUSg81Ls6fZtiAaY5ekJ5sXx1,25128,183709,-158581,621
2022-01-21 07:06:25-05:00,4500,GH6Q9E1jZPTTp46aDd57UNZPNS2D6PBSwyLL3EHSjGn2,2XvwZXNsrPWx4EfPvhTP933bzCC3SJHDQ8xARfrXdVY9,True,5383336,1345834,8331,4165,4166,4BnQKPLuE3DMTtxp8MjUBytgnhvxqq3ZTqZHTVZo4JJh,333252,5379453,-5046201,619
2022-01-21 07:06:29-05:00,4501,6VJcr3VAEcEZaHEpt48QL8QxHKABufVp8n2JSEVTLh9U,8naR6kiySKj3vai9dCetdgCnCHgf2oyLjGqKTJ3Lz64Y,True,668859767,167214941,1044461,522230,522231,4BnQKPLuE3DMTtxp8MjUBytgnhvxqq3ZTqZHTVZo4JJh,41778451,358103632,-316325181,624
2022-01-21 07:06:30-05:00,4502,EeztHR1M4PPacJEZ6c5arCRVCuu8aN7eGdpY1u4bev79,9Twdc9Xrzv2oeJ9Fbd8mRvzjbFi7mkGopFS37SMabeAK,True,48417511,12104377,75145,37572,37573,HfEnetJ7uBSmZWCjBNxdvv9HEC5nsW4wDV7wu6WnhWan,3005810,20593187,-17587377,620
2022-01-21 07:06:30-05:00,4503,36ByQojnxEckWdQTjqHfxKqCx9yjqWQsPsZyqaN72UWR,AZoirtS1fjX61agRM64tqThVinnJTh3BWgiHyNHPTgZP,True,309630,77407,479,239,240,HfEnetJ7uBSmZWCjBNxdvv9HEC5nsW4wDV7wu6WnhWan,19181,199673,-180492,619
2022-01-21 07:06:30-05:00,4504,HSZrdquqBs1gWQGSBcLGs4aa4ox27rLHh6KKmdHrgrVs,DywbuaDt997DQA1GT9GsLL8ML73CxQgHwMLw2MyG8m7M,True,4330711,1082677,6671,3335,3336,HfEnetJ7uBSmZWCjBNxdvv9HEC5nsW4wDV7wu6WnhWan,266875,925086,-658211,616
2022-01-21 07:06:30-05:00,4505,HkRKcvAWLM5sCDL6a5DvYsH55bg5BnZnyP9WwX7wLUDF,GXtDJS8BCoZKnvviGaUb2QfKs2LQQZPMa9564tf5Jq8Y,True,416264051,104066012,640828,320414,320414,3uL2NSR2ZdDqCiKfzA5SwwpddAnit22DBJo6uvvz1rRs,25633138,132708547,-107075409,615
2022-01-21 07:06:30-05:00,4506,AA9zFZTXqBR8Mw1fwEH59edzBiswoGasRNWsi6aLeysB,4VeitxYqqtRxyfdSVpshdJ3EDcgksRVnaHvAqWxTeujH,True,463683,115920,721,360,361,HfEnetJ7uBSmZWCjBNxdvv9HEC5nsW4wDV7wu6WnhWan,28853,175863,-147010,622
2022-01-21 07:06:32-05:00,4507,FpqCxvTkSiwDwD5qEt6hXJxzFDLFLAQ8VevK8zwRqYun,A3p6YQisCJKpNkF7vkjZRbEfbnUt7vTZdR2zPBUSdTkk,True,111908727,27977181,174827,87413,87414,4BnQKPLuE3DMTtxp8MjUBytgnhvxqq3ZTqZHTVZo4JJh,6993119,53487779,-46494660,624
2022-01-21 07:06:32-05:00,4508,3MEiFqy4F9nBW8gHxvGjv7norSBHwxhbzzNKngPk1RHq,2tcsJ4NUJegcEfHNwWPh979yKjKmq568CpNm5iWGbuoR,True,12805906,3201475,19973,9986,9987,4BnQKPLuE3DMTtxp8MjUBytgnhvxqq3ZTqZHTVZo4JJh,798944,5430549,-4631605,623
2022-01-21 07:06:41-05:00,4509,GWkVXmZNQdcdWNNu8dvRqct4aMhLoDNqijrTvxbfEdKN,6LKRNbJv2XkyjJQKCFAqFRPzvANrRBSTmu8doRWqTicU,True,29586596,7396649,45629,22814,22815,HfEnetJ7uBSmZWCjBNxdvv9HEC5nsW4wDV7wu6WnhWan,1825172,8642228,-6817056,616
2022-01-21 07:06:50-05:00,4510,ES1MDwRUa3hoToPKQiiZkzMYe9PDVnAQwMrEvZrzvnc1,C4wBG3xTDkmDQneB28xYnf1aBNEeq7UB8oR7NuEfLkFg,True,7502812,1875703,11707,5853,5854,HfEnetJ7uBSmZWCjBNxdvv9HEC5nsW4wDV7wu6WnhWan,468317,3406087,-2937770,624
2022-01-21 07:06:51-05:00,4511,5nauZoaxftcYR591YH4v52myeJLnXtY4okdttL9qSdkg,7x3G299D3bC7EwUQojhTXUv29BG4NGzrLbgS4mEyqG5r,True,126049523,31512380,196382,98191,98191,4BnQKPLuE3DMTtxp8MjUBytgnhvxqq3ZTqZHTVZo4JJh,7855300,39991547,-32136247,623
2022-01-21 07:06:52-05:00,4512,3njiRuSRMXRzKmamyiR72Hc38PU8UDDmWdfPhgxmGxEW,5WoF3gkgygyNNbwxWgVfqGWkExcDixuzgJQQjXEZQ6J5,True,69517616,17379404,108491,54245,54246,3uL2NSR2ZdDqCiKfzA5SwwpddAnit22DBJo6uvvz1rRs,4339669,57443890,-53104221,624
2022-01-21 07:06:52-05:00,4513,5jin5wXjQQ25nGM2ECrCXcg1a95vquh6kM7rMRru6Ke7,EKM657EQ8HWWgf4cssByoYHoXGjFfTspTKXAGmygAPQG,True,10248750,2562187,15941,7970,7971,3uL2NSR2ZdDqCiKfzA5SwwpddAnit22DBJo6uvvz1rRs,637662,6273793,-5636131,622
2022-01-21 07:06:52-05:00,4514,H6fVnghBUSJRKp2mxSG7Fq2Lr4dE3YMS7yM1XTrxoe3Z,JjgtLi79grUZXofhWukB1yNXZkXFMUX5jm9HcXNDsB6,True,8265137,2066284,12896,6448,6448,3uL2NSR2ZdDqCiKfzA5SwwpddAnit22DBJo6uvvz1rRs,515873,3499602,-2983729,624
2022-01-21 07:06:53-05:00,4515,D2L7ST8iGsRfZ4zj2pdfKTptbojQ4cDtHKQ8ngcFVQwA,7cNrHGWJ6FGGazfGaCePs8XyaK6bwVLrYFCUJQi9w2Wc,True,18434,4608,28,14,14,DddJ7EWCmYEEZETCBNgAUSg81Ls6fZtiAaY5ekJ5sXx1,1152,9709,-8557,624
2022-01-21 07:06:53-05:00,4516,DAku12iueL13vRoTpKLyqdGaLQ2rWF6REe8Dr8soFvNs,H2vVH3LxkhGe6x6Mdwy67BYwTKNQM6XayKx7mhrwyfJM,True,121536,30384,189,94,95,DddJ7EWCmYEEZETCBNgAUSg81Ls6fZtiAaY5ekJ5sXx1,7561,76088,-68527,622
2022-01-21 07:06:56-05:00,4517,7uHMFnppZKtV7nAySv8UGcoGTSQ98RVz1GP47dsFWpYr,FmS9WPYVTT8i4agyidApdLnoHAUMfdRFPnAVJQUwfWr5,True,467681344,116920336,729247,364623,364624,DddJ7EWCmYEEZETCBNgAUSg81Ls6fZtiAaY5ekJ5sXx1,29169888,114586740,-85416852,623
2022-01-21 07:07:01-05:00,4518,GGGyesjbt7h2XHHp9u8vpiWGugFwEbrtYaKrNQSDhQd7,8tydo1ZjGHmPBSqU33tywB3f9szdsHk1ckGFe4Ay5pgs,True,13751177,3437794,21451,10725,10726,4BnQKPLuE3DMTtxp8MjUBytgnhvxqq3ZTqZHTVZo4JJh,858048,12352837,-11494789,623
2022-01-21 07:07:05-05:00,4519,C2Dmfw4G8KKzFq38aRH2pLCRngnGZDvUUN3fHDMjFkoG,7kzJk3BTNvY3hGFNj7nDy9L5CAYus6eNiCAxWH8dSioX,True,101112,25278,157,78,79,4BnQKPLuE3DMTtxp8MjUBytgnhvxqq3ZTqZHTVZo4JJh,6314,74475,-68161,624
2022-01-21 07:07:05-05:00,4520,6xikA6d7sjCBnSfqkFwrL4nPrtQUNWdRhXB7i1AccnxC,G8t7u2R9qjRfdTdULs74v3nVrTM2WeKvc4dK4FFAvuG1,True,10203894,2550973,15955,7977,7978,4BnQKPLuE3DMTtxp8MjUBytgnhvxqq3ZTqZHTVZo4JJh,638214,3329475,-2691261,625
2022-01-21 07:07:05-05:00,4521,2FrqGFZjbiNykJyo9BZ5S9FguQJPJiTi681rJJsQ5dta,3QUncYP92NKrfpaTvuF9iQg11PXKgZAgEngwh6BbnCCj,True,224995,56248,349,174,175,4BnQKPLuE3DMTtxp8MjUBytgnhvxqq3ZTqZHTVZo4JJh,13995,118895,-104900,622
2022-01-21 07:07:06-05:00,4522,5RvNKzSeJ1fvqsKpcQu25evEZGmKjyEDgwsMZkykoT3P,BRqSGfE4XHXu4HrinwetWumfVTmr82iuF6Y5oSV6eMiK,True,39955,9988,62,31,31,HfEnetJ7uBSmZWCjBNxdvv9HEC5nsW4wDV7wu6WnhWan,2482,18282,-15800,621
2022-01-21 07:07:06-05:00,4523,8NdcaYUC1X5CP7FMDip78uqtqmCt8GcZdCzLRTYTihmb,9Ei1K9bXWXSXcBfeX5exPSXGCAu62WSKzvnnd4wHvyVh,True,35790,8947,55,27,28,HfEnetJ7uBSmZWCjBNxdvv9HEC5nsW4wDV7wu6WnhWan,2228,19886,-17658,622
2022-01-21 07:07:09-05:00,4524,AM5fwZR9BUW8AFkhdGWXW4PHd2cy8ora63kDf2z2eknw,E7ru6hg4MchnRG5zcr5YazwX8Snt55r5Xq9zCHCGaYZT,True,260274,65068,405,202,203,4BnQKPLuE3DMTtxp8MjUBytgnhvxqq3ZTqZHTVZo4JJh,16205,156346,-140141,622
2022-01-21 07:07:09-05:00,4525,BAczoNDnbwj5AJX5LwzynzYab7ji7VbhRy9edA9Prax,34sbkUKnMetUNyMs6BhiWut85d5UZtBWnPtwx8jEpJNA,True,354004,88501,550,275,275,DddJ7EWCmYEEZETCBNgAUSg81Ls6fZtiAaY5ekJ5sXx1,22038,201919,-179881,622
2022-01-21 07:07:11-05:00,4526,6CeKxTJvFqhyNEyzySiBBKEwYVMe7j3A6nkMes4BW6o2,DzDR9XvwY1z7ygQ8YrCXrwDGHSf67JZF8BzUnuFE2fxQ,True,1192020,298005,1860,930,930,HfEnetJ7uBSmZWCjBNxdvv9HEC5nsW4wDV7wu6WnhWan,74410,571379,-496969,624
2022-01-21 07:07:17-05:00,4527,LNX7AwwiGpuaXA4J86d1xqqtF6kD7qbCusssSZqtpKd,45a5FGVssw2NoGipB7NRN4XDLPob4GHNxSM9fqgsTpqA,True,235476382,58869095,366651,183325,183326,3uL2NSR2ZdDqCiKfzA5SwwpddAnit22DBJo6uvvz1rRs,14666071,68882103,-54216032,622
2022-01-21 07:07:17-05:00,4528,8hpAXzimCw2bTwLXoRFAbqNW8qoj5VV3JDYCuJwqHpHm,DkfsL2M7oRBX6grAfy15C4urwL6ToMJ7TWJEFAGhWjYX,True,2519611,629902,3940,1970,1970,3uL2NSR2ZdDqCiKfzA5SwwpddAnit22DBJo6uvvz1rRs,157622,798914,-641292,625
2022-01-21 07:07:17-05:00,4529,AGhvB6x3gmvAJSnr9UVtvhKqVg3Qgh1k4roHzrNHhAaa,HhhjXT6WJnz1HQfHcwKdBppuAhc8ncUcq1mkJ4EHqgpe,True,1721,430,2,1,1,3uL2NSR2ZdDqCiKfzA5SwwpddAnit22DBJo6uvvz1rRs,107,943,-836,621
2022-01-21 07:07:26-05:00,4530,6dr65yANjSMmfBeKAuSxG3i16S9vMgF1CQ3zDyzh55Pn,EhrE5QpnshD41S4zPEBy2A5q2Gs2mwUrbHGo6WnT9zDP,True,91119,22779,141,70,71,3uL2NSR2ZdDqCiKfzA5SwwpddAnit22DBJo6uvvz1rRs,5677,57107,-51430,623
2022-01-21 07:07:28-05:00,4531,6u6bPgAmK8ufACrQV99A1Y5nhGkue3KEUHmQQkcNkxwP,7636yXT5w4DcVpc7LJdN46aiggzSq6U2GXHXL5kyy9F3,True,32304698,8076174,50430,25215,25215,3uL2NSR2ZdDqCiKfzA5SwwpddAnit22DBJo6uvvz1rRs,2017215,19753726,-17736511,624
2022-01-21 07:07:41-05:00,4532,2QStaRnbSnDhA891Lb1bxjVeMYpJUpNdqaVkw3rqU45V,DakRWPnttPoRcjY5V7WLwiwBx39BapCo9Atog8dL17Ku,True,616677,154169,964,482,482,HfEnetJ7uBSmZWCjBNxdvv9HEC5nsW4wDV7wu6WnhWan,38585,266614,-228029,625
2022-01-21 07:07:44-05:00,4533,CyWBZ1xJ9LahUnPesbXLZ4Rr5UyWAHgVFYwfrnhyrkNL,2Lpk87Xth8ZL5J9BfzmMpEE3x76FDrrrmdKiCNkSVip2,True,96329446,24082360,149840,74920,74920,3uL2NSR2ZdDqCiKfzA5SwwpddAnit22DBJo6uvvz1rRs,5993633,41046165,-35052532,622
2022-01-21 07:07:52-05:00,4534,F2v1YwVAwXLiUgsJ5uwn4qAAkTXitn1E75fJcPnGuAcy,5rdJ4H5GxPg4Juu77mGc7uya5LwEqLzDSRyG8mQ2mDbK,True,5249262,1312315,8135,4067,4068,HfEnetJ7uBSmZWCjBNxdvv9HEC5nsW4wDV7wu6WnhWan,325416,3205391,-2879975,619
2022-01-21 07:07:52-05:00,4535,Ftuj53jKP3Z8mvuTE1CEypdw2eZrCn5x8ktMWRdJo2gU,9JNUFRLrPNAh3DgKvMdaNvLCAeUtiS9FGWmDcMvcSe7J,True,69478389,17369597,107679,53839,53840,4BnQKPLuE3DMTtxp8MjUBytgnhvxqq3ZTqZHTVZo4JJh,4307190,32657430,-28350240,619
2022-01-21 07:07:53-05:00,4536,3Lv2XpiD4KBUHq7Zx6u3zNhpXoySodXHH8o8f5yaaPxG,H6TN4rhpBXkEH3mZnymYNcKfmnxRH2uzfwzeLH2q6ahP,True,50826,12706,78,39,39,4BnQKPLuE3DMTtxp8MjUBytgnhvxqq3ZTqZHTVZo4JJh,3148,27985,-24837,619
2022-01-21 07:07:53-05:00,4537,AHm7zF4rpaxaayBLn5QDHgJSp8KAr647s4cNvQ9wLgd7,FDM33WngED24pukBvSDpPAzinW6afVAeGReum5nyLRiC,True,225437,56359,349,174,175,HfEnetJ7uBSmZWCjBNxdvv9HEC5nsW4wDV7wu6WnhWan,13971,141803,-127832,619
2022-01-21 07:07:57-05:00,4538,Fd2HrzBAr4JobRPARZwpQHHVoSCEoog32A6tKMWAC1sK,BYappsar5sQf8VLem4wrLuTtrDFH9y8pEx1aMxfuU4Pq,True,8196797,2049199,12795,6397,6398,72FwbpFGoLEazJEdpqNtPNefsadUrimUqma9wSoy4qiS,511832,5006772,-4494940,624
2022-01-21 07:07:57-05:00,4539,6tFQaTqqffino9kwMZTL2xVNBG8k9VREFhXqVi2si3A3,3w3wGxBbS4bmXeqmvd595SAWFeXekVpnH4UdbeEs8Sx5,True,1193157,298289,1865,932,933,72FwbpFGoLEazJEdpqNtPNefsadUrimUqma9wSoy4qiS,74635,570467,-495832,625
2022-01-21 07:07:58-05:00,4540,Ayx8dFsVzUBb9b7QKxw7YHJuhptdSitBXFEczXTaxe85,EvU1VLChnowi6ccSPeJRSk65njrqZfYouAN7SHePxsxf,True,6368,1592,9,4,5,72FwbpFGoLEazJEdpqNtPNefsadUrimUqma9wSoy4qiS,395,4007,-3612,620
2022-01-21 07:07:58-05:00,4541,8VnGmfop6qcUezAJ2M15jz2Nn6mPQgehDcJPvypq4XJn,6F6sqXNhgkW9ev8QNMm4ydywUUmemhwgydRQYNeqyUmi,True,2881908,720477,4463,2231,2232,4BnQKPLuE3DMTtxp8MjUBytgnhvxqq3ZTqZHTVZo4JJh,178537,2927996,-2749459,619
2022-01-21 07:08:14-05:00,4542,DYCYiQFH9QHzCo3eAw1pFoDu7pzwFMo1E2WDZjVFRz5w,CPh4FWsGak1kd1WFEH9qBjNhnun3R2tHtZA57zW8ugn5,True,19245764,4811441,29941,14970,14971,4BnQKPLuE3DMTtxp8MjUBytgnhvxqq3ZTqZHTVZo4JJh,1197647,11758577,-10560930,622
2022-01-21 07:08:33-05:00,4543,6yw4GPvkqUbakcEWtqSCfjVLukty11xqjDpGxtEN9Km2,5ppEx7wkpqbG5nApCWMdRja3oRSheFmAAsNHUX7h2w2Y,True,449391,112347,699,349,350,3uL2NSR2ZdDqCiKfzA5SwwpddAnit22DBJo6uvvz1rRs,27972,464384,-436412,622
2022-01-21 07:08:33-05:00,4544,5SskSWkRPP5BNaqvHkJCbTAgHPUkHEwFh5pFr4t8PoBr,EqdX8Sdm9LCfdrzVKzisKaFcP2YEdSRNZYmev5RWjGqb,True,1066010,266502,1659,829,830,3uL2NSR2ZdDqCiKfzA5SwwpddAnit22DBJo6uvvz1rRs,66378,344961,-278583,622
2022-01-21 07:08:37-05:00,4545,5kwvkEtRFFD84j4ntVgxkacadgJaFvQ9JLhJqzLR7Y3G,GpMMkTv9T7y8DTiizuoJUsWvnSk3GSxADjRMGyYpryxm,True,12236863,3059215,19087,9543,9544,HfEnetJ7uBSmZWCjBNxdvv9HEC5nsW4wDV7wu6WnhWan,763513,4657917,-3894404,623
2022-01-21 07:08:41-05:00,4546,7CSCMFa9W52tBDVUbXbc3woAy3GByeA1wPJdp3MgznPa,3447ptuVFu6G8B6N63RmS8mRv4n9PfHneypHLvbeaGLn,True,40867056,10216764,63491,31745,31746,DddJ7EWCmYEEZETCBNgAUSg81Ls6fZtiAaY5ekJ5sXx1,2539654,22681259,-20141605,621
2022-01-21 07:08:41-05:00,4547,EmGW2aAG69ssWqCtbfDocRaM2u3TJsczn2HHP9jdmRvD,aypkDKsp9uqAB4F6mwvm5LofpsrFBuZT2MMWtE2eHdB,True,175698,43924,274,137,137,DddJ7EWCmYEEZETCBNgAUSg81Ls6fZtiAaY5ekJ5sXx1,10998,102547,-91549,625
2022-01-21 07:08:54-05:00,4548,GKKRAsYGdcf47eFThG4KwhNv7egeHRuc2wmTh4kqpego,4ippJxgnqCtdtGzCkdZoYwv68fiXNSqQcgrnaHdXZDUa,True,405398847,101349710,633242,316621,316621,3uL2NSR2ZdDqCiKfzA5SwwpddAnit22DBJo6uvvz1rRs,25329680,185279748,-159950068,624
2022-01-21 07:09:01-05:00,4549,53LQyY375e9D9Lt5KCueA28GwzeBeb53W4V9Qszcd6D,9kG7BrpuFUgF1CkqBfUEJgyVwK338eHMFAJfqvBy63E2,True,1274799416,318699852,1992966,996483,996483,4BnQKPLuE3DMTtxp8MjUBytgnhvxqq3ZTqZHTVZo4JJh,79718642,367872168,-288153526,625
2022-01-21 07:09:09-05:00,4550,WMUVFELv3C3KdMKJ5ZL4rG7o1YrV1qTP6Mmp2S5Rp8S,7UNzS3zDqT1oeq9a7eJGU8cgf8eUzEAZubSBQvNmK6uJ,True,4932054,1233013,7601,3800,3801,4BnQKPLuE3DMTtxp8MjUBytgnhvxqq3ZTqZHTVZo4JJh,304043,1490424,-1186381,616
2022-01-21 07:09:09-05:00,4551,E8ifvhmyJGBGVQomo3AnZw2UcaLHcpGsTtuoCid8voU3,FMQUWTbTAfSLfrc6GTrz4DM2ZSgoxF3KtqGn8AyjVtsf,True,1934580,483645,2994,1497,1497,4BnQKPLuE3DMTtxp8MjUBytgnhvxqq3ZTqZHTVZo4JJh,119779,915026,-795247,619
2022-01-21 07:09:10-05:00,4552,AATMHH4e4B6SL9bThnXGktzWuqWkPdx3JbRXk8HwkbPW,6F3u2yLx7P9gtpAAXASx7uF8xNyVBgJiKosMKUrgpicA,True,68034082,17008520,105124,52562,52562,HfEnetJ7uBSmZWCjBNxdvv9HEC5nsW4wDV7wu6WnhWan,4204960,36524806,-32319846,618
2022-01-21 07:09:11-05:00,4553,9zpPiboHF5HW7NfCx7hYdmJGwUomVMTiUFc4Um5KrDi3,8q3eBpuwV6dMNkib9N8XQAq2tBUcjSANRe5SXpd4dFhZ,True,2231778,557944,3464,1732,1732,DddJ7EWCmYEEZETCBNgAUSg81Ls6fZtiAaY5ekJ5sXx1,138592,1003502,-864910,620
2022-01-21 07:09:13-05:00,4554,6Y1UoGwrKyKsScZQm9ng1rNrXXykKT82V7kUopc43kAy,8YtWQTTKymCESbPMWCP9TMehbMU25zJMtxt9grqrpbD4,True,10369709,2592427,16178,8089,8089,DddJ7EWCmYEEZETCBNgAUSg81Ls6fZtiAaY5ekJ5sXx1,647129,10525378,-9878249,624
2022-01-21 07:09:13-05:00,4555,3oCun4gm3k8sXxVxiYM8okGi8iCXH9LvDkHf9PBQWYXR,E1np1dZ7jUm811ddvy1jQerBwGSYb5BbZWnUHeotvrfH,True,115957086,28989271,181264,90632,90632,4BnQKPLuE3DMTtxp8MjUBytgnhvxqq3ZTqZHTVZo4JJh,7250562,31401449,-24150887,625
2022-01-21 07:09:13-05:00,4556,FtF3PVw8YNJseWPMcA2GEuQZ6nni1mq5kYPa2LrSzfkW,4yr1TM2dXrBvLNMpSaoryuGU2P8D3WG1ZCkvVzWFiQRH,True,74467552660,18616888163,115912818,57956409,57956409,HfEnetJ7uBSmZWCjBNxdvv9HEC5nsW4wDV7wu6WnhWan,4636512725,15524103865,-10887591140,622
2022-01-21 07:09:14-05:00,4557,8T4WK27RvWVGqPuNqY6whk1fmU4vd5qaUQPZG1GJ79bh,DvSz7knS8N3K7L6JhQf1s4mJSyxB8uJXNQXtyjJn8QRL,True,47987480,11996869,74591,37295,37296,HfEnetJ7uBSmZWCjBNxdvv9HEC5nsW4wDV7wu6WnhWan,2983644,24951411,-21967767,621
2022-01-21 07:09:19-05:00,4558,2F45BX9mRmtNCHPejKFknN5aNgGvR4vVLFjMaY1a7dR8,ALdSutsvEFRUEQGGBbi31QywTL1pdXSDWrNJzvNTaoXL,True,6812805,1703201,10618,5309,5309,3uL2NSR2ZdDqCiKfzA5SwwpddAnit22DBJo6uvvz1rRs,424759,4039151,-3614392,623
2022-01-21 07:09:20-05:00,4559,HdRgh9niYSd3YKCxzGdusYFquiVoFTP2mEGEzJJL5Nii,78C68Gbb1jYFQmYNCHHjL52keEKMXtGukmBwT7ahon4B,True,5754642128,1438660531,8962229,4481114,4481115,4BnQKPLuE3DMTtxp8MjUBytgnhvxqq3ZTqZHTVZo4JJh,358489184,2667029163,-2308539979,622
2022-01-21 07:09:23-05:00,4560,5Rxuqgs4CaSKbfDXqBMFXkLTQ9dxrUjThXzoy3ouYVtK,BgvbKru66ebrGUcFFymGTmsaQv6GgcGMybiWaXqzBtwX,True,80565,20141,125,62,63,3uL2NSR2ZdDqCiKfzA5SwwpddAnit22DBJo6uvvz1rRs,5021,55309,-50288,623
2022-01-21 07:09:24-05:00,4561,9UyQC8vc6zJJaSdnjvTAzgmcsw4fC3xFBBiCC1w9Sbjx,3ppBfboe6FPmt7f6WrivspMUoAznZKWQMeh3rCgw7vjQ,True,2434744,608686,3778,1889,1889,HfEnetJ7uBSmZWCjBNxdvv9HEC5nsW4wDV7wu6WnhWan,151129,1094867,-943738,620
2022-01-21 07:09:31-05:00,4562,3VYtHvoT9wi4K1PBjg6JjCf6U9fVPDf6tX9jyRRvLxcg,Ba5fjpVyAxLbiP6hYJmrxzougi7JUEDfDLKBxSbbTL7q,True,122727903,30681975,191000,95500,95500,4BnQKPLuE3DMTtxp8MjUBytgnhvxqq3ZTqZHTVZo4JJh,7640039,36062937,-28422898,622
2022-01-21 07:09:36-05:00,4563,HwosLQgDY1xtHQRQ4hzroPQHFWssPzTj5vRkP37FcviB,HKTNEYNXrephNkH7apbobK4mcQXcNayQA4W1NgM6sLr8,True,23794980,5948744,36754,18377,18377,4BnQKPLuE3DMTtxp8MjUBytgnhvxqq3ZTqZHTVZo4JJh,1470188,8776519,-7306331,617
2022-01-21 07:09:39-05:00,4564,H1LftKtj94Zs6PG2A7gJt9rPurBkXkTy2hbbArQwAehi,8bANmhgdnPYa3PqdPnk5BA2xhvqJmPyaMF77mrBePJ13,True,10407,2601,16,8,8,3uL2NSR2ZdDqCiKfzA5SwwpddAnit22DBJo6uvvz1rRs,651,9848,-9197,625
2022-01-21 07:09:41-05:00,4565,A1j2G5FZRyWSjFt6dK87WHhLkQrPUVqHaM3KhSzhAKDT,2fMiHLYm4pL3YCd8aveTR4mT9uVxztQeMwb5eRZb4wUW,True,271110,67777,424,212,212,3uL2NSR2ZdDqCiKfzA5SwwpddAnit22DBJo6uvvz1rRs,16963,146268,-129305,625
2022-01-21 07:09:42-05:00,4566,3ogBPSRcKfmwzgumVDHBkXLi1eCsEFG2xzSJgD4LQDNy,7TXyqWgJqfe71MSWFA2n7ufZbUdzf7JJoWej8FNNtMXo,True,8161648,2040412,12634,6317,6317,DddJ7EWCmYEEZETCBNgAUSg81Ls6fZtiAaY5ekJ5sXx1,505390,3730089,-3224699,619
2022-01-21 07:09:54-05:00,4567,6uZobpBuFcQeYgZ4dApFi6iy4DB9GLHP1AAsQcCj6212,SGGFiPjjhscwroiWMqY4jTAHFw8eakpsEv35wNoHUPY,True,110087054,27521762,172013,86006,86007,4BnQKPLuE3DMTtxp8MjUBytgnhvxqq3ZTqZHTVZo4JJh,6880528,22053474,-15172946,625
2022-01-21 07:09:54-05:00,4568,DC4UVUDFWL3gVtgkX9hPtFgtxaA8DH5p94i4k9U3wyWv,3HCWqVvQQfRgSKitsTjGTduJ82ointZUSNtj13uea4kD,True,680621471,170155367,1061115,530557,530558,4BnQKPLuE3DMTtxp8MjUBytgnhvxqq3ZTqZHTVZo4JJh,42444610,308464820,-266020210,623
2022-01-21 07:09:55-05:00,4569,8trkirSQNdMmAcJdeswxs5cPjH8dD6U4eJtWiAdMsrDB,HaSzpQ45x2MipfN17U6jGBxX8tXboomVDhXNSrnEfLDr,True,1270724,317681,1971,985,986,DddJ7EWCmYEEZETCBNgAUSg81Ls6fZtiAaY5ekJ5sXx1,78879,651946,-573067,620
2022-01-21 07:09:56-05:00,4570,8xvLGVeDmhVYQhN2ZpWkVG9jCrukRsNQ4926a4TMiZqa,9ciBySSjvADwp47WkETiFWZKVTFL8Hf1XvK7aSxhcgQS,True,9640667,2410166,14889,7444,7445,DddJ7EWCmYEEZETCBNgAUSg81Ls6fZtiAaY5ekJ5sXx1,595599,4779992,-4184393,617
2022-01-21 07:10:00-05:00,4571,78EeyPYzQjrmW6z9VGhRci6ihMUZb5rtpXo3GAxugf55,9AgZ45TMxaqwWGVWSgnEkvio3s6fXtHjAVRVCA7Zgsd2,True,21485734,5371433,33378,16689,16689,4BnQKPLuE3DMTtxp8MjUBytgnhvxqq3ZTqZHTVZo4JJh,1335155,8373021,-7037866,621
2022-01-21 07:10:05-05:00,4572,AvwHizRhHUSahmvSg4jmTUErc7vAFSmkRAEsiKhXfW1m,3UrWYx8y9N5o9GYneSe6zyyHRTZzxwvcipQfHHYh7tEs,True,998862,249715,1516,758,758,4BnQKPLuE3DMTtxp8MjUBytgnhvxqq3ZTqZHTVZo4JJh,60641,469054,-408413,607
2022-01-21 07:10:05-05:00,4573,7feC64HZfQpniey2iXsMMgQXnfcunJus74DiKDeKaEUw,GstsCxAiBBEUrXNkvZZ9Sg4vNK916PsKe2Mx6e4M6dU7,True,2151285,537821,3296,1648,1648,HfEnetJ7uBSmZWCjBNxdvv9HEC5nsW4wDV7wu6WnhWan,131854,980382,-848528,612
2022-01-21 07:10:05-05:00,4574,pgzvXpnUYiY7hLrfjmwScqLd8oj9vYcXpFvpm4y4JvG,GdqdQgoyBAFuXdbvoZyDhB3jyqJzVo4nkGh7EPFxkBF2,True,575878,143969,901,450,451,4BnQKPLuE3DMTtxp8MjUBytgnhvxqq3ZTqZHTVZo4JJh,36043,599288,-563245,625
2022-01-21 07:10:09-05:00,4575,J4krKPBBTMVLZRgrSeYJAMyHQs2FkNm5TXk7nQWwDB43,ASmLbfNbhTD2HHeV7qzAqiHjUx5a8Traj8oPDwbkMdFg,True,7724414,1931103,12086,6043,6043,HfEnetJ7uBSmZWCjBNxdvv9HEC5nsW4wDV7wu6WnhWan,483456,3769486,-3286030,625
2022-01-21 07:10:22-05:00,4576,CvZssqscu2dm35mwcE3zg9zedavbRjVJjWD59Py5ExUK,7pXaoR6aHKYofCmg1eHipygNYDteEaf8rbbS8BDYGQK6,True,191056,47764,297,148,149,4BnQKPLuE3DMTtxp8MjUBytgnhvxqq3ZTqZHTVZo4JJh,11889,91728,-79839,622
2022-01-21 07:10:22-05:00,4577,brCL9pzP6q4b6rKgAH1AJbMoqffBWyXLX8oAnZDoi77,Dx4G5UP9jTb47JQypWJnv48mPTzhJvqPD1BtBtDT7TJF,True,2205996,551499,3448,1724,1724,HfEnetJ7uBSmZWCjBNxdvv9HEC5nsW4wDV7wu6WnhWan,137933,556939,-419006,625
2022-01-21 07:10:22-05:00,4578,51yPLtXTgL9oLKs1cCf5TjL54Ld5vuVxat2NNtwZVsZG,7UjtM7Z1tiXEQMMiorQyncgi9SKu3v46DhVdgXbWqSiF,True,96840622,24210155,151208,75604,75604,HfEnetJ7uBSmZWCjBNxdvv9HEC5nsW4wDV7wu6WnhWan,6048327,97237834,-91189507,624
2022-01-21 07:10:22-05:00,4579,3EmGvYu72cR4Ta3wLA5HKZBEqgfChCyiRanwj5hGLJXc,6NEWPFaKi5uLsrj4n6RM1DBhQTcGFE9TwYeJ12pC7yyp,True,10826,2706,16,8,8,HfEnetJ7uBSmZWCjBNxdvv9HEC5nsW4wDV7wu6WnhWan,676,5744,-5068,624
2022-01-21 07:10:25-05:00,4580,67Z7ZGhNu5xxEh9BYKWcXp9m1T4tFiE1o1M16hCzUWQA,CT7YKWixz7BhTbvg5F6M5HCyPGnHoFLNFuDV9GhoLTo3,True,886995,221748,1384,692,692,HfEnetJ7uBSmZWCjBNxdvv9HEC5nsW4wDV7wu6WnhWan,55374,627011,-571637,624
2022-01-21 07:10:33-05:00,4581,7hTjPRQSYAoWHhtpsVz2oKK5SAuFJd8dPHShKgKJq8dy,6DcHcrtcXR88d8e2KahhAiWTeRznNfF8oXLHmh5wE7wz,True,369364163,92341040,573058,286529,286529,HfEnetJ7uBSmZWCjBNxdvv9HEC5nsW4wDV7wu6WnhWan,22922322,169368714,-146446392,620
2022-01-21 07:10:33-05:00,4582,ApAgbKGyEYXRonGM33w56ZxHQNAGSd9ji4K3zAGN2yA8,FZAhAUDtEaNsFmh4fP8uXNjoHneNkpZ2wQCfEeU4RYRM,True,27574737,6893684,43008,21504,21504,4BnQKPLuE3DMTtxp8MjUBytgnhvxqq3ZTqZHTVZo4JJh,1720336,13376071,-11655735,623
2022-01-21 07:10:34-05:00,4583,2jDRvE3pQNjWy1NRFa4tzB3KmU5UkbUCHw8sQRFujo66,C4zNi2szDrEEh4coTF3WRUghfP4ZwAVVSYTLWfkejQRu,True,184219152,46054787,286994,143497,143497,3uL2NSR2ZdDqCiKfzA5SwwpddAnit22DBJo6uvvz1rRs,11479798,83456891,-71977093,623
2022-01-21 07:10:40-05:00,4584,CbhrZUdan1axNDFUrX1ZuEohfNMEGrszKSkk6pppVQuw,DHEAjJNtuEePezYAv77thWabbVxxqQpfuiC6moRSrpG1,True,35771462,8942865,55686,27843,27843,DddJ7EWCmYEEZETCBNgAUSg81Ls6fZtiAaY5ekJ5sXx1,2227470,23404675,-21177205,622
2022-01-21 07:10:41-05:00,4585,Ckqos6cdncPKj13DnCmDVZsZTqp6eS7277CRrT9WhcEr,AtUV8m7VQJvZq7GLCAHMf3jV7iamKEPnWVZHWuuVZQp1,True,338763,84690,527,263,264,72FwbpFGoLEazJEdpqNtPNefsadUrimUqma9wSoy4qiS,21087,250499,-229412,622
2022-01-21 07:10:42-05:00,4586,M69XSefqeum2arinvHEqmA3L2XHWNFN17p4msRhRZXf,2vK15yYUANLSbAoiBfgJ9VLyqsmtEpd2iNytQjms8GaQ,True,73933703,18483425,115551,57775,57776,72FwbpFGoLEazJEdpqNtPNefsadUrimUqma9wSoy4qiS,4622045,57022051,-52400006,625
2022-01-21 07:10:42-05:00,4587,o2aCmkxsxSiyUX8soTEjwUCbJeXmCZsEaf8CWwxDT5n,3pvS2bTsUuiQyqZp5rdnTpq4cqWGgtv4E5rN9HsBxpRt,True,6519,1629,10,5,5,4BnQKPLuE3DMTtxp8MjUBytgnhvxqq3ZTqZHTVZo4JJh,407,2581,-2174,624
2022-01-21 07:10:44-05:00,4588,DGAQzgZhS2yioeZmG3cbacM3hdz4F1aZn1PWRwgiFukc,48KUtJaNCPNxkLXJBtWAdDxY4b9vZzLgbGxTNdwMqmjz,True,142591975,35647993,221213,110606,110607,DddJ7EWCmYEEZETCBNgAUSg81Ls6fZtiAaY5ekJ5sXx1,8848533,83093073,-74244540,620
2022-01-21 07:10:46-05:00,4589,9vcKW1GfrDZ3KLPh2pEVFF8ZyKqD1pJW1hiE8H98Av7S,C6Ki27mo4sCHu6u8UnR1p7WSgsTjFQxGGR9Lk9n5Rhjq,True,757450,189362,1164,582,582,4BnQKPLuE3DMTtxp8MjUBytgnhvxqq3ZTqZHTVZo4JJh,46569,459107,-412538,614
2022-01-21 07:10:47-05:00,4590,C1CsbgQFvEvSXzuVHTr39tQHr3drDhjxeYiotd8eNocF,4rAaTCAMj5VpgNVKiYizabH7cMLhEA12seu2QXQNTyV3,True,24442590,6110647,37937,18968,18969,3uL2NSR2ZdDqCiKfzA5SwwpddAnit22DBJo6uvvz1rRs,1517503,6845424,-5327921,620
2022-01-21 07:10:50-05:00,4591,6nJyqvFKprwaVCE1gAa2P4RHKc6Pa6XFSJymx654zZ9K,4e7iJmdwzAPxp1Zi8Azo38YyPQdPKqqY4VLJyQ5rpdYP,True,679086,169771,1038,519,519,HfEnetJ7uBSmZWCjBNxdvv9HEC5nsW4wDV7wu6WnhWan,41530,432941,-391411,611
2022-01-21 07:10:53-05:00,4592,DdAPWdHnb7ocaYtcwwwYnppsH39sZpmzMyANeoJbCV7s,3BVmC39L8dEypPN1BZhsf9bx9Ge2sXCZR8Y6RH4eBNMJ,True,286806838,71701709,439299,219649,219650,3uL2NSR2ZdDqCiKfzA5SwwpddAnit22DBJo6uvvz1rRs,17571977,249424210,-231852233,612
2022-01-21 07:10:53-05:00,4593,8sneA6wAg6geVDJ1g7YWg4R1PfjuRVzeHp1nUBJinhZa,14i1uWtmcTjrdbg3DSr9vzd5NBnxqsn1A4QdgFBZqeYM,True,82181,20545,128,64,64,DddJ7EWCmYEEZETCBNgAUSg81Ls6fZtiAaY5ekJ5sXx1,5122,40003,-34881,623
2022-01-21 07:10:54-05:00,4594,4cKgCTttVp8pzJnp43PP7uLLUXNcU7YGPJ3cCGHaUFe7,BBQqjwTpVEgpDzMk4wDDH8rCjaSxCRPWVhtFxERSujTD,True,11026679,2756669,16916,8458,8458,HfEnetJ7uBSmZWCjBNxdvv9HEC5nsW4wDV7wu6WnhWan,676675,6022390,-5345715,613
2022-01-21 07:10:54-05:00,4595,6oroGB3mvzK3tDfiB9X2NJuL3x476pxhgRnt7VxqhdLo,2SoK8tKkLn2ppKURpTVazKsCEis4uahkHMsac1m85J4r,True,488344,122086,758,379,379,DddJ7EWCmYEEZETCBNgAUSg81Ls6fZtiAaY5ekJ5sXx1,30359,492215,-461856,621
2022-01-21 07:10:54-05:00,4596,2s9VGesQYbKr3LwuraMEa9sXbXz7f8299HPPAHgSaUdp,8uMS2GDsbmygjbRnc2gjwNkXKogmJX1i8nchmqt8ixCe,True,12203443364,3050860841,18979688,9489844,9489844,DddJ7EWCmYEEZETCBNgAUSg81Ls6fZtiAaY5ekJ5sXx1,759187546,6760194723,-6001007177,622
2022-01-21 07:10:54-05:00,4597,5sN3cfz4hZjwy2HkAStKWeL8wHhdbkW8F7USzwCzmggh,Fme7U7QY92biAsV3RR2Fj7rJPnpdcov13mmFhVDFuyYG,True,194972937,48743234,303885,151942,151943,DddJ7EWCmYEEZETCBNgAUSg81Ls6fZtiAaY5ekJ5sXx1,12155416,100640909,-88485493,623
2022-01-21 07:10:54-05:00,4598,JDeYjCLpfnzcfxDFgHf4aBcHsajwdR14GUaKAA9euzVf,EJbvKoyMZcoCx4vWa61uMbW2vr6mUhrgEuECdteVBuZZ,True,3005050,751262,4689,2344,2345,4BnQKPLuE3DMTtxp8MjUBytgnhvxqq3ZTqZHTVZo4JJh,187560,2043081,-1855521,624
2022-01-21 07:10:54-05:00,4599,DdYgcyV1T2CDYiQVr4VL9Ym8RdKm93a7SKy8HxuyaoMW,GPdAeqeXb1UJ56AttcwwY1CyFhRyfptDC4BAX2Tc8MpE,True,143254,35813,218,109,109,HfEnetJ7uBSmZWCjBNxdvv9HEC5nsW4wDV7wu6WnhWan,8738,90720,-81982,609
2022-01-21 07:10:54-05:00,4600,CRaKcudjkQiSw5YPVjTLVdXvJskeGiHSYtq5ZcMPJhgQ,AgqTg3b3bAcaBmRidhNC4Uf9ZwNbeH52RQEqumWyuUs7,True,235960,58990,359,179,180,72FwbpFGoLEazJEdpqNtPNefsadUrimUqma9wSoy4qiS,14380,174790,-160410,609
2022-01-21 07:10:55-05:00,4601,FS5xx53Bo65G21gJLta7LEEiS132VJM1kGpUzuqyfzoy,2kbTLjdBBA9K1coxKmwmYbjq2heSnuNg4Nh2EfVNYgwj,True,114714556,28678638,176214,88107,88107,72FwbpFGoLEazJEdpqNtPNefsadUrimUqma9wSoy4qiS,7048576,32751229,-25702653,614
2022-01-21 07:10:55-05:00,4602,2hirR46fpyHEg1Fv9vAzYgnoNRBWaky7LoFGVof4DnpK,DXTEHauVDdz4Mjjj6sJHPUh6TnzU6ob6Nj63To2vCNPW,True,613775984,153443996,935824,467912,467912,72FwbpFGoLEazJEdpqNtPNefsadUrimUqma9wSoy4qiS,37432992,138157008,-100724016,609
2022-01-21 07:11:00-05:00,4603,HVZkXeDR3mc8oB9qFFwCK4RXpPojdcHk9tRGep6xtKGK,Bh3py7awPejWqeTMxtAgF7mPotL2Asxf8YrYJykq9nBt,True,1796390,449097,2782,1391,1391,4BnQKPLuE3DMTtxp8MjUBytgnhvxqq3ZTqZHTVZo4JJh,111280,987788,-876508,619
2022-01-21 07:11:10-05:00,4604,8627qmFevGS1LSDyCgoJjbURcf8CjVFCcxE7U9mWVP5f,3sgQuNcZuGV59Q9apxSBQcV1XAa6og6xa8FLpumvN7iZ,True,10923,2730,17,8,9,3uL2NSR2ZdDqCiKfzA5SwwpddAnit22DBJo6uvvz1rRs,683,5887,-5204,625
2022-01-21 07:11:10-05:00,4605,CagSUfZLwXuCdypC4KzU6FSNdmCj9dKDroPcNeaRtsyt,yxw5d1ztZuEUY2QjL7eLpr72QJAj5rJd6ERvg91cy1m,True,440616,110154,681,340,341,DddJ7EWCmYEEZETCBNgAUSg81Ls6fZtiAaY5ekJ5sXx1,27276,219872,-192596,619
2022-01-21 07:11:10-05:00,4606,3qnPsgqW11AcDEmyjmJquPcPLyE3EdJQuVLJ5kinDrd3,86rZadBB7emKio76aFTahpbrFtxd9tqZ4Mxgzaavq2xU,True,43035,10758,66,33,33,DddJ7EWCmYEEZETCBNgAUSg81Ls6fZtiAaY5ekJ5sXx1,2668,23782,-21114,619
2022-01-21 07:11:14-05:00,4607,2jPxG5FL6D6XEJsRszJ9cmQ54AWSpZyPFSbn3DpWBSuM,3toQou4UVNvyWYvMvkuv379RVEF2aN2TzCpKKBUqeQV6,True,52598681,13149670,81430,40715,40715,3uL2NSR2ZdDqCiKfzA5SwwpddAnit22DBJo6uvvz1rRs,3257220,28505498,-25248278,619
2022-01-21 07:11:14-05:00,4608,CBL2NbekJrXvBiAcoj4fzQ4PfLDwTntW7Zt4nruHFYEw,59EvfgYTdKkfjUJz5LddLUAqbEdLaihcMzjcrTZsyzyS,True,2550,637,3,1,2,3uL2NSR2ZdDqCiKfzA5SwwpddAnit22DBJo6uvvz1rRs,158,1382,-1224,619
2022-01-21 07:11:15-05:00,4609,6BQVtmNsxihi4PcA7MurtguTwa6SmbmKyP14RHyjVZkf,7ZFv5ms4HzVKiw7KgE8RUoKxW9rB6JUD7ujZxMx4DwnM,True,903050,225762,1409,704,705,4BnQKPLuE3DMTtxp8MjUBytgnhvxqq3ZTqZHTVZo4JJh,56397,418846,-362449,624
2022-01-21 07:11:15-05:00,4610,GqAS41YJssg9aaEp3hs3sG98APCsXhiQBQszXaSjZ2bN,2wodJ3AhrXdE1T4oVL95KvoBND7PubG5Wd5GWiLCMZJU,True,51742285,12935571,80212,40106,40106,HfEnetJ7uBSmZWCjBNxdvv9HEC5nsW4wDV7wu6WnhWan,3208484,49970928,-46762444,620
2022-01-21 07:11:15-05:00,4611,3C2MZQKh9x4zNTCMbhhvoafGaFMwUooqfy9MCgPyXs6E,AHjgWKpYPWe6ketjDHDKFBFsKQiRJ41jnkuo39MVYxZo,True,57671195,14417798,89470,44735,44735,HfEnetJ7uBSmZWCjBNxdvv9HEC5nsW4wDV7wu6WnhWan,3578810,40698802,-37119992,620
2022-01-21 07:11:18-05:00,4612,EL9JxeMvWWLTdVC5QrZzSSgApEwv1nDhZc6yNmH9G8ad,EqSQLSFx1eKkTYAdv5XhekttqVh7TappXAHuv9EedCXq,True,28527,7131,44,22,22,4BnQKPLuE3DMTtxp8MjUBytgnhvxqq3ZTqZHTVZo4JJh,1772,15403,-13631,621
2022-01-21 07:11:21-05:00,4613,FKQVm9RsteDe7dQmwx4NGYhz3Wrvwh7TCp9rFbTgAomx,Dbwox8eRCdmH5KXyi5sBaqWzhxtaVPo1teWXJ2kRFT1f,True,187962321,46990580,291466,145733,145733,HfEnetJ7uBSmZWCjBNxdvv9HEC5nsW4wDV7wu6WnhWan,11658660,175562658,-163903998,620
2022-01-21 07:11:21-05:00,4614,BLJgLzizx2yLgd12pVBAHTMqn9J5JA3JHCF8PnLnPyUk,HhDmwMysBFWhXnd3mrV31w75WBRKBS8wJSiEMZgqdUSp,True,278429655,69607413,432635,216317,216318,3uL2NSR2ZdDqCiKfzA5SwwpddAnit22DBJo6uvvz1rRs,17305427,160722033,-143416606,621
2022-01-21 07:11:22-05:00,4615,2FEbsetZMkRqLjSC8GBbgecKgX5T1T1fci2sLQux29p8,H722Fcd6DkTFRZxqQWbPDufBfXEgmFfhiEpQZWhxwYv1,True,1316064,329016,2047,1023,1024,4BnQKPLuE3DMTtxp8MjUBytgnhvxqq3ZTqZHTVZo4JJh,81885,666093,-584208,622
2022-01-21 07:11:22-05:00,4616,9Hz4p7gcfDbXBJp8KzhaBBPh9i7xe9kun7zLfDtqPe6c,2bJ43Lep6kp6WY7Ct56oiscKnAbdtC265G5yRvRPFThU,True,258746556,64686639,404213,202106,202107,HfEnetJ7uBSmZWCjBNxdvv9HEC5nsW4wDV7wu6WnhWan,16168520,75570589,-59402069,624
2022-01-21 07:11:29-05:00,4617,HGJoZvLakWfSDFwuvShNBc4kCf7nP7VqzyM3mELpbFEf,12Qn5jin7QvsBngXqYAv4UstyG3b6nRf1jsLp9Dp8G7k,True,4420074,1105018,6913,3456,3457,HfEnetJ7uBSmZWCjBNxdvv9HEC5nsW4wDV7wu6WnhWan,276547,2537625,-2261078,625
2022-01-21 07:11:29-05:00,4618,U3vvMQ4X4aKzVYfhMw1V1p58HRqaLnuXozqmmefYeD9,7JA94MArkNCFRhBq8f5a32DgMF6aPdFsoC5HvXDQ6NuR,True,85529666,21382416,133215,66607,66608,72FwbpFGoLEazJEdpqNtPNefsadUrimUqma9wSoy4qiS,5328604,55613000,-50284396,623
2022-01-21 07:11:31-05:00,4619,5rW9kqXB9feGSKSvSMNJF1FCsBYV3vGmTmc8MvzaZ3pi,7AjnjcfPJevW5521hXw4VtgRCfHSsAqyzyArukKfNcHo,True,2993046,748261,4584,2292,2292,HfEnetJ7uBSmZWCjBNxdvv9HEC5nsW4wDV7wu6WnhWan,183373,1920196,-1736823,612
2022-01-21 07:11:34-05:00,4620,DMgD2KCEhTGFLUZ5GnfNcwfiiwKYbyVpoWiN6knMkCAf,5KU2vgBkPTNVHsSULjgX7ZkZS56U3Dy3xqLTxL5sUZJ3,True,388209179,97052294,601637,300818,300819,4BnQKPLuE3DMTtxp8MjUBytgnhvxqq3ZTqZHTVZo4JJh,24065519,287550665,-263485146,619
2022-01-21 07:11:37-05:00,4621,BYvjENe16Ta77PqGV7JKEWrsqCTfkMGYwTSG5gXneDvd,EvxAXgvhPC6QkNurbK7vWyTApGo8J2R4EgMAknkHVU3d,True,841585,210396,1305,652,653,4BnQKPLuE3DMTtxp8MjUBytgnhvxqq3ZTqZHTVZo4JJh,52224,635938,-583714,620
2022-01-21 07:11:37-05:00,4622,E1CShgy7M9998q9jyzpnHZxHJR6z5hvnshUJt37kVPtG,96f1nYW4S9APCJS3TXTGSb9UcJDdxJuoBR3pLYqcNz2b,True,48109890,12027472,74505,37252,37253,4BnQKPLuE3DMTtxp8MjUBytgnhvxqq3ZTqZHTVZo4JJh,2980227,26054976,-23074749,619
2022-01-21 07:11:37-05:00,4623,8MGEQ1KEMv9WSgVifjN7CQ7tDbJBJbWgGYu71dTDKEPQ,mQY2X9KYVXf9JmGY8XwMK4G8odM4HmWkgEmYYqKnkvF,True,46819045,11704761,71763,35881,35882,4BnQKPLuE3DMTtxp8MjUBytgnhvxqq3ZTqZHTVZo4JJh,2870539,29608803,-26738264,613
2022-01-21 07:11:41-05:00,4624,B4Uc39nKzz9wBRQsCkMR4A7RwTJ8rSuwpR6EQn2AesRb,H49bGZgatRZVpj6QufZRVgYrQtH7LpdbiqKBs23151m,True,7044554,1761138,10908,5454,5454,4BnQKPLuE3DMTtxp8MjUBytgnhvxqq3ZTqZHTVZo4JJh,436324,7424154,-6987830,619
2022-01-21 07:11:43-05:00,4625,54grbLQHZsNK4qTyXb8kXAU12Af9QUNFMujuzLLHHHef,3Ua1LDmZfPxvpaCp45RJ5xn3ovNuMxyWGrxnLcsK2ko3,True,435586345,108896586,681438,340719,340719,4BnQKPLuE3DMTtxp8MjUBytgnhvxqq3ZTqZHTVZo4JJh,27257559,224497938,-197240379,625
2022-01-21 07:11:43-05:00,4626,AaMCg49sJwNtdB5wHACg15TYAzzJXy8xtG4zuVXhKiVE,HbDYqDa9bewGPvsiaHRM9HmEvh1scPaUaGvqog66gYir,True,44571027,11142756,69498,34749,34749,4BnQKPLuE3DMTtxp8MjUBytgnhvxqq3ZTqZHTVZo4JJh,2779933,14451306,-11671373,623
2022-01-21 07:11:43-05:00,4627,FV9CBGGTbppLnBKh79f2LzD1diTiS5g6u89FcpZHZmnK,Fe7mtmCUziFqbbYTvrhAcAq1Ub7YLfTJRtQ1hG7GzJD1,True,1481162,370290,2297,1148,1149,4BnQKPLuE3DMTtxp8MjUBytgnhvxqq3ZTqZHTVZo4JJh,91886,749519,-657633,620
2022-01-21 07:11:43-05:00,4628,BrHRMouGRz3LBNzd9anfdYMhWfg8yUPHL4PqJ8WdEDFS,4uzoLa3mC2VYHAPBoHLX4gTjPTC28rPf2fvEGtJWPYc,True,16563541,4140885,25469,12734,12735,72FwbpFGoLEazJEdpqNtPNefsadUrimUqma9wSoy4qiS,1018783,15920250,-14901467,615
2022-01-21 07:11:43-05:00,4629,CwTus4FyoXYqyTKAYDp69NLhA1joYZ3tarzY6FFTr6fn,6ivuvYWU6i25MzJSY8rG9rPDKiq38E6QtrV1jvRubLGr,True,2851,712,4,2,2,4BnQKPLuE3DMTtxp8MjUBytgnhvxqq3ZTqZHTVZo4JJh,177,1601,-1424,620
2022-01-21 07:11:43-05:00,4630,3WcJUt8jQ1ngL3ZCGo6dFrc3GmTMTYtzeDva7mri2Tqx,HeG1Pz2oMjqtkfsRMsbqP3VpatnVEQzcWmKDVoFp4Htr,True,4419637,1104909,6892,3446,3446,4BnQKPLuE3DMTtxp8MjUBytgnhvxqq3ZTqZHTVZo4JJh,275691,2537203,-2261512,623
2022-01-21 07:11:44-05:00,4631,BPsM1um9ZJf7eNoVMsQCRSwgARMuLCGGSDxf9tZeNeEy,BpzDdXfxVygiSYSmsHV6uPxQMeTFtrURMCCqhswQjd5X,True,328194,82048,507,253,254,HfEnetJ7uBSmZWCjBNxdvv9HEC5nsW4wDV7wu6WnhWan,20313,167221,-146908,618
2022-01-21 07:11:44-05:00,4632,6rb3fRVWJ5cSzFcmuC1YwdrNxiNctvboDF7HwsfyGoCA,H6JaYfFZkRk6iSJrA4nVeuFpMVQtVwQZHVgK1TyaupTE,True,11815,2953,18,9,9,HfEnetJ7uBSmZWCjBNxdvv9HEC5nsW4wDV7wu6WnhWan,733,10982,-10249,620
2022-01-21 07:11:44-05:00,4633,96StvqZyFUPtyMr4o9s7K4V29RSNyRpVi76vNwxG5rUf,GZKXFSFq4aGiTaqovtxqNCCVGkAFNXPh4Hep1ZMwdZ8g,True,6286148,1571537,9760,4880,4880,DddJ7EWCmYEEZETCBNgAUSg81Ls6fZtiAaY5ekJ5sXx1,390416,6409576,-6019160,621
2022-01-21 07:11:44-05:00,4634,FF8rqfM9PTEjYiVFy8jS81weDRwdaYooux2uSa2LexrJ,JBk1JghH1gged1YpDbkczFXP9ka5ivYSkaYoVbbXD4kg,True,51066250,12766562,79044,39522,39522,4BnQKPLuE3DMTtxp8MjUBytgnhvxqq3ZTqZHTVZo4JJh,3161785,31189444,-28027659,619
2022-01-21 07:11:46-05:00,4635,Cs2YxkuqBK1kjoYZbUZdUcxapPbv8oC75trwGgWoCPfG,2PgHQM1GhHykE4bQ1ggueAw2Zs1BFUW5hxvMvr8DojKM,True,15472447,3868111,24192,12096,12096,4BnQKPLuE3DMTtxp8MjUBytgnhvxqq3ZTqZHTVZo4JJh,967684,10834118,-9866434,625
2022-01-21 07:11:46-05:00,4636,5yPGvUz6JWKjkViGwTCpygJii1rP2xv5yx146ULtBiYq,FMnHUCQWTf1UHu5qVFqUAsWh8aba9EQYTEoiXy55totD,True,1321689996,330422499,2046139,1023069,1023070,4BnQKPLuE3DMTtxp8MjUBytgnhvxqq3ZTqZHTVZo4JJh,81845569,304615573,-222770004,619
2022-01-21 07:11:46-05:00,4637,6Bq55LtGCEeGqh4JrFLCmmGc2iJfTTBJixivqH78aGSE,DSNrCgWJeNe2P9tAQu5FvCueTzNKDKds7wzuwTQSMRG,True,1870005,467501,2907,1453,1454,72FwbpFGoLEazJEdpqNtPNefsadUrimUqma9wSoy4qiS,116302,933095,-816793,621
2022-01-21 07:11:46-05:00,4638,8nXbrdjjaHB73CRPRenGEQj73wbtEFGDwXsehRGMhsap,43pvdcJ6f27wz94D6ZboKwRJYbyvYCrjsJhYsvk7LJCM,True,17553052,4388263,27249,13624,13625,72FwbpFGoLEazJEdpqNtPNefsadUrimUqma9wSoy4qiS,1089989,4930531,-3840542,620
2022-01-21 07:11:46-05:00,4639,BJV5jbowrbELXfDvfMovaQy4PiRf12pLYHimW9bgzW5X,6WXrWso5FvLx7RMCFBzrbzh5qevKkk2LJAihUfWXxXzB,True,5892219,1473054,9118,4559,4559,72FwbpFGoLEazJEdpqNtPNefsadUrimUqma9wSoy4qiS,364728,5703664,-5338936,618
2022-01-21 07:11:51-05:00,4640,ymyzGH4Qc7HH5PbKpVphCbsQgLLXyGkPcXamQJuNj5C,8oTLHaV2XzbKXNWRuUjCfHjUn61Pw93LYK14m9q2VDpZ,True,3743624,935906,5797,2898,2899,4BnQKPLuE3DMTtxp8MjUBytgnhvxqq3ZTqZHTVZo4JJh,231919,1872670,-1640751,619
2022-01-21 07:11:51-05:00,4641,9ebpuMtXee3DSx4qWiEYEtTT1gK5FqCY2H5yQVWWtTts,9b71dTsTYD1bx6KsjFs5h6d3Jj4T9eX3nqmS7RQj3HS5,True,82407613,20601903,128952,64476,64476,4BnQKPLuE3DMTtxp8MjUBytgnhvxqq3ZTqZHTVZo4JJh,5158088,44455649,-39297561,625
2022-01-21 07:12:10-05:00,4642,GjQQ2fQ7mrGjWZwjVYFUKp9NM1LmfkhEo675ovU5SPa8,ECgVUMRY5nB4MALs5drDyipF7YohCPuJpj2UegCs7HMn,True,6149519,1537379,9601,4800,4801,DddJ7EWCmYEEZETCBNgAUSg81Ls6fZtiAaY5ekJ5sXx1,384041,3259053,-2875012,624
2022-01-21 07:12:11-05:00,4643,5NVD6QvomTAD35yNxSFZw4DhF2hCtV8drkbnGhBVtK5y,3JzkyPnREvoFZLL9JZuuDEnee3nuKcrqY3xLuXsmHwRo,True,16257807,4064451,25409,12704,12705,4BnQKPLuE3DMTtxp8MjUBytgnhvxqq3ZTqZHTVZo4JJh,1016373,9753566,-8737193,625
2022-01-21 07:12:49-05:00,4644,CP2qcTSw1Y5J7jZiEgbtsvJoigRbJ4m9oHGQS8Fiai2x,7Zd1uX1thbuGkp9H4r1t8aLTu9W8MxvUBNjji2FNJa8E,True,11040338,2760084,17263,8631,8632,DddJ7EWCmYEEZETCBNgAUSg81Ls6fZtiAaY5ekJ5sXx1,690554,6022610,-5332056,625
2022-01-21 07:12:51-05:00,4645,F9s8a7Cpiw5dw3a2aNFMofqwyDWNXvDLnSdJzoj1gRiV,GpKsQKJD79KBRWdCTkyi4zX7NaoCWsLUjrKxAwJB6o6s,True,8119694,2029923,12568,6284,6284,4BnQKPLuE3DMTtxp8MjUBytgnhvxqq3ZTqZHTVZo4JJh,502739,2567758,-2065019,619
2022-01-21 07:14:28-05:00,4646,AWvHDdb2ikqV8wc7qQ8azbvNTZdixMNxhQjhQdhayYtR,9EpgEPBb1nog6aQeFdMXfSRiLSnzGQFQ39mbLdCxgYTv,True,17826640,4456660,27748,13874,13874,HfEnetJ7uBSmZWCjBNxdvv9HEC5nsW4wDV7wu6WnhWan,1109936,6881352,-5771416,622
2022-01-21 07:14:28-05:00,4647,5eMLdQ4gYA5iqvTXSNdGvctHp7s5VpyFuwtJKqx6chBc,Ckxc5K39nkBNXBTmFTM8J48R7wGqNm3vHKZu4G5baumZ,True,126275020,31568755,196873,98436,98437,HfEnetJ7uBSmZWCjBNxdvv9HEC5nsW4wDV7wu6WnhWan,7874929,53476674,-45601745,623
2022-01-21 07:15:08-05:00,4648,Br1j5Ftafei7ysu5SmqVZSoRe4uS4qCPeKSPHg55pyiE,G8fc7QvXjfkgBFvAVUgJFQS3VaF1biL9rktBExGa87Ks,True,2662764431,665691107,4158577,2079288,2079289,DddJ7EWCmYEEZETCBNgAUSg81Ls6fZtiAaY5ekJ5sXx1,166343083,1143909614,-977566531,624
2022-01-21 07:16:15-05:00,4649,7vKmhLV45Q5etXhJL5ng8rxWhYSiUCDmAbGnwBPr7zcx,cP6xPeuHLnjr858QK1F9qYn7rJpEbPy7wEJHoju6oV7,True,9504228,2376057,14873,7436,7437,HfEnetJ7uBSmZWCjBNxdvv9HEC5nsW4wDV7wu6WnhWan,594959,5275729,-4680770,625
2022-01-21 07:16:15-05:00,4650,89CkXnSZnr52Zsoh48efv9MQacrkB6GMtrbEpNJSyA2H,HcvRBS4Z22CpYgDNgm4TVF4AVXFDuYzBUAFcdHAwdpg4,True,658644,164661,1029,514,515,4BnQKPLuE3DMTtxp8MjUBytgnhvxqq3ZTqZHTVZo4JJh,41172,361361,-320189,625
2022-01-21 07:16:15-05:00,4651,BJaaH1SK1pF2kZQzmYpLFfDtm52CR9a5rd39RAPtLe8q,HUsT5FVxaisdnCvG1BQxX6zffjfL2Rwx5mMo5y8SDV7e,True,27436208,6859052,42710,21355,21355,HfEnetJ7uBSmZWCjBNxdvv9HEC5nsW4wDV7wu6WnhWan,1708439,9285015,-7576576,622
2022-01-21 07:16:16-05:00,4652,Ar5QB4VBcUyzSCG23z2QNAbrWY55NbHCr1MNN6P2GAmh,BusFGTiDrJmxzwGUxWz9b3SFF3eseqtgh2DRHqyAwyVe,True,101636,25409,158,79,79,4BnQKPLuE3DMTtxp8MjUBytgnhvxqq3ZTqZHTVZo4JJh,6353,58265,-51912,625
2022-01-21 07:16:16-05:00,4653,Bsr6kx1B6BSEd5UnJ7Z61M49iUb3bFrDVhiEtMVtPDF2,3CFd1pUJAJPA9fobwn4Jj2mRju1CWmoop4Mh4znypNWT,True,11276513,2819128,17581,8790,8791,4BnQKPLuE3DMTtxp8MjUBytgnhvxqq3ZTqZHTVZo4JJh,703248,5129031,-4425783,623
2022-01-21 07:16:18-05:00,4654,AA6QgBaH9F8QfPT9xjztv9uELcADPxwUuXofkBV8dYg4,FCMXozSstTNA74FVCJ5hpYvNJamjutnoakHoBVnzwcWj,True,5841,1460,9,4,5,3uL2NSR2ZdDqCiKfzA5SwwpddAnit22DBJo6uvvz1rRs,365,3451,-3086,624
2022-01-21 07:16:30-05:00,4655,EhANPABkSw9x9WnsDEi8pCg67iQTX2UGTTUpyjADTwdN,4FKLi98hyg9ZjM4MY6ctJsv7B6vPUnTYWdhrnNoYsztX,True,2201488,550372,3417,1708,1709,4BnQKPLuE3DMTtxp8MjUBytgnhvxqq3ZTqZHTVZo4JJh,136706,1478362,-1341656,620
2022-01-21 07:16:34-05:00,4656,E1wp3bmkcY3eiEYyGYwhTCsr7BZ7RfPa5DJTZFupcFwj,452hVdYkD5SDDrA6hv6DLPFvyS8PvR2P6DPNScGxWTsW,True,176826,44206,271,135,136,4BnQKPLuE3DMTtxp8MjUBytgnhvxqq3ZTqZHTVZo4JJh,10855,101276,-90421,613
2022-01-21 07:16:35-05:00,4657,GaEpNGa8jnwSRvjzzEMYkZe1pKcr2eiZtePrqFxpABjB,5CFZHuyWbJv14zPdX5dSQDREgHrCb4vsFvB6hLiEe3Ji,True,33427,8356,51,25,26,4BnQKPLuE3DMTtxp8MjUBytgnhvxqq3ZTqZHTVZo4JJh,2053,18521,-16468,614
2022-01-21 07:16:35-05:00,4658,3REbHhGGpn5b2GH67yQy2Dn7ZLNGLfM6hkBNU8UE1BRm,FBeCamJw884cPNpzbzhjSF7CFXyyhjnj3qWWCdBCK1NP,True,1301758,325439,2000,1000,1000,3uL2NSR2ZdDqCiKfzA5SwwpddAnit22DBJo6uvvz1rRs,80018,391934,-311916,614
2022-01-21 07:16:35-05:00,4659,3tmdrjoBp8JsjUxZ87Fqjwsfmow5pjYjRyuYdvtjwK2D,uhC85HiGrbC8fBsU227msvkzEDAcY2EDAJcYoBR31Qg,True,23713449,5928362,36434,18217,18217,4BnQKPLuE3DMTtxp8MjUBytgnhvxqq3ZTqZHTVZo4JJh,1457372,18279067,-16821695,614
2022-01-21 07:16:36-05:00,4660,8W9NJfM6cqCsvR1FC8Ab8YZPSQF7bz7inxJZxWnF7GsX,3exfPuVcTnPxs8GwCtS3ruKUGveYymwGV7RXQssPiizJ,True,86322025,21580506,132452,66226,66226,4BnQKPLuE3DMTtxp8MjUBytgnhvxqq3ZTqZHTVZo4JJh,5298085,83176060,-77877975,613
2022-01-21 07:16:36-05:00,4661,Cb4zhnvig11U4GcC4kqKrnDicGgPhUpfDQB1U7hP3nPa,DiRAMrKqaevGXeXg38KnhaYBERj8tNKU7oWFJvhS32kw,True,44232,11058,67,33,34,3uL2NSR2ZdDqCiKfzA5SwwpddAnit22DBJo6uvvz1rRs,2715,21839,-19124,613
2022-01-21 07:16:37-05:00,4662,X5SF9srgzDgBRBhv8xUWyszYYSQiqFF6cVnVLWzQgp1,7rTqnMkPuUUJFt5px1DxwsUK8U5fQUtnx9N4v6dA4vGb,True,7254,1813,11,5,6,3uL2NSR2ZdDqCiKfzA5SwwpddAnit22DBJo6uvvz1rRs,445,4057,-3612,613
2022-01-21 07:16:37-05:00,4663,i7TcF4weYcqgrRdH3GpndbEYxCxfcSfr9JWYrAUg1CF,BkDfknUir7PnSEW8auoB87PytycEFwyX5kT2GY4SGJJL,True,1159355,289838,1779,889,890,3uL2NSR2ZdDqCiKfzA5SwwpddAnit22DBJo6uvvz1rRs,71189,1138871,-1067682,614
2022-01-21 07:16:38-05:00,4664,DH6W3oB22rPJj7PPrey3Rgtn8Tz8kFKQjftajzUFBeKK,5gNsQSAUq8yFVt3FtU854NfuvFQaaCDC6oAqKA6hoZ3F,True,11207056,2801764,17186,8593,8593,3uL2NSR2ZdDqCiKfzA5SwwpddAnit22DBJo6uvvz1rRs,687472,5510053,-4822581,613
2022-01-21 07:16:38-05:00,4665,2PzBAkdXkrwH9VuoMALumQz86qkW7sSBQtCrHw14JUp3,D5vwWAMHVooobG2sCWv9EwtJrAFZG6cwKH4dfmA98tbt,True,570315,142578,873,436,437,3uL2NSR2ZdDqCiKfzA5SwwpddAnit22DBJo6uvvz1rRs,34935,319801,-284866,612
2022-01-21 07:16:39-05:00,4666,2iG781tfP9H77hcFimqp5X9KB9QsbVkQVS9q7emJAJXX,5XDdJMfPSs8WwZZgEtv22RQXEbg748ia4gGfZCy1n4jy,True,3274396,818599,5016,2508,2508,4BnQKPLuE3DMTtxp8MjUBytgnhvxqq3ZTqZHTVZo4JJh,200670,861188,-660518,612
2022-01-21 07:16:40-05:00,4667,HutRztBianNUgm9sJDWKUQBmoVyy8y7CfnNk4hHjSkEW,EtVfvPyiy5bizbCZxR19TNUgETf3QcmziBvMtc6o5zjr,True,54092189,13523047,83792,41896,41896,DddJ7EWCmYEEZETCBNgAUSg81Ls6fZtiAaY5ekJ5sXx1,3351697,55031613,-51679916,619
2022-01-21 07:16:40-05:00,4668,2NHv3c4ufYGo3xNr6KXymAZJdpfURrNiCKbXZ7s82Vwo,E4NYpYgHTvSG6LqH2bBV9Q1XJ6pAzCp9FLSKMzJmYRrQ,True,5673972,1418493,8778,4389,4389,4BnQKPLuE3DMTtxp8MjUBytgnhvxqq3ZTqZHTVZo4JJh,351151,3878203,-3527052,618
2022-01-21 07:16:40-05:00,4669,D3mXrJzhHf8qRaoCKLschUxAFoijFCFuT6bmNZH4W7Cj,9E3Xtqw7TncXWnbhAbFJMtuNmP6WS3ooGuptzyzw7UpA,True,12696,3174,19,9,10,3uL2NSR2ZdDqCiKfzA5SwwpddAnit22DBJo6uvvz1rRs,783,9019,-8236,616
2022-01-21 07:16:41-05:00,4670,2BH44k4TYoQSqsSs5EASqJhxpH17Fr8Ahxbg2MAkWa72,HwvvVWpqfN7NDsVYdxbCSbqxSrLCThwnJiZQHh2w2zJb,True,3936,984,6,3,3,4BnQKPLuE3DMTtxp8MjUBytgnhvxqq3ZTqZHTVZo4JJh,242,2133,-1891,614
2022-01-21 07:16:41-05:00,4671,2rCRdyfi65rpxRRmg7knaSb8t55FuPt3h8wF4Fzhy8MM,CLVY5nSG3jTdRo7tRSKgK9DJgW6aswfWKe4tLxzsENmb,True,138236,34559,212,106,106,3uL2NSR2ZdDqCiKfzA5SwwpddAnit22DBJo6uvvz1rRs,8509,69205,-60696,615
2022-01-21 07:16:41-05:00,4672,6h43GsVT3TjtLa5nRpsXp15GDpAY4smWCYHgcq58dSPM,CTgbWridYWnfE5Emwr7qiCEb3LcXHupqeB9zwmddoEqB,True,34802267,8700566,53315,26657,26658,3uL2NSR2ZdDqCiKfzA5SwwpddAnit22DBJo6uvvz1rRs,2132602,32355005,-30222403,612
2022-01-21 07:16:41-05:00,4673,AKxRtcdpi7gWhAuL8ENj7zhgeQezzEXe9TSANE6bQoRA,2YH4vrU9deP8Cu6E8Hzf8GqKG1yVjv5pdz4FE7r5YKir,True,1501657,375414,2328,1164,1164,4BnQKPLuE3DMTtxp8MjUBytgnhvxqq3ZTqZHTVZo4JJh,93149,825670,-732521,620
2022-01-21 07:16:42-05:00,4674,5Z3ZFCA65WoWhm3okRuuziEMi7ajGAEHWUFchzBNba5S,FcomdrWidygkxMKzcsY5xELbmwC652uMci648LMTv7AB,True,2728,682,4,2,2,4BnQKPLuE3DMTtxp8MjUBytgnhvxqq3ZTqZHTVZo4JJh,168,1490,-1322,615
2022-01-21 07:16:42-05:00,4675,EHJXCJ4ZxPY7F1CeDQkXxVCLyTBXAY2ouWMJfKic9EcK,3yxXBa3sJhUhK9auop8niypnuWiasge5waVTM1zzuhU7,True,242311353,60577838,377799,188899,188900,4BnQKPLuE3DMTtxp8MjUBytgnhvxqq3ZTqZHTVZo4JJh,15111992,76743358,-61631366,623
2022-01-21 07:16:42-05:00,4676,9TL17gjvWFdhSJkpXgfnX7fKF9c2hfw59k3g8WUqm8Cb,7TyxFBKG4z5Xv3js3n1gbEWWj1M9KBF7dEmFxjCPGidC,True,40575047,10143761,62906,31453,31453,4BnQKPLuE3DMTtxp8MjUBytgnhvxqq3ZTqZHTVZo4JJh,2516245,18871829,-16355584,620
2022-01-21 07:16:42-05:00,4677,F1JT1p2VuwK4L7zj7NNnZtYiZiNUCcTGKDkgdoX3BZdZ,3BKe4yzTwnnBnvTWP3britpPJ4oAWL7JZJzNLCxjUufS,True,1426,356,2,1,1,4BnQKPLuE3DMTtxp8MjUBytgnhvxqq3ZTqZHTVZo4JJh,89,515,-426,624
2022-01-21 07:16:44-05:00,4678,9rfebymEFqy2SoBoDKKUppZVRPr1zNh6gkFYkmVsqbqz,6pQ3MsewzM8jzKEQG5zJDry8iEMUjGA1UDJPEQjFWTgR,True,1814790,453697,2816,1408,1408,4BnQKPLuE3DMTtxp8MjUBytgnhvxqq3ZTqZHTVZo4JJh,112675,544372,-431697,620
2022-01-21 07:16:44-05:00,4679,7D4rFmGMPKNAF75VRPxHAhSn2wTjiW8jmth1UD22Xqq9,GQ7BrT6vsXu8tHCMm75YdxFR2r9QTCrCUbdPEZBSAg9w,True,10510493,2627623,16146,8073,8073,4BnQKPLuE3DMTtxp8MjUBytgnhvxqq3ZTqZHTVZo4JJh,645872,5086804,-4440932,614
2022-01-21 07:16:44-05:00,4680,3y34hmyz6rsVnpp7d6a9s2Xw9GdezLU1H44HfieG6SGG,9DCz2eyYsrk1Hd5zsSVBhKTV9QD6beym5zB5fH3aA4hE,True,226589747,56647436,349480,174740,174740,4BnQKPLuE3DMTtxp8MjUBytgnhvxqq3ZTqZHTVZo4JJh,13979217,210519609,-196540392,616
2022-01-21 07:16:45-05:00,4681,75ycx5sUFBxDhY1uwuPCW22s2C6BydkJTje7q7zEQFGT,FpEgrVFRubjGK4DRjTqdVbxSECURpn16zfpoC31NbwnN,True,1398586,349646,2177,1088,1089,HfEnetJ7uBSmZWCjBNxdvv9HEC5nsW4wDV7wu6WnhWan,87098,940831,-853733,622
2022-01-21 07:16:45-05:00,4682,GABCjRvhnVZwwR9aZLhkTfaH9xdp2hJK7J6h4kD5VzkC,JabV7oy3dp6jshtccn89ybinAuaf9dHVmKuiEjXDPT9,True,12702987,3175746,19669,9834,9835,HfEnetJ7uBSmZWCjBNxdvv9HEC5nsW4wDV7wu6WnhWan,786777,7167496,-6380719,619
2022-01-21 07:16:45-05:00,4683,6tWqNUhr9XZVB1sc33W8VEo7gbptDtnKzGVvMZ4Xh68n,8NdrSzU8Tc6Ng2o1RWKfXyZb7i8jm6waYTBomq24F8wZ,True,719943,179985,1116,558,558,HfEnetJ7uBSmZWCjBNxdvv9HEC5nsW4wDV7wu6WnhWan,44655,186096,-141441,620
2022-01-21 07:16:45-05:00,4684,DrzTARa7RK8RXoxHZPKCBqYtMC8TAUHRw8SznXRKTa5M,FYANet92VhyXkKZqqBJR4sFxuCftWb68sgQU9VHCdTJk,True,7242,1810,11,5,6,HfEnetJ7uBSmZWCjBNxdvv9HEC5nsW4wDV7wu6WnhWan,445,3901,-3456,614
2022-01-21 07:16:49-05:00,4685,9jdfc9GFTecsdRuTjWFGX13niKKmeBxRgtv5j86uhSnU,HLWMShobjSkaLyXrNjgwVaUGVtbtdUSnr1XjqpXn1bLR,True,64296,16074,100,50,50,HfEnetJ7uBSmZWCjBNxdvv9HEC5nsW4wDV7wu6WnhWan,4018,38692,-34674,624
2022-01-21 07:16:50-05:00,4686,6kbTnDL9xhi1YvPLtFvRmk8aE1HWsxNAEALcQ9kdCJQW,3Z1kmT8dUJJTUqbrCWGSBqV12GHhzcs3ZGKwaXP8gpGW,True,2936369615,734092403,4589596,2294798,2294798,HfEnetJ7uBSmZWCjBNxdvv9HEC5nsW4wDV7wu6WnhWan,183583878,865743463,-682159585,625
2022-01-21 07:16:50-05:00,4687,FX5sizQGZcDCaETDyJ3HbLxFwhu4t9bX6YyQM7cVEo9Z,6EqnCsv1JPjz6JX1yLNcf74rmkuhAUx6Sf35QMYGuuF6,True,48047991,12011997,73504,36752,36752,HfEnetJ7uBSmZWCjBNxdvv9HEC5nsW4wDV7wu6WnhWan,2940168,26219186,-23279018,611
2022-01-21 07:16:50-05:00,4688,CK3ocyWzXQkJJZQmM6bBK4Nv6Rh3UEufjY6DvNU6gJZy,C924o4GY3p2BHLeAbFbe9SEysXqCUyD8sFu2d4NzkAV7,True,1428706,357176,2183,1091,1092,HfEnetJ7uBSmZWCjBNxdvv9HEC5nsW4wDV7wu6WnhWan,87320,717268,-629948,611
2022-01-21 07:16:51-05:00,4689,9ydHRjDWvWV2XqbXKKpeLDh2RV7WnQZWDTi4ahgDjGNh,AiJQBv4a1Z4w2rsRog5WTaKb4dTjAXfAvXcWoW4DztSW,True,13730769,3432692,21227,10613,10614,HfEnetJ7uBSmZWCjBNxdvv9HEC5nsW4wDV7wu6WnhWan,849117,3993364,-3144247,618
2022-01-21 07:16:53-05:00,4690,EV21gv8jEvXtmGDoGRNm5LJEvTBccLMZyVDCLsp54jP3,DGxxoU52aQNoUQcxdvQtv2H5q2PhK6TGkLgNSaFgnZrb,True,979225,244806,1527,763,764,4BnQKPLuE3DMTtxp8MjUBytgnhvxqq3ZTqZHTVZo4JJh,61118,560398,-499280,624
2022-01-21 07:16:54-05:00,4691,96DzqyUxsB1FKWrhLdTdjDcokuus6rbx83gLsghqPPwt,74CWb7SVoSy3ADysEzFEeMiS2fxHJ9gdUF9pzM3E52Gj,True,4250,1062,6,3,3,4BnQKPLuE3DMTtxp8MjUBytgnhvxqq3ZTqZHTVZo4JJh,266,2321,-2055,625
2022-01-21 07:16:56-05:00,4692,EeUACm9TkjHKES5U7Yj1oPhYmcp7R3tvesGBiP8txEzq,3qkmm4aS6EDirEDejmbm5PDw2jpYkC7zKqrMkmgeE5BA,True,50714,12678,79,39,40,HfEnetJ7uBSmZWCjBNxdvv9HEC5nsW4wDV7wu6WnhWan,3174,24711,-21537,625
2022-01-21 07:17:08-05:00,4693,GhV3DChNShu8mGwUUy7VLidabCV6Y2aKdp7cqPynd6Ci,8R8QkgruGRCeE1pjXmn3WjdVDiawNbXFid8gU8BfabZA,True,3911,977,6,3,3,HfEnetJ7uBSmZWCjBNxdvv9HEC5nsW4wDV7wu6WnhWan,242,2112,-1870,618
2022-01-21 07:17:19-05:00,4694,6XHt7CrURSomkQrtVXV5JuKSZY4tQRpUyQKfCDaSTYaD,GCgcmPSDDBsn2smYbpiX3PJybDkQWtufPu4YRsbEEU8X,True,73993053,18498263,115385,57692,57693,4BnQKPLuE3DMTtxp8MjUBytgnhvxqq3ZTqZHTVZo4JJh,4615417,56956105,-52340688,623
2022-01-21 07:17:21-05:00,4695,4MmpDGUTyMcYEqJ1RoZ46AN2BhrBUseHaHqF8AmiTPyD,7HW2YZpYM349HMfW7u4h9ESZ1AXkwN8JcVDTNFzp9aTz,True,26325001,6581250,40852,20426,20426,HfEnetJ7uBSmZWCjBNxdvv9HEC5nsW4wDV7wu6WnhWan,1634083,17613864,-15979781,620
2022-01-21 07:17:26-05:00,4696,BzSJ77zKaqtBk2cEL1XqFL97zTXXMRHmxtkgtXwCc3C,2g4KXTwy2MPSRQ2khNp1o1rn7CradEr9H4ySYKDoSWN9,True,2215239,553809,3430,1715,1715,HfEnetJ7uBSmZWCjBNxdvv9HEC5nsW4wDV7wu6WnhWan,137232,2523888,-2386656,619
2022-01-21 07:17:27-05:00,4697,8BMDSWFtzq9fu1ubVGtSFw8fEaMg1uvJiECuJnN8e1pd,FwkETAXL296CirvQ2AJuSHHtdKsxkZkmXSwZVVHXVDhA,True,28546789,7136697,44504,22252,22252,HfEnetJ7uBSmZWCjBNxdvv9HEC5nsW4wDV7wu6WnhWan,1780168,15469319,-13689151,623
2022-01-21 07:17:28-05:00,4698,4j19AEcDwhtAZrnoDc4epNPmEL1jPpVUMeg7RmQ72Qkb,84WB42AAGbczVE9txZPwXrx4FD5jP87r8QdDzEABTm5G,True,14423718914,3605929728,22340633,11170316,11170317,HfEnetJ7uBSmZWCjBNxdvv9HEC5nsW4wDV7wu6WnhWan,893625348,10239936272,-9346310924,619
2022-01-21 07:17:28-05:00,4699,7nByfyoLmMrzzVHsjxL2FRF72tfW3KiRT27BRGUp4PhP,36SF6NBnUc5wK41yfGCnujpCaCwExR3iRXJQx1WNakyM,True,8723674,2180918,13584,6792,6792,HfEnetJ7uBSmZWCjBNxdvv9HEC5nsW4wDV7wu6WnhWan,543399,2535356,-1991957,622
2022-01-21 07:17:33-05:00,4700,44iCXTAbcJMVscvvJQfTuVqj88V9QDgwXJDmVk7YcFBS,Dz3doggGiqe6rpazVjeA2j3XpRFmqesx7CRKsPAGKEVf,True,12428,3107,19,9,10,72FwbpFGoLEazJEdpqNtPNefsadUrimUqma9wSoy4qiS,776,6831,-6055,624
2022-01-21 07:17:34-05:00,4701,KoCscQ9Q8TZHhmya5KaXBrwUEMTdCkEMRtrhvtgEmiZ,6aZ5AFMFoqf1X64RwAt1J4Yrx4WGGe2JMiEjqnQ2gEtk,True,103386,25846,159,79,80,3uL2NSR2ZdDqCiKfzA5SwwpddAnit22DBJo6uvvz1rRs,6388,36490,-30102,617
2022-01-21 07:17:34-05:00,4702,CAkknoa9UFPMEZ1KWSfqtmnL7ArVNV3HRETLwecuuXP,4cHJYv3dxA6qjcuxUkGRuL7STWobGPKtoHFD4ACUbiWq,True,2296187,574046,3586,1793,1793,4BnQKPLuE3DMTtxp8MjUBytgnhvxqq3ZTqZHTVZo4JJh,143471,1252163,-1108692,624
2022-01-21 07:17:47-05:00,4703,9YEzjb49Awvedv9yNc6LG54SkGBug2RYiJwiUV13mGsS,3H8w5WCD187NWWoZMNUCzUDdxTgqrRJLga8gDzUVXBgZ,True,240630,60157,376,188,188,HfEnetJ7uBSmZWCjBNxdvv9HEC5nsW4wDV7wu6WnhWan,15060,181966,-166906,625
2022-01-21 07:27:02-05:00,4704,7LRBswSEDBjJzQ4YurfTxLydh7tFS2jVn5V95Z6wL7ci,fD41VYGmk66MW46KKb23vAqQvUSDScgXnVdsHhJBZzu,True,25841,6460,40,20,20,4BnQKPLuE3DMTtxp8MjUBytgnhvxqq3ZTqZHTVZo4JJh,1616,16371,-14755,625
2022-01-21 07:27:02-05:00,4705,6WNPf4rFCX74PuyvdmzRFqbxWhguuxTQqBSdnaTVBd5D,9N7a9aiHGQsxFMgVbmWoCF9w95d12xyT7XFAwpHGkTLA,True,330195,82548,515,257,258,HfEnetJ7uBSmZWCjBNxdvv9HEC5nsW4wDV7wu6WnhWan,20619,133428,-112809,624
2022-01-21 07:27:05-05:00,4706,C3k34T2x8fW171coEG9YvoUePvxtHmrQMjVsX1Cb5ZbU,4mh5Tp4Jjh5X3GDERpSMAFgsfYJvysRdd1Nu5oJQ1Dhw,True,5002,1250,7,3,4,4BnQKPLuE3DMTtxp8MjUBytgnhvxqq3ZTqZHTVZo4JJh,313,2695,-2382,625
2022-01-21 07:27:31-05:00,4707,Grw2snBvSDMa7ev2nWZo81WoLfyavmXXxCV1ugHGk5Xe,AF1WVCQcBmXCnWbDx2s62vU99zW1AdhNoqbWvdrbiQVm,True,3395418,848854,5295,2647,2648,HfEnetJ7uBSmZWCjBNxdvv9HEC5nsW4wDV7wu6WnhWan,211828,1799312,-1587484,623
2022-01-21 07:27:31-05:00,4708,Mcbzp1LhZwpfmXTv1pqe9D1jCKHw443j9QKp6tUpzgM,8uforSMAKEih5jHfHp3gCqCvaugtCmhzVfVHA63Akz7F,True,436971,109242,675,337,338,HfEnetJ7uBSmZWCjBNxdvv9HEC5nsW4wDV7wu6WnhWan,27028,294707,-267679,618
2022-01-21 07:27:31-05:00,4709,6AHFxqjtpMsrCJ9E4ofrq4DVbaZSpDqyVMp6bznPqMg9,F3EauaowTvSs4NZ1EpUVonpNMmpMijcWHNi1AiKFZVxY,True,69077383,17269345,107351,53675,53676,HfEnetJ7uBSmZWCjBNxdvv9HEC5nsW4wDV7wu6WnhWan,4294053,17236817,-12942764,621
2022-01-21 07:27:32-05:00,4710,AtKuDfcFXqWUMnRqQpjedUMTb5CQKLc2zoqEAcQpysKQ,9bPFLYp5TDZruLLDXDYYCiPYcD982iF8xt5rfTkqwNsL,True,2439,609,3,1,2,HfEnetJ7uBSmZWCjBNxdvv9HEC5nsW4wDV7wu6WnhWan,152,1317,-1165,623
2022-01-21 07:27:32-05:00,4711,B8kSMCHEX64joQD9EWuQFN15QunybWnKiiE8DuGZyMLk,EkKznVWgH3CLUXJk1uVWZUMvBRVPXakAVDwHXZwfm3bA,True,160469894,40117473,249219,124609,124610,HfEnetJ7uBSmZWCjBNxdvv9HEC5nsW4wDV7wu6WnhWan,9968784,61537937,-51569153,621
2022-01-21 07:27:32-05:00,4712,2NdwSLxsGok8PczpCZj9CVX2BymNU5MvHt7hWfGetg2M,8AQbDXeA6mD9QoZBFJcYbnHvZwKNxzA9CCHLAgdSfTA3,True,2333,583,3,1,2,HfEnetJ7uBSmZWCjBNxdvv9HEC5nsW4wDV7wu6WnhWan,145,1573,-1428,621
2022-01-21 07:27:34-05:00,4713,4mB2DVbQVqVk535v98Cj8SPNg1tTc3DFyY2Q7VBbY645,HXo255k3RgsTGsc4hiP6ZTXUspBTqJ37duQa5eK7tqp3,True,110234159,27558539,172301,86150,86151,HfEnetJ7uBSmZWCjBNxdvv9HEC5nsW4wDV7wu6WnhWan,6892077,54222551,-47330474,625
2022-01-21 07:27:45-05:00,4714,99NHcwD1iaf5FXM3UNb91SjNiiT3HwyQFQMhkGd5ASts,8syAydy52vSQQLzsLXW24BFw4VPeK66Vp3BmAbnHfgod,True,10838878,2709719,16749,8374,8375,4BnQKPLuE3DMTtxp8MjUBytgnhvxqq3ZTqZHTVZo4JJh,669972,6276496,-5606524,618
2022-01-21 07:27:54-05:00,4715,3axqGcX5yuJ2vGxRjtNguefXUvSQHDQmn2zskhyCuQkf,EYrZo9zZDaHqFdc1fam63W3jvqqmbU67wzp6yFcppwsL,True,5884379,1471094,9101,4550,4551,4BnQKPLuE3DMTtxp8MjUBytgnhvxqq3ZTqZHTVZo4JJh,364065,5869177,-5505112,618
2022-01-21 07:27:54-05:00,4716,GxFxvEUdWofneMmVvhCSScH9V6Zia5WJ2J9q6CpPnaq3,ATLykiHDii3Lw53MoZXwqu1FbBNPJbVNVGe2SoQMjVmY,True,1234909,308727,1916,958,958,4BnQKPLuE3DMTtxp8MjUBytgnhvxqq3ZTqZHTVZo4JJh,76665,741925,-665260,620
2022-01-21 07:27:55-05:00,4717,BmDwvPUjxBakng8ARj7cfjgYJUYCJhLeVnRYXcLDMy4G,8YVEshruc7LMMPf7vrPK9x5eLQGwe7py6bhZoxb9yfkz,True,80430963,20107740,124131,62065,62066,4BnQKPLuE3DMTtxp8MjUBytgnhvxqq3ZTqZHTVZo4JJh,4965269,18584401,-13619132,617
2022-01-21 07:27:56-05:00,4718,4hrm69kAKNcfBkiP2YgtW94Pbip6FLfQAwnDRAAack69,BjbZRdGMoC7Mfoa4H19UvE2eQafgKD5rqnK7BSGwqS1s,True,7420,1855,11,5,6,4BnQKPLuE3DMTtxp8MjUBytgnhvxqq3ZTqZHTVZo4JJh,463,4159,-3696,623
2022-01-21 07:27:56-05:00,4719,C7a8BtMjuLXkzxZBC4Wk2gjkGBmucLmDjokf9pyA1Mu6,GxwYNWwYTtFMUxuZvNC5qrEYuJzYiEURQVuBxssfCJzr,True,335380,83845,517,258,259,4BnQKPLuE3DMTtxp8MjUBytgnhvxqq3ZTqZHTVZo4JJh,20713,135846,-115133,617
2022-01-21 07:27:56-05:00,4720,AVon82fTHT5KeqJkdoG4KkbGoVF3ocK4rqz52umUeEBy,LdgtwakPuhGZCh47WNERa6op7z2YtouJFv4mhFLtVgs,True,27870328,6967582,43301,21650,21651,4BnQKPLuE3DMTtxp8MjUBytgnhvxqq3ZTqZHTVZo4JJh,1732072,23356763,-21624691,621
2022-01-21 07:27:56-05:00,4721,DiB9SeCFXjioNGPJM3GuZ3FCG9KBZhHK27zCSN5b6gkq,GtK8UtKDQy9jgtTXvam4jja9N7c4EFuDQr4TKHgNyhXT,True,885833,221458,1381,690,691,4BnQKPLuE3DMTtxp8MjUBytgnhvxqq3ZTqZHTVZo4JJh,55250,531198,-475948,623
2022-01-21 07:27:56-05:00,4722,2RZPBo8Z2BgZmsASo14ySTSwqqgqmfVEjPkiAwQ1VTgf,BRS5cYtEoPRoSvTAiQaT1svWRdLJWVfy8LUb4SCudCjS,True,1071564,267891,1656,828,828,HfEnetJ7uBSmZWCjBNxdvv9HEC5nsW4wDV7wu6WnhWan,66276,593282,-527006,618
2022-01-21 07:27:56-05:00,4723,3JzquEXUqphLYNmaVQLUTyrD6mJKXDcSSu9m39YCYvHf,Dk8mswH5HnCUmTEFvX4xHhUPk2m8VmgZW344BiNqg819,True,1040748589,260187147,1622135,811067,811068,4BnQKPLuE3DMTtxp8MjUBytgnhvxqq3ZTqZHTVZo4JJh,64885423,497202906,-432317483,623
2022-01-21 07:27:56-05:00,4724,A7HnmwpMzu9yYuvURa1Zct5JUoFujFybc6Ympjciuz99,E41s3xNbU4haxQQjR8nXZwTpJCoLiJ2BJSncHDfc6HzS,True,121584863,30396215,188265,94132,94133,4BnQKPLuE3DMTtxp8MjUBytgnhvxqq3ZTqZHTVZo4JJh,7530634,54679329,-47148695,619
2022-01-21 07:28:03-05:00,4725,8VT2nxz5ZYDJFd9uL2XZwEXxChd9pjuMJNMAcutZubL1,EhAkiRbouzUAWtqQFsN8HEEfi46UVN8H8tyBP7CbgeLe,True,2008,502,3,1,2,3uL2NSR2ZdDqCiKfzA5SwwpddAnit22DBJo6uvvz1rRs,125,1243,-1118,622
2022-01-21 07:28:03-05:00,4726,5hUZ9uQFcYnjAQVVaGLJWdKyg7y1XMpoo8osQ9DeY7Xd,BdYiKWsjuzJLcHh3814mJ4xQ9JxoQKKcr7AHZ7Vxoavq,True,8876,2219,13,6,7,4BnQKPLuE3DMTtxp8MjUBytgnhvxqq3ZTqZHTVZo4JJh,553,5043,-4490,623
2022-01-21 07:28:03-05:00,4727,GZZ8WePhKCrJLhXXvRD21rp79pFiaJeGykVsyeKAYe9W,6P1C9RDFQoFqZ5eFo59UwVnNrnyAWaNnACNQMqR3uJhs,True,311683882,77920970,486426,243213,243213,4BnQKPLuE3DMTtxp8MjUBytgnhvxqq3ZTqZHTVZo4JJh,19457068,75237112,-55780044,624
2022-01-21 07:28:05-05:00,4728,ZoNjrSjYh4NJLW38LUPcf7jtEBxdaaM7T1zp795qjHE,FZx6v8cU25NwEosbKJ2n141o9uFAWURZB7NeCeX1trEn,True,308046,77011,480,240,240,4BnQKPLuE3DMTtxp8MjUBytgnhvxqq3ZTqZHTVZo4JJh,19222,124146,-104924,623
2022-01-21 07:28:05-05:00,4729,Buioe5v3DyFwD9nquW5XdYeVYbSABCyg79eUHEvtvfaW,7T9gi7prCcZJkYJMSB5Ef6Bu4pAuBw4XLvumSFnqKDSi,True,142670,35667,222,111,111,DddJ7EWCmYEEZETCBNgAUSg81Ls6fZtiAaY5ekJ5sXx1,8905,100593,-91688,624
2022-01-21 07:28:05-05:00,4730,8DSiP9CwJm3AEcH6uuAYFpArRRDLYpDQgjHEvjkUgfg2,ERJ8kuhPRRmUAhSM4oxUheh39YUVVYNgaTt6AdMXcCvL,True,322627356,80656839,502946,251473,251473,3uL2NSR2ZdDqCiKfzA5SwwpddAnit22DBJo6uvvz1rRs,20117859,81897046,-61779187,623
2022-01-21 07:28:06-05:00,4731,C4dbwF9mioaBkZnyBFvFs6Cqd362VuGPBGPbTY9CAnAk,CcUqBfu1hbWm5VVxbtF2Xm6HUz4CLFzuDsjUi6KtnZQg,True,358630,89657,559,279,280,HfEnetJ7uBSmZWCjBNxdvv9HEC5nsW4wDV7wu6WnhWan,22392,144308,-121916,624
2022-01-21 07:28:12-05:00,4732,8mbMH9EKd9kQDyFrYiDJCV9VaWxWCzpZBQZLyYN2yNVx,J9gT39dF1egMeQvweXYWeRAX3kpmBABijYZhfj6M2UqU,True,4918739,1229684,7695,3847,3848,72FwbpFGoLEazJEdpqNtPNefsadUrimUqma9wSoy4qiS,307807,2357055,-2049248,625
2022-01-21 07:30:06-05:00,4733,CEbGTNX6WpaoKp4RBGSn9LzYM6yAYyeiMrgVYgJxA4zb,AiXUcGAFFm4tc7vKBscSNjZawV5YJqbv7D1KpxD3Zufg,True,3996567,999141,6248,3124,3124,4BnQKPLuE3DMTtxp8MjUBytgnhvxqq3ZTqZHTVZo4JJh,249921,2812958,-2563037,625
2022-01-21 07:30:38-05:00,4734,D58t4uTjFumsUeYFaKnpV8BRTEQEqKXBreFTdwGrott7,67p6kHDfVqQijfcwugvZK59c3aRRH9x3eHxruqH8WEqF,True,109185719,27296429,170399,85199,85200,HfEnetJ7uBSmZWCjBNxdvv9HEC5nsW4wDV7wu6WnhWan,6815975,29048188,-22232213,624
2022-01-21 07:30:57-05:00,4735,91tPxdvLhrVtytKuNkf33XocRnpEqA1x3jDb1Je6xeui,2ByoMpaZg1uzkA48vMufvcx8BLYxWLXUK3tXAJcupanF,True,6362,1590,9,4,5,4BnQKPLuE3DMTtxp8MjUBytgnhvxqq3ZTqZHTVZo4JJh,398,3456,-3058,625
2022-01-21 07:31:14-05:00,4736,FjDp4bWCtqehFD7FunCrjrcdxMezTJj5aqh2VnBvHDQU,HRYeZqcqhP1RPiAGXziR1qCWwk4sF6c5ZYbvSDhX7foN,True,1616631,404157,2526,1263,1263,4BnQKPLuE3DMTtxp8MjUBytgnhvxqq3ZTqZHTVZo4JJh,101060,859930,-758870,625
2022-01-21 07:31:25-05:00,4737,6BPPDj3BVgBPD3agd8b4B12d9Gvp4bFPXRWjzbtsmtRF,8VZnAwXPyKK2AHoMTZxKXthAiFMrL6b5EXAGqsAMTdhm,True,6360,1590,9,4,5,HfEnetJ7uBSmZWCjBNxdvv9HEC5nsW4wDV7wu6WnhWan,398,3457,-3059,625
2022-01-21 07:31:34-05:00,4738,8pjAmnuqsXh8eP7XWphZmeCKYPGc8J2ux6u9VEGjjkPp,Bv67SHZoVqFhDZ7QRQLTUi1NR9zUPD9T7uw1zmoAuuTh,True,4693313,1173328,7336,3668,3668,4BnQKPLuE3DMTtxp8MjUBytgnhvxqq3ZTqZHTVZo4JJh,293455,3599334,-3305879,625
2022-01-21 07:31:47-05:00,4739,FLQcLhAsRBKnLcSYkK94Za6NhGudrCGhGGxFTdDhVC6L,7vr92sRGp6DopaDv3wJr7gw4BFmxY74K8kFheKyxZdLX,True,104426,26105,163,81,82,4BnQKPLuE3DMTtxp8MjUBytgnhvxqq3ZTqZHTVZo4JJh,6525,43553,-37028,624
2022-01-21 07:31:58-05:00,4740,EEcTbsFTUEifcdbPyjBLkS943daEx1RpR8F3uZxKRZbT,8V3JzDQ1VWYQLas8fxUsWJZZHe4gEmn74RehtUwLw3k5,True,1078222,269555,1683,841,842,DddJ7EWCmYEEZETCBNgAUSg81Ls6fZtiAaY5ekJ5sXx1,67323,686876,-619553,624
2022-01-21 07:32:01-05:00,4741,EuvK7bsc3hbxqeJjJkLELCvS7kruCMAGDctn5u7Q7BnP,Dv4XTdwnp6Sv5zxkSwRwsdSzxApDtBr4A13x4vvzTVjm,True,10493166,2623291,16397,8198,8199,3uL2NSR2ZdDqCiKfzA5SwwpddAnit22DBJo6uvvz1rRs,655895,5983058,-5327163,625
2022-01-21 07:32:21-05:00,4742,EgU9hX6VK7YXeCgCHVaJAMekCcyZa2MVWdKra5pN7Gwv,7y8Ad9XY34bqREvheXHT2tr8Jy11D6X3pu7yLVtjU4QV,True,1994693,498673,3117,1558,1559,HfEnetJ7uBSmZWCjBNxdvv9HEC5nsW4wDV7wu6WnhWan,124684,1280132,-1155448,625
2022-01-21 07:32:22-05:00,4743,DiPSJvnnEwg1En7HJfEsKrUbBgtUf4KzGMyMCZDQSYgp,s8UVC6vPBofuXUS6RW1aQmZ8C35PrC5r4A6ugmvzLGB,True,391709,97927,611,305,306,HfEnetJ7uBSmZWCjBNxdvv9HEC5nsW4wDV7wu6WnhWan,24470,158358,-133888,624
2022-01-21 07:32:22-05:00,4744,2ce2v2TCbjNH635NgbwTG3sqiRWYrRRaBpxPxBZJ929q,9cnoebT43FkWDFhidndGCVNiFD4NErv8DuL1Va4Jv9S8,True,1211639,302909,1891,945,946,4BnQKPLuE3DMTtxp8MjUBytgnhvxqq3ZTqZHTVZo4JJh,75655,1141703,-1066048,624
2022-01-21 07:32:38-05:00,4745,5BjBPqumCb9KC82ZNNch3dcRzbpGdRLJneru7o9a1D9R,FuZtBWKktxFu4yoiLVMzxq8fMhQyN8SGzGPz49xs3m6P,True,29664021,7416005,46363,23181,23182,HfEnetJ7uBSmZWCjBNxdvv9HEC5nsW4wDV7wu6WnhWan,1854523,19022969,-17168446,625
2022-01-21 07:33:04-05:00,4746,7MSzV5yy5FmrM4j1BcYSRiTGWfit1AJahheRUaXzz349,aPSTZLxBpVr3sucjbj95emRV2J1GrUWr7wbARYqJkQZ,True,896302,224075,1399,699,700,HfEnetJ7uBSmZWCjBNxdvv9HEC5nsW4wDV7wu6WnhWan,55961,428409,-372448,624
2022-01-21 07:33:05-05:00,4747,93ho4cgnpAJiJsG6uu2udkLVNU7rkz4QjCYfsqvpbPA5,45ouQn9gGwXqnTGfaP5CvU8fCKadBRA5kPwtfvJzykRU,True,12771748,3192937,19945,9972,9973,4BnQKPLuE3DMTtxp8MjUBytgnhvxqq3ZTqZHTVZo4JJh,797801,6263387,-5465586,624
2022-01-21 07:33:07-05:00,4748,3zH1b58jqbNU37y9kDTZZrotSeT8XzS1tuyAHPKWrbah,4trxDWV16x6sVcz7bxHehYHkjjyKebh3S9fyJf8txzK5,True,1524,381,2,1,1,4BnQKPLuE3DMTtxp8MjUBytgnhvxqq3ZTqZHTVZo4JJh,95,832,-737,623
2022-01-21 07:33:09-05:00,4749,4FazDUgfQ3AKoFcnWHr8E9Ht8jLA3tkxf75yrGZVHdmF,HzRMH6mbgEKydRCnnMvSsKgTEVNQi6nuzoR1xutYFdzg,True,12338,3084,19,9,10,4BnQKPLuE3DMTtxp8MjUBytgnhvxqq3ZTqZHTVZo4JJh,771,10971,-10200,624
2022-01-21 07:33:13-05:00,4750,87R8o8xLjHw2GpunYkm7pX7uJ8hjM4B1y4Qm7aQf6Yh4,48aSVPQoFYdncF5NtJ114urbdTzVjTgYLgPzMfpJbZB3,True,12863355,3215838,20119,10059,10060,4BnQKPLuE3DMTtxp8MjUBytgnhvxqq3ZTqZHTVZo4JJh,804785,14371195,-13566410,625
2022-01-21 07:33:25-05:00,4751,E9FFPvygPSF22u7gqFq4w6yE5kV15zbeGDXFQc349RsG,yi1REPVUwKhr5ss5YJc56crYz8LVfkqNVMpKcdSfwfY,True,336136,84034,525,262,263,HfEnetJ7uBSmZWCjBNxdvv9HEC5nsW4wDV7wu6WnhWan,21010,135387,-114377,625
2022-01-21 07:33:25-05:00,4752,9gYrMXAGmGSV4VFjXzYP5WwH2aFpB1TxA6CqpYsosKLv,Dh8aH6RK48wu4fkT9xKw5XL7itxnPDuw3SDwPwvL5sva,True,5330,1332,8,4,4,HfEnetJ7uBSmZWCjBNxdvv9HEC5nsW4wDV7wu6WnhWan,333,2944,-2611,624
2022-01-21 07:33:42-05:00,4753,AQr9mVmcXCNQhBVCfx63MwR6c4WqDSC9K2BZqr7N8LCx,CB7TWUaL381ounsLw6neAUaKRxJL9P1HC9uGX5e1Uxod,True,115762886,28940721,181166,90583,90583,HfEnetJ7uBSmZWCjBNxdvv9HEC5nsW4wDV7wu6WnhWan,7246661,95727166,-88480505,625
2022-01-21 07:33:42-05:00,4754,2kqN3TbCDgM4x8XfZvKgqJvDAHqvZxtT89NcfmQSQa5b,8fEx56PjuPAP61CBnrsnnnQnZmt8cw6KVjhYDK1mWJzP,True,114747548,28686887,179348,89674,89674,HfEnetJ7uBSmZWCjBNxdvv9HEC5nsW4wDV7wu6WnhWan,7173942,34424533,-27250591,625
2022-01-21 07:33:56-05:00,4755,HHHj6EinpgAJeZkDXfsvCo3UXnmAdiAZNvPSUfVPc5Sg,3gx9c31MDtJtByxkUuWcqf1oARnZTjpx3QtxsM1Xb6Gp,True,289239552,72309888,449292,224646,224646,HfEnetJ7uBSmZWCjBNxdvv9HEC5nsW4wDV7wu6WnhWan,17971698,120512883,-102541185,621
2022-01-21 07:33:56-05:00,4756,72woixtGAuGazCMfsYfYBYLP7FuRj8Fwz9fynFo4MCE4,5237BmWkKf58PBeTUEiu3Ld5uKXEe8wcrJRmCnUoWWku,True,268192246,67048061,417881,208940,208941,3uL2NSR2ZdDqCiKfzA5SwwpddAnit22DBJo6uvvz1rRs,16715253,83615020,-66899767,623
2022-01-21 07:34:02-05:00,4757,DWTaeNeq5x83cBvKUz2jZfXDz5z4F5wbSZLNv7smnjvd,9pQGArZnJV4Fu8tBVEfknmmfmrRv5RKV2u58BJBuhzpF,True,35992169,8998042,56260,28130,28130,4BnQKPLuE3DMTtxp8MjUBytgnhvxqq3ZTqZHTVZo4JJh,2250410,16258241,-14007831,625
2022-01-21 07:34:02-05:00,4758,6NJFN855M3Q3RLTDNo57gTgAmwPD6G2E3WvMb1m5eNCN,3YpqNnonsvXaRT4nCC3G5FZx1jjVtbDPc36LiR6WK5jR,True,29273693,7318423,45632,22816,22816,4BnQKPLuE3DMTtxp8MjUBytgnhvxqq3ZTqZHTVZo4JJh,1825290,19612045,-17786755,623
2022-01-21 07:34:02-05:00,4759,9LZ3rShLfzErXsGkh4dYfAm58GNPWhK6ohDy5RrLJhc,41tLyuvuJ5M7YctkSASD2R7RGGetD7FmKaZUdkTdgXgt,True,290886,72721,454,227,227,HfEnetJ7uBSmZWCjBNxdvv9HEC5nsW4wDV7wu6WnhWan,18198,117757,-99559,625
2022-01-21 07:34:03-05:00,4760,3g1debT8Z2efQPuMNSDPUNZzDqarBG2acErsZ4HP7QGA,42wDHagxr5Nno3mUx6kyYGDjwR98aedRbh3ByB468agB,True,3804,951,5,2,3,3uL2NSR2ZdDqCiKfzA5SwwpddAnit22DBJo6uvvz1rRs,238,2116,-1878,625
2022-01-21 07:34:04-05:00,4761,ioPHEVyheRnHYomVS7PmP6Coyhjk6LCs7hMD5Mq9Ngv,DYTpFmZ4yXVghKwkaovgCdpv3jfWkjtXRzxsZjKJfXNN,True,4834,1208,7,3,4,HfEnetJ7uBSmZWCjBNxdvv9HEC5nsW4wDV7wu6WnhWan,302,2692,-2390,624
2022-01-21 07:34:04-05:00,4762,ECuu1L4QGdemZ7FjAjVAAxYN6piinweY7Fuk5csVovfT,Amd8WGcpdtB8yoA83R1BUT5uryuqoKbcBexYacbrbGVX,True,613784,153446,958,479,479,HfEnetJ7uBSmZWCjBNxdvv9HEC5nsW4wDV7wu6WnhWan,38334,312069,-273735,624
2022-01-21 07:34:11-05:00,4763,Fani89KviVFZek4si6YZ3apVuM2kSqVUijDnLBqtvJEH,EpC29dECx1cLC69bj2ncG3jFp7obPaxbH7F6mju27cwL,True,8447770,2111942,13189,6594,6595,HfEnetJ7uBSmZWCjBNxdvv9HEC5nsW4wDV7wu6WnhWan,527588,1909818,-1382230,624
2022-01-21 07:34:16-05:00,4764,D64rDiWT3YG28fCgXCmbNjYa2JakZbpKQ1D2XuLChUfV,8WmMWq8cTsGQym5pUbHm9dPCpJugBeWUMVERYFGLxWHj,True,13736095,3434023,21328,10664,10664,HfEnetJ7uBSmZWCjBNxdvv9HEC5nsW4wDV7wu6WnhWan,853138,5886619,-5033481,621
2022-01-21 07:34:19-05:00,4765,GufVttJatW8NLeztT1NRQSLZpQNRk45kaG41p3QcWhx7,GTJUsWoWRyeafYJVhx2aRo8NE94U5UrBjaehmJ4PRUhn,True,10785250,2696312,16658,8329,8329,3uL2NSR2ZdDqCiKfzA5SwwpddAnit22DBJo6uvvz1rRs,666336,4116246,-3449910,617
2022-01-21 07:34:33-05:00,4766,FLTW9fwjWqGPm5PiE3C9LFzwZxtDh8c2MnEoRq8W7MfQ,GKsfzKBP2QkmoEWvTaUN1h4nqrT3kAcwYRC9WxW9bB3h,True,2477340,619335,3875,1937,1938,4BnQKPLuE3DMTtxp8MjUBytgnhvxqq3ZTqZHTVZo4JJh,155027,1196864,-1041837,625
2022-01-21 07:34:49-05:00,4767,CCHzYXr5zMXFu8MMZNkfUWGyUcF8xy7Vvhq7tNCtZg2L,AuEXkCJTTJ3HK8iP4qTWpQr4vp6HPRJZyZwfRjF8zjfp,True,29430,7357,45,22,23,HfEnetJ7uBSmZWCjBNxdvv9HEC5nsW4wDV7wu6WnhWan,1835,14223,-12388,623
2022-01-21 07:34:50-05:00,4768,6osqTNxgZv1Y1EjnVR7D1G4cywof1CrWswj87tAnktWV,Fah93R9W7SFuajFif4AbXDdxouWA5rrLz29vzVRGsMxv,True,2509302,627325,3904,1952,1952,HfEnetJ7uBSmZWCjBNxdvv9HEC5nsW4wDV7wu6WnhWan,156191,2630294,-2474103,622
2022-01-21 07:34:52-05:00,4769,6gFbxvPafnpqZjWW94MMmL8mGp2FHZGqoJC5fWqgwNxS,C6WcDycp3Ff3xYmb81i8JbD39Xv1o5G2AdtPs1FdXtr4,True,462299635,115574908,720882,360441,360441,4BnQKPLuE3DMTtxp8MjUBytgnhvxqq3ZTqZHTVZo4JJh,28835287,136021450,-107186163,623
2022-01-21 07:34:52-05:00,4770,6d6HN8LWikwW2HYdy3BABWuxKHt1sgv4DcneACR133sE,4eKvzmfFvX96XbujKBhUauAvWP4yQYwZH3pd7gXzbCvJ,True,335346,83836,521,260,261,HfEnetJ7uBSmZWCjBNxdvv9HEC5nsW4wDV7wu6WnhWan,20864,136030,-115166,622
2022-01-21 07:34:52-05:00,4771,9k5YHTFCHczFg6KAZXf2ostkFLH7WdVAxiA9zCGRprg3,2b52r1TA8dkJsnuMuM9cNfGxKEynd42WjQUuzcQTRcD9,True,12795,3198,19,9,10,4BnQKPLuE3DMTtxp8MjUBytgnhvxqq3ZTqZHTVZo4JJh,797,7146,-6349,622
2022-01-21 07:34:53-05:00,4772,921FBgLS3A1wA77uWitsnTvW737Q2jY7tzvgWtWLXNC7,E4eJ9H7cqP9zNpMH5xRBTAp9yaBCBihuJBNd6pqzteDG,True,29424,7356,45,22,23,72FwbpFGoLEazJEdpqNtPNefsadUrimUqma9wSoy4qiS,1838,14231,-12393,624
2022-01-21 07:34:55-05:00,4773,8swGZMrPrLAxZd7MxTbkCL13k3DmAJUw41jCp6Xo6awW,3fKnX7yTNXAT4uMmXVdTy47ALJT8h8YSD3WiBb4BGuzH,True,89275183,22318795,139658,69829,69829,3uL2NSR2ZdDqCiKfzA5SwwpddAnit22DBJo6uvvz1rRs,5586332,47106069,-41519737,625
2022-01-21 07:34:55-05:00,4774,BPRoaqrDs8vhqv2T7d9qV2oPU33pi1K1LUaotM7yuD2i,6qo8uQGAEwBfYQR36v6nRiqA2xGV6SjJAsXsdzy5bqNH,True,208101797,52025449,324540,162270,162270,3uL2NSR2ZdDqCiKfzA5SwwpddAnit22DBJo6uvvz1rRs,12981624,125257959,-112276335,623
2022-01-21 07:34:58-05:00,4775,2bikYf33ZxxDmvkMNjWDGGqEpbYJPvWv5At3hzyeLEQK,5FtirUBjRAZ3k5arFFVwKz42ixWzhkEBLkaK9PraRZ78,True,29423,7355,45,22,23,3uL2NSR2ZdDqCiKfzA5SwwpddAnit22DBJo6uvvz1rRs,1837,14232,-12395,624
2022-01-21 07:34:58-05:00,4776,HhwiZPKZBGa16oVi739s4qtMDMTwzWXc7iwNfX63t2UP,5AnbMbAFKy85yHt5y2M5S38nNkA1vT4ejY5NjGbRNUqn,True,277938,69484,432,216,216,DddJ7EWCmYEEZETCBNgAUSg81Ls6fZtiAaY5ekJ5sXx1,17318,215023,-197705,623
2022-01-21 07:34:58-05:00,4777,DJiXXW7sjNsAAxWupDKBUsFhXSgPoerVYaAtJqqNgVbn,2MsqvNuJw1xQhJ3UnXt9i7oNHDuZpR9w7iE1WQcGqt5m,True,29423,7355,45,22,23,3uL2NSR2ZdDqCiKfzA5SwwpddAnit22DBJo6uvvz1rRs,1839,14233,-12394,625
2022-01-21 07:35:01-05:00,4778,2p2fGXdKrmxjomLSnyaNg84J82cBBBNympZ6qQc8UZgU,HKAM8bazuLMUY6yapZJqYsgaWkTBqKHyMs1hSfpYsZGi,True,163005794,40751448,254002,127001,127001,72FwbpFGoLEazJEdpqNtPNefsadUrimUqma9wSoy4qiS,10160086,109205762,-99045676,623
2022-01-21 07:35:02-05:00,4779,duKo8riX1qpX1K1qpgwZniMtUeWqu2eYgchTu5n7Rbu,9vAVwfVtdsaZMbeZvoymjHqwASeuM38gfEJkbTVwDqya,True,13452445,3363111,21012,10506,10506,HfEnetJ7uBSmZWCjBNxdvv9HEC5nsW4wDV7wu6WnhWan,840501,7319673,-6479172,624
2022-01-21 07:35:06-05:00,4780,DkvR2xUPMyXWGGkUSmDSfhp7RtvMkfbT1ThKCS3TwrXd,F7jYV6TtT1LZ5XCNn1zkbUfNMo4gGcQUczAQy1jLHpaW,True,234192739,58548184,364774,182387,182387,HfEnetJ7uBSmZWCjBNxdvv9HEC5nsW4wDV7wu6WnhWan,14590970,120938604,-106347634,623
2022-01-21 07:35:09-05:00,4781,7g4NJBHwDTRm58GqX7Tz1JzqwbAhF6EWJUQH3SoDxSf7,82Ypv7STZeSCBPf3HckWdyatELpvaDaWxFXhD5dNSML4,True,4674,1168,7,3,4,4BnQKPLuE3DMTtxp8MjUBytgnhvxqq3ZTqZHTVZo4JJh,292,2609,-2317,624
2022-01-21 07:35:09-05:00,4782,Sapmbypb7FUXhKQEdjyH2AUDgh8QWQ1mu6SSHm7673N,7AGij8bP7Kq3iARJ41duwggPrDfuXDoKwRSKV9SG8nk2,True,56327759,14081939,87955,43977,43978,4BnQKPLuE3DMTtxp8MjUBytgnhvxqq3ZTqZHTVZo4JJh,3518202,12180442,-8662240,624
2022-01-21 07:35:12-05:00,4783,DY6k3Dkwe18iLneaT8Xo3VpJWB6V4jWwQQjoDvEzdg2j,3GGV7S9FpRQGbARBXkvGFVqLrmw8JvYAcpnR1aKVUY2f,True,4757728,1189432,7350,3675,3675,HfEnetJ7uBSmZWCjBNxdvv9HEC5nsW4wDV7wu6WnhWan,294008,3210880,-2916872,617
2022-01-21 07:35:23-05:00,4784,BgnsCfJ54ReunUtwPJLzkW4PWnqpBDWGNYxsW5PvDrbK,KpMqEkQ9dKMgCevsEK895wHd3fCLRPSzDmJSv3tKU4u,True,5576259673,1394064918,8645769,4322884,4322885,HfEnetJ7uBSmZWCjBNxdvv9HEC5nsW4wDV7wu6WnhWan,345830770,2565653044,-2219822274,620
2022-01-21 07:35:30-05:00,4785,9WJBnVi84E926j7xEd566WzrZJkPJWRgmEnYj9vyjuad,4dLaFS5F7TGyLdwuJLMGkz3bSL53aHzd9ZfpNmhHxXeF,True,5905825,1476456,9210,4605,4605,4BnQKPLuE3DMTtxp8MjUBytgnhvxqq3ZTqZHTVZo4JJh,368419,3572272,-3203853,623
2022-01-21 07:35:30-05:00,4786,CxLFMBDFkoMvpK9YUf7WtCq6hn7k3QACAuetAnGjU6KA,2gE52a1GWQnS6ifV6eVtKQyr13LXP5Jdt3yG9SjGPJPF,True,467099996,116774999,728340,364170,364170,4BnQKPLuE3DMTtxp8MjUBytgnhvxqq3ZTqZHTVZo4JJh,29133606,124510256,-95376650,623
2022-01-21 07:35:42-05:00,4787,J3ggP7ZxL8HRh3CBp5iYG2WgjLyNSAWYT46uC9VYDLCz,2FqTRiRPiLvdAH2BS5vroVntpsSXvTJEn5UHWmtKHzh9,True,11295735,2823933,17514,8757,8757,HfEnetJ7uBSmZWCjBNxdvv9HEC5nsW4wDV7wu6WnhWan,700581,4552591,-3852010,620
2022-01-21 07:36:00-05:00,4788,4kbcrzH6o2LvLUCNphyL52i8uGzVD8wcUNEqoQ14z3VG,5Q1atmEBs2AqaDZsiZFG5stHzj1fE6ZvypgfkEc9LYqE,True,35794911,8948727,56013,28006,28007,HfEnetJ7uBSmZWCjBNxdvv9HEC5nsW4wDV7wu6WnhWan,2240538,25477390,-23236852,625
2022-01-21 07:36:03-05:00,4789,6pUtYz474QrpATEZnfb3iFbTKYA65pNyKAo4TQZAjtqe,8dipRUXvxJiDLdHEtCPkso4vErbVwshHQiRfvSngBS9J,True,99610333029,24902583255,155697265,77848632,77848633,4BnQKPLuE3DMTtxp8MjUBytgnhvxqq3ZTqZHTVZo4JJh,6227890603,22276985474,-16049094871,625
2022-01-21 07:36:07-05:00,4790,HkRKcvAWLM5sCDL6a5DvYsH55bg5BnZnyP9WwX7wLUDF,GXtDJS8BCoZKnvviGaUb2QfKs2LQQZPMa9564tf5Jq8Y,True,306335023,76583755,478232,239116,239116,HfEnetJ7uBSmZWCjBNxdvv9HEC5nsW4wDV7wu6WnhWan,19129294,105300367,-86171073,624
2022-01-21 07:36:07-05:00,4791,Gs3WP18hbzNpbBgiU39e6tfkggfCKRyNqPqJQcthuHFD,4XAY25YUma6gUdG2GdbXeivum3t21g93ZagfWGTZYkWZ,True,3737820,934454,5799,2899,2900,4BnQKPLuE3DMTtxp8MjUBytgnhvxqq3ZTqZHTVZo4JJh,231994,2191767,-1959773,620
2022-01-21 07:36:11-05:00,4792,4uygLJDk9DFCifJ56YwMrEsvd3oQNq8tYSLnMCyWorS6,GimL4uKGvg3FFmFQSWzAcjstv3Vmk5NMgDGMKTuXYVpB,True,198947740,49736935,301536,150768,150768,3uL2NSR2ZdDqCiKfzA5SwwpddAnit22DBJo6uvvz1rRs,12061476,100570700,-88509224,606
2022-01-21 07:36:11-05:00,4793,Frobc1KZTVcsyfwyKwSpHJobxmiJBomzHhGCLdrzdAz8,HziyKP9uxWCuXddtbRzWMczHNdgyQB5UXQZj4MnMm14,True,97918759,24479689,150173,75086,75087,4BnQKPLuE3DMTtxp8MjUBytgnhvxqq3ZTqZHTVZo4JJh,6006923,28856564,-22849641,613
2022-01-21 07:36:11-05:00,4794,8E3K7vCHJ2xjdFofPRGLbMxrkm8UYEi926QmXPAFwsqe,4qHUDA1c43Dg4qi1ZPKqmpGYiEMUZ6r4UuzB5ftHCEhW,True,543862754,135965688,820275,410137,410138,4BnQKPLuE3DMTtxp8MjUBytgnhvxqq3ZTqZHTVZo4JJh,32811017,333641031,-300830014,603
2022-01-21 07:36:19-05:00,4795,HSZrdquqBs1gWQGSBcLGs4aa4ox27rLHh6KKmdHrgrVs,DywbuaDt997DQA1GT9GsLL8ML73CxQgHwMLw2MyG8m7M,True,3186636,796659,4970,2485,2485,4BnQKPLuE3DMTtxp8MjUBytgnhvxqq3ZTqZHTVZo4JJh,198806,753863,-555057,623
2022-01-21 07:36:19-05:00,4796,7W6ih2ZGXaE6tvuQFUPCvc7NvEJHy7UffgoVX3ZPdLXt,6uQCkeMjEXHBQxE2HD33RM1zyTsSko1fYZA1mWUggJ5B,True,5161,1290,8,4,4,3pStmNaV47N2sqUtHJHLAtCKiN9JZ6jzNY9h94ng8G1D,322,2951,-2629,623
2022-01-21 07:36:19-05:00,4797,FnAT8HKGgisYfeAbxKU2gSbCp8KbZHULRpaJX1NVijHy,2u637Crc2QzfSJmCnRNqeib3aZQVn4NGncpgM3Ph6jvm,True,13154832,3288708,20342,10171,10171,3uL2NSR2ZdDqCiKfzA5SwwpddAnit22DBJo6uvvz1rRs,813718,5545408,-4731690,618
2022-01-21 07:36:20-05:00,4798,399591e8XgY52yCMorCQ2WL6dQZTC485ZooHtmGuirhZ,JCiXAooFmKmEPQ2S7C8iSk6CLcTyrPEe1SsPSLyUGySe,True,410547,102636,620,310,310,HfEnetJ7uBSmZWCjBNxdvv9HEC5nsW4wDV7wu6WnhWan,24802,279398,-254596,604
2022-01-21 07:36:21-05:00,4799,8kJu5aqVSmW8FSZR9h6F75ftn9V2U9uMLBEKeqRaC855,FhVHByujkvwwtjTVpZ4mqSUqoMoBgeLUc5H7rbz3FgAt,True,33899911,8474977,52269,26134,26135,HfEnetJ7uBSmZWCjBNxdvv9HEC5nsW4wDV7wu6WnhWan,2090780,23105397,-21014617,616
2022-01-21 07:36:21-05:00,4800,D9VKhnfLLCrntDGFYSfoxFaY76VnHmYZ1ZbyFXdKdibz,2hRCRH2pMDyQGYcXHa8Y6BZo6FbcGZf5VJC1v8Bp6tGa,True,35275280,8818820,54126,27063,27063,HfEnetJ7uBSmZWCjBNxdvv9HEC5nsW4wDV7wu6WnhWan,2165042,16590030,-14424988,613
2022-01-21 07:36:23-05:00,4801,GWkVXmZNQdcdWNNu8dvRqct4aMhLoDNqijrTvxbfEdKN,6LKRNbJv2XkyjJQKCFAqFRPzvANrRBSTmu8doRWqTicU,True,21770715,5442678,34007,17003,17004,72FwbpFGoLEazJEdpqNtPNefsadUrimUqma9wSoy4qiS,1360311,6892343,-5532032,624
2022-01-21 07:36:23-05:00,4802,A4tDE948CPFPh1UwHb8sXryfKktbxZ8BCkqXgA5DJHA8,3zXeKMrsEpCe5fQumLNzCgpxcG1kLJFEAtJuqxLsC6ZG,True,33230846,8307711,50441,25220,25221,72FwbpFGoLEazJEdpqNtPNefsadUrimUqma9wSoy4qiS,2017647,17812896,-15795249,607
2022-01-21 07:36:27-05:00,4803,D7XummfEc3NTK4qMvZegV3FrYuqc8mNgnQu3ujwemZtg,HHiRcecqzW7sGFTio7Ph6TYv3dGt64KWv4DEKgKm84fQ,True,2146422,536605,3345,1672,1673,HfEnetJ7uBSmZWCjBNxdvv9HEC5nsW4wDV7wu6WnhWan,133827,1310494,-1176667,623
2022-01-21 07:36:31-05:00,4804,36ByQojnxEckWdQTjqHfxKqCx9yjqWQsPsZyqaN72UWR,AZoirtS1fjX61agRM64tqThVinnJTh3BWgiHyNHPTgZP,True,227700,56924,354,177,177,HfEnetJ7uBSmZWCjBNxdvv9HEC5nsW4wDV7wu6WnhWan,14179,154073,-139894,622
2022-01-21 07:36:32-05:00,4805,Ehw3RgdbzyAHHddgSv7F6f3WtYhyBtRg2ropQaWGgwcL,GGw3xDe5jKd5UNB9bPLqp2xzw2SKz7CMg358Fy7UypDL,True,3363674917,840918729,5254417,2627208,2627209,4BnQKPLuE3DMTtxp8MjUBytgnhvxqq3ZTqZHTVZo4JJh,210176690,1232262220,-1022085530,624
2022-01-21 07:36:35-05:00,4806,GH6Q9E1jZPTTp46aDd57UNZPNS2D6PBSwyLL3EHSjGn2,2XvwZXNsrPWx4EfPvhTP933bzCC3SJHDQ8xARfrXdVY9,True,3960322,990080,6193,3096,3097,4BnQKPLuE3DMTtxp8MjUBytgnhvxqq3ZTqZHTVZo4JJh,247741,4109573,-3861832,625
2022-01-21 07:36:48-05:00,4807,4D7mDXe7SdmbAx7kaD1mBNuEa7DzMi6TAwXURxtLEazk,5pSnT91PHoLdN6uhPnUtoD7cboLmndn26y1XouPx8vwW,True,297442,74360,465,232,233,HfEnetJ7uBSmZWCjBNxdvv9HEC5nsW4wDV7wu6WnhWan,18607,143437,-124830,625
2022-01-21 07:36:54-05:00,4808,9KD2AifD5wFD4QkHYuawXbJgLWHrfj2QPF3fT8jhGVA5,Ga9gAqmkuHbqrr31sUFPqa1xa5WNxLWJWGPUaMxQqLdj,True,373425,93356,583,291,292,HfEnetJ7uBSmZWCjBNxdvv9HEC5nsW4wDV7wu6WnhWan,23333,257859,-234526,624
2022-01-21 07:37:10-05:00,4809,EeztHR1M4PPacJEZ6c5arCRVCuu8aN7eGdpY1u4bev79,9Twdc9Xrzv2oeJ9Fbd8mRvzjbFi7mkGopFS37SMabeAK,True,35609978,8902494,55687,27843,27844,4BnQKPLuE3DMTtxp8MjUBytgnhvxqq3ZTqZHTVZo4JJh,2227509,16121221,-13893712,625
2022-01-21 07:37:23-05:00,4810,AUH6YGBV8tDVX1E1WTo92Mubfx1DGsqfGeyUBqxo4fSr,33QZgMwmW32WuvmxD8XNbmF9ea88bLe3YTtNwHV73Wwu,True,80126053,20031513,125200,62600,62600,3uL2NSR2ZdDqCiKfzA5SwwpddAnit22DBJo6uvvz1rRs,5008014,34516590,-29508576,625
2022-01-21 07:37:24-05:00,4811,AA9zFZTXqBR8Mw1fwEH59edzBiswoGasRNWsi6aLeysB,4VeitxYqqtRxyfdSVpshdJ3EDcgksRVnaHvAqWxTeujH,True,340943,85235,532,266,266,HfEnetJ7uBSmZWCjBNxdvv9HEC5nsW4wDV7wu6WnhWan,21312,138390,-117078,625
2022-01-21 07:37:24-05:00,4812,4xn9vTtLZyNtCbBLLpcXUMWU8AnnZCov9rJaY6rew16T,5UNWdFw2CP44qS8oc4uPt8zxw6zFg8oXz8SUCedZLLEC,True,9112793,2278198,14206,7103,7103,HfEnetJ7uBSmZWCjBNxdvv9HEC5nsW4wDV7wu6WnhWan,568251,2690538,-2122287,623
2022-01-21 07:37:32-05:00,4813,8VnGmfop6qcUezAJ2M15jz2Nn6mPQgehDcJPvypq4XJn,6F6sqXNhgkW9ev8QNMm4ydywUUmemhwgydRQYNeqyUmi,True,2119882,529970,3313,1656,1657,4BnQKPLuE3DMTtxp8MjUBytgnhvxqq3ZTqZHTVZo4JJh,132525,2236169,-2103644,625
2022-01-21 07:37:32-05:00,4814,5nauZoaxftcYR591YH4v52myeJLnXtY4okdttL9qSdkg,7x3G299D3bC7EwUQojhTXUv29BG4NGzrLbgS4mEyqG5r,True,92597532,23149383,142982,71491,71491,4BnQKPLuE3DMTtxp8MjUBytgnhvxqq3ZTqZHTVZo4JJh,5719307,31761241,-26041934,617
2022-01-21 07:37:32-05:00,4815,DAku12iueL13vRoTpKLyqdGaLQ2rWF6REe8Dr8soFvNs,H2vVH3LxkhGe6x6Mdwy67BYwTKNQM6XayKx7mhrwyfJM,True,89281,22320,137,68,69,4BnQKPLuE3DMTtxp8MjUBytgnhvxqq3ZTqZHTVZo4JJh,5501,58768,-53267,616
2022-01-21 07:37:32-05:00,4816,Ftuj53jKP3Z8mvuTE1CEypdw2eZrCn5x8ktMWRdJo2gU,9JNUFRLrPNAh3DgKvMdaNvLCAeUtiS9FGWmDcMvcSe7J,True,51107010,12776752,79943,39971,39972,4BnQKPLuE3DMTtxp8MjUBytgnhvxqq3ZTqZHTVZo4JJh,3197729,25462239,-22264510,625
2022-01-21 07:37:34-05:00,4817,5jin5wXjQQ25nGM2ECrCXcg1a95vquh6kM7rMRru6Ke7,EKM657EQ8HWWgf4cssByoYHoXGjFfTspTKXAGmygAPQG,True,7528849,1882212,11600,5800,5800,4BnQKPLuE3DMTtxp8MjUBytgnhvxqq3ZTqZHTVZo4JJh,464007,4848821,-4384814,616
2022-01-21 07:37:34-05:00,4818,6VJcr3VAEcEZaHEpt48QL8QxHKABufVp8n2JSEVTLh9U,8naR6kiySKj3vai9dCetdgCnCHgf2oyLjGqKTJ3Lz64Y,True,491398668,122849666,762195,381097,381098,HfEnetJ7uBSmZWCjBNxdvv9HEC5nsW4wDV7wu6WnhWan,30487832,277986603,-247498771,620
2022-01-21 07:37:34-05:00,4819,GGGyesjbt7h2XHHp9u8vpiWGugFwEbrtYaKrNQSDhQd7,8tydo1ZjGHmPBSqU33tywB3f9szdsHk1ckGFe4Ay5pgs,True,10105019,2526254,15705,7852,7853,HfEnetJ7uBSmZWCjBNxdvv9HEC5nsW4wDV7wu6WnhWan,628233,9457692,-8829459,621
2022-01-21 07:37:36-05:00,4820,8NdcaYUC1X5CP7FMDip78uqtqmCt8GcZdCzLRTYTihmb,9Ei1K9bXWXSXcBfeX5exPSXGCAu62WSKzvnnd4wHvyVh,True,26307,6576,40,20,20,DddJ7EWCmYEEZETCBNgAUSg81Ls6fZtiAaY5ekJ5sXx1,1637,15418,-13781,622
2022-01-21 07:37:36-05:00,4821,3Lv2XpiD4KBUHq7Zx6u3zNhpXoySodXHH8o8f5yaaPxG,H6TN4rhpBXkEH3mZnymYNcKfmnxRH2uzfwzeLH2q6ahP,True,37387,9346,58,29,29,3uL2NSR2ZdDqCiKfzA5SwwpddAnit22DBJo6uvvz1rRs,2337,21699,-19362,625
2022-01-21 07:37:37-05:00,4822,LNX7AwwiGpuaXA4J86d1xqqtF6kD7qbCusssSZqtpKd,45a5FGVssw2NoGipB7NRN4XDLPob4GHNxSM9fqgsTpqA,True,173079568,43269892,269292,134646,134646,3uL2NSR2ZdDqCiKfzA5SwwpddAnit22DBJo6uvvz1rRs,10771701,54961914,-44190213,622
2022-01-21 07:37:37-05:00,4823,ES1MDwRUa3hoToPKQiiZkzMYe9PDVnAQwMrEvZrzvnc1,C4wBG3xTDkmDQneB28xYnf1aBNEeq7UB8oR7NuEfLkFg,True,5511591,1377897,8527,4263,4264,3uL2NSR2ZdDqCiKfzA5SwwpddAnit22DBJo6uvvz1rRs,341092,2659939,-2318847,618
2022-01-21 07:37:39-05:00,4824,H6fVnghBUSJRKp2mxSG7Fq2Lr4dE3YMS7yM1XTrxoe3Z,JjgtLi79grUZXofhWukB1yNXZkXFMUX5jm9HcXNDsB6,True,6071621,1517905,9393,4696,4697,4BnQKPLuE3DMTtxp8MjUBytgnhvxqq3ZTqZHTVZo4JJh,375745,2740775,-2365030,618
2022-01-21 07:37:39-05:00,4825,2FrqGFZjbiNykJyo9BZ5S9FguQJPJiTi681rJJsQ5dta,3QUncYP92NKrfpaTvuF9iQg11PXKgZAgEngwh6BbnCCj,True,165375,41343,256,128,128,4BnQKPLuE3DMTtxp8MjUBytgnhvxqq3ZTqZHTVZo4JJh,10274,92322,-82048,621
2022-01-21 07:37:40-05:00,4826,7uHMFnppZKtV7nAySv8UGcoGTSQ98RVz1GP47dsFWpYr,FmS9WPYVTT8i4agyidApdLnoHAUMfdRFPnAVJQUwfWr5,True,343592140,85898035,531794,265897,265897,HfEnetJ7uBSmZWCjBNxdvv9HEC5nsW4wDV7wu6WnhWan,21271773,92505061,-71233288,619
2022-01-21 07:37:40-05:00,4827,6u6bPgAmK8ufACrQV99A1Y5nhGkue3KEUHmQQkcNkxwP,7636yXT5w4DcVpc7LJdN46aiggzSq6U2GXHXL5kyy9F3,True,23744342,5936085,37065,18532,18533,4BnQKPLuE3DMTtxp8MjUBytgnhvxqq3ZTqZHTVZo4JJh,1482603,15269180,-13786577,624
2022-01-21 07:37:43-05:00,4828,AHm7zF4rpaxaayBLn5QDHgJSp8KAr647s4cNvQ9wLgd7,FDM33WngED24pukBvSDpPAzinW6afVAeGReum5nyLRiC,True,165825,41456,259,129,130,4BnQKPLuE3DMTtxp8MjUBytgnhvxqq3ZTqZHTVZo4JJh,10369,109497,-99128,625
2022-01-21 07:37:44-05:00,4829,AGhvB6x3gmvAJSnr9UVtvhKqVg3Qgh1k4roHzrNHhAaa,HhhjXT6WJnz1HQfHcwKdBppuAhc8ncUcq1mkJ4EHqgpe,True,1265,316,1,0,1,4BnQKPLuE3DMTtxp8MjUBytgnhvxqq3ZTqZHTVZo4JJh,79,733,-654,624
2022-01-21 07:37:44-05:00,4830,AM5fwZR9BUW8AFkhdGWXW4PHd2cy8ora63kDf2z2eknw,E7ru6hg4MchnRG5zcr5YazwX8Snt55r5Xq9zCHCGaYZT,True,191297,47824,297,148,149,4BnQKPLuE3DMTtxp8MjUBytgnhvxqq3ZTqZHTVZo4JJh,11891,120907,-109016,621
2022-01-21 07:37:44-05:00,4831,6CeKxTJvFqhyNEyzySiBBKEwYVMe7j3A6nkMes4BW6o2,DzDR9XvwY1z7ygQ8YrCXrwDGHSf67JZF8BzUnuFE2fxQ,True,876112,219028,1366,683,683,4BnQKPLuE3DMTtxp8MjUBytgnhvxqq3ZTqZHTVZo4JJh,54647,445277,-390630,623
2022-01-21 07:37:44-05:00,4832,D2L7ST8iGsRfZ4zj2pdfKTptbojQ4cDtHKQ8ngcFVQwA,7cNrHGWJ6FGGazfGaCePs8XyaK6bwVLrYFCUJQi9w2Wc,True,13541,3385,20,10,10,4BnQKPLuE3DMTtxp8MjUBytgnhvxqq3ZTqZHTVZo4JJh,839,7543,-6704,619
2022-01-21 07:37:44-05:00,4833,3njiRuSRMXRzKmamyiR72Hc38PU8UDDmWdfPhgxmGxEW,5WoF3gkgygyNNbwxWgVfqGWkExcDixuzgJQQjXEZQ6J5,True,51065803,12766450,78969,39484,39485,4BnQKPLuE3DMTtxp8MjUBytgnhvxqq3ZTqZHTVZo4JJh,3158769,44059403,-40900634,618
2022-01-21 07:37:44-05:00,4834,FpqCxvTkSiwDwD5qEt6hXJxzFDLFLAQ8VevK8zwRqYun,A3p6YQisCJKpNkF7vkjZRbEfbnUt7vTZdR2zPBUSdTkk,True,82169558,20542389,126407,63203,63204,4BnQKPLuE3DMTtxp8MjUBytgnhvxqq3ZTqZHTVZo4JJh,5056304,41689410,-36633106,615
2022-01-21 07:37:44-05:00,4835,8hpAXzimCw2bTwLXoRFAbqNW8qoj5VV3JDYCuJwqHpHm,DkfsL2M7oRBX6grAfy15C4urwL6ToMJ7TWJEFAGhWjYX,True,1851870,462967,2896,1448,1448,72FwbpFGoLEazJEdpqNtPNefsadUrimUqma9wSoy4qiS,115843,634652,-518809,625
2022-01-21 07:37:45-05:00,4836,F2v1YwVAwXLiUgsJ5uwn4qAAkTXitn1E75fJcPnGuAcy,5rdJ4H5GxPg4Juu77mGc7uya5LwEqLzDSRyG8mQ2mDbK,True,3861044,965261,6034,3017,3017,HfEnetJ7uBSmZWCjBNxdvv9HEC5nsW4wDV7wu6WnhWan,241378,2477264,-2235886,625
2022-01-21 07:37:51-05:00,4837,6xikA6d7sjCBnSfqkFwrL4nPrtQUNWdRhXB7i1AccnxC,G8t7u2R9qjRfdTdULs74v3nVrTM2WeKvc4dK4FFAvuG1,True,7498043,1874510,11684,5842,5842,4BnQKPLuE3DMTtxp8MjUBytgnhvxqq3ZTqZHTVZo4JJh,467381,2640706,-2173325,623
2022-01-21 07:37:52-05:00,4838,6dr65yANjSMmfBeKAuSxG3i16S9vMgF1CQ3zDyzh55Pn,EhrE5QpnshD41S4zPEBy2A5q2Gs2mwUrbHGo6WnT9zDP,True,66966,16741,104,52,52,4BnQKPLuE3DMTtxp8MjUBytgnhvxqq3ZTqZHTVZo4JJh,4162,44109,-39947,621
2022-01-21 07:37:52-05:00,4839,5RvNKzSeJ1fvqsKpcQu25evEZGmKjyEDgwsMZkykoT3P,BRqSGfE4XHXu4HrinwetWumfVTmr82iuF6Y5oSV6eMiK,True,29364,7341,45,22,23,HfEnetJ7uBSmZWCjBNxdvv9HEC5nsW4wDV7wu6WnhWan,1817,14271,-12454,618
2022-01-21 07:38:01-05:00,4840,2QStaRnbSnDhA891Lb1bxjVeMYpJUpNdqaVkw3rqU45V,DakRWPnttPoRcjY5V7WLwiwBx39BapCo9Atog8dL17Ku,True,453217,113304,708,354,354,4BnQKPLuE3DMTtxp8MjUBytgnhvxqq3ZTqZHTVZo4JJh,28330,208644,-180314,625
2022-01-21 07:38:01-05:00,4841,BAczoNDnbwj5AJX5LwzynzYab7ji7VbhRy9edA9Prax,34sbkUKnMetUNyMs6BhiWut85d5UZtBWnPtwx8jEpJNA,True,260157,65039,403,201,202,72FwbpFGoLEazJEdpqNtPNefsadUrimUqma9wSoy4qiS,16142,156400,-140258,620
2022-01-21 07:38:01-05:00,4842,Ayx8dFsVzUBb9b7QKxw7YHJuhptdSitBXFEczXTaxe85,EvU1VLChnowi6ccSPeJRSk65njrqZfYouAN7SHePxsxf,True,4683,1170,7,3,4,4BnQKPLuE3DMTtxp8MjUBytgnhvxqq3ZTqZHTVZo4JJh,293,3096,-2803,625
2022-01-21 07:38:01-05:00,4843,C2Dmfw4G8KKzFq38aRH2pLCRngnGZDvUUN3fHDMjFkoG,7kzJk3BTNvY3hGFNj7nDy9L5CAYus6eNiCAxWH8dSioX,True,74291,18572,115,57,58,4BnQKPLuE3DMTtxp8MjUBytgnhvxqq3ZTqZHTVZo4JJh,4614,57278,-52664,621
2022-01-21 07:38:01-05:00,4844,FsMiJiJZibohKoV5QRisWCjzuFd86xSxFb4m73AQmu93,7p3TSKBaG9SV2YNDnhutQKacPKpTTmgsEfzmK51t6sYb,True,80021328,20005332,124677,62338,62339,4BnQKPLuE3DMTtxp8MjUBytgnhvxqq3ZTqZHTVZo4JJh,4987114,33851637,-28864523,623
2022-01-21 07:38:03-05:00,4845,H3394S5wdbwXB4scjGAY8NsXxCdGy1Xebct18s42FM1K,Hz84L1EquzhCvBJP75ScKug46hYGdNMVNH16AdG4y5D8,True,18002708,4500677,28110,14055,14055,HfEnetJ7uBSmZWCjBNxdvv9HEC5nsW4wDV7wu6WnhWan,1124439,8777094,-7652655,624
2022-01-21 07:38:03-05:00,4846,FV3G5EsSmyiLAAoREhgDXwvzbxoyDeq4Mwfj4jK5fJ7U,5nhzbJmm5JAwGDpTZoenkM1u3XtMY4uN7Qsm3vFGtRJE,True,23631565,5907891,36903,18451,18452,4BnQKPLuE3DMTtxp8MjUBytgnhvxqq3ZTqZHTVZo4JJh,1476146,6363364,-4887218,624
2022-01-21 07:38:09-05:00,4847,3VdSA9CED9f5swRwHX2U15U7J6Muaq8VPnCNy9CaGDHe,2YYstfnfdYic5NWmEbcUEHpccNUVd1EhuCkExvMsoMk8,True,1921831,480457,3004,1502,1502,4BnQKPLuE3DMTtxp8MjUBytgnhvxqq3ZTqZHTVZo4JJh,120171,1314479,-1194308,625
2022-01-21 07:38:09-05:00,4848,DvuRmJkfn6FQczUKgYeaSCqwy2NTMunuAKNrnmxMvnzS,7LpWTX9dgBtW75kfEoB5WuNsDwEdw5s8CYSHh3J4qagM,True,24282226,6070556,37862,18931,18931,72FwbpFGoLEazJEdpqNtPNefsadUrimUqma9wSoy4qiS,1514503,15011723,-13497220,623
2022-01-21 07:38:10-05:00,4849,BZxJ6CtrVoiU86DMMieMeDFLNWtMpHGTvZfM7nyay6o4,6CRxRR8bisRLHFJBFWjyumYuy7j4C4PkjYH1K8gXhdWD,True,1449714,362427,2268,1134,1134,4BnQKPLuE3DMTtxp8MjUBytgnhvxqq3ZTqZHTVZo4JJh,90722,555684,-464962,625
2022-01-21 07:38:23-05:00,4850,5SskSWkRPP5BNaqvHkJCbTAgHPUkHEwFh5pFr4t8PoBr,EqdX8Sdm9LCfdrzVKzisKaFcP2YEdSRNZYmev5RWjGqb,True,783471,195867,1217,608,609,4BnQKPLuE3DMTtxp8MjUBytgnhvxqq3ZTqZHTVZo4JJh,48682,273657,-224975,621
2022-01-21 07:38:24-05:00,4851,Fd2HrzBAr4JobRPARZwpQHHVoSCEoog32A6tKMWAC1sK,BYappsar5sQf8VLem4wrLuTtrDFH9y8pEx1aMxfuU4Pq,True,6021874,1505468,9332,4666,4666,72FwbpFGoLEazJEdpqNtPNefsadUrimUqma9wSoy4qiS,373313,3870244,-3496931,619
2022-01-21 07:38:25-05:00,4852,6tFQaTqqffino9kwMZTL2xVNBG8k9VREFhXqVi2si3A3,3w3wGxBbS4bmXeqmvd595SAWFeXekVpnH4UdbeEs8Sx5,True,876567,219141,1361,680,681,72FwbpFGoLEazJEdpqNtPNefsadUrimUqma9wSoy4qiS,54469,444645,-390176,621
2022-01-21 07:38:26-05:00,4853,WMUVFELv3C3KdMKJ5ZL4rG7o1YrV1qTP6Mmp2S5Rp8S,7UNzS3zDqT1oeq9a7eJGU8cgf8eUzEAZubSBQvNmK6uJ,True,3629817,907454,5680,2840,2840,4BnQKPLuE3DMTtxp8MjUBytgnhvxqq3ZTqZHTVZo4JJh,227218,1186229,-959011,625
2022-01-21 07:38:26-05:00,4854,EmGW2aAG69ssWqCtbfDocRaM2u3TJsczn2HHP9jdmRvD,aypkDKsp9uqAB4F6mwvm5LofpsrFBuZT2MMWtE2eHdB,True,129131,32282,202,101,101,4BnQKPLuE3DMTtxp8MjUBytgnhvxqq3ZTqZHTVZo4JJh,8081,79387,-71306,625
2022-01-21 07:38:26-05:00,4855,6yw4GPvkqUbakcEWtqSCfjVLukty11xqjDpGxtEN9Km2,5ppEx7wkpqbG5nApCWMdRja3oRSheFmAAsNHUX7h2w2Y,True,330271,82567,512,256,256,HfEnetJ7uBSmZWCjBNxdvv9HEC5nsW4wDV7wu6WnhWan,20500,354584,-334084,620
2022-01-21 07:38:32-05:00,4856,A36aouot1oFLUtswuBUM4EVcis9chKaSJu53MRoPDjab,33U9gpq1RRFMGWDrWa3ezXXkwgBewdAS6QGgGVPtGvqb,True,103152691,25788172,160133,80066,80067,4BnQKPLuE3DMTtxp8MjUBytgnhvxqq3ZTqZHTVZo4JJh,6405328,43437192,-37031864,620
2022-01-21 07:38:35-05:00,4857,CyWBZ1xJ9LahUnPesbXLZ4Rr5UyWAHgVFYwfrnhyrkNL,2Lpk87Xth8ZL5J9BfzmMpEE3x76FDrrrmdKiCNkSVip2,True,70820206,17705050,110422,55211,55211,4BnQKPLuE3DMTtxp8MjUBytgnhvxqq3ZTqZHTVZo4JJh,4416913,32133256,-27716343,623
2022-01-21 07:38:35-05:00,4858,7ptPfZnqDCvTWotn8wPGyzERTJYLBgk47j7qf8Ciq941,AfAGcFqFFPi6LCQXydgsPWidN35c7NbhBa7RLEaDQQCu,True,3891851,972960,6063,3031,3032,4BnQKPLuE3DMTtxp8MjUBytgnhvxqq3ZTqZHTVZo4JJh,242528,1449966,-1207438,623
2022-01-21 07:38:40-05:00,4859,7CSCMFa9W52tBDVUbXbc3woAy3GByeA1wPJdp3MgznPa,3447ptuVFu6G8B6N63RmS8mRv4n9PfHneypHLvbeaGLn,True,30047368,7511841,46830,23415,23415,4BnQKPLuE3DMTtxp8MjUBytgnhvxqq3ZTqZHTVZo4JJh,1873239,17582388,-15709149,623
2022-01-21 07:38:49-05:00,4860,AATMHH4e4B6SL9bThnXGktzWuqWkPdx3JbRXk8HwkbPW,6F3u2yLx7P9gtpAAXASx7uF8xNyVBgJiKosMKUrgpicA,True,50050250,12512562,78113,39056,39057,3uL2NSR2ZdDqCiKfzA5SwwpddAnit22DBJo6uvvz1rRs,3124524,28339768,-25215244,624
2022-01-21 07:38:54-05:00,4861,E8ifvhmyJGBGVQomo3AnZw2UcaLHcpGsTtuoCid8voU3,FMQUWTbTAfSLfrc6GTrz4DM2ZSgoxF3KtqGn8AyjVtsf,True,1423198,355799,2226,1113,1113,4BnQKPLuE3DMTtxp8MjUBytgnhvxqq3ZTqZHTVZo4JJh,89048,713221,-624173,625
2022-01-21 07:39:34-05:00,4862,8T4WK27RvWVGqPuNqY6whk1fmU4vd5qaUQPZG1GJ79bh,DvSz7knS8N3K7L6JhQf1s4mJSyxB8uJXNQXtyjJn8QRL,True,35269863,8817465,54707,27353,27354,HfEnetJ7uBSmZWCjBNxdvv9HEC5nsW4wDV7wu6WnhWan,2188305,19384953,-17196648,620
2022-01-21 07:39:35-05:00,4863,5kwvkEtRFFD84j4ntVgxkacadgJaFvQ9JLhJqzLR7Y3G,GpMMkTv9T7y8DTiizuoJUsWvnSk3GSxADjRMGyYpryxm,True,8989989,2247497,13919,6959,6960,HfEnetJ7uBSmZWCjBNxdvv9HEC5nsW4wDV7wu6WnhWan,556767,3665237,-3108470,619
2022-01-21 07:39:35-05:00,4864,DC4UVUDFWL3gVtgkX9hPtFgtxaA8DH5p94i4k9U3wyWv,3HCWqVvQQfRgSKitsTjGTduJ82ointZUSNtj13uea4kD,True,499784076,124946019,767536,383768,383768,HfEnetJ7uBSmZWCjBNxdvv9HEC5nsW4wDV7wu6WnhWan,30701467,240905551,-210204084,614
2022-01-21 07:39:35-05:00,4865,5Rxuqgs4CaSKbfDXqBMFXkLTQ9dxrUjThXzoy3ouYVtK,BgvbKru66ebrGUcFFymGTmsaQv6GgcGMybiWaXqzBtwX,True,59217,14804,92,46,46,4BnQKPLuE3DMTtxp8MjUBytgnhvxqq3ZTqZHTVZo4JJh,3689,42613,-38924,622
2022-01-21 07:39:36-05:00,4866,AvwHizRhHUSahmvSg4jmTUErc7vAFSmkRAEsiKhXfW1m,3UrWYx8y9N5o9GYneSe6zyyHRTZzxwvcipQfHHYh7tEs,True,735468,183867,1136,568,568,HfEnetJ7uBSmZWCjBNxdvv9HEC5nsW4wDV7wu6WnhWan,45446,365435,-319989,617
2022-01-21 07:39:45-05:00,4867,7feC64HZfQpniey2iXsMMgQXnfcunJus74DiKDeKaEUw,GstsCxAiBBEUrXNkvZZ9Sg4vNK916PsKe2Mx6e4M6dU7,True,1583741,395934,2470,1235,1235,72FwbpFGoLEazJEdpqNtPNefsadUrimUqma9wSoy4qiS,98835,764955,-666120,624
2022-01-21 07:39:57-05:00,4868,3ogBPSRcKfmwzgumVDHBkXLi1eCsEFG2xzSJgD4LQDNy,7TXyqWgJqfe71MSWFA2n7ufZbUdzf7JJoWej8FNNtMXo,True,6001417,1500354,9323,4661,4662,4BnQKPLuE3DMTtxp8MjUBytgnhvxqq3ZTqZHTVZo4JJh,372937,2911284,-2538347,621
2022-01-21 07:40:05-05:00,4869,A1j2G5FZRyWSjFt6dK87WHhLkQrPUVqHaM3KhSzhAKDT,2fMiHLYm4pL3YCd8aveTR4mT9uVxztQeMwb5eRZb4wUW,True,199241,49810,311,155,156,HfEnetJ7uBSmZWCjBNxdvv9HEC5nsW4wDV7wu6WnhWan,12447,113519,-101072,624
2022-01-21 07:40:05-05:00,4870,HdRgh9niYSd3YKCxzGdusYFquiVoFTP2mEGEzJJL5Nii,78C68Gbb1jYFQmYNCHHjL52keEKMXtGukmBwT7ahon4B,True,4230541733,1057635432,6602177,3301088,3301089,72FwbpFGoLEazJEdpqNtPNefsadUrimUqma9wSoy4qiS,264087091,2081270353,-1817183262,624
2022-01-21 07:40:05-05:00,4871,DYCYiQFH9QHzCo3eAw1pFoDu7pzwFMo1E2WDZjVFRz5w,CPh4FWsGak1kd1WFEH9qBjNhnun3R2tHtZA57zW8ugn5,True,14147989,3536996,22034,11017,11017,72FwbpFGoLEazJEdpqNtPNefsadUrimUqma9wSoy4qiS,881372,9088412,-8207040,622
2022-01-21 07:40:05-05:00,4872,9zpPiboHF5HW7NfCx7hYdmJGwUomVMTiUFc4Um5KrDi3,8q3eBpuwV6dMNkib9N8XQAq2tBUcjSANRe5SXpd4dFhZ,True,1641233,410308,2563,1281,1282,4BnQKPLuE3DMTtxp8MjUBytgnhvxqq3ZTqZHTVZo4JJh,102527,783811,-681284,624
2022-01-21 07:40:10-05:00,4873,HwosLQgDY1xtHQRQ4hzroPQHFWssPzTj5vRkP37FcviB,HKTNEYNXrephNkH7apbobK4mcQXcNayQA4W1NgM6sLr8,True,17502456,4375614,27241,13620,13621,4BnQKPLuE3DMTtxp8MjUBytgnhvxqq3ZTqZHTVZo4JJh,1089654,6913199,-5823545,622
2022-01-21 07:40:10-05:00,4874,BjCNaM7YbE9SjFi7tzi4677zg1fKXGJwtecz2GWwWuhd,6rNsSrKZezQrLb2whToNjnizpnurDXrobHqfEK3QqU1M,True,16967955226,4241988806,26499819,13249909,13249910,DddJ7EWCmYEEZETCBNgAUSg81Ls6fZtiAaY5ekJ5sXx1,1059992777,4100731351,-3040738574,624
2022-01-21 07:40:10-05:00,4875,53LQyY375e9D9Lt5KCueA28GwzeBeb53W4V9Qszcd6D,9kG7BrpuFUgF1CkqBfUEJgyVwK338eHMFAJfqvBy63E2,True,936918289,234229572,1463611,731805,731806,4BnQKPLuE3DMTtxp8MjUBytgnhvxqq3ZTqZHTVZo4JJh,58544445,293874639,-235330194,624
2022-01-21 07:40:11-05:00,4876,8xvLGVeDmhVYQhN2ZpWkVG9jCrukRsNQ4926a4TMiZqa,9ciBySSjvADwp47WkETiFWZKVTFL8Hf1XvK7aSxhcgQS,True,7088778,1772194,10974,5487,5487,4BnQKPLuE3DMTtxp8MjUBytgnhvxqq3ZTqZHTVZo4JJh,438987,3719010,-3280023,619
2022-01-21 07:40:18-05:00,4877,78EeyPYzQjrmW6z9VGhRci6ihMUZb5rtpXo3GAxugf55,9AgZ45TMxaqwWGVWSgnEkvio3s6fXtHjAVRVCA7Zgsd2,True,15798441,3949610,24647,12323,12324,4BnQKPLuE3DMTtxp8MjUBytgnhvxqq3ZTqZHTVZo4JJh,985917,6580199,-5594282,624
2022-01-21 07:40:25-05:00,4878,6Y1UoGwrKyKsScZQm9ng1rNrXXykKT82V7kUopc43kAy,8YtWQTTKymCESbPMWCP9TMehbMU25zJMtxt9grqrpbD4,True,7606737,1901684,11510,5755,5755,4BnQKPLuE3DMTtxp8MjUBytgnhvxqq3ZTqZHTVZo4JJh,460406,8039640,-7579234,605
2022-01-21 07:40:28-05:00,4879,6nJyqvFKprwaVCE1gAa2P4RHKc6Pa6XFSJymx654zZ9K,4e7iJmdwzAPxp1Zi8Azo38YyPQdPKqqY4VLJyQ5rpdYP,True,499851,124962,775,387,388,HfEnetJ7uBSmZWCjBNxdvv9HEC5nsW4wDV7wu6WnhWan,31028,334051,-303023,620
2022-01-21 07:40:28-05:00,4880,8trkirSQNdMmAcJdeswxs5cPjH8dD6U4eJtWiAdMsrDB,HaSzpQ45x2MipfN17U6jGBxX8tXboomVDhXNSrnEfLDr,True,932929,233232,1419,709,710,HfEnetJ7uBSmZWCjBNxdvv9HEC5nsW4wDV7wu6WnhWan,56794,506710,-449916,608
2022-01-21 07:40:28-05:00,4881,brCL9pzP6q4b6rKgAH1AJbMoqffBWyXLX8oAnZDoi77,Dx4G5UP9jTb47JQypWJnv48mPTzhJvqPD1BtBtDT7TJF,True,1620544,405136,2513,1256,1257,HfEnetJ7uBSmZWCjBNxdvv9HEC5nsW4wDV7wu6WnhWan,100532,448740,-348208,620
2022-01-21 07:40:28-05:00,4882,DGAQzgZhS2yioeZmG3cbacM3hdz4F1aZn1PWRwgiFukc,48KUtJaNCPNxkLXJBtWAdDxY4b9vZzLgbGxTNdwMqmjz,True,104859955,26214988,163582,81791,81791,HfEnetJ7uBSmZWCjBNxdvv9HEC5nsW4wDV7wu6WnhWan,6543293,64310939,-57767646,624
2022-01-21 07:40:29-05:00,4883,ApAgbKGyEYXRonGM33w56ZxHQNAGSd9ji4K3zAGN2yA8,FZAhAUDtEaNsFmh4fP8uXNjoHneNkpZ2wQCfEeU4RYRM,True,20264371,5066092,31516,15758,15758,HfEnetJ7uBSmZWCjBNxdvv9HEC5nsW4wDV7wu6WnhWan,1260646,10419138,-9158492,622
2022-01-21 07:40:29-05:00,4884,2hirR46fpyHEg1Fv9vAzYgnoNRBWaky7LoFGVof4DnpK,DXTEHauVDdz4Mjjj6sJHPUh6TnzU6ob6Nj63To2vCNPW,True,451888639,112972159,701345,350672,350673,HfEnetJ7uBSmZWCjBNxdvv9HEC5nsW4wDV7wu6WnhWan,28053819,112043209,-83989390,620
2022-01-21 07:40:29-05:00,4885,DdYgcyV1T2CDYiQVr4VL9Ym8RdKm93a7SKy8HxuyaoMW,GPdAeqeXb1UJ56AttcwwY1CyFhRyfptDC4BAX2Tc8MpE,True,105468,26367,163,81,82,4BnQKPLuE3DMTtxp8MjUBytgnhvxqq3ZTqZHTVZo4JJh,6547,70007,-63460,620
2022-01-21 07:40:33-05:00,4886,2jDRvE3pQNjWy1NRFa4tzB3KmU5UkbUCHw8sQRFujo66,C4zNi2szDrEEh4coTF3WRUghfP4ZwAVVSYTLWfkejQRu,True,135366393,33841597,209870,104935,104935,72FwbpFGoLEazJEdpqNtPNefsadUrimUqma9wSoy4qiS,8394832,65176281,-56781449,620
2022-01-21 07:40:33-05:00,4887,7hTjPRQSYAoWHhtpsVz2oKK5SAuFJd8dPHShKgKJq8dy,6DcHcrtcXR88d8e2KahhAiWTeRznNfF8oXLHmh5wE7wz,True,271391800,67847950,417948,208974,208974,72FwbpFGoLEazJEdpqNtPNefsadUrimUqma9wSoy4qiS,16717941,132190671,-115472730,616
2022-01-21 07:40:33-05:00,4888,3oCun4gm3k8sXxVxiYM8okGi8iCXH9LvDkHf9PBQWYXR,E1np1dZ7jUm811ddvy1jQerBwGSYb5BbZWnUHeotvrfH,True,85056747,21264186,128955,64477,64478,72FwbpFGoLEazJEdpqNtPNefsadUrimUqma9wSoy4qiS,5158230,25182576,-20024346,606
2022-01-21 07:40:33-05:00,4889,3EmGvYu72cR4Ta3wLA5HKZBEqgfChCyiRanwj5hGLJXc,6NEWPFaKi5uLsrj4n6RM1DBhQTcGFE9TwYeJ12pC7yyp,True,7953,1988,12,6,6,4BnQKPLuE3DMTtxp8MjUBytgnhvxqq3ZTqZHTVZo4JJh,493,4462,-3969,619
2022-01-21 07:40:35-05:00,4890,9vcKW1GfrDZ3KLPh2pEVFF8ZyKqD1pJW1hiE8H98Av7S,C6Ki27mo4sCHu6u8UnR1p7WSgsTjFQxGGR9Lk9n5Rhjq,True,557307,139326,865,432,433,72FwbpFGoLEazJEdpqNtPNefsadUrimUqma9wSoy4qiS,34624,354809,-320185,621
2022-01-21 07:40:35-05:00,4891,2F45BX9mRmtNCHPejKFknN5aNgGvR4vVLFjMaY1a7dR8,ALdSutsvEFRUEQGGBbi31QywTL1pdXSDWrNJzvNTaoXL,True,4998518,1249629,7576,3788,3788,HfEnetJ7uBSmZWCjBNxdvv9HEC5nsW4wDV7wu6WnhWan,303055,3124936,-2821881,606
2022-01-21 07:40:35-05:00,4892,J4krKPBBTMVLZRgrSeYJAMyHQs2FkNm5TXk7nQWwDB43,ASmLbfNbhTD2HHeV7qzAqiHjUx5a8Traj8oPDwbkMdFg,True,5669855,1417463,8697,4348,4349,72FwbpFGoLEazJEdpqNtPNefsadUrimUqma9wSoy4qiS,347914,2935894,-2587980,613
2022-01-21 07:40:35-05:00,4893,DdAPWdHnb7ocaYtcwwwYnppsH39sZpmzMyANeoJbCV7s,3BVmC39L8dEypPN1BZhsf9bx9Ge2sXCZR8Y6RH4eBNMJ,True,211067239,52766809,327369,163684,163685,HfEnetJ7uBSmZWCjBNxdvv9HEC5nsW4wDV7wu6WnhWan,13094788,191022881,-177928093,620
2022-01-21 07:40:35-05:00,4894,CbhrZUdan1axNDFUrX1ZuEohfNMEGrszKSkk6pppVQuw,DHEAjJNtuEePezYAv77thWabbVxxqQpfuiC6moRSrpG1,True,26277995,6569498,40529,20264,20265,HfEnetJ7uBSmZWCjBNxdvv9HEC5nsW4wDV7wu6WnhWan,1621182,18054760,-16433578,616
2022-01-21 07:40:35-05:00,4895,67Z7ZGhNu5xxEh9BYKWcXp9m1T4tFiE1o1M16hCzUWQA,CT7YKWixz7BhTbvg5F6M5HCyPGnHoFLNFuDV9GhoLTo3,True,651411,162852,1003,501,502,72FwbpFGoLEazJEdpqNtPNefsadUrimUqma9wSoy4qiS,40154,482719,-442565,616
2022-01-21 07:40:36-05:00,4896,H1LftKtj94Zs6PG2A7gJt9rPurBkXkTy2hbbArQwAehi,8bANmhgdnPYa3PqdPnk5BA2xhvqJmPyaMF77mrBePJ13,True,7638,1909,11,5,6,DddJ7EWCmYEEZETCBNgAUSg81Ls6fZtiAaY5ekJ5sXx1,467,7534,-7067,611
2022-01-21 07:40:36-05:00,4897,3VYtHvoT9wi4K1PBjg6JjCf6U9fVPDf6tX9jyRRvLxcg,Ba5fjpVyAxLbiP6hYJmrxzougi7JUEDfDLKBxSbbTL7q,True,90059495,22514873,136565,68282,68283,4BnQKPLuE3DMTtxp8MjUBytgnhvxqq3ZTqZHTVZo4JJh,5462606,28766324,-23303718,606
2022-01-21 07:40:36-05:00,4898,pgzvXpnUYiY7hLrfjmwScqLd8oj9vYcXpFvpm4y4JvG,GdqdQgoyBAFuXdbvoZyDhB3jyqJzVo4nkGh7EPFxkBF2,True,422668,105667,647,323,324,4BnQKPLuE3DMTtxp8MjUBytgnhvxqq3ZTqZHTVZo4JJh,25901,457577,-431676,612
2022-01-21 07:40:40-05:00,4899,9UyQC8vc6zJJaSdnjvTAzgmcsw4fC3xFBBiCC1w9Sbjx,3ppBfboe6FPmt7f6WrivspMUoAznZKWQMeh3rCgw7vjQ,True,1786544,446636,2695,1347,1348,HfEnetJ7uBSmZWCjBNxdvv9HEC5nsW4wDV7wu6WnhWan,107837,855155,-747318,603
2022-01-21 07:40:40-05:00,4900,CvZssqscu2dm35mwcE3zg9zedavbRjVJjWD59Py5ExUK,7pXaoR6aHKYofCmg1eHipygNYDteEaf8rbbS8BDYGQK6,True,140311,35077,215,107,108,HfEnetJ7uBSmZWCjBNxdvv9HEC5nsW4wDV7wu6WnhWan,8611,71472,-62861,613
2022-01-21 07:40:41-05:00,4901,51yPLtXTgL9oLKs1cCf5TjL54Ld5vuVxat2NNtwZVsZG,7UjtM7Z1tiXEQMMiorQyncgi9SKu3v46DhVdgXbWqSiF,True,71119706,17779926,109658,54829,54829,72FwbpFGoLEazJEdpqNtPNefsadUrimUqma9wSoy4qiS,4386358,74289376,-69903018,616
2022-01-21 07:40:41-05:00,4902,Ckqos6cdncPKj13DnCmDVZsZTqp6eS7277CRrT9WhcEr,AtUV8m7VQJvZq7GLCAHMf3jV7iamKEPnWVZHWuuVZQp1,True,249050,62262,388,194,194,4BnQKPLuE3DMTtxp8MjUBytgnhvxqq3ZTqZHTVZo4JJh,15537,192620,-177083,623
2022-01-21 07:40:41-05:00,4903,CRaKcudjkQiSw5YPVjTLVdXvJskeGiHSYtq5ZcMPJhgQ,AgqTg3b3bAcaBmRidhNC4Uf9ZwNbeH52RQEqumWyuUs7,True,173672,43418,268,134,134,72FwbpFGoLEazJEdpqNtPNefsadUrimUqma9wSoy4qiS,10723,134329,-123606,617
2022-01-21 07:40:41-05:00,4904,7jvKp6onXyWgwsFrFWj4hYTXJsYYD6ot5mn6rPFuJriy,J7N6HiozevJVTiY9hDEUs2ud5BwT5QSE7wnMBS1w5ie2,True,12123134,3030783,18938,9469,9469,4BnQKPLuE3DMTtxp8MjUBytgnhvxqq3ZTqZHTVZo4JJh,757523,7664903,-6907380,624
2022-01-21 07:40:47-05:00,4905,4cKgCTttVp8pzJnp43PP7uLLUXNcU7YGPJ3cCGHaUFe7,BBQqjwTpVEgpDzMk4wDDH8rCjaSxCRPWVhtFxERSujTD,True,8113444,2028361,12579,6289,6290,HfEnetJ7uBSmZWCjBNxdvv9HEC5nsW4wDV7wu6WnhWan,503193,4669047,-4165854,620
2022-01-21 07:40:50-05:00,4906,o2aCmkxsxSiyUX8soTEjwUCbJeXmCZsEaf8CWwxDT5n,3pvS2bTsUuiQyqZp5rdnTpq4cqWGgtv4E5rN9HsBxpRt,True,4793,1198,7,3,4,4BnQKPLuE3DMTtxp8MjUBytgnhvxqq3ZTqZHTVZo4JJh,300,2028,-1728,625
2022-01-21 07:40:58-05:00,4907,GjQQ2fQ7mrGjWZwjVYFUKp9NM1LmfkhEo675ovU5SPa8,ECgVUMRY5nB4MALs5drDyipF7YohCPuJpj2UegCs7HMn,True,4519978,1129994,7056,3528,3528,3uL2NSR2ZdDqCiKfzA5SwwpddAnit22DBJo6uvvz1rRs,282278,2530701,-2248423,624
2022-01-21 07:40:58-05:00,4908,5NVD6QvomTAD35yNxSFZw4DhF2hCtV8drkbnGhBVtK5y,3JzkyPnREvoFZLL9JZuuDEnee3nuKcrqY3xLuXsmHwRo,True,11949706,2987426,18682,9341,9341,4BnQKPLuE3DMTtxp8MjUBytgnhvxqq3ZTqZHTVZo4JJh,747314,7543864,-6796550,625
2022-01-21 07:41:08-05:00,4909,F9s8a7Cpiw5dw3a2aNFMofqwyDWNXvDLnSdJzoj1gRiV,GpKsQKJD79KBRWdCTkyi4zX7NaoCWsLUjrKxAwJB6o6s,True,5972511,1493127,9322,4661,4661,3uL2NSR2ZdDqCiKfzA5SwwpddAnit22DBJo6uvvz1rRs,372911,2038937,-1666026,624
2022-01-21 07:41:09-05:00,4910,3MEiFqy4F9nBW8gHxvGjv7norSBHwxhbzzNKngPk1RHq,2tcsJ4NUJegcEfHNwWPh979yKjKmq568CpNm5iWGbuoR,True,9413965,2353490,14712,7356,7356,4BnQKPLuE3DMTtxp8MjUBytgnhvxqq3ZTqZHTVZo4JJh,588505,4252678,-3664173,625
2022-01-21 07:41:10-05:00,4911,M69XSefqeum2arinvHEqmA3L2XHWNFN17p4msRhRZXf,2vK15yYUANLSbAoiBfgJ9VLyqsmtEpd2iNytQjms8GaQ,True,54341763,13585440,84949,42474,42475,4BnQKPLuE3DMTtxp8MjUBytgnhvxqq3ZTqZHTVZo4JJh,3397979,43806564,-40408585,625
2022-01-21 07:41:28-05:00,4912,BXMMFy2k9b2hVBEG6RyXAq3qqXxJ7EY2xhyPZqtLvBiU,KpoZwr4ZFTHJgebbf4tcjT9iKvpC1EF8Aw4uaVPxXNd,True,12995072,3248768,20329,10164,10165,HfEnetJ7uBSmZWCjBNxdvv9HEC5nsW4wDV7wu6WnhWan,813175,2808103,-1994928,625
2022-01-21 07:41:59-05:00,4913,A1VornXbzK5rFgsy9D4qThcPnYVP8AB9RRzWsV1h6L17,9M4dQgz1zWrtKHqZMt9w7PbM9CvmyjhY5ZZ6jjajMzqm,True,19005482,4751370,29237,14618,14619,4BnQKPLuE3DMTtxp8MjUBytgnhvxqq3ZTqZHTVZo4JJh,1169500,5808051,-4638551,615
2022-01-21 07:41:59-05:00,4914,DXEJNyHSCbGZezXHy2xQaSzd37dwJs4dMTgt5VF5UZAG,7fCYM9DWrAX7vgZ11CwQMNd5NU8FB1yrbctxHaPYshpB,True,17849103,4462275,26865,13432,13433,HfEnetJ7uBSmZWCjBNxdvv9HEC5nsW4wDV7wu6WnhWan,1074608,5723243,-4648635,602
2022-01-21 07:42:03-05:00,4915,B9WJfmrYEkVH3L1UWz4qqWpaexHydymbzvEfwNVtB9BV,6mQb4yzGq8jE1NbweKCKSbevnnYVhHYxyc6Gz2a5kJLn,True,130103949,32525987,199967,99983,99984,4BnQKPLuE3DMTtxp8MjUBytgnhvxqq3ZTqZHTVZo4JJh,7998717,37005106,-29006389,614
2022-01-21 07:42:04-05:00,4916,J6jBKPDR6R5cLMqLufw3zoVfheNYs1KF7C4Ft2dakXeA,6wTTLK675Ym6toJRp7tYaUZzisWfgGjSp3X3yJ31xiKt,True,28360240,7090060,43268,21634,21634,4BnQKPLuE3DMTtxp8MjUBytgnhvxqq3ZTqZHTVZo4JJh,1730722,10637454,-8906732,610
2022-01-21 07:42:04-05:00,4917,DDsY5V3F9wnEGBoQFCEf1hvEYuKUaJdysbc7TxhNqe9G,5oBCGzvy8odB8MCxCUvPDqYCnTyteZ4Yy1JDroroygbi,True,28528430,7132107,43357,21678,21679,4BnQKPLuE3DMTtxp8MjUBytgnhvxqq3ZTqZHTVZo4JJh,1734286,8775178,-7040892,607
2022-01-21 07:43:38-05:00,4918,GxFxvEUdWofneMmVvhCSScH9V6Zia5WJ2J9q6CpPnaq3,ATLykiHDii3Lw53MoZXwqu1FbBNPJbVNVGe2SoQMjVmY,True,905957,226489,1363,681,682,HfEnetJ7uBSmZWCjBNxdvv9HEC5nsW4wDV7wu6WnhWan,54524,573695,-519171,601
2022-01-21 07:45:31-05:00,4919,4ne6vC7qdxQYHJCsaeFAKZrKdFt2SwXGHQ3jrMHqt4DL,Cf1dLHY2WXH9rXbRKq5TT8THbdo9SdNUZq4rYhRCF9z,True,27456718,6864179,42842,21421,21421,4BnQKPLuE3DMTtxp8MjUBytgnhvxqq3ZTqZHTVZo4JJh,1713684,9055494,-7341810,624
2022-01-21 07:47:16-05:00,4920,2mfcg17QocKKvDcqDH88TwxHRiS8dAQiJAGoAh1brns9,8aQLELBgaA9eXsxSciMjxWv8B1hpbUPfLwqVjEnasZbe,True,63331148,15832787,95457,47728,47729,HfEnetJ7uBSmZWCjBNxdvv9HEC5nsW4wDV7wu6WnhWan,3818296,20571012,-16752716,602
2022-01-21 07:47:19-05:00,4921,GNkEoVMpNAgfyDBZ986MR9BEVc485xpLuZWwSCyZk5zJ,AT2eiaMyZNHZGqgTdie8QjLWCTrWSdkRmQxU2vZNgtDs,True,22778221,5694555,35009,17504,17505,HfEnetJ7uBSmZWCjBNxdvv9HEC5nsW4wDV7wu6WnhWan,1400384,6024704,-4624320,614
2022-01-21 07:47:19-05:00,4922,8trFFwvXKKMwMx952ugCZmqyw29e1HxEKBuQmFn8ZwTf,FsD7gCvHXM3QchQiDcd292ksy5afZMWApneNTat5ndeS,True,115570944,28892736,172729,86364,86365,4BnQKPLuE3DMTtxp8MjUBytgnhvxqq3ZTqZHTVZo4JJh,6909196,32983380,-26074184,597
2022-01-21 07:55:07-05:00,4923,72woixtGAuGazCMfsYfYBYLP7FuRj8Fwz9fynFo4MCE4,5237BmWkKf58PBeTUEiu3Ld5uKXEe8wcrJRmCnUoWWku,True,197116644,49279161,306745,153372,153373,HfEnetJ7uBSmZWCjBNxdvv9HEC5nsW4wDV7wu6WnhWan,12269831,66473165,-54203334,622
2022-01-21 07:55:38-05:00,4924,HPDN6Ro6gPgYbNgnv7yhFCpyY3uYzT18epFxRFNZ985w,3Jop74A52E7gYLXJRUAoPBzSZ6mmP2gmaCg7eG6eQHu5,True,221108554,55277138,344656,172328,172328,DddJ7EWCmYEEZETCBNgAUSg81Ls6fZtiAaY5ekJ5sXx1,13786277,77452706,-63666429,623
2022-01-21 07:55:38-05:00,4925,6oroGB3mvzK3tDfiB9X2NJuL3x476pxhgRnt7VxqhdLo,2SoK8tKkLn2ppKURpTVazKsCEis4uahkHMsac1m85J4r,True,358999,89749,558,279,279,HfEnetJ7uBSmZWCjBNxdvv9HEC5nsW4wDV7wu6WnhWan,22342,375994,-353652,622
2022-01-21 07:55:39-05:00,4926,2s9VGesQYbKr3LwuraMEa9sXbXz7f8299HPPAHgSaUdp,8uMS2GDsbmygjbRnc2gjwNkXKogmJX1i8nchmqt8ixCe,True,8973214925,2243303731,14021006,7010503,7010503,3uL2NSR2ZdDqCiKfzA5SwwpddAnit22DBJo6uvvz1rRs,560840260,5242497358,-4681657098,625
2022-01-21 07:55:44-05:00,4927,HVZkXeDR3mc8oB9qFFwCK4RXpPojdcHk9tRGep6xtKGK,Bh3py7awPejWqeTMxtAgF7mPotL2Asxf8YrYJykq9nBt,True,1321297,330324,2062,1031,1031,3pStmNaV47N2sqUtHJHLAtCKiN9JZ6jzNY9h94ng8G1D,82502,765880,-683378,624
2022-01-21 07:55:51-05:00,4928,8MGEQ1KEMv9WSgVifjN7CQ7tDbJBJbWgGYu71dTDKEPQ,mQY2X9KYVXf9JmGY8XwMK4G8odM4HmWkgEmYYqKnkvF,True,34468361,8617090,53821,26910,26911,4BnQKPLuE3DMTtxp8MjUBytgnhvxqq3ZTqZHTVZo4JJh,2152853,22852499,-20699646,624
2022-01-21 07:55:51-05:00,4929,5sN3cfz4hZjwy2HkAStKWeL8wHhdbkW8F7USzwCzmggh,Fme7U7QY92biAsV3RR2Fj7rJPnpdcov13mmFhVDFuyYG,True,143329331,35832332,223778,111889,111889,HfEnetJ7uBSmZWCjBNxdvv9HEC5nsW4wDV7wu6WnhWan,8951159,78216033,-69264874,624
2022-01-21 07:55:51-05:00,4930,2jPxG5FL6D6XEJsRszJ9cmQ54AWSpZyPFSbn3DpWBSuM,3toQou4UVNvyWYvMvkuv379RVEF2aN2TzCpKKBUqeQV6,True,38692789,9673197,60489,30244,30245,HfEnetJ7uBSmZWCjBNxdvv9HEC5nsW4wDV7wu6WnhWan,2419568,22112028,-19692460,625
2022-01-21 07:55:52-05:00,4931,5rW9kqXB9feGSKSvSMNJF1FCsBYV3vGmTmc8MvzaZ3pi,7AjnjcfPJevW5521hXw4VtgRCfHSsAqyzyArukKfNcHo,True,2203693,550923,3442,1721,1721,4BnQKPLuE3DMTtxp8MjUBytgnhvxqq3ZTqZHTVZo4JJh,137697,1481407,-1343710,624
2022-01-21 07:55:52-05:00,4932,CagSUfZLwXuCdypC4KzU6FSNdmCj9dKDroPcNeaRtsyt,yxw5d1ztZuEUY2QjL7eLpr72QJAj5rJd6ERvg91cy1m,True,324127,81031,506,253,253,4BnQKPLuE3DMTtxp8MjUBytgnhvxqq3ZTqZHTVZo4JJh,20260,171043,-150783,625
2022-01-21 07:55:52-05:00,4933,FtF3PVw8YNJseWPMcA2GEuQZ6nni1mq5kYPa2LrSzfkW,4yr1TM2dXrBvLNMpSaoryuGU2P8D3WG1ZCkvVzWFiQRH,True,54742108541,13685527134,85301098,42650549,42650549,HfEnetJ7uBSmZWCjBNxdvv9HEC5nsW4wDV7wu6WnhWan,3412043951,12703558322,-9291514371,623
2022-01-21 07:55:56-05:00,4934,EL9JxeMvWWLTdVC5QrZzSSgApEwv1nDhZc6yNmH9G8ad,EqSQLSFx1eKkTYAdv5XhekttqVh7TappXAHuv9EedCXq,True,20980,5245,32,16,16,4BnQKPLuE3DMTtxp8MjUBytgnhvxqq3ZTqZHTVZo4JJh,1312,11952,-10640,625
2022-01-21 07:55:56-05:00,4935,GqAS41YJssg9aaEp3hs3sG98APCsXhiQBQszXaSjZ2bN,2wodJ3AhrXdE1T4oVL95KvoBND7PubG5Wd5GWiLCMZJU,True,38050783,9512695,59308,29654,29654,4BnQKPLuE3DMTtxp8MjUBytgnhvxqq3ZTqZHTVZo4JJh,2372341,38200141,-35827800,623
2022-01-21 07:55:58-05:00,4936,BrHRMouGRz3LBNzd9anfdYMhWfg8yUPHL4PqJ8WdEDFS,4uzoLa3mC2VYHAPBoHLX4gTjPTC28rPf2fvEGtJWPYc,True,12190420,3047605,19026,9513,9513,4BnQKPLuE3DMTtxp8MjUBytgnhvxqq3ZTqZHTVZo4JJh,761078,12169419,-11408341,624
2022-01-21 07:55:59-05:00,4937,3qnPsgqW11AcDEmyjmJquPcPLyE3EdJQuVLJ5kinDrd3,86rZadBB7emKio76aFTahpbrFtxd9tqZ4Mxgzaavq2xU,True,31648,7912,49,24,25,3uL2NSR2ZdDqCiKfzA5SwwpddAnit22DBJo6uvvz1rRs,1973,18439,-16466,623
2022-01-21 07:55:59-05:00,4938,BLJgLzizx2yLgd12pVBAHTMqn9J5JA3JHCF8PnLnPyUk,HhDmwMysBFWhXnd3mrV31w75WBRKBS8wJSiEMZgqdUSp,True,204756307,51189076,320171,160085,160086,3uL2NSR2ZdDqCiKfzA5SwwpddAnit22DBJo6uvvz1rRs,12806857,124436059,-111629202,625
2022-01-21 07:56:01-05:00,4939,FKQVm9RsteDe7dQmwx4NGYhz3Wrvwh7TCp9rFbTgAomx,Dbwox8eRCdmH5KXyi5sBaqWzhxtaVPo1teWXJ2kRFT1f,True,138225671,34556417,215528,107764,107764,DddJ7EWCmYEEZETCBNgAUSg81Ls6fZtiAaY5ekJ5sXx1,8621124,134295650,-125674526,623
2022-01-21 07:56:01-05:00,4940,3C2MZQKh9x4zNTCMbhhvoafGaFMwUooqfy9MCgPyXs6E,AHjgWKpYPWe6ketjDHDKFBFsKQiRJ41jnkuo39MVYxZo,True,42409004,10602251,66123,33061,33062,DddJ7EWCmYEEZETCBNgAUSg81Ls6fZtiAaY5ekJ5sXx1,2644947,31329373,-28684426,623
2022-01-21 07:56:02-05:00,4941,EYt1Pzqfwnd4iXSmcpw4T3Edmm1y3GnRhCjcQEEK4Atj,EHqporfvvfg7UQPsjv5tsgZE8u9yyRuEU2DdLpQeXy85,True,22214192825,5553548206,34502501,17251250,17251251,HfEnetJ7uBSmZWCjBNxdvv9HEC5nsW4wDV7wu6WnhWan,1380100053,5272192223,-3892092170,621
2022-01-21 07:56:02-05:00,4942,CBL2NbekJrXvBiAcoj4fzQ4PfLDwTntW7Zt4nruHFYEw,59EvfgYTdKkfjUJz5LddLUAqbEdLaihcMzjcrTZsyzyS,True,1875,468,2,1,1,3uL2NSR2ZdDqCiKfzA5SwwpddAnit22DBJo6uvvz1rRs,117,1074,-957,624
2022-01-21 07:56:04-05:00,4943,2FEbsetZMkRqLjSC8GBbgecKgX5T1T1fci2sLQux29p8,H722Fcd6DkTFRZxqQWbPDufBfXEgmFfhiEpQZWhxwYv1,True,967652,241913,1511,755,756,HfEnetJ7uBSmZWCjBNxdvv9HEC5nsW4wDV7wu6WnhWan,60442,517995,-457553,624
2022-01-21 07:56:05-05:00,4944,HGJoZvLakWfSDFwuvShNBc4kCf7nP7VqzyM3mELpbFEf,12Qn5jin7QvsBngXqYAv4UstyG3b6nRf1jsLp9Dp8G7k,True,3248319,812079,5072,2536,2536,4BnQKPLuE3DMTtxp8MjUBytgnhvxqq3ZTqZHTVZo4JJh,202897,1965444,-1762547,624
2022-01-21 07:56:10-05:00,4945,B4Uc39nKzz9wBRQsCkMR4A7RwTJ8rSuwpR6EQn2AesRb,H49bGZgatRZVpj6QufZRVgYrQtH7LpdbiqKBs23151m,True,5178315,1294578,8007,4003,4004,4BnQKPLuE3DMTtxp8MjUBytgnhvxqq3ZTqZHTVZo4JJh,320315,5666290,-5345975,618
2022-01-21 07:56:10-05:00,4946,DMgD2KCEhTGFLUZ5GnfNcwfiiwKYbyVpoWiN6knMkCAf,5KU2vgBkPTNVHsSULjgX7ZkZS56U3Dy3xqLTxL5sUZJ3,True,285392344,71348086,442483,221241,221242,4BnQKPLuE3DMTtxp8MjUBytgnhvxqq3ZTqZHTVZo4JJh,17699341,221079491,-203380150,620
2022-01-21 07:56:10-05:00,4947,FF8rqfM9PTEjYiVFy8jS81weDRwdaYooux2uSa2LexrJ,JBk1JghH1gged1YpDbkczFXP9ka5ivYSkaYoVbbXD4kg,True,37537994,9384498,58026,29013,29013,4BnQKPLuE3DMTtxp8MjUBytgnhvxqq3ZTqZHTVZo4JJh,2321047,24103514,-21782467,618
2022-01-21 07:56:10-05:00,4948,8nXbrdjjaHB73CRPRenGEQj73wbtEFGDwXsehRGMhsap,43pvdcJ6f27wz94D6ZboKwRJYbyvYCrjsJhYsvk7LJCM,True,12903285,3225821,20030,10015,10015,4BnQKPLuE3DMTtxp8MjUBytgnhvxqq3ZTqZHTVZo4JJh,801236,3943150,-3141914,620
2022-01-21 07:56:10-05:00,4949,BJV5jbowrbELXfDvfMovaQy4PiRf12pLYHimW9bgzW5X,6WXrWso5FvLx7RMCFBzrbzh5qevKkk2LJAihUfWXxXzB,True,4331382,1082845,6695,3347,3348,4BnQKPLuE3DMTtxp8MjUBytgnhvxqq3ZTqZHTVZo4JJh,267827,4359814,-4091987,618
2022-01-21 07:56:10-05:00,4950,96StvqZyFUPtyMr4o9s7K4V29RSNyRpVi76vNwxG5rUf,GZKXFSFq4aGiTaqovtxqNCCVGkAFNXPh4Hep1ZMwdZ8g,True,4620839,1155209,7172,3586,3586,4BnQKPLuE3DMTtxp8MjUBytgnhvxqq3ZTqZHTVZo4JJh,286884,4895027,-4608143,620
2022-01-21 07:56:11-05:00,4951,5dM6X7DVy28oznuB7mhJjdDNte6mcTZ31HLF7DqFDGsR,9UwrfQNmyeymmtrJEabKd3yWVKGP6UbNCRqKe9cLT3N9,True,3903675922,975918980,6056445,3028222,3028223,4BnQKPLuE3DMTtxp8MjUBytgnhvxqq3ZTqZHTVZo4JJh,242257813,1385467742,-1143209929,620
2022-01-21 07:56:14-05:00,4952,U3vvMQ4X4aKzVYfhMw1V1p58HRqaLnuXozqmmefYeD9,7JA94MArkNCFRhBq8f5a32DgMF6aPdFsoC5HvXDQ6NuR,True,62780532,15695133,95716,47858,47858,4BnQKPLuE3DMTtxp8MjUBytgnhvxqq3ZTqZHTVZo4JJh,3828671,42908767,-39080096,609
2022-01-21 07:56:14-05:00,4953,6rb3fRVWJ5cSzFcmuC1YwdrNxiNctvboDF7HwsfyGoCA,H6JaYfFZkRk6iSJrA4nVeuFpMVQtVwQZHVgK1TyaupTE,True,8678,2169,13,6,7,4BnQKPLuE3DMTtxp8MjUBytgnhvxqq3ZTqZHTVZo4JJh,531,8403,-7872,611
2022-01-21 07:56:14-05:00,4954,E1CShgy7M9998q9jyzpnHZxHJR6z5hvnshUJt37kVPtG,96f1nYW4S9APCJS3TXTGSb9UcJDdxJuoBR3pLYqcNz2b,True,35330624,8832656,53848,26924,26924,4BnQKPLuE3DMTtxp8MjUBytgnhvxqq3ZTqZHTVZo4JJh,2153928,20211808,-18057880,609
2022-01-21 07:56:14-05:00,4955,FV9CBGGTbppLnBKh79f2LzD1diTiS5g6u89FcpZHZmnK,Fe7mtmCUziFqbbYTvrhAcAq1Ub7YLfTJRtQ1hG7GzJD1,True,1087743,271935,1661,830,831,4BnQKPLuE3DMTtxp8MjUBytgnhvxqq3ZTqZHTVZo4JJh,66460,582815,-516355,610
2022-01-21 07:56:15-05:00,4956,6BQVtmNsxihi4PcA7MurtguTwa6SmbmKyP14RHyjVZkf,7ZFv5ms4HzVKiw7KgE8RUoKxW9rB6JUD7ujZxMx4DwnM,True,662655,165663,1008,504,504,4BnQKPLuE3DMTtxp8MjUBytgnhvxqq3ZTqZHTVZo4JJh,40355,326826,-286471,608
2022-01-21 07:56:15-05:00,4957,CwTus4FyoXYqyTKAYDp69NLhA1joYZ3tarzY6FFTr6fn,6ivuvYWU6i25MzJSY8rG9rPDKiq38E6QtrV1jvRubLGr,True,2095,523,3,1,2,4BnQKPLuE3DMTtxp8MjUBytgnhvxqq3ZTqZHTVZo4JJh,129,1242,-1113,615
2022-01-21 07:56:15-05:00,4958,BZwH7dXogZ1qX5RWqAyiMi8f99fGmebwM56C3QkWRqDd,3avt3UeuxPZj65bCYKotbqAyr5L2ycfkbQp9Z75xqAkN,True,15013,3753,22,11,11,4BnQKPLuE3DMTtxp8MjUBytgnhvxqq3ZTqZHTVZo4JJh,918,8628,-7710,611
2022-01-21 07:56:15-05:00,4959,E1wp3bmkcY3eiEYyGYwhTCsr7BZ7RfPa5DJTZFupcFwj,452hVdYkD5SDDrA6hv6DLPFvyS8PvR2P6DPNScGxWTsW,True,130153,32538,202,101,101,4BnQKPLuE3DMTtxp8MjUBytgnhvxqq3ZTqZHTVZo4JJh,8117,78401,-70284,623
2022-01-21 07:56:15-05:00,4960,7D4rFmGMPKNAF75VRPxHAhSn2wTjiW8jmth1UD22Xqq9,GQ7BrT6vsXu8tHCMm75YdxFR2r9QTCrCUbdPEZBSAg9w,True,7737110,1934277,12099,6049,6050,4BnQKPLuE3DMTtxp8MjUBytgnhvxqq3ZTqZHTVZo4JJh,483966,3960427,-3476461,625
2022-01-21 07:56:15-05:00,4961,DH6W3oB22rPJj7PPrey3Rgtn8Tz8kFKQjftajzUFBeKK,5gNsQSAUq8yFVt3FtU854NfuvFQaaCDC6oAqKA6hoZ3F,True,8249810,2062452,12870,6435,6435,4BnQKPLuE3DMTtxp8MjUBytgnhvxqq3ZTqZHTVZo4JJh,514804,4287223,-3772419,624
2022-01-21 07:56:17-05:00,4962,8627qmFevGS1LSDyCgoJjbURcf8CjVFCcxE7U9mWVP5f,3sgQuNcZuGV59Q9apxSBQcV1XAa6og6xa8FLpumvN7iZ,True,8014,2003,12,6,6,4BnQKPLuE3DMTtxp8MjUBytgnhvxqq3ZTqZHTVZo4JJh,487,4570,-4083,607
2022-01-21 07:56:17-05:00,4963,CP2qcTSw1Y5J7jZiEgbtsvJoigRbJ4m9oHGQS8Fiai2x,7Zd1uX1thbuGkp9H4r1t8aLTu9W8MxvUBNjji2FNJa8E,True,8111123,2027780,12604,6302,6302,4BnQKPLuE3DMTtxp8MjUBytgnhvxqq3ZTqZHTVZo4JJh,504160,4672335,-4168175,621
2022-01-21 07:56:17-05:00,4964,X5SF9srgzDgBRBhv8xUWyszYYSQiqFF6cVnVLWzQgp1,7rTqnMkPuUUJFt5px1DxwsUK8U5fQUtnx9N4v6dA4vGb,True,5340,1335,8,4,4,4BnQKPLuE3DMTtxp8MjUBytgnhvxqq3ZTqZHTVZo4JJh,333,3144,-2811,623
2022-01-21 07:56:17-05:00,4965,9Hz4p7gcfDbXBJp8KzhaBBPh9i7xe9kun7zLfDtqPe6c,2bJ43Lep6kp6WY7Ct56oiscKnAbdtC265G5yRvRPFThU,True,189863063,47465765,289186,144593,144593,4BnQKPLuE3DMTtxp8MjUBytgnhvxqq3ZTqZHTVZo4JJh,11567453,60316428,-48748975,609
2022-01-21 07:56:18-05:00,4966,3REbHhGGpn5b2GH67yQy2Dn7ZLNGLfM6hkBNU8UE1BRm,FBeCamJw884cPNpzbzhjSF7CFXyyhjnj3qWWCdBCK1NP,True,958117,239529,1495,747,748,4BnQKPLuE3DMTtxp8MjUBytgnhvxqq3ZTqZHTVZo4JJh,59816,311956,-252140,624
2022-01-21 07:56:18-05:00,4967,CK3ocyWzXQkJJZQmM6bBK4Nv6Rh3UEufjY6DvNU6gJZy,C924o4GY3p2BHLeAbFbe9SEysXqCUyD8sFu2d4NzkAV7,True,1051810,262952,1635,817,818,4BnQKPLuE3DMTtxp8MjUBytgnhvxqq3ZTqZHTVZo4JJh,65417,557599,-492182,621
2022-01-21 07:56:18-05:00,4968,D7XummfEc3NTK4qMvZegV3FrYuqc8mNgnQu3ujwemZtg,HHiRcecqzW7sGFTio7Ph6TYv3dGt64KWv4DEKgKm84fQ,True,1577293,394323,2448,1224,1224,DddJ7EWCmYEEZETCBNgAUSg81Ls6fZtiAaY5ekJ5sXx1,97958,1012983,-915025,621
2022-01-21 07:56:18-05:00,4969,FX5sizQGZcDCaETDyJ3HbLxFwhu4t9bX6YyQM7cVEo9Z,6EqnCsv1JPjz6JX1yLNcf74rmkuhAUx6Sf35QMYGuuF6,True,35372816,8843204,55087,27543,27544,4BnQKPLuE3DMTtxp8MjUBytgnhvxqq3ZTqZHTVZo4JJh,2203486,20325952,-18122466,622
2022-01-21 07:56:18-05:00,4970,8sneA6wAg6geVDJ1g7YWg4R1PfjuRVzeHp1nUBJinhZa,14i1uWtmcTjrdbg3DSr9vzd5NBnxqsn1A4QdgFBZqeYM,True,60399,15099,93,46,47,4BnQKPLuE3DMTtxp8MjUBytgnhvxqq3ZTqZHTVZo4JJh,3757,31157,-27400,622
2022-01-21 07:56:18-05:00,4971,54grbLQHZsNK4qTyXb8kXAU12Af9QUNFMujuzLLHHHef,3Ua1LDmZfPxvpaCp45RJ5xn3ovNuMxyWGrxnLcsK2ko3,True,319874321,79968580,494017,247008,247009,4BnQKPLuE3DMTtxp8MjUBytgnhvxqq3ZTqZHTVZo4JJh,19760683,174508311,-154747628,617
2022-01-21 07:56:18-05:00,4972,3tmdrjoBp8JsjUxZ87Fqjwsfmow5pjYjRyuYdvtjwK2D,uhC85HiGrbC8fBsU227msvkzEDAcY2EDAJcYoBR31Qg,True,17453409,4363352,27231,13615,13616,4BnQKPLuE3DMTtxp8MjUBytgnhvxqq3ZTqZHTVZo4JJh,1089260,14037217,-12947957,624
2022-01-21 07:56:18-05:00,4973,GaEpNGa8jnwSRvjzzEMYkZe1pKcr2eiZtePrqFxpABjB,5CFZHuyWbJv14zPdX5dSQDREgHrCb4vsFvB6hLiEe3Ji,True,24603,6150,38,19,19,4BnQKPLuE3DMTtxp8MjUBytgnhvxqq3ZTqZHTVZo4JJh,1534,14354,-12820,623
2022-01-21 07:56:19-05:00,4974,i7TcF4weYcqgrRdH3GpndbEYxCxfcSfr9JWYrAUg1CF,BkDfknUir7PnSEW8auoB87PytycEFwyX5kT2GY4SGJJL,True,853391,213347,1332,666,666,4BnQKPLuE3DMTtxp8MjUBytgnhvxqq3ZTqZHTVZo4JJh,53284,870173,-816889,624
2022-01-21 07:56:22-05:00,4975,5yPGvUz6JWKjkViGwTCpygJii1rP2xv5yx146ULtBiYq,FMnHUCQWTf1UHu5qVFqUAsWh8aba9EQYTEoiXy55totD,True,970607850,242651962,1478494,739247,739247,72FwbpFGoLEazJEdpqNtPNefsadUrimUqma9wSoy4qiS,59139783,246891041,-187751258,609
2022-01-21 07:56:23-05:00,4976,AA6QgBaH9F8QfPT9xjztv9uELcADPxwUuXofkBV8dYg4,FCMXozSstTNA74FVCJ5hpYvNJamjutnoakHoBVnzwcWj,True,4293,1073,6,3,3,4BnQKPLuE3DMTtxp8MjUBytgnhvxqq3ZTqZHTVZo4JJh,268,2671,-2403,624
2022-01-21 07:56:23-05:00,4977,2iG781tfP9H77hcFimqp5X9KB9QsbVkQVS9q7emJAJXX,5XDdJMfPSs8WwZZgEtv22RQXEbg748ia4gGfZCy1n4jy,True,2410210,602552,3751,1875,1876,4BnQKPLuE3DMTtxp8MjUBytgnhvxqq3ZTqZHTVZo4JJh,150067,691043,-540976,622
2022-01-21 07:56:23-05:00,4978,89CkXnSZnr52Zsoh48efv9MQacrkB6GMtrbEpNJSyA2H,HcvRBS4Z22CpYgDNgm4TVF4AVXFDuYzBUAFcdHAwdpg4,True,484094,121023,756,378,378,72FwbpFGoLEazJEdpqNtPNefsadUrimUqma9wSoy4qiS,30254,280285,-250031,624
2022-01-21 07:56:25-05:00,4979,3WcJUt8jQ1ngL3ZCGo6dFrc3GmTMTYtzeDva7mri2Tqx,HeG1Pz2oMjqtkfsRMsbqP3VpatnVEQzcWmKDVoFp4Htr,True,3245380,811345,4986,2493,2493,72FwbpFGoLEazJEdpqNtPNefsadUrimUqma9wSoy4qiS,199451,1964934,-1765483,614
2022-01-21 07:56:25-05:00,4980,BYvjENe16Ta77PqGV7JKEWrsqCTfkMGYwTSG5gXneDvd,EvxAXgvhPC6QkNurbK7vWyTApGo8J2R4EgMAknkHVU3d,True,617973,154493,942,471,471,3uL2NSR2ZdDqCiKfzA5SwwpddAnit22DBJo6uvvz1rRs,37703,488705,-451002,610
2022-01-21 07:56:25-05:00,4981,6Bq55LtGCEeGqh4JrFLCmmGc2iJfTTBJixivqH78aGSE,DSNrCgWJeNe2P9tAQu5FvCueTzNKDKds7wzuwTQSMRG,True,1373197,343299,2102,1051,1051,3uL2NSR2ZdDqCiKfzA5SwwpddAnit22DBJo6uvvz1rRs,84088,725991,-641903,612
2022-01-21 07:56:25-05:00,4982,FuoFPNTdYVDkSHaBac6UC1aNJXafSNTvFJuBCdrgQQrH,ApBS1Fx83tcECMzDV6wEzEzEdg4e2hgj3djtjRUoSKK5,True,1149010457,287252613,1777097,888548,888549,3uL2NSR2ZdDqCiKfzA5SwwpddAnit22DBJo6uvvz1rRs,71083892,461822882,-390738990,618
2022-01-21 07:56:26-05:00,4983,8W9NJfM6cqCsvR1FC8Ab8YZPSQF7bz7inxJZxWnF7GsX,3exfPuVcTnPxs8GwCtS3ruKUGveYymwGV7RXQssPiizJ,True,63530300,15882575,98860,49430,49430,72FwbpFGoLEazJEdpqNtPNefsadUrimUqma9wSoy4qiS,3954414,63574213,-59619799,622
2022-01-21 07:56:27-05:00,4984,2BH44k4TYoQSqsSs5EASqJhxpH17Fr8Ahxbg2MAkWa72,HwvvVWpqfN7NDsVYdxbCSbqxSrLCThwnJiZQHh2w2zJb,True,2897,724,4,2,2,4BnQKPLuE3DMTtxp8MjUBytgnhvxqq3ZTqZHTVZo4JJh,181,1655,-1474,624
2022-01-21 07:56:27-05:00,4985,AaMCg49sJwNtdB5wHACg15TYAzzJXy8xtG4zuVXhKiVE,HbDYqDa9bewGPvsiaHRM9HmEvh1scPaUaGvqog66gYir,True,32728645,8182161,50270,25135,25135,72FwbpFGoLEazJEdpqNtPNefsadUrimUqma9wSoy4qiS,2010809,11463983,-9453174,614
2022-01-21 07:56:27-05:00,4986,9ebpuMtXee3DSx4qWiEYEtTT1gK5FqCY2H5yQVWWtTts,9b71dTsTYD1bx6KsjFs5h6d3Jj4T9eX3nqmS7RQj3HS5,True,60513836,15128459,93431,46715,46716,72FwbpFGoLEazJEdpqNtPNefsadUrimUqma9wSoy4qiS,3737262,34502377,-30765115,617
2022-01-21 07:56:27-05:00,4987,EhANPABkSw9x9WnsDEi8pCg67iQTX2UGTTUpyjADTwdN,4FKLi98hyg9ZjM4MY6ctJsv7B6vPUnTYWdhrnNoYsztX,True,1619124,404781,2532,1266,1266,4BnQKPLuE3DMTtxp8MjUBytgnhvxqq3ZTqZHTVZo4JJh,101297,1139532,-1038235,625
2022-01-21 07:56:31-05:00,4988,Cs2YxkuqBK1kjoYZbUZdUcxapPbv8oC75trwGgWoCPfG,2PgHQM1GhHykE4bQ1ggueAw2Zs1BFUW5hxvMvr8DojKM,True,11361043,2840260,17504,8752,8752,4BnQKPLuE3DMTtxp8MjUBytgnhvxqq3ZTqZHTVZo4JJh,700199,8343321,-7643122,616
2022-01-21 07:56:31-05:00,4989,DrzTARa7RK8RXoxHZPKCBqYtMC8TAUHRw8SznXRKTa5M,FYANet92VhyXkKZqqBJR4sFxuCftWb68sgQU9VHCdTJk,True,5331,1332,8,4,4,4BnQKPLuE3DMTtxp8MjUBytgnhvxqq3ZTqZHTVZo4JJh,333,3027,-2694,624
2022-01-21 07:56:31-05:00,4990,GKKRAsYGdcf47eFThG4KwhNv7egeHRuc2wmTh4kqpego,4ippJxgnqCtdtGzCkdZoYwv68fiXNSqQcgrnaHdXZDUa,True,298007834,74501957,466378,233189,233189,4BnQKPLuE3DMTtxp8MjUBytgnhvxqq3ZTqZHTVZo4JJh,18655135,144661181,-126006046,625
2022-01-21 07:56:31-05:00,4991,GCNi25P1Ywvfx5JpyxFVV68sRkio7LEhFgY85ZqveKR3,34mxz8fCss7KNAbEi2Wj9z5dTgXCGxuq2vyqzBPChtmq,True,4041941639,1010485409,6289280,3144640,3144640,HfEnetJ7uBSmZWCjBNxdvv9HEC5nsW4wDV7wu6WnhWan,251571215,1914359920,-1662788705,622
2022-01-21 07:56:31-05:00,4992,ymyzGH4Qc7HH5PbKpVphCbsQgLLXyGkPcXamQJuNj5C,8oTLHaV2XzbKXNWRuUjCfHjUn61Pw93LYK14m9q2VDpZ,True,2748920,687230,4183,2091,2092,4BnQKPLuE3DMTtxp8MjUBytgnhvxqq3ZTqZHTVZo4JJh,167324,1456686,-1289362,608
2022-01-21 07:56:31-05:00,4993,BPsM1um9ZJf7eNoVMsQCRSwgARMuLCGGSDxf9tZeNeEy,BpzDdXfxVygiSYSmsHV6uPxQMeTFtrURMCCqhswQjd5X,True,240985,60246,366,183,183,HfEnetJ7uBSmZWCjBNxdvv9HEC5nsW4wDV7wu6WnhWan,14645,129988,-115343,607
2022-01-21 07:56:34-05:00,4994,6h43GsVT3TjtLa5nRpsXp15GDpAY4smWCYHgcq58dSPM,CTgbWridYWnfE5Emwr7qiCEb3LcXHupqeB9zwmddoEqB,True,25615069,6403767,39816,19908,19908,72FwbpFGoLEazJEdpqNtPNefsadUrimUqma9wSoy4qiS,1592655,24746106,-23153451,621
2022-01-21 07:56:34-05:00,4995,Cb4zhnvig11U4GcC4kqKrnDicGgPhUpfDQB1U7hP3nPa,DiRAMrKqaevGXeXg38KnhaYBERj8tNKU7oWFJvhS32kw,True,32552,8138,50,25,25,72FwbpFGoLEazJEdpqNtPNefsadUrimUqma9wSoy4qiS,2026,16992,-14966,622
2022-01-21 07:56:39-05:00,4996,2PzBAkdXkrwH9VuoMALumQz86qkW7sSBQtCrHw14JUp3,D5vwWAMHVooobG2sCWv9EwtJrAFZG6cwKH4dfmA98tbt,True,419746,104936,651,325,326,4BnQKPLuE3DMTtxp8MjUBytgnhvxqq3ZTqZHTVZo4JJh,26071,247713,-221642,621
2022-01-21 07:56:44-05:00,4997,2rCRdyfi65rpxRRmg7knaSb8t55FuPt3h8wF4Fzhy8MM,CLVY5nSG3jTdRo7tRSKgK9DJgW6aswfWKe4tLxzsENmb,True,101733,25433,158,79,79,4BnQKPLuE3DMTtxp8MjUBytgnhvxqq3ZTqZHTVZo4JJh,6353,53820,-47467,624
2022-01-21 07:56:44-05:00,4998,7vKmhLV45Q5etXhJL5ng8rxWhYSiUCDmAbGnwBPr7zcx,cP6xPeuHLnjr858QK1F9qYn7rJpEbPy7wEJHoju6oV7,True,6984357,1746089,10906,5453,5453,4BnQKPLuE3DMTtxp8MjUBytgnhvxqq3ZTqZHTVZo4JJh,436272,4090665,-3654393,624
2022-01-21 07:56:45-05:00,4999,Ar5QB4VBcUyzSCG23z2QNAbrWY55NbHCr1MNN6P2GAmh,BusFGTiDrJmxzwGUxWz9b3SFF3eseqtgh2DRHqyAwyVe,True,74686,18671,116,58,58,3uL2NSR2ZdDqCiKfzA5SwwpddAnit22DBJo6uvvz1rRs,4654,45130,-40476,623
2022-01-21 07:56:49-05:00,5000,3y34hmyz6rsVnpp7d6a9s2Xw9GdezLU1H44HfieG6SGG,9DCz2eyYsrk1Hd5zsSVBhKTV9QD6beym5zB5fH3aA4hE,True,166744412,41686103,260795,130397,130398,3uL2NSR2ZdDqCiKfzA5SwwpddAnit22DBJo6uvvz1rRs,10431838,161035696,-150603858,625
2022-01-21 07:56:56-05:00,5001,D3mXrJzhHf8qRaoCKLschUxAFoijFCFuT6bmNZH4W7Cj,9E3Xtqw7TncXWnbhAbFJMtuNmP6WS3ooGuptzyzw7UpA,True,9342,2335,14,7,7,4BnQKPLuE3DMTtxp8MjUBytgnhvxqq3ZTqZHTVZo4JJh,584,6942,-6358,625
2022-01-21 07:57:04-05:00,5002,5Z3ZFCA65WoWhm3okRuuziEMi7ajGAEHWUFchzBNba5S,FcomdrWidygkxMKzcsY5xELbmwC652uMci648LMTv7AB,True,2007,501,3,1,2,4BnQKPLuE3DMTtxp8MjUBytgnhvxqq3ZTqZHTVZo4JJh,125,1156,-1031,622
2022-01-21 07:57:05-05:00,5003,GhV3DChNShu8mGwUUy7VLidabCV6Y2aKdp7cqPynd6Ci,8R8QkgruGRCeE1pjXmn3WjdVDiawNbXFid8gU8BfabZA,True,2878,719,4,2,2,4BnQKPLuE3DMTtxp8MjUBytgnhvxqq3ZTqZHTVZo4JJh,180,1639,-1459,625
2022-01-21 08:00:19-05:00,5004,5hJereyPSCNUrGW7TdYXHKjhXMWTbGZzc2GF9MWksLJE,AUE3NpqaeamHGBKUVuKnUhnBb4Lzt7xWU1FHMu1Hq5dC,True,265282668,66320667,413312,206656,206656,HfEnetJ7uBSmZWCjBNxdvv9HEC5nsW4wDV7wu6WnhWan,16532484,88125326,-71592842,623
2022-01-21 08:02:02-05:00,5005,EDSf2w1UyGvbgMuxyoXL58ifR1dviZinnLBYnFmgjcNG,DFenkzbL9SUjs9cSCaHJ1eXK75mHfk3GSPRFs8TSzrFV,True,1426277290,356569322,2220342,1110171,1110171,HfEnetJ7uBSmZWCjBNxdvv9HEC5nsW4wDV7wu6WnhWan,88813692,345572737,-256759045,622
2022-01-21 08:25:42-05:00,5006,3Xbsek5MsEGoWr3G9yhuohREr26B2vSQcjqXdspTFHta,2rPxkUiMo9wGDq8EvAiwY3ngRpKmL223cBWWNTYoBmFp,True,55232438,13808109,85506,42753,42753,4BnQKPLuE3DMTtxp8MjUBytgnhvxqq3ZTqZHTVZo4JJh,3420277,17839020,-14418743,619
2022-01-21 08:36:31-05:00,5007,DRVtEzZs9u9ysrcANZLEjrvbuuGqYn77v2h4cDFKuNUx,Fv9qiMZhuSBL2cs9AWUYbDLQjB46W2ZwrhxaNXtPLDpC,True,24965516,6241378,38990,19495,19495,HfEnetJ7uBSmZWCjBNxdvv9HEC5nsW4wDV7wu6WnhWan,1559624,5346370,-3786746,624
2022-01-21 08:38:40-05:00,5008,Br1j5Ftafei7ysu5SmqVZSoRe4uS4qCPeKSPHg55pyiE,G8fc7QvXjfkgBFvAVUgJFQS3VaF1biL9rktBExGa87Ks,True,1957767792,489441945,3059450,1529725,1529725,HfEnetJ7uBSmZWCjBNxdvv9HEC5nsW4wDV7wu6WnhWan,122378028,894886087,-772508059,625
2022-01-21 08:38:40-05:00,5009,4xn9vTtLZyNtCbBLLpcXUMWU8AnnZCov9rJaY6rew16T,5UNWdFw2CP44qS8oc4uPt8zxw6zFg8oXz8SUCedZLLEC,True,6692466,1673116,10245,5122,5123,4BnQKPLuE3DMTtxp8MjUBytgnhvxqq3ZTqZHTVZo4JJh,409834,2143680,-1733846,612
2022-01-21 08:38:41-05:00,5010,DvuRmJkfn6FQczUKgYeaSCqwy2NTMunuAKNrnmxMvnzS,7LpWTX9dgBtW75kfEoB5WuNsDwEdw5s8CYSHh3J4qagM,True,17854540,4463635,27848,13924,13924,3uL2NSR2ZdDqCiKfzA5SwwpddAnit22DBJo6uvvz1rRs,1113957,11594013,-10480056,623
2022-01-21 08:38:42-05:00,5011,FV3G5EsSmyiLAAoREhgDXwvzbxoyDeq4Mwfj4jK5fJ7U,5nhzbJmm5JAwGDpTZoenkM1u3XtMY4uN7Qsm3vFGtRJE,True,17374092,4343523,27106,13553,13553,HfEnetJ7uBSmZWCjBNxdvv9HEC5nsW4wDV7wu6WnhWan,1084256,5099260,-4015004,624
2022-01-21 09:08:54-05:00,5012,HGAFdundf5voDqeh9g7d6Q9mgMf8eEg898QMRBqwPZ6C,deanBuZXWBHEe2TGfP37S9aMBEnEgmZoyRJjAvruzfA,True,44495322,11123830,69123,34561,34562,4BnQKPLuE3DMTtxp8MjUBytgnhvxqq3ZTqZHTVZo4JJh,2764935,26342140,-23577205,621
2022-01-21 09:10:51-05:00,5013,2MbNCikBC3fdwqJKfMK1FjPg7wT3xWMXmN88XuikJ8r9,5eG6U5x63YYMpE7iwwu1TPcZapvQMyKczvtnFfST1BH3,True,73211,18302,114,57,57,HfEnetJ7uBSmZWCjBNxdvv9HEC5nsW4wDV7wu6WnhWan,4582,26763,-22181,625
2022-01-21 09:19:27-05:00,5014,56488NdcUy6Hi6X5SLs2GFtW5pG4u5wJpH7vHdxTCx4z,tGgXjJeVr3W2m3T2NXPCqpBEd6HJKE2cRsgCyiDZQy4,True,27657516,6914378,43101,21550,21551,HfEnetJ7uBSmZWCjBNxdvv9HEC5nsW4wDV7wu6WnhWan,1724077,14112222,-12388145,623
2022-01-21 10:27:05-05:00,5015,AvwHizRhHUSahmvSg4jmTUErc7vAFSmkRAEsiKhXfW1m,3UrWYx8y9N5o9GYneSe6zyyHRTZzxwvcipQfHHYh7tEs,True,541345,135336,840,420,420,3zqXX6kzhkbW3d4TwD2CNjMRwxTbREXySekvq37kfCNk,33610,283858,-250248,620
2022-01-21 10:27:05-05:00,5016,DC4UVUDFWL3gVtgkX9hPtFgtxaA8DH5p94i4k9U3wyWv,3HCWqVvQQfRgSKitsTjGTduJ82ointZUSNtj13uea4kD,True,367977254,91994313,569283,284641,284642,3zqXX6kzhkbW3d4TwD2CNjMRwxTbREXySekvq37kfCNk,22771352,187289058,-164517706,618
2022-01-21 12:56:13-05:00,5017,7oxuCEhooUZ5z2nnZRD226rcqdZgAR75SamX9DD7ejUf,CPqBb5ptWUPUJhVjshxNZCHd5RDF3fve29z4vz72JhvM,True,164719,41178,257,128,129,3zqXX6kzhkbW3d4TwD2CNjMRwxTbREXySekvq37kfCNk,10309,63135,-52826,625
2022-01-21 13:23:42-05:00,5018,H3x9b27yHVdCxvtDf7mmJxkNeubcmQMwfAkLTYADPWNv,HGVCCz23rWx78vrTB2wvm2aesbLZuYFhhNuznGiSSAyA,True,1296765354,324191338,2023398,1011699,1011699,HfEnetJ7uBSmZWCjBNxdvv9HEC5nsW4wDV7wu6WnhWan,80935952,366894218,-285958266,624
2022-01-21 13:23:49-05:00,5019,CLVUzXSNsQnX7n5cvxMuTjyMSjy1pNpPnWejFaeuonvb,BXZzBujr8DAUcGJcHQBaz1ZSwkATAHg3NX3bLnrjQpLh,True,75511529,18877882,118150,59075,59075,3zqXX6kzhkbW3d4TwD2CNjMRwxTbREXySekvq37kfCNk,4726030,14254501,-9528471,625
2022-01-21 13:24:25-05:00,5020,H1oYXGZTagwv48FdDe6RNkjNaesedqLKyXxTmPc5k4Fp,Am3rx6XrkrZ4MdeZDyZUv1YW2fBujcz4dLjVCnRQHKZa,True,711205017,177801254,1112209,556104,556105,3zqXX6kzhkbW3d4TwD2CNjMRwxTbREXySekvq37kfCNk,44488396,149533379,-105044983,625
2022-01-21 13:27:44-05:00,5021,8abFwhhZyq3xkvjp4NWDBt7qAPXBbzBxksUk8SAUeVkN,A9u4dhWZbBwthC4WXQg1Dfp3wHYXr67SGs5na1EQ1k3r,True,22188129,5547031,34573,17286,17287,HfEnetJ7uBSmZWCjBNxdvv9HEC5nsW4wDV7wu6WnhWan,1382939,5868704,-4485765,623
2022-01-21 13:27:45-05:00,5022,DMACzuFBuj2vGqxZ3FV7QAo24jMV3EHKL8MrDrGbRkaJ,EnLfmDVW4ba2uqZKhj3X1TFnx8AHv7xwSWrMbVBYwcu9,True,35107223,8776805,54935,27467,27468,3uL2NSR2ZdDqCiKfzA5SwwpddAnit22DBJo6uvvz1rRs,2197416,13881371,-11683955,625
2022-01-21 13:31:39-05:00,5023,H1Z83zVoskNuBvYao1FjdLfETfhPpQFQUkniJfGxbaNz,EVqbBRV6Zy1tPLRevxpAykp8Mvv6tDZVTc4RmCKw4Gq1,True,572450304,143112575,895004,447502,447502,3zqXX6kzhkbW3d4TwD2CNjMRwxTbREXySekvq37kfCNk,35800169,292957695,-257157526,625
2022-01-21 13:31:55-05:00,5024,JDeYjCLpfnzcfxDFgHf4aBcHsajwdR14GUaKAA9euzVf,EJbvKoyMZcoCx4vWa61uMbW2vr6mUhrgEuECdteVBuZZ,True,2210021,552505,3441,1720,1721,HfEnetJ7uBSmZWCjBNxdvv9HEC5nsW4wDV7wu6WnhWan,137665,1573074,-1435409,622
2022-01-21 13:32:05-05:00,5025,442usWu6XpJZvU25bqXeynRrQ15jAzWwU9DWMgHpTn3Q,CtvADKp39bjJf3cPKWNL3wxnhq273fVM4fC5DmEcg5cC,True,15553495526,3888373881,24141628,12070814,12070814,3zqXX6kzhkbW3d4TwD2CNjMRwxTbREXySekvq37kfCNk,965665135,3551339520,-2585674385,620
2022-01-21 14:52:17-05:00,5026,AWvHDdb2ikqV8wc7qQ8azbvNTZdixMNxhQjhQdhayYtR,9EpgEPBb1nog6aQeFdMXfSRiLSnzGQFQ39mbLdCxgYTv,True,13088394,3272098,19773,9886,9887,DddJ7EWCmYEEZETCBNgAUSg81Ls6fZtiAaY5ekJ5sXx1,790947,5401110,-4610163,604
2022-01-21 14:52:17-05:00,5027,GufVttJatW8NLeztT1NRQSLZpQNRk45kaG41p3QcWhx7,GTJUsWoWRyeafYJVhx2aRo8NE94U5UrBjaehmJ4PRUhn,True,7939917,1984979,12370,6185,6185,3zqXX6kzhkbW3d4TwD2CNjMRwxTbREXySekvq37kfCNk,494800,3231260,-2736460,623
2022-01-21 14:52:17-05:00,5028,6NJFN855M3Q3RLTDNo57gTgAmwPD6G2E3WvMb1m5eNCN,3YpqNnonsvXaRT4nCC3G5FZx1jjVtbDPc36LiR6WK5jR,True,21527185,5381796,33392,16696,16696,DddJ7EWCmYEEZETCBNgAUSg81Ls6fZtiAaY5ekJ5sXx1,1335693,15103893,-13768200,620
2022-01-21 14:52:17-05:00,5029,Bsr6kx1B6BSEd5UnJ7Z61M49iUb3bFrDVhiEtMVtPDF2,3CFd1pUJAJPA9fobwn4Jj2mRju1CWmoop4Mh4znypNWT,True,8283469,2070867,12641,6320,6321,3zqXX6kzhkbW3d4TwD2CNjMRwxTbREXySekvq37kfCNk,505641,3998901,-3493260,610
2022-01-21 14:52:17-05:00,5030,DWTaeNeq5x83cBvKUz2jZfXDz5z4F5wbSZLNv7smnjvd,9pQGArZnJV4Fu8tBVEfknmmfmrRv5RKV2u58BJBuhzpF,True,26467649,6616912,41203,20601,20602,3uL2NSR2ZdDqCiKfzA5SwwpddAnit22DBJo6uvvz1rRs,1648147,12680562,-11032415,622
2022-01-21 14:52:17-05:00,5031,HHHj6EinpgAJeZkDXfsvCo3UXnmAdiAZNvPSUfVPc5Sg,3gx9c31MDtJtByxkUuWcqf1oARnZTjpx3QtxsM1Xb6Gp,True,212670090,53167522,327648,163824,163824,3zqXX6kzhkbW3d4TwD2CNjMRwxTbREXySekvq37kfCNk,13105937,94275342,-81169405,616
2022-01-21 14:52:17-05:00,5032,5eMLdQ4gYA5iqvTXSNdGvctHp7s5VpyFuwtJKqx6chBc,Ckxc5K39nkBNXBTmFTM8J48R7wGqNm3vHKZu4G5baumZ,True,92710234,23177558,140340,70170,70170,3uL2NSR2ZdDqCiKfzA5SwwpddAnit22DBJo6uvvz1rRs,5613629,41811724,-36198095,605
2022-01-21 14:52:26-05:00,5033,D64rDiWT3YG28fCgXCmbNjYa2JakZbpKQ1D2XuLChUfV,8WmMWq8cTsGQym5pUbHm9dPCpJugBeWUMVERYFGLxWHj,True,10110377,2527594,15816,7908,7908,DddJ7EWCmYEEZETCBNgAUSg81Ls6fZtiAaY5ekJ5sXx1,632656,4599472,-3966816,625
2022-01-21 14:53:45-05:00,5034,J1sBDjpdBZcsSBS5eg95SSRjRqmQUR9cXJCsLJu8yCUt,F5wRpD2senMkGbL8Uquqo8W9x5NQDDa268dHuVFAZCww,True,1366432,341608,2136,1068,1068,3pStmNaV47N2sqUtHJHLAtCKiN9JZ6jzNY9h94ng8G1D,85472,749630,-664158,625
2022-01-21 14:56:33-05:00,5035,3idUQDMPAN9f6F6BipHAYFZyhG5JADey1y7JcFYx5BRh,D6UMk8WsSRahs4nGyi9DLt2HyZQy4wAywDwL31sL8BVj,True,14561829,3640457,22777,11388,11389,3zqXX6kzhkbW3d4TwD2CNjMRwxTbREXySekvq37kfCNk,911115,4401934,-3490819,625
2022-01-21 14:57:00-05:00,5036,2SNV9Q6vzQP5XxxqSrwXpQdRvk45FPiqLXmhNZzbLt1k,6dLG3ojK5Unm1mBh9aDZfryvoT2a6cSuWA8CxXy3oi7n,True,531158518,132789628,821726,410863,410863,3zqXX6kzhkbW3d4TwD2CNjMRwxTbREXySekvq37kfCNk,32869065,251710547,-218841482,618
2022-01-21 14:59:44-05:00,5037,Fani89KviVFZek4si6YZ3apVuM2kSqVUijDnLBqtvJEH,EpC29dECx1cLC69bj2ncG3jFp7obPaxbH7F6mju27cwL,True,6213786,1553446,9694,4847,4847,DddJ7EWCmYEEZETCBNgAUSg81Ls6fZtiAaY5ekJ5sXx1,387772,1546490,-1158718,624
2022-01-21 15:00:08-05:00,5038,GGcsY84pkqUn2xySuLYrUUg8gWMBWgfHaQ7rK42NoZaH,4EyjJvctL9WBQiauD2Eaf2Hus8htYzHxP5GR2HsUfuks,True,487014012,121753502,761512,380756,380756,3zqXX6kzhkbW3d4TwD2CNjMRwxTbREXySekvq37kfCNk,30460502,188243714,-157783212,625
2022-01-21 15:00:09-05:00,5039,DY6k3Dkwe18iLneaT8Xo3VpJWB6V4jWwQQjoDvEzdg2j,3GGV7S9FpRQGbARBXkvGFVqLrmw8JvYAcpnR1aKVUY2f,True,3503802,875950,5481,2740,2741,3zqXX6kzhkbW3d4TwD2CNjMRwxTbREXySekvq37kfCNk,219244,2471394,-2252150,625
2022-01-21 15:00:09-05:00,5040,8swGZMrPrLAxZd7MxTbkCL13k3DmAJUw41jCp6Xo6awW,3fKnX7yTNXAT4uMmXVdTy47ALJT8h8YSD3WiBb4BGuzH,True,65654879,16413719,102261,51130,51131,3zqXX6kzhkbW3d4TwD2CNjMRwxTbREXySekvq37kfCNk,4090440,36532159,-32441719,623
2022-01-21 15:00:09-05:00,5041,DkvR2xUPMyXWGGkUSmDSfhp7RtvMkfbT1ThKCS3TwrXd,F7jYV6TtT1LZ5XCNn1zkbUfNMo4gGcQUczAQy1jLHpaW,True,172341289,43085322,269481,134740,134741,3zqXX6kzhkbW3d4TwD2CNjMRwxTbREXySekvq37kfCNk,10779274,93846044,-83066770,625
2022-01-21 15:06:30-05:00,5042,9E97vZ6evPgg1Ao8KwvjjZhBFW6dXZrrJENk1HvZ3SU,D7U38PB8BXLwUVKbRNv9po7VcFdnn7Y4tWY9xpRiNJsT,True,19649364,4912340,30652,15326,15326,3zqXX6kzhkbW3d4TwD2CNjMRwxTbREXySekvq37kfCNk,1226100,6708619,-5482519,623
2022-01-21 15:11:30-05:00,5043,3JrhHRs4UkkuMoCrQAaAGKZQrWoU72zWArnDGxKFESzH,8yREVE3kMYB7UAwtUDnTDK3egXTuTsN4igtJ5yeHYkCP,True,286154546,71538636,447425,223712,223713,HfEnetJ7uBSmZWCjBNxdvv9HEC5nsW4wDV7wu6WnhWan,17897000,88243893,-70346893,625
2022-01-21 15:13:09-05:00,5044,6uZobpBuFcQeYgZ4dApFi6iy4DB9GLHP1AAsQcCj6212,SGGFiPjjhscwroiWMqY4jTAHFw8eakpsEv35wNoHUPY,True,81030557,20257638,126337,63168,63169,3zqXX6kzhkbW3d4TwD2CNjMRwxTbREXySekvq37kfCNk,5053510,17968039,-12914529,623
2022-01-21 15:14:07-05:00,5045,BgnsCfJ54ReunUtwPJLzkW4PWnqpBDWGNYxsW5PvDrbK,KpMqEkQ9dKMgCevsEK895wHd3fCLRPSzDmJSv3tKU4u,True,4100241962,1025060490,6295093,3147546,3147547,3zqXX6kzhkbW3d4TwD2CNjMRwxTbREXySekvq37kfCNk,251803735,2000138623,-1748334888,614
2022-01-21 15:14:08-05:00,5046,CxLFMBDFkoMvpK9YUf7WtCq6hn7k3QACAuetAnGjU6KA,2gE52a1GWQnS6ifV6eVtKQyr13LXP5Jdt3yG9SjGPJPF,True,343384950,85846237,529454,264727,264727,DddJ7EWCmYEEZETCBNgAUSg81Ls6fZtiAaY5ekJ5sXx1,21178186,99659880,-78481694,616
2022-01-21 15:14:08-05:00,5047,9WJBnVi84E926j7xEd566WzrZJkPJWRgmEnYj9vyjuad,4dLaFS5F7TGyLdwuJLMGkz3bSL53aHzd9ZfpNmhHxXeF,True,4341291,1085322,6687,3343,3344,DddJ7EWCmYEEZETCBNgAUSg81Ls6fZtiAaY5ekJ5sXx1,267503,2758474,-2490971,616
2022-01-21 15:14:09-05:00,5048,J3ggP7ZxL8HRh3CBp5iYG2WgjLyNSAWYT46uC9VYDLCz,2FqTRiRPiLvdAH2BS5vroVntpsSXvTJEn5UHWmtKHzh9,True,8308923,2077230,12831,6415,6416,HfEnetJ7uBSmZWCjBNxdvv9HEC5nsW4wDV7wu6WnhWan,513243,3565136,-3051893,617
2022-01-21 15:14:17-05:00,5049,399591e8XgY52yCMorCQ2WL6dQZTC485ZooHtmGuirhZ,JCiXAooFmKmEPQ2S7C8iSk6CLcTyrPEe1SsPSLyUGySe,True,302860,75715,471,235,236,3uL2NSR2ZdDqCiKfzA5SwwpddAnit22DBJo6uvvz1rRs,18878,214877,-195999,623
2022-01-21 15:14:17-05:00,5050,7ptPfZnqDCvTWotn8wPGyzERTJYLBgk47j7qf8Ciq941,AfAGcFqFFPi6LCQXydgsPWidN35c7NbhBa7RLEaDQQCu,True,2883611,720901,4503,2251,2252,3zqXX6kzhkbW3d4TwD2CNjMRwxTbREXySekvq37kfCNk,180139,1139714,-959575,624
2022-01-21 15:14:18-05:00,5051,B2hN3Lt5pFbUyfEUc5s48hkxUJ5rr2SeFxgdGdQ8pDD2,7bZJCCud253j9g411HQUDXUAADcwd5yJWznoTChBdB2H,True,1718937076,429734269,2685933,1342966,1342967,3zqXX6kzhkbW3d4TwD2CNjMRwxTbREXySekvq37kfCNk,107437331,371370255,-263932924,625
2022-01-21 15:14:19-05:00,5052,8E3K7vCHJ2xjdFofPRGLbMxrkm8UYEi926QmXPAFwsqe,4qHUDA1c43Dg4qi1ZPKqmpGYiEMUZ6r4UuzB5ftHCEhW,True,401140311,100285077,622465,311232,311233,DddJ7EWCmYEEZETCBNgAUSg81Ls6fZtiAaY5ekJ5sXx1,24898607,257293917,-232395310,620
2022-01-21 15:14:26-05:00,5053,4uygLJDk9DFCifJ56YwMrEsvd3oQNq8tYSLnMCyWorS6,GimL4uKGvg3FFmFQSWzAcjstv3Vmk5NMgDGMKTuXYVpB,True,146744377,36686094,229270,114635,114635,3zqXX6kzhkbW3d4TwD2CNjMRwxTbREXySekvq37kfCNk,9170826,78021170,-68850344,624
2022-01-21 15:14:28-05:00,5054,A4tDE948CPFPh1UwHb8sXryfKktbxZ8BCkqXgA5DJHA8,3zXeKMrsEpCe5fQumLNzCgpxcG1kLJFEAtJuqxLsC6ZG,True,24509276,6127319,38321,19160,19161,3zqXX6kzhkbW3d4TwD2CNjMRwxTbREXySekvq37kfCNk,1532856,13793209,-12260353,625
2022-01-21 15:14:32-05:00,5055,DkKumyFA6dGw77wcwd16nWzTEC9McvmasAbmGfQXLkB7,9u6QyrruYFjhyLV5AXYUKkrBggzrxXfNH57smUAap5Ro,True,16998364,4249591,26545,13272,13273,3zqXX6kzhkbW3d4TwD2CNjMRwxTbREXySekvq37kfCNk,1061816,6754596,-5692780,624
2022-01-21 15:14:32-05:00,5056,C33hfnDHzVwKXxr6AwFAXhd1vJYrPKhtqc75Qpjm19Zt,2WYBMSyrHQEYZqxEtxBMe2xn7eioJEGsudqdCmGvssGh,True,18578013,4644503,29016,14508,14508,3zqXX6kzhkbW3d4TwD2CNjMRwxTbREXySekvq37kfCNk,1160646,5124397,-3963751,624
2022-01-21 15:14:43-05:00,5057,HmspGdpobjC5Vbmo3FcKdw4RLPN7wJKxv3uKqDjVhLee,3YEX8TzdyJyuHo76Kw76imVCJjzrC9m188YuRKvwwSwD,True,120711085,30177771,188082,94041,94041,3zqXX6kzhkbW3d4TwD2CNjMRwxTbREXySekvq37kfCNk,7523291,35087677,-27564386,623
2022-01-21 15:14:43-05:00,5058,GKCeRcHQYMhcTwEm5wu1SbkXAT19gjGUGji43HS36B5N,EYQKX5sWsmXoge5xbTcMYAjvRbSUTXXpHEzckPY2LV8W,True,695427,173856,1087,543,544,3zqXX6kzhkbW3d4TwD2CNjMRwxTbREXySekvq37kfCNk,43517,237896,-194379,625
2022-01-21 15:15:15-05:00,5059,8T4WK27RvWVGqPuNqY6whk1fmU4vd5qaUQPZG1GJ79bh,DvSz7knS8N3K7L6JhQf1s4mJSyxB8uJXNQXtyjJn8QRL,True,25956290,6489072,40326,20163,20163,HfEnetJ7uBSmZWCjBNxdvv9HEC5nsW4wDV7wu6WnhWan,1613048,15006684,-13393636,621
2022-01-21 15:15:18-05:00,5060,D9VKhnfLLCrntDGFYSfoxFaY76VnHmYZ1ZbyFXdKdibz,2hRCRH2pMDyQGYcXHa8Y6BZo6FbcGZf5VJC1v8Bp6tGa,True,25979303,6494825,40300,20150,20150,3zqXX6kzhkbW3d4TwD2CNjMRwxTbREXySekvq37kfCNk,1612008,12907968,-11295960,620
2022-01-21 15:15:19-05:00,5061,8kJu5aqVSmW8FSZR9h6F75ftn9V2U9uMLBEKeqRaC855,FhVHByujkvwwtjTVpZ4mqSUqoMoBgeLUc5H7rbz3FgAt,True,24963001,6240750,38891,19445,19446,3zqXX6kzhkbW3d4TwD2CNjMRwxTbREXySekvq37kfCNk,1555675,17778637,-16222962,623
2022-01-21 15:15:22-05:00,5062,FnAT8HKGgisYfeAbxKU2gSbCp8KbZHULRpaJX1NVijHy,2u637Crc2QzfSJmCnRNqeib3aZQVn4NGncpgM3Ph6jvm,True,9683234,2420808,15059,7529,7530,DddJ7EWCmYEEZETCBNgAUSg81Ls6fZtiAaY5ekJ5sXx1,602375,4334041,-3731666,622
2022-01-21 15:15:34-05:00,5063,9KD2AifD5wFD4QkHYuawXbJgLWHrfj2QPF3fT8jhGVA5,Ga9gAqmkuHbqrr31sUFPqa1xa5WNxLWJWGPUaMxQqLdj,True,274692,68673,428,214,214,DddJ7EWCmYEEZETCBNgAUSg81Ls6fZtiAaY5ekJ5sXx1,17143,198415,-181272,624
2022-01-21 15:15:49-05:00,5064,FsMiJiJZibohKoV5QRisWCjzuFd86xSxFb4m73AQmu93,7p3TSKBaG9SV2YNDnhutQKacPKpTTmgsEfzmK51t6sYb,True,58854829,14713707,91296,45648,45648,3zqXX6kzhkbW3d4TwD2CNjMRwxTbREXySekvq37kfCNk,3651876,26461740,-22809864,620
2022-01-21 15:15:56-05:00,5065,AUH6YGBV8tDVX1E1WTo92Mubfx1DGsqfGeyUBqxo4fSr,33QZgMwmW32WuvmxD8XNbmF9ea88bLe3YTtNwHV73Wwu,True,58900660,14725165,90987,45493,45494,3zqXX6kzhkbW3d4TwD2CNjMRwxTbREXySekvq37kfCNk,3639501,26965121,-23325620,617
2022-01-21 15:15:58-05:00,5066,H3394S5wdbwXB4scjGAY8NsXxCdGy1Xebct18s42FM1K,Hz84L1EquzhCvBJP75ScKug46hYGdNMVNH16AdG4y5D8,True,13243141,3310785,20658,10329,10329,3uL2NSR2ZdDqCiKfzA5SwwpddAnit22DBJo6uvvz1rRs,826325,6824723,-5998398,623
2022-01-21 15:16:00-05:00,5067,3VdSA9CED9f5swRwHX2U15U7J6Muaq8VPnCNy9CaGDHe,2YYstfnfdYic5NWmEbcUEHpccNUVd1EhuCkExvMsoMk8,True,1413736,353434,2208,1104,1104,3zqXX6kzhkbW3d4TwD2CNjMRwxTbREXySekvq37kfCNk,88343,1011714,-923371,624
2022-01-21 15:16:05-05:00,5068,A36aouot1oFLUtswuBUM4EVcis9chKaSJu53MRoPDjab,33U9gpq1RRFMGWDrWa3ezXXkwgBewdAS6QGgGVPtGvqb,True,75914653,18978663,118289,59144,59145,3zqXX6kzhkbW3d4TwD2CNjMRwxTbREXySekvq37kfCNk,4731584,33955854,-29224270,623
2022-01-21 15:16:35-05:00,5069,56488NdcUy6Hi6X5SLs2GFtW5pG4u5wJpH7vHdxTCx4z,tGgXjJeVr3W2m3T2NXPCqpBEd6HJKE2cRsgCyiDZQy4,True,20351078,5087769,31776,15888,15888,DddJ7EWCmYEEZETCBNgAUSg81Ls6fZtiAaY5ekJ5sXx1,1271040,10954219,-9683179,624
2022-01-21 15:16:44-05:00,5070,5kwvkEtRFFD84j4ntVgxkacadgJaFvQ9JLhJqzLR7Y3G,GpMMkTv9T7y8DTiizuoJUsWvnSk3GSxADjRMGyYpryxm,True,6618951,1654737,10343,5171,5172,DddJ7EWCmYEEZETCBNgAUSg81Ls6fZtiAaY5ekJ5sXx1,413741,2868639,-2454898,625
2022-01-21 15:17:55-05:00,5071,442usWu6XpJZvU25bqXeynRrQ15jAzWwU9DWMgHpTn3Q,CtvADKp39bjJf3cPKWNL3wxnhq273fVM4fC5DmEcg5cC,True,11440256049,2860064012,17865302,8932651,8932651,HfEnetJ7uBSmZWCjBNxdvv9HEC5nsW4wDV7wu6WnhWan,714612094,2882686236,-2168074142,624
2022-01-21 15:21:58-05:00,5072,FuoFPNTdYVDkSHaBac6UC1aNJXafSNTvFJuBCdrgQQrH,ApBS1Fx83tcECMzDV6wEzEzEdg4e2hgj3djtjRUoSKK5,True,846311282,211577819,1321668,660834,660834,DddJ7EWCmYEEZETCBNgAUSg81Ls6fZtiAaY5ekJ5sXx1,52866733,361374092,-308507359,624
2022-01-21 15:31:43-05:00,5073,6pUtYz474QrpATEZnfb3iFbTKYA65pNyKAo4TQZAjtqe,8dipRUXvxJiDLdHEtCPkso4vErbVwshHQiRfvSngBS9J,True,73301308483,18325327120,114275704,57137852,57137852,DddJ7EWCmYEEZETCBNgAUSg81Ls6fZtiAaY5ekJ5sXx1,4571028181,18082124790,-13511096609,623
2022-01-21 15:31:52-05:00,5074,36ByQojnxEckWdQTjqHfxKqCx9yjqWQsPsZyqaN72UWR,AZoirtS1fjX61agRM64tqThVinnJTh3BWgiHyNHPTgZP,True,167581,41895,262,131,131,3uL2NSR2ZdDqCiKfzA5SwwpddAnit22DBJo6uvvz1rRs,10484,118602,-108118,625
2022-01-21 15:31:52-05:00,5075,H1Z83zVoskNuBvYao1FjdLfETfhPpQFQUkniJfGxbaNz,EVqbBRV6Zy1tPLRevxpAykp8Mvv6tDZVTc4RmCKw4Gq1,True,420768246,105192061,656497,328248,328249,DddJ7EWCmYEEZETCBNgAUSg81Ls6fZtiAaY5ekJ5sXx1,26259912,227705467,-201445555,624
2022-01-21 15:31:53-05:00,5076,5Rxuqgs4CaSKbfDXqBMFXkLTQ9dxrUjThXzoy3ouYVtK,BgvbKru66ebrGUcFFymGTmsaQv6GgcGMybiWaXqzBtwX,True,43519,10879,66,33,33,DddJ7EWCmYEEZETCBNgAUSg81Ls6fZtiAaY5ekJ5sXx1,2667,32755,-30088,612
2022-01-21 15:31:54-05:00,5077,3ogBPSRcKfmwzgumVDHBkXLi1eCsEFG2xzSJgD4LQDNy,7TXyqWgJqfe71MSWFA2n7ufZbUdzf7JJoWej8FNNtMXo,True,4414344,1103586,6829,3414,3415,3zqXX6kzhkbW3d4TwD2CNjMRwxTbREXySekvq37kfCNk,273176,2263658,-1990482,618
2022-01-21 15:50:24-05:00,5078,HGAFdundf5voDqeh9g7d6Q9mgMf8eEg898QMRBqwPZ6C,deanBuZXWBHEe2TGfP37S9aMBEnEgmZoyRJjAvruzfA,True,32743467,8185866,51208,25604,25604,HfEnetJ7uBSmZWCjBNxdvv9HEC5nsW4wDV7wu6WnhWan,2048325,20359269,-18310944,625
2022-01-21 15:54:46-05:00,5079,Br1j5Ftafei7ysu5SmqVZSoRe4uS4qCPeKSPHg55pyiE,G8fc7QvXjfkgBFvAVUgJFQS3VaF1biL9rktBExGa87Ks,True,1440328467,360082115,2247373,1123686,1123687,HfEnetJ7uBSmZWCjBNxdvv9HEC5nsW4wDV7wu6WnhWan,89894931,697288744,-607393813,624
2022-01-21 16:30:20-05:00,5080,442usWu6XpJZvU25bqXeynRrQ15jAzWwU9DWMgHpTn3Q,CtvADKp39bjJf3cPKWNL3wxnhq273fVM4fC5DmEcg5cC,True,8411128799,2102782199,13108015,6554007,6554008,3zqXX6kzhkbW3d4TwD2CNjMRwxTbREXySekvq37kfCNk,524320636,2321642496,-1797321860,623
2022-01-21 16:32:00-05:00,5081,7oxuCEhooUZ5z2nnZRD226rcqdZgAR75SamX9DD7ejUf,CPqBb5ptWUPUJhVjshxNZCHd5RDF3fve29z4vz72JhvM,True,120477,30117,188,94,94,3zqXX6kzhkbW3d4TwD2CNjMRwxTbREXySekvq37kfCNk,7539,49604,-42065,625
2022-01-21 16:32:00-05:00,5082,A1j2G5FZRyWSjFt6dK87WHhLkQrPUVqHaM3KhSzhAKDT,2fMiHLYm4pL3YCd8aveTR4mT9uVxztQeMwb5eRZb4wUW,True,146515,36628,226,113,113,HfEnetJ7uBSmZWCjBNxdvv9HEC5nsW4wDV7wu6WnhWan,9072,87793,-78721,619
2022-01-21 16:32:04-05:00,5083,8xvLGVeDmhVYQhN2ZpWkVG9jCrukRsNQ4926a4TMiZqa,9ciBySSjvADwp47WkETiFWZKVTFL8Hf1XvK7aSxhcgQS,True,5216831,1304207,8074,4037,4037,3uL2NSR2ZdDqCiKfzA5SwwpddAnit22DBJo6uvvz1rRs,322977,2882751,-2559774,619
2022-01-21 16:32:08-05:00,5084,78EeyPYzQjrmW6z9VGhRci6ihMUZb5rtpXo3GAxugf55,9AgZ45TMxaqwWGVWSgnEkvio3s6fXtHjAVRVCA7Zgsd2,True,11626639,2906659,18182,9091,9091,HfEnetJ7uBSmZWCjBNxdvv9HEC5nsW4wDV7wu6WnhWan,727301,5145217,-4417916,625
2022-01-21 16:32:14-05:00,5085,7hTjPRQSYAoWHhtpsVz2oKK5SAuFJd8dPHShKgKJq8dy,6DcHcrtcXR88d8e2KahhAiWTeRznNfF8oXLHmh5wE7wz,True,199826997,49956749,309512,154756,154756,3zqXX6kzhkbW3d4TwD2CNjMRwxTbREXySekvq37kfCNk,12380509,102705591,-90325082,619
2022-01-21 16:32:16-05:00,5086,CbhrZUdan1axNDFUrX1ZuEohfNMEGrszKSkk6pppVQuw,DHEAjJNtuEePezYAv77thWabbVxxqQpfuiC6moRSrpG1,True,19351902,4837975,30110,15055,15055,3zqXX6kzhkbW3d4TwD2CNjMRwxTbREXySekvq37kfCNk,1204435,13886254,-12681819,622
2022-01-21 16:32:17-05:00,5087,CyWBZ1xJ9LahUnPesbXLZ4Rr5UyWAHgVFYwfrnhyrkNL,2Lpk87Xth8ZL5J9BfzmMpEE3x76FDrrrmdKiCNkSVip2,True,52137918,13034477,81542,40771,40771,3zqXX6kzhkbW3d4TwD2CNjMRwxTbREXySekvq37kfCNk,3261716,25026249,-21764533,625
2022-01-21 16:32:22-05:00,5088,HwosLQgDY1xtHQRQ4hzroPQHFWssPzTj5vRkP37FcviB,HKTNEYNXrephNkH7apbobK4mcQXcNayQA4W1NgM6sLr8,True,12887366,3221841,20167,10083,10084,DddJ7EWCmYEEZETCBNgAUSg81Ls6fZtiAaY5ekJ5sXx1,806699,5413844,-4607145,625
2022-01-21 16:32:35-05:00,5089,BJaaH1SK1pF2kZQzmYpLFfDtm52CR9a5rd39RAPtLe8q,HUsT5FVxaisdnCvG1BQxX6zffjfL2Rwx5mMo5y8SDV7e,True,20208373,5052092,31618,15809,15809,3zqXX6kzhkbW3d4TwD2CNjMRwxTbREXySekvq37kfCNk,1264721,7315943,-6051222,625
2022-01-21 16:32:35-05:00,5090,4ne6vC7qdxQYHJCsaeFAKZrKdFt2SwXGHQ3jrMHqt4DL,Cf1dLHY2WXH9rXbRKq5TT8THbdo9SdNUZq4rYhRCF9z,True,20226167,5056541,31583,15791,15792,3zqXX6kzhkbW3d4TwD2CNjMRwxTbREXySekvq37kfCNk,1263350,7136094,-5872744,624
2022-01-21 16:33:03-05:00,5091,46TNhGwBVzedW8xSb9UY94HNeSom9iGiZzAjrKHiRM2G,7JVTiqNYeKHbyzRkKtvSEpqLPKykZso8cGUr3sX1j7QF,True,40529547,10132386,63346,31673,31673,3zqXX6kzhkbW3d4TwD2CNjMRwxTbREXySekvq37kfCNk,2533850,16866926,-14333076,625
2022-01-21 16:33:09-05:00,5092,JDeYjCLpfnzcfxDFgHf4aBcHsajwdR14GUaKAA9euzVf,EJbvKoyMZcoCx4vWa61uMbW2vr6mUhrgEuECdteVBuZZ,True,1625219,406304,2533,1266,1267,HfEnetJ7uBSmZWCjBNxdvv9HEC5nsW4wDV7wu6WnhWan,101357,1210212,-1108855,623
2022-01-21 16:33:30-05:00,5093,D58t4uTjFumsUeYFaKnpV8BRTEQEqKXBreFTdwGrott7,67p6kHDfVqQijfcwugvZK59c3aRRH9x3eHxruqH8WEqF,True,80358153,20089537,125360,62680,62680,3zqXX6kzhkbW3d4TwD2CNjMRwxTbREXySekvq37kfCNk,5014408,23219833,-18205425,624
2022-01-21 16:33:59-05:00,5094,AWvHDdb2ikqV8wc7qQ8azbvNTZdixMNxhQjhQdhayYtR,9EpgEPBb1nog6aQeFdMXfSRiLSnzGQFQ39mbLdCxgYTv,True,9633001,2408250,14632,7316,7316,DddJ7EWCmYEEZETCBNgAUSg81Ls6fZtiAaY5ekJ5sXx1,585312,4226238,-3640926,607
2022-01-21 16:34:01-05:00,5095,HHHj6EinpgAJeZkDXfsvCo3UXnmAdiAZNvPSUfVPc5Sg,3gx9c31MDtJtByxkUuWcqf1oARnZTjpx3QtxsM1Xb6Gp,True,156528214,39132053,244055,122027,122028,3zqXX6kzhkbW3d4TwD2CNjMRwxTbREXySekvq37kfCNk,9762217,73615821,-63853604,623
2022-01-21 16:34:01-05:00,5096,Bsr6kx1B6BSEd5UnJ7Z61M49iUb3bFrDVhiEtMVtPDF2,3CFd1pUJAJPA9fobwn4Jj2mRju1CWmoop4Mh4znypNWT,True,6096523,1524130,9382,4691,4691,DddJ7EWCmYEEZETCBNgAUSg81Ls6fZtiAaY5ekJ5sXx1,375297,3111325,-2736028,615
2022-01-21 16:34:04-05:00,5097,5eMLdQ4gYA5iqvTXSNdGvctHp7s5VpyFuwtJKqx6chBc,Ckxc5K39nkBNXBTmFTM8J48R7wGqNm3vHKZu4G5baumZ,True,68235585,17058896,103950,51975,51975,DddJ7EWCmYEEZETCBNgAUSg81Ls6fZtiAaY5ekJ5sXx1,4158012,32604095,-28446083,609
2022-01-21 16:35:30-05:00,5098,DDuXUcRDez68Tx651sVKxjubhTdNHkuarbeDEKFp5HRs,DNWcrd23zaT7LuXHuhPVqqAvLVpEzoqebr4sho45CphT,True,7013908,1753477,10806,5403,5403,3zqXX6kzhkbW3d4TwD2CNjMRwxTbREXySekvq37kfCNk,432253,1911445,-1479192,616
2022-01-21 16:35:30-05:00,5099,D64rDiWT3YG28fCgXCmbNjYa2JakZbpKQ1D2XuLChUfV,8WmMWq8cTsGQym5pUbHm9dPCpJugBeWUMVERYFGLxWHj,True,7425948,1856487,11450,5725,5725,3zqXX6kzhkbW3d4TwD2CNjMRwxTbREXySekvq37kfCNk,458022,3589975,-3131953,616
2022-01-21 16:35:31-05:00,5100,Fani89KviVFZek4si6YZ3apVuM2kSqVUijDnLBqtvJEH,EpC29dECx1cLC69bj2ncG3jFp7obPaxbH7F6mju27cwL,True,4565049,1141262,7039,3519,3520,3zqXX6kzhkbW3d4TwD2CNjMRwxTbREXySekvq37kfCNk,281568,1245900,-964332,616
2022-01-21 16:35:37-05:00,5101,DWTaeNeq5x83cBvKUz2jZfXDz5z4F5wbSZLNv7smnjvd,9pQGArZnJV4Fu8tBVEfknmmfmrRv5RKV2u58BJBuhzpF,True,19436603,4859150,29690,14845,14845,3uL2NSR2ZdDqCiKfzA5SwwpddAnit22DBJo6uvvz1rRs,1187619,9876100,-8688481,611
2022-01-21 16:35:42-05:00,5102,6NJFN855M3Q3RLTDNo57gTgAmwPD6G2E3WvMb1m5eNCN,3YpqNnonsvXaRT4nCC3G5FZx1jjVtbDPc36LiR6WK5jR,True,15808477,3952119,24029,12014,12015,3uL2NSR2ZdDqCiKfzA5SwwpddAnit22DBJo6uvvz1rRs,961167,11624257,-10663090,608
2022-01-21 16:35:46-05:00,5103,GufVttJatW8NLeztT1NRQSLZpQNRk45kaG41p3QcWhx7,GTJUsWoWRyeafYJVhx2aRo8NE94U5UrBjaehmJ4PRUhn,True,5830653,1457663,8914,4457,4457,3zqXX6kzhkbW3d4TwD2CNjMRwxTbREXySekvq37kfCNk,356588,2533222,-2176634,611
2022-01-21 16:36:11-05:00,5104,DkvR2xUPMyXWGGkUSmDSfhp7RtvMkfbT1ThKCS3TwrXd,F7jYV6TtT1LZ5XCNn1zkbUfNMo4gGcQUczAQy1jLHpaW,True,126546082,31636520,194455,97227,97228,3zqXX6kzhkbW3d4TwD2CNjMRwxTbREXySekvq37kfCNk,7778237,72789748,-65011511,614
2022-01-21 16:36:11-05:00,5105,BgnsCfJ54ReunUtwPJLzkW4PWnqpBDWGNYxsW5PvDrbK,KpMqEkQ9dKMgCevsEK895wHd3fCLRPSzDmJSv3tKU4u,True,3018990624,754747656,4720012,2360006,2360006,3zqXX6kzhkbW3d4TwD2CNjMRwxTbREXySekvq37kfCNk,188800496,1557086909,-1368286413,625
2022-01-21 16:36:11-05:00,5106,8swGZMrPrLAxZd7MxTbkCL13k3DmAJUw41jCp6Xo6awW,3fKnX7yTNXAT4uMmXVdTy47ALJT8h8YSD3WiBb4BGuzH,True,48193650,12048412,73310,36655,36655,3zqXX6kzhkbW3d4TwD2CNjMRwxTbREXySekvq37kfCNk,2932414,28311441,-25379027,608
2022-01-21 16:36:14-05:00,5107,DY6k3Dkwe18iLneaT8Xo3VpJWB6V4jWwQQjoDvEzdg2j,3GGV7S9FpRQGbARBXkvGFVqLrmw8JvYAcpnR1aKVUY2f,True,2571922,642980,3934,1967,1967,3zqXX6kzhkbW3d4TwD2CNjMRwxTbREXySekvq37kfCNk,157393,1902437,-1745044,611
2022-01-21 16:36:17-05:00,5108,9WJBnVi84E926j7xEd566WzrZJkPJWRgmEnYj9vyjuad,4dLaFS5F7TGyLdwuJLMGkz3bSL53aHzd9ZfpNmhHxXeF,True,3195632,798908,4998,2499,2499,3zqXX6kzhkbW3d4TwD2CNjMRwxTbREXySekvq37kfCNk,199932,2128499,-1928567,625
2022-01-21 16:36:38-05:00,5109,gMjmD7WioyUdQdwNqE5fobLcxPwoJv5rAvLmJaf8Jjw,5n77euFjVJiwKrnbYq1KpcENW1mzBZj2BuDGyzazrkJ8,True,47642372,11910592,71986,35993,35993,3zqXX6kzhkbW3d4TwD2CNjMRwxTbREXySekvq37kfCNk,2879478,14914682,-12035204,604
2022-01-21 16:36:39-05:00,5110,J3ggP7ZxL8HRh3CBp5iYG2WgjLyNSAWYT46uC9VYDLCz,2FqTRiRPiLvdAH2BS5vroVntpsSXvTJEn5UHWmtKHzh9,True,6101427,1525356,9227,4613,4614,3zqXX6kzhkbW3d4TwD2CNjMRwxTbREXySekvq37kfCNk,369099,2788289,-2419190,604
2022-01-21 16:36:39-05:00,5111,CxLFMBDFkoMvpK9YUf7WtCq6hn7k3QACAuetAnGjU6KA,2gE52a1GWQnS6ifV6eVtKQyr13LXP5Jdt3yG9SjGPJPF,True,252154826,63038706,380538,190269,190269,3zqXX6kzhkbW3d4TwD2CNjMRwxTbREXySekvq37kfCNk,15221545,79471804,-64250259,603
2022-01-21 16:36:39-05:00,5112,399591e8XgY52yCMorCQ2WL6dQZTC485ZooHtmGuirhZ,JCiXAooFmKmEPQ2S7C8iSk6CLcTyrPEe1SsPSLyUGySe,True,222391,55597,340,170,170,3zqXX6kzhkbW3d4TwD2CNjMRwxTbREXySekvq37kfCNk,13615,165369,-151754,612
2022-01-21 16:36:41-05:00,5113,4uygLJDk9DFCifJ56YwMrEsvd3oQNq8tYSLnMCyWorS6,GimL4uKGvg3FFmFQSWzAcjstv3Vmk5NMgDGMKTuXYVpB,True,107777966,26944491,166068,83034,83034,3zqXX6kzhkbW3d4TwD2CNjMRwxTbREXySekvq37kfCNk,6642732,60561922,-53919190,616
2022-01-21 16:36:41-05:00,5114,D9VKhnfLLCrntDGFYSfoxFaY76VnHmYZ1ZbyFXdKdibz,2hRCRH2pMDyQGYcXHa8Y6BZo6FbcGZf5VJC1v8Bp6tGa,True,19108354,4777088,29807,14903,14904,3zqXX6kzhkbW3d4TwD2CNjMRwxTbREXySekvq37kfCNk,1192303,10040432,-8848129,623
2022-01-21 16:36:41-05:00,5115,FgQrRo4eGQAonSsFfQgnp8trGGqGZCLeGX6yvJnMnTjd,8KhemHLBY6nGmo3xMDedW2wnCSxQq6LwbTExif4sUSxx,True,285041363,71260340,432965,216482,216483,3zqXX6kzhkbW3d4TwD2CNjMRwxTbREXySekvq37kfCNk,17318617,68247854,-50929237,607
2022-01-21 16:36:42-05:00,5116,8E3K7vCHJ2xjdFofPRGLbMxrkm8UYEi926QmXPAFwsqe,4qHUDA1c43Dg4qi1ZPKqmpGYiEMUZ6r4UuzB5ftHCEhW,True,294606297,73651574,449415,224707,224708,3zqXX6kzhkbW3d4TwD2CNjMRwxTbREXySekvq37kfCNk,17976611,198530981,-180554370,610
2022-01-21 16:36:43-05:00,5117,B2hN3Lt5pFbUyfEUc5s48hkxUJ5rr2SeFxgdGdQ8pDD2,7bZJCCud253j9g411HQUDXUAADcwd5yJWznoTChBdB2H,True,1262344927,315586231,1941917,970958,970959,3zqXX6kzhkbW3d4TwD2CNjMRwxTbREXySekvq37kfCNk,77676683,302604285,-224927602,615
2022-01-21 16:36:43-05:00,5118,A4tDE948CPFPh1UwHb8sXryfKktbxZ8BCkqXgA5DJHA8,3zXeKMrsEpCe5fQumLNzCgpxcG1kLJFEAtJuqxLsC6ZG,True,17997773,4499443,27681,13840,13841,3zqXX6kzhkbW3d4TwD2CNjMRwxTbREXySekvq37kfCNk,1107260,10686741,-9579481,615
2022-01-21 16:36:43-05:00,5119,8eTH6eJyyVeMno3UQkffeBg32xofKsQfkhLhXdtaf87s,BCFC7CPXrQPsUfJb2eYSht8GhaApWHpc49AeCXqaYq13,True,46483635,11620908,71752,35876,35876,3zqXX6kzhkbW3d4TwD2CNjMRwxTbREXySekvq37kfCNk,2870119,14428684,-11558565,617
2022-01-21 16:37:11-05:00,5120,BMn3FQ6axnUt5K3esCEgoVi8GZAcPCg3YrjcwAFVvTah,HEvRK6CPti7aoTaYExEQAyr9ZyTQ6u4jg5Y2btc7ovdd,True,177584,44395,274,137,137,HfEnetJ7uBSmZWCjBNxdvv9HEC5nsW4wDV7wu6WnhWan,10979,34353,-23374,618
