ts,record_id,user_authority,user,partial,base_asset_value,base_asset_value_closed,liquidation_fee,fee_to_liquidator,fee_to_insurance_fund,liquidator,total_collateral,collateral,unrealized_pnl,margin_ratio
2022-02-24 01:32:39-05:00,13313,7rq3F5ZQXc991M4SCSqvhYKL2SsPT1DKjBBUoxovYt1e,BwzUY6Tyc5TnBfSajK9WeyjGVqVj6Lup73vd88dSc1vh,True,1670739,417684,2610,1305,1305,DddJ7EWCmYEEZETCBNgAUSg81Ls6fZtiAaY5ekJ5sXx1,104434,1117154,-1012720,625
2022-02-24 01:40:52-05:00,13314,9Wzu7BWPgx9JRwuituo7vxNXVkpRA7C5W62CATnPpy6Q,GYPiAfGtfkMjDKdi6MrM7VXzpSwPnp2qWwwCX4iFGVtq,True,25804829,6451207,40208,20104,20104,3zqXX6kzhkbW3d4TwD2CNjMRwxTbREXySekvq37kfCNk,1608340,22619913,-21011573,623
2022-02-24 01:41:45-05:00,13315,442usWu6XpJZvU25bqXeynRrQ15jAzWwU9DWMgHpTn3Q,CtvADKp39bjJf3cPKWNL3wxnhq273fVM4fC5DmEcg5cC,True,4902467505,1225616874,7669082,3834541,3834541,3zqXX6kzhkbW3d4TwD2CNjMRwxTbREXySekvq37kfCNk,306763297,1794275525,-1487512228,625
2022-02-24 02:05:47-05:00,13316,H1Z83zVoskNuBvYao1FjdLfETfhPpQFQUkniJfGxbaNz,EVqbBRV6Zy1tPLRevxpAykp8Mvv6tDZVTc4RmCKw4Gq1,True,8266928,2066731,12937,6468,6469,DddJ7EWCmYEEZETCBNgAUSg81Ls6fZtiAaY5ekJ5sXx1,517489,7033202,-6515713,625
2022-02-24 02:08:51-05:00,13317,HmspGdpobjC5Vbmo3FcKdw4RLPN7wJKxv3uKqDjVhLee,3YEX8TzdyJyuHo76Kw76imVCJjzrC9m188YuRKvwwSwD,True,7150369,1787592,11156,5578,5578,2BPYaeCXY4BCFSGFSfiGtqmhzJ4fkhYLxGjqFvLCB6hG,446263,4065009,-3618746,624
2022-02-24 02:10:21-05:00,13318,25NUDrsdLhS3fcARLiTMbbmZHvvzvzPj9xAdoN8sJBN3,8baNRGHfYRcLdhbHNuH72ofAWM9UojqhTMLnbBayzGnW,True,325364,81341,507,253,254,HfEnetJ7uBSmZWCjBNxdvv9HEC5nsW4wDV7wu6WnhWan,20303,233952,-213649,624
2022-02-24 02:10:25-05:00,13319,243SAnGxchCVB1LQAUF4SsozR86yDwEdg2QQpbWGsMYe,5u8sNkb2oEQjUXJAB3yGStmv3Uwz16gBgExBo5myVK4b,True,108458,27114,168,84,84,3zqXX6kzhkbW3d4TwD2CNjMRwxTbREXySekvq37kfCNk,6753,76732,-69979,622
2022-02-24 02:11:33-05:00,13320,A7bxZn4tYkEvYHu2SEqUbouNoSBSGMeqK4Kx4qySkNEZ,DNajWLThK1wtHsiGVcd9hNPyAch6BsX5Np1jxy9kHSJ8,True,28036047,7009011,43805,21902,21903,DddJ7EWCmYEEZETCBNgAUSg81Ls6fZtiAaY5ekJ5sXx1,1752214,14399953,-12647739,624
2022-02-24 02:11:44-05:00,13321,4Enpw9W2mWGnNYagYQ8WW29RLSs4R5YX4qXCsVqMFeHn,9QwbJmm9QDKXyc4ZViq74BfS35zzewEceXQNnFCgczXu,True,31494047,7873511,49208,24604,24604,3zqXX6kzhkbW3d4TwD2CNjMRwxTbREXySekvq37kfCNk,1968320,15021857,-13053537,624
2022-02-24 02:20:56-05:00,13322,BJaaH1SK1pF2kZQzmYpLFfDtm52CR9a5rd39RAPtLe8q,HUsT5FVxaisdnCvG1BQxX6zffjfL2Rwx5mMo5y8SDV7e,True,46680,11670,73,36,37,HfEnetJ7uBSmZWCjBNxdvv9HEC5nsW4wDV7wu6WnhWan,2921,39338,-36417,625
2022-02-24 02:24:39-05:00,13323,BCGTaPQxGEMjD7xUxwfwmVVYJ9CEGH33yJRi3QjwyiLE,JBct1cZ9a959UKwABBEefwxZnGTAAGLzyUdXrXqGGCZd,True,156602,39150,244,122,122,HfEnetJ7uBSmZWCjBNxdvv9HEC5nsW4wDV7wu6WnhWan,9761,103762,-94001,623
2022-02-24 02:25:01-05:00,13324,2rLWe1XADCU93guPU6WgSW6x56gYNfif9bm11V93mJnv,BEGhQRm3fgSHeBtk2DYrXEBPKPRvS3sHyTNopmoBJxMs,True,42194906,10548726,66024,33012,33012,3zqXX6kzhkbW3d4TwD2CNjMRwxTbREXySekvq37kfCNk,2640989,40127348,-37486359,625
2022-02-24 02:25:10-05:00,13325,BZxJ6CtrVoiU86DMMieMeDFLNWtMpHGTvZfM7nyay6o4,6CRxRR8bisRLHFJBFWjyumYuy7j4C4PkjYH1K8gXhdWD,True,14266406,3566601,22221,11110,11111,HfEnetJ7uBSmZWCjBNxdvv9HEC5nsW4wDV7wu6WnhWan,888843,4508937,-3620094,623
2022-02-24 02:27:02-05:00,13326,FtF3PVw8YNJseWPMcA2GEuQZ6nni1mq5kYPa2LrSzfkW,4yr1TM2dXrBvLNMpSaoryuGU2P8D3WG1ZCkvVzWFiQRH,True,1052247427,263061855,1642485,821242,821243,3zqXX6kzhkbW3d4TwD2CNjMRwxTbREXySekvq37kfCNk,65699433,503783382,-438083949,624
2022-02-24 02:29:27-05:00,13327,FMdKLXhQEnNJtvM17ZX8jhaeMaSD9UgDuN3Kw7kMrd7K,5pURHYWB5LUGwJmWVBGH8p6oyR9NJvXnZk7uDVoiassv,True,539215127,134803780,843667,421833,421834,3zqXX6kzhkbW3d4TwD2CNjMRwxTbREXySekvq37kfCNk,33746713,193334364,-159587651,625
2022-02-24 02:29:46-05:00,13328,B5CTBTggmGFvGFSunjbB4C9tLKcYcULehmEiEXRihY2J,FX3ebF8P89rZBWfR74PDWUzxnLuDkUDgGcPYCBD5sMUG,True,2664598,666149,4169,2084,2085,HfEnetJ7uBSmZWCjBNxdvv9HEC5nsW4wDV7wu6WnhWan,166792,1778551,-1611759,625
2022-02-24 02:30:15-05:00,13329,BgNgALwBEuiumVgiXRmBZRnyFrr9QTDy2maHzsNwNHGf,ag35Ec2uFtqkarizCxFyhM2SPBuUwfmLRhAdFEWFCNa,True,212333,53083,332,166,166,HfEnetJ7uBSmZWCjBNxdvv9HEC5nsW4wDV7wu6WnhWan,13283,139063,-125780,625
2022-02-24 02:31:11-05:00,13330,aTkGURJptmKNNP6RSXSWsmVbfcriSAJaMuUiT2eZEfb,5qoGxL83PLhrguyk27X8xE6jGitRg5BaQpXzrcfEvCfJ,True,21315707,5328926,33120,16560,16560,HfEnetJ7uBSmZWCjBNxdvv9HEC5nsW4wDV7wu6WnhWan,1324837,7934539,-6609702,621
2022-02-24 02:31:24-05:00,13331,5BJnMHFSiQjHRGFJDW1jnqCfkHHYWnQzmmccy9eA4jNj,9517JGYsPmvgPUM9pFRD2vipHmdgE578F7jA7Qq6jorm,True,368140,92035,576,288,288,HfEnetJ7uBSmZWCjBNxdvv9HEC5nsW4wDV7wu6WnhWan,23040,294131,-271091,625
2022-02-24 02:31:37-05:00,13332,HXMjB1tdGJUtjXi5sQon6m4XJjfC6X7pdc6jTXApyjsH,CFcAoXdBVcPW7YYqP5ujq7q94DCsP4dLK2XDSwxQutKy,True,451272,112818,705,352,353,HfEnetJ7uBSmZWCjBNxdvv9HEC5nsW4wDV7wu6WnhWan,28219,226378,-198159,625
2022-02-24 02:31:52-05:00,13333,2niazdR63iWLyZ3ABWZVAnJiEjVyDyLGo4jZ6wh3j2Zz,4RvU5UtyE5CqMStPciiCTdhYCdaUUfdKSYS5nkATs1qn,True,136124,34031,212,106,106,HfEnetJ7uBSmZWCjBNxdvv9HEC5nsW4wDV7wu6WnhWan,8517,97850,-89333,625
2022-02-24 02:31:53-05:00,13334,GQviUdocJ1s4FsVDDexanvo5yQWRZgwwkGJBCg7TMtJC,HAX4VAKgQpKtm1149iRgtzvUaUkiXWcA1bJ9ERu6tXkd,True,134439,33609,209,104,105,3zqXX6kzhkbW3d4TwD2CNjMRwxTbREXySekvq37kfCNk,8371,96570,-88199,622
2022-02-24 02:31:54-05:00,13335,6k9unyyhVTrGhAhBrFjgumRfBtKFRBrVaeWtYB56LgEg,3n9VYUH53fxmwFwdYKT9xAZYDzjodhMsJ5iGAoJTqCt4,True,136116,34029,212,106,106,3zqXX6kzhkbW3d4TwD2CNjMRwxTbREXySekvq37kfCNk,8511,97854,-89343,625
2022-02-24 02:31:54-05:00,13336,GHn96Ev7UmKJWqch3H3wzXpRT7qLg5FBuSBJAATVED1f,BXBSUddfz9MThXqk4517M7YVRDGdTm4pC6G4ipT69TMV,True,108489,27122,169,84,85,HfEnetJ7uBSmZWCjBNxdvv9HEC5nsW4wDV7wu6WnhWan,6786,77762,-70976,625
2022-02-24 02:32:07-05:00,13337,Ai6G7vosJfmkRqtDAkqxRtbzELp6P5xe9r2RH3LYcLZt,8SUpKXakmhi4rYiFKnHYpgaAopomfDqEX6Efew9iM6nk,True,468129836,117032458,731226,365613,365613,3zqXX6kzhkbW3d4TwD2CNjMRwxTbREXySekvq37kfCNk,29249075,232143895,-202894820,624
2022-02-24 02:32:25-05:00,13338,98pwBGgiSDuwuas6WYW2hc9qUxfULwvNE34aixaxbxXY,BLrjKxekjThtJ9rKtQxs1Y4rZ225EE2Q16VkP9TkThyV,True,106000,26500,165,82,83,HfEnetJ7uBSmZWCjBNxdvv9HEC5nsW4wDV7wu6WnhWan,6628,76936,-70308,625
2022-02-24 02:32:39-05:00,13339,EDSf2w1UyGvbgMuxyoXL58ifR1dviZinnLBYnFmgjcNG,DFenkzbL9SUjs9cSCaHJ1eXK75mHfk3GSPRFs8TSzrFV,True,652352,163088,1020,510,510,HfEnetJ7uBSmZWCjBNxdvv9HEC5nsW4wDV7wu6WnhWan,40816,515240,-474424,625
2022-02-24 02:32:39-05:00,13340,7ayTm4uC5VbtMt9w6g9tFban4fYVwbqCzJZpiFMjmBiB,BvidnEZHHtXVhtgv4qFKThEaFZsFmyAuDVqZQwMppjSg,True,58548920,14637230,91490,45745,45745,HfEnetJ7uBSmZWCjBNxdvv9HEC5nsW4wDV7wu6WnhWan,3659604,54291163,-50631559,625
2022-02-24 02:32:50-05:00,13341,4frcw72EwhHoErBpaUopvk1TG76ScAEAdCa1YYpuXNBH,CrGAbKa9vZKUmr9sALaHgWMcczDGmUq5kFP7w1fbXmKY,True,417743905,104435976,653448,326724,326724,3zqXX6kzhkbW3d4TwD2CNjMRwxTbREXySekvq37kfCNk,26137953,161023361,-134885408,625
2022-02-24 02:33:09-05:00,13342,CiomzdJ9g2bCskudk28cEU4aTgF6jYaerkiazbB7E3DA,9rxtTBmKoxPzhR4xoRH65Kmi7f3pEp1RanoeQq9V9RU5,True,16141700,4035425,25023,12511,12512,HfEnetJ7uBSmZWCjBNxdvv9HEC5nsW4wDV7wu6WnhWan,1000931,8418443,-7417512,620
2022-02-24 02:33:10-05:00,13343,28JujYG1mbpYSjF7LNqXpup17TXb45VJHhhnFMVXtft2,DAqyVExAtmsovPGrkpkFDxm6T7pKWLztfh9iPjTNDqrd,True,167536,41884,261,130,131,HfEnetJ7uBSmZWCjBNxdvv9HEC5nsW4wDV7wu6WnhWan,10445,121874,-111429,623
2022-02-24 02:33:15-05:00,13344,G3vArDs7nb18se4xMZ68oMHmTAsYP63x8dfY57jAogwp,EY7J8Hw8jWbryw11CYdPVUSdAoDGGNEfacqghVnJn3JK,True,391717,97929,612,306,306,HfEnetJ7uBSmZWCjBNxdvv9HEC5nsW4wDV7wu6WnhWan,24493,284773,-260280,625
2022-02-24 02:33:15-05:00,13345,2utXC9PmMHh7D9x9wRdyibUHvSUquo96HHKy8F5cBeKY,GabBfvJyVgAUVuCe5sk4UHyC95AWaB4CSJiwWZUKerTd,True,3488768,872192,5453,2726,2727,HfEnetJ7uBSmZWCjBNxdvv9HEC5nsW4wDV7wu6WnhWan,218137,1473551,-1255414,625
2022-02-24 02:33:28-05:00,13346,9d7ixk9XCdumGXVP5fEQKJPDx15SS2uz5gvJA7HxaQsx,12pcw5FXob2x6LG3UmXZ2HE8zrVre91YZWfRqwm6XA5Q,True,2538,634,3,1,2,2BPYaeCXY4BCFSGFSfiGtqmhzJ4fkhYLxGjqFvLCB6hG,158,1242,-1084,622
2022-02-24 02:33:39-05:00,13347,7FB6X8YgiDn7YK9bZZmcFyzhuvVLVWPCfBbenwMXhx5,2EaDCpL9MpAKuiC2bvUCGRfvqYvgVXGFHXt35QdNakfG,True,95956,23989,149,74,75,HfEnetJ7uBSmZWCjBNxdvv9HEC5nsW4wDV7wu6WnhWan,5983,50914,-44931,623
2022-02-24 02:34:20-05:00,13348,Cgga7cjzsiecXRFLLf4jnEaGGwzr6qroh36G7kz3tV2t,AhUKdVt6jf8L2p5DbxkYPMAZUFqpz1uKBgPMUBJqEcnz,True,2577454,644363,4030,2015,2015,HfEnetJ7uBSmZWCjBNxdvv9HEC5nsW4wDV7wu6WnhWan,161218,1086730,-925512,625
2022-02-24 02:34:46-05:00,13349,33CE2t84MhG7SMsphhZaxvwFVRbK5wcUMUdEw8UBhoq8,DjNko7SbbK9nQT4K5oBWKiSiXiYS9Rv1k5vT3PNiMyaf,True,95600,23900,148,74,74,2BPYaeCXY4BCFSGFSfiGtqmhzJ4fkhYLxGjqFvLCB6hG,5952,88416,-82464,622
2022-02-24 02:34:53-05:00,13350,2eFLHfWwuTKeGn9Xm9VQk1Ae7BA9j3Vs7Kg5Unn3qaXi,3JJCnrCAR4fwYJChZvBzLdgvWs1ogcNqKRWHa6VABbcU,True,11349326,2837331,17760,8880,8880,HfEnetJ7uBSmZWCjBNxdvv9HEC5nsW4wDV7wu6WnhWan,710413,3552898,-2842485,625
2022-02-24 02:35:05-05:00,13351,H3394S5wdbwXB4scjGAY8NsXxCdGy1Xebct18s42FM1K,Hz84L1EquzhCvBJP75ScKug46hYGdNMVNH16AdG4y5D8,True,267020,66755,416,208,208,3zqXX6kzhkbW3d4TwD2CNjMRwxTbREXySekvq37kfCNk,16677,206789,-190112,624
2022-02-24 02:36:49-05:00,13352,442usWu6XpJZvU25bqXeynRrQ15jAzWwU9DWMgHpTn3Q,CtvADKp39bjJf3cPKWNL3wxnhq273fVM4fC5DmEcg5cC,True,3604140509,901035126,5638639,2819319,2819320,3zqXX6kzhkbW3d4TwD2CNjMRwxTbREXySekvq37kfCNk,225545576,1414005718,-1188460142,625
2022-02-24 02:36:52-05:00,13353,72L76qDRMK3M7X52zuuB9GVyvFFLDBZwFMpVjWjghXzA,4m2ZVuemUctu1edv4YJVAcjXzKwpbCmBujzoUmLDeA7h,True,2013334,503333,3141,1570,1571,3zqXX6kzhkbW3d4TwD2CNjMRwxTbREXySekvq37kfCNk,125677,1026197,-900520,624
2022-02-24 02:36:54-05:00,13354,3VdSA9CED9f5swRwHX2U15U7J6Muaq8VPnCNy9CaGDHe,2YYstfnfdYic5NWmEbcUEHpccNUVd1EhuCkExvMsoMk8,True,28497,7124,44,22,22,3zqXX6kzhkbW3d4TwD2CNjMRwxTbREXySekvq37kfCNk,1779,28810,-27031,624
2022-02-24 14:37:07-05:00,13355,DVMLxFACqaNBD7q1TGJUUApJX7etJsxQRRFBP2DfBazJ,4hnRjD7S2KxD7UrgfrApntVxUD7Srh5E9nwPY53v89kz,True,222162908,55540727,343171,171585,171586,2BPYaeCXY4BCFSGFSfiGtqmhzJ4fkhYLxGjqFvLCB6hG,13726854,39245073,-25518219,617
2022-02-24 14:58:57-05:00,13356,DCgsQbdxSRAfkZvMT8jVWVsaPwsYGKnnxTEUBtbSSiBT,Bax3ybWnawNP13ZghFg9mWHVaoo9hGdah11wj82k2YWQ,True,5575587124,1393896781,8722427,4361213,4361214,3zqXX6kzhkbW3d4TwD2CNjMRwxTbREXySekvq37kfCNk,348897093,984448228,-635551135,625
2022-02-24 14:59:24-05:00,13357,DVMLxFACqaNBD7q1TGJUUApJX7etJsxQRRFBP2DfBazJ,4hnRjD7S2KxD7UrgfrApntVxUD7Srh5E9nwPY53v89kz,True,169403107,42350776,265068,132534,132534,HfEnetJ7uBSmZWCjBNxdvv9HEC5nsW4wDV7wu6WnhWan,10602757,32522700,-21919943,625
2022-02-24 15:04:34-05:00,13358,Eec3xvC7d5iuGEXySFtzWekD1e9Ed6hQ2m7ExeJ9fDif,54WbNCyeTCrF5f57b67xRw2gNT42eM6PxG7mU5tPCcXW,True,23370564757,5842641189,35673903,17836951,17836952,3zqXX6kzhkbW3d4TwD2CNjMRwxTbREXySekvq37kfCNk,1426956121,4132929182,-2705973061,610
2022-02-24 15:04:44-05:00,13359,BZQYYFyK2GBU3mYi7BJuh1kRDmSvK6iGdHQwy5jitqQo,Hm3UsDcsURA7KPrR7khH8VH4k7H6ULnpxA5HW7s7Hw5R,True,124155306,31038826,193920,96960,96960,3zqXX6kzhkbW3d4TwD2CNjMRwxTbREXySekvq37kfCNk,7756839,15906653,-8149814,624
2022-02-24 15:05:09-05:00,13360,DCgsQbdxSRAfkZvMT8jVWVsaPwsYGKnnxTEUBtbSSiBT,Bax3ybWnawNP13ZghFg9mWHVaoo9hGdah11wj82k2YWQ,True,4256711235,1064177808,6630599,3315299,3315300,3zqXX6kzhkbW3d4TwD2CNjMRwxTbREXySekvq37kfCNk,265223964,817129222,-551905258,623
2022-02-24 15:06:29-05:00,13361,Eec3xvC7d5iuGEXySFtzWekD1e9Ed6hQ2m7ExeJ9fDif,54WbNCyeTCrF5f57b67xRw2gNT42eM6PxG7mU5tPCcXW,True,17809931051,4452482762,27731868,13865934,13865934,2BPYaeCXY4BCFSGFSfiGtqmhzJ4fkhYLxGjqFvLCB6hG,1109274735,3431460997,-2322186262,622
2022-02-24 15:07:09-05:00,13362,DVMLxFACqaNBD7q1TGJUUApJX7etJsxQRRFBP2DfBazJ,4hnRjD7S2KxD7UrgfrApntVxUD7Srh5E9nwPY53v89kz,True,129424704,32356176,199186,99593,99593,HfEnetJ7uBSmZWCjBNxdvv9HEC5nsW4wDV7wu6WnhWan,7967442,26779972,-18812530,615
2022-02-24 17:16:33-05:00,13363,JE2PdvSvfaXowRWshpvgcRZ5HTmkRdqejVb2Mckg4kyF,9sLTy5CKpq9evvXqc2ofXDucPDg3FBKN5cQGX673D9wc,True,247057,61764,385,192,193,3zqXX6kzhkbW3d4TwD2CNjMRwxTbREXySekvq37kfCNk,15408,47220,-31812,623
2022-02-24 17:27:54-05:00,13364,JE2PdvSvfaXowRWshpvgcRZ5HTmkRdqejVb2Mckg4kyF,9sLTy5CKpq9evvXqc2ofXDucPDg3FBKN5cQGX673D9wc,True,188868,47217,286,143,143,3zqXX6kzhkbW3d4TwD2CNjMRwxTbREXySekvq37kfCNk,11448,38882,-27434,606
2022-02-24 17:35:52-05:00,13365,JE2PdvSvfaXowRWshpvgcRZ5HTmkRdqejVb2Mckg4kyF,9sLTy5CKpq9evvXqc2ofXDucPDg3FBKN5cQGX673D9wc,True,144639,36159,204,102,102,2BPYaeCXY4BCFSGFSfiGtqmhzJ4fkhYLxGjqFvLCB6hG,8174,28921,-20747,565
2022-02-24 18:12:15-05:00,13366,JE2PdvSvfaXowRWshpvgcRZ5HTmkRdqejVb2Mckg4kyF,9sLTy5CKpq9evvXqc2ofXDucPDg3FBKN5cQGX673D9wc,True,109613,27403,170,85,85,DddJ7EWCmYEEZETCBNgAUSg81Ls6fZtiAaY5ekJ5sXx1,6830,20521,-13691,623
2022-02-24 18:46:38-05:00,13367,JE2PdvSvfaXowRWshpvgcRZ5HTmkRdqejVb2Mckg4kyF,9sLTy5CKpq9evvXqc2ofXDucPDg3FBKN5cQGX673D9wc,True,83653,20913,130,65,65,3zqXX6kzhkbW3d4TwD2CNjMRwxTbREXySekvq37kfCNk,5217,16928,-11711,623
2022-02-24 21:20:22-05:00,13368,JE2PdvSvfaXowRWshpvgcRZ5HTmkRdqejVb2Mckg4kyF,9sLTy5CKpq9evvXqc2ofXDucPDg3FBKN5cQGX673D9wc,True,63828,15957,99,49,50,HfEnetJ7uBSmZWCjBNxdvv9HEC5nsW4wDV7wu6WnhWan,3987,13858,-9871,624
2022-02-24 21:28:48-05:00,13369,V34VhGxE5BcLmc9gtpAK6UBD91Pr38z8amqTRXdKkJW,GWhFwG72FzXQzw8h9EfMaP8qADufnSpMHzUzxsFQiwex,True,529540548,132385137,828174,414087,414087,HfEnetJ7uBSmZWCjBNxdvv9HEC5nsW4wDV7wu6WnhWan,33126965,130651253,-97524288,625
2022-02-25 08:00:30-05:00,13370,G6KNZdFV14LDXQfW6w54nXF3Ay3jWcSZsGonoFWMcRo4,8vP5gsK1yDTo9gXbkdqB1CmeSUJzHvALWVDnLMBvKohh,True,66390226,16597556,103379,51689,51690,3zqXX6kzhkbW3d4TwD2CNjMRwxTbREXySekvq37kfCNk,4135162,11725083,-7589921,622
2022-02-25 11:10:45-05:00,13371,88awjJ2gbtVpwNCSwDLUbmtQM5xqGbJBwgEngdgUT8uV,7SE7JbDbRgsUzXUAnTrtCyzSCnEkLyYRuTQYRFqQ4rH9,True,202082367,50520591,315278,157639,157639,3zqXX6kzhkbW3d4TwD2CNjMRwxTbREXySekvq37kfCNk,12611131,35632043,-23020912,624
2022-02-25 11:58:00-05:00,13372,JE2PdvSvfaXowRWshpvgcRZ5HTmkRdqejVb2Mckg4kyF,9sLTy5CKpq9evvXqc2ofXDucPDg3FBKN5cQGX673D9wc,True,48671,12167,75,37,38,HfEnetJ7uBSmZWCjBNxdvv9HEC5nsW4wDV7wu6WnhWan,3039,11242,-8203,624
2022-02-25 11:59:32-05:00,13373,V34VhGxE5BcLmc9gtpAK6UBD91Pr38z8amqTRXdKkJW,GWhFwG72FzXQzw8h9EfMaP8qADufnSpMHzUzxsFQiwex,True,404740249,101185062,630433,315216,315217,3zqXX6kzhkbW3d4TwD2CNjMRwxTbREXySekvq37kfCNk,25217320,105100993,-79883673,623
2022-02-25 12:02:50-05:00,13374,JE2PdvSvfaXowRWshpvgcRZ5HTmkRdqejVb2Mckg4kyF,9sLTy5CKpq9evvXqc2ofXDucPDg3FBKN5cQGX673D9wc,True,37141,9285,58,29,29,DddJ7EWCmYEEZETCBNgAUSg81Ls6fZtiAaY5ekJ5sXx1,2325,9114,-6789,625
2022-02-25 14:24:39-05:00,13375,V34VhGxE5BcLmc9gtpAK6UBD91Pr38z8amqTRXdKkJW,GWhFwG72FzXQzw8h9EfMaP8qADufnSpMHzUzxsFQiwex,True,308590130,77147531,482525,241262,241263,HfEnetJ7uBSmZWCjBNxdvv9HEC5nsW4wDV7wu6WnhWan,19301001,84418465,-65117464,625
2022-02-25 14:28:27-05:00,13376,JE2PdvSvfaXowRWshpvgcRZ5HTmkRdqejVb2Mckg4kyF,9sLTy5CKpq9evvXqc2ofXDucPDg3FBKN5cQGX673D9wc,True,28357,7089,44,22,22,DddJ7EWCmYEEZETCBNgAUSg81Ls6fZtiAaY5ekJ5sXx1,1760,7352,-5592,620
2022-02-25 14:31:05-05:00,13377,9SFSrNvCt3CrFrRpgrPVob9tSGBidBRqUXJLK7b1SzBh,EBruibWjGm8o4cb1L6N4ygjLqG8PSPnRor4Q8KiJATzi,True,1405579616,351394904,2177299,1088649,1088650,DddJ7EWCmYEEZETCBNgAUSg81Ls6fZtiAaY5ekJ5sXx1,87091978,507133880,-420041902,619
2022-02-25 15:25:41-05:00,13378,G6KNZdFV14LDXQfW6w54nXF3Ay3jWcSZsGonoFWMcRo4,8vP5gsK1yDTo9gXbkdqB1CmeSUJzHvALWVDnLMBvKohh,True,50672886,12668221,78790,39395,39395,3zqXX6kzhkbW3d4TwD2CNjMRwxTbREXySekvq37kfCNk,3151633,9724353,-6572720,621
2022-02-25 15:44:49-05:00,13379,G6KNZdFV14LDXQfW6w54nXF3Ay3jWcSZsGonoFWMcRo4,8vP5gsK1yDTo9gXbkdqB1CmeSUJzHvALWVDnLMBvKohh,True,38705559,9676389,59298,29649,29649,FRen9v5CgMn6Y5bpz6LomHmA6CMeXehrKKpjQ15cCJPE,2371949,8002419,-5630470,612
2022-02-25 15:48:51-05:00,13380,G6KNZdFV14LDXQfW6w54nXF3Ay3jWcSZsGonoFWMcRo4,8vP5gsK1yDTo9gXbkdqB1CmeSUJzHvALWVDnLMBvKohh,True,29499273,7374818,46063,23031,23032,3zqXX6kzhkbW3d4TwD2CNjMRwxTbREXySekvq37kfCNk,1842548,6535524,-4692976,624
2022-02-25 16:34:20-05:00,13381,G6KNZdFV14LDXQfW6w54nXF3Ay3jWcSZsGonoFWMcRo4,8vP5gsK1yDTo9gXbkdqB1CmeSUJzHvALWVDnLMBvKohh,True,22514436,5628609,35156,17578,17578,3zqXX6kzhkbW3d4TwD2CNjMRwxTbREXySekvq37kfCNk,1406262,5315986,-3909724,624
2022-02-25 17:40:47-05:00,13382,V34VhGxE5BcLmc9gtpAK6UBD91Pr38z8amqTRXdKkJW,GWhFwG72FzXQzw8h9EfMaP8qADufnSpMHzUzxsFQiwex,True,235560008,58890001,368396,184198,184198,DddJ7EWCmYEEZETCBNgAUSg81Ls6fZtiAaY5ekJ5sXx1,14735864,67598728,-52862864,625
2022-02-25 17:40:56-05:00,13383,JE2PdvSvfaXowRWshpvgcRZ5HTmkRdqejVb2Mckg4kyF,9sLTy5CKpq9evvXqc2ofXDucPDg3FBKN5cQGX673D9wc,True,21659,5414,32,16,16,HfEnetJ7uBSmZWCjBNxdvv9HEC5nsW4wDV7wu6WnhWan,1319,5904,-4585,608
2022-02-25 17:42:52-05:00,13384,BZQYYFyK2GBU3mYi7BJuh1kRDmSvK6iGdHQwy5jitqQo,Hm3UsDcsURA7KPrR7khH8VH4k7H6ULnpxA5HW7s7Hw5R,True,94796126,23699031,148002,74001,74001,DddJ7EWCmYEEZETCBNgAUSg81Ls6fZtiAaY5ekJ5sXx1,5920081,13712202,-7792121,624
2022-02-25 17:43:34-05:00,13385,9SFSrNvCt3CrFrRpgrPVob9tSGBidBRqUXJLK7b1SzBh,EBruibWjGm8o4cb1L6N4ygjLqG8PSPnRor4Q8KiJATzi,True,1072099227,268024806,1667379,833689,833690,3zqXX6kzhkbW3d4TwD2CNjMRwxTbREXySekvq37kfCNk,66695198,399651526,-332956328,622
2022-02-25 17:46:25-05:00,13386,DVMLxFACqaNBD7q1TGJUUApJX7etJsxQRRFBP2DfBazJ,4hnRjD7S2KxD7UrgfrApntVxUD7Srh5E9nwPY53v89kz,True,98702724,24675681,154303,77151,77152,HfEnetJ7uBSmZWCjBNxdvv9HEC5nsW4wDV7wu6WnhWan,6172157,21915864,-15743707,625
2022-02-25 17:47:53-05:00,13387,Eec3xvC7d5iuGEXySFtzWekD1e9Ed6hQ2m7ExeJ9fDif,54WbNCyeTCrF5f57b67xRw2gNT42eM6PxG7mU5tPCcXW,True,13606587472,3401646868,21012315,10506157,10506158,3zqXX6kzhkbW3d4TwD2CNjMRwxTbREXySekvq37kfCNk,840492637,2837330615,-1996837978,617
2022-02-25 17:51:37-05:00,13388,4QJuKV4x6Wo4AsTA2Xsx7MwbjCrSVncnm6dkusWRg48J,EFhoiz3Td7yuFTo3NJBunx3pP4HHuk8yoNxk4gHqYTSt,True,31467,7866,49,24,25,HfEnetJ7uBSmZWCjBNxdvv9HEC5nsW4wDV7wu6WnhWan,1964,5588,-3624,624
2022-02-25 18:02:02-05:00,13389,4oMasDRj8HWfknmdwt6Mkz3eonr8J2byoiSTRo4sCnFQ,3emcATkEFvDVETiK97eVET2Z2jzkgiiSxX3gu5wsUKPe,True,42403302179,10600825544,66285461,33142730,33142731,HfEnetJ7uBSmZWCjBNxdvv9HEC5nsW4wDV7wu6WnhWan,2651418468,15791193299,-13139774831,625
2022-02-25 18:02:42-05:00,13390,V34VhGxE5BcLmc9gtpAK6UBD91Pr38z8amqTRXdKkJW,GWhFwG72FzXQzw8h9EfMaP8qADufnSpMHzUzxsFQiwex,True,180111829,45027957,281645,140822,140823,3zqXX6kzhkbW3d4TwD2CNjMRwxTbREXySekvq37kfCNk,11265810,54000108,-42734298,625
2022-02-25 18:02:54-05:00,13391,JE2PdvSvfaXowRWshpvgcRZ5HTmkRdqejVb2Mckg4kyF,9sLTy5CKpq9evvXqc2ofXDucPDg3FBKN5cQGX673D9wc,True,16510,4127,25,12,13,HfEnetJ7uBSmZWCjBNxdvv9HEC5nsW4wDV7wu6WnhWan,1021,4725,-3704,618
2022-02-25 18:25:25-05:00,13392,SEndYVMCKAeZUKSqGrMUSqXFmxtA9M1t4eXsUhVsTBF,3fcQQcbkpqodakamn82pFnMxBEPL2Drsg4jJNZ6dx72M,True,2455668470,613917116,3833415,1916707,1916708,3zqXX6kzhkbW3d4TwD2CNjMRwxTbREXySekvq37kfCNk,153336613,330167550,-176830937,624
2022-02-25 18:25:26-05:00,13393,88awjJ2gbtVpwNCSwDLUbmtQM5xqGbJBwgEngdgUT8uV,7SE7JbDbRgsUzXUAnTrtCyzSCnEkLyYRuTQYRFqQ4rH9,True,154242223,38560555,240331,120165,120166,HfEnetJ7uBSmZWCjBNxdvv9HEC5nsW4wDV7wu6WnhWan,9613244,29559958,-19946714,623
2022-02-25 18:26:18-05:00,13394,9SFSrNvCt3CrFrRpgrPVob9tSGBidBRqUXJLK7b1SzBh,EBruibWjGm8o4cb1L6N4ygjLqG8PSPnRor4Q8KiJATzi,True,818432551,204608137,1264886,632443,632443,3zqXX6kzhkbW3d4TwD2CNjMRwxTbREXySekvq37kfCNk,50595470,314676738,-264081268,618
2022-02-25 18:26:22-05:00,13395,7CSCMFa9W52tBDVUbXbc3woAy3GByeA1wPJdp3MgznPa,3447ptuVFu6G8B6N63RmS8mRv4n9PfHneypHLvbeaGLn,True,1180099634,295024908,1843041,921520,921521,3zqXX6kzhkbW3d4TwD2CNjMRwxTbREXySekvq37kfCNk,73721664,206459680,-132738016,624
2022-02-25 18:31:34-05:00,13396,4oMasDRj8HWfknmdwt6Mkz3eonr8J2byoiSTRo4sCnFQ,3emcATkEFvDVETiK97eVET2Z2jzkgiiSxX3gu5wsUKPe,True,32379081293,8094770323,50213208,25106604,25106604,FRen9v5CgMn6Y5bpz6LomHmA6CMeXehrKKpjQ15cCJPE,2008528349,12449157041,-10440628692,620
2022-02-25 19:15:00-05:00,13397,JE2PdvSvfaXowRWshpvgcRZ5HTmkRdqejVb2Mckg4kyF,9sLTy5CKpq9evvXqc2ofXDucPDg3FBKN5cQGX673D9wc,True,12599,3149,19,9,10,FRen9v5CgMn6Y5bpz6LomHmA6CMeXehrKKpjQ15cCJPE,779,3773,-2994,618
2022-02-25 19:15:02-05:00,13398,V34VhGxE5BcLmc9gtpAK6UBD91Pr38z8amqTRXdKkJW,GWhFwG72FzXQzw8h9EfMaP8qADufnSpMHzUzxsFQiwex,True,137390530,34347631,214716,107358,107358,3zqXX6kzhkbW3d4TwD2CNjMRwxTbREXySekvq37kfCNk,8588674,43021984,-34433310,625
2022-02-25 19:22:48-05:00,13399,9SFSrNvCt3CrFrRpgrPVob9tSGBidBRqUXJLK7b1SzBh,EBruibWjGm8o4cb1L6N4ygjLqG8PSPnRor4Q8KiJATzi,True,624037770,156009442,976268,488134,488134,DddJ7EWCmYEEZETCBNgAUSg81Ls6fZtiAaY5ekJ5sXx1,39050746,247328396,-208277650,625
2022-02-25 19:24:12-05:00,13400,7CSCMFa9W52tBDVUbXbc3woAy3GByeA1wPJdp3MgznPa,3447ptuVFu6G8B6N63RmS8mRv4n9PfHneypHLvbeaGLn,True,900555099,225138774,1407561,703780,703781,3zqXX6kzhkbW3d4TwD2CNjMRwxTbREXySekvq37kfCNk,56302458,171345448,-115042990,625
2022-02-25 19:37:23-05:00,13401,Eec3xvC7d5iuGEXySFtzWekD1e9Ed6hQ2m7ExeJ9fDif,54WbNCyeTCrF5f57b67xRw2gNT42eM6PxG7mU5tPCcXW,True,10384299721,2596074930,16009046,8004523,8004523,DddJ7EWCmYEEZETCBNgAUSg81Ls6fZtiAaY5ekJ5sXx1,640361874,2320786229,-1680424355,616
2022-02-25 19:38:45-05:00,13402,G6KNZdFV14LDXQfW6w54nXF3Ay3jWcSZsGonoFWMcRo4,8vP5gsK1yDTo9gXbkdqB1CmeSUJzHvALWVDnLMBvKohh,True,17182519,4295629,26849,13424,13425,DddJ7EWCmYEEZETCBNgAUSg81Ls6fZtiAaY5ekJ5sXx1,1073996,4302987,-3228991,625
2022-02-25 19:39:13-05:00,13403,4oMasDRj8HWfknmdwt6Mkz3eonr8J2byoiSTRo4sCnFQ,3emcATkEFvDVETiK97eVET2Z2jzkgiiSxX3gu5wsUKPe,True,24740288546,6185072136,37493275,18746637,18746638,3zqXX6kzhkbW3d4TwD2CNjMRwxTbREXySekvq37kfCNk,1499731027,9791393992,-8291662965,606
2022-02-25 20:21:30-05:00,13404,G6KNZdFV14LDXQfW6w54nXF3Ay3jWcSZsGonoFWMcRo4,8vP5gsK1yDTo9gXbkdqB1CmeSUJzHvALWVDnLMBvKohh,True,13116649,3279162,20434,10217,10217,FRen9v5CgMn6Y5bpz6LomHmA6CMeXehrKKpjQ15cCJPE,817362,3468868,-2651506,623
2022-02-25 23:50:47-05:00,13405,JE2PdvSvfaXowRWshpvgcRZ5HTmkRdqejVb2Mckg4kyF,9sLTy5CKpq9evvXqc2ofXDucPDg3FBKN5cQGX673D9wc,True,9607,2401,14,7,7,HfEnetJ7uBSmZWCjBNxdvv9HEC5nsW4wDV7wu6WnhWan,598,3000,-2402,622
2022-02-26 04:25:41-05:00,13406,9SFSrNvCt3CrFrRpgrPVob9tSGBidBRqUXJLK7b1SzBh,EBruibWjGm8o4cb1L6N4ygjLqG8PSPnRor4Q8KiJATzi,True,477539887,119384971,701344,350672,350672,HfEnetJ7uBSmZWCjBNxdvv9HEC5nsW4wDV7wu6WnhWan,28053768,193775461,-165721693,587
2022-02-26 04:25:42-05:00,13407,7CSCMFa9W52tBDVUbXbc3woAy3GByeA1wPJdp3MgznPa,3447ptuVFu6G8B6N63RmS8mRv4n9PfHneypHLvbeaGLn,True,688661451,172165362,1022903,511451,511452,3zqXX6kzhkbW3d4TwD2CNjMRwxTbREXySekvq37kfCNk,40916154,140448689,-99532535,594
2022-02-26 04:25:44-05:00,13408,V34VhGxE5BcLmc9gtpAK6UBD91Pr38z8amqTRXdKkJW,GWhFwG72FzXQzw8h9EfMaP8qADufnSpMHzUzxsFQiwex,True,105028144,26257035,156318,78159,78159,3zqXX6kzhkbW3d4TwD2CNjMRwxTbREXySekvq37kfCNk,6252744,34102234,-27849490,595
2022-02-26 04:31:16-05:00,13409,JE2PdvSvfaXowRWshpvgcRZ5HTmkRdqejVb2Mckg4kyF,9sLTy5CKpq9evvXqc2ofXDucPDg3FBKN5cQGX673D9wc,True,7333,1833,11,5,6,DddJ7EWCmYEEZETCBNgAUSg81Ls6fZtiAaY5ekJ5sXx1,454,2382,-1928,619
2022-02-26 06:30:45-05:00,13410,GLXb8fHTTJ5njY9j1TzdSs98ZLfmy1QWwKLVHeiwiHhZ,BKoqP2E4J2CoHMhiDHk9W1LbW1DUNF5wuvFPswwnC1kT,True,2428340419,607085104,3766111,1883055,1883056,3zqXX6kzhkbW3d4TwD2CNjMRwxTbREXySekvq37kfCNk,150644460,679548669,-528904209,620
2022-02-26 07:56:50-05:00,13411,G6KNZdFV14LDXQfW6w54nXF3Ay3jWcSZsGonoFWMcRo4,8vP5gsK1yDTo9gXbkdqB1CmeSUJzHvALWVDnLMBvKohh,True,10009579,2502394,15629,7814,7815,DddJ7EWCmYEEZETCBNgAUSg81Ls6fZtiAaY5ekJ5sXx1,625166,2785889,-2160723,624
2022-02-26 08:27:26-05:00,13412,G6KNZdFV14LDXQfW6w54nXF3Ay3jWcSZsGonoFWMcRo4,8vP5gsK1yDTo9gXbkdqB1CmeSUJzHvALWVDnLMBvKohh,True,7638892,1909723,11946,5973,5973,HfEnetJ7uBSmZWCjBNxdvv9HEC5nsW4wDV7wu6WnhWan,477868,2230118,-1752250,625
2022-02-26 12:22:43-05:00,13413,G6KNZdFV14LDXQfW6w54nXF3Ay3jWcSZsGonoFWMcRo4,8vP5gsK1yDTo9gXbkdqB1CmeSUJzHvALWVDnLMBvKohh,True,5831465,1457866,9084,4542,4542,FRen9v5CgMn6Y5bpz6LomHmA6CMeXehrKKpjQ15cCJPE,363375,1779859,-1416484,623
2022-02-26 14:14:36-05:00,13414,SEndYVMCKAeZUKSqGrMUSqXFmxtA9M1t4eXsUhVsTBF,3fcQQcbkpqodakamn82pFnMxBEPL2Drsg4jJNZ6dx72M,True,1879450722,469862679,2939728,1469864,1469864,3zqXX6kzhkbW3d4TwD2CNjMRwxTbREXySekvq37kfCNk,117589134,282926443,-165337309,625
2022-02-26 15:32:28-05:00,13415,V34VhGxE5BcLmc9gtpAK6UBD91Pr38z8amqTRXdKkJW,GWhFwG72FzXQzw8h9EfMaP8qADufnSpMHzUzxsFQiwex,True,79910186,19977546,124490,62245,62245,HfEnetJ7uBSmZWCjBNxdvv9HEC5nsW4wDV7wu6WnhWan,4979618,26885847,-21906229,623
2022-02-26 15:32:28-05:00,13416,9SFSrNvCt3CrFrRpgrPVob9tSGBidBRqUXJLK7b1SzBh,EBruibWjGm8o4cb1L6N4ygjLqG8PSPnRor4Q8KiJATzi,True,362333010,90583252,566483,283241,283242,3zqXX6kzhkbW3d4TwD2CNjMRwxTbREXySekvq37kfCNk,22659332,151129773,-128470441,625
2022-02-26 15:50:50-05:00,13417,7CSCMFa9W52tBDVUbXbc3woAy3GByeA1wPJdp3MgznPa,3447ptuVFu6G8B6N63RmS8mRv4n9PfHneypHLvbeaGLn,True,522943755,130735938,817588,408794,408794,3zqXX6kzhkbW3d4TwD2CNjMRwxTbREXySekvq37kfCNk,32703545,113803545,-81100000,625
2022-02-26 16:03:23-05:00,13418,9Ngb4UJjvSm9zbTN4RYRFWBzTPVWQh7C2hFiDvwPsDBd,EamTKaoTYJo9RUMQC7MjS1HJrVPYipR2cv6nYpgBLnPr,True,38925075,9731268,60266,30133,30133,FRen9v5CgMn6Y5bpz6LomHmA6CMeXehrKKpjQ15cCJPE,2410650,21220850,-18810200,619
2022-02-26 17:10:20-05:00,13419,JE2PdvSvfaXowRWshpvgcRZ5HTmkRdqejVb2Mckg4kyF,9sLTy5CKpq9evvXqc2ofXDucPDg3FBKN5cQGX673D9wc,True,5592,1398,8,4,4,3zqXX6kzhkbW3d4TwD2CNjMRwxTbREXySekvq37kfCNk,341,1879,-1538,609
2022-02-26 17:25:20-05:00,13420,9SFSrNvCt3CrFrRpgrPVob9tSGBidBRqUXJLK7b1SzBh,EBruibWjGm8o4cb1L6N4ygjLqG8PSPnRor4Q8KiJATzi,True,276450298,69112574,432083,216041,216042,3zqXX6kzhkbW3d4TwD2CNjMRwxTbREXySekvq37kfCNk,17283327,118337307,-101053980,625
2022-02-26 17:27:08-05:00,13421,7CSCMFa9W52tBDVUbXbc3woAy3GByeA1wPJdp3MgznPa,3447ptuVFu6G8B6N63RmS8mRv4n9PfHneypHLvbeaGLn,True,399278962,99819740,616444,308222,308222,3zqXX6kzhkbW3d4TwD2CNjMRwxTbREXySekvq37kfCNk,24657784,92555589,-67897805,617
2022-02-26 17:31:47-05:00,13422,V34VhGxE5BcLmc9gtpAK6UBD91Pr38z8amqTRXdKkJW,GWhFwG72FzXQzw8h9EfMaP8qADufnSpMHzUzxsFQiwex,True,60936357,15234087,95212,47606,47606,3zqXX6kzhkbW3d4TwD2CNjMRwxTbREXySekvq37kfCNk,3808487,21263560,-17455073,624
2022-02-26 17:36:12-05:00,13423,JE2PdvSvfaXowRWshpvgcRZ5HTmkRdqejVb2Mckg4kyF,9sLTy5CKpq9evvXqc2ofXDucPDg3FBKN5cQGX673D9wc,True,4261,1065,6,3,3,DddJ7EWCmYEEZETCBNgAUSg81Ls6fZtiAaY5ekJ5sXx1,266,1486,-1220,624
2022-02-28 10:15:48-05:00,13424,V34VhGxE5BcLmc9gtpAK6UBD91Pr38z8amqTRXdKkJW,GWhFwG72FzXQzw8h9EfMaP8qADufnSpMHzUzxsFQiwex,True,46415692,11603922,70031,35015,35016,3zqXX6kzhkbW3d4TwD2CNjMRwxTbREXySekvq37kfCNk,2801244,16656610,-13855366,603
2022-02-28 10:15:51-05:00,13425,JE2PdvSvfaXowRWshpvgcRZ5HTmkRdqejVb2Mckg4kyF,9sLTy5CKpq9evvXqc2ofXDucPDg3FBKN5cQGX673D9wc,True,3242,810,5,2,3,DddJ7EWCmYEEZETCBNgAUSg81Ls6fZtiAaY5ekJ5sXx1,202,1163,-961,623
2022-02-28 10:16:47-05:00,13426,BZQYYFyK2GBU3mYi7BJuh1kRDmSvK6iGdHQwy5jitqQo,Hm3UsDcsURA7KPrR7khH8VH4k7H6ULnpxA5HW7s7Hw5R,True,72503151,18125787,110773,55386,55387,FRen9v5CgMn6Y5bpz6LomHmA6CMeXehrKKpjQ15cCJPE,4430958,11681170,-7250212,611
2022-02-28 10:20:57-05:00,13427,V34VhGxE5BcLmc9gtpAK6UBD91Pr38z8amqTRXdKkJW,GWhFwG72FzXQzw8h9EfMaP8qADufnSpMHzUzxsFQiwex,True,35393412,8848352,54549,27274,27275,3zqXX6kzhkbW3d4TwD2CNjMRwxTbREXySekvq37kfCNk,2181993,13122745,-10940752,616
2022-02-28 10:21:03-05:00,13428,JE2PdvSvfaXowRWshpvgcRZ5HTmkRdqejVb2Mckg4kyF,9sLTy5CKpq9evvXqc2ofXDucPDg3FBKN5cQGX673D9wc,True,2475,618,3,1,2,DddJ7EWCmYEEZETCBNgAUSg81Ls6fZtiAaY5ekJ5sXx1,154,917,-763,622
2022-02-28 10:53:50-05:00,13429,V34VhGxE5BcLmc9gtpAK6UBD91Pr38z8amqTRXdKkJW,GWhFwG72FzXQzw8h9EfMaP8qADufnSpMHzUzxsFQiwex,True,26996717,6749179,42082,21041,21041,3zqXX6kzhkbW3d4TwD2CNjMRwxTbREXySekvq37kfCNk,1683309,10333013,-8649704,623
2022-02-28 10:53:51-05:00,13430,JE2PdvSvfaXowRWshpvgcRZ5HTmkRdqejVb2Mckg4kyF,9sLTy5CKpq9evvXqc2ofXDucPDg3FBKN5cQGX673D9wc,True,1891,472,2,1,1,3zqXX6kzhkbW3d4TwD2CNjMRwxTbREXySekvq37kfCNk,117,723,-606,618
2022-02-28 10:56:27-05:00,13431,Eec3xvC7d5iuGEXySFtzWekD1e9Ed6hQ2m7ExeJ9fDif,54WbNCyeTCrF5f57b67xRw2gNT42eM6PxG7mU5tPCcXW,True,7931591583,1982897895,12365446,6182723,6182723,3zqXX6kzhkbW3d4TwD2CNjMRwxTbREXySekvq37kfCNk,494617855,1900251660,-1405633805,623
2022-02-28 11:26:52-05:00,13432,CLP8qmL8aN9ocJKYnbKSo4k46CU3LBsebspfREQcSGvo,F6tkkFJnvjYyPdSXDNzZMUfhd1o8dFiLyLPRZ5U1sXHE,True,226017843,56504460,351380,175690,175690,3zqXX6kzhkbW3d4TwD2CNjMRwxTbREXySekvq37kfCNk,14055213,40313057,-26257844,621
2022-02-28 11:26:54-05:00,13433,4QJuKV4x6Wo4AsTA2Xsx7MwbjCrSVncnm6dkusWRg48J,EFhoiz3Td7yuFTo3NJBunx3pP4HHuk8yoNxk4gHqYTSt,True,24046,6011,37,18,19,DddJ7EWCmYEEZETCBNgAUSg81Ls6fZtiAaY5ekJ5sXx1,1491,4654,-3163,620
2022-02-28 12:51:29-05:00,13434,JE2PdvSvfaXowRWshpvgcRZ5HTmkRdqejVb2Mckg4kyF,9sLTy5CKpq9evvXqc2ofXDucPDg3FBKN5cQGX673D9wc,True,1444,361,2,1,1,3zqXX6kzhkbW3d4TwD2CNjMRwxTbREXySekvq37kfCNk,90,569,-479,623
2022-02-28 12:58:45-05:00,13435,V34VhGxE5BcLmc9gtpAK6UBD91Pr38z8amqTRXdKkJW,GWhFwG72FzXQzw8h9EfMaP8qADufnSpMHzUzxsFQiwex,True,20595878,5148968,32174,16087,16087,3zqXX6kzhkbW3d4TwD2CNjMRwxTbREXySekvq37kfCNk,1286967,8121351,-6834384,624
2022-02-28 15:20:40-05:00,13436,BZQYYFyK2GBU3mYi7BJuh1kRDmSvK6iGdHQwy5jitqQo,Hm3UsDcsURA7KPrR7khH8VH4k7H6ULnpxA5HW7s7Hw5R,True,55242117,13810529,86356,43178,43178,HfEnetJ7uBSmZWCjBNxdvv9HEC5nsW4wDV7wu6WnhWan,3454276,9756725,-6302449,625
2022-02-28 15:22:46-05:00,13437,Ldn4w1zXoukjaJegLhsk1L3UBx4jPHwBuaQDo37KN3r,523bwDjqdA4ZqdzEfpEkSoDky94dTRP9VS9AjakFuj5z,True,33515080214,8378770052,52286084,26143042,26143042,3zqXX6kzhkbW3d4TwD2CNjMRwxTbREXySekvq37kfCNk,2091443397,6127255533,-4035812136,624
2022-02-28 15:22:49-05:00,13438,4QJuKV4x6Wo4AsTA2Xsx7MwbjCrSVncnm6dkusWRg48J,EFhoiz3Td7yuFTo3NJBunx3pP4HHuk8yoNxk4gHqYTSt,True,18348,4587,28,14,14,3zqXX6kzhkbW3d4TwD2CNjMRwxTbREXySekvq37kfCNk,1141,3826,-2685,621
2022-02-28 15:22:49-05:00,13439,CLP8qmL8aN9ocJKYnbKSo4k46CU3LBsebspfREQcSGvo,F6tkkFJnvjYyPdSXDNzZMUfhd1o8dFiLyLPRZ5U1sXHE,True,172460607,43115151,268842,134421,134421,FRen9v5CgMn6Y5bpz6LomHmA6CMeXehrKKpjQ15cCJPE,10753705,33394662,-22640957,623
2022-02-28 15:58:32-05:00,13440,BZQYYFyK2GBU3mYi7BJuh1kRDmSvK6iGdHQwy5jitqQo,Hm3UsDcsURA7KPrR7khH8VH4k7H6ULnpxA5HW7s7Hw5R,True,42166378,10541594,65828,32914,32914,3zqXX6kzhkbW3d4TwD2CNjMRwxTbREXySekvq37kfCNk,2633130,8094777,-5461647,624
2022-02-28 15:59:50-05:00,13441,FjjU3VtoUbcgBtU8pxo96JfvXHppbQVGTyz4hJYiC7k4,8VztSSmeE9EfRwmfr22gdqviqdy7W5sATZLkuGWBMxP6,True,200659,50164,313,156,157,DddJ7EWCmYEEZETCBNgAUSg81Ls6fZtiAaY5ekJ5sXx1,12557,41777,-29220,625
2022-02-28 15:59:54-05:00,13442,4Siq98BDakELWP5BzVoEN5tcg1ywRxTYs1aUcfW8spCt,2EBXLTVz1Gk9gS5JcVqCKAP5PatFGw1Vnww65Moz3SUn,True,1963200542,490800135,3071894,1535947,1535947,3zqXX6kzhkbW3d4TwD2CNjMRwxTbREXySekvq37kfCNk,122875799,356261914,-233386115,625
2022-02-28 17:32:53-05:00,13443,DukppMFjzXeiNRuLVC8SVps3SgT3whoea3dTogk3vP3W,4KEBNv3wZsMbmkPmZ1J54uT6raZEJjrzPGDkoGG4nU7Q,True,1830715123,457678780,2851687,1425843,1425844,3zqXX6kzhkbW3d4TwD2CNjMRwxTbREXySekvq37kfCNk,114067505,326380550,-212313045,623
2022-02-28 17:33:52-05:00,13444,7X1UBUXhC59kzJKyroP6fe5GVtGCrVMZGKwbSnedkvwJ,5A24drY1wqNsjV6cABFfFx2D5BQ16m6vozbxvyUcXG4C,True,2168088154,542022038,3315464,1657732,1657732,HfEnetJ7uBSmZWCjBNxdvv9HEC5nsW4wDV7wu6WnhWan,132618599,382771112,-250152513,611
2022-02-28 17:34:03-05:00,13445,DukppMFjzXeiNRuLVC8SVps3SgT3whoea3dTogk3vP3W,4KEBNv3wZsMbmkPmZ1J54uT6raZEJjrzPGDkoGG4nU7Q,True,1397333799,349333449,2172959,1086479,1086480,3zqXX6kzhkbW3d4TwD2CNjMRwxTbREXySekvq37kfCNk,86918362,270484983,-183566621,622
2022-02-28 17:34:12-05:00,13446,G6KNZdFV14LDXQfW6w54nXF3Ay3jWcSZsGonoFWMcRo4,8vP5gsK1yDTo9gXbkdqB1CmeSUJzHvALWVDnLMBvKohh,True,4461459,1115364,6842,3421,3421,3zqXX6kzhkbW3d4TwD2CNjMRwxTbREXySekvq37kfCNk,273713,1423936,-1150223,613
2022-02-28 17:34:13-05:00,13447,V34VhGxE5BcLmc9gtpAK6UBD91Pr38z8amqTRXdKkJW,GWhFwG72FzXQzw8h9EfMaP8qADufnSpMHzUzxsFQiwex,True,15756477,3939118,24057,12028,12029,FRen9v5CgMn6Y5bpz6LomHmA6CMeXehrKKpjQ15cCJPE,962285,6369027,-5406742,610
2022-02-28 17:34:14-05:00,13448,JE2PdvSvfaXowRWshpvgcRZ5HTmkRdqejVb2Mckg4kyF,9sLTy5CKpq9evvXqc2ofXDucPDg3FBKN5cQGX673D9wc,True,1105,276,1,0,1,DddJ7EWCmYEEZETCBNgAUSg81Ls6fZtiAaY5ekJ5sXx1,66,447,-381,597
2022-02-28 17:35:17-05:00,13449,Eec3xvC7d5iuGEXySFtzWekD1e9Ed6hQ2m7ExeJ9fDif,54WbNCyeTCrF5f57b67xRw2gNT42eM6PxG7mU5tPCcXW,True,6051866784,1512966696,9452592,4726296,4726296,3zqXX6kzhkbW3d4TwD2CNjMRwxTbREXySekvq37kfCNk,378103688,1536607776,-1158504088,624
2022-02-28 17:35:36-05:00,13450,SEndYVMCKAeZUKSqGrMUSqXFmxtA9M1t4eXsUhVsTBF,3fcQQcbkpqodakamn82pFnMxBEPL2Drsg4jJNZ6dx72M,True,1448523622,362130905,2251983,1125991,1125992,3zqXX6kzhkbW3d4TwD2CNjMRwxTbREXySekvq37kfCNk,90079346,240427528,-150348182,621
2022-02-28 17:35:46-05:00,13451,4QJuKV4x6Wo4AsTA2Xsx7MwbjCrSVncnm6dkusWRg48J,EFhoiz3Td7yuFTo3NJBunx3pP4HHuk8yoNxk4gHqYTSt,True,14016,3504,21,10,11,3zqXX6kzhkbW3d4TwD2CNjMRwxTbREXySekvq37kfCNk,858,3126,-2268,612
2022-02-28 17:35:46-05:00,13452,CLP8qmL8aN9ocJKYnbKSo4k46CU3LBsebspfREQcSGvo,F6tkkFJnvjYyPdSXDNzZMUfhd1o8dFiLyLPRZ5U1sXHE,True,131741689,32935422,202161,101080,101081,DddJ7EWCmYEEZETCBNgAUSg81Ls6fZtiAaY5ekJ5sXx1,8086440,27463590,-19377150,613
2022-02-28 17:36:37-05:00,13453,BZQYYFyK2GBU3mYi7BJuh1kRDmSvK6iGdHQwy5jitqQo,Hm3UsDcsURA7KPrR7khH8VH4k7H6ULnpxA5HW7s7Hw5R,True,32192368,8048092,49979,24989,24990,FRen9v5CgMn6Y5bpz6LomHmA6CMeXehrKKpjQ15cCJPE,1999185,6663016,-4663831,621
2022-02-28 17:36:41-05:00,13454,88awjJ2gbtVpwNCSwDLUbmtQM5xqGbJBwgEngdgUT8uV,7SE7JbDbRgsUzXUAnTrtCyzSCnEkLyYRuTQYRFqQ4rH9,True,117964564,29491141,183944,91972,91972,3zqXX6kzhkbW3d4TwD2CNjMRwxTbREXySekvq37kfCNk,7357793,24601055,-17243262,623
2022-02-28 17:36:47-05:00,13455,Ldn4w1zXoukjaJegLhsk1L3UBx4jPHwBuaQDo37KN3r,523bwDjqdA4ZqdzEfpEkSoDky94dTRP9VS9AjakFuj5z,True,25755842576,6438960643,39954640,19977320,19977320,DddJ7EWCmYEEZETCBNgAUSg81Ls6fZtiAaY5ekJ5sXx1,1598185609,5071958030,-3473772421,620
2022-02-28 17:37:16-05:00,13456,FjjU3VtoUbcgBtU8pxo96JfvXHppbQVGTyz4hJYiC7k4,8VztSSmeE9EfRwmfr22gdqviqdy7W5sATZLkuGWBMxP6,True,153217,38304,238,119,119,HfEnetJ7uBSmZWCjBNxdvv9HEC5nsW4wDV7wu6WnhWan,9520,34157,-24637,621
2022-02-28 17:37:17-05:00,13457,4Siq98BDakELWP5BzVoEN5tcg1ywRxTYs1aUcfW8spCt,2EBXLTVz1Gk9gS5JcVqCKAP5PatFGw1Vnww65Moz3SUn,True,1498552104,374638026,2340680,1170340,1170340,DddJ7EWCmYEEZETCBNgAUSg81Ls6fZtiAaY5ekJ5sXx1,93627212,294838245,-201211033,624
2022-02-28 17:37:22-05:00,13458,Fs4ni3Mb3hF1dT7W3mW5vwjuavGKc2d3N4BPVXa7Hn3,vHGFetJQKv989wRLozjiHAs297YzNZZPeGiTaH2KepG,True,698249,174562,1076,538,538,FRen9v5CgMn6Y5bpz6LomHmA6CMeXehrKKpjQ15cCJPE,43040,127668,-84628,616
2022-02-28 17:37:25-05:00,13459,3TCKVG1t5DCSXRdVXTN8uMxoDuhQ41WDYrcoKDz8byPL,Cm23o46LQekUd4f756Eq1shLCmZCAzEEdWpRcaMY1WVk,True,352664,88166,551,275,276,HfEnetJ7uBSmZWCjBNxdvv9HEC5nsW4wDV7wu6WnhWan,22063,69140,-47077,625
2022-02-28 17:37:54-05:00,13460,V34VhGxE5BcLmc9gtpAK6UBD91Pr38z8amqTRXdKkJW,GWhFwG72FzXQzw8h9EfMaP8qADufnSpMHzUzxsFQiwex,True,12050120,3012528,17876,8938,8938,3zqXX6kzhkbW3d4TwD2CNjMRwxTbREXySekvq37kfCNk,715049,4993286,-4278237,593
2022-02-28 17:37:58-05:00,13461,JE2PdvSvfaXowRWshpvgcRZ5HTmkRdqejVb2Mckg4kyF,9sLTy5CKpq9evvXqc2ofXDucPDg3FBKN5cQGX673D9wc,True,849,212,1,0,1,FRen9v5CgMn6Y5bpz6LomHmA6CMeXehrKKpjQ15cCJPE,45,351,-306,530
2022-02-28 17:38:00-05:00,13462,EG8G1DMZqXByLNtowrEJr9Rb4HnG89REC6NLsg8bdmep,94AvgT7uB6KfmKitJPYwPa6T9TScSnCQ5ziQG5VT5qSA,True,158253,39563,246,123,123,DddJ7EWCmYEEZETCBNgAUSg81Ls6fZtiAaY5ekJ5sXx1,9874,28064,-18190,623
2022-02-28 17:38:16-05:00,13463,JE2PdvSvfaXowRWshpvgcRZ5HTmkRdqejVb2Mckg4kyF,9sLTy5CKpq9evvXqc2ofXDucPDg3FBKN5cQGX673D9wc,True,641,160,1,0,1,FRen9v5CgMn6Y5bpz6LomHmA6CMeXehrKKpjQ15cCJPE,40,273,-233,624
2022-02-28 17:41:03-05:00,13464,4S7Ky4QBiqRWUFYsCcsSnijMTPsNNcDDSAHNyS9Mvzo2,DsdFdR1MT5pdU196PCYM6a5os3TAiAg6fUweGAugHsb8,True,218770523,54692630,341089,170544,170545,3zqXX6kzhkbW3d4TwD2CNjMRwxTbREXySekvq37kfCNk,13643593,55416126,-41772533,623
2022-02-28 17:41:43-05:00,13465,V34VhGxE5BcLmc9gtpAK6UBD91Pr38z8amqTRXdKkJW,GWhFwG72FzXQzw8h9EfMaP8qADufnSpMHzUzxsFQiwex,True,9158131,2289532,14304,7152,7152,3zqXX6kzhkbW3d4TwD2CNjMRwxTbREXySekvq37kfCNk,572198,3905852,-3333654,624
2022-02-28 17:41:50-05:00,13466,DukppMFjzXeiNRuLVC8SVps3SgT3whoea3dTogk3vP3W,4KEBNv3wZsMbmkPmZ1J54uT6raZEJjrzPGDkoGG4nU7Q,True,1072250674,268062668,1512376,756188,756188,FRen9v5CgMn6Y5bpz6LomHmA6CMeXehrKKpjQ15cCJPE,60495079,222439877,-161944798,564
2022-02-28 17:41:50-05:00,13467,7X1UBUXhC59kzJKyroP6fe5GVtGCrVMZGKwbSnedkvwJ,5A24drY1wqNsjV6cABFfFx2D5BQ16m6vozbxvyUcXG4C,True,1666101373,416525343,2231696,1115848,1115848,FRen9v5CgMn6Y5bpz6LomHmA6CMeXehrKKpjQ15cCJPE,89267878,316965384,-227697506,535
2022-02-28 17:42:11-05:00,13468,4oMasDRj8HWfknmdwt6Mkz3eonr8J2byoiSTRo4sCnFQ,3emcATkEFvDVETiK97eVET2Z2jzkgiiSxX3gu5wsUKPe,True,43571742043,10892935510,67737228,33868614,33868614,3zqXX6kzhkbW3d4TwD2CNjMRwxTbREXySekvq37kfCNk,2709489145,15284710067,-12575220922,621
2022-02-28 17:42:31-05:00,13469,7qxGLMg6ZAxkVjhuj2PY6a5F36k4Efo3aCa99kvTpSKw,wgWcmEebBLbcm9a2jyCiw8nzqbGbfj6zRou4ZZhfWp7,True,77111019,19277754,120589,60294,60295,3zqXX6kzhkbW3d4TwD2CNjMRwxTbREXySekvq37kfCNk,4823576,29418417,-24594841,625
2022-02-28 18:22:03-05:00,13470,G6KNZdFV14LDXQfW6w54nXF3Ay3jWcSZsGonoFWMcRo4,8vP5gsK1yDTo9gXbkdqB1CmeSUJzHvALWVDnLMBvKohh,True,3400084,850021,5320,2660,2660,HfEnetJ7uBSmZWCjBNxdvv9HEC5nsW4wDV7wu6WnhWan,212825,1129481,-916656,625
2022-02-28 18:36:42-05:00,13471,G6KNZdFV14LDXQfW6w54nXF3Ay3jWcSZsGonoFWMcRo4,8vP5gsK1yDTo9gXbkdqB1CmeSUJzHvALWVDnLMBvKohh,True,2595228,648807,4058,2029,2029,DddJ7EWCmYEEZETCBNgAUSg81Ls6fZtiAaY5ekJ5sXx1,162340,894997,-732657,625
2022-02-28 18:38:49-05:00,13472,JE2PdvSvfaXowRWshpvgcRZ5HTmkRdqejVb2Mckg4kyF,9sLTy5CKpq9evvXqc2ofXDucPDg3FBKN5cQGX673D9wc,True,490,122,0,0,0,FRen9v5CgMn6Y5bpz6LomHmA6CMeXehrKKpjQ15cCJPE,30,214,-184,612
2022-02-28 18:51:10-05:00,13473,4oMasDRj8HWfknmdwt6Mkz3eonr8J2byoiSTRo4sCnFQ,3emcATkEFvDVETiK97eVET2Z2jzkgiiSxX3gu5wsUKPe,True,33231756714,8307939178,51994455,25997227,25997228,3zqXX6kzhkbW3d4TwD2CNjMRwxTbREXySekvq37kfCNk,2079778227,12073127042,-9993348815,625
2022-02-28 19:00:35-05:00,13474,Eec3xvC7d5iuGEXySFtzWekD1e9Ed6hQ2m7ExeJ9fDif,54WbNCyeTCrF5f57b67xRw2gNT42eM6PxG7mU5tPCcXW,True,4620117102,1155029275,7172961,3586480,3586481,HfEnetJ7uBSmZWCjBNxdvv9HEC5nsW4wDV7wu6WnhWan,286918444,1237640568,-950722124,621
2022-02-28 19:01:28-05:00,13475,V34VhGxE5BcLmc9gtpAK6UBD91Pr38z8amqTRXdKkJW,GWhFwG72FzXQzw8h9EfMaP8qADufnSpMHzUzxsFQiwex,True,6988623,1747155,10890,5445,5445,DddJ7EWCmYEEZETCBNgAUSg81Ls6fZtiAaY5ekJ5sXx1,435615,3055080,-2619465,623
2022-02-28 19:02:40-05:00,13476,88awjJ2gbtVpwNCSwDLUbmtQM5xqGbJBwgEngdgUT8uV,7SE7JbDbRgsUzXUAnTrtCyzSCnEkLyYRuTQYRFqQ4rH9,True,90039464,22509866,140175,70087,70088,DddJ7EWCmYEEZETCBNgAUSg81Ls6fZtiAaY5ekJ5sXx1,5607027,20105702,-14498675,622
2022-02-28 19:02:42-05:00,13477,7qxGLMg6ZAxkVjhuj2PY6a5F36k4Efo3aCa99kvTpSKw,wgWcmEebBLbcm9a2jyCiw8nzqbGbfj6zRou4ZZhfWp7,True,58996751,14749187,91994,45997,45997,3zqXX6kzhkbW3d4TwD2CNjMRwxTbREXySekvq37kfCNk,3679766,23124936,-19445170,623
2022-02-28 19:23:52-05:00,13478,G6KNZdFV14LDXQfW6w54nXF3Ay3jWcSZsGonoFWMcRo4,8vP5gsK1yDTo9gXbkdqB1CmeSUJzHvALWVDnLMBvKohh,True,1983132,495783,3035,1517,1518,DddJ7EWCmYEEZETCBNgAUSg81Ls6fZtiAaY5ekJ5sXx1,121436,707640,-586204,612
2022-02-28 19:29:56-05:00,13479,G6KNZdFV14LDXQfW6w54nXF3Ay3jWcSZsGonoFWMcRo4,8vP5gsK1yDTo9gXbkdqB1CmeSUJzHvALWVDnLMBvKohh,True,1513910,378477,2296,1148,1148,DddJ7EWCmYEEZETCBNgAUSg81Ls6fZtiAaY5ekJ5sXx1,91840,558054,-466214,606
2022-02-28 19:30:39-05:00,13480,SEndYVMCKAeZUKSqGrMUSqXFmxtA9M1t4eXsUhVsTBF,3fcQQcbkpqodakamn82pFnMxBEPL2Drsg4jJNZ6dx72M,True,1113785140,278446284,1740872,870436,870436,3zqXX6kzhkbW3d4TwD2CNjMRwxTbREXySekvq37kfCNk,69634891,200615063,-130980172,625
2022-03-01 05:33:20-05:00,13481,JE2PdvSvfaXowRWshpvgcRZ5HTmkRdqejVb2Mckg4kyF,9sLTy5CKpq9evvXqc2ofXDucPDg3FBKN5cQGX673D9wc,True,375,93,0,0,0,3zqXX6kzhkbW3d4TwD2CNjMRwxTbREXySekvq37kfCNk,23,168,-145,613
2022-03-01 05:35:12-05:00,13482,4oMasDRj8HWfknmdwt6Mkz3eonr8J2byoiSTRo4sCnFQ,3emcATkEFvDVETiK97eVET2Z2jzkgiiSxX3gu5wsUKPe,True,25349794852,6337448713,39479092,19739546,19739546,HfEnetJ7uBSmZWCjBNxdvv9HEC5nsW4wDV7wu6WnhWan,1579163691,9505244661,-7926080970,622
2022-03-01 05:36:09-05:00,13483,V34VhGxE5BcLmc9gtpAK6UBD91Pr38z8amqTRXdKkJW,GWhFwG72FzXQzw8h9EfMaP8qADufnSpMHzUzxsFQiwex,True,5327709,1331926,8287,4143,4144,HfEnetJ7uBSmZWCjBNxdvv9HEC5nsW4wDV7wu6WnhWan,331485,2385983,-2054498,622
2022-03-01 05:38:13-05:00,13484,7qxGLMg6ZAxkVjhuj2PY6a5F36k4Efo3aCa99kvTpSKw,wgWcmEebBLbcm9a2jyCiw8nzqbGbfj6zRou4ZZhfWp7,True,44731708,11182927,69958,34979,34979,3zqXX6kzhkbW3d4TwD2CNjMRwxTbREXySekvq37kfCNk,2798320,18144980,-15346660,625
2022-03-01 06:00:17-05:00,13485,JE2PdvSvfaXowRWshpvgcRZ5HTmkRdqejVb2Mckg4kyF,9sLTy5CKpq9evvXqc2ofXDucPDg3FBKN5cQGX673D9wc,True,288,72,0,0,0,3zqXX6kzhkbW3d4TwD2CNjMRwxTbREXySekvq37kfCNk,17,132,-115,590
2022-03-01 07:12:13-05:00,13486,4S7Ky4QBiqRWUFYsCcsSnijMTPsNNcDDSAHNyS9Mvzo2,DsdFdR1MT5pdU196PCYM6a5os3TAiAg6fUweGAugHsb8,True,166886752,41721688,259875,129937,129938,3zqXX6kzhkbW3d4TwD2CNjMRwxTbREXySekvq37kfCNk,10395026,44533728,-34138702,622
2022-03-01 07:13:29-05:00,13487,6fSdeis6nFxh1SZusjL6cReVZLqVPTK4bo33XY1JRLts,91dgzxhnfPYvnQK5GSbqVJ4XKPMxSoqATS78CEhnXNoG,True,59720411,14930102,93120,46560,46560,3zqXX6kzhkbW3d4TwD2CNjMRwxTbREXySekvq37kfCNk,3724800,4572222,-847422,623
2022-03-01 07:13:56-05:00,13488,7X1UBUXhC59kzJKyroP6fe5GVtGCrVMZGKwbSnedkvwJ,5A24drY1wqNsjV6cABFfFx2D5BQ16m6vozbxvyUcXG4C,True,1257406297,314351574,1961610,980805,980805,3zqXX6kzhkbW3d4TwD2CNjMRwxTbREXySekvq37kfCNk,78464401,257095049,-178630648,624
2022-03-01 07:17:18-05:00,13489,DukppMFjzXeiNRuLVC8SVps3SgT3whoea3dTogk3vP3W,4KEBNv3wZsMbmkPmZ1J54uT6raZEJjrzPGDkoGG4nU7Q,True,811941554,202985388,1268797,634398,634399,3zqXX6kzhkbW3d4TwD2CNjMRwxTbREXySekvq37kfCNk,50751903,179975149,-129223246,625
2022-03-01 07:47:43-05:00,13490,7RCDGRGZPnFcUdKEaewrP815tuYDwWDmWytdHK6AaoqA,7WWDb3AVBpkpfpqcGV44LU2QXqsFTQhrJZ7tvae43p5L,True,55354416,13838604,86612,43306,43306,DddJ7EWCmYEEZETCBNgAUSg81Ls6fZtiAaY5ekJ5sXx1,3464507,9008808,-5544301,625
2022-03-01 08:02:40-05:00,13491,4S7Ky4QBiqRWUFYsCcsSnijMTPsNNcDDSAHNyS9Mvzo2,DsdFdR1MT5pdU196PCYM6a5os3TAiAg6fUweGAugHsb8,True,127354130,31838532,198581,99290,99291,DddJ7EWCmYEEZETCBNgAUSg81Ls6fZtiAaY5ekJ5sXx1,7943260,35736604,-27793344,623
2022-03-01 08:03:42-05:00,13492,6fSdeis6nFxh1SZusjL6cReVZLqVPTK4bo33XY1JRLts,91dgzxhnfPYvnQK5GSbqVJ4XKPMxSoqATS78CEhnXNoG,True,45572406,11393101,71214,35607,35607,DddJ7EWCmYEEZETCBNgAUSg81Ls6fZtiAaY5ekJ5sXx1,2848573,4266276,-1417703,625
2022-03-01 08:04:35-05:00,13493,7X1UBUXhC59kzJKyroP6fe5GVtGCrVMZGKwbSnedkvwJ,5A24drY1wqNsjV6cABFfFx2D5BQ16m6vozbxvyUcXG4C,True,959801900,239950475,1493359,746679,746680,DddJ7EWCmYEEZETCBNgAUSg81Ls6fZtiAaY5ekJ5sXx1,59734366,210469905,-150735539,622
2022-03-01 08:50:13-05:00,13494,9pEArHtaXLJT3Byxom7eHPqN33JQReQW7nc9sBM2WM2X,C42NkGyduwu7Rc7m5t53SQ72AkeD7NJMSemZBoc4QAYf,True,12072479353,3018119838,18849064,9424532,9424532,3zqXX6kzhkbW3d4TwD2CNjMRwxTbREXySekvq37kfCNk,753962564,3132996551,-2379033987,624
2022-03-01 08:50:31-05:00,13495,5yPGvUz6JWKjkViGwTCpygJii1rP2xv5yx146ULtBiYq,FMnHUCQWTf1UHu5qVFqUAsWh8aba9EQYTEoiXy55totD,True,1317866028,329466507,2055199,1027599,1027600,HfEnetJ7uBSmZWCjBNxdvv9HEC5nsW4wDV7wu6WnhWan,82207985,231895289,-149687304,623
2022-03-01 08:50:57-05:00,13496,Eec3xvC7d5iuGEXySFtzWekD1e9Ed6hQ2m7ExeJ9fDif,54WbNCyeTCrF5f57b67xRw2gNT42eM6PxG7mU5tPCcXW,True,3523530219,880882554,5500455,2750227,2750228,3zqXX6kzhkbW3d4TwD2CNjMRwxTbREXySekvq37kfCNk,220018226,991857959,-771839733,624
2022-03-01 09:02:27-05:00,13497,88awjJ2gbtVpwNCSwDLUbmtQM5xqGbJBwgEngdgUT8uV,7SE7JbDbRgsUzXUAnTrtCyzSCnEkLyYRuTQYRFqQ4rH9,True,68754476,17188619,106715,53357,53358,HfEnetJ7uBSmZWCjBNxdvv9HEC5nsW4wDV7wu6WnhWan,4268630,16367621,-12098991,620
2022-03-01 09:05:58-05:00,13498,4QJuKV4x6Wo4AsTA2Xsx7MwbjCrSVncnm6dkusWRg48J,EFhoiz3Td7yuFTo3NJBunx3pP4HHuk8yoNxk4gHqYTSt,True,10682,2670,16,8,8,HfEnetJ7uBSmZWCjBNxdvv9HEC5nsW4wDV7wu6WnhWan,668,2539,-1871,625
2022-03-01 09:06:01-05:00,13499,4BHydPKft6s7nYozhJ63rVrkQ22QywsrBQf2BAuW6mDS,8Tz6FZpzjoRBZqEwdPdkr4XGmURu3n1SjV3CTuc3o5yw,True,85130137,21282534,133094,66547,66547,HfEnetJ7uBSmZWCjBNxdvv9HEC5nsW4wDV7wu6WnhWan,5323771,15213386,-9889615,625
2022-03-01 09:06:02-05:00,13500,CLP8qmL8aN9ocJKYnbKSo4k46CU3LBsebspfREQcSGvo,F6tkkFJnvjYyPdSXDNzZMUfhd1o8dFiLyLPRZ5U1sXHE,True,100415119,25103779,157121,78560,78561,HfEnetJ7uBSmZWCjBNxdvv9HEC5nsW4wDV7wu6WnhWan,6284852,22426679,-16141827,625
2022-03-01 09:12:58-05:00,13501,9pEArHtaXLJT3Byxom7eHPqN33JQReQW7nc9sBM2WM2X,C42NkGyduwu7Rc7m5t53SQ72AkeD7NJMSemZBoc4QAYf,True,9226812989,2306703247,14058905,7029452,7029453,3zqXX6kzhkbW3d4TwD2CNjMRwxTbREXySekvq37kfCNk,562356229,2521522845,-1959166616,609
2022-03-01 09:13:07-05:00,13502,Eec3xvC7d5iuGEXySFtzWekD1e9Ed6hQ2m7ExeJ9fDif,54WbNCyeTCrF5f57b67xRw2gNT42eM6PxG7mU5tPCcXW,True,2689028121,672257030,4201219,2100609,2100610,3zqXX6kzhkbW3d4TwD2CNjMRwxTbREXySekvq37kfCNk,168048779,793510778,-625461999,624
2022-03-01 09:16:35-05:00,13503,DVMLxFACqaNBD7q1TGJUUApJX7etJsxQRRFBP2DfBazJ,4hnRjD7S2KxD7UrgfrApntVxUD7Srh5E9nwPY53v89kz,True,147598750,36899687,230657,115328,115329,3zqXX6kzhkbW3d4TwD2CNjMRwxTbREXySekvq37kfCNk,9226317,34842096,-25615779,625
2022-03-01 09:19:31-05:00,13504,5yPGvUz6JWKjkViGwTCpygJii1rP2xv5yx146ULtBiYq,FMnHUCQWTf1UHu5qVFqUAsWh8aba9EQYTEoiXy55totD,True,1005818701,251454674,1567676,783838,783838,3zqXX6kzhkbW3d4TwD2CNjMRwxTbREXySekvq37kfCNk,62707055,192411429,-129704374,623
2022-03-01 22:23:35-05:00,13505,E3YuTc7utKqF3BG5gqHDtTrFuRiKGAe5cVvYQqJBxmzB,6VCK2UbYZzyxMR21sNn4qHNe75QvA4C3HBXpmcTnH37Y,True,8187332606,2046833151,12173494,6086747,6086747,3zqXX6kzhkbW3d4TwD2CNjMRwxTbREXySekvq37kfCNk,486939777,1465004318,-978064541,594
2022-03-01 22:23:37-05:00,13506,3LdzsUHuXx2cNUp12gx2VDku2UkeTdwuXxHFavAakXrz,CbRvRaT7kvFDM1k5SrnxAZvgnEAkvvJoUiukRVg1dXZm,True,117315300,29328825,179083,89541,89542,3zqXX6kzhkbW3d4TwD2CNjMRwxTbREXySekvq37kfCNk,7163346,23582984,-16419638,610
2022-03-01 22:32:45-05:00,13507,BZQYYFyK2GBU3mYi7BJuh1kRDmSvK6iGdHQwy5jitqQo,Hm3UsDcsURA7KPrR7khH8VH4k7H6ULnpxA5HW7s7Hw5R,True,24563090,6140772,38368,19184,19184,HfEnetJ7uBSmZWCjBNxdvv9HEC5nsW4wDV7wu6WnhWan,1534753,5451447,-3916694,624
2022-03-01 22:33:07-05:00,13508,5GGcHTFi7PqKJdfyoc3CGNjxeQjcvuvgYf2c8EaJweuB,Cu7qDjNFpac1hHLQbdJ2iNH8o6q4hcd1R7tsV7MMopJv,True,2600583,650145,4030,2015,2015,DddJ7EWCmYEEZETCBNgAUSg81Ls6fZtiAaY5ekJ5sXx1,161217,464993,-303776,619
2022-03-01 22:33:07-05:00,13509,Fm5iYx8uoYBa7JeUMwAFV4rnjFvydcdJkdYoJ8JdfpdB,8PUy18EgWtdoT1PacmvdCvNpPBFZY1DMCWxdqgB3hSxH,True,960287115,240071778,1487314,743657,743657,HfEnetJ7uBSmZWCjBNxdvv9HEC5nsW4wDV7wu6WnhWan,59492590,170049828,-110557238,619
2022-03-01 22:33:17-05:00,13510,FjjU3VtoUbcgBtU8pxo96JfvXHppbQVGTyz4hJYiC7k4,8VztSSmeE9EfRwmfr22gdqviqdy7W5sATZLkuGWBMxP6,True,116946,29236,181,90,91,HfEnetJ7uBSmZWCjBNxdvv9HEC5nsW4wDV7wu6WnhWan,7269,27780,-20511,621
2022-03-01 22:33:23-05:00,13511,Ldn4w1zXoukjaJegLhsk1L3UBx4jPHwBuaQDo37KN3r,523bwDjqdA4ZqdzEfpEkSoDky94dTRP9VS9AjakFuj5z,True,19659458979,4914864744,30766802,15383401,15383401,3zqXX6kzhkbW3d4TwD2CNjMRwxTbREXySekvq37kfCNk,1230672111,4169068406,-2938396295,625
2022-03-01 22:33:52-05:00,13512,Fs4ni3Mb3hF1dT7W3mW5vwjuavGKc2d3N4BPVXa7Hn3,vHGFetJQKv989wRLozjiHAs297YzNZZPeGiTaH2KepG,True,532524,133131,830,415,415,3zqXX6kzhkbW3d4TwD2CNjMRwxTbREXySekvq37kfCNk,33221,105529,-72308,623
2022-03-01 22:35:20-05:00,13513,3TCKVG1t5DCSXRdVXTN8uMxoDuhQ41WDYrcoKDz8byPL,Cm23o46LQekUd4f756Eq1shLCmZCAzEEdWpRcaMY1WVk,True,269248,67312,420,210,210,HfEnetJ7uBSmZWCjBNxdvv9HEC5nsW4wDV7wu6WnhWan,16809,56866,-40057,624
2022-03-01 22:36:34-05:00,13514,6xeNr9LhAfC6FRV62dALYdgx3bsoUpUpmEBiUPYCV5fz,8GP5cEpfNTEjvqm9usBUXs7jPCK5RciqjVJqtvX9fuGs,True,1960430082,490107520,3059576,1529788,1529788,3zqXX6kzhkbW3d4TwD2CNjMRwxTbREXySekvq37kfCNk,122383067,504932559,-382549492,624
2022-03-01 22:36:40-05:00,13515,EG8G1DMZqXByLNtowrEJr9Rb4HnG89REC6NLsg8bdmep,94AvgT7uB6KfmKitJPYwPa6T9TScSnCQ5ziQG5VT5qSA,True,120787,30196,188,94,94,DddJ7EWCmYEEZETCBNgAUSg81Ls6fZtiAaY5ekJ5sXx1,7552,23291,-15739,625
2022-03-01 22:36:50-05:00,13516,4BHydPKft6s7nYozhJ63rVrkQ22QywsrBQf2BAuW6mDS,8Tz6FZpzjoRBZqEwdPdkr4XGmURu3n1SjV3CTuc3o5yw,True,64988549,16247137,101378,50689,50689,3zqXX6kzhkbW3d4TwD2CNjMRwxTbREXySekvq37kfCNk,4055123,12613328,-8558205,623
2022-03-01 22:36:51-05:00,13517,CLP8qmL8aN9ocJKYnbKSo4k46CU3LBsebspfREQcSGvo,F6tkkFJnvjYyPdSXDNzZMUfhd1o8dFiLyLPRZ5U1sXHE,True,76653436,19163359,119799,59899,59900,3zqXX6kzhkbW3d4TwD2CNjMRwxTbREXySekvq37kfCNk,4791995,18240525,-13448530,625
2022-03-01 22:36:52-05:00,13518,4QJuKV4x6Wo4AsTA2Xsx7MwbjCrSVncnm6dkusWRg48J,EFhoiz3Td7yuFTo3NJBunx3pP4HHuk8yoNxk4gHqYTSt,True,8156,2039,12,6,6,DddJ7EWCmYEEZETCBNgAUSg81Ls6fZtiAaY5ekJ5sXx1,508,2055,-1547,622
2022-03-01 22:38:01-05:00,13519,CrWves8LVM4K1FY6VXQsodgD45vWM5Phbz6bVdcRFHcB,CJU6eRRHDJR2phdR1TmRuiKwcviNEqdCKSsVDkXctt9H,True,632548454,158137113,989461,494730,494731,HfEnetJ7uBSmZWCjBNxdvv9HEC5nsW4wDV7wu6WnhWan,39578459,122480716,-82902257,625
2022-03-01 22:38:01-05:00,13520,E3YuTc7utKqF3BG5gqHDtTrFuRiKGAe5cVvYQqJBxmzB,6VCK2UbYZzyxMR21sNn4qHNe75QvA4C3HBXpmcTnH37Y,True,6226288890,1556572222,9724421,4862210,4862211,3zqXX6kzhkbW3d4TwD2CNjMRwxTbREXySekvq37kfCNk,388976848,1208760578,-819783730,624
2022-03-01 22:38:02-05:00,13521,DVMLxFACqaNBD7q1TGJUUApJX7etJsxQRRFBP2DfBazJ,4hnRjD7S2KxD7UrgfrApntVxUD7Srh5E9nwPY53v89kz,True,112663830,28165957,176005,88002,88003,3zqXX6kzhkbW3d4TwD2CNjMRwxTbREXySekvq37kfCNk,7040231,28216968,-21176737,624
2022-03-01 22:38:37-05:00,13522,3LdzsUHuXx2cNUp12gx2VDku2UkeTdwuXxHFavAakXrz,CbRvRaT7kvFDM1k5SrnxAZvgnEAkvvJoUiukRVg1dXZm,True,89407847,22351961,139072,69536,69536,3zqXX6kzhkbW3d4TwD2CNjMRwxTbREXySekvq37kfCNk,5562891,19299081,-13736190,622
2022-03-01 22:38:45-05:00,13523,V34VhGxE5BcLmc9gtpAK6UBD91Pr38z8amqTRXdKkJW,GWhFwG72FzXQzw8h9EfMaP8qADufnSpMHzUzxsFQiwex,True,4065349,1016336,6361,3180,3181,FRen9v5CgMn6Y5bpz6LomHmA6CMeXehrKKpjQ15cCJPE,254479,1857193,-1602714,625
2022-03-01 22:39:45-05:00,13524,BZQYYFyK2GBU3mYi7BJuh1kRDmSvK6iGdHQwy5jitqQo,Hm3UsDcsURA7KPrR7khH8VH4k7H6ULnpxA5HW7s7Hw5R,True,18746582,4686645,29303,14651,14652,HfEnetJ7uBSmZWCjBNxdvv9HEC5nsW4wDV7wu6WnhWan,1172121,4433909,-3261788,625
2022-03-01 22:42:17-05:00,13525,Fm5iYx8uoYBa7JeUMwAFV4rnjFvydcdJkdYoJ8JdfpdB,8PUy18EgWtdoT1PacmvdCvNpPBFZY1DMCWxdqgB3hSxH,True,732452981,183113245,1144190,572095,572095,3zqXX6kzhkbW3d4TwD2CNjMRwxTbREXySekvq37kfCNk,45767632,140929364,-95161732,624
2022-03-01 22:42:17-05:00,13526,5GGcHTFi7PqKJdfyoc3CGNjxeQjcvuvgYf2c8EaJweuB,Cu7qDjNFpac1hHLQbdJ2iNH8o6q4hcd1R7tsV7MMopJv,True,1983646,495911,3099,1549,1550,DddJ7EWCmYEEZETCBNgAUSg81Ls6fZtiAaY5ekJ5sXx1,123979,385019,-261040,625
2022-03-01 22:43:06-05:00,13527,FjjU3VtoUbcgBtU8pxo96JfvXHppbQVGTyz4hJYiC7k4,8VztSSmeE9EfRwmfr22gdqviqdy7W5sATZLkuGWBMxP6,True,89226,22306,139,69,70,HfEnetJ7uBSmZWCjBNxdvv9HEC5nsW4wDV7wu6WnhWan,5572,22471,-16899,624
2022-03-01 22:47:36-05:00,13528,Fs4ni3Mb3hF1dT7W3mW5vwjuavGKc2d3N4BPVXa7Hn3,vHGFetJQKv989wRLozjiHAs297YzNZZPeGiTaH2KepG,True,406384,101596,635,317,318,HfEnetJ7uBSmZWCjBNxdvv9HEC5nsW4wDV7wu6WnhWan,25400,86622,-61222,625
2022-03-01 22:48:09-05:00,13529,Ldn4w1zXoukjaJegLhsk1L3UBx4jPHwBuaQDo37KN3r,523bwDjqdA4ZqdzEfpEkSoDky94dTRP9VS9AjakFuj5z,True,15061508245,3765377060,23420063,11710031,11710032,3zqXX6kzhkbW3d4TwD2CNjMRwxTbREXySekvq37kfCNk,936802535,3405774127,-2468971592,621
2022-03-01 22:48:13-05:00,13530,3TCKVG1t5DCSXRdVXTN8uMxoDuhQ41WDYrcoKDz8byPL,Cm23o46LQekUd4f756Eq1shLCmZCAzEEdWpRcaMY1WVk,True,205948,51487,309,154,155,HfEnetJ7uBSmZWCjBNxdvv9HEC5nsW4wDV7wu6WnhWan,12377,46431,-34054,600
2022-03-01 22:52:05-05:00,13531,2ix7AR3FgZjmFiXAyrr9Jg63xUxgn8oDp3pcGP3Yfj23,Gm2QCdpM13K99ZMWGijYXM7Ur9sK4n67g4gDCap7r3r5,True,19531,4882,30,15,15,HfEnetJ7uBSmZWCjBNxdvv9HEC5nsW4wDV7wu6WnhWan,1222,3666,-2444,625
2022-03-01 23:05:12-05:00,13532,4YmfEwKwf89Xq8vXAPPXqafTrbbpEMaWZaXGZAvrZXxx,9gxwvv5EuyhAWahjjBvdo18oJPuEj6BcHk2zU13cEFYm,True,39407513,9851878,59852,29926,29926,DddJ7EWCmYEEZETCBNgAUSg81Ls6fZtiAaY5ekJ5sXx1,2394084,6810313,-4416229,607
2022-03-01 23:06:18-05:00,13533,7qxGLMg6ZAxkVjhuj2PY6a5F36k4Efo3aCa99kvTpSKw,wgWcmEebBLbcm9a2jyCiw8nzqbGbfj6zRou4ZZhfWp7,True,34616628,8654156,54024,27012,27012,DddJ7EWCmYEEZETCBNgAUSg81Ls6fZtiAaY5ekJ5sXx1,2160961,14177991,-12017030,624
2022-03-01 23:06:29-05:00,13534,6xeNr9LhAfC6FRV62dALYdgx3bsoUpUpmEBiUPYCV5fz,8GP5cEpfNTEjvqm9usBUXs7jPCK5RciqjVJqtvX9fuGs,True,1496268944,374067236,2334367,1167183,1167184,HfEnetJ7uBSmZWCjBNxdvv9HEC5nsW4wDV7wu6WnhWan,93374692,406256439,-312881747,624
2022-03-01 23:06:37-05:00,13535,EG8G1DMZqXByLNtowrEJr9Rb4HnG89REC6NLsg8bdmep,94AvgT7uB6KfmKitJPYwPa6T9TScSnCQ5ziQG5VT5qSA,True,92187,23046,144,72,72,DddJ7EWCmYEEZETCBNgAUSg81Ls6fZtiAaY5ekJ5sXx1,5768,19168,-13400,625
2022-03-02 05:39:59-05:00,13536,4BHydPKft6s7nYozhJ63rVrkQ22QywsrBQf2BAuW6mDS,8Tz6FZpzjoRBZqEwdPdkr4XGmURu3n1SjV3CTuc3o5yw,True,49605026,12401256,77274,38637,38637,3zqXX6kzhkbW3d4TwD2CNjMRwxTbREXySekvq37kfCNk,3090986,10373281,-7282295,623
2022-03-02 05:39:59-05:00,13537,CLP8qmL8aN9ocJKYnbKSo4k46CU3LBsebspfREQcSGvo,F6tkkFJnvjYyPdSXDNzZMUfhd1o8dFiLyLPRZ5U1sXHE,True,58506737,14626684,91413,45706,45707,3zqXX6kzhkbW3d4TwD2CNjMRwxTbREXySekvq37kfCNk,3656545,14759639,-11103094,624
2022-03-02 05:40:01-05:00,13538,4QJuKV4x6Wo4AsTA2Xsx7MwbjCrSVncnm6dkusWRg48J,EFhoiz3Td7yuFTo3NJBunx3pP4HHuk8yoNxk4gHqYTSt,True,6228,1557,9,4,5,HfEnetJ7uBSmZWCjBNxdvv9HEC5nsW4wDV7wu6WnhWan,385,1656,-1271,618
2022-03-02 05:40:06-05:00,13539,E3YuTc7utKqF3BG5gqHDtTrFuRiKGAe5cVvYQqJBxmzB,6VCK2UbYZzyxMR21sNn4qHNe75QvA4C3HBXpmcTnH37Y,True,4752890047,1188222511,7404023,3702011,3702012,3zqXX6kzhkbW3d4TwD2CNjMRwxTbREXySekvq37kfCNk,296160945,994424644,-698263699,623
2022-03-02 05:40:06-05:00,13540,DVMLxFACqaNBD7q1TGJUUApJX7etJsxQRRFBP2DfBazJ,4hnRjD7S2KxD7UrgfrApntVxUD7Srh5E9nwPY53v89kz,True,86010655,21502663,133823,66911,66912,3zqXX6kzhkbW3d4TwD2CNjMRwxTbREXySekvq37kfCNk,5352926,22748338,-17395412,622
2022-03-02 05:40:07-05:00,13541,CrWves8LVM4K1FY6VXQsodgD45vWM5Phbz6bVdcRFHcB,CJU6eRRHDJR2phdR1TmRuiKwcviNEqdCKSsVDkXctt9H,True,482966955,120741738,751042,375521,375521,3zqXX6kzhkbW3d4TwD2CNjMRwxTbREXySekvq37kfCNk,30041706,100776621,-70734915,622
2022-03-02 05:40:08-05:00,13542,3LdzsUHuXx2cNUp12gx2VDku2UkeTdwuXxHFavAakXrz,CbRvRaT7kvFDM1k5SrnxAZvgnEAkvvJoUiukRVg1dXZm,True,68215631,17053907,106631,53315,53316,3zqXX6kzhkbW3d4TwD2CNjMRwxTbREXySekvq37kfCNk,4265249,15727187,-11461938,625
2022-03-02 05:47:31-05:00,13543,Y22tWk4tECzARPFYM87xgBPZXaNsYMbkpRaRZAZZQDR,GPgSj6yDWD1odK4CAwzQgwqnW9RLJNXHo8tVba8DuEa1,True,402967,100741,629,314,315,3zqXX6kzhkbW3d4TwD2CNjMRwxTbREXySekvq37kfCNk,25170,77384,-52214,624
2022-03-02 05:47:51-05:00,13544,BZQYYFyK2GBU3mYi7BJuh1kRDmSvK6iGdHQwy5jitqQo,Hm3UsDcsURA7KPrR7khH8VH4k7H6ULnpxA5HW7s7Hw5R,True,14311598,3577899,22285,11142,11143,DddJ7EWCmYEEZETCBNgAUSg81Ls6fZtiAaY5ekJ5sXx1,891402,3589406,-2698004,622
2022-03-02 05:48:01-05:00,13545,Fm5iYx8uoYBa7JeUMwAFV4rnjFvydcdJkdYoJ8JdfpdB,8PUy18EgWtdoT1PacmvdCvNpPBFZY1DMCWxdqgB3hSxH,True,559116116,139779029,871416,435708,435708,3zqXX6kzhkbW3d4TwD2CNjMRwxTbREXySekvq37kfCNk,34856657,116007830,-81151173,623
2022-03-02 05:48:03-05:00,13546,5GGcHTFi7PqKJdfyoc3CGNjxeQjcvuvgYf2c8EaJweuB,Cu7qDjNFpac1hHLQbdJ2iNH8o6q4hcd1R7tsV7MMopJv,True,1514368,378592,2356,1178,1178,DddJ7EWCmYEEZETCBNgAUSg81Ls6fZtiAaY5ekJ5sXx1,94272,316685,-222413,622
2022-03-02 05:48:04-05:00,13547,5V5gFVMYSwGYfHFecRoHg8G22Rg4bXfVK2FSRTMhPQty,73raXd5MvixmDvJRnVjRL7yQaHZGFRiC9aBxL9ysiRvy,True,847243627,211810906,1325621,662810,662811,3zqXX6kzhkbW3d4TwD2CNjMRwxTbREXySekvq37kfCNk,53024874,218521294,-165496420,625
2022-03-02 05:48:17-05:00,13548,FjjU3VtoUbcgBtU8pxo96JfvXHppbQVGTyz4hJYiC7k4,8VztSSmeE9EfRwmfr22gdqviqdy7W5sATZLkuGWBMxP6,True,68096,17024,106,53,53,DddJ7EWCmYEEZETCBNgAUSg81Ls6fZtiAaY5ekJ5sXx1,4258,18108,-13850,625
2022-03-02 07:10:44-05:00,13549,88awjJ2gbtVpwNCSwDLUbmtQM5xqGbJBwgEngdgUT8uV,7SE7JbDbRgsUzXUAnTrtCyzSCnEkLyYRuTQYRFqQ4rH9,True,52448802,13112200,82003,41001,41002,3zqXX6kzhkbW3d4TwD2CNjMRwxTbREXySekvq37kfCNk,3280125,13237374,-9957249,625
2022-03-02 10:00:43-05:00,13550,DukppMFjzXeiNRuLVC8SVps3SgT3whoea3dTogk3vP3W,4KEBNv3wZsMbmkPmZ1J54uT6raZEJjrzPGDkoGG4nU7Q,True,620206479,155051619,961584,480792,480792,3zqXX6kzhkbW3d4TwD2CNjMRwxTbREXySekvq37kfCNk,38463384,146637405,-108174021,620
2022-03-02 19:44:30-05:00,13551,G6KNZdFV14LDXQfW6w54nXF3Ay3jWcSZsGonoFWMcRo4,8vP5gsK1yDTo9gXbkdqB1CmeSUJzHvALWVDnLMBvKohh,True,1153675,288418,1771,885,886,DddJ7EWCmYEEZETCBNgAUSg81Ls6fZtiAaY5ekJ5sXx1,70875,438777,-367902,614
2022-03-02 20:18:48-05:00,13552,G6KNZdFV14LDXQfW6w54nXF3Ay3jWcSZsGonoFWMcRo4,8vP5gsK1yDTo9gXbkdqB1CmeSUJzHvALWVDnLMBvKohh,True,879803,219950,1362,681,681,HfEnetJ7uBSmZWCjBNxdvv9HEC5nsW4wDV7wu6WnhWan,54518,344990,-290472,619
2022-03-03 14:26:03-05:00,13553,G6KNZdFV14LDXQfW6w54nXF3Ay3jWcSZsGonoFWMcRo4,8vP5gsK1yDTo9gXbkdqB1CmeSUJzHvALWVDnLMBvKohh,True,670911,167727,1047,523,524,DddJ7EWCmYEEZETCBNgAUSg81Ls6fZtiAaY5ekJ5sXx1,41913,270825,-228912,624
2022-03-04 15:15:45-05:00,13554,BW5oQvMFmCHU93ahEeXfDvaYdvhD2gTojBhgSiVtE1Cc,FNhUANJ8psG8Hg7DBriFnZG4L8PKcrnSGQ6vZL4ynLcv,False,4270879,4270879,266403,13320,253083,HfEnetJ7uBSmZWCjBNxdvv9HEC5nsW4wDV7wu6WnhWan,266403,984061,-717658,623
2022-03-04 19:33:03-05:00,13555,DwoQXrbwHmfnkWvYaHbPjir3WLmq3oSpSrAjnPdDqgtL,Hv6r5uYpyyn8B4PTzrki6mj5hdF64yaa564Zi277tANU,True,4890859519,1222714879,7637754,3818877,3818877,DddJ7EWCmYEEZETCBNgAUSg81Ls6fZtiAaY5ekJ5sXx1,305510178,1121379700,-815869522,624
2022-03-04 19:40:25-05:00,13556,4rT1wS6WUtvVSDazrJVhn26rspWSsm9Y5DN2qCvmiBZw,BAVHTZSqhKmS3afYrGhG5CMXgffDAmfuPXKo48eDVfka,True,140186280,35046570,218931,109465,109466,DddJ7EWCmYEEZETCBNgAUSg81Ls6fZtiAaY5ekJ5sXx1,8757268,19570988,-10813720,624
2022-03-06 14:09:34-05:00,13557,DwoQXrbwHmfnkWvYaHbPjir3WLmq3oSpSrAjnPdDqgtL,Hv6r5uYpyyn8B4PTzrki6mj5hdF64yaa564Zi277tANU,True,3606791695,901697923,5632710,2816355,2816355,HfEnetJ7uBSmZWCjBNxdvv9HEC5nsW4wDV7wu6WnhWan,225308413,898791089,-673482676,624
2022-03-06 14:11:45-05:00,13558,AzmKB7i1dJucc5Ec1mxpoJor662CDFKAAWRstWDtrmaq,Fd2bPyTR54f8fcTkUokCjcgYgReTGR9vN7ymaGXVcMDK,True,1670475246,417618811,2603776,1301888,1301888,HfEnetJ7uBSmZWCjBNxdvv9HEC5nsW4wDV7wu6WnhWan,104151051,401391021,-297239970,623
2022-03-06 14:12:53-05:00,13559,9fQYe5d1WwEkXZxNZ4tCajD1bc4HTqXTc8dtgC68s1Cn,GzTejmot4NaV8pZhvb8Xev8VD4sDNKC5TS1aW8ZhQd6J,True,141824216,35456054,220922,110461,110461,3zqXX6kzhkbW3d4TwD2CNjMRwxTbREXySekvq37kfCNk,8836892,31992386,-23155494,623
2022-03-06 14:43:02-05:00,13560,4rT1wS6WUtvVSDazrJVhn26rspWSsm9Y5DN2qCvmiBZw,BAVHTZSqhKmS3afYrGhG5CMXgffDAmfuPXKo48eDVfka,True,103335903,25833975,160302,80151,80151,3zqXX6kzhkbW3d4TwD2CNjMRwxTbREXySekvq37kfCNk,6412099,16326370,-9914271,620
2022-03-06 14:43:07-05:00,13561,DRVfxdTJpa8HtbkXPuPZjLruLT2CXgnCSSMUUTy6hKCN,GvNqT7eQiooijWjC2crwkCk2EAn6HcbCFhRqXXEUrqHA,True,46305235,11576308,71654,35827,35827,HfEnetJ7uBSmZWCjBNxdvv9HEC5nsW4wDV7wu6WnhWan,2866177,10662209,-7796032,618
2022-03-06 14:43:09-05:00,13562,FbtArBT3XdxP9u4SrPseaHqUBuFsrjQt5UzHfmS29S4H,ENMrsXs6brtRUojEMCiARxFgwqwZinHBEmXWV9EfNf4Y,False,12903871,12903871,806279,40313,765966,HfEnetJ7uBSmZWCjBNxdvv9HEC5nsW4wDV7wu6WnhWan,806279,2915912,-2109633,624
2022-03-06 18:23:47-05:00,13563,DwoQXrbwHmfnkWvYaHbPjir3WLmq3oSpSrAjnPdDqgtL,Hv6r5uYpyyn8B4PTzrki6mj5hdF64yaa564Zi277tANU,True,2651720730,662930182,4138214,2069107,2069107,3zqXX6kzhkbW3d4TwD2CNjMRwxTbREXySekvq37kfCNk,165528562,724140567,-558612005,624
2022-03-06 19:08:11-05:00,13564,AzmKB7i1dJucc5Ec1mxpoJor662CDFKAAWRstWDtrmaq,Fd2bPyTR54f8fcTkUokCjcgYgReTGR9vN7ymaGXVcMDK,True,1227954527,306988631,1904986,952493,952493,3zqXX6kzhkbW3d4TwD2CNjMRwxTbREXySekvq37kfCNk,76199461,324058396,-247858935,620
2022-03-06 19:08:16-05:00,13565,9fQYe5d1WwEkXZxNZ4tCajD1bc4HTqXTc8dtgC68s1Cn,GzTejmot4NaV8pZhvb8Xev8VD4sDNKC5TS1aW8ZhQd6J,True,104274179,26068544,162102,81051,81051,3zqXX6kzhkbW3d4TwD2CNjMRwxTbREXySekvq37kfCNk,6484084,25944881,-19460797,621
2022-03-06 19:09:26-05:00,13566,4rT1wS6WUtvVSDazrJVhn26rspWSsm9Y5DN2qCvmiBZw,BAVHTZSqhKmS3afYrGhG5CMXgffDAmfuPXKo48eDVfka,True,76022557,19005639,118619,59309,59310,HfEnetJ7uBSmZWCjBNxdvv9HEC5nsW4wDV7wu6WnhWan,4744772,13659943,-8915171,624
2022-03-06 19:16:47-05:00,13567,DRVfxdTJpa8HtbkXPuPZjLruLT2CXgnCSSMUUTy6hKCN,GvNqT7eQiooijWjC2crwkCk2EAn6HcbCFhRqXXEUrqHA,True,34071128,8517782,53107,26553,26554,3zqXX6kzhkbW3d4TwD2CNjMRwxTbREXySekvq37kfCNk,2124317,8629161,-6504844,623
2022-03-06 19:24:01-05:00,13568,DaGrneyXBcyfjFxj3xRZaevDKyoZF1btK1xjvcDCk7s,6HvTNyXnu6cR9zJe13Tz3pvfghnztBxyZt4RPep5p8ok,True,38694525,9673631,60346,30173,30173,3zqXX6kzhkbW3d4TwD2CNjMRwxTbREXySekvq37kfCNk,2413870,8705375,-6291505,623
2022-03-06 19:24:01-05:00,13569,FSjUzAuFJJDeBerdVPJbWjTyD47GpJRat2h1eCUD1HPH,GT4MarSodCNayJqgVEYMkJQjRvCYYb7S8WJoSaLC144U,False,15083622,15083622,936006,46800,889206,DddJ7EWCmYEEZETCBNgAUSg81Ls6fZtiAaY5ekJ5sXx1,936006,4573618,-3637612,620
2022-03-06 19:24:02-05:00,13570,DwoQXrbwHmfnkWvYaHbPjir3WLmq3oSpSrAjnPdDqgtL,Hv6r5uYpyyn8B4PTzrki6mj5hdF64yaa564Zi277tANU,True,1949000372,487250093,3036488,1518244,1518244,3zqXX6kzhkbW3d4TwD2CNjMRwxTbREXySekvq37kfCNk,121459552,580279442,-458819890,623
2022-03-06 19:24:07-05:00,13571,FV9CBGGTbppLnBKh79f2LzD1diTiS5g6u89FcpZHZmnK,Fe7mtmCUziFqbbYTvrhAcAq1Ub7YLfTJRtQ1hG7GzJD1,True,25026489,6256622,38618,19309,19309,3zqXX6kzhkbW3d4TwD2CNjMRwxTbREXySekvq37kfCNk,1544755,6523991,-4979236,617
2022-03-06 19:24:09-05:00,13572,AzmKB7i1dJucc5Ec1mxpoJor662CDFKAAWRstWDtrmaq,Fd2bPyTR54f8fcTkUokCjcgYgReTGR9vN7ymaGXVcMDK,True,902532468,225633117,1396526,698263,698263,3zqXX6kzhkbW3d4TwD2CNjMRwxTbREXySekvq37kfCNk,55861047,260203740,-204342693,618
2022-03-06 19:24:14-05:00,13573,4rT1wS6WUtvVSDazrJVhn26rspWSsm9Y5DN2qCvmiBZw,BAVHTZSqhKmS3afYrGhG5CMXgffDAmfuPXKo48eDVfka,True,55879502,13969875,87218,43609,43609,HfEnetJ7uBSmZWCjBNxdvv9HEC5nsW4wDV7wu6WnhWan,3488737,11312586,-7823849,624
2022-03-06 19:24:19-05:00,13574,9fQYe5d1WwEkXZxNZ4tCajD1bc4HTqXTc8dtgC68s1Cn,GzTejmot4NaV8pZhvb8Xev8VD4sDNKC5TS1aW8ZhQd6J,True,76570135,19142533,117162,58581,58581,HfEnetJ7uBSmZWCjBNxdvv9HEC5nsW4wDV7wu6WnhWan,4686482,20917688,-16231206,612
2022-03-06 19:24:31-05:00,13575,DRVfxdTJpa8HtbkXPuPZjLruLT2CXgnCSSMUUTy6hKCN,GvNqT7eQiooijWjC2crwkCk2EAn6HcbCFhRqXXEUrqHA,True,25046068,6261517,39098,19549,19549,HfEnetJ7uBSmZWCjBNxdvv9HEC5nsW4wDV7wu6WnhWan,1563932,6949855,-5385923,624
2022-03-06 22:03:38-05:00,13576,6kMVNqnB85fNoY7qUmhveP3CEB5VD53m7X1UyAkuKQHG,7tzFCnn9VFDWkLekGf3efr53G75cQ6B4jKXAAEgP4JVq,True,150046213,37511553,233849,116924,116925,3zqXX6kzhkbW3d4TwD2CNjMRwxTbREXySekvq37kfCNk,9353989,34287895,-24933906,623
2022-03-06 22:10:35-05:00,13577,B6Wc3euMqUf6QjzCqDtNeAEUM7MvADFaiReEq9VYH2Qg,2pzhsqXYd5u7h4xTN8bMS3GbicVnJ6KY3MQn7spSXroA,True,746402197,186600549,1162190,581095,581095,DddJ7EWCmYEEZETCBNgAUSg81Ls6fZtiAaY5ekJ5sXx1,46487630,168908330,-122420700,622
2022-03-07 14:33:30-05:00,13578,9ancY5Fso8pUktKpRj3qc1YPQA6thy5n4f7uvNnsqMWR,CLUi9rvU9NTi7h4sNwqfr8aqChyGDbVJA1aKvKMWQv2r,True,951510450,237877612,1451249,725624,725625,DddJ7EWCmYEEZETCBNgAUSg81Ls6fZtiAaY5ekJ5sXx1,58049992,216462669,-158412677,610
2022-03-07 14:45:13-05:00,13579,DaGrneyXBcyfjFxj3xRZaevDKyoZF1btK1xjvcDCk7s,6HvTNyXnu6cR9zJe13Tz3pvfghnztBxyZt4RPep5p8ok,True,28471761,7117940,44449,22224,22225,HfEnetJ7uBSmZWCjBNxdvv9HEC5nsW4wDV7wu6WnhWan,1777997,7045774,-5267777,624
2022-03-07 14:47:58-05:00,13580,DwoQXrbwHmfnkWvYaHbPjir3WLmq3oSpSrAjnPdDqgtL,Hv6r5uYpyyn8B4PTzrki6mj5hdF64yaa564Zi277tANU,True,1433893713,358473428,2230896,1115448,1115448,3zqXX6kzhkbW3d4TwD2CNjMRwxTbREXySekvq37kfCNk,89235867,461246727,-372010860,622
2022-03-07 14:48:00-05:00,13581,FV9CBGGTbppLnBKh79f2LzD1diTiS5g6u89FcpZHZmnK,Fe7mtmCUziFqbbYTvrhAcAq1Ub7YLfTJRtQ1hG7GzJD1,True,18430787,4607696,28748,14374,14374,DddJ7EWCmYEEZETCBNgAUSg81Ls6fZtiAaY5ekJ5sXx1,1149953,5223467,-4073514,623
2022-03-07 14:48:05-05:00,13582,AzmKB7i1dJucc5Ec1mxpoJor662CDFKAAWRstWDtrmaq,Fd2bPyTR54f8fcTkUokCjcgYgReTGR9vN7ymaGXVcMDK,True,664585045,166146261,1038329,519164,519165,3zqXX6kzhkbW3d4TwD2CNjMRwxTbREXySekvq37kfCNk,41533192,207112907,-165579715,624
2022-03-07 14:51:20-05:00,13583,9fQYe5d1WwEkXZxNZ4tCajD1bc4HTqXTc8dtgC68s1Cn,GzTejmot4NaV8pZhvb8Xev8VD4sDNKC5TS1aW8ZhQd6J,True,56430274,14107568,87988,43994,43994,3zqXX6kzhkbW3d4TwD2CNjMRwxTbREXySekvq37kfCNk,3519545,16690338,-13170793,623
2022-03-07 14:51:33-05:00,13584,4rT1wS6WUtvVSDazrJVhn26rspWSsm9Y5DN2qCvmiBZw,BAVHTZSqhKmS3afYrGhG5CMXgffDAmfuPXKo48eDVfka,True,41115353,10278838,64224,32112,32112,DddJ7EWCmYEEZETCBNgAUSg81Ls6fZtiAaY5ekJ5sXx1,2568980,9231171,-6662191,624
2022-03-07 14:51:39-05:00,13585,DRVfxdTJpa8HtbkXPuPZjLruLT2CXgnCSSMUUTy6hKCN,GvNqT7eQiooijWjC2crwkCk2EAn6HcbCFhRqXXEUrqHA,True,18372625,4593156,27393,13696,13697,3zqXX6kzhkbW3d4TwD2CNjMRwxTbREXySekvq37kfCNk,1095740,5547115,-4451375,596
2022-03-07 14:51:58-05:00,13586,B6Wc3euMqUf6QjzCqDtNeAEUM7MvADFaiReEq9VYH2Qg,2pzhsqXYd5u7h4xTN8bMS3GbicVnJ6KY3MQn7spSXroA,True,548991314,137247828,852233,426116,426117,3zqXX6kzhkbW3d4TwD2CNjMRwxTbREXySekvq37kfCNk,34089329,136720661,-102631332,620
2022-03-09 01:33:50-05:00,13587,7qxGLMg6ZAxkVjhuj2PY6a5F36k4Efo3aCa99kvTpSKw,wgWcmEebBLbcm9a2jyCiw8nzqbGbfj6zRou4ZZhfWp7,True,25304485,5330890,33124,16562,16562,HfEnetJ7uBSmZWCjBNxdvv9HEC5nsW4wDV7wu6WnhWan,1572323,10873118,-9300795,621
2022-03-09 01:34:21-05:00,13588,JE2PdvSvfaXowRWshpvgcRZ5HTmkRdqejVb2Mckg4kyF,9sLTy5CKpq9evvXqc2ofXDucPDg3FBKN5cQGX673D9wc,False,220,220,12,0,12,DddJ7EWCmYEEZETCBNgAUSg81Ls6fZtiAaY5ekJ5sXx1,12,101,-89,545
2022-03-09 01:41:20-05:00,13589,4YmfEwKwf89Xq8vXAPPXqafTrbbpEMaWZaXGZAvrZXxx,9gxwvv5EuyhAWahjjBvdo18oJPuEj6BcHk2zU13cEFYm,True,29725508,7431377,46261,23130,23131,3zqXX6kzhkbW3d4TwD2CNjMRwxTbREXySekvq37kfCNk,1850445,5332497,-3482052,622
2022-03-09 01:41:20-05:00,13590,8r7PnF6cMDxvrcgPX18p9PzbDfw7QKsLZaHTsHa33USx,DBe2TbGi97LyiMM3CxBmpmM2jNcF9h98HwSHxcRmZ8xM,True,30832498,7708124,47330,23665,23665,DddJ7EWCmYEEZETCBNgAUSg81Ls6fZtiAaY5ekJ5sXx1,1893224,14428222,-12534998,614
2022-03-09 01:43:25-05:00,13591,V34VhGxE5BcLmc9gtpAK6UBD91Pr38z8amqTRXdKkJW,GWhFwG72FzXQzw8h9EfMaP8qADufnSpMHzUzxsFQiwex,False,3064696,3064696,189256,9462,179794,DddJ7EWCmYEEZETCBNgAUSg81Ls6fZtiAaY5ekJ5sXx1,189258,1422826,-1233568,617
2022-03-09 02:17:55-05:00,13592,7qxGLMg6ZAxkVjhuj2PY6a5F36k4Efo3aCa99kvTpSKw,wgWcmEebBLbcm9a2jyCiw8nzqbGbfj6zRou4ZZhfWp7,True,20290263,4072974,25179,12589,12590,3zqXX6kzhkbW3d4TwD2CNjMRwxTbREXySekvq37kfCNk,1254364,8670108,-7415744,618
2022-03-09 02:25:49-05:00,13593,4YmfEwKwf89Xq8vXAPPXqafTrbbpEMaWZaXGZAvrZXxx,9gxwvv5EuyhAWahjjBvdo18oJPuEj6BcHk2zU13cEFYm,True,22680039,5670009,35353,17676,17677,DddJ7EWCmYEEZETCBNgAUSg81Ls6fZtiAaY5ekJ5sXx1,1414130,4411582,-2997452,623
2022-03-09 02:25:49-05:00,13594,8r7PnF6cMDxvrcgPX18p9PzbDfw7QKsLZaHTsHa33USx,DBe2TbGi97LyiMM3CxBmpmM2jNcF9h98HwSHxcRmZ8xM,True,23499146,5874786,36670,18335,18335,3zqXX6kzhkbW3d4TwD2CNjMRwxTbREXySekvq37kfCNk,1466826,11242850,-9776024,624
2022-03-09 06:06:04-05:00,13595,7qxGLMg6ZAxkVjhuj2PY6a5F36k4Efo3aCa99kvTpSKw,wgWcmEebBLbcm9a2jyCiw8nzqbGbfj6zRou4ZZhfWp7,True,16523097,3116822,19464,9732,9732,HfEnetJ7uBSmZWCjBNxdvv9HEC5nsW4wDV7wu6WnhWan,1031909,6938651,-5906742,624
2022-03-09 06:06:48-05:00,13596,4YmfEwKwf89Xq8vXAPPXqafTrbbpEMaWZaXGZAvrZXxx,9gxwvv5EuyhAWahjjBvdo18oJPuEj6BcHk2zU13cEFYm,True,17300136,4325034,27000,13500,13500,HfEnetJ7uBSmZWCjBNxdvv9HEC5nsW4wDV7wu6WnhWan,1080036,3618234,-2538198,624
2022-03-09 06:06:49-05:00,13597,8r7PnF6cMDxvrcgPX18p9PzbDfw7QKsLZaHTsHa33USx,DBe2TbGi97LyiMM3CxBmpmM2jNcF9h98HwSHxcRmZ8xM,True,17925671,4481417,27997,13998,13999,HfEnetJ7uBSmZWCjBNxdvv9HEC5nsW4wDV7wu6WnhWan,1119898,8753229,-7633331,624
2022-03-09 07:32:47-05:00,13598,GNWK9cTrChbcAqTWaonyQ1SKWh1PELcRzATeKra7Cj7m,G5bQaczo8MNq3GHLx9V6UtX6N2EfzQYuEQ64Tm2E8RHK,True,297503335,74375833,464576,232288,232288,DddJ7EWCmYEEZETCBNgAUSg81Ls6fZtiAaY5ekJ5sXx1,18583077,108904313,-90321236,624
2022-03-09 10:25:11-05:00,13599,7qxGLMg6ZAxkVjhuj2PY6a5F36k4Efo3aCa99kvTpSKw,wgWcmEebBLbcm9a2jyCiw8nzqbGbfj6zRou4ZZhfWp7,False,13512643,13512643,840928,42046,798882,DddJ7EWCmYEEZETCBNgAUSg81Ls6fZtiAaY5ekJ5sXx1,840929,5578323,-4737394,622
2022-03-09 10:26:37-05:00,13600,4YmfEwKwf89Xq8vXAPPXqafTrbbpEMaWZaXGZAvrZXxx,9gxwvv5EuyhAWahjjBvdo18oJPuEj6BcHk2zU13cEFYm,False,13210823,13210823,812553,40627,771926,HfEnetJ7uBSmZWCjBNxdvv9HEC5nsW4wDV7wu6WnhWan,812553,2951924,-2139371,615
2022-03-09 10:26:37-05:00,13601,8r7PnF6cMDxvrcgPX18p9PzbDfw7QKsLZaHTsHa33USx,DBe2TbGi97LyiMM3CxBmpmM2jNcF9h98HwSHxcRmZ8xM,False,13688773,13688773,842448,42122,800326,DddJ7EWCmYEEZETCBNgAUSg81Ls6fZtiAaY5ekJ5sXx1,842448,6811966,-5969518,615
2022-03-09 10:27:25-05:00,13602,GNWK9cTrChbcAqTWaonyQ1SKWh1PELcRzATeKra7Cj7m,G5bQaczo8MNq3GHLx9V6UtX6N2EfzQYuEQ64Tm2E8RHK,True,227011213,56752803,354513,177256,177257,HfEnetJ7uBSmZWCjBNxdvv9HEC5nsW4wDV7wu6WnhWan,14180545,85805572,-71625027,624
2022-03-09 11:33:18-05:00,13603,GNWK9cTrChbcAqTWaonyQ1SKWh1PELcRzATeKra7Cj7m,G5bQaczo8MNq3GHLx9V6UtX6N2EfzQYuEQ64Tm2E8RHK,True,173277344,43319336,269797,134898,134899,3zqXX6kzhkbW3d4TwD2CNjMRwxTbREXySekvq37kfCNk,10791888,67529812,-56737924,622
2022-03-13 08:31:24-04:00,13604,Ht5tqGiAf5tF8nRVDnpdvj7B9vNot6ijzykEDtQypxYC,2C7i83GfaXauAsZH3WMFofJdzNCpxeaQvVJ72iQb4fQM,True,431011829,107752957,672937,336468,336469,3zqXX6kzhkbW3d4TwD2CNjMRwxTbREXySekvq37kfCNk,26917490,95792849,-68875359,624
2022-03-13 08:35:37-04:00,13605,6kMVNqnB85fNoY7qUmhveP3CEB5VD53m7X1UyAkuKQHG,7tzFCnn9VFDWkLekGf3efr53G75cQ6B4jKXAAEgP4JVq,True,110879561,27719890,172833,86416,86417,DddJ7EWCmYEEZETCBNgAUSg81Ls6fZtiAaY5ekJ5sXx1,6913355,27269148,-20355793,623
2022-03-13 16:10:40-04:00,13606,DaGrneyXBcyfjFxj3xRZaevDKyoZF1btK1xjvcDCk7s,6HvTNyXnu6cR9zJe13Tz3pvfghnztBxyZt4RPep5p8ok,True,20948254,5237063,31284,15642,15642,DddJ7EWCmYEEZETCBNgAUSg81Ls6fZtiAaY5ekJ5sXx1,1251394,5607803,-4356409,597
2022-03-13 16:10:42-04:00,13607,AzmKB7i1dJucc5Ec1mxpoJor662CDFKAAWRstWDtrmaq,Fd2bPyTR54f8fcTkUokCjcgYgReTGR9vN7ymaGXVcMDK,True,489621200,122405300,747172,373586,373586,DddJ7EWCmYEEZETCBNgAUSg81Ls6fZtiAaY5ekJ5sXx1,29886913,162893959,-133007046,610
2022-03-13 16:10:43-04:00,13608,DwoQXrbwHmfnkWvYaHbPjir3WLmq3oSpSrAjnPdDqgtL,Hv6r5uYpyyn8B4PTzrki6mj5hdF64yaa564Zi277tANU,True,1055855176,263963794,1589471,794735,794736,3zqXX6kzhkbW3d4TwD2CNjMRwxTbREXySekvq37kfCNk,63578842,362174035,-298595193,602
2022-03-13 16:10:44-04:00,13609,9fQYe5d1WwEkXZxNZ4tCajD1bc4HTqXTc8dtgC68s1Cn,GzTejmot4NaV8pZhvb8Xev8VD4sDNKC5TS1aW8ZhQd6J,True,41617531,10404382,64355,32177,32178,DddJ7EWCmYEEZETCBNgAUSg81Ls6fZtiAaY5ekJ5sXx1,2574200,13157504,-10583304,618
2022-03-13 16:10:44-04:00,13610,FV9CBGGTbppLnBKh79f2LzD1diTiS5g6u89FcpZHZmnK,Fe7mtmCUziFqbbYTvrhAcAq1Ub7YLfTJRtQ1hG7GzJD1,False,13572464,13572464,820948,41047,779901,DddJ7EWCmYEEZETCBNgAUSg81Ls6fZtiAaY5ekJ5sXx1,820948,4126715,-3305767,604
2022-03-13 16:10:45-04:00,13611,BhhVhLVZkSd3aHDMd6ojTgtJtbgAdMCA9Xj8jL2GMXoL,G8HUQp2yGSw9T6it5ej91cqkd82naca8heji453g2jEH,True,4436659930,1109164982,6890688,3445344,3445344,3zqXX6kzhkbW3d4TwD2CNjMRwxTbREXySekvq37kfCNk,275627543,962239573,-686612030,621
2022-03-13 16:10:49-04:00,13612,4rT1wS6WUtvVSDazrJVhn26rspWSsm9Y5DN2qCvmiBZw,BAVHTZSqhKmS3afYrGhG5CMXgffDAmfuPXKo48eDVfka,True,30326436,7581609,47091,23545,23546,HfEnetJ7uBSmZWCjBNxdvv9HEC5nsW4wDV7wu6WnhWan,1883646,7390386,-5506740,621
2022-03-13 16:10:51-04:00,13613,DRVfxdTJpa8HtbkXPuPZjLruLT2CXgnCSSMUUTy6hKCN,GvNqT7eQiooijWjC2crwkCk2EAn6HcbCFhRqXXEUrqHA,False,13600951,13600951,840013,42000,798013,3zqXX6kzhkbW3d4TwD2CNjMRwxTbREXySekvq37kfCNk,840013,4357066,-3517053,617
2022-03-13 16:10:54-04:00,13614,6Voi3FJ96g3v6FqWWoa46Ct7qbbFAfMSdujpvZCyQvf1,AugWTJjZdpcpo9UCEVGtqprswAgKVSCtvKuV1roHS3QG,True,3264558405,816139601,5078134,2539067,2539067,HfEnetJ7uBSmZWCjBNxdvv9HEC5nsW4wDV7wu6WnhWan,203125399,708176722,-505051323,622
2022-03-13 18:16:26-04:00,13615,3WcJUt8jQ1ngL3ZCGo6dFrc3GmTMTYtzeDva7mri2Tqx,HeG1Pz2oMjqtkfsRMsbqP3VpatnVEQzcWmKDVoFp4Htr,True,404617932,101154483,631889,315944,315945,3zqXX6kzhkbW3d4TwD2CNjMRwxTbREXySekvq37kfCNk,25275580,90197988,-64922408,624
2022-03-13 18:49:25-04:00,13616,6eEifGxGRBnXV5EW2BwmCj8pa67znMjet98Nsq11LCsd,Dd4UCEX7tm6Q82SdSSFX9wBcJNw5TwKu8EyGjvxi9FVc,True,357482505,89370626,553263,276631,276632,3zqXX6kzhkbW3d4TwD2CNjMRwxTbREXySekvq37kfCNk,22130557,79617838,-57487281,619
2022-03-13 18:50:00-04:00,13617,B6Wc3euMqUf6QjzCqDtNeAEUM7MvADFaiReEq9VYH2Qg,2pzhsqXYd5u7h4xTN8bMS3GbicVnJ6KY3MQn7spSXroA,True,405170211,101292552,628593,314296,314297,DddJ7EWCmYEEZETCBNgAUSg81Ls6fZtiAaY5ekJ5sXx1,25143758,108693581,-83549823,620
2022-03-13 18:50:09-04:00,13618,kEstb9msKrdEaMjoEad819rcrobFGdiknwKxTi1Dw6y,5fgoHmS5JvLHxKc2rqTy9efcwGT92rgEs1eB12DtXvVf,True,141220964,35305241,218376,109188,109188,3zqXX6kzhkbW3d4TwD2CNjMRwxTbREXySekvq37kfCNk,8735076,20441626,-11706550,618
2022-03-13 18:50:25-04:00,13619,AwT3pH9dHjECDnuUiazbD6tZxZHdNwgJ4vBMmxLHMiLo,AjybksvjMT1QT6KvryXCG47pQGT8v9jxM34VkveGPQrs,True,105413276,26353319,163718,81859,81859,DddJ7EWCmYEEZETCBNgAUSg81Ls6fZtiAaY5ekJ5sXx1,6548724,18622214,-12073490,621
2022-03-13 18:50:53-04:00,13620,DaGrneyXBcyfjFxj3xRZaevDKyoZF1btK1xjvcDCk7s,6HvTNyXnu6cR9zJe13Tz3pvfghnztBxyZt4RPep5p8ok,False,15448109,15448109,956080,47804,908276,DddJ7EWCmYEEZETCBNgAUSg81Ls6fZtiAaY5ekJ5sXx1,956080,4486474,-3530394,618
2022-03-13 18:50:54-04:00,13621,Ht5tqGiAf5tF8nRVDnpdvj7B9vNot6ijzykEDtQypxYC,2C7i83GfaXauAsZH3WMFofJdzNCpxeaQvVJ72iQb4fQM,True,316899823,79224955,494356,247178,247178,3zqXX6kzhkbW3d4TwD2CNjMRwxTbREXySekvq37kfCNk,19774271,77792022,-58017751,623
2022-03-13 18:51:24-04:00,13622,6kMVNqnB85fNoY7qUmhveP3CEB5VD53m7X1UyAkuKQHG,7tzFCnn9VFDWkLekGf3efr53G75cQ6B4jKXAAEgP4JVq,True,81509839,20377459,126550,63275,63275,3zqXX6kzhkbW3d4TwD2CNjMRwxTbREXySekvq37kfCNk,5062033,21978858,-16916825,621
2022-03-13 18:51:26-04:00,13623,EDSf2w1UyGvbgMuxyoXL58ifR1dviZinnLBYnFmgjcNG,DFenkzbL9SUjs9cSCaHJ1eXK75mHfk3GSPRFs8TSzrFV,False,534983,534983,33348,1667,31681,3zqXX6kzhkbW3d4TwD2CNjMRwxTbREXySekvq37kfCNk,33348,343448,-310100,623
2022-03-13 18:52:14-04:00,13624,AzmKB7i1dJucc5Ec1mxpoJor662CDFKAAWRstWDtrmaq,Fd2bPyTR54f8fcTkUokCjcgYgReTGR9vN7ymaGXVcMDK,True,360494866,90123716,559913,279956,279957,3zqXX6kzhkbW3d4TwD2CNjMRwxTbREXySekvq37kfCNk,22396546,128875472,-106478926,621
2022-03-13 18:52:20-04:00,13625,BhhVhLVZkSd3aHDMd6ojTgtJtbgAdMCA9Xj8jL2GMXoL,G8HUQp2yGSw9T6it5ej91cqkd82naca8heji453g2jEH,True,3256815384,814203846,4946408,2473204,2473204,DddJ7EWCmYEEZETCBNgAUSg81Ls6fZtiAaY5ekJ5sXx1,197856328,783689320,-585832992,607
2022-03-13 18:52:20-04:00,13626,4rT1wS6WUtvVSDazrJVhn26rspWSsm9Y5DN2qCvmiBZw,BAVHTZSqhKmS3afYrGhG5CMXgffDAmfuPXKo48eDVfka,True,22274380,5568595,34118,17059,17059,DddJ7EWCmYEEZETCBNgAUSg81Ls6fZtiAaY5ekJ5sXx1,1364734,5965246,-4600512,612
2022-03-13 18:52:20-04:00,13627,9fQYe5d1WwEkXZxNZ4tCajD1bc4HTqXTc8dtgC68s1Cn,GzTejmot4NaV8pZhvb8Xev8VD4sDNKC5TS1aW8ZhQd6J,True,30529691,7632422,45612,22806,22806,DddJ7EWCmYEEZETCBNgAUSg81Ls6fZtiAaY5ekJ5sXx1,1824504,10445459,-8620955,597
2022-03-13 18:57:43-04:00,13628,3WcJUt8jQ1ngL3ZCGo6dFrc3GmTMTYtzeDva7mri2Tqx,HeG1Pz2oMjqtkfsRMsbqP3VpatnVEQzcWmKDVoFp4Htr,True,297402734,74350683,464574,232287,232287,HfEnetJ7uBSmZWCjBNxdvv9HEC5nsW4wDV7wu6WnhWan,18582976,73337432,-54754456,624
2022-03-13 20:13:48-04:00,13629,Ht5tqGiAf5tF8nRVDnpdvj7B9vNot6ijzykEDtQypxYC,2C7i83GfaXauAsZH3WMFofJdzNCpxeaQvVJ72iQb4fQM,True,232954055,58238513,363407,181703,181704,3zqXX6kzhkbW3d4TwD2CNjMRwxTbREXySekvq37kfCNk,14536293,62771635,-48235342,623
2022-03-14 08:54:06-04:00,13630,6kMVNqnB85fNoY7qUmhveP3CEB5VD53m7X1UyAkuKQHG,7tzFCnn9VFDWkLekGf3efr53G75cQ6B4jKXAAEgP4JVq,True,59928117,14982029,92707,46353,46354,HfEnetJ7uBSmZWCjBNxdvv9HEC5nsW4wDV7wu6WnhWan,3708316,17600281,-13891965,618
2022-03-14 13:24:26-04:00,13631,3WcJUt8jQ1ngL3ZCGo6dFrc3GmTMTYtzeDva7mri2Tqx,HeG1Pz2oMjqtkfsRMsbqP3VpatnVEQzcWmKDVoFp4Htr,True,218268233,54567058,329857,164928,164929,3zqXX6kzhkbW3d4TwD2CNjMRwxTbREXySekvq37kfCNk,13194283,59045021,-45850738,604
2022-03-14 14:26:28-04:00,13632,8xQ3tsWVUe75EG1HmocULJ3kh52utveoFMEPotTGrKno,i3SKW3ywrwYucX9ySEx1C4zaUKGnzLerP3V38437NyV,False,66864,66864,4160,208,3952,3zqXX6kzhkbW3d4TwD2CNjMRwxTbREXySekvq37kfCNk,4161,82725,-78564,622
2022-03-14 14:26:31-04:00,13633,Ht5tqGiAf5tF8nRVDnpdvj7B9vNot6ijzykEDtQypxYC,2C7i83GfaXauAsZH3WMFofJdzNCpxeaQvVJ72iQb4fQM,True,171354375,42838593,267719,133859,133860,3zqXX6kzhkbW3d4TwD2CNjMRwxTbREXySekvq37kfCNk,10708771,50247122,-39538351,624
2022-03-14 14:27:43-04:00,13634,3kJcvfwmKERJ7A3rMT3R5vpJyqpfGY1614WuqGrbbLiL,8fwfbJLzaDfc4GJ4YbnkWPHKA5sHNc3SAUr5bkprsJKt,True,847446813,211861703,1323054,661527,661527,HfEnetJ7uBSmZWCjBNxdvv9HEC5nsW4wDV7wu6WnhWan,52922199,194630530,-141708331,624
2022-03-14 14:30:20-04:00,13635,6kMVNqnB85fNoY7qUmhveP3CEB5VD53m7X1UyAkuKQHG,7tzFCnn9VFDWkLekGf3efr53G75cQ6B4jKXAAEgP4JVq,True,44078393,11019598,68354,34177,34177,3zqXX6kzhkbW3d4TwD2CNjMRwxTbREXySekvq37kfCNk,2734162,14020877,-11286715,620
2022-03-15 22:09:29-04:00,13636,HDmtdNjr3UNmzXfmajyKASLz9wz4YzNrspTMABcr7tXV,bsQ5Ae5oD7dbNjnz49unSovEp4eDGiB2bfdihVZkAtE,True,93401475,23350368,145590,72795,72795,3zqXX6kzhkbW3d4TwD2CNjMRwxTbREXySekvq37kfCNk,5823620,9225166,-3401546,623
2022-03-15 22:15:16-04:00,13637,BdkmXzBSkSfgLhv8XZLzmYaBBt9tecyvw9WFJx8wPNyF,A871ZXJaC6iMKBduSdk77od9HCoQQHnQuU6FBpwYvJq3,True,54600693556,9356797489,58401073,29200536,29200537,3zqXX6kzhkbW3d4TwD2CNjMRwxTbREXySekvq37kfCNk,3407938620,5905551614,-2497612994,624
2022-03-16 15:19:50-04:00,13638,BGXRhvHe5qrmQxVrpTCs7i62JsJux15Qwzg9qBCLRabB,7HBUeLofeArctvYw6QYhmQd7muSUPi9MTVU1yfRC9cwu,True,549130670,137282667,856732,428366,428366,3zqXX6kzhkbW3d4TwD2CNjMRwxTbREXySekvq37kfCNk,34269284,53533093,-19263809,624
2022-03-16 16:10:59-04:00,13639,BN4r1CTMsR8mFGW9PvUdgAGFBdsxGwbYhZhPfwG9qQBG,5xm8CgZbmFHuXQi9gj441RSLssNhh1vPWBwiUykpobW1,True,11151306164,2787826541,17330673,8665336,8665337,3zqXX6kzhkbW3d4TwD2CNjMRwxTbREXySekvq37kfCNk,693226941,992839068,-299612127,621
2022-03-16 16:31:53-04:00,13640,BGXRhvHe5qrmQxVrpTCs7i62JsJux15Qwzg9qBCLRabB,7HBUeLofeArctvYw6QYhmQd7muSUPi9MTVU1yfRC9cwu,True,419275651,104818912,649589,324794,324795,3zqXX6kzhkbW3d4TwD2CNjMRwxTbREXySekvq37kfCNk,25983586,47861976,-21878390,619
2022-03-16 21:37:43-04:00,13641,BGXRhvHe5qrmQxVrpTCs7i62JsJux15Qwzg9qBCLRabB,7HBUeLofeArctvYw6QYhmQd7muSUPi9MTVU1yfRC9cwu,True,319907678,79976919,496959,248479,248480,3zqXX6kzhkbW3d4TwD2CNjMRwxTbREXySekvq37kfCNk,19878382,41739751,-21861369,621
2022-03-16 21:48:20-04:00,13642,9xYKpeaw3zRCtq29pioMFBTSDKKr39juHgaosmX9NGi1,2UCFhiEzYUbobNC56ffxFnx7MFVTtY1ABtfBqZgjN2Gg,True,27018981,6754745,41926,20963,20963,DddJ7EWCmYEEZETCBNgAUSg81Ls6fZtiAaY5ekJ5sXx1,1677079,3060562,-1383483,620
2022-03-16 23:04:48-04:00,13643,BGXRhvHe5qrmQxVrpTCs7i62JsJux15Qwzg9qBCLRabB,7HBUeLofeArctvYw6QYhmQd7muSUPi9MTVU1yfRC9cwu,True,244048524,61012131,381281,190640,190641,3zqXX6kzhkbW3d4TwD2CNjMRwxTbREXySekvq37kfCNk,15251254,35765975,-20514721,624
2022-03-17 07:16:04-04:00,13644,BGXRhvHe5qrmQxVrpTCs7i62JsJux15Qwzg9qBCLRabB,7HBUeLofeArctvYw6QYhmQd7muSUPi9MTVU1yfRC9cwu,True,186232912,46558228,290837,145418,145419,3zqXX6kzhkbW3d4TwD2CNjMRwxTbREXySekvq37kfCNk,11633497,30216583,-18583086,624
2022-03-17 07:20:24-04:00,13645,BGXRhvHe5qrmQxVrpTCs7i62JsJux15Qwzg9qBCLRabB,7HBUeLofeArctvYw6QYhmQd7muSUPi9MTVU1yfRC9cwu,True,142143305,35535826,221850,110925,110925,3zqXX6kzhkbW3d4TwD2CNjMRwxTbREXySekvq37kfCNk,8874039,25280273,-16406234,624
2022-03-17 08:50:01-04:00,13646,BGXRhvHe5qrmQxVrpTCs7i62JsJux15Qwzg9qBCLRabB,7HBUeLofeArctvYw6QYhmQd7muSUPi9MTVU1yfRC9cwu,True,108483115,27120778,169378,84689,84689,3zqXX6kzhkbW3d4TwD2CNjMRwxTbREXySekvq37kfCNk,6775136,20955617,-14180481,624
2022-03-17 09:00:18-04:00,13647,6Rk6wVu6pCDFwEWDbiY8wS93nDghyHP9kzdUEa6eFRRq,B5v7eFjSX6dDt1kt84Uvtqmrn7STbQPMbFMvjH6WGXJg,True,1610175634,402543908,2507197,1253598,1253599,3zqXX6kzhkbW3d4TwD2CNjMRwxTbREXySekvq37kfCNk,100287914,164931908,-64643994,622
2022-03-17 10:04:29-04:00,13648,7XwpsC8WZcJX3xStrAzvcgzG38xqjj7hvCBVbADyVzh4,6bQ752FahPEFGZEku6URJbhaRxNdN6njqEepCF5itE2A,True,415655235,103913808,647815,323907,323908,3zqXX6kzhkbW3d4TwD2CNjMRwxTbREXySekvq37kfCNk,25912604,41567776,-15655172,623
2022-03-17 10:11:07-04:00,13649,9xYKpeaw3zRCtq29pioMFBTSDKKr39juHgaosmX9NGi1,2UCFhiEzYUbobNC56ffxFnx7MFVTtY1ABtfBqZgjN2Gg,True,20612724,5153181,32161,16080,16081,3zqXX6kzhkbW3d4TwD2CNjMRwxTbREXySekvq37kfCNk,1286446,2672552,-1386106,624
2022-03-17 20:59:10-04:00,13650,9U25LWBU67c9S6L9F4qmjpTkaHqjFgxyuTCqQ7Zqj62g,ESyDCGZWamnabH3NNvus52X6Z9YAmt3y8oB8zYLmhfX3,True,2159331084,539832771,3335572,1667786,1667786,3zqXX6kzhkbW3d4TwD2CNjMRwxTbREXySekvq37kfCNk,133422882,210151269,-76728387,617
2022-03-17 23:40:11-04:00,13651,HqbjKHcGHGWkmHL6dymsWKammiGJvZMZ1YxAbbJ3D2M9,8K4C92rfgEBkx4eHMr83UBEfbssW5EZsuZobi82mxFk6,True,2025319213,506329803,3144126,1572063,1572063,3zqXX6kzhkbW3d4TwD2CNjMRwxTbREXySekvq37kfCNk,125765047,208105465,-82340418,620
2022-03-18 03:51:01-04:00,13652,CZ1snuuBhno2SqfAmMLzEEQhrsH2reAmZrGhFVsydvHD,F4Hj3jxxE8W8TbgpvjRLnrQ1Jdd28ZKTPNyu1h9BnLiH,True,44203850245,5921531765,36976961,18488480,18488481,3zqXX6kzhkbW3d4TwD2CNjMRwxTbREXySekvq37kfCNk,2760306201,4983176730,-2222870529,624
2022-03-18 05:21:56-04:00,13653,CZ1snuuBhno2SqfAmMLzEEQhrsH2reAmZrGhFVsydvHD,F4Hj3jxxE8W8TbgpvjRLnrQ1Jdd28ZKTPNyu1h9BnLiH,True,37926633703,5127734218,32009599,16004799,16004800,3zqXX6kzhkbW3d4TwD2CNjMRwxTbREXySekvq37kfCNk,2367549290,4622120747,-2254571457,624
2022-03-18 07:08:11-04:00,13654,9U25LWBU67c9S6L9F4qmjpTkaHqjFgxyuTCqQ7Zqj62g,ESyDCGZWamnabH3NNvus52X6Z9YAmt3y8oB8zYLmhfX3,True,1588796586,397199146,2480476,1240238,1240238,3zqXX6kzhkbW3d4TwD2CNjMRwxTbREXySekvq37kfCNk,99219067,187506749,-88287682,624
2022-03-18 12:02:01-04:00,13655,BGXRhvHe5qrmQxVrpTCs7i62JsJux15Qwzg9qBCLRabB,7HBUeLofeArctvYw6QYhmQd7muSUPi9MTVU1yfRC9cwu,True,92468485,23117121,143218,71609,71609,3zqXX6kzhkbW3d4TwD2CNjMRwxTbREXySekvq37kfCNk,5728735,17260691,-11531956,619
2022-03-18 12:04:03-04:00,13656,BGXRhvHe5qrmQxVrpTCs7i62JsJux15Qwzg9qBCLRabB,7HBUeLofeArctvYw6QYhmQd7muSUPi9MTVU1yfRC9cwu,True,70552970,17638242,109597,54798,54799,3zqXX6kzhkbW3d4TwD2CNjMRwxTbREXySekvq37kfCNk,4383911,14234554,-9850643,621
2022-03-18 12:34:35-04:00,13657,BGXRhvHe5qrmQxVrpTCs7i62JsJux15Qwzg9qBCLRabB,7HBUeLofeArctvYw6QYhmQd7muSUPi9MTVU1yfRC9cwu,True,53840961,13460240,83702,41851,41851,3zqXX6kzhkbW3d4TwD2CNjMRwxTbREXySekvq37kfCNk,3348081,11662336,-8314255,621
2022-03-18 14:04:56-04:00,13658,HDmtdNjr3UNmzXfmajyKASLz9wz4YzNrspTMABcr7tXV,bsQ5Ae5oD7dbNjnz49unSovEp4eDGiB2bfdihVZkAtE,True,71343231,17835807,111388,55694,55694,3zqXX6kzhkbW3d4TwD2CNjMRwxTbREXySekvq37kfCNk,4455553,8298935,-3843382,624
2022-03-18 15:53:08-04:00,13659,BGXRhvHe5qrmQxVrpTCs7i62JsJux15Qwzg9qBCLRabB,7HBUeLofeArctvYw6QYhmQd7muSUPi9MTVU1yfRC9cwu,True,41081612,10270403,64044,32022,32022,3zqXX6kzhkbW3d4TwD2CNjMRwxTbREXySekvq37kfCNk,2561761,9498365,-6936604,623
2022-03-18 20:15:44-04:00,13660,BGXRhvHe5qrmQxVrpTCs7i62JsJux15Qwzg9qBCLRabB,7HBUeLofeArctvYw6QYhmQd7muSUPi9MTVU1yfRC9cwu,True,31356576,7839144,48723,24361,24362,3zqXX6kzhkbW3d4TwD2CNjMRwxTbREXySekvq37kfCNk,1948927,7696759,-5747832,621
2022-03-18 20:50:46-04:00,13661,9xYKpeaw3zRCtq29pioMFBTSDKKr39juHgaosmX9NGi1,2UCFhiEzYUbobNC56ffxFnx7MFVTtY1ABtfBqZgjN2Gg,False,15736507,15736507,978350,48917,929433,YQC4EUcgeBi9431viwvzvBbZJW3szeHX4dFmowRDyDw,978350,2294896,-1316546,621
2022-03-18 20:50:55-04:00,13662,5sjdX9FCc1LmNLr16UpLitNE8DKPH6QberKxDKMPVe57,6GhL5uRa6ZY2xNNZA91RTbw7EqrKNgfTBkn3KUwfNXHn,True,28277781,7069445,44178,22089,22089,YQC4EUcgeBi9431viwvzvBbZJW3szeHX4dFmowRDyDw,1767135,5004910,-3237775,624
2022-03-19 09:00:47-04:00,13663,BGXRhvHe5qrmQxVrpTCs7i62JsJux15Qwzg9qBCLRabB,7HBUeLofeArctvYw6QYhmQd7muSUPi9MTVU1yfRC9cwu,True,23919782,5979945,37275,18637,18638,3zqXX6kzhkbW3d4TwD2CNjMRwxTbREXySekvq37kfCNk,1491020,6204250,-4713230,623
2022-03-19 10:38:48-04:00,13664,A11mzoTX3dyc9gACVJkbRGZ6QACJsrF3ZHJUsGEtRnsj,H7z8CfHxnxo3mPrvxfiLLNwrDX1cxGWWDUxXs9EpzSi,True,510495910,127623977,787314,393657,393657,3zqXX6kzhkbW3d4TwD2CNjMRwxTbREXySekvq37kfCNk,31492580,3036490,28456090,616
2022-03-19 10:38:48-04:00,13665,76MxXg67Q8CrmgUHJUQufvLmURy6k2DwpPfzVA8ar8AC,WHd5ddz9UZgSX66YkBPPnJFdqkaJqJ4KPLghCRCE1eP,True,462244958,115561239,712488,356244,356244,YQC4EUcgeBi9431viwvzvBbZJW3szeHX4dFmowRDyDw,28499551,1790509,26709042,616
2022-03-19 10:51:11-04:00,13666,79jusNA3eftYUdbg8bv2bjHMh9iXmnFNAzuMVF34hCig,9pusYzDbrN5Jz1bNu8i7orUhYV428Lo2jCqKa8wjrkH2,True,187996777177,46999194294,293505791,146752895,146752896,YQC4EUcgeBi9431viwvzvBbZJW3szeHX4dFmowRDyDw,11740231649,18808636232,-7068404583,624
2022-03-19 11:40:29-04:00,13667,5sjdX9FCc1LmNLr16UpLitNE8DKPH6QberKxDKMPVe57,6GhL5uRa6ZY2xNNZA91RTbw7EqrKNgfTBkn3KUwfNXHn,True,21592325,5398081,33399,16699,16700,DddJ7EWCmYEEZETCBNgAUSg81Ls6fZtiAaY5ekJ5sXx1,1335997,4148323,-2812326,618
2022-03-19 11:58:04-04:00,13668,76MxXg67Q8CrmgUHJUQufvLmURy6k2DwpPfzVA8ar8AC,WHd5ddz9UZgSX66YkBPPnJFdqkaJqJ4KPLghCRCE1eP,True,352447618,88111904,550397,275198,275199,3zqXX6kzhkbW3d4TwD2CNjMRwxTbREXySekvq37kfCNk,22015896,7749807,14266089,624
2022-03-19 11:58:04-04:00,13669,A11mzoTX3dyc9gACVJkbRGZ6QACJsrF3ZHJUsGEtRnsj,H7z8CfHxnxo3mPrvxfiLLNwrDX1cxGWWDUxXs9EpzSi,True,389257824,97314456,607783,303891,303892,3zqXX6kzhkbW3d4TwD2CNjMRwxTbREXySekvq37kfCNk,24311348,9357355,14953993,624
2022-03-19 12:01:00-04:00,13670,7XwpsC8WZcJX3xStrAzvcgzG38xqjj7hvCBVbADyVzh4,6bQ752FahPEFGZEku6URJbhaRxNdN6njqEepCF5itE2A,True,657768214,164442053,1018103,509051,509052,DddJ7EWCmYEEZETCBNgAUSg81Ls6fZtiAaY5ekJ5sXx1,40724130,63492256,-22768126,619
2022-03-19 12:22:47-04:00,13671,BGXRhvHe5qrmQxVrpTCs7i62JsJux15Qwzg9qBCLRabB,7HBUeLofeArctvYw6QYhmQd7muSUPi9MTVU1yfRC9cwu,True,18254277,4563569,28478,14239,14239,3zqXX6kzhkbW3d4TwD2CNjMRwxTbREXySekvq37kfCNk,1139125,4988491,-3849366,624
2022-03-19 12:31:03-04:00,13672,BGXRhvHe5qrmQxVrpTCs7i62JsJux15Qwzg9qBCLRabB,7HBUeLofeArctvYw6QYhmQd7muSUPi9MTVU1yfRC9cwu,False,13967563,13967563,833792,41689,792103,DddJ7EWCmYEEZETCBNgAUSg81Ls6fZtiAaY5ekJ5sXx1,833792,3997673,-3163881,596
2022-03-19 22:38:38-04:00,13673,Eo5LYLiUCspbrK13ker5skq9kMjnpUJEJPSbRDWjH6V4,GefeNAw5BdDkibatZknZVGsLhkfc8wfxriEfjHNpvMPm,True,42069400236,10517350059,65496780,32748390,32748390,3zqXX6kzhkbW3d4TwD2CNjMRwxTbREXySekvq37kfCNk,2619871209,3048995578,-429124369,622
2022-03-20 08:07:57-04:00,13674,CZ1snuuBhno2SqfAmMLzEEQhrsH2reAmZrGhFVsydvHD,F4Hj3jxxE8W8TbgpvjRLnrQ1Jdd28ZKTPNyu1h9BnLiH,True,240220311,60055077,374841,187420,187421,YQC4EUcgeBi9431viwvzvBbZJW3szeHX4dFmowRDyDw,14993670,24753473,-9759803,624
2022-03-20 11:25:52-04:00,13675,8M8iZgfM5MGDfP1aN3Eyb1wceigeBJPbiGqEtJvAYupn,5ph2RDtCTw6a48s7Qq3YmMartVTNiuhu5JgTP7gtgCTN,True,19209072,4802268,29920,14960,14960,3zqXX6kzhkbW3d4TwD2CNjMRwxTbREXySekvq37kfCNk,1196802,1979416,-782614,623
2022-03-20 11:51:08-04:00,13676,FrT2apkEuxM4EvLPXgDq9vNc6wvRcRrZUo7Mu7nAFvCR,8BFxfNtzPa9LqErFhoZKfPLjEwjW8RzWdXnCsZBdrWAc,False,9602965,9602965,593546,29677,563869,YQC4EUcgeBi9431viwvzvBbZJW3szeHX4dFmowRDyDw,593546,986900,-393354,618
2022-03-20 12:05:36-04:00,13677,Eo5LYLiUCspbrK13ker5skq9kMjnpUJEJPSbRDWjH6V4,GefeNAw5BdDkibatZknZVGsLhkfc8wfxriEfjHNpvMPm,True,30931901947,7732975486,48318489,24159244,24159245,3zqXX6kzhkbW3d4TwD2CNjMRwxTbREXySekvq37kfCNk,1932739582,2889073993,-956334411,624
2022-03-20 12:06:02-04:00,13678,5F7WHSYiVtCY8Z9KX9h6AT8qr4hbsSYasG15fq82ZWhr,E5wj8cqKM1ofNv14TspTa8yRwern8y2w6pXekL4cAWX7,True,96101992,24025498,149893,74946,74947,3zqXX6kzhkbW3d4TwD2CNjMRwxTbREXySekvq37kfCNk,5995728,9873696,-3877968,623
2022-03-20 13:31:54-04:00,13679,3hEe6AXGjjVzWnsadNZHfeB6CGg8nKSLyhtyqgBtVivt,6Qdu667ChFcRT7J5QHQzUsWpLmxmNvywAaevseSXqxPZ,True,310100282,77525070,484077,242038,242039,YQC4EUcgeBi9431viwvzvBbZJW3szeHX4dFmowRDyDw,19363090,31950233,-12587143,624
2022-03-20 13:40:16-04:00,13680,F2AU2PjaSmHxWWhkz8XxMggkCMWbMVgawt89tSnYS6RL,ET9febRJiW197DYMaJbgk3kWsAeFv5f4peQ4vFCVppK6,True,692503902,173125975,1072089,536044,536045,3zqXX6kzhkbW3d4TwD2CNjMRwxTbREXySekvq37kfCNk,42883563,71148691,-28265128,619
2022-03-20 20:29:01-04:00,13681,3hEe6AXGjjVzWnsadNZHfeB6CGg8nKSLyhtyqgBtVivt,6Qdu667ChFcRT7J5QHQzUsWpLmxmNvywAaevseSXqxPZ,True,227793383,56948345,352230,176115,176115,YQC4EUcgeBi9431viwvzvBbZJW3szeHX4dFmowRDyDw,14089218,28312231,-14223013,618
2022-03-20 22:31:42-04:00,13682,CZ1snuuBhno2SqfAmMLzEEQhrsH2reAmZrGhFVsydvHD,F4Hj3jxxE8W8TbgpvjRLnrQ1Jdd28ZKTPNyu1h9BnLiH,True,176479731,44119932,272912,136456,136456,3zqXX6kzhkbW3d4TwD2CNjMRwxTbREXySekvq37kfCNk,10916482,21922322,-11005840,618
2022-03-20 22:32:59-04:00,13683,4y31jWFrDnYBxDvQv5VQEmP2SmRQ7mJGNWRbyFhkgEHU,5obEGdveYbRCE1kyaNmo85DXsgGxaL2FPLqJmJbBi2CC,True,562816207,140704051,876524,438262,438262,3zqXX6kzhkbW3d4TwD2CNjMRwxTbREXySekvq37kfCNk,35060967,57934573,-22873606,622
2022-03-20 22:34:04-04:00,13684,Br1j5Ftafei7ysu5SmqVZSoRe4uS4qCPeKSPHg55pyiE,G8fc7QvXjfkgBFvAVUgJFQS3VaF1biL9rktBExGa87Ks,True,2176558461,377890152,2312742,1156371,1156371,3zqXX6kzhkbW3d4TwD2CNjMRwxTbREXySekvq37kfCNk,133208582,157218898,-24010316,612
2022-03-20 22:34:06-04:00,13685,7XwpsC8WZcJX3xStrAzvcgzG38xqjj7hvCBVbADyVzh4,6bQ752FahPEFGZEku6URJbhaRxNdN6njqEepCF5itE2A,True,547463370,136865842,855131,427565,427566,3zqXX6kzhkbW3d4TwD2CNjMRwxTbREXySekvq37kfCNk,34205258,56916520,-22711262,624
2022-03-20 22:34:07-04:00,13686,gCNpMXEHPTLvMvyyaYCLJrd8RRGnKAHz7sBD5j7yyBt,9cRU1ZAZRT5Ei4YAmCrPJZMHGsWspcYXTuZH58iexwDv,True,1238316346,309579086,1899381,949690,949691,3zqXX6kzhkbW3d4TwD2CNjMRwxTbREXySekvq37kfCNk,75975243,127589383,-51614140,613
2022-03-20 22:34:09-04:00,13687,8M8iZgfM5MGDfP1aN3Eyb1wceigeBJPbiGqEtJvAYupn,5ph2RDtCTw6a48s7Qq3YmMartVTNiuhu5JgTP7gtgCTN,False,14101367,14101367,860558,43027,817531,YQC4EUcgeBi9431viwvzvBbZJW3szeHX4dFmowRDyDw,860558,1752959,-892401,610
2022-03-20 22:34:45-04:00,13688,9U25LWBU67c9S6L9F4qmjpTkaHqjFgxyuTCqQ7Zqj62g,ESyDCGZWamnabH3NNvus52X6Z9YAmt3y8oB8zYLmhfX3,True,1750208771,437552192,2727520,1363760,1363760,3zqXX6kzhkbW3d4TwD2CNjMRwxTbREXySekvq37kfCNk,109100836,162690195,-53589359,623
2022-03-20 22:35:19-04:00,13689,5WyyoDD9VWumR9CfNBxCb8XTN97eJ978NvhcmMFxcxNN,DkmRs18Z8odFcijexj44FMPT54kDYF6o95u8TFedZ69K,True,259550477,64887619,405175,202587,202588,3zqXX6kzhkbW3d4TwD2CNjMRwxTbREXySekvq37kfCNk,16207004,26595118,-10388114,624
2022-03-20 22:36:51-04:00,13690,9PaH4MCn4Pj2nhx1Ws3bMb1KBZ1yUBCvF3H425bWAPHe,HkYtBSjhF7y5t1ezeSx7CyParVnNQ3gpeWQU7joTp29q,True,2800423608,700105902,4342456,2171228,2171228,3zqXX6kzhkbW3d4TwD2CNjMRwxTbREXySekvq37kfCNk,173698241,311296676,-137598435,620
2022-03-21 00:58:52-04:00,13691,88awjJ2gbtVpwNCSwDLUbmtQM5xqGbJBwgEngdgUT8uV,7SE7JbDbRgsUzXUAnTrtCyzSCnEkLyYRuTQYRFqQ4rH9,True,199641952,49910488,308900,154450,154450,3zqXX6kzhkbW3d4TwD2CNjMRwxTbREXySekvq37kfCNk,12356013,19078105,-6722092,618
2022-03-21 03:51:39-04:00,13692,CVjkHr29t8pzeXU1U1CdMpT6qwf9Jw4XGxvxU7RURPYj,D66Zpxp7q4Tn4KiLa2pHTrADhgtP8tGqNXVPyCo9mcxc,True,1697810308,424452577,2615479,1307739,1307740,3zqXX6kzhkbW3d4TwD2CNjMRwxTbREXySekvq37kfCNk,104619173,230464259,-125845086,616
2022-03-21 04:05:20-04:00,13693,88awjJ2gbtVpwNCSwDLUbmtQM5xqGbJBwgEngdgUT8uV,7SE7JbDbRgsUzXUAnTrtCyzSCnEkLyYRuTQYRFqQ4rH9,True,152220823,38055205,237838,118919,118919,YQC4EUcgeBi9431viwvzvBbZJW3szeHX4dFmowRDyDw,9513536,17044713,-7531177,624
2022-03-21 05:28:55-04:00,13694,6KGKhfpWXmDyPbXsBbisR5XyebepKXaK9DQuxu3zHVY,EkEvXBiDuHtF8S1rW5H2uGGaPcAsypaHF6VuJeeD8aP7,True,742370166951,185592541737,1158886335,579443167,579443168,3zqXX6kzhkbW3d4TwD2CNjMRwxTbREXySekvq37kfCNk,46355453420,93404988491,-47049535071,624
2022-03-21 12:08:52-04:00,13695,niCk6QHFU1kyU56Mdq5RJzKrecdkNSn23ZA6wduFdWS,BQbUYSw1XsuE6LnVd4XjmxAyYgx4drE4FsetJBCdwVZW,True,1607520495,401760001,2505490,1252745,1252745,3zqXX6kzhkbW3d4TwD2CNjMRwxTbREXySekvq37kfCNk,100249630,286939008,-186689378,623
2022-03-21 12:33:32-04:00,13696,3hEe6AXGjjVzWnsadNZHfeB6CGg8nKSLyhtyqgBtVivt,6Qdu667ChFcRT7J5QHQzUsWpLmxmNvywAaevseSXqxPZ,True,170676590,42669147,264138,132069,132069,3zqXX6kzhkbW3d4TwD2CNjMRwxTbREXySekvq37kfCNk,10565542,17640857,-7075315,619
2022-03-21 14:50:47-04:00,13697,CVjkHr29t8pzeXU1U1CdMpT6qwf9Jw4XGxvxU7RURPYj,D66Zpxp7q4Tn4KiLa2pHTrADhgtP8tGqNXVPyCo9mcxc,True,1294154893,323538723,2013630,1006815,1006815,3zqXX6kzhkbW3d4TwD2CNjMRwxTbREXySekvq37kfCNk,80545223,195743372,-115198149,622
2022-03-21 20:32:43-04:00,13698,3hEe6AXGjjVzWnsadNZHfeB6CGg8nKSLyhtyqgBtVivt,6Qdu667ChFcRT7J5QHQzUsWpLmxmNvywAaevseSXqxPZ,True,125532736,31383184,195573,97786,97787,YQC4EUcgeBi9431viwvzvBbZJW3szeHX4dFmowRDyDw,7822928,15604369,-7781441,623
2022-03-21 23:21:49-04:00,13699,9LALbB5Fz4D75m41xyJR8o9AiUbiwpDTWaPc2tsCtzCN,9u8d8rYZHHLn7tTKpFfTCjgpqXYXfrNU5ug8Tx9wY6Ag,True,124517929,31129482,194507,97253,97254,3zqXX6kzhkbW3d4TwD2CNjMRwxTbREXySekvq37kfCNk,7780296,11961591,-4181295,624
2022-03-22 00:03:30-04:00,13700,niCk6QHFU1kyU56Mdq5RJzKrecdkNSn23ZA6wduFdWS,BQbUYSw1XsuE6LnVd4XjmxAyYgx4drE4FsetJBCdwVZW,True,1227063771,306643411,1902425,951212,951213,3zqXX6kzhkbW3d4TwD2CNjMRwxTbREXySekvq37kfCNk,76127459,237495240,-161367781,620
2022-03-22 00:26:25-04:00,13701,BAob82SHpZa66TNmJ6CgU1vDNPtLuBpMar4mQDwpUPma,HbM2kckEqXAjqSU3bX1G5y3Hotz6MJDYcDaMn6ps9NKr,True,40821426,10205356,61069,30534,30535,DddJ7EWCmYEEZETCBNgAUSg81Ls6fZtiAaY5ekJ5sXx1,2442785,4028896,-1586111,598
2022-03-22 00:27:31-04:00,13702,Bmqae54jhWBLPKUhbE9qJN3Wfy56zR9U6kygyvPjin4Y,EV6XRL5dMERF3yWBQYeXscBiqWwGQ3mYXApdqBUZnhj9,True,1139610871,284902717,1738979,869489,869490,3zqXX6kzhkbW3d4TwD2CNjMRwxTbREXySekvq37kfCNk,69559160,207870761,-138311601,610
2022-03-22 00:27:40-04:00,13703,9LALbB5Fz4D75m41xyJR8o9AiUbiwpDTWaPc2tsCtzCN,9u8d8rYZHHLn7tTKpFfTCjgpqXYXfrNU5ug8Tx9wY6Ag,True,95054695,23763673,147991,73995,73996,3zqXX6kzhkbW3d4TwD2CNjMRwxTbREXySekvq37kfCNk,5919642,10722034,-4802392,622
2022-03-22 07:13:30-04:00,13704,niCk6QHFU1kyU56Mdq5RJzKrecdkNSn23ZA6wduFdWS,BQbUYSw1XsuE6LnVd4XjmxAyYgx4drE4FsetJBCdwVZW,True,936286471,233948377,1452635,726317,726318,YQC4EUcgeBi9431viwvzvBbZJW3szeHX4dFmowRDyDw,58136048,195056588,-136920540,620
2022-03-22 09:23:04-04:00,13705,niCk6QHFU1kyU56Mdq5RJzKrecdkNSn23ZA6wduFdWS,BQbUYSw1XsuE6LnVd4XjmxAyYgx4drE4FsetJBCdwVZW,True,715256080,178691236,1092139,546069,546070,3zqXX6kzhkbW3d4TwD2CNjMRwxTbREXySekvq37kfCNk,43715608,159341222,-115625614,611
2022-03-22 09:49:50-04:00,13706,3hEe6AXGjjVzWnsadNZHfeB6CGg8nKSLyhtyqgBtVivt,6Qdu667ChFcRT7J5QHQzUsWpLmxmNvywAaevseSXqxPZ,True,89974837,22493709,140390,70195,70195,3zqXX6kzhkbW3d4TwD2CNjMRwxTbREXySekvq37kfCNk,5615635,9255194,-3639559,624
2022-03-22 10:01:20-04:00,13707,niCk6QHFU1kyU56Mdq5RJzKrecdkNSn23ZA6wduFdWS,BQbUYSw1XsuE6LnVd4XjmxAyYgx4drE4FsetJBCdwVZW,True,545232050,136184228,847787,423893,423894,3zqXX6kzhkbW3d4TwD2CNjMRwxTbREXySekvq37kfCNk,33942351,129338685,-95396334,622
2022-03-22 15:57:07-04:00,13708,6RuQVU9nu2Ecp177M9ggWczLACvQ8PfT31RTcmfwe9Hq,DZgsgqvMNLTXkBxySZC7Monak2JGsXRMJT4hBQzpf6Xm,True,1235444402,308861100,1909762,954881,954881,3zqXX6kzhkbW3d4TwD2CNjMRwxTbREXySekvq37kfCNk,76390495,127976747,-51586252,618
2022-03-22 19:29:54-04:00,13709,3hEe6AXGjjVzWnsadNZHfeB6CGg8nKSLyhtyqgBtVivt,6Qdu667ChFcRT7J5QHQzUsWpLmxmNvywAaevseSXqxPZ,True,66137945,16534486,103265,51632,51633,3zqXX6kzhkbW3d4TwD2CNjMRwxTbREXySekvq37kfCNk,4130614,8203536,-4072922,624
2022-03-22 19:41:01-04:00,13710,9GfDDypCCSZVA19wMaqoHLNKMHuHNEgmgUB5V8iAaeoL,8pLnmCLcuFpDbnMuPtM2XyYyxsWJBJR51oxDvL6hq9Hk,True,17753196923,2193153392,13676414,6838207,6838207,3zqXX6kzhkbW3d4TwD2CNjMRwxTbREXySekvq37kfCNk,1107082082,1542468925,-435386843,623
2022-03-22 21:04:10-04:00,13711,9GfDDypCCSZVA19wMaqoHLNKMHuHNEgmgUB5V8iAaeoL,8pLnmCLcuFpDbnMuPtM2XyYyxsWJBJR51oxDvL6hq9Hk,True,15424142244,1622181214,10067953,5033976,5033977,YQC4EUcgeBi9431viwvzvBbZJW3szeHX4dFmowRDyDw,957288547,1408214683,-450926136,620
2022-03-22 21:04:36-04:00,13712,3hEe6AXGjjVzWnsadNZHfeB6CGg8nKSLyhtyqgBtVivt,6Qdu667ChFcRT7J5QHQzUsWpLmxmNvywAaevseSXqxPZ,True,48543951,12135987,74190,37095,37095,68sueyVfmy5ToEGtLFGDkwebX47xAmzyXE29z8JrmcWv,2967629,7081867,-4114238,611
2022-03-22 21:05:23-04:00,13713,7pmTYsybMmqgDWwzNkXNUGCG6dEgMKNN8FHujMRHcFmh,FAFWuMtG3xxysZ6RoajG451uVpCKGikfCiJ5mgGmKksf,True,11296689157,2824172289,17640235,8820117,8820118,3zqXX6kzhkbW3d4TwD2CNjMRwxTbREXySekvq37kfCNk,705609435,750732963,-45123528,624
2022-03-22 21:06:11-04:00,13714,9GfDDypCCSZVA19wMaqoHLNKMHuHNEgmgUB5V8iAaeoL,8pLnmCLcuFpDbnMuPtM2XyYyxsWJBJR51oxDvL6hq9Hk,True,13710248832,1352261927,8438004,4219002,4219002,YQC4EUcgeBi9431viwvzvBbZJW3szeHX4dFmowRDyDw,855508396,1284894208,-429385812,623
2022-03-23 09:55:22-04:00,13715,6r7SyFNUp6Tj8v2AqRzJXRhwXgwEP7brQiJkBrdVwzgE,GLDGrumcVUaVpX96rfvdTrPSvxxjR1xN8SwJGHYQzJrP,False,8780782,8780782,541829,27091,514738,3zqXX6kzhkbW3d4TwD2CNjMRwxTbREXySekvq37kfCNk,541831,1655835,-1114004,617
2022-03-23 09:55:23-04:00,13716,Ci7ANhmFNiDuKv8L2sysyoXk1zh4wXqpNR1s9Cj1LQXH,6mLkVNHmGET4AJJ4AHqfWiH5LFLKbBK4zWadaeQt2i1q,True,2015444801,503861200,3120805,1560402,1560403,3zqXX6kzhkbW3d4TwD2CNjMRwxTbREXySekvq37kfCNk,124832223,468547337,-343715114,619
2022-03-23 10:07:33-04:00,13717,Ci7ANhmFNiDuKv8L2sysyoXk1zh4wXqpNR1s9Cj1LQXH,6mLkVNHmGET4AJJ4AHqfWiH5LFLKbBK4zWadaeQt2i1q,False,1568864779,1568864779,64321752,3216087,61105665,3zqXX6kzhkbW3d4TwD2CNjMRwxTbREXySekvq37kfCNk,64321752,379457437,-315135685,409
2022-03-23 10:53:45-04:00,13718,7XwpsC8WZcJX3xStrAzvcgzG38xqjj7hvCBVbADyVzh4,6bQ752FahPEFGZEku6URJbhaRxNdN6njqEepCF5itE2A,True,518279592,129569898,808414,404207,404207,3zqXX6kzhkbW3d4TwD2CNjMRwxTbREXySekvq37kfCNk,32336571,50616270,-18279699,623
2022-03-23 11:14:37-04:00,13719,GwfLBmVoBKibVLjH1DHEqsvyrqWGheK59s18BGrtunJg,CizH6WcFyEuTDkERDWxpnfbnHPBQUCLoM8CNaH2wX8Z8,True,96317794,24079448,146485,73242,73243,3zqXX6kzhkbW3d4TwD2CNjMRwxTbREXySekvq37kfCNk,5859405,17187488,-11328083,608
2022-03-23 11:16:14-04:00,13720,AkGQxVK2FFRi9doFRx5gwGXBr6WKknvU3evZkDu3Yas4,Abu1FYCyBSutkrvrx56tL61xoDyYSCjwrDU1wnKn2gin,True,659966121,164991530,1030735,515367,515368,3zqXX6kzhkbW3d4TwD2CNjMRwxTbREXySekvq37kfCNk,41229419,117900910,-76671491,624
2022-03-23 11:36:01-04:00,13721,76MxXg67Q8CrmgUHJUQufvLmURy6k2DwpPfzVA8ar8AC,WHd5ddz9UZgSX66YkBPPnJFdqkaJqJ4KPLghCRCE1eP,True,269027246,67256811,420269,210134,210135,3zqXX6kzhkbW3d4TwD2CNjMRwxTbREXySekvq37kfCNk,16810773,10803755,6007018,624
2022-03-23 11:36:01-04:00,13722,A11mzoTX3dyc9gACVJkbRGZ6QACJsrF3ZHJUsGEtRnsj,H7z8CfHxnxo3mPrvxfiLLNwrDX1cxGWWDUxXs9EpzSi,True,297124129,74281032,464086,232043,232043,3zqXX6kzhkbW3d4TwD2CNjMRwxTbREXySekvq37kfCNk,18563454,12529959,6033495,624
2022-03-23 20:02:56-04:00,13723,9GfDDypCCSZVA19wMaqoHLNKMHuHNEgmgUB5V8iAaeoL,8pLnmCLcuFpDbnMuPtM2XyYyxsWJBJR51oxDvL6hq9Hk,True,3200372684,800093171,4924927,2462463,2462464,YQC4EUcgeBi9431viwvzvBbZJW3szeHX4dFmowRDyDw,196997108,302724490,-105727382,615
2022-03-24 01:45:52-04:00,13724,GwfLBmVoBKibVLjH1DHEqsvyrqWGheK59s18BGrtunJg,CizH6WcFyEuTDkERDWxpnfbnHPBQUCLoM8CNaH2wX8Z8,True,73375469,18343867,114394,57197,57197,YQC4EUcgeBi9431viwvzvBbZJW3szeHX4dFmowRDyDw,4575797,14209046,-9633249,623
2022-03-24 01:53:44-04:00,13725,AT4qoJDVGXpEm3BGACUhC1zpVNLq4iX2bJ4cpABehpoD,AqaDPXbaY6ksVQwWGKorgBdRQMz3VpqxmHdWXmq17ScF,True,56436619535,14109154883,88139499,44069749,44069750,YQC4EUcgeBi9431viwvzvBbZJW3szeHX4dFmowRDyDw,3525579980,9951708896,-6426128916,624
2022-03-24 02:14:33-04:00,13726,AkGQxVK2FFRi9doFRx5gwGXBr6WKknvU3evZkDu3Yas4,Abu1FYCyBSutkrvrx56tL61xoDyYSCjwrDU1wnKn2gin,True,503696117,125924029,786905,393452,393453,3zqXX6kzhkbW3d4TwD2CNjMRwxTbREXySekvq37kfCNk,31476236,97704389,-66228153,624
2022-03-24 02:28:29-04:00,13727,76MxXg67Q8CrmgUHJUQufvLmURy6k2DwpPfzVA8ar8AC,WHd5ddz9UZgSX66YkBPPnJFdqkaJqJ4KPLghCRCE1eP,True,205437956,51359489,318065,159032,159033,YQC4EUcgeBi9431viwvzvBbZJW3szeHX4dFmowRDyDw,12722609,11885444,837165,619
2022-03-24 02:28:30-04:00,13728,A11mzoTX3dyc9gACVJkbRGZ6QACJsrF3ZHJUsGEtRnsj,H7z8CfHxnxo3mPrvxfiLLNwrDX1cxGWWDUxXs9EpzSi,True,226921938,56730484,350502,175251,175251,YQC4EUcgeBi9431viwvzvBbZJW3szeHX4dFmowRDyDw,14020114,13574536,445578,617
2022-03-24 03:35:03-04:00,13729,9PaH4MCn4Pj2nhx1Ws3bMb1KBZ1yUBCvF3H425bWAPHe,HkYtBSjhF7y5t1ezeSx7CyParVnNQ3gpeWQU7joTp29q,True,4215882038,1053970509,6581738,3290869,3290869,3zqXX6kzhkbW3d4TwD2CNjMRwxTbREXySekvq37kfCNk,263269547,406102491,-142832944,624
2022-03-24 04:36:04-04:00,13730,DVMLxFACqaNBD7q1TGJUUApJX7etJsxQRRFBP2DfBazJ,4hnRjD7S2KxD7UrgfrApntVxUD7Srh5E9nwPY53v89kz,True,530797784,132699446,825402,412701,412701,3zqXX6kzhkbW3d4TwD2CNjMRwxTbREXySekvq37kfCNk,33016083,63677379,-30661296,622
2022-03-24 05:56:07-04:00,13731,GwfLBmVoBKibVLjH1DHEqsvyrqWGheK59s18BGrtunJg,CizH6WcFyEuTDkERDWxpnfbnHPBQUCLoM8CNaH2wX8Z8,True,56020044,14005011,86813,43406,43407,3zqXX6kzhkbW3d4TwD2CNjMRwxTbREXySekvq37kfCNk,3472550,11685965,-8213415,619
2022-03-24 06:01:28-04:00,13732,AT4qoJDVGXpEm3BGACUhC1zpVNLq4iX2bJ4cpABehpoD,AqaDPXbaY6ksVQwWGKorgBdRQMz3VpqxmHdWXmq17ScF,True,43076623812,10769155953,67198890,33599445,33599445,3zqXX6kzhkbW3d4TwD2CNjMRwxTbREXySekvq37kfCNk,2687955629,8278594387,-5590638758,623
2022-03-24 06:12:16-04:00,13733,AkGQxVK2FFRi9doFRx5gwGXBr6WKknvU3evZkDu3Yas4,Abu1FYCyBSutkrvrx56tL61xoDyYSCjwrDU1wnKn2gin,True,384494576,96123644,599115,299557,299558,YQC4EUcgeBi9431viwvzvBbZJW3szeHX4dFmowRDyDw,23964625,80359935,-56395310,623
2022-03-24 06:19:53-04:00,13734,76MxXg67Q8CrmgUHJUQufvLmURy6k2DwpPfzVA8ar8AC,WHd5ddz9UZgSX66YkBPPnJFdqkaJqJ4KPLghCRCE1eP,True,156707560,39176890,244363,122181,122182,3zqXX6kzhkbW3d4TwD2CNjMRwxTbREXySekvq37kfCNk,9774550,11776097,-2001547,623
2022-03-24 06:19:53-04:00,13735,A11mzoTX3dyc9gACVJkbRGZ6QACJsrF3ZHJUsGEtRnsj,H7z8CfHxnxo3mPrvxfiLLNwrDX1cxGWWDUxXs9EpzSi,True,173073320,43268330,269668,134834,134834,3zqXX6kzhkbW3d4TwD2CNjMRwxTbREXySekvq37kfCNk,10786751,13334832,-2548081,623
2022-03-24 06:20:20-04:00,13736,DVMLxFACqaNBD7q1TGJUUApJX7etJsxQRRFBP2DfBazJ,4hnRjD7S2KxD7UrgfrApntVxUD7Srh5E9nwPY53v89kz,True,405028135,101257033,631511,315755,315756,3zqXX6kzhkbW3d4TwD2CNjMRwxTbREXySekvq37kfCNk,25260449,55188270,-29927821,623
2022-03-24 06:35:19-04:00,13737,4J7uT2PQnrfWazv3DJcM82i49WmTugyfpdmDvEjKLDks,HsyGm9ttVqNJp38udSabXHM11MTaNUdxnAT2fWKWz1HZ,True,238360957,59590239,370714,185357,185357,3zqXX6kzhkbW3d4TwD2CNjMRwxTbREXySekvq37kfCNk,14828588,50016984,-35188396,622
2022-03-24 06:38:19-04:00,13738,5oPfboLByFzHVXaoTXuEWuLhuYWqYreXHh8qbec1zPRJ,9dvakgfYekqTqotL5hhBNrkH78L7NwCZYFSvK2b5JS25,True,1478787971,369696992,2308046,1154023,1154023,3zqXX6kzhkbW3d4TwD2CNjMRwxTbREXySekvq37kfCNk,92321861,144115689,-51793828,624
2022-03-24 06:38:25-04:00,13739,GwfLBmVoBKibVLjH1DHEqsvyrqWGheK59s18BGrtunJg,CizH6WcFyEuTDkERDWxpnfbnHPBQUCLoM8CNaH2wX8Z8,True,42739302,10684825,66536,33268,33268,YQC4EUcgeBi9431viwvzvBbZJW3szeHX4dFmowRDyDw,2661458,9545808,-6884350,622
2022-03-24 06:38:37-04:00,13740,7XwpsC8WZcJX3xStrAzvcgzG38xqjj7hvCBVbADyVzh4,6bQ752FahPEFGZEku6URJbhaRxNdN6njqEepCF5itE2A,True,321136861,80284215,500350,250175,250175,YQC4EUcgeBi9431viwvzvBbZJW3szeHX4dFmowRDyDw,20014003,31186698,-11172695,623
2022-03-24 06:44:32-04:00,13741,AT4qoJDVGXpEm3BGACUhC1zpVNLq4iX2bJ4cpABehpoD,AqaDPXbaY6ksVQwWGKorgBdRQMz3VpqxmHdWXmq17ScF,True,32895154314,8223788578,50826757,25413378,25413379,3zqXX6kzhkbW3d4TwD2CNjMRwxTbREXySekvq37kfCNk,2033070284,6826140772,-4793070488,618
2022-03-24 06:44:34-04:00,13742,AkGQxVK2FFRi9doFRx5gwGXBr6WKknvU3evZkDu3Yas4,Abu1FYCyBSutkrvrx56tL61xoDyYSCjwrDU1wnKn2gin,True,293445940,73361485,457262,228631,228631,3zqXX6kzhkbW3d4TwD2CNjMRwxTbREXySekvq37kfCNk,18290502,65662961,-47372459,623
2022-03-24 06:54:04-04:00,13743,A11mzoTX3dyc9gACVJkbRGZ6QACJsrF3ZHJUsGEtRnsj,H7z8CfHxnxo3mPrvxfiLLNwrDX1cxGWWDUxXs9EpzSi,True,132080514,33020128,206038,103019,103019,YQC4EUcgeBi9431viwvzvBbZJW3szeHX4dFmowRDyDw,8241559,12428370,-4186811,623
2022-03-24 06:54:06-04:00,13744,76MxXg67Q8CrmgUHJUQufvLmURy6k2DwpPfzVA8ar8AC,WHd5ddz9UZgSX66YkBPPnJFdqkaJqJ4KPLghCRCE1eP,True,119591764,29897941,186727,93363,93364,YQC4EUcgeBi9431viwvzvBbZJW3szeHX4dFmowRDyDw,7469093,11031533,-3562440,624
2022-03-24 06:55:02-04:00,13745,DVMLxFACqaNBD7q1TGJUUApJX7etJsxQRRFBP2DfBazJ,4hnRjD7S2KxD7UrgfrApntVxUD7Srh5E9nwPY53v89kz,True,309090447,77272611,482739,241369,241370,3zqXX6kzhkbW3d4TwD2CNjMRwxTbREXySekvq37kfCNk,19309593,47075968,-27766375,624
2022-03-24 07:02:10-04:00,13746,4J7uT2PQnrfWazv3DJcM82i49WmTugyfpdmDvEjKLDks,HsyGm9ttVqNJp38udSabXHM11MTaNUdxnAT2fWKWz1HZ,True,182142439,45535609,277133,138566,138567,3zqXX6kzhkbW3d4TwD2CNjMRwxTbREXySekvq37kfCNk,11085358,40848746,-29763388,608
2022-03-24 09:43:46-04:00,13747,9PaH4MCn4Pj2nhx1Ws3bMb1KBZ1yUBCvF3H425bWAPHe,HkYtBSjhF7y5t1ezeSx7CyParVnNQ3gpeWQU7joTp29q,True,3218816819,804704204,4978698,2489349,2489349,3zqXX6kzhkbW3d4TwD2CNjMRwxTbREXySekvq37kfCNk,199147943,363451208,-164303265,618
2022-03-24 11:37:01-04:00,13748,Bmqae54jhWBLPKUhbE9qJN3Wfy56zR9U6kygyvPjin4Y,EV6XRL5dMERF3yWBQYeXscBiqWwGQ3mYXApdqBUZnhj9,True,868061574,217015393,1354492,677246,677246,YQC4EUcgeBi9431viwvzvBbZJW3szeHX4dFmowRDyDw,54179684,171279845,-117100161,624
2022-03-24 11:40:38-04:00,13749,5oPfboLByFzHVXaoTXuEWuLhuYWqYreXHh8qbec1zPRJ,9dvakgfYekqTqotL5hhBNrkH78L7NwCZYFSvK2b5JS25,True,1128685037,282171259,1760299,880149,880150,YQC4EUcgeBi9431viwvzvBbZJW3szeHX4dFmowRDyDw,70411993,128867524,-58455531,623
2022-03-24 11:40:38-04:00,13750,GwfLBmVoBKibVLjH1DHEqsvyrqWGheK59s18BGrtunJg,CizH6WcFyEuTDkERDWxpnfbnHPBQUCLoM8CNaH2wX8Z8,True,32614867,8153716,50857,25428,25429,3zqXX6kzhkbW3d4TwD2CNjMRwxTbREXySekvq37kfCNk,2034308,7757972,-5723664,623
2022-03-24 11:40:52-04:00,13751,7XwpsC8WZcJX3xStrAzvcgzG38xqjj7hvCBVbADyVzh4,6bQ752FahPEFGZEku6URJbhaRxNdN6njqEepCF5itE2A,True,245086376,61271594,381955,190977,190978,YQC4EUcgeBi9431viwvzvBbZJW3szeHX4dFmowRDyDw,15278239,27892249,-12614010,623
2022-03-24 11:44:00-04:00,13752,5SQYzeBHLqEsJzcHFV7pbnLoAyQstKaMiECyjwiJHQi6,GFNvxiLMPzxEWMX7UeCVPFgk6z9zS1LDVFWheCzSsXhd,False,3347054,3347054,207592,10379,197213,YQC4EUcgeBi9431viwvzvBbZJW3szeHX4dFmowRDyDw,207592,1034647,-827055,620
2022-03-24 12:26:16-04:00,13753,AkGQxVK2FFRi9doFRx5gwGXBr6WKknvU3evZkDu3Yas4,Abu1FYCyBSutkrvrx56tL61xoDyYSCjwrDU1wnKn2gin,True,223925989,55981497,349740,174870,174870,3zqXX6kzhkbW3d4TwD2CNjMRwxTbREXySekvq37kfCNk,13989616,53361044,-39371428,624
2022-03-24 12:26:16-04:00,13754,AT4qoJDVGXpEm3BGACUhC1zpVNLq4iX2bJ4cpABehpoD,AqaDPXbaY6ksVQwWGKorgBdRQMz3VpqxmHdWXmq17ScF,True,25087594872,6271898718,39144509,19572254,19572255,YQC4EUcgeBi9431viwvzvBbZJW3szeHX4dFmowRDyDw,1565780365,5583847924,-4018067559,624
2022-03-24 13:07:30-04:00,13755,FHL6i18MNUoLhsMqwUFQfQLyVQy4R1jhzxG95NeKBkec,3VwEsYwnCcv6NR8wC72JaSYPTMxkzzcF3SYRAFiEfJi2,False,8248889,8248889,515489,25774,489715,YQC4EUcgeBi9431viwvzvBbZJW3szeHX4dFmowRDyDw,515489,2972762,-2457273,624
2022-03-24 15:09:21-04:00,13756,76MxXg67Q8CrmgUHJUQufvLmURy6k2DwpPfzVA8ar8AC,WHd5ddz9UZgSX66YkBPPnJFdqkaJqJ4KPLghCRCE1eP,True,91277651,22819412,142423,71211,71212,3zqXX6kzhkbW3d4TwD2CNjMRwxTbREXySekvq37kfCNk,5696928,9952691,-4255763,624
2022-03-24 15:09:25-04:00,13757,A11mzoTX3dyc9gACVJkbRGZ6QACJsrF3ZHJUsGEtRnsj,H7z8CfHxnxo3mPrvxfiLLNwrDX1cxGWWDUxXs9EpzSi,True,100881528,25220382,155315,77657,77658,YQC4EUcgeBi9431viwvzvBbZJW3szeHX4dFmowRDyDw,6212601,11173979,-4961378,615
2022-03-24 15:29:00-04:00,13758,4J7uT2PQnrfWazv3DJcM82i49WmTugyfpdmDvEjKLDks,HsyGm9ttVqNJp38udSabXHM11MTaNUdxnAT2fWKWz1HZ,True,138780481,34695120,215818,107909,107909,3zqXX6kzhkbW3d4TwD2CNjMRwxTbREXySekvq37kfCNk,8632737,33129139,-24496402,622
2022-03-24 21:31:06-04:00,13759,5oPfboLByFzHVXaoTXuEWuLhuYWqYreXHh8qbec1zPRJ,9dvakgfYekqTqotL5hhBNrkH78L7NwCZYFSvK2b5JS25,True,861799146,215449786,1333713,666856,666857,YQC4EUcgeBi9431viwvzvBbZJW3szeHX4dFmowRDyDw,53348535,112484688,-59136153,619
2022-03-24 21:31:07-04:00,13760,GwfLBmVoBKibVLjH1DHEqsvyrqWGheK59s18BGrtunJg,CizH6WcFyEuTDkERDWxpnfbnHPBQUCLoM8CNaH2wX8Z8,True,24899738,6224934,38608,19304,19304,YQC4EUcgeBi9431viwvzvBbZJW3szeHX4dFmowRDyDw,1544350,6275691,-4731341,620
2022-03-24 21:31:17-04:00,13761,7XwpsC8WZcJX3xStrAzvcgzG38xqjj7hvCBVbADyVzh4,6bQ752FahPEFGZEku6URJbhaRxNdN6njqEepCF5itE2A,True,187032981,46758245,291855,145927,145928,3zqXX6kzhkbW3d4TwD2CNjMRwxTbREXySekvq37kfCNk,11674226,24353363,-12679137,624
2022-03-24 22:11:41-04:00,13762,AkGQxVK2FFRi9doFRx5gwGXBr6WKknvU3evZkDu3Yas4,Abu1FYCyBSutkrvrx56tL61xoDyYSCjwrDU1wnKn2gin,True,170901398,42725349,266992,133496,133496,3zqXX6kzhkbW3d4TwD2CNjMRwxTbREXySekvq37kfCNk,10679701,43165489,-32485788,624
2022-03-24 22:11:57-04:00,13763,AT4qoJDVGXpEm3BGACUhC1zpVNLq4iX2bJ4cpABehpoD,AqaDPXbaY6ksVQwWGKorgBdRQMz3VpqxmHdWXmq17ScF,True,19146539753,4786634938,29885660,14942830,14942830,YQC4EUcgeBi9431viwvzvBbZJW3szeHX4dFmowRDyDw,1195426427,4543809118,-3348382691,624
2022-03-24 22:12:09-04:00,13764,niCk6QHFU1kyU56Mdq5RJzKrecdkNSn23ZA6wduFdWS,BQbUYSw1XsuE6LnVd4XjmxAyYgx4drE4FsetJBCdwVZW,True,251804914,52139059,325811,162905,162906,3zqXX6kzhkbW3d4TwD2CNjMRwxTbREXySekvq37kfCNk,15735048,33718892,-17983844,624
2022-03-25 00:57:28-04:00,13765,A11mzoTX3dyc9gACVJkbRGZ6QACJsrF3ZHJUsGEtRnsj,H7z8CfHxnxo3mPrvxfiLLNwrDX1cxGWWDUxXs9EpzSi,True,76962266,19240566,118878,59439,59439,3zqXX6kzhkbW3d4TwD2CNjMRwxTbREXySekvq37kfCNk,4755148,9777374,-5022226,617
2022-03-25 00:57:28-04:00,13766,76MxXg67Q8CrmgUHJUQufvLmURy6k2DwpPfzVA8ar8AC,WHd5ddz9UZgSX66YkBPPnJFdqkaJqJ4KPLghCRCE1eP,True,69685121,17421280,108167,54083,54084,3zqXX6kzhkbW3d4TwD2CNjMRwxTbREXySekvq37kfCNk,4326701,8745465,-4418764,620
2022-03-25 07:18:24-04:00,13767,HZ7AK8m2hQ5JSKV6dU97VJjKbhdAj91aLHkmckXGBam6,Aw4qaqgEsxys52J5a97wAjfFavYKFZEAYEpBgkzi4pLW,True,6765532505,1691383126,10509416,5254708,5254708,3zqXX6kzhkbW3d4TwD2CNjMRwxTbREXySekvq37kfCNk,420376671,1181519851,-761143180,621
2022-03-25 07:40:59-04:00,13768,GTzLxRn226vTjN4HTSDSCjDLjwNiP4jsarG4umsA4CPc,6BWii3HLmdacnSS1pe8RkbbN6kbe4jpYYbnHqM1hh2G5,True,1047754487,261938621,1618179,809089,809090,YQC4EUcgeBi9431viwvzvBbZJW3szeHX4dFmowRDyDw,64727164,110620491,-45893327,617
2022-03-25 07:41:00-04:00,13769,Bmqae54jhWBLPKUhbE9qJN3Wfy56zR9U6kygyvPjin4Y,EV6XRL5dMERF3yWBQYeXscBiqWwGQ3mYXApdqBUZnhj9,True,662297599,165574399,1030910,515455,515455,3zqXX6kzhkbW3d4TwD2CNjMRwxTbREXySekvq37kfCNk,41236410,140320304,-99083894,622
2022-03-25 07:42:54-04:00,13770,8trFFwvXKKMwMx952ugCZmqyw29e1HxEKBuQmFn8ZwTf,FsD7gCvHXM3QchQiDcd292ksy5afZMWApneNTat5ndeS,True,134341604,33585401,209351,104675,104676,YQC4EUcgeBi9431viwvzvBbZJW3szeHX4dFmowRDyDw,8374070,16556444,-8182374,623
2022-03-25 07:42:58-04:00,13771,DgtZ1dBzCaR4K38CxgyhxaGCdwXM69N4CZDZ4nsZXYE4,8x5yYiS88nDTvj1v11s3J9kQ94S3j94NZvqfV9dxJuWJ,True,2955725697,738931424,4610709,2305354,2305355,3zqXX6kzhkbW3d4TwD2CNjMRwxTbREXySekvq37kfCNk,184428368,291140057,-106711689,623
2022-03-25 12:53:43-04:00,13772,DBpCYPg3XaURq987o1MQwphyzjmD7VTWAjfQDgPw95aD,CNdhCvdP6ajoYKwRnsc2W3eahwUW4MZb2hGjFc1tjEWx,True,2523482979,630870744,3938903,1969451,1969452,3zqXX6kzhkbW3d4TwD2CNjMRwxTbREXySekvq37kfCNk,157556139,259975085,-102418946,624
2022-03-25 12:58:17-04:00,13773,CZ1snuuBhno2SqfAmMLzEEQhrsH2reAmZrGhFVsydvHD,F4Hj3jxxE8W8TbgpvjRLnrQ1Jdd28ZKTPNyu1h9BnLiH,True,1926305182,481576295,2995284,1497642,1497642,3zqXX6kzhkbW3d4TwD2CNjMRwxTbREXySekvq37kfCNk,119811399,198675440,-78864041,621
2022-03-25 13:00:01-04:00,13774,2yH4iJWVSDWHGjm5J95sbsRbHGA81VNPaox8xz8DWQaG,EHUYNPTqdUDGi3TBrr5BjDByCzLKq27CECCFUNyGRbQR,True,2204582256,551145564,3418117,1709058,1709059,3zqXX6kzhkbW3d4TwD2CNjMRwxTbREXySekvq37kfCNk,136724705,227611961,-90887256,620
2022-03-25 13:08:54-04:00,13775,F2AU2PjaSmHxWWhkz8XxMggkCMWbMVgawt89tSnYS6RL,ET9febRJiW197DYMaJbgk3kWsAeFv5f4peQ4vFCVppK6,True,675317348,168829337,1055156,527578,527578,YQC4EUcgeBi9431viwvzvBbZJW3szeHX4dFmowRDyDw,42206278,62752232,-20545954,624
2022-03-25 13:09:05-04:00,13776,7ueXVhSvXvttkeQ18w2cLh65naoEPvYF86RrdUK2Vc5Q,CKTehY1W6bw85cS4o7g2qXKjP4656Vwo37244BAEAiw1,True,63202279464,4921977395,30755988,15377994,15377994,3zqXX6kzhkbW3d4TwD2CNjMRwxTbREXySekvq37kfCNk,3949324513,6917409995,-2968085482,624
2022-03-25 13:09:29-04:00,13777,BhhVhLVZkSd3aHDMd6ojTgtJtbgAdMCA9Xj8jL2GMXoL,G8HUQp2yGSw9T6it5ej91cqkd82naca8heji453g2jEH,True,8511032957,1715830309,10604020,5302010,5302010,3zqXX6kzhkbW3d4TwD2CNjMRwxTbREXySekvq37kfCNk,525991211,958186439,-432195228,618
2022-03-25 13:09:31-04:00,13778,4hyYkR4vX3HuybAHHKyLgfseU7qBB5r5xYZ3Ye4ssNaM,8EKhsSKPiaueXNNgPqpyNkAy64bVYaRqiJE1CdryT9wW,False,4882112,4882112,303034,15151,287883,YQC4EUcgeBi9431viwvzvBbZJW3szeHX4dFmowRDyDw,303034,510922,-207888,620
2022-03-25 13:09:37-04:00,13779,5xpiEvfY9hpdUW1c85fQSTBPgVbcrjD5hkmUCYvSF2DR,AhJe4Y7uima7HC8eYfZs7xJZrWth12UczAa2fHyUjfbp,True,3052573080,763143270,4734792,2367396,2367396,3zqXX6kzhkbW3d4TwD2CNjMRwxTbREXySekvq37kfCNk,189391711,341558493,-152166782,620
2022-03-25 13:09:40-04:00,13780,5yPGvUz6JWKjkViGwTCpygJii1rP2xv5yx146ULtBiYq,FMnHUCQWTf1UHu5qVFqUAsWh8aba9EQYTEoiXy55totD,True,2924249231,731062307,4543111,2271555,2271556,3zqXX6kzhkbW3d4TwD2CNjMRwxTbREXySekvq37kfCNk,181724449,379461199,-197736750,621
2022-03-25 13:09:52-04:00,13781,FioVoekYeX2y7AHTM628E3xpE6WLA3KJbqzXGBNRHbS2,EDaypRrdcSbE8natjsc4mDuv3WR7cuwvZcLfcb44Ya9S,True,761485042,190371260,1187180,593590,593590,YQC4EUcgeBi9431viwvzvBbZJW3szeHX4dFmowRDyDw,47487222,100394720,-52907498,623
2022-03-25 13:10:03-04:00,13782,EFzTG8kgbs1kExcFxcQrLSteeKD7jVqgQ2x3onCnhNuP,9wLCaZ7eVfs3u7Gp6HypL1Nz7hWgAcLcjbLtdyxf9gFU,True,79379685,19844921,123979,61989,61990,3zqXX6kzhkbW3d4TwD2CNjMRwxTbREXySekvq37kfCNk,4959166,8179478,-3220312,624
2022-03-25 13:10:04-04:00,13783,7ueXVhSvXvttkeQ18w2cLh65naoEPvYF86RrdUK2Vc5Q,CKTehY1W6bw85cS4o7g2qXKjP4656Vwo37244BAEAiw1,True,57983162613,4066711488,25399282,12699641,12699641,3zqXX6kzhkbW3d4TwD2CNjMRwxTbREXySekvq37kfCNk,3621429069,6585206096,-2963777027,624
2022-03-25 18:13:47-04:00,13784,13QjvYYcM5izdJ49PzRWqrw8ZCT3zH818AuTUJhw5Mbz,7Uxmf8a4rpKW1Z163MQygUqmqj2mMqjxih3ppwv3G8ee,True,482193153,120548288,751570,375785,375785,3zqXX6kzhkbW3d4TwD2CNjMRwxTbREXySekvq37kfCNk,30062829,14303938,15758891,623
2022-03-27 16:35:42-04:00,13785,HZ7AK8m2hQ5JSKV6dU97VJjKbhdAj91aLHkmckXGBam6,Aw4qaqgEsxys52J5a97wAjfFavYKFZEAYEpBgkzi4pLW,True,5162591709,1290647927,7930425,3965212,3965213,YQC4EUcgeBi9431viwvzvBbZJW3szeHX4dFmowRDyDw,317217014,976971655,-659754641,614
2022-03-27 16:35:53-04:00,13786,GTzLxRn226vTjN4HTSDSCjDLjwNiP4jsarG4umsA4CPc,6BWii3HLmdacnSS1pe8RkbbN6kbe4jpYYbnHqM1hh2G5,True,798936376,199734094,1233451,616725,616726,YQC4EUcgeBi9431viwvzvBbZJW3szeHX4dFmowRDyDw,49338057,96890304,-47552247,617
2022-03-27 16:35:53-04:00,13787,Bmqae54jhWBLPKUhbE9qJN3Wfy56zR9U6kygyvPjin4Y,EV6XRL5dMERF3yWBQYeXscBiqWwGQ3mYXApdqBUZnhj9,True,505050949,126262737,786665,393332,393333,YQC4EUcgeBi9431viwvzvBbZJW3szeHX4dFmowRDyDw,31466615,114111457,-82644842,623
2022-03-27 16:36:18-04:00,13788,2Gfse9HBrkdSHZrKFk2Lbabmw7Mf9SAGpTftge3QCzfh,7bEeqMeSHXDSZzPu6sZEtHCUs1uZRXqWfz9FHwD9gBGS,True,639260069,159815017,997285,498642,498643,3zqXX6kzhkbW3d4TwD2CNjMRwxTbREXySekvq37kfCNk,39891416,79215916,-39324500,624
2022-03-27 16:36:24-04:00,13789,5YC2wXkdk7D4Ubs9TEAbP1hi88Sy35bzYVWjLbgVxn5s,4Mx69ezqFK2wudZ62oVhx2pwjVbKv8JB1HR29ZUcdEJb,True,10704042683,2676010670,16714307,8357153,8357154,3zqXX6kzhkbW3d4TwD2CNjMRwxTbREXySekvq37kfCNk,668572314,1372607807,-704035493,624
2022-03-27 16:36:24-04:00,13790,DgtZ1dBzCaR4K38CxgyhxaGCdwXM69N4CZDZ4nsZXYE4,8x5yYiS88nDTvj1v11s3J9kQ94S3j94NZvqfV9dxJuWJ,True,2254593881,563648470,3504709,1752354,1752355,3zqXX6kzhkbW3d4TwD2CNjMRwxTbREXySekvq37kfCNk,140188394,258115841,-117927447,621
2022-03-27 16:37:26-04:00,13791,8qq2gfbca7JXvq4gViBBVT2QAbM4MvBMEQLXgn8UUTvt,3o5jpBVYdFFEYrGRdCUkLrUC85wsuTKgy8iYwnpZyC1B,True,3627077945,540765994,3229499,1614749,1614750,3zqXX6kzhkbW3d4TwD2CNjMRwxTbREXySekvq37kfCNk,216612096,915662107,-699050011,597
2022-03-27 16:37:27-04:00,13792,5rv28YXtxD3bThdni7X4qz6ye1BNPx2S8yXur1vJeVfX,EPvM8N8DFVRHLKbuC9e4P6W2NF8kzGWFjq2eCEKM2Zfr,True,644346814,161086703,994270,497135,497135,3zqXX6kzhkbW3d4TwD2CNjMRwxTbREXySekvq37kfCNk,39770833,84137223,-44366390,617
2022-03-27 16:37:33-04:00,13793,FcXe2wJqFzVRpRMSsPwzmwKAQ7f9CfHmwCt99k1cQeE1,BFjwToxLi3yzSDP13XqEXifQXahGyr5BWPBJyiM2iaai,True,78115601,6752688,41955,20977,20978,YQC4EUcgeBi9431viwvzvBbZJW3szeHX4dFmowRDyDw,4853407,19969106,-15115699,621
2022-03-27 16:37:44-04:00,13794,AxUKatZukyU1PaNZzQFftBbga7GQC7nArZKv6wHCtXVR,HEqbmmGLsuxSSbqx931nFbbhhsNFNEx8Srf8J7wZr7pa,True,78210850,6753585,41088,20544,20544,3zqXX6kzhkbW3d4TwD2CNjMRwxTbREXySekvq37kfCNk,4758383,19969375,-15210992,608
2022-03-27 16:38:27-04:00,13795,4S7Ky4QBiqRWUFYsCcsSnijMTPsNNcDDSAHNyS9Mvzo2,DsdFdR1MT5pdU196PCYM6a5os3TAiAg6fUweGAugHsb8,True,98099468,24524867,152487,76243,76244,3u7uYrYWGhL1rNaQfaT1E4Lc1EbfzR8ZudfMhbesRBZ5,6099514,29528533,-23429019,621
2022-03-27 16:38:29-04:00,13796,6fSdeis6nFxh1SZusjL6cReVZLqVPTK4bo33XY1JRLts,91dgzxhnfPYvnQK5GSbqVJ4XKPMxSoqATS78CEhnXNoG,True,35121263,8780315,54277,27138,27139,YQC4EUcgeBi9431viwvzvBbZJW3szeHX4dFmowRDyDw,2171112,4176369,-2005257,618
2022-03-27 16:38:38-04:00,13797,BKh4M4RqABRMxV6WuHRwMtX7f1C7KmJZg7UC85HWBU9,AxnhkR43eVPWrSZwrLkZ9GqERfYRbANwXqPurK21joJW,True,647128487,161782121,1006091,503045,503046,3zqXX6kzhkbW3d4TwD2CNjMRwxTbREXySekvq37kfCNk,40243672,87393900,-47150228,621
2022-03-27 16:38:47-04:00,13798,FcXe2wJqFzVRpRMSsPwzmwKAQ7f9CfHmwCt99k1cQeE1,BFjwToxLi3yzSDP13XqEXifQXahGyr5BWPBJyiM2iaai,True,71748031,6638298,40953,20476,20477,3zqXX6kzhkbW3d4TwD2CNjMRwxTbREXySekvq37kfCNk,4426334,18424462,-13998128,616
2022-03-27 16:39:01-04:00,13799,H7wVZszBQdmFuwMUYAw4SSYbjxeFY1QvNBuT8QiqTxZS,CUm235keNKnVd2BaCNp5a6HePtWGMo8dq8S1KXf2KRR4,True,203907194,50976798,317936,158968,158968,3zqXX6kzhkbW3d4TwD2CNjMRwxTbREXySekvq37kfCNk,12717460,19436760,-6719300,623
2022-03-27 16:39:02-04:00,13800,HZ7AK8m2hQ5JSKV6dU97VJjKbhdAj91aLHkmckXGBam6,Aw4qaqgEsxys52J5a97wAjfFavYKFZEAYEpBgkzi4pLW,True,3936140651,984035162,6127243,3063621,3063622,3zqXX6kzhkbW3d4TwD2CNjMRwxTbREXySekvq37kfCNk,245089720,804360641,-559270921,622
2022-03-27 16:39:06-04:00,13801,HegY1tDz2ki6vSf9FPRSF4dwGKyciGCt6bovVYdFJRk6,soWdvQVu9EW4Mkk5WUY6rZLA3cEXhFUKqNyY7kpg8ZD,True,76195744,6656269,41553,20776,20777,YQC4EUcgeBi9431viwvzvBbZJW3szeHX4dFmowRDyDw,4756796,19952550,-15195754,624
2022-03-27 16:39:26-04:00,13802,AxUKatZukyU1PaNZzQFftBbga7GQC7nArZKv6wHCtXVR,HEqbmmGLsuxSSbqx931nFbbhhsNFNEx8Srf8J7wZr7pa,True,71694552,6629583,41426,20713,20713,3zqXX6kzhkbW3d4TwD2CNjMRwxTbREXySekvq37kfCNk,4480008,18424706,-13944698,624
2022-03-27 16:39:56-04:00,13803,GTzLxRn226vTjN4HTSDSCjDLjwNiP4jsarG4umsA4CPc,6BWii3HLmdacnSS1pe8RkbbN6kbe4jpYYbnHqM1hh2G5,True,609368211,152342052,948466,474233,474233,3zqXX6kzhkbW3d4TwD2CNjMRwxTbREXySekvq37kfCNk,37938677,83775451,-45836774,622
2022-03-27 16:40:21-04:00,13804,Bmqae54jhWBLPKUhbE9qJN3Wfy56zR9U6kygyvPjin4Y,EV6XRL5dMERF3yWBQYeXscBiqWwGQ3mYXApdqBUZnhj9,True,385401420,96350355,601668,300834,300834,3zqXX6kzhkbW3d4TwD2CNjMRwxTbREXySekvq37kfCNk,24066742,92665948,-68599206,624
2022-03-27 16:41:53-04:00,13805,2Gfse9HBrkdSHZrKFk2Lbabmw7Mf9SAGpTftge3QCzfh,7bEeqMeSHXDSZzPu6sZEtHCUs1uZRXqWfz9FHwD9gBGS,True,487915831,121978957,760583,380291,380292,YQC4EUcgeBi9431viwvzvBbZJW3szeHX4dFmowRDyDw,30423352,68391755,-37968403,623
2022-03-27 16:41:59-04:00,13806,DgtZ1dBzCaR4K38CxgyhxaGCdwXM69N4CZDZ4nsZXYE4,8x5yYiS88nDTvj1v11s3J9kQ94S3j94NZvqfV9dxJuWJ,True,1720286752,430071688,2683558,1341779,1341779,YQC4EUcgeBi9431viwvzvBbZJW3szeHX4dFmowRDyDw,107342344,225182631,-117840287,623
2022-03-27 16:42:05-04:00,13807,5YC2wXkdk7D4Ubs9TEAbP1hi88Sy35bzYVWjLbgVxn5s,4Mx69ezqFK2wudZ62oVhx2pwjVbKv8JB1HR29ZUcdEJb,True,8170228356,2042557089,12741541,6370770,6370771,3zqXX6kzhkbW3d4TwD2CNjMRwxTbREXySekvq37kfCNk,509661664,1181070343,-671408679,623
2022-03-27 16:50:14-04:00,13808,4J7uT2PQnrfWazv3DJcM82i49WmTugyfpdmDvEjKLDks,HsyGm9ttVqNJp38udSabXHM11MTaNUdxnAT2fWKWz1HZ,True,105859708,26464927,165185,82592,82593,YQC4EUcgeBi9431viwvzvBbZJW3szeHX4dFmowRDyDw,6607421,26754188,-20146767,624
2022-03-27 16:50:16-04:00,13809,AzmKB7i1dJucc5Ec1mxpoJor662CDFKAAWRstWDtrmaq,Fd2bPyTR54f8fcTkUokCjcgYgReTGR9vN7ymaGXVcMDK,True,1716022030,429005507,2647404,1323702,1323702,3zqXX6kzhkbW3d4TwD2CNjMRwxTbREXySekvq37kfCNk,105896193,317401611,-211505418,617
2022-03-27 16:50:48-04:00,13810,FcXe2wJqFzVRpRMSsPwzmwKAQ7f9CfHmwCt99k1cQeE1,BFjwToxLi3yzSDP13XqEXifQXahGyr5BWPBJyiM2iaai,True,65414496,6230109,38863,19431,19432,YQC4EUcgeBi9431viwvzvBbZJW3szeHX4dFmowRDyDw,4080618,16995213,-12914595,623
2022-03-27 16:51:59-04:00,13811,HegY1tDz2ki6vSf9FPRSF4dwGKyciGCt6bovVYdFJRk6,soWdvQVu9EW4Mkk5WUY6rZLA3cEXhFUKqNyY7kpg8ZD,True,69889523,6538013,40835,20417,20418,YQC4EUcgeBi9431viwvzvBbZJW3szeHX4dFmowRDyDw,4365195,18504757,-14139562,624
2022-03-27 16:52:19-04:00,13812,2Tm69hQroe4dREXCLHubHfDTkDPohvcMEFuALmCpNZw6,4FH8oJspDa4TPVVXgzJzVM1eTHdnNvSf59C1A8m2PXoc,True,1346975733,155005514,968722,484361,484361,3zqXX6kzhkbW3d4TwD2CNjMRwxTbREXySekvq37kfCNk,84180668,123083612,-38902944,624
2022-03-27 16:52:24-04:00,13813,C6xDH6AEdEyYtKgexB19RoQuM6LaAaaSeQfi6fEVJ3py,9jo1gW46G4Gkmc2AjVizvQLdMATTmtuuYwXQAUGSgsA6,True,2606854590,651713647,4004172,2002086,2002086,3zqXX6kzhkbW3d4TwD2CNjMRwxTbREXySekvq37kfCNk,160166897,248853233,-88686336,614
2022-03-27 17:29:21-04:00,13814,AxUKatZukyU1PaNZzQFftBbga7GQC7nArZKv6wHCtXVR,HEqbmmGLsuxSSbqx931nFbbhhsNFNEx8Srf8J7wZr7pa,True,65418984,6242431,38980,19490,19490,YQC4EUcgeBi9431viwvzvBbZJW3szeHX4dFmowRDyDw,4085098,17004218,-12919120,624
2022-03-27 17:32:39-04:00,13815,HegY1tDz2ki6vSf9FPRSF4dwGKyciGCt6bovVYdFJRk6,soWdvQVu9EW4Mkk5WUY6rZLA3cEXhFUKqNyY7kpg8ZD,True,63700220,5992561,37405,18702,18703,3zqXX6kzhkbW3d4TwD2CNjMRwxTbREXySekvq37kfCNk,3976175,16926431,-12950256,624
2022-03-27 17:32:40-04:00,13816,FcXe2wJqFzVRpRMSsPwzmwKAQ7f9CfHmwCt99k1cQeE1,BFjwToxLi3yzSDP13XqEXifQXahGyr5BWPBJyiM2iaai,True,59530524,5148532,31965,15982,15983,3zqXX6kzhkbW3d4TwD2CNjMRwxTbREXySekvq37kfCNk,3696117,15976740,-12280623,620
2022-03-27 17:32:41-04:00,13817,5rv28YXtxD3bThdni7X4qz6ye1BNPx2S8yXur1vJeVfX,EPvM8N8DFVRHLKbuC9e4P6W2NF8kzGWFjq2eCEKM2Zfr,True,491468932,122867233,764259,382129,382130,3zqXX6kzhkbW3d4TwD2CNjMRwxTbREXySekvq37kfCNk,30570377,72058257,-41487880,622
2022-03-27 17:32:47-04:00,13818,9UmMXBkDkVUeQ3KPNfbBWyHZc8ZHxbcTPj3uEnagYVsH,AMynuRjvyHfuqzpbWrM5ifmgaR7BqMAkoZLGVWKN865w,False,11275476,11275476,696905,34845,662060,YQC4EUcgeBi9431viwvzvBbZJW3szeHX4dFmowRDyDw,696905,1977476,-1280571,618
2022-03-27 17:32:51-04:00,13819,AxUKatZukyU1PaNZzQFftBbga7GQC7nArZKv6wHCtXVR,HEqbmmGLsuxSSbqx931nFbbhhsNFNEx8Srf8J7wZr7pa,True,59505263,5149821,32171,16085,16086,3zqXX6kzhkbW3d4TwD2CNjMRwxTbREXySekvq37kfCNk,3717408,15972803,-12255395,624
2022-03-27 17:32:51-04:00,13820,GwfLBmVoBKibVLjH1DHEqsvyrqWGheK59s18BGrtunJg,CizH6WcFyEuTDkERDWxpnfbnHPBQUCLoM8CNaH2wX8Z8,True,18989611,4747402,29622,14811,14811,YQC4EUcgeBi9431viwvzvBbZJW3szeHX4dFmowRDyDw,1184886,5048202,-3863316,623
2022-03-27 18:25:42-04:00,13821,4S7Ky4QBiqRWUFYsCcsSnijMTPsNNcDDSAHNyS9Mvzo2,DsdFdR1MT5pdU196PCYM6a5os3TAiAg6fUweGAugHsb8,True,74914626,18728656,115175,57587,57588,3zqXX6kzhkbW3d4TwD2CNjMRwxTbREXySekvq37kfCNk,4607033,23518903,-18911870,614
2022-03-27 18:25:42-04:00,13822,6fSdeis6nFxh1SZusjL6cReVZLqVPTK4bo33XY1JRLts,91dgzxhnfPYvnQK5GSbqVJ4XKPMxSoqATS78CEhnXNoG,True,26791849,6697962,41648,20824,20824,3zqXX6kzhkbW3d4TwD2CNjMRwxTbREXySekvq37kfCNk,1665945,3620801,-1954856,621
2022-03-27 18:26:00-04:00,13823,FcXe2wJqFzVRpRMSsPwzmwKAQ7f9CfHmwCt99k1cQeE1,BFjwToxLi3yzSDP13XqEXifQXahGyr5BWPBJyiM2iaai,True,54640315,5037268,31397,15698,15699,3zqXX6kzhkbW3d4TwD2CNjMRwxTbREXySekvq37kfCNk,3405776,14733688,-11327912,623
2022-03-27 18:26:00-04:00,13824,BKh4M4RqABRMxV6WuHRwMtX7f1C7KmJZg7UC85HWBU9,AxnhkR43eVPWrSZwrLkZ9GqERfYRbANwXqPurK21joJW,True,494264035,123566008,758003,379001,379002,3zqXX6kzhkbW3d4TwD2CNjMRwxTbREXySekvq37kfCNk,30320121,74604737,-44284616,613
2022-03-27 18:26:00-04:00,13825,HZ7AK8m2hQ5JSKV6dU97VJjKbhdAj91aLHkmckXGBam6,Aw4qaqgEsxys52J5a97wAjfFavYKFZEAYEpBgkzi4pLW,True,3003843371,750960842,4680646,2340323,2340323,3zqXX6kzhkbW3d4TwD2CNjMRwxTbREXySekvq37kfCNk,187225870,658563286,-471337416,623
2022-03-27 18:26:04-04:00,13826,H7wVZszBQdmFuwMUYAw4SSYbjxeFY1QvNBuT8QiqTxZS,CUm235keNKnVd2BaCNp5a6HePtWGMo8dq8S1KXf2KRR4,True,155696239,38924059,240843,120421,120422,YQC4EUcgeBi9431viwvzvBbZJW3szeHX4dFmowRDyDw,9633747,17439507,-7805760,618
2022-03-27 19:22:23-04:00,13827,AkGQxVK2FFRi9doFRx5gwGXBr6WKknvU3evZkDu3Yas4,Abu1FYCyBSutkrvrx56tL61xoDyYSCjwrDU1wnKn2gin,True,130414623,32603655,203331,101665,101666,3zqXX6kzhkbW3d4TwD2CNjMRwxTbREXySekvq37kfCNk,8133278,34736370,-26603092,623
2022-03-27 19:22:32-04:00,13828,AT4qoJDVGXpEm3BGACUhC1zpVNLq4iX2bJ4cpABehpoD,AqaDPXbaY6ksVQwWGKorgBdRQMz3VpqxmHdWXmq17ScF,True,14610165039,3652541259,22767743,11383871,11383872,3zqXX6kzhkbW3d4TwD2CNjMRwxTbREXySekvq37kfCNk,910709723,3674519095,-2763809372,623
2022-03-27 19:23:11-04:00,13829,A11mzoTX3dyc9gACVJkbRGZ6QACJsrF3ZHJUsGEtRnsj,H7z8CfHxnxo3mPrvxfiLLNwrDX1cxGWWDUxXs9EpzSi,True,58673299,14668324,91661,45830,45831,3zqXX6kzhkbW3d4TwD2CNjMRwxTbREXySekvq37kfCNk,3666467,8384777,-4718310,624
2022-03-27 19:23:13-04:00,13830,76MxXg67Q8CrmgUHJUQufvLmURy6k2DwpPfzVA8ar8AC,WHd5ddz9UZgSX66YkBPPnJFdqkaJqJ4KPLghCRCE1eP,True,53175676,13293919,82255,41127,41128,3zqXX6kzhkbW3d4TwD2CNjMRwxTbREXySekvq37kfCNk,3290216,7516158,-4225942,618
2022-03-27 19:23:16-04:00,13831,HegY1tDz2ki6vSf9FPRSF4dwGKyciGCt6bovVYdFJRk6,soWdvQVu9EW4Mkk5WUY6rZLA3cEXhFUKqNyY7kpg8ZD,True,58020381,5042451,31511,15755,15756,3zqXX6kzhkbW3d4TwD2CNjMRwxTbREXySekvq37kfCNk,3625908,15896320,-12270412,624
2022-03-27 19:25:52-04:00,13832,6Rk6wVu6pCDFwEWDbiY8wS93nDghyHP9kzdUEa6eFRRq,B5v7eFjSX6dDt1kt84Uvtqmrn7STbQPMbFMvjH6WGXJg,True,451094374,112773585,703332,351666,351666,3zqXX6kzhkbW3d4TwD2CNjMRwxTbREXySekvq37kfCNk,28133350,82665591,-54532241,623
2022-03-27 19:27:40-04:00,13833,AxUKatZukyU1PaNZzQFftBbga7GQC7nArZKv6wHCtXVR,HEqbmmGLsuxSSbqx931nFbbhhsNFNEx8Srf8J7wZr7pa,True,54635559,5030490,31350,15675,15675,3zqXX6kzhkbW3d4TwD2CNjMRwxTbREXySekvq37kfCNk,3404953,14728146,-11323193,623
2022-03-27 19:30:33-04:00,13834,2Tm69hQroe4dREXCLHubHfDTkDPohvcMEFuALmCpNZw6,4FH8oJspDa4TPVVXgzJzVM1eTHdnNvSf59C1A8m2PXoc,True,1089192916,108354197,677180,338590,338590,YQC4EUcgeBi9431viwvzvBbZJW3szeHX4dFmowRDyDw,68071216,115632965,-47561749,624
2022-03-27 19:31:12-04:00,13835,AzmKB7i1dJucc5Ec1mxpoJor662CDFKAAWRstWDtrmaq,Fd2bPyTR54f8fcTkUokCjcgYgReTGR9vN7ymaGXVcMDK,True,1308506809,327126702,2044127,1022063,1022064,YQC4EUcgeBi9431viwvzvBbZJW3szeHX4dFmowRDyDw,81765114,261903690,-180138576,624
2022-03-27 19:31:12-04:00,13836,4J7uT2PQnrfWazv3DJcM82i49WmTugyfpdmDvEjKLDks,HsyGm9ttVqNJp38udSabXHM11MTaNUdxnAT2fWKWz1HZ,True,80795590,20198897,126045,63022,63023,3zqXX6kzhkbW3d4TwD2CNjMRwxTbREXySekvq37kfCNk,5041835,21552786,-16510951,624
2022-03-27 19:33:07-04:00,13837,niCk6QHFU1kyU56Mdq5RJzKrecdkNSn23ZA6wduFdWS,BQbUYSw1XsuE6LnVd4XjmxAyYgx4drE4FsetJBCdwVZW,True,205133183,40108238,250018,125009,125009,YQC4EUcgeBi9431viwvzvBbZJW3szeHX4dFmowRDyDw,12787194,27973866,-15186672,623
2022-03-27 19:33:19-04:00,13838,6KGKhfpWXmDyPbXsBbisR5XyebepKXaK9DQuxu3zHVY,EkEvXBiDuHtF8S1rW5H2uGGaPcAsypaHF6VuJeeD8aP7,True,518755292982,81451405638,506798037,253399018,253399019,3zqXX6kzhkbW3d4TwD2CNjMRwxTbREXySekvq37kfCNk,32277425145,70695750021,-38418324876,622
2022-03-27 19:33:20-04:00,13839,3TCKVG1t5DCSXRdVXTN8uMxoDuhQ41WDYrcoKDz8byPL,Cm23o46LQekUd4f756Eq1shLCmZCAzEEdWpRcaMY1WVk,False,158412,158412,9457,472,8985,YQC4EUcgeBi9431viwvzvBbZJW3szeHX4dFmowRDyDw,9457,38947,-29490,596
2022-03-27 19:33:20-04:00,13840,HegY1tDz2ki6vSf9FPRSF4dwGKyciGCt6bovVYdFJRk6,soWdvQVu9EW4Mkk5WUY6rZLA3cEXhFUKqNyY7kpg8ZD,True,53281564,5006105,30918,15459,15459,YQC4EUcgeBi9431viwvzvBbZJW3szeHX4dFmowRDyDw,3290763,14759872,-11469109,617
2022-03-27 19:33:23-04:00,13841,FcXe2wJqFzVRpRMSsPwzmwKAQ7f9CfHmwCt99k1cQeE1,BFjwToxLi3yzSDP13XqEXifQXahGyr5BWPBJyiM2iaai,True,49873328,4741492,29509,14754,14755,YQC4EUcgeBi9431viwvzvBbZJW3szeHX4dFmowRDyDw,3103954,13602373,-10498419,622
2022-03-27 19:33:24-04:00,13842,GwfLBmVoBKibVLjH1DHEqsvyrqWGheK59s18BGrtunJg,CizH6WcFyEuTDkERDWxpnfbnHPBQUCLoM8CNaH2wX8Z8,False,14503559,14503559,893954,44697,849257,YQC4EUcgeBi9431viwvzvBbZJW3szeHX4dFmowRDyDw,893954,4052793,-3158839,616
2022-03-27 20:03:10-04:00,13843,HREFGG6Dedwcd81uY8UER88bgX9aNWF3ggADJW5NVpvj,3tMM6Rx63EaQCGQYDBcEdF4pLVLf3qRchsENd7zxDnam,True,762238681,93205781,582072,291036,291036,3zqXX6kzhkbW3d4TwD2CNjMRwxTbREXySekvq37kfCNk,47602018,213305147,-165703129,624
2022-03-27 20:31:09-04:00,13844,GTzLxRn226vTjN4HTSDSCjDLjwNiP4jsarG4umsA4CPc,6BWii3HLmdacnSS1pe8RkbbN6kbe4jpYYbnHqM1hh2G5,True,464967781,116241945,725799,362899,362900,3zqXX6kzhkbW3d4TwD2CNjMRwxTbREXySekvq37kfCNk,29031978,71354958,-42322980,624
2022-03-27 20:31:20-04:00,13845,Bmqae54jhWBLPKUhbE9qJN3Wfy56zR9U6kygyvPjin4Y,EV6XRL5dMERF3yWBQYeXscBiqWwGQ3mYXApdqBUZnhj9,True,294128013,73532003,459440,229720,229720,3zqXX6kzhkbW3d4TwD2CNjMRwxTbREXySekvq37kfCNk,18377626,74905321,-56527695,624
2022-03-27 20:32:27-04:00,13846,2Gfse9HBrkdSHZrKFk2Lbabmw7Mf9SAGpTftge3QCzfh,7bEeqMeSHXDSZzPu6sZEtHCUs1uZRXqWfz9FHwD9gBGS,True,372325895,93081473,581512,290756,290756,3zqXX6kzhkbW3d4TwD2CNjMRwxTbREXySekvq37kfCNk,23260489,58128223,-34867734,624
2022-03-27 20:32:31-04:00,13847,EeztHR1M4PPacJEZ6c5arCRVCuu8aN7eGdpY1u4bev79,9Twdc9Xrzv2oeJ9Fbd8mRvzjbFi7mkGopFS37SMabeAK,False,1973232,1973232,123260,6163,117097,YQC4EUcgeBi9431viwvzvBbZJW3szeHX4dFmowRDyDw,123260,514278,-391018,624
2022-03-27 20:32:35-04:00,13848,DgtZ1dBzCaR4K38CxgyhxaGCdwXM69N4CZDZ4nsZXYE4,8x5yYiS88nDTvj1v11s3J9kQ94S3j94NZvqfV9dxJuWJ,True,1312882517,328220629,2048615,1024307,1024308,3zqXX6kzhkbW3d4TwD2CNjMRwxTbREXySekvq37kfCNk,81944605,193022546,-111077941,624
2022-03-27 20:32:40-04:00,13849,5YC2wXkdk7D4Ubs9TEAbP1hi88Sy35bzYVWjLbgVxn5s,4Mx69ezqFK2wudZ62oVhx2pwjVbKv8JB1HR29ZUcdEJb,True,6234958697,1558739674,9735273,4867636,4867637,3zqXX6kzhkbW3d4TwD2CNjMRwxTbREXySekvq37kfCNk,389410933,1000927533,-611516600,624
2022-03-27 20:32:46-04:00,13850,AxUKatZukyU1PaNZzQFftBbga7GQC7nArZKv6wHCtXVR,HEqbmmGLsuxSSbqx931nFbbhhsNFNEx8Srf8J7wZr7pa,True,49863372,4763870,29757,14878,14879,YQC4EUcgeBi9431viwvzvBbZJW3szeHX4dFmowRDyDw,3114710,13603201,-10488491,624
2022-03-27 20:32:51-04:00,13851,3Gkfjg2BFLhzvTArvUb7t4EqjMevBgjLYHiQ62bMjC5q,oNcVBNCpeMzQDMqat31fDFi8x4G7Af3Rsm4uSMwngdb,True,32005835,8001458,48954,24477,24477,YQC4EUcgeBi9431viwvzvBbZJW3szeHX4dFmowRDyDw,1958161,3962570,-2004409,611
2022-03-27 20:34:03-04:00,13852,7RCDGRGZPnFcUdKEaewrP815tuYDwWDmWytdHK6AaoqA,7WWDb3AVBpkpfpqcGV44LU2QXqsFTQhrJZ7tvae43p5L,True,44443107,8051738,49901,24950,24951,YQC4EUcgeBi9431viwvzvBbZJW3szeHX4dFmowRDyDw,2754410,7729450,-4975040,619
2022-03-27 20:34:05-04:00,13853,HegY1tDz2ki6vSf9FPRSF4dwGKyciGCt6bovVYdFJRk6,soWdvQVu9EW4Mkk5WUY6rZLA3cEXhFUKqNyY7kpg8ZD,True,48507466,4564073,28483,14241,14242,3zqXX6kzhkbW3d4TwD2CNjMRwxTbREXySekvq37kfCNk,3027266,13472273,-10445007,624
2022-03-27 20:34:06-04:00,13854,AdhLnfiTUme12n7GxSwQXVV5EUYFLqFKtwqjc3DHdu4a,GXzNAxZ6x3zDd3Ctvc43Ct1tuq22YG72VtfZ4FNfpFhL,True,51293711,10565268,66002,33001,33001,3zqXX6kzhkbW3d4TwD2CNjMRwxTbREXySekvq37kfCNk,3204365,5395517,-2191152,624
2022-03-27 20:34:12-04:00,13855,FcXe2wJqFzVRpRMSsPwzmwKAQ7f9CfHmwCt99k1cQeE1,BFjwToxLi3yzSDP13XqEXifQXahGyr5BWPBJyiM2iaai,True,45372160,3934063,24569,12284,12285,3zqXX6kzhkbW3d4TwD2CNjMRwxTbREXySekvq37kfCNk,2833641,12768389,-9934748,624
2022-03-27 20:34:28-04:00,13856,2Tm69hQroe4dREXCLHubHfDTkDPohvcMEFuALmCpNZw6,4FH8oJspDa4TPVVXgzJzVM1eTHdnNvSf59C1A8m2PXoc,True,909716359,90394437,564427,282213,282214,3zqXX6kzhkbW3d4TwD2CNjMRwxTbREXySekvq37kfCNk,56803138,104329976,-47526838,624
2022-03-27 20:34:44-04:00,13857,AxUKatZukyU1PaNZzQFftBbga7GQC7nArZKv6wHCtXVR,HEqbmmGLsuxSSbqx931nFbbhhsNFNEx8Srf8J7wZr7pa,True,45351561,3936141,24587,12293,12294,3zqXX6kzhkbW3d4TwD2CNjMRwxTbREXySekvq37kfCNk,2832894,12747068,-9914174,624
2022-03-27 20:35:49-04:00,13858,5rv28YXtxD3bThdni7X4qz6ye1BNPx2S8yXur1vJeVfX,EPvM8N8DFVRHLKbuC9e4P6W2NF8kzGWFjq2eCEKM2Zfr,True,374972598,93743149,585499,292749,292750,YQC4EUcgeBi9431viwvzvBbZJW3szeHX4dFmowRDyDw,23419981,60909210,-37489229,624
2022-03-27 23:04:52-04:00,13859,3Gkfjg2BFLhzvTArvUb7t4EqjMevBgjLYHiQ62bMjC5q,oNcVBNCpeMzQDMqat31fDFi8x4G7Af3Rsm4uSMwngdb,True,24413131,6103282,37490,18745,18745,YQC4EUcgeBi9431viwvzvBbZJW3szeHX4dFmowRDyDw,1499638,3411706,-1912068,614
2022-03-28 00:32:57-04:00,13860,v8PjH3mAe252Zyh1iuPMigysGQZoZL1KncefGDw1ANx,2BDYraDRL6SekAjXy3rbGXCxmPt75gkEfhomEp9FzkUE,True,152142250563,17028277992,106378707,53189353,53189354,3zqXX6kzhkbW3d4TwD2CNjMRwxTbREXySekvq37kfCNk,9504599352,21665043777,-12160444425,624
2022-03-28 01:15:21-04:00,13861,v8PjH3mAe252Zyh1iuPMigysGQZoZL1KncefGDw1ANx,2BDYraDRL6SekAjXy3rbGXCxmPt75gkEfhomEp9FzkUE,True,136019861630,12814516361,79965821,39982910,39982911,3zqXX6kzhkbW3d4TwD2CNjMRwxTbREXySekvq37kfCNk,8487983265,20994343149,-12506359884,624
2022-03-28 01:30:32-04:00,13862,2ix7AR3FgZjmFiXAyrr9Jg63xUxgn8oDp3pcGP3Yfj23,Gm2QCdpM13K99ZMWGijYXM7Ur9sK4n67g4gDCap7r3r5,False,15033,15033,935,46,889,YQC4EUcgeBi9431viwvzvBbZJW3szeHX4dFmowRDyDw,935,3151,-2216,621
2022-03-28 01:31:48-04:00,13863,AkGQxVK2FFRi9doFRx5gwGXBr6WKknvU3evZkDu3Yas4,Abu1FYCyBSutkrvrx56tL61xoDyYSCjwrDU1wnKn2gin,True,99569930,24892482,154184,77092,77092,3zqXX6kzhkbW3d4TwD2CNjMRwxTbREXySekvq37kfCNk,6167396,27878777,-21711381,619
2022-03-28 01:31:51-04:00,13864,AT4qoJDVGXpEm3BGACUhC1zpVNLq4iX2bJ4cpABehpoD,AqaDPXbaY6ksVQwWGKorgBdRQMz3VpqxmHdWXmq17ScF,True,11149702114,2787425528,17386553,8693276,8693277,3zqXX6kzhkbW3d4TwD2CNjMRwxTbREXySekvq37kfCNk,695462151,2961680575,-2266218424,623
2022-03-28 01:31:57-04:00,13865,EG8G1DMZqXByLNtowrEJr9Rb4HnG89REC6NLsg8bdmep,94AvgT7uB6KfmKitJPYwPa6T9TScSnCQ5ziQG5VT5qSA,False,71057,71057,4304,215,4089,YQC4EUcgeBi9431viwvzvBbZJW3szeHX4dFmowRDyDw,4304,16269,-11965,605
2022-03-28 01:31:57-04:00,13866,A11mzoTX3dyc9gACVJkbRGZ6QACJsrF3ZHJUsGEtRnsj,H7z8CfHxnxo3mPrvxfiLLNwrDX1cxGWWDUxXs9EpzSi,True,44831274,11207818,68672,34336,34336,3zqXX6kzhkbW3d4TwD2CNjMRwxTbREXySekvq37kfCNk,2746896,7111951,-4365055,612
2022-03-28 01:31:58-04:00,13867,CLP8qmL8aN9ocJKYnbKSo4k46CU3LBsebspfREQcSGvo,F6tkkFJnvjYyPdSXDNzZMUfhd1o8dFiLyLPRZ5U1sXHE,True,45123800,11280950,67448,33724,33724,3zqXX6kzhkbW3d4TwD2CNjMRwxTbREXySekvq37kfCNk,2697921,12269008,-9571087,597
2022-03-28 01:31:59-04:00,13868,4BHydPKft6s7nYozhJ63rVrkQ22QywsrBQf2BAuW6mDS,8Tz6FZpzjoRBZqEwdPdkr4XGmURu3n1SjV3CTuc3o5yw,True,38258362,9564590,56959,28479,28480,3zqXX6kzhkbW3d4TwD2CNjMRwxTbREXySekvq37kfCNk,2278367,8794695,-6516328,595
2022-03-28 01:31:59-04:00,13869,HegY1tDz2ki6vSf9FPRSF4dwGKyciGCt6bovVYdFJRk6,soWdvQVu9EW4Mkk5WUY6rZLA3cEXhFUKqNyY7kpg8ZD,True,44204343,3843455,23764,11882,11882,YQC4EUcgeBi9431viwvzvBbZJW3szeHX4dFmowRDyDw,2733273,12625152,-9891879,618
2022-03-28 01:31:59-04:00,13870,EENJ9iyTJtHmiY3vGyrZFUqks3k74YPZcHyTLxCNtyNE,E8tKKqgVTy89xSKWG1HrZzyA8Na4mPWA8PmqbTg9ryET,True,9668162302,2417040575,14567597,7283798,7283799,3zqXX6kzhkbW3d4TwD2CNjMRwxTbREXySekvq37kfCNk,582703886,2882519447,-2299815561,602
2022-03-28 01:32:00-04:00,13871,76MxXg67Q8CrmgUHJUQufvLmURy6k2DwpPfzVA8ar8AC,WHd5ddz9UZgSX66YkBPPnJFdqkaJqJ4KPLghCRCE1eP,True,40645970,10161492,61057,30528,30529,3zqXX6kzhkbW3d4TwD2CNjMRwxTbREXySekvq37kfCNk,2442290,6375978,-3933688,600
2022-03-28 01:32:08-04:00,13872,4QJuKV4x6Wo4AsTA2Xsx7MwbjCrSVncnm6dkusWRg48J,EFhoiz3Td7yuFTo3NJBunx3pP4HHuk8yoNxk4gHqYTSt,False,4804,4804,284,14,270,EZEEdtBnevEDeAC4SSzUUgLixHHAukPwHtvyi5yeYbFW,284,1369,-1085,591
2022-03-28 01:33:12-04:00,13873,6Rk6wVu6pCDFwEWDbiY8wS93nDghyHP9kzdUEa6eFRRq,B5v7eFjSX6dDt1kt84Uvtqmrn7STbQPMbFMvjH6WGXJg,True,344278503,86069617,536498,268249,268249,YQC4EUcgeBi9431viwvzvBbZJW3szeHX4dFmowRDyDw,21459962,68318180,-46858218,623
2022-03-28 01:33:16-04:00,13874,Y22tWk4tECzARPFYM87xgBPZXaNsYMbkpRaRZAZZQDR,GPgSj6yDWD1odK4CAwzQgwqnW9RLJNXHo8tVba8DuEa1,False,310202,310202,19149,957,18192,YQC4EUcgeBi9431viwvzvBbZJW3szeHX4dFmowRDyDw,19149,66284,-47135,617
2022-03-28 01:33:20-04:00,13875,FcXe2wJqFzVRpRMSsPwzmwKAQ7f9CfHmwCt99k1cQeE1,BFjwToxLi3yzSDP13XqEXifQXahGyr5BWPBJyiM2iaai,True,41644179,3832148,23910,11955,11955,3zqXX6kzhkbW3d4TwD2CNjMRwxTbREXySekvq37kfCNk,2598423,11758312,-9159889,623
2022-03-28 01:33:29-04:00,13876,5GGcHTFi7PqKJdfyoc3CGNjxeQjcvuvgYf2c8EaJweuB,Cu7qDjNFpac1hHLQbdJ2iNH8o6q4hcd1R7tsV7MMopJv,False,1164667,1164667,72718,3635,69083,YQC4EUcgeBi9431viwvzvBbZJW3szeHX4dFmowRDyDw,72718,268417,-195699,624
2022-03-28 01:34:13-04:00,13877,4J7uT2PQnrfWazv3DJcM82i49WmTugyfpdmDvEjKLDks,HsyGm9ttVqNJp38udSabXHM11MTaNUdxnAT2fWKWz1HZ,True,61661141,15415285,96228,48114,48114,3zqXX6kzhkbW3d4TwD2CNjMRwxTbREXySekvq37kfCNk,3849138,17296837,-13447699,624
2022-03-28 01:34:15-04:00,13878,AzmKB7i1dJucc5Ec1mxpoJor662CDFKAAWRstWDtrmaq,Fd2bPyTR54f8fcTkUokCjcgYgReTGR9vN7ymaGXVcMDK,True,998656057,249664014,1560233,780116,780117,3zqXX6kzhkbW3d4TwD2CNjMRwxTbREXySekvq37kfCNk,62409333,214800119,-152390786,624
2022-03-28 01:35:03-04:00,13879,FjjU3VtoUbcgBtU8pxo96JfvXHppbQVGTyz4hJYiC7k4,8VztSSmeE9EfRwmfr22gdqviqdy7W5sATZLkuGWBMxP6,False,52422,52422,3238,161,3077,YQC4EUcgeBi9431viwvzvBbZJW3szeHX4dFmowRDyDw,3238,14974,-11736,617
2022-03-28 01:35:13-04:00,13880,AYQdtUZRag2htfExQ6oGFby4udBWuTZbhCaH3242MmgW,aiQaN2BxfgY59xzA1mZU12TC686SBxVAS4MGW2pniAJ,False,40661,40661,2508,125,2383,YQC4EUcgeBi9431viwvzvBbZJW3szeHX4dFmowRDyDw,2508,10302,-7794,616
2022-03-28 01:35:14-04:00,13881,HBYoCwAU3bgnxsrUpBcgEs1ppJxn7Firm8sgpQYCYnsM,EZEEdtBnevEDeAC4SSzUUgLixHHAukPwHtvyi5yeYbFW,True,83640866,20910216,130582,65291,65291,YQC4EUcgeBi9431viwvzvBbZJW3szeHX4dFmowRDyDw,5223295,8003848,-2780553,624
2022-03-28 01:35:44-04:00,13882,AxUKatZukyU1PaNZzQFftBbga7GQC7nArZKv6wHCtXVR,HEqbmmGLsuxSSbqx931nFbbhhsNFNEx8Srf8J7wZr7pa,True,41618537,3823669,23892,11946,11946,3zqXX6kzhkbW3d4TwD2CNjMRwxTbREXySekvq37kfCNk,2600634,11734909,-9134275,624
2022-03-28 01:35:51-04:00,13883,4srwVCqLz4ztWwdfMu9jXRy99UwMvWGN13mvLAVCUEg5,CbrNiF6CNCG3RiUHBG5AdoHmqwjDPsfUUtPno9DswcQM,False,3517649,3517649,216177,10808,205369,YQC4EUcgeBi9431viwvzvBbZJW3szeHX4dFmowRDyDw,216177,668257,-452080,614
2022-03-28 01:35:53-04:00,13884,niCk6QHFU1kyU56Mdq5RJzKrecdkNSn23ZA6wduFdWS,BQbUYSw1XsuE6LnVd4XjmxAyYgx4drE4FsetJBCdwVZW,True,167863474,30692705,191799,95899,95900,3zqXX6kzhkbW3d4TwD2CNjMRwxTbREXySekvq37kfCNk,10489861,22705107,-12215246,624
2022-03-28 01:40:50-04:00,13885,2PCcuGzx7sxcdHyNWoP4jyMWRP8wJonHD2Y4UGxBVvfo,4GFTJ1GRrgj64infmM3dH28GiasJgR4co5iR5MUwdSxx,False,144526,144526,9027,451,8576,YQC4EUcgeBi9431viwvzvBbZJW3szeHX4dFmowRDyDw,9027,27487,-18460,624
2022-03-28 01:46:12-04:00,13886,7orEnq4GXQgjZ1Q9TxgivgGquE1ZxZ6wg1MWuiWh9QhU,FrAoUJMdohhjWpJMgRNHrrZbWuXnfP2yZCAqTdc9BRke,False,142474,142474,8867,443,8424,YQC4EUcgeBi9431viwvzvBbZJW3szeHX4dFmowRDyDw,8867,28649,-19782,622
2022-03-28 01:46:17-04:00,13887,AkGQxVK2FFRi9doFRx5gwGXBr6WKknvU3evZkDu3Yas4,Abu1FYCyBSutkrvrx56tL61xoDyYSCjwrDU1wnKn2gin,True,75944927,18986231,118643,59321,59322,3zqXX6kzhkbW3d4TwD2CNjMRwxTbREXySekvq37kfCNk,4745733,22296804,-17551071,624
2022-03-28 01:46:25-04:00,13888,v8PjH3mAe252Zyh1iuPMigysGQZoZL1KncefGDw1ANx,2BDYraDRL6SekAjXy3rbGXCxmPt75gkEfhomEp9FzkUE,True,123874841694,11327287574,70762110,35381055,35381055,3zqXX6kzhkbW3d4TwD2CNjMRwxTbREXySekvq37kfCNk,7738521019,20438521497,-12700000478,624
2022-03-28 01:46:27-04:00,13889,HegY1tDz2ki6vSf9FPRSF4dwGKyciGCt6bovVYdFJRk6,soWdvQVu9EW4Mkk5WUY6rZLA3cEXhFUKqNyY7kpg8ZD,True,40542578,3835288,23912,11956,11956,3zqXX6kzhkbW3d4TwD2CNjMRwxTbREXySekvq37kfCNk,2527819,11711065,-9183246,623
2022-03-28 01:46:27-04:00,13890,AT4qoJDVGXpEm3BGACUhC1zpVNLq4iX2bJ4cpABehpoD,AqaDPXbaY6ksVQwWGKorgBdRQMz3VpqxmHdWXmq17ScF,True,8509086208,2127271552,13281649,6640824,6640825,3zqXX6kzhkbW3d4TwD2CNjMRwxTbREXySekvq37kfCNk,531265976,2378467252,-1847201276,624
2022-03-28 01:46:28-04:00,13891,CLP8qmL8aN9ocJKYnbKSo4k46CU3LBsebspfREQcSGvo,F6tkkFJnvjYyPdSXDNzZMUfhd1o8dFiLyLPRZ5U1sXHE,True,34334888,8583722,53460,26730,26730,YQC4EUcgeBi9431viwvzvBbZJW3szeHX4dFmowRDyDw,2138435,9808800,-7670365,622
2022-03-28 01:46:28-04:00,13892,4BHydPKft6s7nYozhJ63rVrkQ22QywsrBQf2BAuW6mDS,8Tz6FZpzjoRBZqEwdPdkr4XGmURu3n1SjV3CTuc3o5yw,True,29110945,7277736,45105,22552,22553,3zqXX6kzhkbW3d4TwD2CNjMRwxTbREXySekvq37kfCNk,1804235,7108663,-5304428,619
2022-03-28 01:47:19-04:00,13893,76MxXg67Q8CrmgUHJUQufvLmURy6k2DwpPfzVA8ar8AC,WHd5ddz9UZgSX66YkBPPnJFdqkaJqJ4KPLghCRCE1eP,False,31399502,31399502,1466209,73310,1392899,YQC4EUcgeBi9431viwvzvBbZJW3szeHX4dFmowRDyDw,1466209,5331510,-3865301,466
2022-03-28 01:47:19-04:00,13894,2Tm69hQroe4dREXCLHubHfDTkDPohvcMEFuALmCpNZw6,4FH8oJspDa4TPVVXgzJzVM1eTHdnNvSf59C1A8m2PXoc,True,741392005,75786910,434011,217005,217006,3zqXX6kzhkbW3d4TwD2CNjMRwxTbREXySekvq37kfCNk,42457597,92942221,-50484624,572
2022-03-28 01:47:19-04:00,13895,EENJ9iyTJtHmiY3vGyrZFUqks3k74YPZcHyTLxCNtyNE,E8tKKqgVTy89xSKWG1HrZzyA8Na4mPWA8PmqbTg9ryET,False,7469855406,7469855406,349402610,17470130,331932480,YQC4EUcgeBi9431viwvzvBbZJW3szeHX4dFmowRDyDw,349402610,2293520572,-1944117962,467
2022-03-28 01:47:20-04:00,13896,6Rk6wVu6pCDFwEWDbiY8wS93nDghyHP9kzdUEa6eFRRq,B5v7eFjSX6dDt1kt84Uvtqmrn7STbQPMbFMvjH6WGXJg,True,265755364,66438833,334423,167211,167212,3zqXX6kzhkbW3d4TwD2CNjMRwxTbREXySekvq37kfCNk,13376986,56067879,-42690893,503
2022-03-28 01:47:20-04:00,13897,429jPeeFjDTX93YH4wyuZKDsbTikueUnsFG6cvFQC3Nf,9npKGMooVRgrs4DP5JCRkjD5bM2Uu1R5YTCc6CXPe4mh,True,22531254,5632813,29977,14988,14989,3zqXX6kzhkbW3d4TwD2CNjMRwxTbREXySekvq37kfCNk,1199119,4233015,-3033896,532
2022-03-28 01:47:22-04:00,13898,CD72r5bjRGSd1tLsvDC9YQe5nPYBHexpXGPZvyMRdAwk,5syEXm5Dc1UgWAHfCmgooc4Wkjei8V5A1PR5MNWMPT7N,True,33707201,8426800,50109,25054,25055,3zqXX6kzhkbW3d4TwD2CNjMRwxTbREXySekvq37kfCNk,2004385,6308347,-4303962,594
2022-03-28 01:47:22-04:00,13899,9R52LDEW4iXndDw1WuVKCCEdJ4fD1n43wwUDGgVZbf1Y,4jyskz93s8y5nkMzo8x3xEKJaaKcybEnCZDCX5U4vYBF,True,2271014006605,259248174269,1591480523,795740261,795740262,3zqXX6kzhkbW3d4TwD2CNjMRwxTbREXySekvq37kfCNk,139413693887,856771816701,-717358122814,613
2022-03-28 01:47:23-04:00,13900,6qqBmN3Mmy56gXvtBwLUyQwJoh2cYKmMtP61Po9xgxRj,FySpFnWFTZAaYLZ2c8Lb9m89CJxj3ZFMcZTdcwRrEEGH,False,820077494,820077494,39985319,1999265,37986054,3zqXX6kzhkbW3d4TwD2CNjMRwxTbREXySekvq37kfCNk,39985319,149003731,-109018412,487
2022-03-28 01:47:23-04:00,13901,niCk6QHFU1kyU56Mdq5RJzKrecdkNSn23ZA6wduFdWS,BQbUYSw1XsuE6LnVd4XjmxAyYgx4drE4FsetJBCdwVZW,True,140109107,35027276,183992,91996,91996,3zqXX6kzhkbW3d4TwD2CNjMRwxTbREXySekvq37kfCNk,7359724,18132873,-10773149,525
2022-03-28 01:47:23-04:00,13902,2Tm69hQroe4dREXCLHubHfDTkDPohvcMEFuALmCpNZw6,4FH8oJspDa4TPVVXgzJzVM1eTHdnNvSf59C1A8m2PXoc,True,667975969,64326008,381854,190927,190927,3zqXX6kzhkbW3d4TwD2CNjMRwxTbREXySekvq37kfCNk,39652712,88952418,-49299706,593
2022-03-28 01:47:23-04:00,13903,AT4qoJDVGXpEm3BGACUhC1zpVNLq4iX2bJ4cpABehpoD,AqaDPXbaY6ksVQwWGKorgBdRQMz3VpqxmHdWXmq17ScF,True,6541643063,1635410765,8953898,4476949,4476949,3zqXX6kzhkbW3d4TwD2CNjMRwxTbREXySekvq37kfCNk,358155920,1903798191,-1545642271,547
2022-03-28 01:47:24-04:00,13904,A11mzoTX3dyc9gACVJkbRGZ6QACJsrF3ZHJUsGEtRnsj,H7z8CfHxnxo3mPrvxfiLLNwrDX1cxGWWDUxXs9EpzSi,True,34351123,8587780,48763,24381,24382,3zqXX6kzhkbW3d4TwD2CNjMRwxTbREXySekvq37kfCNk,1950557,5952028,-4001471,567
2022-03-28 01:47:24-04:00,13905,3Qauv179unF6Lj5nierv8UzijeYSV5r2eedE7uH5t5zu,TjTYpji1EcSidxX6n1r76Ce8Awbf7jZbTj3o5wUAmgk,False,57513,57513,3319,165,3154,YQC4EUcgeBi9431viwvzvBbZJW3szeHX4dFmowRDyDw,3319,16041,-12722,577
2022-03-28 01:47:25-04:00,13906,3MJWM6aknu6UM3Fhy79zFBqwdgFiJRSKD7vt146oGUWo,3cSepXowxnfbijr3FJuPCVwQuPbhioEvq7RVaJMm9nnq,False,267943,267943,16031,801,15230,YQC4EUcgeBi9431viwvzvBbZJW3szeHX4dFmowRDyDw,16031,51627,-35596,598
2022-03-28 01:47:27-04:00,13907,Fi3t3YvraGMh2meqW3EHC976qLj4WHbG7gZQQ3BF94L9,DSBz6jKDLWfWWFufKjXXwiCUHtDSwufCEpjEQ9yWtVFm,False,1417387,1417387,87108,4355,82753,72FwbpFGoLEazJEdpqNtPNefsadUrimUqma9wSoy4qiS,87108,269394,-182286,614
2022-03-28 01:47:32-04:00,13908,zuCM1fMKnuKrpoy1zB9cQiFrkpiZXmrScN8e1coVEdF,J2eUoBRmW6k4BzKL2EMQ7a8MLreGdtvH6a4rn6vd39Pt,False,171493,171493,10271,513,9758,YQC4EUcgeBi9431viwvzvBbZJW3szeHX4dFmowRDyDw,10271,39757,-29486,598
2022-03-28 01:52:03-04:00,13909,FcXe2wJqFzVRpRMSsPwzmwKAQ7f9CfHmwCt99k1cQeE1,BFjwToxLi3yzSDP13XqEXifQXahGyr5BWPBJyiM2iaai,True,38031207,3591687,22243,11121,11122,3zqXX6kzhkbW3d4TwD2CNjMRwxTbREXySekvq37kfCNk,2355337,10855371,-8500034,619
2022-03-28 01:52:04-04:00,13910,4J7uT2PQnrfWazv3DJcM82i49WmTugyfpdmDvEjKLDks,HsyGm9ttVqNJp38udSabXHM11MTaNUdxnAT2fWKWz1HZ,True,47129394,11782348,71734,35867,35867,YQC4EUcgeBi9431viwvzvBbZJW3szeHX4dFmowRDyDw,2869372,13838706,-10969334,608
2022-03-28 01:52:06-04:00,13911,AzmKB7i1dJucc5Ec1mxpoJor662CDFKAAWRstWDtrmaq,Fd2bPyTR54f8fcTkUokCjcgYgReTGR9vN7ymaGXVcMDK,True,763261879,190815469,1164481,582240,582241,3zqXX6kzhkbW3d4TwD2CNjMRwxTbREXySekvq37kfCNk,46579264,175148377,-128569113,610
2022-03-28 01:52:14-04:00,13912,HBYoCwAU3bgnxsrUpBcgEs1ppJxn7Firm8sgpQYCYnsM,EZEEdtBnevEDeAC4SSzUUgLixHHAukPwHtvyi5yeYbFW,True,63868726,15967181,98865,49432,49433,3zqXX6kzhkbW3d4TwD2CNjMRwxTbREXySekvq37kfCNk,3954637,7178177,-3223540,619
2022-03-28 01:52:57-04:00,13913,5B1hTu14cEQS6SNY45RrFMUhG8nRv1CGMLog4hCBmBoH,CTLp3MQcZzPA275nkCz5D5Sm1tfwDDkV4Tyqqovpzp8f,False,64668,64668,4032,201,3831,YQC4EUcgeBi9431viwvzvBbZJW3szeHX4dFmowRDyDw,4032,15517,-11485,623
2022-03-28 01:53:02-04:00,13914,AxUKatZukyU1PaNZzQFftBbga7GQC7nArZKv6wHCtXVR,HEqbmmGLsuxSSbqx931nFbbhhsNFNEx8Srf8J7wZr7pa,True,37997681,3581324,22374,11187,11187,3zqXX6kzhkbW3d4TwD2CNjMRwxTbREXySekvq37kfCNk,2373929,10840458,-8466529,624
2022-03-28 01:53:53-04:00,13915,v8PjH3mAe252Zyh1iuPMigysGQZoZL1KncefGDw1ANx,2BDYraDRL6SekAjXy3rbGXCxmPt75gkEfhomEp9FzkUE,True,113152082813,9552944483,59631819,29815909,29815910,3zqXX6kzhkbW3d4TwD2CNjMRwxTbREXySekvq37kfCNk,7063230216,18451817086,-11388586870,624
2022-03-28 01:54:17-04:00,13916,HegY1tDz2ki6vSf9FPRSF4dwGKyciGCt6bovVYdFJRk6,soWdvQVu9EW4Mkk5WUY6rZLA3cEXhFUKqNyY7kpg8ZD,True,36905128,3423085,21389,10694,10695,3zqXX6kzhkbW3d4TwD2CNjMRwxTbREXySekvq37kfCNk,2306069,10664361,-8358292,624
2022-03-28 01:54:31-04:00,13917,GP2fiNyYQqm2QuNbTanAwtQzkS5YiXQmiGoLrjCpCJ4X,6sVdFAHGfHbzHFtZb1Zy4xkWyTGrJP9z8r8MWfKNptVG,False,732415,732415,45707,2285,43422,YQC4EUcgeBi9431viwvzvBbZJW3szeHX4dFmowRDyDw,45707,140680,-94973,624
2022-03-28 01:54:41-04:00,13918,AkGQxVK2FFRi9doFRx5gwGXBr6WKknvU3evZkDu3Yas4,Abu1FYCyBSutkrvrx56tL61xoDyYSCjwrDU1wnKn2gin,True,57966792,14491698,90474,45237,45237,3zqXX6kzhkbW3d4TwD2CNjMRwxTbREXySekvq37kfCNk,3618994,17790425,-14171431,624
2022-03-28 01:56:37-04:00,13919,HREFGG6Dedwcd81uY8UER88bgX9aNWF3ggADJW5NVpvj,3tMM6Rx63EaQCGQYDBcEdF4pLVLf3qRchsENd7zxDnam,True,673952605,79092381,492640,246320,246320,3zqXX6kzhkbW3d4TwD2CNjMRwxTbREXySekvq37kfCNk,41978357,189862054,-147883697,622
2022-03-28 07:32:07-04:00,13920,HREFGG6Dedwcd81uY8UER88bgX9aNWF3ggADJW5NVpvj,3tMM6Rx63EaQCGQYDBcEdF4pLVLf3qRchsENd7zxDnam,True,598935647,70569440,439504,219752,219752,YQC4EUcgeBi9431viwvzvBbZJW3szeHX4dFmowRDyDw,37301539,172943238,-135641699,622
2022-03-28 07:46:51-04:00,13921,FcXe2wJqFzVRpRMSsPwzmwKAQ7f9CfHmwCt99k1cQeE1,BFjwToxLi3yzSDP13XqEXifQXahGyr5BWPBJyiM2iaai,True,34606134,3062038,19135,9567,9568,3zqXX6kzhkbW3d4TwD2CNjMRwxTbREXySekvq37kfCNk,2162620,10190702,-8028082,624
2022-03-28 09:36:16-04:00,13922,AxUKatZukyU1PaNZzQFftBbga7GQC7nArZKv6wHCtXVR,HEqbmmGLsuxSSbqx931nFbbhhsNFNEx8Srf8J7wZr7pa,True,34602065,3045149,19016,9508,9508,3zqXX6kzhkbW3d4TwD2CNjMRwxTbREXySekvq37kfCNk,2160902,10184934,-8024032,624
2022-03-28 09:36:18-04:00,13923,4S7Ky4QBiqRWUFYsCcsSnijMTPsNNcDDSAHNyS9Mvzo2,DsdFdR1MT5pdU196PCYM6a5os3TAiAg6fUweGAugHsb8,True,57089171,14272292,88993,44496,44497,3zqXX6kzhkbW3d4TwD2CNjMRwxTbREXySekvq37kfCNk,3559755,18646904,-15087149,623
2022-03-28 09:38:11-04:00,13924,HegY1tDz2ki6vSf9FPRSF4dwGKyciGCt6bovVYdFJRk6,soWdvQVu9EW4Mkk5WUY6rZLA3cEXhFUKqNyY7kpg8ZD,True,33659865,2919729,18233,9116,9117,3zqXX6kzhkbW3d4TwD2CNjMRwxTbREXySekvq37kfCNk,2102018,10027541,-7925523,624
2022-03-28 09:38:12-04:00,13925,6fSdeis6nFxh1SZusjL6cReVZLqVPTK4bo33XY1JRLts,91dgzxhnfPYvnQK5GSbqVJ4XKPMxSoqATS78CEhnXNoG,True,20432593,5108148,31881,15940,15941,3zqXX6kzhkbW3d4TwD2CNjMRwxTbREXySekvq37kfCNk,1275255,3080110,-1804855,624
2022-03-28 09:52:39-04:00,13926,BKh4M4RqABRMxV6WuHRwMtX7f1C7KmJZg7UC85HWBU9,AxnhkR43eVPWrSZwrLkZ9GqERfYRbANwXqPurK21joJW,True,376633590,94158397,585904,292952,292952,3zqXX6kzhkbW3d4TwD2CNjMRwxTbREXySekvq37kfCNk,23436183,62587635,-39151452,622
2022-03-28 09:52:53-04:00,13927,FcXe2wJqFzVRpRMSsPwzmwKAQ7f9CfHmwCt99k1cQeE1,BFjwToxLi3yzSDP13XqEXifQXahGyr5BWPBJyiM2iaai,True,31705318,2912787,18201,9100,9101,3zqXX6kzhkbW3d4TwD2CNjMRwxTbREXySekvq37kfCNk,1981163,9323270,-7342107,624
2022-03-28 09:52:55-04:00,13928,HZ7AK8m2hQ5JSKV6dU97VJjKbhdAj91aLHkmckXGBam6,Aw4qaqgEsxys52J5a97wAjfFavYKFZEAYEpBgkzi4pLW,True,2291268615,572817153,3575059,1787529,1787530,3zqXX6kzhkbW3d4TwD2CNjMRwxTbREXySekvq37kfCNk,143002395,534974571,-391972176,624
2022-03-28 09:54:32-04:00,13929,GTzLxRn226vTjN4HTSDSCjDLjwNiP4jsarG4umsA4CPc,6BWii3HLmdacnSS1pe8RkbbN6kbe4jpYYbnHqM1hh2G5,True,354750939,88687734,552871,276435,276436,YQC4EUcgeBi9431viwvzvBbZJW3szeHX4dFmowRDyDw,22114858,59884339,-37769481,623
2022-03-28 09:55:24-04:00,13930,Bmqae54jhWBLPKUhbE9qJN3Wfy56zR9U6kygyvPjin4Y,EV6XRL5dMERF3yWBQYeXscBiqWwGQ3mYXApdqBUZnhj9,True,224496232,56124058,347822,173911,173911,3zqXX6kzhkbW3d4TwD2CNjMRwxTbREXySekvq37kfCNk,13912895,60209650,-46296755,619
2022-03-28 09:55:45-04:00,13931,AxUKatZukyU1PaNZzQFftBbga7GQC7nArZKv6wHCtXVR,HEqbmmGLsuxSSbqx931nFbbhhsNFNEx8Srf8J7wZr7pa,True,31725534,2914664,18128,9064,9064,YQC4EUcgeBi9431viwvzvBbZJW3szeHX4dFmowRDyDw,1973268,9335612,-7362344,621
2022-03-28 09:56:13-04:00,13932,HREFGG6Dedwcd81uY8UER88bgX9aNWF3ggADJW5NVpvj,3tMM6Rx63EaQCGQYDBcEdF4pLVLf3qRchsENd7zxDnam,True,532022504,60233012,375707,187853,187854,YQC4EUcgeBi9431viwvzvBbZJW3szeHX4dFmowRDyDw,33185254,154763294,-121578040,623
2022-03-28 09:56:15-04:00,13933,A11mzoTX3dyc9gACVJkbRGZ6QACJsrF3ZHJUsGEtRnsj,H7z8CfHxnxo3mPrvxfiLLNwrDX1cxGWWDUxXs9EpzSi,True,26044277,6511069,40542,20271,20271,3zqXX6kzhkbW3d4TwD2CNjMRwxTbREXySekvq37kfCNk,1621711,4903755,-3282044,622
2022-03-28 09:56:28-04:00,13934,4BHydPKft6s7nYozhJ63rVrkQ22QywsrBQf2BAuW6mDS,8Tz6FZpzjoRBZqEwdPdkr4XGmURu3n1SjV3CTuc3o5yw,True,22213103,5553275,34499,17249,17250,3zqXX6kzhkbW3d4TwD2CNjMRwxTbREXySekvq37kfCNk,1379962,5738182,-4358220,621
2022-03-28 09:56:32-04:00,13935,HegY1tDz2ki6vSf9FPRSF4dwGKyciGCt6bovVYdFJRk6,soWdvQVu9EW4Mkk5WUY6rZLA3cEXhFUKqNyY7kpg8ZD,True,30893896,2927030,18285,9142,9143,3zqXX6kzhkbW3d4TwD2CNjMRwxTbREXySekvq37kfCNk,1930025,9304426,-7374401,624
2022-03-28 09:57:28-04:00,13936,CLP8qmL8aN9ocJKYnbKSo4k46CU3LBsebspfREQcSGvo,F6tkkFJnvjYyPdSXDNzZMUfhd1o8dFiLyLPRZ5U1sXHE,True,26201505,6550376,40887,20443,20444,3zqXX6kzhkbW3d4TwD2CNjMRwxTbREXySekvq37kfCNk,1635492,7838611,-6203119,624
2022-03-28 10:32:30-04:00,13937,3Gkfjg2BFLhzvTArvUb7t4EqjMevBgjLYHiQ62bMjC5q,oNcVBNCpeMzQDMqat31fDFi8x4G7Af3Rsm4uSMwngdb,True,18610024,4652506,29000,14500,14500,3zqXX6kzhkbW3d4TwD2CNjMRwxTbREXySekvq37kfCNk,1160000,2894230,-1734230,623
2022-03-28 10:47:36-04:00,13938,v8PjH3mAe252Zyh1iuPMigysGQZoZL1KncefGDw1ANx,2BDYraDRL6SekAjXy3rbGXCxmPt75gkEfhomEp9FzkUE,True,104104468280,8664627700,53970501,26985250,26985251,3zqXX6kzhkbW3d4TwD2CNjMRwxTbREXySekvq37kfCNk,6484491406,18072344441,-11587853035,622
2022-03-28 10:47:37-04:00,13939,CD72r5bjRGSd1tLsvDC9YQe5nPYBHexpXGPZvyMRdAwk,5syEXm5Dc1UgWAHfCmgooc4Wkjei8V5A1PR5MNWMPT7N,True,25646614,6411653,39720,19860,19860,YQC4EUcgeBi9431viwvzvBbZJW3szeHX4dFmowRDyDw,1588831,5183022,-3594191,619
2022-03-28 10:47:38-04:00,13940,6Rk6wVu6pCDFwEWDbiY8wS93nDghyHP9kzdUEa6eFRRq,B5v7eFjSX6dDt1kt84Uvtqmrn7STbQPMbFMvjH6WGXJg,True,200330105,50082518,300873,150436,150437,YQC4EUcgeBi9431viwvzvBbZJW3szeHX4dFmowRDyDw,12034990,45067162,-33032172,600
2022-03-28 10:47:44-04:00,13941,5BSr2tqthLtZfR2Dcq1hndaU2URYFNzdfjh3evp4kUnV,HcTxCpo9CeQMAjvXE9668B2LQHJXNqEUsPABLputs7Nm,True,150271891,37567972,234575,117287,117288,3zqXX6kzhkbW3d4TwD2CNjMRwxTbREXySekvq37kfCNk,9383037,27556804,-18173767,624
2022-03-28 10:47:44-04:00,13942,429jPeeFjDTX93YH4wyuZKDsbTikueUnsFG6cvFQC3Nf,9npKGMooVRgrs4DP5JCRkjD5bM2Uu1R5YTCc6CXPe4mh,True,17014995,4253748,26327,13163,13164,YQC4EUcgeBi9431viwvzvBbZJW3szeHX4dFmowRDyDw,1053097,3445076,-2391979,618
2022-03-28 10:47:59-04:00,13943,AzmKB7i1dJucc5Ec1mxpoJor662CDFKAAWRstWDtrmaq,Fd2bPyTR54f8fcTkUokCjcgYgReTGR9vN7ymaGXVcMDK,True,581542237,145385559,908407,454203,454204,3zqXX6kzhkbW3d4TwD2CNjMRwxTbREXySekvq37kfCNk,36336316,141862491,-105526175,624
2022-03-28 10:48:00-04:00,13944,4J7uT2PQnrfWazv3DJcM82i49WmTugyfpdmDvEjKLDks,HsyGm9ttVqNJp38udSabXHM11MTaNUdxnAT2fWKWz1HZ,True,35936617,8984154,55228,27614,27614,3zqXX6kzhkbW3d4TwD2CNjMRwxTbREXySekvq37kfCNk,2209139,11025723,-8816584,614
2022-03-28 10:48:27-04:00,13945,6NtCMv6nfNhBTXZdoUBYy52hUNWDFZNtdznX3BJsbePF,AEMV8N9T2ci7dny4DJGYWTjj2jdZCFb5rCRAviwDQ6gA,False,404482,404482,25155,1257,23898,3zqXX6kzhkbW3d4TwD2CNjMRwxTbREXySekvq37kfCNk,25155,84436,-59281,621
2022-03-28 10:49:33-04:00,13946,HBYoCwAU3bgnxsrUpBcgEs1ppJxn7Firm8sgpQYCYnsM,EZEEdtBnevEDeAC4SSzUUgLixHHAukPwHtvyi5yeYbFW,True,48718098,12179524,76016,38008,38008,3zqXX6kzhkbW3d4TwD2CNjMRwxTbREXySekvq37kfCNk,3040670,6274906,-3234236,624
2022-03-28 10:50:58-04:00,13947,FcXe2wJqFzVRpRMSsPwzmwKAQ7f9CfHmwCt99k1cQeE1,BFjwToxLi3yzSDP13XqEXifQXahGyr5BWPBJyiM2iaai,True,28946073,2717369,16981,8490,8491,3zqXX6kzhkbW3d4TwD2CNjMRwxTbREXySekvq37kfCNk,1808892,8606589,-6797697,624
2022-03-28 10:51:20-04:00,13948,v8PjH3mAe252Zyh1iuPMigysGQZoZL1KncefGDw1ANx,2BDYraDRL6SekAjXy3rbGXCxmPt75gkEfhomEp9FzkUE,True,95885153166,7141007620,44574594,22287297,22287297,YQC4EUcgeBi9431viwvzvBbZJW3szeHX4dFmowRDyDw,5985208319,16406890045,-10421681726,624
2022-03-28 10:51:21-04:00,13949,5seV37JfFeqX91yaDfiupi2Ms7yYuuZFHwZ42ovhTbdU,KqBKpYuGWPhC8iYvedTYb4k5Lu3y89UMxt46t8gvn6h,True,973709656,243427414,1511457,755728,755729,3zqXX6kzhkbW3d4TwD2CNjMRwxTbREXySekvq37kfCNk,60458295,182600951,-122142656,620
2022-03-28 10:51:37-04:00,13950,AxUKatZukyU1PaNZzQFftBbga7GQC7nArZKv6wHCtXVR,HEqbmmGLsuxSSbqx931nFbbhhsNFNEx8Srf8J7wZr7pa,True,28959471,2710131,16901,8450,8451,3zqXX6kzhkbW3d4TwD2CNjMRwxTbREXySekvq37kfCNk,1806013,8617123,-6811110,623
2022-03-28 10:52:06-04:00,13951,AT4qoJDVGXpEm3BGACUhC1zpVNLq4iX2bJ4cpABehpoD,AqaDPXbaY6ksVQwWGKorgBdRQMz3VpqxmHdWXmq17ScF,True,4946914356,1236728589,7716658,3858329,3858329,3zqXX6kzhkbW3d4TwD2CNjMRwxTbREXySekvq37kfCNk,308666344,1508815222,-1200148878,623
2022-03-28 10:52:33-04:00,13952,AkGQxVK2FFRi9doFRx5gwGXBr6WKknvU3evZkDu3Yas4,Abu1FYCyBSutkrvrx56tL61xoDyYSCjwrDU1wnKn2gin,True,44240334,11060083,69114,34557,34557,3zqXX6kzhkbW3d4TwD2CNjMRwxTbREXySekvq37kfCNk,2764588,14158419,-11393831,624
2022-03-28 10:55:03-04:00,13953,4BHydPKft6s7nYozhJ63rVrkQ22QywsrBQf2BAuW6mDS,8Tz6FZpzjoRBZqEwdPdkr4XGmURu3n1SjV3CTuc3o5yw,True,16958362,4239590,26172,13086,13086,YQC4EUcgeBi9431viwvzvBbZJW3szeHX4dFmowRDyDw,1046886,4614088,-3567202,617
2022-03-28 10:55:06-04:00,13954,A11mzoTX3dyc9gACVJkbRGZ6QACJsrF3ZHJUsGEtRnsj,H7z8CfHxnxo3mPrvxfiLLNwrDX1cxGWWDUxXs9EpzSi,True,19874010,4968502,31007,15503,15504,3zqXX6kzhkbW3d4TwD2CNjMRwxTbREXySekvq37kfCNk,1240316,4042655,-2802339,624
2022-03-28 11:12:19-04:00,13955,2Gfse9HBrkdSHZrKFk2Lbabmw7Mf9SAGpTftge3QCzfh,7bEeqMeSHXDSZzPu6sZEtHCUs1uZRXqWfz9FHwD9gBGS,True,284032243,71008060,443603,221801,221802,3zqXX6kzhkbW3d4TwD2CNjMRwxTbREXySekvq37kfCNk,17744120,48684109,-30939989,624
2022-03-28 11:23:45-04:00,13956,v8PjH3mAe252Zyh1iuPMigysGQZoZL1KncefGDw1ANx,2BDYraDRL6SekAjXy3rbGXCxmPt75gkEfhomEp9FzkUE,True,89115558857,6873346429,42945066,21472533,21472533,3zqXX6kzhkbW3d4TwD2CNjMRwxTbREXySekvq37kfCNk,5567991703,16151260705,-10583269002,624
2022-03-28 11:24:14-04:00,13957,HegY1tDz2ki6vSf9FPRSF4dwGKyciGCt6bovVYdFJRk6,soWdvQVu9EW4Mkk5WUY6rZLA3cEXhFUKqNyY7kpg8ZD,True,28122688,2598791,16217,8108,8109,3zqXX6kzhkbW3d4TwD2CNjMRwxTbREXySekvq37kfCNk,1755013,8467578,-6712565,624
2022-03-28 11:25:45-04:00,13958,DgtZ1dBzCaR4K38CxgyhxaGCdwXM69N4CZDZ4nsZXYE4,8x5yYiS88nDTvj1v11s3J9kQ94S3j94NZvqfV9dxJuWJ,True,1001463025,250365756,1564417,782208,782209,3zqXX6kzhkbW3d4TwD2CNjMRwxTbREXySekvq37kfCNk,62576685,162703454,-100126769,624
2022-03-28 12:20:44-04:00,13959,8qq2gfbca7JXvq4gViBBVT2QAbM4MvBMEQLXgn8UUTvt,3o5jpBVYdFFEYrGRdCUkLrUC85wsuTKgy8iYwnpZyC1B,True,3192400941,420543540,2623668,1311834,1311834,3zqXX6kzhkbW3d4TwD2CNjMRwxTbREXySekvq37kfCNk,199166089,871161224,-671995135,623
2022-03-28 12:46:33-04:00,13960,88awjJ2gbtVpwNCSwDLUbmtQM5xqGbJBwgEngdgUT8uV,7SE7JbDbRgsUzXUAnTrtCyzSCnEkLyYRuTQYRFqQ4rH9,True,115802454,28950613,180800,90400,90400,YQC4EUcgeBi9431viwvzvBbZJW3szeHX4dFmowRDyDw,7232009,14517369,-7285360,624
2022-03-28 13:53:20-04:00,13961,88awjJ2gbtVpwNCSwDLUbmtQM5xqGbJBwgEngdgUT8uV,7SE7JbDbRgsUzXUAnTrtCyzSCnEkLyYRuTQYRFqQ4rH9,True,88406208,22101552,137355,68677,68678,3zqXX6kzhkbW3d4TwD2CNjMRwxTbREXySekvq37kfCNk,5494223,12512690,-7018467,621
2022-03-28 14:22:40-04:00,13962,v8PjH3mAe252Zyh1iuPMigysGQZoZL1KncefGDw1ANx,2BDYraDRL6SekAjXy3rbGXCxmPt75gkEfhomEp9FzkUE,True,82602266336,6447725449,40290275,20145137,20145138,3zqXX6kzhkbW3d4TwD2CNjMRwxTbREXySekvq37kfCNk,5161615714,15487042778,-10325427064,624
2022-03-28 14:46:00-04:00,13963,v8PjH3mAe252Zyh1iuPMigysGQZoZL1KncefGDw1ANx,2BDYraDRL6SekAjXy3rbGXCxmPt75gkEfhomEp9FzkUE,True,76499793229,5625281631,35120037,17560018,17560019,3zqXX6kzhkbW3d4TwD2CNjMRwxTbREXySekvq37kfCNk,4776073097,14285785460,-9509712363,624
2022-03-28 14:48:17-04:00,13964,5YC2wXkdk7D4Ubs9TEAbP1hi88Sy35bzYVWjLbgVxn5s,4Mx69ezqFK2wudZ62oVhx2pwjVbKv8JB1HR29ZUcdEJb,True,4757982144,1189495536,7383365,3691682,3691683,3zqXX6kzhkbW3d4TwD2CNjMRwxTbREXySekvq37kfCNk,295334620,836116781,-540782161,620
2022-03-28 14:49:10-04:00,13965,HREFGG6Dedwcd81uY8UER88bgX9aNWF3ggADJW5NVpvj,3tMM6Rx63EaQCGQYDBcEdF4pLVLf3qRchsENd7zxDnam,True,474972586,53691824,334595,167297,167298,3zqXX6kzhkbW3d4TwD2CNjMRwxTbREXySekvq37kfCNk,29599231,141208045,-111608814,623
2022-03-28 14:52:24-04:00,13966,FcXe2wJqFzVRpRMSsPwzmwKAQ7f9CfHmwCt99k1cQeE1,BFjwToxLi3yzSDP13XqEXifQXahGyr5BWPBJyiM2iaai,True,26379046,2324960,14461,7230,7231,3zqXX6kzhkbW3d4TwD2CNjMRwxTbREXySekvq37kfCNk,1640864,8086375,-6445511,622
2022-03-28 14:52:24-04:00,13967,v8PjH3mAe252Zyh1iuPMigysGQZoZL1KncefGDw1ANx,2BDYraDRL6SekAjXy3rbGXCxmPt75gkEfhomEp9FzkUE,True,71172985109,5193008213,32413748,16206874,16206874,3zqXX6kzhkbW3d4TwD2CNjMRwxTbREXySekvq37kfCNk,4442479549,13821613101,-9379133552,624
2022-03-28 15:18:21-04:00,13968,88awjJ2gbtVpwNCSwDLUbmtQM5xqGbJBwgEngdgUT8uV,7SE7JbDbRgsUzXUAnTrtCyzSCnEkLyYRuTQYRFqQ4rH9,True,67443885,16860971,105205,52602,52603,47z82br5WdW2DZajdnPDPSSRRKsyAggqXqK6oPUwTaLf,4208211,10611335,-6403124,623
2022-03-28 17:03:07-04:00,13969,AxUKatZukyU1PaNZzQFftBbga7GQC7nArZKv6wHCtXVR,HEqbmmGLsuxSSbqx931nFbbhhsNFNEx8Srf8J7wZr7pa,True,26388313,2327677,14538,7269,7269,3zqXX6kzhkbW3d4TwD2CNjMRwxTbREXySekvq37kfCNk,1648182,8102972,-6454790,624
2022-03-28 19:19:34-04:00,13970,7CSCMFa9W52tBDVUbXbc3woAy3GByeA1wPJdp3MgznPa,3447ptuVFu6G8B6N63RmS8mRv4n9PfHneypHLvbeaGLn,True,10316171860,1165651125,7240469,3620234,3620235,47z82br5WdW2DZajdnPDPSSRRKsyAggqXqK6oPUwTaLf,640791493,1092177760,-451386267,621
2022-03-28 19:19:36-04:00,13971,8qq2gfbca7JXvq4gViBBVT2QAbM4MvBMEQLXgn8UUTvt,3o5jpBVYdFFEYrGRdCUkLrUC85wsuTKgy8iYwnpZyC1B,True,2742660140,314916264,1964772,982386,982386,47z82br5WdW2DZajdnPDPSSRRKsyAggqXqK6oPUwTaLf,171115430,822848431,-651733001,623
2022-03-28 19:20:46-04:00,13972,D3mQ4aGmHdD8QHuDzGx1ZGRMaM4eB32LzVp1dnt931wx,86icTdjxoqizRxHTrGPUjFkR7gaapLFMuYVLogWJZ12J,True,35435100,8858775,53039,26519,26520,47z82br5WdW2DZajdnPDPSSRRKsyAggqXqK6oPUwTaLf,2121575,3661281,-1539706,598
2022-03-28 19:20:52-04:00,13973,9GfDDypCCSZVA19wMaqoHLNKMHuHNEgmgUB5V8iAaeoL,8pLnmCLcuFpDbnMuPtM2XyYyxsWJBJR51oxDvL6hq9Hk,True,3321821297,830455324,5711037,2855518,2855519,72FwbpFGoLEazJEdpqNtPNefsadUrimUqma9wSoy4qiS,228441482,345721313,-117279831,687
2022-03-28 19:55:45-04:00,13974,9GfDDypCCSZVA19wMaqoHLNKMHuHNEgmgUB5V8iAaeoL,8pLnmCLcuFpDbnMuPtM2XyYyxsWJBJR51oxDvL6hq9Hk,True,2434811620,608702905,4154402,2077201,2077201,72FwbpFGoLEazJEdpqNtPNefsadUrimUqma9wSoy4qiS,166176092,311681505,-145505413,682
2022-03-28 20:08:21-04:00,13975,9GfDDypCCSZVA19wMaqoHLNKMHuHNEgmgUB5V8iAaeoL,8pLnmCLcuFpDbnMuPtM2XyYyxsWJBJR51oxDvL6hq9Hk,True,1788654016,447163504,3110846,1555423,1555423,72FwbpFGoLEazJEdpqNtPNefsadUrimUqma9wSoy4qiS,124433862,271569172,-147135310,695
2022-03-28 22:34:19-04:00,13976,Gr3vv3TmUeQWxjRfE1mLwhLt7TtdY33x5rrKAzjBTVJs,FZWoYYVfeJN8Y93Yw82jyE8DnC39dWMDjNi2NxffTdey,True,50420103,12605025,77583,38791,38792,3RdfgDvLvsdZG5Cf6hKiKMQMqfidyxHzjYvUx1FZpeHQ,3103334,8503438,-5400104,615
2022-03-28 22:55:51-04:00,13977,88awjJ2gbtVpwNCSwDLUbmtQM5xqGbJBwgEngdgUT8uV,7SE7JbDbRgsUzXUAnTrtCyzSCnEkLyYRuTQYRFqQ4rH9,True,51463608,12865902,80251,40125,40126,YQC4EUcgeBi9431viwvzvBbZJW3szeHX4dFmowRDyDw,3210046,8893108,-5683062,623
2022-03-28 23:00:12-04:00,13978,GNWK9cTrChbcAqTWaonyQ1SKWh1PELcRzATeKra7Cj7m,G5bQaczo8MNq3GHLx9V6UtX6N2EfzQYuEQ64Tm2E8RHK,True,130635248,32658812,204063,102031,102032,3RdfgDvLvsdZG5Cf6hKiKMQMqfidyxHzjYvUx1FZpeHQ,8162549,51393357,-43230808,624
2022-03-28 23:14:47-04:00,13979,9JYkdQkHpsKvahhLjrdPevjQ9YR5WhirDc8N7imwT7P1,2PhTT3abP2XPdjk8KXawH36yRrttxGBGezV5rGiRkcKN,False,2209636,2209636,137942,6897,131045,YQC4EUcgeBi9431viwvzvBbZJW3szeHX4dFmowRDyDw,137943,219055,-81112,624
2022-03-28 23:32:41-04:00,13980,Gr3vv3TmUeQWxjRfE1mLwhLt7TtdY33x5rrKAzjBTVJs,FZWoYYVfeJN8Y93Yw82jyE8DnC39dWMDjNi2NxffTdey,True,38438442,9609610,60022,30011,30011,YQC4EUcgeBi9431viwvzvBbZJW3szeHX4dFmowRDyDw,2400909,7074365,-4673456,624
2022-03-29 00:19:16-04:00,13981,88awjJ2gbtVpwNCSwDLUbmtQM5xqGbJBwgEngdgUT8uV,7SE7JbDbRgsUzXUAnTrtCyzSCnEkLyYRuTQYRFqQ4rH9,True,39293765,9823441,60750,30375,30375,YQC4EUcgeBi9431viwvzvBbZJW3szeHX4dFmowRDyDw,2430004,7388374,-4958370,618
2022-03-29 00:23:14-04:00,13982,GNWK9cTrChbcAqTWaonyQ1SKWh1PELcRzATeKra7Cj7m,G5bQaczo8MNq3GHLx9V6UtX6N2EfzQYuEQ64Tm2E8RHK,True,99999981,24999995,148232,74116,74116,YQC4EUcgeBi9431viwvzvBbZJW3szeHX4dFmowRDyDw,5929302,40376023,-34446721,592
2022-03-29 00:34:52-04:00,13983,Gr3vv3TmUeQWxjRfE1mLwhLt7TtdY33x5rrKAzjBTVJs,FZWoYYVfeJN8Y93Yw82jyE8DnC39dWMDjNi2NxffTdey,True,29340590,7335147,45686,22843,22843,YQC4EUcgeBi9431viwvzvBbZJW3szeHX4dFmowRDyDw,1827477,5844335,-4016858,622
2022-03-29 01:04:23-04:00,13984,v8PjH3mAe252Zyh1iuPMigysGQZoZL1KncefGDw1ANx,2BDYraDRL6SekAjXy3rbGXCxmPt75gkEfhomEp9FzkUE,True,66238491625,4847413282,30282217,15141108,15141109,3zqXX6kzhkbW3d4TwD2CNjMRwxTbREXySekvq37kfCNk,4137976917,13271860975,-9133884058,624
2022-03-29 04:10:47-04:00,13985,7zqJsqdXgv922pDkWtNoVKvX3FpabXQUAuWvqgbqgFeV,46fTwY6ZT3sDuDTX1ABZdUcNDy541inNnzQitEz36e7c,True,93001703135,12321751530,70922268,35461134,35461134,YQC4EUcgeBi9431viwvzvBbZJW3szeHX4dFmowRDyDw,5353047256,7809019702,-2455972446,575
2022-03-29 07:46:09-04:00,13986,HegY1tDz2ki6vSf9FPRSF4dwGKyciGCt6bovVYdFJRk6,soWdvQVu9EW4Mkk5WUY6rZLA3cEXhFUKqNyY7kpg8ZD,True,25661861,2242327,13961,6980,6981,YQC4EUcgeBi9431viwvzvBbZJW3szeHX4dFmowRDyDw,1597764,7958872,-6361108,622
2022-03-29 07:49:30-04:00,13987,FcXe2wJqFzVRpRMSsPwzmwKAQ7f9CfHmwCt99k1cQeE1,BFjwToxLi3yzSDP13XqEXifQXahGyr5BWPBJyiM2iaai,True,24167384,2241354,14006,7003,7003,YQC4EUcgeBi9431viwvzvBbZJW3szeHX4dFmowRDyDw,1510206,7405185,-5894979,624
2022-03-29 08:11:09-04:00,13988,AxUKatZukyU1PaNZzQFftBbga7GQC7nArZKv6wHCtXVR,HEqbmmGLsuxSSbqx931nFbbhhsNFNEx8Srf8J7wZr7pa,True,24181865,2246203,14029,7014,7015,YQC4EUcgeBi9431viwvzvBbZJW3szeHX4dFmowRDyDw,1510406,7419880,-5909474,624
2022-03-29 08:11:44-04:00,13989,v8PjH3mAe252Zyh1iuPMigysGQZoZL1KncefGDw1ANx,2BDYraDRL6SekAjXy3rbGXCxmPt75gkEfhomEp9FzkUE,True,61641260381,4380294599,27371198,13685599,13685599,3zqXX6kzhkbW3d4TwD2CNjMRwxTbREXySekvq37kfCNk,3851784694,12351782375,-8499997681,624
2022-03-29 08:12:28-04:00,13990,HegY1tDz2ki6vSf9FPRSF4dwGKyciGCt6bovVYdFJRk6,soWdvQVu9EW4Mkk5WUY6rZLA3cEXhFUKqNyY7kpg8ZD,True,23534423,2232979,13933,6966,6967,YQC4EUcgeBi9431viwvzvBbZJW3szeHX4dFmowRDyDw,1468584,7363387,-5894803,624
2022-03-29 08:15:05-04:00,13991,8K1GzGeaAuFdjuVZi6DqBcYiA1zSRioMkRvjotr8p7fz,5mqocPwTdjwAPiJf7vx9bo7AzvfQBT2t5bV9u2Jzb2e1,True,2794867483,698716870,4363628,2181814,2181814,3zqXX6kzhkbW3d4TwD2CNjMRwxTbREXySekvq37kfCNk,174545137,271537119,-96991982,624
2022-03-29 08:15:06-04:00,13992,CLP8qmL8aN9ocJKYnbKSo4k46CU3LBsebspfREQcSGvo,F6tkkFJnvjYyPdSXDNzZMUfhd1o8dFiLyLPRZ5U1sXHE,True,20016621,5004155,30773,15386,15387,YQC4EUcgeBi9431viwvzvBbZJW3szeHX4dFmowRDyDw,1230933,6248768,-5017835,614
2022-03-29 08:44:36-04:00,13993,J1hcSpbzFoDTKb78Pk2AEedKHSzQGrB25jAXG4bio8K7,ruzy52ZWcT8J5e3gVancgmiCX8KnH6dq2iGiJnZuv78,False,697002,697002,43143,2157,40986,YQC4EUcgeBi9431viwvzvBbZJW3szeHX4dFmowRDyDw,43143,137698,-94555,618
2022-03-29 08:44:36-04:00,13994,7yW1M1xeVx4hy3QftnpqdBDRYwamfu3K5i6AEnxgyTWb,7wf7FWS2DYp5RveQAmGNXAEUWPcHziuMLd4hV5LPgxF8,True,725235899,181308974,1126893,563446,563447,YQC4EUcgeBi9431viwvzvBbZJW3szeHX4dFmowRDyDw,45075740,70311135,-25235395,621
2022-03-29 08:44:40-04:00,13995,CD72r5bjRGSd1tLsvDC9YQe5nPYBHexpXGPZvyMRdAwk,5syEXm5Dc1UgWAHfCmgooc4Wkjei8V5A1PR5MNWMPT7N,True,19565403,4891350,30512,15256,15256,YQC4EUcgeBi9431viwvzvBbZJW3szeHX4dFmowRDyDw,1220495,4246584,-3026089,623
2022-03-29 08:45:04-04:00,13996,429jPeeFjDTX93YH4wyuZKDsbTikueUnsFG6cvFQC3Nf,9npKGMooVRgrs4DP5JCRkjD5bM2Uu1R5YTCc6CXPe4mh,False,12982868,12982868,806359,40317,766042,YQC4EUcgeBi9431viwvzvBbZJW3szeHX4dFmowRDyDw,806359,2821966,-2015607,621
2022-03-29 08:45:06-04:00,13997,5BSr2tqthLtZfR2Dcq1hndaU2URYFNzdfjh3evp4kUnV,HcTxCpo9CeQMAjvXE9668B2LQHJXNqEUsPABLputs7Nm,True,114786706,28696676,176909,88454,88455,3zqXX6kzhkbW3d4TwD2CNjMRwxTbREXySekvq37kfCNk,7076361,22789616,-15713255,616
2022-03-29 08:45:21-04:00,13998,niCk6QHFU1kyU56Mdq5RJzKrecdkNSn23ZA6wduFdWS,BQbUYSw1XsuE6LnVd4XjmxAyYgx4drE4FsetJBCdwVZW,True,106892496,18106723,113079,56539,56540,YQC4EUcgeBi9431viwvzvBbZJW3szeHX4dFmowRDyDw,6675606,15273991,-8598385,624
2022-03-29 08:45:41-04:00,13999,FcXe2wJqFzVRpRMSsPwzmwKAQ7f9CfHmwCt99k1cQeE1,BFjwToxLi3yzSDP13XqEXifQXahGyr5BWPBJyiM2iaai,True,22049759,2053646,12779,6389,6390,YQC4EUcgeBi9431viwvzvBbZJW3szeHX4dFmowRDyDw,1372124,6810603,-5438479,622
2022-03-29 08:46:27-04:00,14000,4J7uT2PQnrfWazv3DJcM82i49WmTugyfpdmDvEjKLDks,HsyGm9ttVqNJp38udSabXHM11MTaNUdxnAT2fWKWz1HZ,True,27405779,6851444,42578,21289,21289,YQC4EUcgeBi9431viwvzvBbZJW3szeHX4dFmowRDyDw,1703142,8768903,-7065761,621
2022-03-29 08:46:38-04:00,14001,AzmKB7i1dJucc5Ec1mxpoJor662CDFKAAWRstWDtrmaq,Fd2bPyTR54f8fcTkUokCjcgYgReTGR9vN7ymaGXVcMDK,True,444012013,111003003,690345,345172,345173,3zqXX6kzhkbW3d4TwD2CNjMRwxTbREXySekvq37kfCNk,27613831,114615789,-87001958,621
2022-03-29 08:54:46-04:00,14002,v8PjH3mAe252Zyh1iuPMigysGQZoZL1KncefGDw1ANx,2BDYraDRL6SekAjXy3rbGXCxmPt75gkEfhomEp9FzkUE,True,57493396339,3923569625,24513067,12256533,12256534,YQC4EUcgeBi9431viwvzvBbZJW3szeHX4dFmowRDyDw,3591982939,11840036103,-8248053164,624
2022-03-29 08:56:35-04:00,14003,CHhzBk7s3v78eiNfUnHDV2P1VDMPKEQCwS6F49v76fPQ,57DFvkRBc8cYmyQCxrPmpq6fZqaT9BSurRBoRbuFU5kT,False,274491,274491,17037,851,16186,YQC4EUcgeBi9431viwvzvBbZJW3szeHX4dFmowRDyDw,17037,55538,-38501,620
2022-03-29 08:56:40-04:00,14004,EySWgmc7VFSa2kPLu1F5FuajNNN8gNBvKFWof7Q388up,APGDoB8vc1EFxBSbgEmPH5ita4TLDpzrJPY83d4HP6dR,True,5521414088,1380353522,8576415,4288207,4288208,YQC4EUcgeBi9431viwvzvBbZJW3szeHX4dFmowRDyDw,343056633,538789154,-195732521,621
2022-03-29 08:56:48-04:00,14005,5seV37JfFeqX91yaDfiupi2Ms7yYuuZFHwZ42ovhTbdU,KqBKpYuGWPhC8iYvedTYb4k5Lu3y89UMxt46t8gvn6h,True,743025900,185756475,1156798,578399,578399,3zqXX6kzhkbW3d4TwD2CNjMRwxTbREXySekvq37kfCNk,46271933,150628535,-104356602,622
2022-03-29 08:56:55-04:00,14006,CzWT7zuiD3Usn1DB8C87kZ3yaLcAd1GXe62cZ5xDdEKa,2AsTxJr8dyhHmccUngu2f6beGE9iiXH4yXhmQ48SpCXm,True,168951064,42237766,263384,131692,131692,3zqXX6kzhkbW3d4TwD2CNjMRwxTbREXySekvq37kfCNk,10535394,30964339,-20428945,623
2022-03-29 09:36:24-04:00,14007,v8PjH3mAe252Zyh1iuPMigysGQZoZL1KncefGDw1ANx,2BDYraDRL6SekAjXy3rbGXCxmPt75gkEfhomEp9FzkUE,True,53791819725,3731169481,23200214,11600107,11600107,YQC4EUcgeBi9431viwvzvBbZJW3szeHX4dFmowRDyDw,3344746876,11406833997,-8062087121,621
2022-03-29 10:35:26-04:00,14008,88awjJ2gbtVpwNCSwDLUbmtQM5xqGbJBwgEngdgUT8uV,7SE7JbDbRgsUzXUAnTrtCyzSCnEkLyYRuTQYRFqQ4rH9,True,29966945,7491736,46621,23310,23311,YQC4EUcgeBi9431viwvzvBbZJW3szeHX4dFmowRDyDw,1864850,6080256,-4215406,622
2022-03-29 11:01:22-04:00,14009,Gr3vv3TmUeQWxjRfE1mLwhLt7TtdY33x5rrKAzjBTVJs,FZWoYYVfeJN8Y93Yw82jyE8DnC39dWMDjNi2NxffTdey,True,22384856,5596214,34888,17444,17444,YQC4EUcgeBi9431viwvzvBbZJW3szeHX4dFmowRDyDw,1395542,4787603,-3392061,623
2022-03-29 11:53:18-04:00,14010,SEndYVMCKAeZUKSqGrMUSqXFmxtA9M1t4eXsUhVsTBF,3fcQQcbkpqodakamn82pFnMxBEPL2Drsg4jJNZ6dx72M,True,7034159849,1621471572,10982420,5491210,5491210,3zqXX6kzhkbW3d4TwD2CNjMRwxTbREXySekvq37kfCNk,476432053,721190569,-244758516,677
2022-03-29 12:12:37-04:00,14011,9GfDDypCCSZVA19wMaqoHLNKMHuHNEgmgUB5V8iAaeoL,8pLnmCLcuFpDbnMuPtM2XyYyxsWJBJR51oxDvL6hq9Hk,True,1363970060,340992515,2424579,1212289,1212290,3zqXX6kzhkbW3d4TwD2CNjMRwxTbREXySekvq37kfCNk,96983198,231652301,-134669103,711
2022-03-29 12:12:37-04:00,14012,3hEe6AXGjjVzWnsadNZHfeB6CGg8nKSLyhtyqgBtVivt,6Qdu667ChFcRT7J5QHQzUsWpLmxmNvywAaevseSXqxPZ,True,75356542,18839135,132581,66290,66291,YQC4EUcgeBi9431viwvzvBbZJW3szeHX4dFmowRDyDw,5303248,7702395,-2399147,703
2022-03-29 12:13:51-04:00,14013,SEndYVMCKAeZUKSqGrMUSqXFmxtA9M1t4eXsUhVsTBF,3fcQQcbkpqodakamn82pFnMxBEPL2Drsg4jJNZ6dx72M,True,5449773298,1213611686,8463096,4231548,4231548,YQC4EUcgeBi9431viwvzvBbZJW3szeHX4dFmowRDyDw,380038876,647257045,-267218169,697
2022-03-29 12:14:51-04:00,14014,4U5pUaMfeesvncA9JNmMhs7gSV1B8cmPnXJXSRBVS3So,QaYTU1jx464rJqmQtqtb4z5uuT5KEFNQNQiJgo81RzA,True,211313923,52828480,328039,164019,164020,3zqXX6kzhkbW3d4TwD2CNjMRwxTbREXySekvq37kfCNk,13121585,21779713,-8658128,620
2022-03-29 14:09:00-04:00,14015,74MzhjMjDLChEL9RWjUtb6Ztm7Qmq15MUkrbgAiJ8mgK,EY6caxTDF9WQWa7c9ZJCqL92EDcVMcLaSnHhWXvNW6nA,True,134587488,33646872,210049,105024,105025,YQC4EUcgeBi9431viwvzvBbZJW3szeHX4dFmowRDyDw,8401987,29289467,-20887480,624
2022-03-29 14:09:00-04:00,14016,88awjJ2gbtVpwNCSwDLUbmtQM5xqGbJBwgEngdgUT8uV,7SE7JbDbRgsUzXUAnTrtCyzSCnEkLyYRuTQYRFqQ4rH9,True,22871084,5717771,35457,17728,17729,YQC4EUcgeBi9431viwvzvBbZJW3szeHX4dFmowRDyDw,1418316,4975750,-3557434,620
2022-03-29 15:31:56-04:00,14017,Gr3vv3TmUeQWxjRfE1mLwhLt7TtdY33x5rrKAzjBTVJs,FZWoYYVfeJN8Y93Yw82jyE8DnC39dWMDjNi2NxffTdey,True,17085140,4271285,26529,13264,13265,YQC4EUcgeBi9431viwvzvBbZJW3szeHX4dFmowRDyDw,1061179,3901725,-2840546,621
2022-03-29 18:34:50-04:00,14018,SEndYVMCKAeZUKSqGrMUSqXFmxtA9M1t4eXsUhVsTBF,3fcQQcbkpqodakamn82pFnMxBEPL2Drsg4jJNZ6dx72M,True,5094861845,944304101,6488788,3244394,3244394,3zqXX6kzhkbW3d4TwD2CNjMRwxTbREXySekvq37kfCNk,350093615,568425410,-218331795,687
2022-03-29 21:39:59-04:00,14019,3hEe6AXGjjVzWnsadNZHfeB6CGg8nKSLyhtyqgBtVivt,6Qdu667ChFcRT7J5QHQzUsWpLmxmNvywAaevseSXqxPZ,True,55264095,13816023,97616,48808,48808,YQC4EUcgeBi9431viwvzvBbZJW3szeHX4dFmowRDyDw,3904644,6957841,-3053197,706
2022-03-29 21:40:01-04:00,14020,9GfDDypCCSZVA19wMaqoHLNKMHuHNEgmgUB5V8iAaeoL,8pLnmCLcuFpDbnMuPtM2XyYyxsWJBJR51oxDvL6hq9Hk,True,999374184,249843546,1768126,884063,884063,YQC4EUcgeBi9431viwvzvBbZJW3szeHX4dFmowRDyDw,70725075,195513199,-124788124,707
2022-03-29 21:42:04-04:00,14021,7JbCUyTgV4oLjFST9UUvtJkKpK6F99Pwb1Xe6JT8v7s4,9uYeL9R23XRstddnVE6kohfwCkR41E1GXtyduzc9TwEX,True,97543612467,24385903116,149925533,74962766,74962767,YQC4EUcgeBi9431viwvzvBbZJW3szeHX4dFmowRDyDw,5997021356,10075848301,-4078826945,614
2022-03-29 21:43:07-04:00,14022,4U5pUaMfeesvncA9JNmMhs7gSV1B8cmPnXJXSRBVS3So,QaYTU1jx464rJqmQtqtb4z5uuT5KEFNQNQiJgo81RzA,True,155400312,38850078,242656,121328,121328,YQC4EUcgeBi9431viwvzvBbZJW3szeHX4dFmowRDyDw,9706252,19285319,-9579067,624
2022-03-29 21:43:26-04:00,14023,SEndYVMCKAeZUKSqGrMUSqXFmxtA9M1t4eXsUhVsTBF,3fcQQcbkpqodakamn82pFnMxBEPL2Drsg4jJNZ6dx72M,True,4287498691,697219927,4751416,2375708,2375708,3zqXX6kzhkbW3d4TwD2CNjMRwxTbREXySekvq37kfCNk,292184631,507747019,-215562388,681
2022-03-29 21:43:45-04:00,14024,7yW1M1xeVx4hy3QftnpqdBDRYwamfu3K5i6AEnxgyTWb,7wf7FWS2DYp5RveQAmGNXAEUWPcHziuMLd4hV5LPgxF8,True,334741747,83685436,522306,261153,261153,YQC4EUcgeBi9431viwvzvBbZJW3szeHX4dFmowRDyDw,20892248,42156830,-21264582,624
2022-03-30 02:03:39-04:00,14025,3Xbsek5MsEGoWr3G9yhuohREr26B2vSQcjqXdspTFHta,2rPxkUiMo9wGDq8EvAiwY3ngRpKmL223cBWWNTYoBmFp,True,318221562,79555390,563669,281834,281835,YQC4EUcgeBi9431viwvzvBbZJW3szeHX4dFmowRDyDw,22546771,30759310,-8212539,708
2022-03-30 02:54:34-04:00,14026,3Xbsek5MsEGoWr3G9yhuohREr26B2vSQcjqXdspTFHta,2rPxkUiMo9wGDq8EvAiwY3ngRpKmL223cBWWNTYoBmFp,True,243288934,60822233,434008,217004,217004,3zqXX6kzhkbW3d4TwD2CNjMRwxTbREXySekvq37kfCNk,17360340,28151157,-10790817,713
2022-03-30 09:00:01-04:00,14027,niCk6QHFU1kyU56Mdq5RJzKrecdkNSn23ZA6wduFdWS,BQbUYSw1XsuE6LnVd4XjmxAyYgx4drE4FsetJBCdwVZW,True,88130435,13630427,85187,42593,42594,3zqXX6kzhkbW3d4TwD2CNjMRwxTbREXySekvq37kfCNk,5508020,11858696,-6350676,624
2022-03-30 09:28:19-04:00,14028,AT4qoJDVGXpEm3BGACUhC1zpVNLq4iX2bJ4cpABehpoD,AqaDPXbaY6ksVQwWGKorgBdRQMz3VpqxmHdWXmq17ScF,True,3775881948,943970487,5896748,2948374,2948374,YQC4EUcgeBi9431viwvzvBbZJW3szeHX4dFmowRDyDw,235869922,1201810547,-965940625,624
2022-03-30 09:28:24-04:00,14029,AkGQxVK2FFRi9doFRx5gwGXBr6WKknvU3evZkDu3Yas4,Abu1FYCyBSutkrvrx56tL61xoDyYSCjwrDU1wnKn2gin,True,33782742,8445685,52462,26231,26231,YQC4EUcgeBi9431viwvzvBbZJW3szeHX4dFmowRDyDw,2098495,11246369,-9147874,621
2022-03-30 09:28:26-04:00,14030,A11mzoTX3dyc9gACVJkbRGZ6QACJsrF3ZHJUsGEtRnsj,H7z8CfHxnxo3mPrvxfiLLNwrDX1cxGWWDUxXs9EpzSi,False,15171396,15171396,945895,47294,898601,YQC4EUcgeBi9431viwvzvBbZJW3szeHX4dFmowRDyDw,945895,3313539,-2367644,623
2022-03-30 09:28:27-04:00,14031,4BHydPKft6s7nYozhJ63rVrkQ22QywsrBQf2BAuW6mDS,8Tz6FZpzjoRBZqEwdPdkr4XGmURu3n1SjV3CTuc3o5yw,False,12937873,12937873,803722,40186,763536,YQC4EUcgeBi9431viwvzvBbZJW3szeHX4dFmowRDyDw,803722,3698226,-2894504,621
2022-03-30 09:28:36-04:00,14032,CLP8qmL8aN9ocJKYnbKSo4k46CU3LBsebspfREQcSGvo,F6tkkFJnvjYyPdSXDNzZMUfhd1o8dFiLyLPRZ5U1sXHE,False,15272897,15272897,940813,47040,893773,3zqXX6kzhkbW3d4TwD2CNjMRwxTbREXySekvq37kfCNk,940813,4964622,-4023809,616
2022-03-30 09:29:46-04:00,14033,CD72r5bjRGSd1tLsvDC9YQe5nPYBHexpXGPZvyMRdAwk,5syEXm5Dc1UgWAHfCmgooc4Wkjei8V5A1PR5MNWMPT7N,False,14932215,14932215,932878,46643,886235,YQC4EUcgeBi9431viwvzvBbZJW3szeHX4dFmowRDyDw,932878,3460609,-2527731,624
2022-03-30 09:32:33-04:00,14034,5BSr2tqthLtZfR2Dcq1hndaU2URYFNzdfjh3evp4kUnV,HcTxCpo9CeQMAjvXE9668B2LQHJXNqEUsPABLputs7Nm,True,87539194,21884798,136411,68205,68206,3zqXX6kzhkbW3d4TwD2CNjMRwxTbREXySekvq37kfCNk,5456476,18690662,-13234186,623
2022-03-30 09:32:40-04:00,14035,niCk6QHFU1kyU56Mdq5RJzKrecdkNSn23ZA6wduFdWS,BQbUYSw1XsuE6LnVd4XjmxAyYgx4drE4FsetJBCdwVZW,True,74885968,10365519,64604,32302,32302,YQC4EUcgeBi9431viwvzvBbZJW3szeHX4dFmowRDyDw,4667399,9243711,-4576312,623
2022-03-30 09:32:55-04:00,14036,4J7uT2PQnrfWazv3DJcM82i49WmTugyfpdmDvEjKLDks,HsyGm9ttVqNJp38udSabXHM11MTaNUdxnAT2fWKWz1HZ,True,20914821,5228705,32538,16269,16269,YQC4EUcgeBi9431viwvzvBbZJW3szeHX4dFmowRDyDw,1301553,6961364,-5659811,622
2022-03-30 09:33:10-04:00,14037,AzmKB7i1dJucc5Ec1mxpoJor662CDFKAAWRstWDtrmaq,Fd2bPyTR54f8fcTkUokCjcgYgReTGR9vN7ymaGXVcMDK,True,339057483,84764370,522472,261236,261236,YQC4EUcgeBi9431viwvzvBbZJW3szeHX4dFmowRDyDw,20898902,92199974,-71301072,616
2022-03-30 09:37:49-04:00,14038,DXZMRSKFgnNdiXHps2xzayuztJNH9EUUz2wkCCneXtW5,9Z2sUfTCZCkmw5n3HSsoLG992AcpJo2qxp7XpJnnBxZM,True,3270942230,817730981,5014237,2507118,2507119,3zqXX6kzhkbW3d4TwD2CNjMRwxTbREXySekvq37kfCNk,200570644,249964340,-49393696,613
2022-03-30 10:44:14-04:00,14039,EySWgmc7VFSa2kPLu1F5FuajNNN8gNBvKFWof7Q388up,APGDoB8vc1EFxBSbgEmPH5ita4TLDpzrJPY83d4HP6dR,True,4214206061,1053551515,6533368,3266684,3266684,YQC4EUcgeBi9431viwvzvBbZJW3szeHX4dFmowRDyDw,261334723,481488983,-220154260,620
2022-03-30 10:44:22-04:00,14040,9ZVrkxds9vQ17KGWgANMfJeyMCGxuFRLFVBVS1wrPCqH,HyxwwiTVpAoaeKgX2no9Sp4o8hML15xABjRmMnFfJeYS,True,144536058,36134014,224785,112392,112393,YQC4EUcgeBi9431viwvzvBbZJW3szeHX4dFmowRDyDw,8991412,43787154,-34795742,622
2022-03-30 10:44:29-04:00,14041,5seV37JfFeqX91yaDfiupi2Ms7yYuuZFHwZ42ovhTbdU,KqBKpYuGWPhC8iYvedTYb4k5Lu3y89UMxt46t8gvn6h,True,567210243,141802560,880484,440242,440242,3zqXX6kzhkbW3d4TwD2CNjMRwxTbREXySekvq37kfCNk,35219364,123431010,-88211646,620
2022-03-30 10:47:13-04:00,14042,7Q55QWAHVoeaDAMyK1EkjQmsmj51YPu4AiiMJF2uWoG6,2Eziix2N6sX4zutLfENFsBnhy8X73xQvFUAhHZvmho6B,True,29306841,7326710,45645,22822,22823,YQC4EUcgeBi9431viwvzvBbZJW3szeHX4dFmowRDyDw,1825815,10064550,-8238735,622
2022-03-30 10:47:13-04:00,14043,CzWT7zuiD3Usn1DB8C87kZ3yaLcAd1GXe62cZ5xDdEKa,2AsTxJr8dyhHmccUngu2f6beGE9iiXH4yXhmQ48SpCXm,True,128946918,32236729,201215,100607,100608,YQC4EUcgeBi9431viwvzvBbZJW3szeHX4dFmowRDyDw,8048623,25604130,-17555507,624
2022-03-30 10:49:05-04:00,14044,AT4qoJDVGXpEm3BGACUhC1zpVNLq4iX2bJ4cpABehpoD,AqaDPXbaY6ksVQwWGKorgBdRQMz3VpqxmHdWXmq17ScF,True,2882509572,720627393,4485038,2242519,2242519,YQC4EUcgeBi9431viwvzvBbZJW3szeHX4dFmowRDyDw,179401554,954530478,-775128924,622
2022-03-30 10:49:14-04:00,14045,AkGQxVK2FFRi9doFRx5gwGXBr6WKknvU3evZkDu3Yas4,Abu1FYCyBSutkrvrx56tL61xoDyYSCjwrDU1wnKn2gin,True,25818663,6454665,39116,19558,19558,3zqXX6kzhkbW3d4TwD2CNjMRwxTbREXySekvq37kfCNk,1564663,8907180,-7342517,606
2022-03-30 10:49:34-04:00,14046,EToqvQTpzBfLfgPLf2vbpSkLt4isU6hR6E3Dhcx1uCD9,6sJ7wNkr4fL9uWuFcE9AvpzrNvCp3XX168DwjMLkaM4z,True,73572804978,18393201244,114503157,57251578,57251579,3zqXX6kzhkbW3d4TwD2CNjMRwxTbREXySekvq37kfCNk,4580126283,16115925143,-11535798860,622
2022-03-30 10:50:03-04:00,14047,5BSr2tqthLtZfR2Dcq1hndaU2URYFNzdfjh3evp4kUnV,HcTxCpo9CeQMAjvXE9668B2LQHJXNqEUsPABLputs7Nm,True,66874209,16718552,102521,51260,51261,3zqXX6kzhkbW3d4TwD2CNjMRwxTbREXySekvq37kfCNk,4100862,15246360,-11145498,613
2022-03-30 10:53:18-04:00,14048,niCk6QHFU1kyU56Mdq5RJzKrecdkNSn23ZA6wduFdWS,BQbUYSw1XsuE6LnVd4XjmxAyYgx4drE4FsetJBCdwVZW,True,65116487,8359307,51780,25890,25890,3zqXX6kzhkbW3d4TwD2CNjMRwxTbREXySekvq37kfCNk,4033571,7139039,-3105468,619
2022-03-30 10:53:19-04:00,14049,4J7uT2PQnrfWazv3DJcM82i49WmTugyfpdmDvEjKLDks,HsyGm9ttVqNJp38udSabXHM11MTaNUdxnAT2fWKWz1HZ,False,15968289,15968289,986987,49349,937638,3zqXX6kzhkbW3d4TwD2CNjMRwxTbREXySekvq37kfCNk,986987,5514020,-4527033,618
2022-03-30 10:53:19-04:00,14050,AzmKB7i1dJucc5Ec1mxpoJor662CDFKAAWRstWDtrmaq,Fd2bPyTR54f8fcTkUokCjcgYgReTGR9vN7ymaGXVcMDK,True,258597186,64649296,401867,200933,200934,3RdfgDvLvsdZG5Cf6hKiKMQMqfidyxHzjYvUx1FZpeHQ,16074713,73855231,-57780518,621
2022-03-30 10:53:46-04:00,14051,Hya9U3Ao61oebVBPEnUiqinqvpzTguAZhbAWDmEQpm3a,FdYMMqoYPe5Jgj8R2ovKVUKxRPK1xppR59XRGPdvHRAx,True,280506305,70126576,437650,218825,218825,YQC4EUcgeBi9431viwvzvBbZJW3szeHX4dFmowRDyDw,17506014,97953389,-80447375,624
2022-03-30 10:53:52-04:00,14052,EySWgmc7VFSa2kPLu1F5FuajNNN8gNBvKFWof7Q388up,APGDoB8vc1EFxBSbgEmPH5ita4TLDpzrJPY83d4HP6dR,True,3215338097,803834524,5002945,2501472,2501473,YQC4EUcgeBi9431viwvzvBbZJW3szeHX4dFmowRDyDw,200117804,420035847,-219918043,622
2022-03-30 10:54:27-04:00,14053,9ZVrkxds9vQ17KGWgANMfJeyMCGxuFRLFVBVS1wrPCqH,HyxwwiTVpAoaeKgX2no9Sp4o8hML15xABjRmMnFfJeYS,True,110297110,27574277,171789,85894,85895,YQC4EUcgeBi9431viwvzvBbZJW3szeHX4dFmowRDyDw,6871561,34863545,-27991984,623
2022-03-30 10:54:33-04:00,14054,5seV37JfFeqX91yaDfiupi2Ms7yYuuZFHwZ42ovhTbdU,KqBKpYuGWPhC8iYvedTYb4k5Lu3y89UMxt46t8gvn6h,True,432765898,108191474,674516,337258,337258,3zqXX6kzhkbW3d4TwD2CNjMRwxTbREXySekvq37kfCNk,26980665,100499531,-73518866,623
2022-03-30 10:54:33-04:00,14055,HUS4p17tsXBKEDpErqmWw8obXz7Wbnre8Ep9WvYTDebx,6TcAWZZhCUMpEsXrjqEknWFTPgj8edhkLuJJ1pVFcPZ7,False,611200,611200,37957,1897,36060,3zqXX6kzhkbW3d4TwD2CNjMRwxTbREXySekvq37kfCNk,37957,120883,-82926,621
2022-03-30 10:54:45-04:00,14056,ECghAuNBATf1BCewpLJDi3XFrW3ULgyVkb37hURNARWB,DU6fWUBnqXTMiUBMTz8MSGD68j89K8LZhUhj1WpxbZwM,True,2501999196,625499799,3908699,1954349,1954350,3zqXX6kzhkbW3d4TwD2CNjMRwxTbREXySekvq37kfCNk,156347972,310755987,-154408015,624
2022-03-30 10:54:56-04:00,14057,7Q55QWAHVoeaDAMyK1EkjQmsmj51YPu4AiiMJF2uWoG6,2Eziix2N6sX4zutLfENFsBnhy8X73xQvFUAhHZvmho6B,True,22368291,5592072,34800,17400,17400,3zqXX6kzhkbW3d4TwD2CNjMRwxTbREXySekvq37kfCNk,1392010,7959225,-6567215,622
2022-03-30 10:54:57-04:00,14058,CzWT7zuiD3Usn1DB8C87kZ3yaLcAd1GXe62cZ5xDdEKa,2AsTxJr8dyhHmccUngu2f6beGE9iiXH4yXhmQ48SpCXm,True,98427256,24606814,153258,76629,76629,3zqXX6kzhkbW3d4TwD2CNjMRwxTbREXySekvq37kfCNk,6130341,21014139,-14883798,622
2022-03-30 11:06:06-04:00,14059,4Bi1PEYPfA5VEoBqzGbt5fSd6PwuVsrF5SfLWXtpNxFA,3aApRXGYkRs9AZXchR5i7HnWXiRvBQgg3fz1bb4gMx2U,True,63309043,9457126,58654,29327,29327,YQC4EUcgeBi9431viwvzvBbZJW3szeHX4dFmowRDyDw,3926546,16000566,-12074020,620
2022-03-30 11:06:11-04:00,14060,AkGQxVK2FFRi9doFRx5gwGXBr6WKknvU3evZkDu3Yas4,Abu1FYCyBSutkrvrx56tL61xoDyYSCjwrDU1wnKn2gin,True,19667649,4916912,30552,15276,15276,YQC4EUcgeBi9431viwvzvBbZJW3szeHX4dFmowRDyDw,1222083,7032625,-5810542,621
2022-03-30 11:06:11-04:00,14061,7yW1M1xeVx4hy3QftnpqdBDRYwamfu3K5i6AEnxgyTWb,7wf7FWS2DYp5RveQAmGNXAEUWPcHziuMLd4hV5LPgxF8,True,384798226,96199556,600932,300466,300466,YQC4EUcgeBi9431viwvzvBbZJW3szeHX4dFmowRDyDw,24037308,37829958,-13792650,624
2022-03-30 11:06:13-04:00,14062,AT4qoJDVGXpEm3BGACUhC1zpVNLq4iX2bJ4cpABehpoD,AqaDPXbaY6ksVQwWGKorgBdRQMz3VpqxmHdWXmq17ScF,True,2200154255,550038563,3416634,1708317,1708317,YQC4EUcgeBi9431viwvzvBbZJW3szeHX4dFmowRDyDw,136665371,756326895,-619661524,621
2022-03-30 11:15:34-04:00,14063,niCk6QHFU1kyU56Mdq5RJzKrecdkNSn23ZA6wduFdWS,BQbUYSw1XsuE6LnVd4XjmxAyYgx4drE4FsetJBCdwVZW,True,56853767,7988534,49583,24791,24792,YQC4EUcgeBi9431viwvzvBbZJW3szeHX4dFmowRDyDw,3528847,7986976,-4458129,620
2022-03-30 11:19:37-04:00,14064,5LtcaH2KubtMvwgj6bXBuq5wPH41uiwe7h25L5r2sTKc,3yxQpcC5s557FY8mJrQHp6jxRLnfjsemDiL87ZvLnVkT,False,3328834,3328834,203985,10199,193786,YQC4EUcgeBi9431viwvzvBbZJW3szeHX4dFmowRDyDw,203985,1032819,-828834,612
2022-03-30 11:19:38-04:00,14065,EToqvQTpzBfLfgPLf2vbpSkLt4isU6hR6E3Dhcx1uCD9,6sJ7wNkr4fL9uWuFcE9AvpzrNvCp3XX168DwjMLkaM4z,True,56188675049,14047168762,86427053,43213526,43213527,3zqXX6kzhkbW3d4TwD2CNjMRwxTbREXySekvq37kfCNk,3457082151,13150041955,-9692959804,615
2022-03-30 11:19:40-04:00,14066,5BSr2tqthLtZfR2Dcq1hndaU2URYFNzdfjh3evp4kUnV,HcTxCpo9CeQMAjvXE9668B2LQHJXNqEUsPABLputs7Nm,True,51047956,12761989,77663,38831,38832,3zqXX6kzhkbW3d4TwD2CNjMRwxTbREXySekvq37kfCNk,3106524,12357972,-9251448,608
2022-02-23 23:16:24-05:00,13043,7EtGovzHsbD8cKGqq4R5rvKBbncR4Kc7CDkTjof2QBMf,8ShjeNWM2vcvUF9yYztYCHUQfcGsyg2A1LyWiPbQDDvq,True,4868,1217,6,3,3,HfEnetJ7uBSmZWCjBNxdvv9HEC5nsW4wDV7wu6WnhWan,267,6679,-6412,548
2022-02-23 23:16:24-05:00,13044,6aW9dhnTNerVd1MPv5GrcYqgjVPE9LsNCGYSJSrNdgS8,8kmJu2UxTk2T37sqxDSrf6pDWhJZRxfRdJB7DLeoWddJ,True,1502082,375520,2106,1053,1053,HfEnetJ7uBSmZWCjBNxdvv9HEC5nsW4wDV7wu6WnhWan,84261,2005405,-1921144,560
2022-02-23 23:16:24-05:00,13045,CyWBZ1xJ9LahUnPesbXLZ4Rr5UyWAHgVFYwfrnhyrkNL,2Lpk87Xth8ZL5J9BfzmMpEE3x76FDrrrmdKiCNkSVip2,True,220431,55106,334,167,167,HfEnetJ7uBSmZWCjBNxdvv9HEC5nsW4wDV7wu6WnhWan,13377,209607,-196230,606
2022-02-23 23:16:24-05:00,13046,2dm92uFR4iRK6BaXt5sGWZiFAFXMUDHphr9ENjrBNDMx,HjUUKnmbvGwAmzVxMecrY4o8EgfWCzvKukCQRzUggvX8,True,196379,49094,274,137,137,3zqXX6kzhkbW3d4TwD2CNjMRwxTbREXySekvq37kfCNk,10985,51914,-40929,559
2022-02-23 23:16:24-05:00,13047,FMfGuLLeTq6brZtmED8oq6Ys4W9ga9gGH3UdpkYoW6m7,Cy1ZW5cbdA2ZXwgoAN3Rs46p9zg15F3qSNMGEGBbD1RT,True,33197189,8299297,50290,25145,25145,3zqXX6kzhkbW3d4TwD2CNjMRwxTbREXySekvq37kfCNk,2011601,11767247,-9755646,605
2022-02-23 23:16:24-05:00,13048,Cf6VsvBxhycnYD2QfnHqca6QeJRs7gzSkYEbfmarRNkZ,2ahUgNCtaCLoujC6ChNY3t1ffConqjCBcK9Ri17S8Pvf,True,493271072,123317767,730780,365390,365390,3zqXX6kzhkbW3d4TwD2CNjMRwxTbREXySekvq37kfCNk,29231223,195180751,-165949528,592
2022-02-23 23:16:24-05:00,13049,23FjS7S6hwPkaBsziThnqwAqy3dZvDYvNLdCKfxp7Jr4,CpGixAiKhjCWJ8tD8hWxuSUeU7mQeoZU5TVdqsAEMvLQ,True,1791790,447947,2612,1306,1306,3zqXX6kzhkbW3d4TwD2CNjMRwxTbREXySekvq37kfCNk,104519,3443802,-3339283,583
2022-02-23 23:16:24-05:00,13050,AwT3pH9dHjECDnuUiazbD6tZxZHdNwgJ4vBMmxLHMiLo,AjybksvjMT1QT6KvryXCG47pQGT8v9jxM34VkveGPQrs,True,123064841,30766210,186817,93408,93409,HfEnetJ7uBSmZWCjBNxdvv9HEC5nsW4wDV7wu6WnhWan,7472694,71979518,-64506824,607
2022-02-23 23:16:24-05:00,13051,BXMMFy2k9b2hVBEG6RyXAq3qqXxJ7EY2xhyPZqtLvBiU,KpoZwr4ZFTHJgebbf4tcjT9iKvpC1EF8Aw4uaVPxXNd,True,2356634,589158,3627,1813,1814,HfEnetJ7uBSmZWCjBNxdvv9HEC5nsW4wDV7wu6WnhWan,145093,595335,-450242,615
2022-02-23 23:16:24-05:00,13052,As81koHnSP9quoXuUVNHp3VR3Qaks8HLa4sFgJDocYiF,AMVm8dXia5s974VgZSbeE6uPDgyXDHZFyJ2W1J1CWvKW,True,535021,133755,807,403,404,HfEnetJ7uBSmZWCjBNxdvv9HEC5nsW4wDV7wu6WnhWan,32286,737450,-705164,603
2022-02-23 23:16:25-05:00,13053,9Kmy166yoeTZNt9KDchxyj3PWNQ3tJZ5a24pMqx6DxrZ,2TNQaUck5kGpwpPwh98FHnxzsLrQFSvuFBv9t6yBNUb1,True,1897240,474310,2891,1445,1446,HfEnetJ7uBSmZWCjBNxdvv9HEC5nsW4wDV7wu6WnhWan,115642,528717,-413075,609
2022-02-23 23:16:25-05:00,13054,6fqbSyhh3PPdgRcLraHb7Jahj9s1oHHeX3SsjNSsGa6t,GpRUow48TYgttdYfsygbgjYQcmHyYjWETUDjDVphEgwq,True,209957653,52489413,317193,158596,158597,3zqXX6kzhkbW3d4TwD2CNjMRwxTbREXySekvq37kfCNk,12687749,135779068,-123091319,604
2022-02-23 23:16:25-05:00,13055,EBnMKbaJEjNXjt14hxssR8wd3Ua37McPQxUZnKxxbgtd,FAALK2LRFhg98ezHEBFrgrzxTg66eZpmo7ctKDEck8q5,True,33614,8403,52,26,26,HfEnetJ7uBSmZWCjBNxdvv9HEC5nsW4wDV7wu6WnhWan,2091,43644,-41553,622
2022-02-23 23:16:25-05:00,13056,6h43GsVT3TjtLa5nRpsXp15GDpAY4smWCYHgcq58dSPM,CTgbWridYWnfE5Emwr7qiCEb3LcXHupqeB9zwmddoEqB,True,38897990,9724497,60407,30203,30204,3zqXX6kzhkbW3d4TwD2CNjMRwxTbREXySekvq37kfCNk,2416317,12555168,-10138851,621
2022-02-23 23:16:25-05:00,13057,CJpe9bNHxS63QMaGJhmnr4u7eTo6e5GApZQZyPtXLAkk,EMVL4sDfVXwGEoGEYwLp8D6itfy3eu4FZBAj1kMz6uXa,True,510331,127582,769,384,385,HfEnetJ7uBSmZWCjBNxdvv9HEC5nsW4wDV7wu6WnhWan,30790,704273,-673483,603
2022-02-23 23:16:25-05:00,13058,FF8rqfM9PTEjYiVFy8jS81weDRwdaYooux2uSa2LexrJ,JBk1JghH1gged1YpDbkczFXP9ka5ivYSkaYoVbbXD4kg,True,13793,3448,21,10,11,2BPYaeCXY4BCFSGFSfiGtqmhzJ4fkhYLxGjqFvLCB6hG,848,20542,-19694,614
2022-02-23 23:16:25-05:00,13059,BLJgLzizx2yLgd12pVBAHTMqn9J5JA3JHCF8PnLnPyUk,HhDmwMysBFWhXnd3mrV31w75WBRKBS8wJSiEMZgqdUSp,True,75140,18785,114,57,57,2BPYaeCXY4BCFSGFSfiGtqmhzJ4fkhYLxGjqFvLCB6hG,4579,108018,-103439,609
2022-02-23 23:16:25-05:00,13060,3sGCWcgPY7TzRCkFR1uuY8KcUzVRbdTyFYxh7V1csNMX,CcRFNnG2uhyLwhNAbX4U49jkMeC11kJtVhhyqDWdDK5r,True,543621,135905,819,409,410,2BPYaeCXY4BCFSGFSfiGtqmhzJ4fkhYLxGjqFvLCB6hG,32782,751893,-719111,603
2022-02-23 23:16:25-05:00,13061,92Y3wzUXMk16wyPR2kxgkRZj1adCYbAtZBj9Mj1d22Ui,9iwMBXfKfZqjQeKDRtQz4fgCQDNMeLgPBYLLazsfymkL,True,376041406,94010351,567373,283686,283687,HfEnetJ7uBSmZWCjBNxdvv9HEC5nsW4wDV7wu6WnhWan,22694939,191371803,-168676864,603
2022-02-23 23:16:25-05:00,13062,9kYkFDNE3qD6s73fn8kJowgqbDZoDSw22XaUJ7rTD43D,E8zJz8pT2c9aZsxe4kLMNs4bY7skt38SU5wK5JTqbGr6,True,293190,73297,454,227,227,HfEnetJ7uBSmZWCjBNxdvv9HEC5nsW4wDV7wu6WnhWan,18181,413311,-395130,620
2022-02-23 23:16:25-05:00,13063,3NhNdphQiKwgHTmTJc4qVhp3aWjqnwMTYbRW1y9CZrZg,BNpP1sKPAr7Dk1ymSrupge9KGMVpk4LfjTjawgi9YaC5,True,112010,28002,174,87,87,2BPYaeCXY4BCFSGFSfiGtqmhzJ4fkhYLxGjqFvLCB6hG,6966,154273,-147307,621
2022-02-23 23:16:25-05:00,13064,DQX4pfAfWx6y77UCxZiFhY5geqeCMcq7u8W1ErGgTiLx,BH1uBztZpx7oHDeex2EypAdUmmBzvsGJhJFhhaYA8Zhx,True,27644385,6911096,38566,19283,19283,3zqXX6kzhkbW3d4TwD2CNjMRwxTbREXySekvq37kfCNk,1542650,7642676,-6100026,558
2022-02-23 23:16:25-05:00,13065,2ZSfbqxhiCTDrDPeRhoWayTZHNmW7ajVXBCxpFS4eGBF,3ZmWsPdQD7qfSMGKQSNhmBtuH7S6qMFRc8oEmBcHXEiR,True,19094,4773,28,14,14,HfEnetJ7uBSmZWCjBNxdvv9HEC5nsW4wDV7wu6WnhWan,1153,26914,-25761,603
2022-02-23 23:16:26-05:00,13066,U3vvMQ4X4aKzVYfhMw1V1p58HRqaLnuXozqmmefYeD9,7JA94MArkNCFRhBq8f5a32DgMF6aPdFsoC5HvXDQ6NuR,True,23089,5772,35,17,18,HfEnetJ7uBSmZWCjBNxdvv9HEC5nsW4wDV7wu6WnhWan,1405,35813,-34408,608
2022-02-23 23:16:26-05:00,13067,3jJxvfbyc9KvECkLWTGptkezCLZfiums7GgfANyCULF3,C7fXi4upWW22F2Ak7AzsYVASjjdfZZtPmkQ9pBB2bJXZ,True,2063043,515760,3103,1551,1552,HfEnetJ7uBSmZWCjBNxdvv9HEC5nsW4wDV7wu6WnhWan,124130,1614629,-1490499,601
2022-02-23 23:16:26-05:00,13068,HfwGSiwGiyDFaTS2usYRp82zSmPPQqZukbw2d1BuFs5w,ArtgZbmA33k8Y3EfR6oMJiqT72MUrVBQqifPBdcnrzea,True,15063,3765,20,10,10,HfEnetJ7uBSmZWCjBNxdvv9HEC5nsW4wDV7wu6WnhWan,821,13371,-12550,545
2022-02-23 23:16:26-05:00,13069,8w6CkZjw2egvAy9CykZfqz7mdRMxcSyzU4mT5WNLHs5Q,D4u8CcdVvLfDQ4xPzfVMmGzao4XdP5HWBnuh9g7Hc3Qg,True,7982659,1995664,12058,6029,6029,2BPYaeCXY4BCFSGFSfiGtqmhzJ4fkhYLxGjqFvLCB6hG,482346,12075376,-11593030,604
2022-02-23 23:16:26-05:00,13070,6e6PHvHgQBZ8D7TE7g6uoiLe2sU3MKJucZDPBSEi3vtW,FsFud4fWL36V4bDWQDLfey89zu48Ammt5E3vXX78HnQ8,True,18128042,4532010,26177,13088,13089,2BPYaeCXY4BCFSGFSfiGtqmhzJ4fkhYLxGjqFvLCB6hG,1047081,6504672,-5457591,577
2022-02-23 23:16:26-05:00,13071,9Hz4p7gcfDbXBJp8KzhaBBPh9i7xe9kun7zLfDtqPe6c,2bJ43Lep6kp6WY7Ct56oiscKnAbdtC265G5yRvRPFThU,True,69828,17457,104,52,52,HfEnetJ7uBSmZWCjBNxdvv9HEC5nsW4wDV7wu6WnhWan,4198,69052,-64854,601
2022-02-23 23:16:27-05:00,13072,9Digi4Kx7aL6pZ1UytgVhobDVSj5ME66zFPL41DC2byC,8NyLbYQR5mhHBuL78Xr8RhRMnfc9yjkZPbZifgB8xmxP,True,912995,228248,1372,686,686,HfEnetJ7uBSmZWCjBNxdvv9HEC5nsW4wDV7wu6WnhWan,54918,1146347,-1091429,601
2022-02-23 23:16:27-05:00,13073,FdYFnEYtFQKcZPmzUqnvNLzozxdR1emtkmvnYcMgYykS,7arWNJQf2cWxerjhLgQh9CJxwTat1efnr5KmhuD7Qnv4,True,14861,3715,22,11,11,HfEnetJ7uBSmZWCjBNxdvv9HEC5nsW4wDV7wu6WnhWan,896,20957,-20061,602
2022-02-23 23:16:27-05:00,13074,92vHa65f4WpuqzSCMESDMPxZ2yfLxXJMMPYLof75EiN,3QZvcV1wL2ZYnw9yY9sbhiCP3dYYHeUZB7gcqtSutuLK,True,12132666,3033166,18331,9165,9166,HfEnetJ7uBSmZWCjBNxdvv9HEC5nsW4wDV7wu6WnhWan,733243,10138683,-9405440,604
2022-02-23 23:16:28-05:00,13075,5y8ZSWUnrm4B3emh7vLQKTh89vHtCvXqUhk7fJBA52is,Bu1AoKU2QQWpGH54ZzugvvACB3E1d3VvymnegNmTgHqg,True,534964,133741,804,402,402,2BPYaeCXY4BCFSGFSfiGtqmhzJ4fkhYLxGjqFvLCB6hG,32161,737382,-705221,601
2022-02-23 23:16:28-05:00,13076,AgokoeqypXXfMsjAyBXPRrJFGeP7B7D6SXvnGUTwMdap,53zBz3fTZisWQH1v6NHyhCdpLXx5NaPNp7uW9KPXLDan,True,2472153,618038,3771,1885,1886,2BPYaeCXY4BCFSGFSfiGtqmhzJ4fkhYLxGjqFvLCB6hG,150847,1682330,-1531483,610
2022-02-23 23:16:28-05:00,13077,FYdUiU3rPpbYKWnEpekQQsocSJKjXmscohi4v6DYqix7,daPyq9YdunQJhhLoW5ifhJ7UFPTtRZhGs4JwE1nqZhN,True,19218,4804,28,14,14,HfEnetJ7uBSmZWCjBNxdvv9HEC5nsW4wDV7wu6WnhWan,1158,27082,-25924,602
2022-02-23 23:16:28-05:00,13078,7EvJoetxJVTgpJXqE1VC3fZN1CQ5xdWdv29yCiDuH9gU,6RTEusjGEHNDdMj75qkpzYHjHZ3R2XN5xvptCwkRJz5j,True,21412,5353,33,16,17,HfEnetJ7uBSmZWCjBNxdvv9HEC5nsW4wDV7wu6WnhWan,1330,30182,-28852,621
2022-02-23 23:16:28-05:00,13079,EYt1Pzqfwnd4iXSmcpw4T3Edmm1y3GnRhCjcQEEK4Atj,EHqporfvvfg7UQPsjv5tsgZE8u9yyRuEU2DdLpQeXy85,True,17271258,4317814,25079,12539,12540,HfEnetJ7uBSmZWCjBNxdvv9HEC5nsW4wDV7wu6WnhWan,1003192,10934684,-9931492,580
2022-02-23 23:16:28-05:00,13080,F82PLGiP5KXaPHD94YDq5FnfGeFbb6Z4gBFHypukaCi9,7ckYcHsEdKq3mfvAUc71uRUw2ugvS9yu7RNJErsdefi7,True,7984909,1996227,12076,6038,6038,72FwbpFGoLEazJEdpqNtPNefsadUrimUqma9wSoy4qiS,483067,12073846,-11590779,604
2022-02-23 23:16:28-05:00,13081,AeKNHJsY5gWwZZZPvgqZb7TAoS25fQ3pW81QFNeA992E,4ja9TG6tRbQ1xNquFNWdpHWaqdqzbNuZJdu9SyKXB5wV,True,1870123,467530,2519,1259,1260,HfEnetJ7uBSmZWCjBNxdvv9HEC5nsW4wDV7wu6WnhWan,100783,857880,-757097,538
2022-02-23 23:16:28-05:00,13082,DMgD2KCEhTGFLUZ5GnfNcwfiiwKYbyVpoWiN6knMkCAf,5KU2vgBkPTNVHsSULjgX7ZkZS56U3Dy3xqLTxL5sUZJ3,True,104805,26201,163,81,82,HfEnetJ7uBSmZWCjBNxdvv9HEC5nsW4wDV7wu6WnhWan,6536,177608,-171072,623
2022-02-23 23:16:28-05:00,13083,EJLgJiVhkNMJJ1sAGKkyKZs6gjdnXNfn6GainLbohkQe,3kp99ozLWY2QBc8SznbyJjz9WGuUHdkdiN1ThbCWEY4a,True,3391144,847786,5060,2530,2530,HfEnetJ7uBSmZWCjBNxdvv9HEC5nsW4wDV7wu6WnhWan,202420,860948,-658528,596
2022-02-23 23:16:28-05:00,13084,8ARSFh2vPjz7M1pjNqFRsRrHFGwVsUNnD7kLbqhmMrZR,9TGsutLwHv259Le8zfZ75FM4eLZffi6itgWBgYqeKkAy,True,127876,31969,191,95,96,HfEnetJ7uBSmZWCjBNxdvv9HEC5nsW4wDV7wu6WnhWan,7659,179100,-171441,598
2022-02-23 23:16:28-05:00,13085,4q5tGJYhKAyUCLkFdAajtrE9KCvZohCEFqGp5XkqAHwD,8a913NCjVRW6F4DzwaxijQ4URD4AkpCDhts2MJUBYPWs,True,145490,36372,219,109,110,HfEnetJ7uBSmZWCjBNxdvv9HEC5nsW4wDV7wu6WnhWan,8764,74032,-65268,602
2022-02-23 23:16:29-05:00,13086,81Kxg9MYupMmAHF83D8h4Y4FGbixtPdgpAwRduTDzzsE,CaCX1rB2ZuAGP7mq3ncbCtiv2hnfBoJwgFceCSrvu1yz,True,41914688,10478672,56697,28348,28349,72FwbpFGoLEazJEdpqNtPNefsadUrimUqma9wSoy4qiS,2267880,9784221,-7516341,541
2022-02-23 23:16:29-05:00,13087,BrHRMouGRz3LBNzd9anfdYMhWfg8yUPHL4PqJ8WdEDFS,4uzoLa3mC2VYHAPBoHLX4gTjPTC28rPf2fvEGtJWPYc,True,2425,606,3,1,2,HfEnetJ7uBSmZWCjBNxdvv9HEC5nsW4wDV7wu6WnhWan,147,4949,-4802,606
2022-02-23 23:16:29-05:00,13088,4SX2pj4eHRwFMtyDCrMZ8ZT6ASAMi7yfZWZnccw5dGn8,Ads49ZqvTmPHxfzNYm4oJb4HBYhwS6vXQbarqmpUi5VZ,True,15561,3890,23,11,12,HfEnetJ7uBSmZWCjBNxdvv9HEC5nsW4wDV7wu6WnhWan,956,21944,-20988,614
2022-02-23 23:16:29-05:00,13089,6Bq55LtGCEeGqh4JrFLCmmGc2iJfTTBJixivqH78aGSE,DSNrCgWJeNe2P9tAQu5FvCueTzNKDKds7wzuwTQSMRG,False,675,675,33,1,32,HfEnetJ7uBSmZWCjBNxdvv9HEC5nsW4wDV7wu6WnhWan,33,881,-848,488
2022-02-23 23:16:29-05:00,13090,73PpLzJmAimmqtjGpRcYHua8t6wx3gYiiXFvQxnSDMJV,CRCpLcS8LNKX22co94spJBXEes9Fnh5rYBvbVEte4JXA,True,2243929,560982,3494,1747,1747,HfEnetJ7uBSmZWCjBNxdvv9HEC5nsW4wDV7wu6WnhWan,139781,2861061,-2721280,622
2022-02-23 23:16:29-05:00,13091,AvpYg74EBhwAXE8rcdGkpwmbBMRyVidF6zMRSFtWAVC6,4WgpqTp4r9wMpMptYMNbvCaP2faBnVr6FdShCAobetpL,True,18935,4733,28,14,14,HfEnetJ7uBSmZWCjBNxdvv9HEC5nsW4wDV7wu6WnhWan,1147,26710,-25563,605
2022-02-23 23:16:31-05:00,13092,E3VXmcpGHFLMaoEB76WUMUWkaHNGhwQyG88uoRhryniB,9388AsZ75Uh6KpyhPRQeJUJGw8EoGSTGfBsdWzMByKar,True,192047,48011,287,143,144,HfEnetJ7uBSmZWCjBNxdvv9HEC5nsW4wDV7wu6WnhWan,11485,94263,-82778,598
2022-02-23 23:16:34-05:00,13093,Aop82qT6CwZbomif4QowqP3VaSHKB1837B2yNKqw4tER,65BVa4jrCx9etU5eXBAXT2PVnwVot2HLWGYyNXbVJDFk,True,262549,65637,393,196,197,2BPYaeCXY4BCFSGFSfiGtqmhzJ4fkhYLxGjqFvLCB6hG,15732,362002,-346270,599
2022-02-23 23:16:36-05:00,13094,CiomzdJ9g2bCskudk28cEU4aTgF6jYaerkiazbB7E3DA,9rxtTBmKoxPzhR4xoRH65Kmi7f3pEp1RanoeQq9V9RU5,True,29770163,7442540,44964,22482,22482,2BPYaeCXY4BCFSGFSfiGtqmhzJ4fkhYLxGjqFvLCB6hG,1798574,13911400,-12112826,604
2022-02-23 23:16:36-05:00,13095,6Z6y2QLJUZ5s6zdjanJcKprTAotx8tqr9DRNqqycMeS4,JCYwt8MHVaBb14GB2qAvDWwYVMaL7VTxyNEt7Eo5Zy8x,True,15660,3915,24,12,12,HfEnetJ7uBSmZWCjBNxdvv9HEC5nsW4wDV7wu6WnhWan,977,22043,-21066,623
2022-02-23 23:16:38-05:00,13096,9BMHbUs4d3qX49fnroHv2FTPDs4yoDFrvDMqf8p9U4pE,2yL7zwMr7qVG5Sdwkf7z6ppnNqt1ASppBbmxwYjfFY6Z,True,296779,74194,461,230,231,3zqXX6kzhkbW3d4TwD2CNjMRwxTbREXySekvq37kfCNk,18456,418667,-400211,621
2022-02-23 23:16:38-05:00,13097,A4Q7Vrc9M3GtEXNUSiVBFkansyf5sKBtSeVT92WFacqv,EWLNfsTKqzkd7KAhnrPRre4Dyk6exb3H9wSbrJuyWprg,True,486300,121575,725,362,363,HfEnetJ7uBSmZWCjBNxdvv9HEC5nsW4wDV7wu6WnhWan,29000,672392,-643392,596
2022-02-23 23:16:38-05:00,13098,3tQBuHwr3V8AZu8Yqhg1UfmnFoxzkUq9UeGeLm41UHy4,9cESwduiHBgrxZK1hN1eAFwnyfxw3FEHezTa8Ue5Kpye,True,1536629,384157,2338,1169,1169,HfEnetJ7uBSmZWCjBNxdvv9HEC5nsW4wDV7wu6WnhWan,93535,1515612,-1422077,608
2022-02-23 23:16:38-05:00,13099,2EkjFzKuqQaT9iLsf4qHnXM6rnbj7ftEyzzRsWx6D347,9NpHNbrRJF3U8Ub4KraPHhhZpyZk9Teo836dJSktJMEV,True,169015,42253,252,126,126,HfEnetJ7uBSmZWCjBNxdvv9HEC5nsW4wDV7wu6WnhWan,10105,152820,-142715,597
2022-02-23 23:16:40-05:00,13100,ymyzGH4Qc7HH5PbKpVphCbsQgLLXyGkPcXamQJuNj5C,8oTLHaV2XzbKXNWRuUjCfHjUn61Pw93LYK14m9q2VDpZ,True,1011,252,1,0,1,HfEnetJ7uBSmZWCjBNxdvv9HEC5nsW4wDV7wu6WnhWan,63,1336,-1273,623
2022-02-23 23:16:40-05:00,13101,HEFpdWLZaiQnjftmXgxs6RNzhH72YiMjortxPkKekkvb,5Q8mmxBgVTijNGrWsnoA3VMArLHZEX5MkaigYXHpgXHE,True,463608,115902,713,356,357,HfEnetJ7uBSmZWCjBNxdvv9HEC5nsW4wDV7wu6WnhWan,28527,299409,-270882,615
2022-02-23 23:16:41-05:00,13102,22JE5fm9AfMDb7trY9333TRh4PyNmP7VjvvJM4R8XeE7,GR8Q26CoBKMSkodvKEqEEyY7eLssMc7PWDMAmBo1zfcw,True,166736,41684,246,123,123,72FwbpFGoLEazJEdpqNtPNefsadUrimUqma9wSoy4qiS,9842,65138,-55296,590
2022-02-23 23:16:41-05:00,13103,2eFLHfWwuTKeGn9Xm9VQk1Ae7BA9j3Vs7Kg5Unn3qaXi,3JJCnrCAR4fwYJChZvBzLdgvWs1ogcNqKRWHa6VABbcU,True,15426529,3856631,24075,12037,12038,HfEnetJ7uBSmZWCjBNxdvv9HEC5nsW4wDV7wu6WnhWan,963024,4458902,-3495878,624
2022-02-23 23:16:41-05:00,13104,gwRpwn2swQgwyJ7ijihN1aKNb1LtsvJwWpWkGc3ttEc,HT22Au8YZoja3ijYVuxEwSZdve73yrp1NKczv4vGbzrL,True,167355,41838,260,130,130,3zqXX6kzhkbW3d4TwD2CNjMRwxTbREXySekvq37kfCNk,10425,65102,-54677,622
2022-02-23 23:16:41-05:00,13105,4vyDdNpAy92raa6roc12PdabWyqKLgKsrGGVpHaSCwPg,6hzYoxgC3ZHqhdmkgmudaVe6o7hmvThKqzPbH3xtFGF1,True,62960,15740,97,48,49,2BPYaeCXY4BCFSGFSfiGtqmhzJ4fkhYLxGjqFvLCB6hG,3913,16139,-12226,621
2022-02-23 23:16:43-05:00,13106,95urWGJ4HN1bTarbDi8Dpj4K4ms7dovs8gwaYdaSLC6e,2THhqxjhXjp2Zui9ML2MzAbGN4dsfa3dkdqzC8LYhnbQ,True,27964,6991,43,21,22,HfEnetJ7uBSmZWCjBNxdvv9HEC5nsW4wDV7wu6WnhWan,1747,38278,-36531,624
2022-02-23 23:16:43-05:00,13107,EB5HH1VyFu2XrwMArCsDer8tGysBYyx9NHtpPGhma2K4,BoYdgR6GHMPghAQZVeahdFkCZW3xsuDsUZks7wetb9nD,True,61262,15315,95,47,48,HfEnetJ7uBSmZWCjBNxdvv9HEC5nsW4wDV7wu6WnhWan,3831,14892,-11061,625
2022-02-23 23:16:44-05:00,13108,4nhdidD6SASYzwZ7mUnWKyP4xyWXhdBe2gp5F4qDtLrL,HLk6YPhVidsn3i8HfoASvoim1ztxb4bi8JnioiyvorpV,True,107305,26826,166,83,83,HfEnetJ7uBSmZWCjBNxdvv9HEC5nsW4wDV7wu6WnhWan,6652,147387,-140735,619
2022-02-23 23:16:44-05:00,13109,Hqzz5RdbkkmMPCVdxF3Q3sLuh7XVJHEwAP6zpz7pCwTj,TNwXSETgrJGM9S5zbBY3mMWKbPFskbKjPAhBrWFNfuK,True,17078,4269,26,13,13,HfEnetJ7uBSmZWCjBNxdvv9HEC5nsW4wDV7wu6WnhWan,1066,23977,-22911,624
2022-02-23 23:16:44-05:00,13110,9rgrRAMcGSarfz8xXckw1LjkemMwwjzJLApPjpfY2XZ3,BRtNdDDtCiNDYDERZTBCefUiYvjShucRX1hxEBLyeggT,True,15081,3770,23,11,12,HfEnetJ7uBSmZWCjBNxdvv9HEC5nsW4wDV7wu6WnhWan,938,21252,-20314,621
2022-02-23 23:16:44-05:00,13111,C1tcxAjMzZaFVcF2ke2nSyiCjcLBwsz5yKXShy5MB14h,GYkrJj2zHVZuzPC45MbuevYkRJHdeL4Sqj9SWqZfUdiE,True,999405,249851,1561,780,781,HfEnetJ7uBSmZWCjBNxdvv9HEC5nsW4wDV7wu6WnhWan,62452,1359316,-1296864,624
2022-02-23 23:16:46-05:00,13112,BTds7W9qPzLihhoWt6vX5paepTtZBeDvSbeqbvDRuUMP,6dZH72G6AerkQybAFyaPqYdYeHofkSnZbciBGsqF74hk,True,139336,34834,217,108,109,HfEnetJ7uBSmZWCjBNxdvv9HEC5nsW4wDV7wu6WnhWan,8703,42459,-33756,624
2022-02-23 23:16:46-05:00,13113,DD1a8rMoUCwmEiLKRN43VpdqL8Qgfr5yi92ejQxDVRMo,3vMJVNAuyRhM9jkaEZARhwbR6MerR5UmcgoZ9c5bs1VS,True,349422,87355,543,271,272,2BPYaeCXY4BCFSGFSfiGtqmhzJ4fkhYLxGjqFvLCB6hG,21744,492307,-470563,622
2022-02-23 23:16:46-05:00,13114,28YQqynu5oRud5xEcsDvAaGhJhgpiVJSTNeMwkrbpbyv,9zYqRWiRatbohCdBfV3PrAxp8v1kwgbvV9ta4RJRRp68,True,778027,194506,1206,603,603,2BPYaeCXY4BCFSGFSfiGtqmhzJ4fkhYLxGjqFvLCB6hG,48270,1062078,-1013808,620
2022-02-23 23:16:46-05:00,13115,5iRLEmB6qBHqkJBPyyubnd9f1TpRr4EY8BTxuHUREeLB,GkY73KL6HJ4ycdggFtYWALBgmTRZVCx66P2ZJ7E8ENwC,True,16303,4075,25,12,13,2BPYaeCXY4BCFSGFSfiGtqmhzJ4fkhYLxGjqFvLCB6hG,1013,22970,-21957,621
2022-02-23 23:16:46-05:00,13116,9wsQcvpqPp8c9q42RntWDNbqNCnmJeW4GMG2AtKAHkBu,EMqRbzGvXTU1LtmoSw9uSrpTX2L4tpJQAMJJJ4duvzf5,True,2710525,677631,4217,2108,2109,2BPYaeCXY4BCFSGFSfiGtqmhzJ4fkhYLxGjqFvLCB6hG,168705,2288216,-2119511,622
2022-02-23 23:16:46-05:00,13117,446VESPwhh16pG3VcpgraT83MoqWy87qgU36mKZC8BsW,SmUPkPpnnRfSH3tcKUnbpK6HHNJtLfvMiUWk9eUwkNy,True,789182,197295,1221,610,611,2BPYaeCXY4BCFSGFSfiGtqmhzJ4fkhYLxGjqFvLCB6hG,48869,1077453,-1028584,619
2022-02-23 23:16:46-05:00,13118,43EtYHdVkdBxHTtFR3QWVgvCKj1SqsAf7xLY2yphsv1x,8WJbP4mVJWYuN1dVzHpRg7YR2nBELB4Krkq8Zch8sp4g,True,23356,5839,36,18,18,2BPYaeCXY4BCFSGFSfiGtqmhzJ4fkhYLxGjqFvLCB6hG,1451,30872,-29421,621
2022-02-23 23:16:46-05:00,13119,EPWsutEpgpcz776maq552k8QhDKdmkSfAED5E3jgpTdY,CCwGZYDvqoHEBBtSSieAJgy5e3k4jYrpjyDffypwnWxu,True,793992,198498,1230,615,615,2BPYaeCXY4BCFSGFSfiGtqmhzJ4fkhYLxGjqFvLCB6hG,49237,1084063,-1034826,620
2022-02-23 23:16:46-05:00,13120,Bt37YbHvD2M8zcGmanksKy8MCi4Qzto7hEnGRJyNvWyg,4WGRnDhpoY4zJi74iJyALasETpJNJMCJtf9aWJUVrHQv,True,24376542,6094135,38011,19005,19006,3zqXX6kzhkbW3d4TwD2CNjMRwxTbREXySekvq37kfCNk,1520458,20550535,-19030077,623
2022-02-23 23:16:46-05:00,13121,BMawc4jLJMER4ryGcwdm27H3MU8JQCiSfwb9onVfYDpr,5ciaGDuaB3rBKvV7MphT2eMkCUxBzWZc7zYXQM7vbQ46,True,112261,28065,173,86,87,3zqXX6kzhkbW3d4TwD2CNjMRwxTbREXySekvq37kfCNk,6958,154012,-147054,619
2022-02-23 23:16:46-05:00,13122,5zCfNUARbvDrkdkf8rKNnf6D7HXn7Wz6D61jQGTGpw3N,6T76MLTxS5vnRuodEgADt3iXMx8WUFLQzoyKh7f2uPFy,True,34576423,8644105,53996,26998,26998,3zqXX6kzhkbW3d4TwD2CNjMRwxTbREXySekvq37kfCNk,2159878,29317393,-27157515,624
2022-02-23 23:16:47-05:00,13123,5FgPU7KpsDnx4Xc1UdQoLPR7MDd5cBkJXW2Q8ctopMZR,9GWzAZFVfTY8WjTYvDAE2YcAjgeKiDXgToK76KBZF7Rv,True,25245,6311,39,19,20,HfEnetJ7uBSmZWCjBNxdvv9HEC5nsW4wDV7wu6WnhWan,1570,34523,-32953,621
2022-02-23 23:16:47-05:00,13124,9RLPGyaMnS4zZfTbmd1CLWBatjkbr17n2ibhJjGgfwTT,2E81HC81TPbNnv1chxJrVLDfSiB9u2yaqamzHjLnFXLY,True,79200336,19800084,123298,61649,61649,3zqXX6kzhkbW3d4TwD2CNjMRwxTbREXySekvq37kfCNk,4931931,37843235,-32911304,622
2022-02-23 23:16:47-05:00,13125,58EpnDFZvzpSqs4YjpCHAmuXigCxvk9bfGDFos5cPjjB,HBNacFRqXrbRzVD72sRSzVXyCb6zDntS7YzgGJMuVmPh,True,7326,1831,11,5,6,HfEnetJ7uBSmZWCjBNxdvv9HEC5nsW4wDV7wu6WnhWan,457,2146,-1689,623
2022-02-23 23:16:47-05:00,13126,43wwd6zLB8yKfXEu7rtbeDFhKBuxFR66MnyhTKW3zqa3,A9t6AMvVNenwWymz3QMtdUuuGYjjTPLaA9bhRjTzNY9h,True,297526,74381,459,229,230,HfEnetJ7uBSmZWCjBNxdvv9HEC5nsW4wDV7wu6WnhWan,18365,419168,-400803,617
2022-02-23 23:16:47-05:00,13127,GcjcaWoMUcGkLaJBx3svxtzwGNn5SLcFrwaLqnpadUZY,Ep9sDjTMMasVjKdshsE88uk3mWYkKuMTVRooVJWvCq9F,True,290307,72576,450,225,225,2BPYaeCXY4BCFSGFSfiGtqmhzJ4fkhYLxGjqFvLCB6hG,18028,408956,-390928,620
2022-02-23 23:16:47-05:00,13128,E8iuHK2DErFnMAYfWmNoix4jVb4WDG8Sc41hBycLUxbd,77Zoru23JmnK5EJ8eURonQoEpJcLP4edabjD8MR8NKdX,True,296080,74020,458,229,229,HfEnetJ7uBSmZWCjBNxdvv9HEC5nsW4wDV7wu6WnhWan,18346,417468,-399122,619
2022-02-23 23:16:47-05:00,13129,4eaXYcx5ayhTq9TmmQFgLDjy6p3z93txUN97v8PTSh1J,J3vgUnjDUy5ngrmrs6FwpZTexxJNxXM1UjsHvsgw9g9y,True,19098,4774,29,14,15,2BPYaeCXY4BCFSGFSfiGtqmhzJ4fkhYLxGjqFvLCB6hG,1187,26891,-25704,621
2022-02-23 23:16:47-05:00,13130,FRvMjD6zc3KXqdj5VhPBUaW7qHYktbc9WzPYPAiwtZrx,91LzVLfMLiLGjs7MJjz1JgUr2L65Mf4GP7yVkGinnCxq,True,48948599,12237149,76430,38215,38215,3zqXX6kzhkbW3d4TwD2CNjMRwxTbREXySekvq37kfCNk,3057218,15801824,-12744606,624
2022-02-23 23:16:47-05:00,13131,HZSJVNb6g4o52N7pAJCLkGjur8evF5Ex1sAx7uUxUDdm,8LQHKhXStrwcd6f4AxaTVcrGdYpGjQz8vWf5JXsAzcsp,True,21955,5488,34,17,17,HfEnetJ7uBSmZWCjBNxdvv9HEC5nsW4wDV7wu6WnhWan,1368,30975,-29607,623
2022-02-23 23:16:47-05:00,13132,EmXaq1sxmAZUiwYW6LXpKtKFZXu5MzQ3sK4MEAojDK1h,HuAsa5G2wJi8Ah9stxEmggwcB5zW1QjBsP3Ndgke7r8X,True,25561,6390,39,19,20,2BPYaeCXY4BCFSGFSfiGtqmhzJ4fkhYLxGjqFvLCB6hG,1591,35948,-34357,622
2022-02-23 23:16:50-05:00,13133,HpRYrL8HzCPaBJTLFgZmYg2aXBnBQUpf1mikVkzkY56z,8DzHRd8qWcEjnX6cefwYtgRGpQJUaw9QPjyfAsN7j33r,True,194770,48692,303,151,152,2BPYaeCXY4BCFSGFSfiGtqmhzJ4fkhYLxGjqFvLCB6hG,12123,268333,-256210,622
2022-02-23 23:16:52-05:00,13134,Gfe4UgUGqvzcehSbETrWwLRAcqzFnkTrs6vJx8h6kTxi,7exMQ8sLti4Pmb2ZQtZhyuWRuQ6pq7XSXL9sCcWTqCvF,True,1552192,388048,2428,1214,1214,2BPYaeCXY4BCFSGFSfiGtqmhzJ4fkhYLxGjqFvLCB6hG,97142,2150958,-2053816,625
2022-02-23 23:16:53-05:00,13135,2jDRvE3pQNjWy1NRFa4tzB3KmU5UkbUCHw8sQRFujo66,C4zNi2szDrEEh4coTF3WRUghfP4ZwAVVSYTLWfkejQRu,True,791140,197784,1235,617,618,HfEnetJ7uBSmZWCjBNxdvv9HEC5nsW4wDV7wu6WnhWan,49414,702664,-653250,624
2022-02-23 23:16:53-05:00,13136,9T6bCVf7AshQP1NNbsF3eCdbChKbcfrFUPFWUXRijY5M,4ZFq3kdwaUhiotXCXzDFjVCAP3udzGsx5CicgLLXd4PR,True,10719475,2679868,16695,8347,8348,HfEnetJ7uBSmZWCjBNxdvv9HEC5nsW4wDV7wu6WnhWan,667818,9047128,-8379310,622
2022-02-23 23:16:53-05:00,13137,7rv6mScghVBDC6cdbkZ47NtqqrTZAqyewKEsRHUkP6x5,EFgBoSg7u5yHdR5kqARTb3BUGmwnuz6g72GsuJTBiEEv,True,11242,2810,17,8,9,HfEnetJ7uBSmZWCjBNxdvv9HEC5nsW4wDV7wu6WnhWan,702,2586,-1884,624
2022-02-23 23:16:53-05:00,13138,8xjstKJD2RopRxxRP8JbMYRmpBKgSZivMFRXXRZ5syPh,HUfevkvBsm5SDpxnZ4NBD8Re7LvqBQLrx5UWXCeYTBgK,True,28279,7069,44,22,22,HfEnetJ7uBSmZWCjBNxdvv9HEC5nsW4wDV7wu6WnhWan,1762,38723,-36961,623
2022-02-23 23:16:55-05:00,13139,CEtpqFD4BbeiNfaXyLLYEapY2mWgE26H5q6H34tWwRuD,BVqRyqwGFPzSkk1H2finiyfaL3LScbEiQGk3mihirxqs,True,14061,3515,21,10,11,HfEnetJ7uBSmZWCjBNxdvv9HEC5nsW4wDV7wu6WnhWan,875,19546,-18671,622
2022-02-23 23:16:56-05:00,13140,s3MwEMLs777XFqetPJT55cw8NYXg8uHqr6Bnxdvq3bE,GN2D9JsJ8oXhSHXTvvWnoXDfv8JLVYx3ZGNwjAV2Dd3j,True,1258506,314626,1962,981,981,HfEnetJ7uBSmZWCjBNxdvv9HEC5nsW4wDV7wu6WnhWan,78497,405190,-326693,623
2022-02-23 23:16:57-05:00,13141,8GdYhwX26GRmVfGFCbJ3MJrH1UdneN2FNRUexhLsqprN,DpUTHSVucDPyCWoLCdpm8EFRZFiKL88tmnSiWG2TRpS8,True,17123,4280,26,13,13,HfEnetJ7uBSmZWCjBNxdvv9HEC5nsW4wDV7wu6WnhWan,1070,24040,-22970,624
2022-02-23 23:16:57-05:00,13142,4yhW5mBsFVNgQ5QQc2Yg65guctPsTSXcERbzmYM6rdnL,5uJnMZ6DWA9bMSvHvS5zomwtt1sv7YCWq3GDJh77YC3q,True,18778,4694,29,14,15,3zqXX6kzhkbW3d4TwD2CNjMRwxTbREXySekvq37kfCNk,1162,26529,-25367,618
2022-02-23 23:16:59-05:00,13143,HGJoZvLakWfSDFwuvShNBc4kCf7nP7VqzyM3mELpbFEf,12Qn5jin7QvsBngXqYAv4UstyG3b6nRf1jsLp9Dp8G7k,True,1191,297,1,0,1,2BPYaeCXY4BCFSGFSfiGtqmhzJ4fkhYLxGjqFvLCB6hG,74,1718,-1644,621
2022-02-23 23:17:00-05:00,13144,Fw2e6jxKVeFcJSe9MyVhSz3dUdJQLs3XULHrT1mtMU9U,591U5bexgLRJXygtK5fpCRXcZEq89KgewFTdfPkti8bY,True,2258495,564623,3476,1738,1738,HfEnetJ7uBSmZWCjBNxdvv9HEC5nsW4wDV7wu6WnhWan,139047,2885790,-2746743,615
2022-02-23 23:17:05-05:00,13145,H8xJwJy5oLYSGV9ZkQ7f99ibaTyDTmPwLPa9dEjse3wd,D9bhD4xKEvYJq2erBS4NAp4RzTnPgFUFiKfoyj8CbZNi,True,373746430,93436607,584651,292325,292326,HfEnetJ7uBSmZWCjBNxdvv9HEC5nsW4wDV7wu6WnhWan,23386053,170519623,-147133570,625
2022-02-23 23:17:05-05:00,13146,AQr9mVmcXCNQhBVCfx63MwR6c4WqDSC9K2BZqr7N8LCx,CB7TWUaL381ounsLw6neAUaKRxJL9P1HC9uGX5e1Uxod,True,13390133,3347532,20936,10468,10468,2BPYaeCXY4BCFSGFSfiGtqmhzJ4fkhYLxGjqFvLCB6hG,837477,6550024,-5712547,625
2022-02-23 23:17:07-05:00,13147,CygwJ5Z1ZP6xfjN1ZGH7yw8b2oYvf6JTpenXx7A5yFdt,59VKgJtBCTb3Pji7BWtqttisBYVVCnWtyEn5Eba5r52Y,True,332533,83133,519,259,260,HfEnetJ7uBSmZWCjBNxdvv9HEC5nsW4wDV7wu6WnhWan,20797,439891,-419094,625
2022-02-23 23:17:07-05:00,13148,EbScW49FqTmK83BKPFVZWdrJ4XAfoATRT7bbZQZC1anL,3tfG6ocjfFsr7u53NRhcnhNvRqRbmyEa5t37rMhtLyY1,True,529056082,132264020,827441,413720,413721,2BPYaeCXY4BCFSGFSfiGtqmhzJ4fkhYLxGjqFvLCB6hG,33097651,293684230,-260586579,625
2022-02-23 23:17:07-05:00,13149,6kt64nJRnYaWMi9GbpZaUuhbToAVRd7FUMTGASAAJrve,2Sdxv9ZtogNcVbJwBPxKmVjwAiKyX5GHEfnRmFcydQ1G,True,2221389,555347,3475,1737,1738,2BPYaeCXY4BCFSGFSfiGtqmhzJ4fkhYLxGjqFvLCB6hG,139016,2840572,-2701556,625
2022-02-23 23:17:08-05:00,13150,Hkc6fny4GVzErYtfZiHYK995QLoWSfrNutYo3La78cRc,B8ZbsieWAkXEKBiXqzpwjhHTxFC42N1ddQp4jxVE8mra,True,3062932,765733,4784,2392,2392,HfEnetJ7uBSmZWCjBNxdvv9HEC5nsW4wDV7wu6WnhWan,191364,725168,-533804,624
2022-02-23 23:17:10-05:00,13151,8YMEydGnQH9W5AEXFGquFkb1bcf3PcxiMvYBSMPXKJyQ,3CmWH8eYtkmHNisqMmMBLff6C6z6ZcSj38KoQ34DPUE7,True,14978,3744,23,11,12,2BPYaeCXY4BCFSGFSfiGtqmhzJ4fkhYLxGjqFvLCB6hG,937,19817,-18880,625
2022-02-23 23:17:10-05:00,13152,4cNmhgaMic1xBiaDJ6phrQuXmm8WfF1qjyYMqZcKG4c9,43vgfXiLTtcs1bkrcDar2iz9M6RMbGqbA6BMkBHdh7T4,True,17935,4483,28,14,14,2BPYaeCXY4BCFSGFSfiGtqmhzJ4fkhYLxGjqFvLCB6hG,1120,25391,-24271,624
2022-02-23 23:17:11-05:00,13153,8GhXRNmsEgFgKPhGNNgEPUywVzW3bE7uZRWys2P1yNeJ,Bvi5vD5fhRFNdVhEXsSv9vkJzyQzgEswFHBxowkUEgF,True,165033,41258,257,128,129,3zqXX6kzhkbW3d4TwD2CNjMRwxTbREXySekvq37kfCNk,10310,230112,-219802,624
2022-02-23 23:17:14-05:00,13154,FSjUzAuFJJDeBerdVPJbWjTyD47GpJRat2h1eCUD1HPH,GT4MarSodCNayJqgVEYMkJQjRvCYYb7S8WJoSaLC144U,True,18594894,4648723,29037,14518,14519,3zqXX6kzhkbW3d4TwD2CNjMRwxTbREXySekvq37kfCNk,1161503,7528247,-6366744,624
2022-02-23 23:17:14-05:00,13155,7afnF1MkAootZGWc7zsMVLpBuve83hGmvAHkfmwgsq5A,HKdJE8bReznq1Qxqd5iZ4nWQGCk62Vo5TpkRD51bpbGp,True,19639,4909,30,15,15,HfEnetJ7uBSmZWCjBNxdvv9HEC5nsW4wDV7wu6WnhWan,1223,27636,-26413,622
2022-02-23 23:17:14-05:00,13156,3R2wxFQwjCqUwwxJmp9tNrT6osYFpB5gczq2QYik6QYm,7At5Ej3ZsynfWr56FYrd4P4Y6UtD8FHA4gCFB8TaAyaG,True,19131,4782,29,14,15,HfEnetJ7uBSmZWCjBNxdvv9HEC5nsW4wDV7wu6WnhWan,1196,26933,-25737,625
2022-02-23 23:17:15-05:00,13157,45AiuRBbmupfwYXqsWwKHtmEWN8XNJDUSHwHL3b6PvHc,CfvwVkxYPP3jqK2dpAvSRFA1513E9ti84mEpYgtkzFUt,True,32516,8129,50,25,25,2BPYaeCXY4BCFSGFSfiGtqmhzJ4fkhYLxGjqFvLCB6hG,2032,44404,-42372,624
2022-02-23 23:17:15-05:00,13158,73Wkg27usHy8knWENTmb9zbikugYh93JvBB2bF855vZ2,J9WaUA7r8ct4ZG8o8ATZjvHUPuCYqY42aTsr9xveW5BX,True,20019668,5004917,31246,15623,15623,HfEnetJ7uBSmZWCjBNxdvv9HEC5nsW4wDV7wu6WnhWan,1249840,34025291,-32775451,624
2022-02-23 23:17:16-05:00,13159,6Y7FZTyXEwKHvoYQGDnuZShg8YFgZUetGt4eoBpPPp7E,2dkDLHmDZKUA96PPUvkz6s4g1cMeJfaF5t68VexgooFo,True,323083,80770,502,251,251,3zqXX6kzhkbW3d4TwD2CNjMRwxTbREXySekvq37kfCNk,20083,100534,-80451,621
2022-02-23 23:17:16-05:00,13160,AECUZGm5DjFvbLZEUYhepSPg1Wa7hBjxF9e7ZRBzRPhm,Ar7e1iLKAqa54QiQnXifvnETixDZT1T8KL5YWJA8Ykv1,True,23165,5791,35,17,18,3zqXX6kzhkbW3d4TwD2CNjMRwxTbREXySekvq37kfCNk,1439,32554,-31115,621
2022-02-23 23:17:17-05:00,13161,2DHhfXSzcuSwsKfAYLMuWuD17w84mCwNer9fcBNLTpSc,89BVfDycKjdSkQzFVqCXd5c16DntdND7WsqoZtCafYFH,True,915059,228764,1422,711,711,HfEnetJ7uBSmZWCjBNxdvv9HEC5nsW4wDV7wu6WnhWan,56918,1255817,-1198899,622
2022-02-23 23:17:17-05:00,13162,HxhVxMpFpKzeuC6Z6CpsuUhPHdHUzvpMNYJ8LpQ3NYCp,8KyiipC39iU15zVErVvj6hdhbv89STsexrB8dVw3RcLs,True,20036,5009,31,15,16,2BPYaeCXY4BCFSGFSfiGtqmhzJ4fkhYLxGjqFvLCB6hG,1251,28239,-26988,624
2022-02-23 23:17:19-05:00,13163,CYcgATWjZUXrqxJyVTEMkDBv1eyUjb1TZi2raTd1ujvU,7jefj3noz9JDDnJ74YZL946EPJtywSnPsi7ZpgU4Wj1G,True,6175618,1543904,9406,4703,4703,2BPYaeCXY4BCFSGFSfiGtqmhzJ4fkhYLxGjqFvLCB6hG,376274,3544249,-3167975,609
2022-02-23 23:17:19-05:00,13164,2AAWghW6BUAFBtF3R6hB9uoqMc5oUDkU8FTd2JrXKema,798cfEUZ2YhXwNTNjXMS4Z2J8gAHaK4zZwpMkq2HzWWM,True,102714897,25678724,160439,80219,80220,2BPYaeCXY4BCFSGFSfiGtqmhzJ4fkhYLxGjqFvLCB6hG,6417568,102656339,-96238771,624
2022-02-23 23:17:19-05:00,13165,8Xt3qHjZG3zLxozgM5vPHMVxp8eYFMg89kaVW7vdHKoA,2i8riSsQpfADD9LUVpiBJBfX5qjVAgmZegzfKx6RG9dW,True,12498981,3124745,19466,9733,9733,2BPYaeCXY4BCFSGFSfiGtqmhzJ4fkhYLxGjqFvLCB6hG,778660,6563294,-5784634,622
2022-02-23 23:17:19-05:00,13166,68F35fonSGS1P6LMYmAmeoM8kC6Z78NabMqYLeCZr9GJ,8apmWSZdS8s1ScoNVj4AvSJsbQCj1drU3HL74khuANT2,True,20339,5084,31,15,16,2BPYaeCXY4BCFSGFSfiGtqmhzJ4fkhYLxGjqFvLCB6hG,1272,28602,-27330,625
2022-02-23 23:17:21-05:00,13167,HZJyrD4eqM4nKnyRh2JAs1sC2TaJxFhNPixBdK7PLMuS,Hycz71z4tEsKUogJnefT2GN3MPCLdTJdv9B6T82Ngw2u,True,82292,20573,128,64,64,3zqXX6kzhkbW3d4TwD2CNjMRwxTbREXySekvq37kfCNk,5135,116618,-111483,623
2022-02-23 23:17:22-05:00,13168,9QZvB1Gqhk5PKt3MoJMjZL3FaU2bTbTDcVw3nF316zh7,DGJWGr9RCWkzdWn21mWG7NyUN8uuvSQbA53HojFJe1rH,True,245980,61495,378,189,189,2BPYaeCXY4BCFSGFSfiGtqmhzJ4fkhYLxGjqFvLCB6hG,15127,334937,-319810,614
2022-02-23 23:17:22-05:00,13169,AzLdwyd8Q4V3iMaSwWgvWwQ9nCs7X7YV2YKpd6CH33nP,BYjeXF5YkcJy3mNMbvfHzXTtyjkc4U53hM5tvfERUH8y,True,18986,4746,29,14,15,2BPYaeCXY4BCFSGFSfiGtqmhzJ4fkhYLxGjqFvLCB6hG,1167,26716,-25549,614
2022-02-23 23:17:22-05:00,13170,69byqtDPmgEY1NqKBCR95CEPVHRUxgbNW9Y4P4HjQ7ND,E47T4q4zMGzNL6vDxgWdLn3EQbW3WfVryr8Jsymy1hAL,True,31540,7885,48,24,24,2BPYaeCXY4BCFSGFSfiGtqmhzJ4fkhYLxGjqFvLCB6hG,1939,40949,-39010,614
2022-02-23 23:17:22-05:00,13171,E4hzgCW69WjwBVWvTv4EvyTLT63dVBrS2gXeHCaezPrb,GTxQfXHAj9HTiwu7EwEKAQ1ZKoZDmcBgevJoZUDag1Gr,True,20597040,5149260,32020,16010,16010,3zqXX6kzhkbW3d4TwD2CNjMRwxTbREXySekvq37kfCNk,1280825,10201390,-8920565,621
2022-02-23 23:17:23-05:00,13172,6bMu9G5S9o2CSgHegDAymE4UcxrnKH9UfPE5iUmUJ6Aa,ACG6V3LfAH3JtJbBhiumrx7c4QciavNmGWKfBFt7eRz7,True,1183911,295977,1835,917,918,2BPYaeCXY4BCFSGFSfiGtqmhzJ4fkhYLxGjqFvLCB6hG,73417,671072,-597655,620
2022-02-23 23:17:23-05:00,13173,EAUFD16wab8qRMJ4H6updHGt4xFqgRCDeRHVCsLCTSTL,8vkfYSyCyBY9g4TZrp52jUcQj6udy9xAaA4fioRE2RXx,True,11448062,2862015,17669,8834,8835,HfEnetJ7uBSmZWCjBNxdvv9HEC5nsW4wDV7wu6WnhWan,706772,10037092,-9330320,617
2022-02-23 23:17:23-05:00,13174,7Dm3syN4P2mbBLFKyHTrtnSWY4hadGXiKB9EekTdT68S,HF97QS1dqarPMWgNmtcoaq6z3rpJnzAAAfc1PP4FwRhV,True,16989,4247,26,13,13,HfEnetJ7uBSmZWCjBNxdvv9HEC5nsW4wDV7wu6WnhWan,1050,8562,-7512,618
2022-02-23 23:17:23-05:00,13175,6X5por58mMECmNZQEWpo8M8aA1eHJqr5LNeV9vC7GW5e,DPB2C5UB2Ls1kNzbs1GP33junQvhUyFJWP75RoYjqByn,True,1018235,254558,1570,785,785,HfEnetJ7uBSmZWCjBNxdvv9HEC5nsW4wDV7wu6WnhWan,62829,2167676,-2104847,617
2022-02-23 23:17:23-05:00,13176,8VQ21PFXdHBNmiZiF18LyGvsRSpr13vkyktfembNCe3m,5exbVC7vaGFeHEGAx7epYfMaU932QafqzfhFm5FKAq2H,True,17281,4320,26,13,13,HfEnetJ7uBSmZWCjBNxdvv9HEC5nsW4wDV7wu6WnhWan,1067,24314,-23247,617
2022-02-23 23:17:23-05:00,13177,9WRDBHzD4aNHw5qvrhc6nqXCBLA5D7YYP8TvSrLksXd6,GwxWNmv9XDkqQsx7DfCMccFjVik8asPnFU9gtnb4UVx,True,14780,3695,22,11,11,3zqXX6kzhkbW3d4TwD2CNjMRwxTbREXySekvq37kfCNk,908,20838,-19930,614
2022-02-23 23:17:24-05:00,13178,ANXYsUNpZ34dBt7cp6HEE7oi2pTKsbj7B5TeFHKPbHBU,2pqeP4fuMREosHcfWUecEBssp1GM4isihNjn7ALUD51d,True,23248,5812,36,18,18,HfEnetJ7uBSmZWCjBNxdvv9HEC5nsW4wDV7wu6WnhWan,1447,32712,-31265,622
2022-02-23 23:17:24-05:00,13179,FV9CBGGTbppLnBKh79f2LzD1diTiS5g6u89FcpZHZmnK,Fe7mtmCUziFqbbYTvrhAcAq1Ub7YLfTJRtQ1hG7GzJD1,True,4780929,1195232,7409,3704,3705,HfEnetJ7uBSmZWCjBNxdvv9HEC5nsW4wDV7wu6WnhWan,296364,1233609,-937245,619
2022-02-23 23:17:24-05:00,13180,6TvTxJWSPeyaTVm8PmarVDzxhbTqnkyoabQTgihXyGMj,62ngTMHaRDFjpvzasDgfmgyJ5T6jS9PmYgy97HCkyQS4,True,539955,134988,834,417,417,HfEnetJ7uBSmZWCjBNxdvv9HEC5nsW4wDV7wu6WnhWan,33372,222119,-188747,618
2022-02-23 23:17:24-05:00,13181,Dqnxcekm1QfxGQ2FSJ6SjFiwmaQRWEjW9WTJQG4AjEpE,9JiMtjm5AJqngosRg787FiN8NyuBPuAPD2jYpRQkAc1d,True,24883,6220,38,19,19,HfEnetJ7uBSmZWCjBNxdvv9HEC5nsW4wDV7wu6WnhWan,1551,35036,-33485,623
2022-02-23 23:17:24-05:00,13182,oTq8BsGLNc2ddcdR7ELnCXgzf4KvtA7REmfbFKo56FT,4PgxGgi2UaB753PFyELQCrJy7phAkYsW4e39J9wGWrcM,True,1199863,299965,1856,928,928,HfEnetJ7uBSmZWCjBNxdvv9HEC5nsW4wDV7wu6WnhWan,74254,2628636,-2554382,618
2022-02-23 23:17:24-05:00,13183,GM22yjVoBCzgBcVTT5EcgRhVWiXVV82kSj1dPCbegKWj,CDDy8JmJMwJyx1YAvEPpj8AYxCpngRovf3wWfVzao5Rc,True,11297,2824,17,8,9,HfEnetJ7uBSmZWCjBNxdvv9HEC5nsW4wDV7wu6WnhWan,707,9470,-8763,625
2022-02-23 23:17:24-05:00,13184,AiLCB8xw3k5FXdJE1T42PLFhHrz1bLTKpNekR61a915N,HB7CNWxLipWAc6MPGq9wV4TT7AYjiELA5T3onYeVqBbU,True,384056,96014,597,298,299,HfEnetJ7uBSmZWCjBNxdvv9HEC5nsW4wDV7wu6WnhWan,23881,544596,-520715,621
2022-02-23 23:17:24-05:00,13185,G8nRLTWTT5aD7q7TcSa2mw7p12GUuHDVq5ev4vyXbdKi,3DmQyungZMK4T1a1PgXh5shBskwP69tTLmZPh7HZ76vh,True,27915,6978,43,21,22,3zqXX6kzhkbW3d4TwD2CNjMRwxTbREXySekvq37kfCNk,1722,39282,-37560,616
2022-02-23 23:17:27-05:00,13186,9hB3EPuj4SrSrpAzHvExDb6mzh2vNGGVbj7qqfRjeao4,9725jRXGPRUuo1dijvv8mwzvSu1ed4y5hi9FAQNwb8dG,True,324736,81184,508,254,254,HfEnetJ7uBSmZWCjBNxdvv9HEC5nsW4wDV7wu6WnhWan,20324,456612,-436288,625
2022-02-23 23:17:30-05:00,13187,DYCYiQFH9QHzCo3eAw1pFoDu7pzwFMo1E2WDZjVFRz5w,CPh4FWsGak1kd1WFEH9qBjNhnun3R2tHtZA57zW8ugn5,True,114734505,28683626,179549,89774,89775,3zqXX6kzhkbW3d4TwD2CNjMRwxTbREXySekvq37kfCNk,7181986,37284996,-30103010,625
2022-02-24 00:07:52-05:00,13188,8abFwhhZyq3xkvjp4NWDBt7qAPXBbzBxksUk8SAUeVkN,A9u4dhWZbBwthC4WXQg1Dfp3wHYXr67SGs5na1EQ1k3r,True,2668533,667133,4161,2080,2081,HfEnetJ7uBSmZWCjBNxdvv9HEC5nsW4wDV7wu6WnhWan,166459,923189,-756730,623
2022-02-24 00:14:02-05:00,13189,9tt8Hp2uzgmuv9fHSZDH299ytZGpqQuqA4arrksvpncJ,J1Y4k1hkmxncznXCdgNSmH7aW2Zdppe9QPWZZmanXrAL,True,149858369,37464592,234269,117134,117135,3zqXX6kzhkbW3d4TwD2CNjMRwxTbREXySekvq37kfCNk,9370792,47512423,-38141631,625
2022-02-24 00:17:03-05:00,13190,Cgga7cjzsiecXRFLLf4jnEaGGwzr6qroh36G7kz3tV2t,AhUKdVt6jf8L2p5DbxkYPMAZUFqpz1uKBgPMUBJqEcnz,True,6485506,1621376,10138,5069,5069,3zqXX6kzhkbW3d4TwD2CNjMRwxTbREXySekvq37kfCNk,405529,2223340,-1817811,625
2022-02-24 00:17:17-05:00,13191,52pCCDDTo6uQhENab7rCsqS5ZihDDBmMSTQdCj8QLoea,GZh4ev3p6RrDRo98WfQQ7ZzzMBbqWF9gj9WbicU7YWD4,True,17392202,4348050,26746,13373,13373,2BPYaeCXY4BCFSGFSfiGtqmhzJ4fkhYLxGjqFvLCB6hG,1069874,7408265,-6338391,615
2022-02-24 00:18:52-05:00,13192,aTkGURJptmKNNP6RSXSWsmVbfcriSAJaMuUiT2eZEfb,5qoGxL83PLhrguyk27X8xE6jGitRg5BaQpXzrcfEvCfJ,True,39452255,9863063,61662,30831,30831,3zqXX6kzhkbW3d4TwD2CNjMRwxTbREXySekvq37kfCNk,2466504,12659297,-10192793,625
2022-02-24 00:24:55-05:00,13193,3idUQDMPAN9f6F6BipHAYFZyhG5JADey1y7JcFYx5BRh,D6UMk8WsSRahs4nGyi9DLt2HyZQy4wAywDwL31sL8BVj,True,1003228,250807,1562,781,781,HfEnetJ7uBSmZWCjBNxdvv9HEC5nsW4wDV7wu6WnhWan,62489,414743,-352254,622
2022-02-24 00:24:58-05:00,13194,71DcjZY2Fd1Jg9YkDXUH5usC9QcHeQqSxoEk7tH3fhzo,3o4iDHXNpNVAHaHzVirbcNevP6YfoP2EqddBNoSRU4hn,True,7025078,1756269,10966,5483,5483,HfEnetJ7uBSmZWCjBNxdvv9HEC5nsW4wDV7wu6WnhWan,438661,2793729,-2355068,624
2022-02-24 00:24:58-05:00,13195,5gN3624v6n1zQ1BKtZi1e9ZLpbCa4MEfhgHySFB81Qfm,UXT3oB5ud18rBsygsfxwA93kQYdSNbbzTCjt4gtU2jP,True,8650402,2162600,13516,6758,6758,HfEnetJ7uBSmZWCjBNxdvv9HEC5nsW4wDV7wu6WnhWan,540647,2701032,-2160385,624
2022-02-24 00:25:12-05:00,13196,9E97vZ6evPgg1Ao8KwvjjZhBFW6dXZrrJENk1HvZ3SU,D7U38PB8BXLwUVKbRNv9po7VcFdnn7Y4tWY9xpRiNJsT,True,1354156,338538,2105,1052,1053,HfEnetJ7uBSmZWCjBNxdvv9HEC5nsW4wDV7wu6WnhWan,84207,617084,-532877,621
2022-02-24 00:25:14-05:00,13197,JE6YNDmKQsxj4zsURyr1eh5cJjNCR2CvLmawufXWMCKx,2ctukoNZQ4BwabFZBJfhK2ic67ChHnGSBJyiSnmiCpAW,True,86432420,21608105,135065,67532,67533,3zqXX6kzhkbW3d4TwD2CNjMRwxTbREXySekvq37kfCNk,5402617,18183424,-12780807,625
2022-02-24 00:25:27-05:00,13198,EYNh72buYHmKWRSqF8omcFHRbqKWV76iXB2vrjHgQMck,Efm7bH2DFg5Y5M39jq3uDcoDHUa95zmey8n7Ld72jG84,True,11786528,2946632,18398,9199,9199,HfEnetJ7uBSmZWCjBNxdvv9HEC5nsW4wDV7wu6WnhWan,735953,5298831,-4562878,624
2022-02-24 00:25:39-05:00,13199,Cv5oVktxmqbU1SxraxH67NEWMKnjgA18R832Fhe9h74a,Cs7xBD4BDiohyopnaYDDChUtR9vmx7uwot6Qp9beQLzt,True,6894368,1723591,10782,5391,5391,HfEnetJ7uBSmZWCjBNxdvv9HEC5nsW4wDV7wu6WnhWan,431289,2723465,-2292176,625
2022-02-24 00:26:30-05:00,13200,9otCHuzKcxUCC4EgPJkio8Df5gXWB6DtZQnZvWtPfsh6,8cNPdP8rA9sBpcKpmCNcp4W2AYonYdFNoyVmboT6y1Bb,True,28669724,7167431,44790,22395,22395,3zqXX6kzhkbW3d4TwD2CNjMRwxTbREXySekvq37kfCNk,1791601,11166762,-9375161,624
2022-02-24 00:28:19-05:00,13201,BJUNK2orMVx6mYsD9pnQzmsEh95ZF2NWPm9KJ1ZM67Qn,FpxLa3DwWrspYvHVsScSDcscHB2eBHGxRrQ4gVvn4VW,True,399463671,99865917,623877,311938,311939,3zqXX6kzhkbW3d4TwD2CNjMRwxTbREXySekvq37kfCNk,24955105,114220287,-89265182,624
2022-02-24 00:28:33-05:00,13202,7rq3F5ZQXc991M4SCSqvhYKL2SsPT1DKjBBUoxovYt1e,BwzUY6Tyc5TnBfSajK9WeyjGVqVj6Lup73vd88dSc1vh,True,2271870,567967,3538,1769,1769,HfEnetJ7uBSmZWCjBNxdvv9HEC5nsW4wDV7wu6WnhWan,141523,1447596,-1306073,622
2022-02-24 00:29:01-05:00,13203,CcV2aMbd36MCH9wKTJPH1wyEUgErHBbT3gBWedPFeMgh,4nT6pkWKa6P8LmVX9Cur45xqJaqe3YnRFqjeFzUY9eMa,True,47704017,11926004,73448,36724,36724,HfEnetJ7uBSmZWCjBNxdvv9HEC5nsW4wDV7wu6WnhWan,2937949,12244270,-9306321,615
2022-02-24 00:29:01-05:00,13204,2PgwDVQuZqeFJpi2hKDxKGjxPXWm7u3wxqUcphJLj8Hd,Vv77YqR1XigUZWEtGChWYVpJCEE9VN8BuFLzygaPyqW,True,12882747,3220686,20118,10059,10059,3zqXX6kzhkbW3d4TwD2CNjMRwxTbREXySekvq37kfCNk,804740,5206993,-4402253,624
2022-02-24 00:29:45-05:00,13205,HmspGdpobjC5Vbmo3FcKdw4RLPN7wJKxv3uKqDjVhLee,3YEX8TzdyJyuHo76Kw76imVCJjzrC9m188YuRKvwwSwD,True,9704689,2426172,14809,7404,7405,2BPYaeCXY4BCFSGFSfiGtqmhzJ4fkhYLxGjqFvLCB6hG,592394,5246519,-4654125,610
2022-02-24 00:29:48-05:00,13206,243SAnGxchCVB1LQAUF4SsozR86yDwEdg2QQpbWGsMYe,5u8sNkb2oEQjUXJAB3yGStmv3Uwz16gBgExBo5myVK4b,True,147546,36886,230,115,115,2BPYaeCXY4BCFSGFSfiGtqmhzJ4fkhYLxGjqFvLCB6hG,9233,99601,-90368,625
2022-02-24 00:30:02-05:00,13207,25NUDrsdLhS3fcARLiTMbbmZHvvzvzPj9xAdoN8sJBN3,8baNRGHfYRcLdhbHNuH72ofAWM9UojqhTMLnbBayzGnW,True,442533,110633,691,345,346,HfEnetJ7uBSmZWCjBNxdvv9HEC5nsW4wDV7wu6WnhWan,27675,303825,-276150,625
2022-02-24 00:30:03-05:00,13208,CXPwt2ExsLAkjUWVsgUmvcMwji5CVY5vbMvomdg54CnQ,5LeDHg3VwCE8V1J6pMf8wvEVuNUyjQdz3cppSi9swaYP,True,49001840,12250460,76566,38283,38283,3zqXX6kzhkbW3d4TwD2CNjMRwxTbREXySekvq37kfCNk,3062668,11200828,-8138160,625
2022-02-24 00:30:05-05:00,13209,72F3iHXabQD5CDurG76r2riHaH8xGcKRqgBkDpmUnNMn,6Wue3rtmyr1RrEgDoK23ehAjymtLE8AYT2niknNe8Z7M,True,12469125,3117281,19507,9753,9754,2BPYaeCXY4BCFSGFSfiGtqmhzJ4fkhYLxGjqFvLCB6hG,780300,3815168,-3034868,625
2022-02-24 00:30:09-05:00,13210,4ne6vC7qdxQYHJCsaeFAKZrKdFt2SwXGHQ3jrMHqt4DL,Cf1dLHY2WXH9rXbRKq5TT8THbdo9SdNUZq4rYhRCF9z,True,34193,8548,53,26,27,2BPYaeCXY4BCFSGFSfiGtqmhzJ4fkhYLxGjqFvLCB6hG,2136,30022,-27886,624
2022-02-24 00:30:22-05:00,13211,Ai6G7vosJfmkRqtDAkqxRtbzELp6P5xe9r2RH3LYcLZt,8SUpKXakmhi4rYiFKnHYpgaAopomfDqEX6Efew9iM6nk,True,636659944,159164986,995327,497663,497664,3zqXX6kzhkbW3d4TwD2CNjMRwxTbREXySekvq37kfCNk,39813098,297841952,-258028854,625
2022-02-24 00:31:45-05:00,13212,A7bxZn4tYkEvYHu2SEqUbouNoSBSGMeqK4Kx4qySkNEZ,DNajWLThK1wtHsiGVcd9hNPyAch6BsX5Np1jxy9kHSJ8,True,38130919,9532729,59664,29832,29832,3zqXX6kzhkbW3d4TwD2CNjMRwxTbREXySekvq37kfCNk,2386585,18500666,-16114081,625
2022-02-24 00:31:51-05:00,13213,EAtQUZAkQxwJF779DwPcWHZ455FzYX8mzm1uV5LBnhPB,8h8t6GW1Y7xMBfWpfyFfUVBP4apMbJVNg7igZUYZLsyr,True,208476,52119,325,162,163,2BPYaeCXY4BCFSGFSfiGtqmhzJ4fkhYLxGjqFvLCB6hG,13005,142721,-129716,623
2022-02-24 00:31:52-05:00,13214,4Enpw9W2mWGnNYagYQ8WW29RLSs4R5YX4qXCsVqMFeHn,9QwbJmm9QDKXyc4ZViq74BfS35zzewEceXQNnFCgczXu,True,42809193,10702298,66545,33272,33273,3zqXX6kzhkbW3d4TwD2CNjMRwxTbREXySekvq37kfCNk,2661829,19249357,-16587528,621
2022-02-24 00:31:53-05:00,13215,EXP61AETWHw3kHSjrJH1jQBt6cXR9Zebz34Cueb3KAzg,2JT9GrgdUKjuQQtXvZqevbjFquUQBMYDoADmBjDKWXj3,True,846379,211594,1324,662,662,HfEnetJ7uBSmZWCjBNxdvv9HEC5nsW4wDV7wu6WnhWan,52983,728361,-675378,625
2022-02-24 00:32:01-05:00,13216,B5CTBTggmGFvGFSunjbB4C9tLKcYcULehmEiEXRihY2J,FX3ebF8P89rZBWfR74PDWUzxnLuDkUDgGcPYCBD5sMUG,True,3621913,905478,5635,2817,2818,HfEnetJ7uBSmZWCjBNxdvv9HEC5nsW4wDV7wu6WnhWan,225400,2305294,-2079894,622
2022-02-24 00:32:04-05:00,13217,4WSiQCTqMvpSYvrbenQGFoV6fuDALSWMwZZ9MgP82fwb,6Y5GdgKErVfXrabSTi89X7xCEsZnoqDqwFD4hZ3FVtfN,True,2325495,581373,3638,1819,1819,3zqXX6kzhkbW3d4TwD2CNjMRwxTbREXySekvq37kfCNk,145529,1614199,-1468670,625
2022-02-24 00:32:08-05:00,13218,DXEJNyHSCbGZezXHy2xQaSzd37dwJs4dMTgt5VF5UZAG,7fCYM9DWrAX7vgZ11CwQMNd5NU8FB1yrbctxHaPYshpB,True,911025,227756,1421,710,711,2BPYaeCXY4BCFSGFSfiGtqmhzJ4fkhYLxGjqFvLCB6hG,56853,412761,-355908,624
2022-02-24 00:32:14-05:00,13219,Bu65ba81oA2rZqxGAsctgz39NPPJqbXR3SvdMX5KQfTK,DcxNLDe2GwGiQPtQhzMiUjrMaqXjuyx1EGgX3xPtE98T,True,237247768,59311942,371129,185564,185565,3zqXX6kzhkbW3d4TwD2CNjMRwxTbREXySekvq37kfCNk,14845162,58817220,-43972058,625
2022-02-24 00:32:18-05:00,13220,Cgga7cjzsiecXRFLLf4jnEaGGwzr6qroh36G7kz3tV2t,AhUKdVt6jf8L2p5DbxkYPMAZUFqpz1uKBgPMUBJqEcnz,True,4763729,1190932,7374,3687,3687,HfEnetJ7uBSmZWCjBNxdvv9HEC5nsW4wDV7wu6WnhWan,294990,1758751,-1463761,619
2022-02-24 00:34:51-05:00,13221,4Mh9nzgwwnxWJLCNBC9Ntep2Lww6nUoALg6jmC6WoeSz,2sPBsXbpKB9QNQzAMipDMkvAVRE8hQk7vq1oc57kFBkn,True,5695999,1423998,8889,4444,4445,HfEnetJ7uBSmZWCjBNxdvv9HEC5nsW4wDV7wu6WnhWan,355592,2640782,-2285190,624
2022-02-24 00:34:51-05:00,13222,HXMjB1tdGJUtjXi5sQon6m4XJjfC6X7pdc6jTXApyjsH,CFcAoXdBVcPW7YYqP5ujq7q94DCsP4dLK2XDSwxQutKy,True,613706,153426,960,480,480,HfEnetJ7uBSmZWCjBNxdvv9HEC5nsW4wDV7wu6WnhWan,38415,290615,-252200,625
2022-02-24 00:34:52-05:00,13223,GQviUdocJ1s4FsVDDexanvo5yQWRZgwwkGJBCg7TMtJC,HAX4VAKgQpKtm1149iRgtzvUaUkiXWcA1bJ9ERu6tXkd,True,182854,45713,285,142,143,HfEnetJ7uBSmZWCjBNxdvv9HEC5nsW4wDV7wu6WnhWan,11426,125421,-113995,624
2022-02-24 00:34:54-05:00,13224,2niazdR63iWLyZ3ABWZVAnJiEjVyDyLGo4jZ6wh3j2Zz,4RvU5UtyE5CqMStPciiCTdhYCdaUUfdKSYS5nkATs1qn,True,185116,46279,289,144,145,HfEnetJ7uBSmZWCjBNxdvv9HEC5nsW4wDV7wu6WnhWan,11588,127080,-115492,625
2022-02-24 00:34:56-05:00,13225,GgAdS7cJ2KDgGE3xDrYAwqEEKqSsmfpEyBxtN4CMsjid,BidFJqkCxq71QWE7k8o4BnQjWQ61p4BT29jHgw4cC7b3,True,6921127,1730281,10791,5395,5396,HfEnetJ7uBSmZWCjBNxdvv9HEC5nsW4wDV7wu6WnhWan,431674,2407754,-1976080,623
2022-02-24 00:34:56-05:00,13226,6k9unyyhVTrGhAhBrFjgumRfBtKFRBrVaeWtYB56LgEg,3n9VYUH53fxmwFwdYKT9xAZYDzjodhMsJ5iGAoJTqCt4,True,185095,46273,289,144,145,HfEnetJ7uBSmZWCjBNxdvv9HEC5nsW4wDV7wu6WnhWan,11575,127090,-115515,625
2022-02-24 00:34:56-05:00,13227,GHn96Ev7UmKJWqch3H3wzXpRT7qLg5FBuSBJAATVED1f,BXBSUddfz9MThXqk4517M7YVRDGdTm4pC6G4ipT69TMV,True,147528,36882,230,115,115,HfEnetJ7uBSmZWCjBNxdvv9HEC5nsW4wDV7wu6WnhWan,9228,100985,-91757,625
2022-02-24 00:35:06-05:00,13228,2aK454FrEuA6JQZo2hLUabd4E6wyQtVuJWw2rWz2pGVy,3dJvhEh7kykf8hCCWQRarh2s5ybJUAzbaPdDUmX4XokW,True,11600645,2900161,18132,9066,9066,HfEnetJ7uBSmZWCjBNxdvv9HEC5nsW4wDV7wu6WnhWan,725286,3485283,-2759997,625
2022-02-24 00:35:07-05:00,13229,5eMLdQ4gYA5iqvTXSNdGvctHp7s5VpyFuwtJKqx6chBc,Ckxc5K39nkBNXBTmFTM8J48R7wGqNm3vHKZu4G5baumZ,True,1875987,468996,2924,1462,1462,HfEnetJ7uBSmZWCjBNxdvv9HEC5nsW4wDV7wu6WnhWan,116994,1303572,-1186578,623
2022-02-24 00:35:08-05:00,13230,agiVhhsNiMPzMaNWTHKRZ435HtBjqQvRuReKkpG32pn,HgcU2oCotYPxvGY6M21SbdqhzXJmNPDWEiTCDu4rA5dB,True,187320647,46830161,292063,146031,146032,3zqXX6kzhkbW3d4TwD2CNjMRwxTbREXySekvq37kfCNk,11682549,61650509,-49967960,623
2022-02-24 00:35:08-05:00,13231,CYkojG4q1SnizNs59qsYTEBU1c11XC8nteMhxRbwhCBq,A9MsPy3aeMzdQUWXK6qmWLiZfKREiBrSVaJAKp2nEcSt,True,128684,32171,201,100,101,3zqXX6kzhkbW3d4TwD2CNjMRwxTbREXySekvq37kfCNk,8050,95232,-87182,625
2022-02-24 00:35:09-05:00,13232,Dy91szocbSZmPUqtADCcX8Vu7zJpZycXcKJ74ByPeUzS,J9eWx2cfm6ksnZf3XC5MchLD4wuQN5zJgZpcJK97uFBL,True,79464029,19866007,123862,61931,61931,3zqXX6kzhkbW3d4TwD2CNjMRwxTbREXySekvq37kfCNk,4954500,19240642,-14286142,623
2022-02-24 00:35:11-05:00,13233,CmXqgTadXEDp7wu6sWVREPBghDer1vcbk6yS1BH1P79q,HqpjdYnv8bKEuLwKCLwF32auTDy74p7wCdc4PRCvv1AV,True,10636870,2659217,16412,8206,8206,HfEnetJ7uBSmZWCjBNxdvv9HEC5nsW4wDV7wu6WnhWan,656518,4534748,-3878230,617
2022-02-24 00:35:12-05:00,13234,DDsY5V3F9wnEGBoQFCEf1hvEYuKUaJdysbc7TxhNqe9G,5oBCGzvy8odB8MCxCUvPDqYCnTyteZ4Yy1JDroroygbi,True,1453207,363301,2258,1129,1129,2BPYaeCXY4BCFSGFSfiGtqmhzJ4fkhYLxGjqFvLCB6hG,90322,640156,-549834,621
2022-02-24 00:35:12-05:00,13235,pFCQLWBcx4YmtALBatWXwLR3MErHAxAyq1LVjgZJWbo,Hc3WoJQAV3Ue2yzxFxBdsx47ZsH6Hart62y89WRWCtqT,True,9670578,2417644,15102,7551,7551,2BPYaeCXY4BCFSGFSfiGtqmhzJ4fkhYLxGjqFvLCB6hG,604084,4093090,-3489006,624
2022-02-24 00:35:12-05:00,13236,5kkF52hfxQLFF2rzZfwxAAHRqeWigsbRxJBRW57aKsWF,9MjKo4KgnbZ1TYESfLeqH38HNvXPRc5dnvv3bpyBKiCX,True,10984939,2746234,17127,8563,8564,3zqXX6kzhkbW3d4TwD2CNjMRwxTbREXySekvq37kfCNk,685090,4696406,-4011316,623
2022-02-24 00:35:12-05:00,13237,4vW2Q76fdGmfhU2Tx3R2XQkGcQUi6hSM9ixvK5RWvurJ,w8cGbqVpVr6WHSRJFXv469RMgRB3ty3TGpkVXRs7K7H,True,1922131,480532,2990,1495,1495,3zqXX6kzhkbW3d4TwD2CNjMRwxTbREXySekvq37kfCNk,119611,783536,-663925,622
2022-02-24 00:37:01-05:00,13238,JDeYjCLpfnzcfxDFgHf4aBcHsajwdR14GUaKAA9euzVf,EJbvKoyMZcoCx4vWa61uMbW2vr6mUhrgEuECdteVBuZZ,True,44539,11134,69,34,35,HfEnetJ7uBSmZWCjBNxdvv9HEC5nsW4wDV7wu6WnhWan,2782,44855,-42073,624
2022-02-24 00:37:01-05:00,13239,9UKMqQgFYdJb5vXVqPhA8CAMRY1eifgWivANiKQqj3yb,DpE3uNQUZbyYnqjpfHWqp9CHqPBs2uTQLRM6AtzF6Por,True,1898894,474723,2969,1484,1485,HfEnetJ7uBSmZWCjBNxdvv9HEC5nsW4wDV7wu6WnhWan,118784,819525,-700741,625
2022-02-24 00:37:03-05:00,13240,7hTjPRQSYAoWHhtpsVz2oKK5SAuFJd8dPHShKgKJq8dy,6DcHcrtcXR88d8e2KahhAiWTeRznNfF8oXLHmh5wE7wz,True,5466477,1366619,8540,4270,4270,HfEnetJ7uBSmZWCjBNxdvv9HEC5nsW4wDV7wu6WnhWan,341622,4066437,-3724815,624
2022-02-24 00:37:04-05:00,13241,78EeyPYzQjrmW6z9VGhRci6ihMUZb5rtpXo3GAxugf55,9AgZ45TMxaqwWGVWSgnEkvio3s6fXtHjAVRVCA7Zgsd2,True,317711,79427,497,248,249,HfEnetJ7uBSmZWCjBNxdvv9HEC5nsW4wDV7wu6WnhWan,19883,210410,-190527,625
2022-02-24 00:37:06-05:00,13242,Bsr6kx1B6BSEd5UnJ7Z61M49iUb3bFrDVhiEtMVtPDF2,3CFd1pUJAJPA9fobwn4Jj2mRju1CWmoop4Mh4znypNWT,True,167429,41857,261,130,131,HfEnetJ7uBSmZWCjBNxdvv9HEC5nsW4wDV7wu6WnhWan,10479,122838,-112359,625
2022-02-24 00:37:11-05:00,13243,G5NLYTLxDZfJFKsJdMeWS8Ez95ZFwR5AX4hKhnfVJvoE,AwrC3pKhTeEDr1HCTWoKWjadteZccvqcisbC7vxTjn7w,True,3057753,764438,4691,2345,2346,HfEnetJ7uBSmZWCjBNxdvv9HEC5nsW4wDV7wu6WnhWan,187646,2988103,-2800457,613
2022-02-24 00:37:11-05:00,13244,95yx3SCWcW9Cp8oSEDV68kGXRKWGyNdYUtNb5UnWMGBD,7PncaFWqW2iKR6EUKf78EW6LLZr7ZWU5b2d2rP22fsU3,True,1560378,390094,2393,1196,1197,HfEnetJ7uBSmZWCjBNxdvv9HEC5nsW4wDV7wu6WnhWan,95724,1205035,-1109311,613
2022-02-24 00:37:11-05:00,13245,CbhrZUdan1axNDFUrX1ZuEohfNMEGrszKSkk6pppVQuw,DHEAjJNtuEePezYAv77thWabbVxxqQpfuiC6moRSrpG1,True,528490,132122,810,405,405,2BPYaeCXY4BCFSGFSfiGtqmhzJ4fkhYLxGjqFvLCB6hG,32434,518664,-486230,613
2022-02-24 00:37:11-05:00,13246,3ogBPSRcKfmwzgumVDHBkXLi1eCsEFG2xzSJgD4LQDNy,7TXyqWgJqfe71MSWFA2n7ufZbUdzf7JJoWej8FNNtMXo,True,120308,30077,187,93,94,2BPYaeCXY4BCFSGFSfiGtqmhzJ4fkhYLxGjqFvLCB6hG,7487,90066,-82579,622
2022-02-24 00:37:13-05:00,13247,442usWu6XpJZvU25bqXeynRrQ15jAzWwU9DWMgHpTn3Q,CtvADKp39bjJf3cPKWNL3wxnhq273fVM4fC5DmEcg5cC,True,6668502295,1667125573,10431369,5215684,5215685,HfEnetJ7uBSmZWCjBNxdvv9HEC5nsW4wDV7wu6WnhWan,417254762,2268448826,-1851194064,625
2022-02-24 00:37:14-05:00,13248,9Wzu7BWPgx9JRwuituo7vxNXVkpRA7C5W62CATnPpy6Q,GYPiAfGtfkMjDKdi6MrM7VXzpSwPnp2qWwwCX4iFGVtq,True,35068480,8767120,54199,27099,27100,3zqXX6kzhkbW3d4TwD2CNjMRwxTbREXySekvq37kfCNk,2167976,29521314,-27353338,618
2022-02-24 00:37:15-05:00,13249,7ayTm4uC5VbtMt9w6g9tFban4fYVwbqCzJZpiFMjmBiB,BvidnEZHHtXVhtgv4qFKThEaFZsFmyAuDVqZQwMppjSg,True,79621590,19905397,124529,62264,62265,HfEnetJ7uBSmZWCjBNxdvv9HEC5nsW4wDV7wu6WnhWan,4981162,70933269,-65952107,625
2022-02-24 00:37:15-05:00,13250,98pwBGgiSDuwuas6WYW2hc9qUxfULwvNE34aixaxbxXY,BLrjKxekjThtJ9rKtQxs1Y4rZ225EE2Q16VkP9TkThyV,True,144133,36033,225,112,113,HfEnetJ7uBSmZWCjBNxdvv9HEC5nsW4wDV7wu6WnhWan,9006,99949,-90943,624
2022-02-24 00:37:15-05:00,13251,EDSf2w1UyGvbgMuxyoXL58ifR1dviZinnLBYnFmgjcNG,DFenkzbL9SUjs9cSCaHJ1eXK75mHfk3GSPRFs8TSzrFV,True,887122,221780,1388,694,694,HfEnetJ7uBSmZWCjBNxdvv9HEC5nsW4wDV7wu6WnhWan,55525,670769,-615244,625
2022-02-24 00:37:22-05:00,13252,BCGTaPQxGEMjD7xUxwfwmVVYJ9CEGH33yJRi3QjwyiLE,JBct1cZ9a959UKwABBEefwxZnGTAAGLzyUdXrXqGGCZd,True,212662,53165,327,163,164,3zqXX6kzhkbW3d4TwD2CNjMRwxTbREXySekvq37kfCNk,13081,134554,-121473,615
2022-02-24 00:37:25-05:00,13253,Fani89KviVFZek4si6YZ3apVuM2kSqVUijDnLBqtvJEH,EpC29dECx1cLC69bj2ncG3jFp7obPaxbH7F6mju27cwL,True,125310,31327,196,98,98,HfEnetJ7uBSmZWCjBNxdvv9HEC5nsW4wDV7wu6WnhWan,7843,57689,-49846,625
2022-02-24 00:37:27-05:00,13254,2utXC9PmMHh7D9x9wRdyibUHvSUquo96HHKy8F5cBeKY,GabBfvJyVgAUVuCe5sk4UHyC95AWaB4CSJiwWZUKerTd,True,4744560,1186140,7424,3712,3712,HfEnetJ7uBSmZWCjBNxdvv9HEC5nsW4wDV7wu6WnhWan,296987,1878001,-1581014,625
2022-02-24 00:37:27-05:00,13255,28JujYG1mbpYSjF7LNqXpup17TXb45VJHhhnFMVXtft2,DAqyVExAtmsovPGrkpkFDxm6T7pKWLztfh9iPjTNDqrd,True,227839,56959,355,177,178,HfEnetJ7uBSmZWCjBNxdvv9HEC5nsW4wDV7wu6WnhWan,14229,158341,-144112,624
2022-02-24 00:37:30-05:00,13256,ATS5VRAN1aPKBiATDcUs5yd6yVuTmWqrqqRFNdfz6DZT,7VKq4rZLEtY2dhDFZMTQMvCYyJa1ASM9RHobUaYhHWAe,True,1888028,472007,2951,1475,1476,3zqXX6kzhkbW3d4TwD2CNjMRwxTbREXySekvq37kfCNk,118059,1248653,-1130594,625
2022-02-24 00:37:31-05:00,13257,G3vArDs7nb18se4xMZ68oMHmTAsYP63x8dfY57jAogwp,EY7J8Hw8jWbryw11CYdPVUSdAoDGGNEfacqghVnJn3JK,True,532538,133134,830,415,415,2BPYaeCXY4BCFSGFSfiGtqmhzJ4fkhYLxGjqFvLCB6hG,33209,369999,-336790,623
2022-02-24 00:37:32-05:00,13258,6mCEvqP1YwHZNUT9orECs4tE3YzfD2Hfa5FTt9TLo8DH,ApWyeUDzPp6TBczuStvXxEAivhVVJrqC1rodNTNKNFR3,True,1838020,459505,2861,1430,1431,HfEnetJ7uBSmZWCjBNxdvv9HEC5nsW4wDV7wu6WnhWan,114464,1062654,-948190,622
2022-02-24 00:37:34-05:00,13259,D64rDiWT3YG28fCgXCmbNjYa2JakZbpKQ1D2XuLChUfV,8WmMWq8cTsGQym5pUbHm9dPCpJugBeWUMVERYFGLxWHj,True,203633,50908,317,158,159,HfEnetJ7uBSmZWCjBNxdvv9HEC5nsW4wDV7wu6WnhWan,12707,143514,-130807,624
2022-02-24 00:37:35-05:00,13260,2rLWe1XADCU93guPU6WgSW6x56gYNfif9bm11V93mJnv,BEGhQRm3fgSHeBtk2DYrXEBPKPRvS3sHyTNopmoBJxMs,True,57346079,14336519,89289,44644,44645,3zqXX6kzhkbW3d4TwD2CNjMRwxTbREXySekvq37kfCNk,3571586,52467050,-48895464,622
2022-02-24 00:37:40-05:00,13261,9d7ixk9XCdumGXVP5fEQKJPDx15SS2uz5gvJA7HxaQsx,12pcw5FXob2x6LG3UmXZ2HE8zrVre91YZWfRqwm6XA5Q,True,3441,860,5,2,3,2BPYaeCXY4BCFSGFSfiGtqmhzJ4fkhYLxGjqFvLCB6hG,207,1594,-1387,601
2022-02-24 00:37:41-05:00,13262,7FB6X8YgiDn7YK9bZZmcFyzhuvVLVWPCfBbenwMXhx5,2EaDCpL9MpAKuiC2bvUCGRfvqYvgVXGFHXt35QdNakfG,True,130181,32545,197,98,99,HfEnetJ7uBSmZWCjBNxdvv9HEC5nsW4wDV7wu6WnhWan,7908,65575,-57667,607
2022-02-24 00:37:42-05:00,13263,33CE2t84MhG7SMsphhZaxvwFVRbK5wcUMUdEw8UBhoq8,DjNko7SbbK9nQT4K5oBWKiSiXiYS9Rv1k5vT3PNiMyaf,True,129800,32450,198,99,99,2BPYaeCXY4BCFSGFSfiGtqmhzJ4fkhYLxGjqFvLCB6hG,7948,115566,-107618,612
2022-02-24 00:37:43-05:00,13264,BZxJ6CtrVoiU86DMMieMeDFLNWtMpHGTvZfM7nyay6o4,6CRxRR8bisRLHFJBFWjyumYuy7j4C4PkjYH1K8gXhdWD,True,19391872,4847968,30137,15068,15069,HfEnetJ7uBSmZWCjBNxdvv9HEC5nsW4wDV7wu6WnhWan,1205502,5662285,-4456783,621
2022-02-24 00:37:43-05:00,13265,4frcw72EwhHoErBpaUopvk1TG76ScAEAdCa1YYpuXNBH,CrGAbKa9vZKUmr9sALaHgWMcczDGmUq5kFP7w1fbXmKY,True,568140285,142035071,888408,444204,444204,HfEnetJ7uBSmZWCjBNxdvv9HEC5nsW4wDV7wu6WnhWan,35536321,204228850,-168692529,625
2022-02-24 00:37:43-05:00,13266,DENsFT6ZdpY49u447xVXjwxo2Cn3vJXjyvUjoyB8Spoc,C2RSabtDfqwrJEezhPZTzy13bubSuXzaJZmXRJfDmAu3,True,20026111,5006527,31133,15566,15567,HfEnetJ7uBSmZWCjBNxdvv9HEC5nsW4wDV7wu6WnhWan,1245324,6921735,-5676411,621
2022-02-24 00:37:47-05:00,13267,AoPQqPjLPi8fZiLkhMGLRj6oD5k2asrvJtCkpW19DvGr,H5Sgmf1VuY13iHjPuLJ2q9wtSdkXG1AQsEv2eq6zzm8Y,True,10635454,2658863,16604,8302,8302,HfEnetJ7uBSmZWCjBNxdvv9HEC5nsW4wDV7wu6WnhWan,664175,3375341,-2711166,624
2022-02-24 00:37:48-05:00,13268,FtF3PVw8YNJseWPMcA2GEuQZ6nni1mq5kYPa2LrSzfkW,4yr1TM2dXrBvLNMpSaoryuGU2P8D3WG1ZCkvVzWFiQRH,True,1430109750,357527437,2222819,1111409,1111410,3zqXX6kzhkbW3d4TwD2CNjMRwxTbREXySekvq37kfCNk,88912764,645849785,-556937021,621
2022-02-24 00:37:52-05:00,13269,BgNgALwBEuiumVgiXRmBZRnyFrr9QTDy2maHzsNwNHGf,ag35Ec2uFtqkarizCxFyhM2SPBuUwfmLRhAdFEWFCNa,True,288722,72180,450,225,225,3zqXX6kzhkbW3d4TwD2CNjMRwxTbREXySekvq37kfCNk,18037,180130,-162093,624
2022-02-24 00:38:00-05:00,13270,aTkGURJptmKNNP6RSXSWsmVbfcriSAJaMuUiT2eZEfb,5qoGxL83PLhrguyk27X8xE6jGitRg5BaQpXzrcfEvCfJ,True,28992981,7248245,45215,22607,22608,HfEnetJ7uBSmZWCjBNxdvv9HEC5nsW4wDV7wu6WnhWan,1808631,10049489,-8240858,623
2022-02-24 00:38:03-05:00,13271,4PZZxNrWLhNCuT5VJ1DQe3XxQVVwMPrjfUpdeAY8qS7U,A7CvKre7y5VbUN1HneNHmuBv7jWtayV78oozAqaVbQrv,True,36962598,9240649,57704,28852,28852,3zqXX6kzhkbW3d4TwD2CNjMRwxTbREXySekvq37kfCNk,2308196,36919163,-34610967,624
2022-02-24 00:38:03-05:00,13272,9ancY5Fso8pUktKpRj3qc1YPQA6thy5n4f7uvNnsqMWR,CLUi9rvU9NTi7h4sNwqfr8aqChyGDbVJA1aKvKMWQv2r,True,1189021174,297255293,1856226,928113,928113,HfEnetJ7uBSmZWCjBNxdvv9HEC5nsW4wDV7wu6WnhWan,74249063,365039364,-290790301,624
2022-02-24 00:38:05-05:00,13273,Bzp3ZUxzRWqW4QoLq9PtKN1HQeSaKXFQrX1G3a4ocrre,H12B3p4v1ZtZ9gaSgpxCJsKXmmEjiqaRZQzexjzAhevo,True,3049238467,762309616,4763902,2381951,2381951,3zqXX6kzhkbW3d4TwD2CNjMRwxTbREXySekvq37kfCNk,190556112,1362845863,-1172289751,624
2022-02-24 00:38:05-05:00,13274,CxLFMBDFkoMvpK9YUf7WtCq6hn7k3QACAuetAnGjU6KA,2gE52a1GWQnS6ifV6eVtKQyr13LXP5Jdt3yG9SjGPJPF,True,6937081,1734270,10840,5420,5420,HfEnetJ7uBSmZWCjBNxdvv9HEC5nsW4wDV7wu6WnhWan,433622,3519557,-3085935,625
2022-02-24 00:38:05-05:00,13275,HwosLQgDY1xtHQRQ4hzroPQHFWssPzTj5vRkP37FcviB,HKTNEYNXrephNkH7apbobK4mcQXcNayQA4W1NgM6sLr8,True,258676,64668,404,202,202,HfEnetJ7uBSmZWCjBNxdvv9HEC5nsW4wDV7wu6WnhWan,16188,173145,-156957,625
2022-02-24 00:38:10-05:00,13276,FgQrRo4eGQAonSsFfQgnp8trGGqGZCLeGX6yvJnMnTjd,8KhemHLBY6nGmo3xMDedW2wnCSxQq6LwbTExif4sUSxx,True,7841269,1960317,12244,6122,6122,3zqXX6kzhkbW3d4TwD2CNjMRwxTbREXySekvq37kfCNk,489771,3291374,-2801603,624
2022-02-24 00:38:13-05:00,13277,GKKRAsYGdcf47eFThG4KwhNv7egeHRuc2wmTh4kqpego,4ippJxgnqCtdtGzCkdZoYwv68fiXNSqQcgrnaHdXZDUa,True,11080613,2770152,17291,8645,8646,HfEnetJ7uBSmZWCjBNxdvv9HEC5nsW4wDV7wu6WnhWan,691669,7519613,-6827944,624
2022-02-24 00:38:17-05:00,13278,2fCreQCCB6cWjyE1eddSBY89YniYavEfEo2QWKS9MWMT,HkpLJPjXUUbWmJ4pJDFHkGfU6NqEow1iRKiJeD428WWp,True,11492790,2873197,17922,8961,8961,HfEnetJ7uBSmZWCjBNxdvv9HEC5nsW4wDV7wu6WnhWan,716907,4521034,-3804127,623
2022-02-24 00:38:20-05:00,13279,5BJnMHFSiQjHRGFJDW1jnqCfkHHYWnQzmmccy9eA4jNj,9517JGYsPmvgPUM9pFRD2vipHmdgE578F7jA7Qq6jorm,True,499986,124996,772,386,386,HfEnetJ7uBSmZWCjBNxdvv9HEC5nsW4wDV7wu6WnhWan,30895,383215,-352320,617
2022-02-24 00:38:25-05:00,13280,A1VornXbzK5rFgsy9D4qThcPnYVP8AB9RRzWsV1h6L17,9M4dQgz1zWrtKHqZMt9w7PbM9CvmyjhY5ZZ6jjajMzqm,True,965974,241493,1511,755,756,HfEnetJ7uBSmZWCjBNxdvv9HEC5nsW4wDV7wu6WnhWan,60454,425966,-365512,625
2022-02-24 00:38:33-05:00,13281,2JXP6KUwPSmCrXT2uQRqSoCwH8RLYWwmqYsj3zXtv9xF,4qcFVgugXsHVQzFRP2he9CVzvv47xqgokJjigee8oPpP,True,48932379,12233094,75726,37863,37863,3zqXX6kzhkbW3d4TwD2CNjMRwxTbREXySekvq37kfCNk,3029079,19312838,-16283759,619
2022-02-24 00:38:35-05:00,13282,Dng7By2saPu5TVxcvXidBe71ggBo8tiHkAXPi4kKL1tk,75ufEJmHbLHffphL7tvAXhGyftKLr1z2PXXoB2GGY5fG,True,861793,215448,1345,672,673,HfEnetJ7uBSmZWCjBNxdvv9HEC5nsW4wDV7wu6WnhWan,53800,495232,-441432,624
2022-02-24 00:38:36-05:00,13283,9WuBRozWpN4yDacdweLCTNZrsK8LbpfVEbTLrN8QgyZG,9rMFXUMpZwwTnyUejEqS78Ny1yTvAWfhV4QtJwcX5Fo7,True,14514230,3628557,22503,11251,11252,HfEnetJ7uBSmZWCjBNxdvv9HEC5nsW4wDV7wu6WnhWan,900147,5070194,-4170047,620
2022-02-24 00:39:23-05:00,13284,CiomzdJ9g2bCskudk28cEU4aTgF6jYaerkiazbB7E3DA,9rxtTBmKoxPzhR4xoRH65Kmi7f3pEp1RanoeQq9V9RU5,True,21938495,5484623,33933,16966,16967,HfEnetJ7uBSmZWCjBNxdvv9HEC5nsW4wDV7wu6WnhWan,1357336,10831106,-9473770,618
2022-02-24 00:39:42-05:00,13285,BMn3FQ6axnUt5K3esCEgoVi8GZAcPCg3YrjcwAFVvTah,HEvRK6CPti7aoTaYExEQAyr9ZyTQ6u4jg5Y2btc7ovdd,True,245201,61300,383,191,192,HfEnetJ7uBSmZWCjBNxdvv9HEC5nsW4wDV7wu6WnhWan,15349,92718,-77369,625
2022-02-24 00:40:33-05:00,13286,82x7nfr1Hq3uG5VN5srbtuhELRyDgTZqC25WngRAPtH1,AsWpENCfnRHzSE19bzTcd2LrfDHog4N3szmV9MPhPmjq,True,669205901,167301475,1047217,523608,523609,3zqXX6kzhkbW3d4TwD2CNjMRwxTbREXySekvq37kfCNk,41888696,224139191,-182250495,625
2022-02-24 00:40:45-05:00,13287,AgokoeqypXXfMsjAyBXPRrJFGeP7B7D6SXvnGUTwMdap,53zBz3fTZisWQH1v6NHyhCdpLXx5NaPNp7uW9KPXLDan,True,1821243,455310,2845,1422,1423,3zqXX6kzhkbW3d4TwD2CNjMRwxTbREXySekvq37kfCNk,113816,1295301,-1181485,624
2022-02-24 00:41:22-05:00,13288,Cgga7cjzsiecXRFLLf4jnEaGGwzr6qroh36G7kz3tV2t,AhUKdVt6jf8L2p5DbxkYPMAZUFqpz1uKBgPMUBJqEcnz,True,3501825,875456,5416,2708,2708,HfEnetJ7uBSmZWCjBNxdvv9HEC5nsW4wDV7wu6WnhWan,216644,1385438,-1168794,618
2022-02-24 00:41:31-05:00,13289,CYcgATWjZUXrqxJyVTEMkDBv1eyUjb1TZi2raTd1ujvU,7jefj3noz9JDDnJ74YZL946EPJtywSnPsi7ZpgU4Wj1G,True,4550098,1137524,7106,3553,3553,HfEnetJ7uBSmZWCjBNxdvv9HEC5nsW4wDV7wu6WnhWan,284278,2741877,-2457599,624
2022-02-24 00:41:32-05:00,13290,BSDeCyJsPs6y1pbDVHNq5rs6tdxcrbY3NDjXPBxwRjHz,DjHD3jawBVikzjcQ5dXBRLdUmEeBHKt6JZLhvmjScDku,True,131848943,32962235,206078,103039,103039,3zqXX6kzhkbW3d4TwD2CNjMRwxTbREXySekvq37kfCNk,8243125,49294662,-41051537,625
2022-02-24 00:41:34-05:00,13291,HEFpdWLZaiQnjftmXgxs6RNzhH72YiMjortxPkKekkvb,5Q8mmxBgVTijNGrWsnoA3VMArLHZEX5MkaigYXHpgXHE,True,341223,85305,531,265,266,HfEnetJ7uBSmZWCjBNxdvv9HEC5nsW4wDV7wu6WnhWan,21254,230900,-209646,622
2022-02-24 00:44:09-05:00,13292,4Mh9nzgwwnxWJLCNBC9Ntep2Lww6nUoALg6jmC6WoeSz,2sPBsXbpKB9QNQzAMipDMkvAVRE8hQk7vq1oc57kFBkn,True,4185394,1046347,6503,3251,3252,HfEnetJ7uBSmZWCjBNxdvv9HEC5nsW4wDV7wu6WnhWan,260130,2060597,-1800467,621
2022-02-24 00:44:27-05:00,13293,9otCHuzKcxUCC4EgPJkio8Df5gXWB6DtZQnZvWtPfsh6,8cNPdP8rA9sBpcKpmCNcp4W2AYonYdFNoyVmboT6y1Bb,True,21065489,5266372,32750,16375,16375,3zqXX6kzhkbW3d4TwD2CNjMRwxTbREXySekvq37kfCNk,1310007,8778222,-7468215,621
2022-02-24 00:44:27-05:00,13294,5QxR9QPTADFys9VQNm473RgprTikCXC23vhsBc9ojyAQ,H9zdf8nJ4JCF7jrwGsxiuiFoa14gzDmYsZ5N5ig3UGna,True,69542439,17385609,108651,54325,54326,3zqXX6kzhkbW3d4TwD2CNjMRwxTbREXySekvq37kfCNk,4346040,21742890,-17396850,624
2022-02-24 00:44:27-05:00,13295,5acohGZShYQVNGZEfy7pTyX7E8MzqRDwByhFL1H53UNv,4Z454ZseKbWGEtdrE9eotbDZ7o9VHhooMYriTfSFHiGt,True,33187788,8296946,51857,25928,25929,3zqXX6kzhkbW3d4TwD2CNjMRwxTbREXySekvq37kfCNk,2074288,12744315,-10670027,625
2022-02-24 00:44:27-05:00,13296,BgN75npBkPws5uiFE9RAujmPuZyAv2MQUPmfmJ1YCCij,78UFLNDn782TY2P4F5kRkMRC2s3gw8ak7sRQZRWNq82D,True,1367044,341761,2132,1066,1066,HfEnetJ7uBSmZWCjBNxdvv9HEC5nsW4wDV7wu6WnhWan,85306,618434,-533128,624
2022-02-24 00:44:34-05:00,13297,F2AU2PjaSmHxWWhkz8XxMggkCMWbMVgawt89tSnYS6RL,ET9febRJiW197DYMaJbgk3kWsAeFv5f4peQ4vFCVppK6,True,1363389562,340847390,2123105,1061552,1061553,3zqXX6kzhkbW3d4TwD2CNjMRwxTbREXySekvq37kfCNk,84924218,300934656,-216010438,622
2022-02-24 00:44:57-05:00,13298,8eTH6eJyyVeMno3UQkffeBg32xofKsQfkhLhXdtaf87s,BCFC7CPXrQPsUfJb2eYSht8GhaApWHpc49AeCXqaYq13,True,1273578,318394,1989,994,995,3zqXX6kzhkbW3d4TwD2CNjMRwxTbREXySekvq37kfCNk,79566,644574,-565008,624
2022-02-24 00:44:57-05:00,13299,8kJu5aqVSmW8FSZR9h6F75ftn9V2U9uMLBEKeqRaC855,FhVHByujkvwwtjTVpZ4mqSUqoMoBgeLUc5H7rbz3FgAt,True,503030,125757,786,393,393,3zqXX6kzhkbW3d4TwD2CNjMRwxTbREXySekvq37kfCNk,31441,506887,-475446,625
2022-02-24 00:45:08-05:00,13300,CXPwt2ExsLAkjUWVsgUmvcMwji5CVY5vbMvomdg54CnQ,5LeDHg3VwCE8V1J6pMf8wvEVuNUyjQdz3cppSi9swaYP,True,35998469,8999617,55829,27914,27915,HfEnetJ7uBSmZWCjBNxdvv9HEC5nsW4wDV7wu6WnhWan,2233191,9089772,-6856581,620
2022-02-24 00:45:14-05:00,13301,4ne6vC7qdxQYHJCsaeFAKZrKdFt2SwXGHQ3jrMHqt4DL,Cf1dLHY2WXH9rXbRKq5TT8THbdo9SdNUZq4rYhRCF9z,True,25133,6283,39,19,20,HfEnetJ7uBSmZWCjBNxdvv9HEC5nsW4wDV7wu6WnhWan,1571,22998,-21427,625
2022-02-24 00:45:15-05:00,13302,4uygLJDk9DFCifJ56YwMrEsvd3oQNq8tYSLnMCyWorS6,GimL4uKGvg3FFmFQSWzAcjstv3Vmk5NMgDGMKTuXYVpB,True,2951044,737761,4588,2294,2294,HfEnetJ7uBSmZWCjBNxdvv9HEC5nsW4wDV7wu6WnhWan,183545,2354581,-2171036,621
2022-02-24 00:45:15-05:00,13303,F1G1Yb2jhT1hULYuNM9QMuNNA6vHZ2Wg4LhFGWsJmr78,2oF52s77UVwjbZMLmxyNsGRZ36RHqSJiV5VL7FzoWgyB,True,14745574,3686393,23072,11536,11536,HfEnetJ7uBSmZWCjBNxdvv9HEC5nsW4wDV7wu6WnhWan,922919,7768497,-6845578,625
2022-02-24 00:45:23-05:00,13304,B2hN3Lt5pFbUyfEUc5s48hkxUJ5rr2SeFxgdGdQ8pDD2,7bZJCCud253j9g411HQUDXUAADcwd5yJWznoTChBdB2H,True,34573207,8643301,54102,27051,27051,3zqXX6kzhkbW3d4TwD2CNjMRwxTbREXySekvq37kfCNk,2164096,14712932,-12548836,625
2022-02-24 00:45:39-05:00,13305,EkKmfEnxTscSs2BDs1mg6SyHdStC8AYTy9zihw9VWP63,DW4ujEZj4H83B9CrSfbks2pkHEj3gh2d114eo1aDh4s9,True,155242195,38810548,240528,120264,120264,2BPYaeCXY4BCFSGFSfiGtqmhzJ4fkhYLxGjqFvLCB6hG,9621149,46112985,-36491836,619
2022-02-24 00:45:39-05:00,13306,C1CsbgQFvEvSXzuVHTr39tQHr3drDhjxeYiotd8eNocF,4rAaTCAMj5VpgNVKiYizabH7cMLhEA12seu2QXQNTyV3,True,362321,90579,561,280,281,2BPYaeCXY4BCFSGFSfiGtqmhzJ4fkhYLxGjqFvLCB6hG,22458,190599,-168141,619
2022-02-24 00:45:42-05:00,13307,CpxZ136k95cVjGqkJnNpDZKUgrJrfg8HrFDZPL6BgsK4,Fo7HtcrneUTsnGqygsxPQ63G5rayYodYT65xP6B6HusH,True,8852741,2213185,13851,6925,6926,HfEnetJ7uBSmZWCjBNxdvv9HEC5nsW4wDV7wu6WnhWan,554062,3642419,-3088357,625
2022-02-24 00:45:55-05:00,13308,4KMzwWHPeW51cxu4nMpbqCaqo96dMqaHWyRCGQktfQfd,F7q4GNYcbnZa8dJ4qovQwjmxpKpdEmdxQMXRPb9nQupa,True,5432767,1358191,8488,4244,4244,HfEnetJ7uBSmZWCjBNxdvv9HEC5nsW4wDV7wu6WnhWan,339541,2158199,-1818658,624
2022-02-24 00:46:29-05:00,13309,2aK454FrEuA6JQZo2hLUabd4E6wyQtVuJWw2rWz2pGVy,3dJvhEh7kykf8hCCWQRarh2s5ybJUAzbaPdDUmX4XokW,True,8525032,2131258,13292,6646,6646,HfEnetJ7uBSmZWCjBNxdvv9HEC5nsW4wDV7wu6WnhWan,531702,2777154,-2245452,623
2022-02-24 00:46:29-05:00,13310,EAtQUZAkQxwJF779DwPcWHZ455FzYX8mzm1uV5LBnhPB,8h8t6GW1Y7xMBfWpfyFfUVBP4apMbJVNg7igZUYZLsyr,True,153210,38302,238,119,119,HfEnetJ7uBSmZWCjBNxdvv9HEC5nsW4wDV7wu6WnhWan,9533,109968,-100435,622
2022-02-24 00:46:31-05:00,13311,EXP61AETWHw3kHSjrJH1jQBt6cXR9Zebz34Cueb3KAzg,2JT9GrgdUKjuQQtXvZqevbjFquUQBMYDoADmBjDKWXj3,True,621936,155484,970,485,485,HfEnetJ7uBSmZWCjBNxdvv9HEC5nsW4wDV7wu6WnhWan,38810,558194,-519384,624
2022-02-24 01:31:48-05:00,13312,52pCCDDTo6uQhENab7rCsqS5ZihDDBmMSTQdCj8QLoea,GZh4ev3p6RrDRo98WfQQ7ZzzMBbqWF9gj9WbicU7YWD4,True,12805464,3201366,20036,10018,10018,DddJ7EWCmYEEZETCBNgAUSg81Ls6fZtiAaY5ekJ5sXx1,801478,5793967,-4992489,625
