ts,record_id,user_authority,user,partial,base_asset_value,base_asset_value_closed,liquidation_fee,fee_to_liquidator,fee_to_insurance_fund,liquidator,total_collateral,collateral,unrealized_pnl,margin_ratio
2022-05-03 11:24:32-04:00,17409,F4hN7ecndZ8Gr5KQNSFaSrMGawMasz7jfWTLTMpk7gaB,AJ23FpXSGjipcqywk88WGsKfqfiiUjPzZLsvLtBAhB12,True,266629414,37488478,266955,133477,133478,2a35JJeTUW1pm6M3e8DHCjp8qr4vbc2cRPhuzZWyFzYd,18986712,63199582,-44212870,712
2022-05-03 12:08:36-04:00,17410,Cb6MEn1MN9XQcVVd3o9J8QdK3cFWxSNETsFzhVJ8jmdh,A6yTKbggUftjbjAVu5YR1M7rg7h78ghbfofmTSnmKNGz,True,2655416169,663854042,1978874,989437,989437,5HnvdJnCCcmRsm4GkXnYWd4q9RpwuvYDGEUMPkYR3Ts9,79154988,131818203,-52663215,298
2022-05-03 12:08:49-04:00,17411,F5vnN191nY9kUJBtFcm6fUhPDJvUSrSHLvfstesb68rH,9DtiZh3FsVmZA9MRqZhonAN2Pk4rQdcWw8As76DnQ6ee,True,3948082689,987020672,7024705,3512352,3512353,gjBMZYVujDjD1ECG4i97M8Q3gV9ESnwwTSUGropkusj,280988225,512692217,-231703992,711
2022-05-03 14:03:55-04:00,17412,9XmuJX8mFX29c5uh68kK7ff1mPdvs1orJAgEP6BsVKnq,HfPpizwUoK6uEmMb9LWi464BnvjHQY9cuPppFMp1DKDA,True,1580566364,395141591,1197068,598534,598534,AmTrMPzuTp2BjnjqGNKqz9FTTCdpoKcPAJLwFc8ozcbh,47882753,85662161,-37779408,302
2022-05-03 14:12:28-04:00,17413,kn4CMFEGiFu6Sw8v7GAZaBNHKe5Mst4Bj2kds1B6Daw,4FAjghUCswqbD6SKVr7Mu9aLcSLxDofiBvxgkZeiVz32,True,69719363,9556422,28922,14461,14461,2a35JJeTUW1pm6M3e8DHCjp8qr4vbc2cRPhuzZWyFzYd,2110058,10527230,-8417172,302
2022-05-03 14:14:11-04:00,17414,Cb6MEn1MN9XQcVVd3o9J8QdK3cFWxSNETsFzhVJ8jmdh,A6yTKbggUftjbjAVu5YR1M7rg7h78ghbfofmTSnmKNGz,True,1974385170,493596292,1493905,746952,746953,gjBMZYVujDjD1ECG4i97M8Q3gV9ESnwwTSUGropkusj,59756226,116489350,-56733124,302
2022-05-03 14:15:14-04:00,17415,B6Wc3euMqUf6QjzCqDtNeAEUM7MvADFaiReEq9VYH2Qg,2pzhsqXYd5u7h4xTN8bMS3GbicVnJ6KY3MQn7spSXroA,True,69852602,8883032,26841,13420,13421,2a35JJeTUW1pm6M3e8DHCjp8qr4vbc2cRPhuzZWyFzYd,2110703,18080990,-15970287,302
2022-05-03 14:19:24-04:00,17416,7tFD53kPTqrzjCu1Wji78gUqhoRtCUhsP1pM3DQKT7uG,BJvgPLYBDJrQJdQVowrsMwUGMurq4zTihoFwWoEokfu3,True,67265301749,14167299390,44231059,22115529,22115530,AmTrMPzuTp2BjnjqGNKqz9FTTCdpoKcPAJLwFc8ozcbh,2100058360,7492574254,-5392515894,312
2022-05-03 14:40:55-04:00,17417,4pVzpvQywzjV9y7vR4mR3J1vgurmHCPE4z2jDsJfvMdr,DcxzYh2P27r4ji6rV1BiSiDSYW1zQR7eFLYKA6U4s4RP,True,5660654885,1415163721,4277418,2138709,2138709,2py1FiYeL2f7J3HU36qiJz6TD6HCmiTN36RyxYtapQCZ,171096720,297304787,-126208067,302
2022-05-03 14:42:05-04:00,17418,kn4CMFEGiFu6Sw8v7GAZaBNHKe5Mst4Bj2kds1B6Daw,4FAjghUCswqbD6SKVr7Mu9aLcSLxDofiBvxgkZeiVz32,True,59895206,7840770,23738,11869,11869,5HnvdJnCCcmRsm4GkXnYWd4q9RpwuvYDGEUMPkYR3Ts9,1813401,8931623,-7118222,302
2022-05-03 14:43:04-04:00,17419,B6Wc3euMqUf6QjzCqDtNeAEUM7MvADFaiReEq9VYH2Qg,2pzhsqXYd5u7h4xTN8bMS3GbicVnJ6KY3MQn7spSXroA,True,60724177,8547667,25878,12939,12939,2a35JJeTUW1pm6M3e8DHCjp8qr4vbc2cRPhuzZWyFzYd,1838469,16234005,-14395536,302
2022-05-03 15:11:23-04:00,17420,9XmuJX8mFX29c5uh68kK7ff1mPdvs1orJAgEP6BsVKnq,HfPpizwUoK6uEmMb9LWi464BnvjHQY9cuPppFMp1DKDA,True,1174344957,293586239,887796,443898,443898,68sueyVfmy5ToEGtLFGDkwebX47xAmzyXE29z8JrmcWv,35511877,74947211,-39435334,302
2022-05-03 15:22:56-04:00,17421,87yYQuRW91LAqEmqEyYah7obsr4KijRrqsKdK7DGA9w,EJzredSumMNBMTYxMMHocKayWKg3A3621QJ3ArJqro8r,True,639731735,159932933,476001,238000,238001,C4UnXuShCvjSMgBAgVNMy1oakxCNk1et27A82fywU112,19040049,141698347,-122658298,297
2022-05-03 15:22:57-04:00,17422,F2AU2PjaSmHxWWhkz8XxMggkCMWbMVgawt89tSnYS6RL,ET9febRJiW197DYMaJbgk3kWsAeFv5f4peQ4vFCVppK6,True,665460729,166365182,496291,248145,248146,6UQfSsLooL4pQKQfLtXCutQS2BnF7A7F7ewJopDLmUpc,19851653,57550250,-37698597,298
2022-05-03 15:23:19-04:00,17423,3zVmiyif8VbqUW7dAeEMYJYrg8r5pCeBfALsdgu6kgFJ,FwzrxNbJsiCQwqayaDhwkbm9TRG11bK6fWs5Dn75da9a,True,476931775,119232943,359565,179782,179783,gjBMZYVujDjD1ECG4i97M8Q3gV9ESnwwTSUGropkusj,14382637,107989621,-93606984,301
2022-05-03 15:23:24-04:00,17424,CDVtXFbo4Rg2aHsXKv5P3uRJq9ZTgsRd7GXPTxgH5xv9,6zj37qQnaiJT7xGEZmSKx5yQvisQFcs5KhGsG43SGd5y,True,589852478,67687461,220334,110167,110167,3zqXX6kzhkbW3d4TwD2CNjMRwxTbREXySekvq37kfCNk,19200789,185324822,-166124033,325
2022-05-03 15:23:24-04:00,17425,5zqXqEjg95BnghcVbHRhYkSTYnzZjUBichgccv1BpS3d,9SuqSxrKpHh9NcNePe4Q3jXvpCmhNnoQv8YAFih3CqMX,True,6066836322,1516709080,4595061,2297530,2297531,gjBMZYVujDjD1ECG4i97M8Q3gV9ESnwwTSUGropkusj,183802470,1383606893,-1199804423,302
2022-05-03 15:23:27-04:00,17426,5xkW7wHTcF5WadNtBBqKPKctVwyQtTqqscivAmxzseCk,7m31ZMZdCn5Gz2q5sETWA7uKA5LsKD7pJHBBqU3g7tCn,True,2806891621,701722905,2078398,1039199,1039199,3zqXX6kzhkbW3d4TwD2CNjMRwxTbREXySekvq37kfCNk,83135950,145255722,-62119772,296
2022-05-03 15:36:30-04:00,17427,FtF3PVw8YNJseWPMcA2GEuQZ6nni1mq5kYPa2LrSzfkW,4yr1TM2dXrBvLNMpSaoryuGU2P8D3WG1ZCkvVzWFiQRH,True,27655922,1542051,7454,3727,3727,2a35JJeTUW1pm6M3e8DHCjp8qr4vbc2cRPhuzZWyFzYd,1336853,16130509,-14793656,483
2022-05-03 15:40:03-04:00,17428,FRbeFwhUYCiHW5oP26mad8KND7CCYDbfnoNxX7GuXVp8,GrzXKxPX2WDka8i2D8sunMUsrsThKasQi8NYLwuCGygV,True,6802414663,1167304161,4673813,2336906,2336907,2a35JJeTUW1pm6M3e8DHCjp8qr4vbc2cRPhuzZWyFzYd,272364474,1852239295,-1579874821,400
2022-05-03 15:42:07-04:00,17429,kn4CMFEGiFu6Sw8v7GAZaBNHKe5Mst4Bj2kds1B6Daw,4FAjghUCswqbD6SKVr7Mu9aLcSLxDofiBvxgkZeiVz32,True,51821758,7085767,21228,10614,10614,2a35JJeTUW1pm6M3e8DHCjp8qr4vbc2cRPhuzZWyFzYd,1552585,8333257,-6780672,299
2022-05-03 16:14:31-04:00,17430,5QxR9QPTADFys9VQNm473RgprTikCXC23vhsBc9ojyAQ,H9zdf8nJ4JCF7jrwGsxiuiFoa14gzDmYsZ5N5ig3UGna,True,1554301441,388575360,1172570,586285,586285,2xTUy2RS74GJMMDnmFaegMzFLn19RVfYG4CibhBmjP1i,46902823,97640707,-50737884,301
2022-05-03 16:19:10-04:00,17431,CDVtXFbo4Rg2aHsXKv5P3uRJq9ZTgsRd7GXPTxgH5xv9,6zj37qQnaiJT7xGEZmSKx5yQvisQFcs5KhGsG43SGd5y,True,520234582,59379106,194271,97135,97136,2a35JJeTUW1pm6M3e8DHCjp8qr4vbc2cRPhuzZWyFzYd,17020622,170436759,-153416137,327
2022-05-03 16:21:22-04:00,17432,F5vnN191nY9kUJBtFcm6fUhPDJvUSrSHLvfstesb68rH,9DtiZh3FsVmZA9MRqZhonAN2Pk4rQdcWw8As76DnQ6ee,True,2889247109,722311777,5050299,2525149,2525150,68sueyVfmy5ToEGtLFGDkwebX47xAmzyXE29z8JrmcWv,202011963,449006535,-246994572,699
2022-05-03 16:21:23-04:00,17433,D8BtQirMEk3W9Pq29B6KkKWrwPfmsUNpwz5npx7aGMLY,J7LMZwaSoh5hbGcwee6oPsnN4ZFD7Zp3LQWkJGNUHRfJ,True,582619712,145654928,1001889,500944,500945,gjBMZYVujDjD1ECG4i97M8Q3gV9ESnwwTSUGropkusj,40075592,168178324,-128102732,687
2022-05-03 16:21:35-04:00,17434,FtF3PVw8YNJseWPMcA2GEuQZ6nni1mq5kYPa2LrSzfkW,4yr1TM2dXrBvLNMpSaoryuGU2P8D3WG1ZCkvVzWFiQRH,True,26021328,1536184,7289,3644,3645,68sueyVfmy5ToEGtLFGDkwebX47xAmzyXE29z8JrmcWv,1234736,14949162,-13714426,474
2022-05-03 16:21:59-04:00,17435,8fVwuVA2CL5sZoHh6Dg4MBpcX3cvoUm7mnitnpQSdPBD,4F4ccaNm1KQu29XvsKvdjFkmpsbWqNvXkV41851EYQyu,True,23669989,3299226,14696,7348,7348,68sueyVfmy5ToEGtLFGDkwebX47xAmzyXE29z8JrmcWv,1054425,8466312,-7411887,445
2022-05-03 16:22:03-04:00,17436,B6Wc3euMqUf6QjzCqDtNeAEUM7MvADFaiReEq9VYH2Qg,2pzhsqXYd5u7h4xTN8bMS3GbicVnJ6KY3MQn7spSXroA,True,51945136,6620809,20032,10016,10016,5HnvdJnCCcmRsm4GkXnYWd4q9RpwuvYDGEUMPkYR3Ts9,1571755,13993818,-12422063,302
2022-05-03 16:22:32-04:00,17437,29JVska5UEG3axs63EmtHpPvkswNEqYpZ3PKMSfupiAG,DCftNBUsuogxyaJe9G9m3eWipH6o3qo4Rn4TuQXdVaBF,True,29937152,5494030,22650,11325,11325,68sueyVfmy5ToEGtLFGDkwebX47xAmzyXE29z8JrmcWv,1234268,6555699,-5321431,412
2022-05-03 16:40:17-04:00,17438,3Dc89y1Z6ViLFDoY3vwcJewSjMQam2mSTqPtpxsPZVz5,4NfXm5CTgNUTQd6NPj2hKwjMYDr7a8d5yVC9rV2uTcjA,True,1113662479,278415619,1980681,990340,990341,2py1FiYeL2f7J3HU36qiJz6TD6HCmiTN36RyxYtapQCZ,79227247,258087962,-178860715,711
2022-05-03 16:54:28-04:00,17439,D8BtQirMEk3W9Pq29B6KkKWrwPfmsUNpwz5npx7aGMLY,J7LMZwaSoh5hbGcwee6oPsnN4ZFD7Zp3LQWkJGNUHRfJ,True,427096890,106774222,730145,365072,365073,C4UnXuShCvjSMgBAgVNMy1oakxCNk1et27A82fywU112,29205809,135186373,-105980564,683
2022-05-04 02:43:45-04:00,17440,F4hN7ecndZ8Gr5KQNSFaSrMGawMasz7jfWTLTMpk7gaB,AJ23FpXSGjipcqywk88WGsKfqfiiUjPzZLsvLtBAhB12,True,156142125,39035531,278068,139034,139034,GXyFXZMNk2NFyEzw6JetVqsujqcz2yCixH7n8EpDJYWD,11122745,564045,10558700,712
2022-05-04 06:15:54-04:00,17441,7ZYFuMZx2mPLo7MBQC6wGmar8zhrC326eiPS3kogSiYb,X2Ng1YJqAdXRLii2SuczPys6kxjbbw77JPU52SDk3P4,True,1725879922,172610788,779760,389880,389880,68sueyVfmy5ToEGtLFGDkwebX47xAmzyXE29z8JrmcWv,77965810,121240919,-43275109,451
2022-05-04 06:16:04-04:00,17442,5XNxKk3X2hLpUC9Jw5sY6VkwvLLgZxAsLiD6GKsoaC5P,7ahPtnD3R3fUoXptKPky6R8uv3B5ceM8tL7aLnufoxzS,True,4451966558,321312953,1777076,888538,888538,2xTUy2RS74GJMMDnmFaegMzFLn19RVfYG4CibhBmjP1i,246223637,362921375,-116697738,553
2022-05-04 06:16:48-04:00,17443,CFxQJ46pCtCLMzhjVnVZU346FkpqbJXXQR7CqvhDsUnJ,BuDNCmcsAfZgh3qUhuwewSMAx6HZcucdSau2wVYDoiX3,True,196292884,49073221,337930,168965,168965,C4UnXuShCvjSMgBAgVNMy1oakxCNk1et27A82fywU112,13517223,34811694,-21294471,688
2022-05-04 06:16:49-04:00,17444,HHNj1MooHaJCm7SYAjdKSnk2sa7yUFH2PrQYWiN9E6uy,H6hKDBEsDh76s9H9FVBn1ZDTR27JEZTHUM7zwoWw26bc,True,5661060666,1415265166,9659138,4829569,4829569,2py1FiYeL2f7J3HU36qiJz6TD6HCmiTN36RyxYtapQCZ,386365522,632611704,-246246182,682
2022-05-04 06:16:55-04:00,17445,7ZYFuMZx2mPLo7MBQC6wGmar8zhrC326eiPS3kogSiYb,X2Ng1YJqAdXRLii2SuczPys6kxjbbw77JPU52SDk3P4,True,1562057388,131655140,576478,288239,288239,5HnvdJnCCcmRsm4GkXnYWd4q9RpwuvYDGEUMPkYR3Ts9,68397914,102468815,-34070901,437
2022-05-04 06:18:17-04:00,17446,EnWyeq6uuqbcNJ9rRxBmyADxFtJuJLqBEpZ5fCAuuA5r,AqzckBF3sjpbuxGiPzYs11DWwSV6Y4NGdc9hGgn5UoJC,True,231258585411,23968961607,152729146,76364573,76364573,AmTrMPzuTp2BjnjqGNKqz9FTTCdpoKcPAJLwFc8ozcbh,14735693130,26115198543,-11379505413,637
2022-05-04 06:18:17-04:00,17447,5XNxKk3X2hLpUC9Jw5sY6VkwvLLgZxAsLiD6GKsoaC5P,7ahPtnD3R3fUoXptKPky6R8uv3B5ceM8tL7aLnufoxzS,True,4152449435,246471414,1321558,660779,660779,AmTrMPzuTp2BjnjqGNKqz9FTTCdpoKcPAJLwFc8ozcbh,222650731,351999776,-129349045,536
2022-05-04 06:18:51-04:00,17448,CFxQJ46pCtCLMzhjVnVZU346FkpqbJXXQR7CqvhDsUnJ,BuDNCmcsAfZgh3qUhuwewSMAx6HZcucdSau2wVYDoiX3,True,149720845,37430211,266952,133476,133476,68sueyVfmy5ToEGtLFGDkwebX47xAmzyXE29z8JrmcWv,10678111,29152926,-18474815,713
2022-05-04 06:18:52-04:00,17449,HHNj1MooHaJCm7SYAjdKSnk2sa7yUFH2PrQYWiN9E6uy,H6hKDBEsDh76s9H9FVBn1ZDTR27JEZTHUM7zwoWw26bc,True,4319218747,1079804686,7582078,3791039,3791039,2xTUy2RS74GJMMDnmFaegMzFLn19RVfYG4CibhBmjP1i,303283137,563870678,-260587541,702
2022-05-04 06:20:36-04:00,17450,7ZYFuMZx2mPLo7MBQC6wGmar8zhrC326eiPS3kogSiYb,X2Ng1YJqAdXRLii2SuczPys6kxjbbw77JPU52SDk3P4,True,1438554575,258859206,1073709,536854,536855,5HnvdJnCCcmRsm4GkXnYWd4q9RpwuvYDGEUMPkYR3Ts9,59669109,86185983,-26516874,414
2022-05-04 06:20:48-04:00,17451,5XNxKk3X2hLpUC9Jw5sY6VkwvLLgZxAsLiD6GKsoaC5P,7ahPtnD3R3fUoXptKPky6R8uv3B5ceM8tL7aLnufoxzS,True,3920069480,237137749,1253648,626824,626824,AmTrMPzuTp2BjnjqGNKqz9FTTCdpoKcPAJLwFc8ozcbh,207237714,338276933,-131039219,528
2022-05-04 06:21:08-04:00,17452,CFxQJ46pCtCLMzhjVnVZU346FkpqbJXXQR7CqvhDsUnJ,BuDNCmcsAfZgh3qUhuwewSMAx6HZcucdSau2wVYDoiX3,True,114751196,28687799,198764,99382,99382,DQCvC9mR68hJ3tJsUiddh6JwcBJAmntqGJR2nUsEq7yj,7950597,24268847,-16318250,692
2022-05-04 06:21:10-04:00,17453,HHNj1MooHaJCm7SYAjdKSnk2sa7yUFH2PrQYWiN9E6uy,H6hKDBEsDh76s9H9FVBn1ZDTR27JEZTHUM7zwoWw26bc,True,3302596746,825649186,5812959,2906479,2906480,GXyFXZMNk2NFyEzw6JetVqsujqcz2yCixH7n8EpDJYWD,232518374,492547034,-260028660,704
2022-05-04 06:21:18-04:00,17454,7ZYFuMZx2mPLo7MBQC6wGmar8zhrC326eiPS3kogSiYb,X2Ng1YJqAdXRLii2SuczPys6kxjbbw77JPU52SDk3P4,True,1185650091,102268117,454051,227025,227026,2xTUy2RS74GJMMDnmFaegMzFLn19RVfYG4CibhBmjP1i,52640678,92332942,-39692264,443
2022-05-04 06:26:02-04:00,17455,EnWyeq6uuqbcNJ9rRxBmyADxFtJuJLqBEpZ5fCAuuA5r,AqzckBF3sjpbuxGiPzYs11DWwSV6Y4NGdc9hGgn5UoJC,True,208563198312,21898221890,139925253,69962626,69962627,2py1FiYeL2f7J3HU36qiJz6TD6HCmiTN36RyxYtapQCZ,13326770800,25207688845,-11880918045,638
2022-05-04 06:26:05-04:00,17456,5XNxKk3X2hLpUC9Jw5sY6VkwvLLgZxAsLiD6GKsoaC5P,7ahPtnD3R3fUoXptKPky6R8uv3B5ceM8tL7aLnufoxzS,True,3698273037,191649587,987936,493968,493968,2xTUy2RS74GJMMDnmFaegMzFLn19RVfYG4CibhBmjP1i,190642760,311690215,-121047455,515
2022-05-04 06:26:18-04:00,17457,CFxQJ46pCtCLMzhjVnVZU346FkpqbJXXQR7CqvhDsUnJ,BuDNCmcsAfZgh3qUhuwewSMAx6HZcucdSau2wVYDoiX3,True,87663972,21915993,153781,76890,76891,GXyFXZMNk2NFyEzw6JetVqsujqcz2yCixH7n8EpDJYWD,6151258,19991417,-13840159,701
2022-05-04 06:26:23-04:00,17458,HHNj1MooHaJCm7SYAjdKSnk2sa7yUFH2PrQYWiN9E6uy,H6hKDBEsDh76s9H9FVBn1ZDTR27JEZTHUM7zwoWw26bc,True,2526137022,631534255,4437898,2218949,2218949,DQCvC9mR68hJ3tJsUiddh6JwcBJAmntqGJR2nUsEq7yj,177515953,422524431,-245008478,702
2022-05-04 06:26:24-04:00,17459,7ZYFuMZx2mPLo7MBQC6wGmar8zhrC326eiPS3kogSiYb,X2Ng1YJqAdXRLii2SuczPys6kxjbbw77JPU52SDk3P4,True,1090160861,194144405,808656,404328,404328,gjBMZYVujDjD1ECG4i97M8Q3gV9ESnwwTSUGropkusj,45407740,76563931,-31156191,416
2022-05-04 06:26:53-04:00,17460,5XNxKk3X2hLpUC9Jw5sY6VkwvLLgZxAsLiD6GKsoaC5P,7ahPtnD3R3fUoXptKPky6R8uv3B5ceM8tL7aLnufoxzS,True,3518925118,178237313,898312,449156,449156,DQCvC9mR68hJ3tJsUiddh6JwcBJAmntqGJR2nUsEq7yj,177353156,294573620,-117220464,503
2022-05-04 06:27:53-04:00,17461,EnWyeq6uuqbcNJ9rRxBmyADxFtJuJLqBEpZ5fCAuuA5r,AqzckBF3sjpbuxGiPzYs11DWwSV6Y4NGdc9hGgn5UoJC,True,187904453786,17925074227,114701042,57350521,57350521,DQCvC9mR68hJ3tJsUiddh6JwcBJAmntqGJR2nUsEq7yj,12023848027,23714634504,-11690786477,639
2022-05-04 06:29:09-04:00,17462,DfALqn81JH4JiyA7bDhePeXSeqXf3314H5YnPJo1ymmt,J9JbhHKCuknb4vHbTTbv1G5ByqVHuKKRemw7fqv1g1rT,True,204585932711,29035358297,177629677,88814838,88814839,GXyFXZMNk2NFyEzw6JetVqsujqcz2yCixH7n8EpDJYWD,12515958316,28257947238,-15741988922,611
2022-05-04 06:40:52-04:00,17463,5XNxKk3X2hLpUC9Jw5sY6VkwvLLgZxAsLiD6GKsoaC5P,7ahPtnD3R3fUoXptKPky6R8uv3B5ceM8tL7aLnufoxzS,True,3349833666,404094241,2018266,1009133,1009133,A2p75MbAbeUdHkPLkAjgGeiwuu9WPrkMHzjCkDXF1Xr3,167308983,274258062,-106949079,499
2022-05-04 06:41:34-04:00,17464,5XNxKk3X2hLpUC9Jw5sY6VkwvLLgZxAsLiD6GKsoaC5P,7ahPtnD3R3fUoXptKPky6R8uv3B5ceM8tL7aLnufoxzS,True,2955582763,147188930,774132,387066,387066,GXyFXZMNk2NFyEzw6JetVqsujqcz2yCixH7n8EpDJYWD,155447379,267102646,-111655267,525
2022-05-04 06:41:39-04:00,17465,CFxQJ46pCtCLMzhjVnVZU346FkpqbJXXQR7CqvhDsUnJ,BuDNCmcsAfZgh3qUhuwewSMAx6HZcucdSau2wVYDoiX3,True,67117027,16779256,115710,57855,57855,gjBMZYVujDjD1ECG4i97M8Q3gV9ESnwwTSUGropkusj,4628429,16378105,-11749676,689
2022-05-04 06:41:39-04:00,17466,7ZYFuMZx2mPLo7MBQC6wGmar8zhrC326eiPS3kogSiYb,X2Ng1YJqAdXRLii2SuczPys6kxjbbw77JPU52SDk3P4,True,901676676,79641629,355890,177945,177945,DQCvC9mR68hJ3tJsUiddh6JwcBJAmntqGJR2nUsEq7yj,40292748,81165386,-40872638,446
2022-05-04 06:41:42-04:00,17467,HHNj1MooHaJCm7SYAjdKSnk2sa7yUFH2PrQYWiN9E6uy,H6hKDBEsDh76s9H9FVBn1ZDTR27JEZTHUM7zwoWw26bc,True,1934334684,483583671,3333653,1666826,1666827,2xTUy2RS74GJMMDnmFaegMzFLn19RVfYG4CibhBmjP1i,133346138,357287176,-223941038,689
2022-05-04 06:44:24-04:00,17468,EnWyeq6uuqbcNJ9rRxBmyADxFtJuJLqBEpZ5fCAuuA5r,AqzckBF3sjpbuxGiPzYs11DWwSV6Y4NGdc9hGgn5UoJC,True,170928027034,16604183853,106599908,53299954,53299954,2xTUy2RS74GJMMDnmFaegMzFLn19RVfYG4CibhBmjP1i,10973687230,23047635736,-12073948506,642
2022-05-04 06:56:52-04:00,17469,CFxQJ46pCtCLMzhjVnVZU346FkpqbJXXQR7CqvhDsUnJ,BuDNCmcsAfZgh3qUhuwewSMAx6HZcucdSau2wVYDoiX3,True,51311625,12827906,88471,44235,44236,5HnvdJnCCcmRsm4GkXnYWd4q9RpwuvYDGEUMPkYR3Ts9,3538865,13325265,-9786400,689
2022-05-04 06:56:56-04:00,17470,5XNxKk3X2hLpUC9Jw5sY6VkwvLLgZxAsLiD6GKsoaC5P,7ahPtnD3R3fUoXptKPky6R8uv3B5ceM8tL7aLnufoxzS,True,2817378992,135351231,699908,349954,349954,AmTrMPzuTp2BjnjqGNKqz9FTTCdpoKcPAJLwFc8ozcbh,145688088,250761995,-105073907,517
2022-05-04 06:56:56-04:00,17471,HHNj1MooHaJCm7SYAjdKSnk2sa7yUFH2PrQYWiN9E6uy,H6hKDBEsDh76s9H9FVBn1ZDTR27JEZTHUM7zwoWw26bc,True,1475972473,368993118,2619775,1309887,1309888,DQCvC9mR68hJ3tJsUiddh6JwcBJAmntqGJR2nUsEq7yj,104791025,298225480,-193434455,709
2022-05-04 07:04:55-04:00,17472,Aegmcn7VWMa1hTYSqLiJAz2P9EmSHXZNJZgeCtPEnAhZ,5MPtSRLs5paUtdwhinwhZZV8jnR4LeyPbM94qLYMk75C,True,1265069644,316267411,2178382,1089191,1089191,C4UnXuShCvjSMgBAgVNMy1oakxCNk1et27A82fywU112,87135286,129700161,-42564875,688
2022-05-04 07:04:55-04:00,17473,DHv4AsHMRZ6DuPaKEr2cLMNsX2ezT75T9haNgsDngS2b,5pMurvHHPdPKg3R96o1fKBbJh2Mc2tBP6P1e3acB31vQ,True,669637263,167409315,975377,487688,487689,C4UnXuShCvjSMgBAgVNMy1oakxCNk1et27A82fywU112,39015096,69309475,-30294379,582
2022-05-04 07:06:45-04:00,17474,DHv4AsHMRZ6DuPaKEr2cLMNsX2ezT75T9haNgsDngS2b,5pMurvHHPdPKg3R96o1fKBbJh2Mc2tBP6P1e3acB31vQ,True,499078248,124769562,872250,436125,436125,5HnvdJnCCcmRsm4GkXnYWd4q9RpwuvYDGEUMPkYR3Ts9,34890019,60797794,-25907775,699
2022-05-04 07:08:23-04:00,17475,Aegmcn7VWMa1hTYSqLiJAz2P9EmSHXZNJZgeCtPEnAhZ,5MPtSRLs5paUtdwhinwhZZV8jnR4LeyPbM94qLYMk75C,True,927738186,231934546,1597321,798660,798661,gjBMZYVujDjD1ECG4i97M8Q3gV9ESnwwTSUGropkusj,63892857,117012164,-53119307,688
2022-05-04 07:08:37-04:00,17476,DHv4AsHMRZ6DuPaKEr2cLMNsX2ezT75T9haNgsDngS2b,5pMurvHHPdPKg3R96o1fKBbJh2Mc2tBP6P1e3acB31vQ,True,366076028,91519007,644627,322313,322314,DQCvC9mR68hJ3tJsUiddh6JwcBJAmntqGJR2nUsEq7yj,25785111,53469513,-27684402,704
2022-05-04 07:25:12-04:00,17477,Aegmcn7VWMa1hTYSqLiJAz2P9EmSHXZNJZgeCtPEnAhZ,5MPtSRLs5paUtdwhinwhZZV8jnR4LeyPbM94qLYMk75C,True,682176991,170544247,1216722,608361,608361,68sueyVfmy5ToEGtLFGDkwebX47xAmzyXE29z8JrmcWv,48668887,102208235,-53539348,713
2022-05-04 07:29:24-04:00,17478,DHv4AsHMRZ6DuPaKEr2cLMNsX2ezT75T9haNgsDngS2b,5pMurvHHPdPKg3R96o1fKBbJh2Mc2tBP6P1e3acB31vQ,True,268487996,67121999,476786,238393,238393,5HnvdJnCCcmRsm4GkXnYWd4q9RpwuvYDGEUMPkYR3Ts9,19071459,45915420,-26843961,710
2022-05-04 08:44:59-04:00,17479,Aegmcn7VWMa1hTYSqLiJAz2P9EmSHXZNJZgeCtPEnAhZ,5MPtSRLs5paUtdwhinwhZZV8jnR4LeyPbM94qLYMk75C,True,497405546,124351386,830621,415310,415311,2a35JJeTUW1pm6M3e8DHCjp8qr4vbc2cRPhuzZWyFzYd,33224870,87647367,-54422497,667
2022-05-04 09:14:09-04:00,17480,DHv4AsHMRZ6DuPaKEr2cLMNsX2ezT75T9haNgsDngS2b,5pMurvHHPdPKg3R96o1fKBbJh2Mc2tBP6P1e3acB31vQ,True,196596988,49149247,345738,172869,172869,68sueyVfmy5ToEGtLFGDkwebX47xAmzyXE29z8JrmcWv,13829532,38737984,-24908452,703
2022-05-04 09:59:56-04:00,17481,Aegmcn7VWMa1hTYSqLiJAz2P9EmSHXZNJZgeCtPEnAhZ,5MPtSRLs5paUtdwhinwhZZV8jnR4LeyPbM94qLYMk75C,True,366680426,91670106,650697,325348,325349,68sueyVfmy5ToEGtLFGDkwebX47xAmzyXE29z8JrmcWv,26027897,73241129,-47213232,709
2022-05-04 11:13:37-04:00,17482,DLwEaZipqHmVBD5hc5v1NZtDStHyG4hAMwxywDTGGc2e,28GtwJw67UWfrSKxtuvpzoKzPyKXLgP3GKLm3fHdR566,True,17152398984,4288099746,26652089,13326044,13326045,5HnvdJnCCcmRsm4GkXnYWd4q9RpwuvYDGEUMPkYR3Ts9,1066083576,1288684592,-222601016,621
2022-05-04 14:49:34-04:00,17483,DfALqn81JH4JiyA7bDhePeXSeqXf3314H5YnPJo1ymmt,J9JbhHKCuknb4vHbTTbv1G5ByqVHuKKRemw7fqv1g1rT,True,177909184314,21448073401,134002772,67001386,67001386,68sueyVfmy5ToEGtLFGDkwebX47xAmzyXE29z8JrmcWv,11115368543,25485181623,-14369813080,624
2022-05-04 14:56:48-04:00,17484,5XNxKk3X2hLpUC9Jw5sY6VkwvLLgZxAsLiD6GKsoaC5P,7ahPtnD3R3fUoXptKPky6R8uv3B5ceM8tL7aLnufoxzS,True,3339352131,261169330,1420060,710030,710030,5HnvdJnCCcmRsm4GkXnYWd4q9RpwuvYDGEUMPkYR3Ts9,181571170,326453998,-144882828,543
2022-05-04 15:01:49-04:00,17485,DfALqn81JH4JiyA7bDhePeXSeqXf3314H5YnPJo1ymmt,J9JbhHKCuknb4vHbTTbv1G5ByqVHuKKRemw7fqv1g1rT,True,157232919202,16673787151,104214545,52107272,52107273,2xTUy2RS74GJMMDnmFaegMzFLn19RVfYG4CibhBmjP1i,9827375808,23586070365,-13758694557,625
2022-05-04 15:05:15-04:00,17486,EcrRsDA9VHZ5xGL96xbwuWjMKuucQh2vwNtw9xsj3Xh8,5sRcukEVVe1wUxtxRMmNfLnZ6XmeMPfe8hu3Sc6r5U7B,True,592445935028,56902502137,361787719,180893859,180893860,2py1FiYeL2f7J3HU36qiJz6TD6HCmiTN36RyxYtapQCZ,37667880339,87259504381,-49591624042,635
2022-05-04 15:05:15-04:00,17487,EnWyeq6uuqbcNJ9rRxBmyADxFtJuJLqBEpZ5fCAuuA5r,AqzckBF3sjpbuxGiPzYs11DWwSV6Y4NGdc9hGgn5UoJC,True,146139513699,14395456927,89400320,44700160,44700160,2a35JJeTUW1pm6M3e8DHCjp8qr4vbc2cRPhuzZWyFzYd,9075724026,21803285661,-12727561635,621
2022-05-04 15:06:29-04:00,17488,EnWyeq6uuqbcNJ9rRxBmyADxFtJuJLqBEpZ5fCAuuA5r,AqzckBF3sjpbuxGiPzYs11DWwSV6Y4NGdc9hGgn5UoJC,True,132198683701,12548610187,81164291,40582145,40582146,gjBMZYVujDjD1ECG4i97M8Q3gV9ESnwwTSUGropkusj,8550598287,20327789406,-11777191119,646
2022-05-04 15:06:30-04:00,17489,DfALqn81JH4JiyA7bDhePeXSeqXf3314H5YnPJo1ymmt,J9JbhHKCuknb4vHbTTbv1G5ByqVHuKKRemw7fqv1g1rT,True,141728349843,16313980770,98754106,49377053,49377053,A9TwRM1BMxqb8DCC7YNAMV6zPenEJm3HTZBy7wJKK58U,8579301861,21920085115,-13340783254,605
2022-05-04 15:06:30-04:00,17490,EcrRsDA9VHZ5xGL96xbwuWjMKuucQh2vwNtw9xsj3Xh8,5sRcukEVVe1wUxtxRMmNfLnZ6XmeMPfe8hu3Sc6r5U7B,True,539645276626,51225222723,317549987,158774993,158774994,2xTUy2RS74GJMMDnmFaegMzFLn19RVfYG4CibhBmjP1i,33453119771,81866967548,-48413847777,619
2022-05-04 15:06:30-04:00,17491,DfALqn81JH4JiyA7bDhePeXSeqXf3314H5YnPJo1ymmt,J9JbhHKCuknb4vHbTTbv1G5ByqVHuKKRemw7fqv1g1rT,True,126293548101,12594031720,75801084,37900542,37900542,GXyFXZMNk2NFyEzw6JetVqsujqcz2yCixH7n8EpDJYWD,7601368727,20153172518,-12551803791,601
2022-05-04 15:06:30-04:00,17492,EnWyeq6uuqbcNJ9rRxBmyADxFtJuJLqBEpZ5fCAuuA5r,AqzckBF3sjpbuxGiPzYs11DWwSV6Y4NGdc9hGgn5UoJC,True,120611939088,10807357857,67271100,33635550,33635550,2xTUy2RS74GJMMDnmFaegMzFLn19RVfYG4CibhBmjP1i,7507568422,19119010133,-11611441711,622
2022-05-04 15:08:29-04:00,17493,7PzGZgzieFyyFs1dbajkNQgVxooFUNZrj1bUsQvrSwbp,A2gDREmSmJTBPPw3sbKVY3smC9wbHMDdv87gr4Tr2ES7,True,2343714612,585928653,1686533,843266,843267,2py1FiYeL2f7J3HU36qiJz6TD6HCmiTN36RyxYtapQCZ,67461345,125166655,-57705310,287
2022-05-04 15:08:53-04:00,17494,5XNxKk3X2hLpUC9Jw5sY6VkwvLLgZxAsLiD6GKsoaC5P,7ahPtnD3R3fUoXptKPky6R8uv3B5ceM8tL7aLnufoxzS,True,3094941008,197472412,1043221,521610,521611,2a35JJeTUW1pm6M3e8DHCjp8qr4vbc2cRPhuzZWyFzYd,163501794,313064735,-149562941,528
2022-05-04 15:10:42-04:00,17495,EnWyeq6uuqbcNJ9rRxBmyADxFtJuJLqBEpZ5fCAuuA5r,AqzckBF3sjpbuxGiPzYs11DWwSV6Y4NGdc9hGgn5UoJC,True,110170801947,8425075225,54908279,27454139,27454140,6UQfSsLooL4pQKQfLtXCutQS2BnF7A7F7ewJopDLmUpc,7180101147,17992408103,-10812306956,651
2022-05-04 15:10:43-04:00,17496,GETH4jXcsSKMY4q44J6CxaJmoPpc7TgPZRK7vUp6Lurh,Ea474jXmvHNJdETrZPo1pMRMXFNaAY3zanwyjMKbnr5v,True,4705690118,1176422529,3514806,1757403,1757403,DQCvC9mR68hJ3tJsUiddh6JwcBJAmntqGJR2nUsEq7yj,140592265,321731793,-181139528,298
2022-05-04 15:10:43-04:00,17497,EcrRsDA9VHZ5xGL96xbwuWjMKuucQh2vwNtw9xsj3Xh8,5sRcukEVVe1wUxtxRMmNfLnZ6XmeMPfe8hu3Sc6r5U7B,True,490538027750,43091506962,276087584,138043792,138043792,DQCvC9mR68hJ3tJsUiddh6JwcBJAmntqGJR2nUsEq7yj,31428805573,76175799634,-44746994061,640
2022-05-04 15:51:06-04:00,17498,AHPkko5vwX4hGgCyM8imGGmcaEiXKY6XyKx7z5YoCxab,8nRSEWy7zPLBbo2YjN1et1SssSAxUYmTxv4vAt2HWEK1,True,600137243880,48710598194,303570819,151785409,151785410,A2p75MbAbeUdHkPLkAjgGeiwuu9WPrkMHzjCkDXF1Xr3,37401338049,76242483080,-38841145031,623
2022-05-04 17:51:10-04:00,17499,AHPkko5vwX4hGgCyM8imGGmcaEiXKY6XyKx7z5YoCxab,8nRSEWy7zPLBbo2YjN1et1SssSAxUYmTxv4vAt2HWEK1,True,553902242540,43829036787,273850938,136925469,136925469,6UQfSsLooL4pQKQfLtXCutQS2BnF7A7F7ewJopDLmUpc,34608711515,72885945448,-38277233933,624
2022-05-04 19:45:30-04:00,17500,5nALef7nAfNkSQSuTBLwewDby4pUx74Gzqib33Znmmt6,8xNTWK2xNK2xZPpgXfcE4QxPT2i6YvNYakiLgdQ2FqEt,True,1803380955,450845238,1355225,677612,677613,3zqXX6kzhkbW3d4TwD2CNjMRwxTbREXySekvq37kfCNk,54209018,86777509,-32568491,300
2022-05-04 19:46:39-04:00,17501,DfALqn81JH4JiyA7bDhePeXSeqXf3314H5YnPJo1ymmt,J9JbhHKCuknb4vHbTTbv1G5ByqVHuKKRemw7fqv1g1rT,True,114248591686,12404532431,77394632,38697316,38697316,GXyFXZMNk2NFyEzw6JetVqsujqcz2yCixH7n8EpDJYWD,7128223324,18804445224,-11676221900,623
2022-05-04 19:59:21-04:00,17502,AHPkko5vwX4hGgCyM8imGGmcaEiXKY6XyKx7z5YoCxab,8nRSEWy7zPLBbo2YjN1et1SssSAxUYmTxv4vAt2HWEK1,True,512364414047,35998748848,224982065,112491032,112491033,2xTUy2RS74GJMMDnmFaegMzFLn19RVfYG4CibhBmjP1i,32021336343,68609992654,-36588656311,624
2022-05-04 20:03:16-04:00,17503,AHPkko5vwX4hGgCyM8imGGmcaEiXKY6XyKx7z5YoCxab,8nRSEWy7zPLBbo2YjN1et1SssSAxUYmTxv4vAt2HWEK1,True,478259567359,34822516445,217614274,108807137,108807137,2a35JJeTUW1pm6M3e8DHCjp8qr4vbc2cRPhuzZWyFzYd,29887589790,66338546295,-36450956505,624
2022-05-04 20:05:40-04:00,17504,DaHTFbsmuU4J1Erji8ZfqB1L2wSuY7DCxAuHoopwMHog,7tmPzHaeVyGdvMXWEuJzYRoSQfw4dH4Njyf6Rh3F7U9Z,True,69736953,17434238,108619,54309,54310,2a35JJeTUW1pm6M3e8DHCjp8qr4vbc2cRPhuzZWyFzYd,4344771,6673889,-2329118,623
2022-05-04 20:08:27-04:00,17505,DfALqn81JH4JiyA7bDhePeXSeqXf3314H5YnPJo1ymmt,J9JbhHKCuknb4vHbTTbv1G5ByqVHuKKRemw7fqv1g1rT,True,102595415607,9704531826,60484957,30242478,30242479,2xTUy2RS74GJMMDnmFaegMzFLn19RVfYG4CibhBmjP1i,6394413936,17252958790,-10858544854,623
2022-05-04 20:34:08-04:00,17506,5nALef7nAfNkSQSuTBLwewDby4pUx74Gzqib33Znmmt6,8xNTWK2xNK2xZPpgXfcE4QxPT2i6YvNYakiLgdQ2FqEt,True,1364486155,341121538,1022452,511226,511226,3zqXX6kzhkbW3d4TwD2CNjMRwxTbREXySekvq37kfCNk,40898114,77300160,-36402046,299
2022-05-04 21:01:25-04:00,17507,DbhYDjULmvytv9CD9absZq9VABwNkBy3y6ugnQN7RdVD,73NGUFBEAToVdoVP52fDihvDtKE7N2VPJfbbXw4vysSD,True,481691334,120422833,851922,425961,425961,5HnvdJnCCcmRsm4GkXnYWd4q9RpwuvYDGEUMPkYR3Ts9,34076887,47041452,-12964565,707
2022-05-04 22:41:12-04:00,17508,F5vnN191nY9kUJBtFcm6fUhPDJvUSrSHLvfstesb68rH,9DtiZh3FsVmZA9MRqZhonAN2Pk4rQdcWw8As76DnQ6ee,True,1901627045,475406761,3384614,1692307,1692307,2xTUy2RS74GJMMDnmFaegMzFLn19RVfYG4CibhBmjP1i,135384570,183659160,-48274590,711
2022-05-04 23:12:31-04:00,17509,5nALef7nAfNkSQSuTBLwewDby4pUx74Gzqib33Znmmt6,8xNTWK2xNK2xZPpgXfcE4QxPT2i6YvNYakiLgdQ2FqEt,True,1032107489,258026872,778134,389067,389067,2a35JJeTUW1pm6M3e8DHCjp8qr4vbc2cRPhuzZWyFzYd,31125391,67184057,-36058666,301
2022-05-05 00:08:15-04:00,17510,F5vnN191nY9kUJBtFcm6fUhPDJvUSrSHLvfstesb68rH,9DtiZh3FsVmZA9MRqZhonAN2Pk4rQdcWw8As76DnQ6ee,True,1454380811,363595202,2595496,1297748,1297748,2a35JJeTUW1pm6M3e8DHCjp8qr4vbc2cRPhuzZWyFzYd,103819851,168469649,-64649798,713
2022-05-05 09:31:53-04:00,17511,Cb6MEn1MN9XQcVVd3o9J8QdK3cFWxSNETsFzhVJ8jmdh,A6yTKbggUftjbjAVu5YR1M7rg7h78ghbfofmTSnmKNGz,True,1379420711,344855177,2150119,1075059,1075060,AmTrMPzuTp2BjnjqGNKqz9FTTCdpoKcPAJLwFc8ozcbh,86004760,141252053,-55247293,623
2022-05-05 09:31:57-04:00,17512,DHfy6B2AYsqMCxPLBCXMDfQn3Gr2VwJaLFHUZKqpCjsb,EPZpYaY1gCAb8pMtri5veRowBmCrCpTHBMa3Rmgt6S29,True,97949282,24487320,74060,37030,37030,5HnvdJnCCcmRsm4GkXnYWd4q9RpwuvYDGEUMPkYR3Ts9,2962423,4900436,-1938013,302
2022-05-05 09:39:50-04:00,17513,85w2wxozVA7Zfm1FdA1yWb8D43jdC9mefYzNqFyRe5iU,BHieDhQaBUbsWGmqNerfbCAMMGGAjEPpiNiSWAQS57D5,True,3016781358,754195339,2275322,1137661,1137661,5HnvdJnCCcmRsm4GkXnYWd4q9RpwuvYDGEUMPkYR3Ts9,91012898,150739262,-59726364,301
2022-05-05 09:44:50-04:00,17514,7DTi299NL6owDJEkjWY6SZX6MhLB72oU1xr9d5DPUzZp,F8YWvNb45pdhgkfCtrFiPNeS4rtjkjTkBkvL5EoPzYXM,True,510135026,127533756,908227,454113,454114,2a35JJeTUW1pm6M3e8DHCjp8qr4vbc2cRPhuzZWyFzYd,36329090,52063103,-15734013,712
2022-05-05 09:44:50-04:00,17515,FhCW2CghBaoo1MkXUXUb4okam8g5beQofgs3WXerNYzn,HWSPdmF3hSnnfVe29Y5rDGSPqbMQv2ug1wYrdwJZNWFK,True,57616396,7714627,23327,11663,11664,Hu94aiQWvce6THeGyCFqGRPM1pQrK3ihzkcXo1EpJcJL,1742226,3001420,-1259194,302
2022-05-05 09:45:52-04:00,17516,H7rsFRRhZPe2jLex2NkbYYzVtLobvFiqnCd4BUyJVPBB,8bedwDRfSKLP9vUxoXcpHNJzWQemMaf4QGT2mtHFVJFb,True,3401098327,850274581,2571557,1285778,1285779,5HnvdJnCCcmRsm4GkXnYWd4q9RpwuvYDGEUMPkYR3Ts9,102862318,169948858,-67086540,302
2022-05-05 09:55:40-04:00,17517,5xkW7wHTcF5WadNtBBqKPKctVwyQtTqqscivAmxzseCk,7m31ZMZdCn5Gz2q5sETWA7uKA5LsKD7pJHBBqU3g7tCn,True,4461075922,1115268980,3369071,1684535,1684536,3zqXX6kzhkbW3d4TwD2CNjMRwxTbREXySekvq37kfCNk,134762866,259380385,-124617519,302
2022-05-05 09:55:40-04:00,17518,DHfy6B2AYsqMCxPLBCXMDfQn3Gr2VwJaLFHUZKqpCjsb,EPZpYaY1gCAb8pMtri5veRowBmCrCpTHBMa3Rmgt6S29,True,72759441,18189860,54646,27323,27323,2a35JJeTUW1pm6M3e8DHCjp8qr4vbc2cRPhuzZWyFzYd,2185842,4341951,-2156109,300
2022-05-05 09:56:17-04:00,17519,FhCW2CghBaoo1MkXUXUb4okam8g5beQofgs3WXerNYzn,HWSPdmF3hSnnfVe29Y5rDGSPqbMQv2ug1wYrdwJZNWFK,True,49685078,6656078,20124,10062,10062,2a35JJeTUW1pm6M3e8DHCjp8qr4vbc2cRPhuzZWyFzYd,1502208,2871175,-1368967,302
2022-05-05 09:56:30-04:00,17520,DLwEaZipqHmVBD5hc5v1NZtDStHyG4hAMwxywDTGGc2e,28GtwJw67UWfrSKxtuvpzoKzPyKXLgP3GKLm3fHdR566,True,16602207865,4150551966,25848129,12924064,12924065,5HnvdJnCCcmRsm4GkXnYWd4q9RpwuvYDGEUMPkYR3Ts9,1033925170,1218017415,-184092245,622
2022-05-05 09:58:06-04:00,17521,H7rsFRRhZPe2jLex2NkbYYzVtLobvFiqnCd4BUyJVPBB,8bedwDRfSKLP9vUxoXcpHNJzWQemMaf4QGT2mtHFVJFb,True,2525534802,631383700,1875045,937522,937523,2xTUy2RS74GJMMDnmFaegMzFLn19RVfYG4CibhBmjP1i,75001817,150699838,-75698021,296
2022-05-05 09:58:48-04:00,17522,FhCW2CghBaoo1MkXUXUb4okam8g5beQofgs3WXerNYzn,HWSPdmF3hSnnfVe29Y5rDGSPqbMQv2ug1wYrdwJZNWFK,True,42843015,5753698,17405,8702,8703,Hu94aiQWvce6THeGyCFqGRPM1pQrK3ihzkcXo1EpJcJL,1296099,2609815,-1313716,302
2022-05-05 10:00:11-04:00,17523,DHfy6B2AYsqMCxPLBCXMDfQn3Gr2VwJaLFHUZKqpCjsb,EPZpYaY1gCAb8pMtri5veRowBmCrCpTHBMa3Rmgt6S29,True,54076541,13519135,40941,20470,20471,2a35JJeTUW1pm6M3e8DHCjp8qr4vbc2cRPhuzZWyFzYd,1637643,3747809,-2110166,302
2022-05-05 10:00:17-04:00,17524,5xkW7wHTcF5WadNtBBqKPKctVwyQtTqqscivAmxzseCk,7m31ZMZdCn5Gz2q5sETWA7uKA5LsKD7pJHBBqU3g7tCn,True,3313172761,828293190,2468202,1234101,1234101,AmTrMPzuTp2BjnjqGNKqz9FTTCdpoKcPAJLwFc8ozcbh,98728107,224988965,-126260858,297
2022-05-05 10:04:55-04:00,17525,FhCW2CghBaoo1MkXUXUb4okam8g5beQofgs3WXerNYzn,HWSPdmF3hSnnfVe29Y5rDGSPqbMQv2ug1wYrdwJZNWFK,True,36916421,4927037,14746,7373,7373,68sueyVfmy5ToEGtLFGDkwebX47xAmzyXE29z8JrmcWv,1104952,2479089,-1374137,299
2022-05-05 10:05:14-04:00,17526,H7rsFRRhZPe2jLex2NkbYYzVtLobvFiqnCd4BUyJVPBB,8bedwDRfSKLP9vUxoXcpHNJzWQemMaf4QGT2mtHFVJFb,True,1876383579,469095894,1383532,691766,691766,5HnvdJnCCcmRsm4GkXnYWd4q9RpwuvYDGEUMPkYR3Ts9,55341281,129935032,-74593751,294
2022-05-05 10:06:03-04:00,17527,DHfy6B2AYsqMCxPLBCXMDfQn3Gr2VwJaLFHUZKqpCjsb,EPZpYaY1gCAb8pMtri5veRowBmCrCpTHBMa3Rmgt6S29,True,40145562,10036390,29621,14810,14811,YQC4EUcgeBi9431viwvzvBbZJW3szeHX4dFmowRDyDw,1184858,3179352,-1994494,295
2022-05-05 10:06:03-04:00,17528,5xkW7wHTcF5WadNtBBqKPKctVwyQtTqqscivAmxzseCk,7m31ZMZdCn5Gz2q5sETWA7uKA5LsKD7pJHBBqU3g7tCn,True,2461963465,615490866,1833594,916797,916797,Hu94aiQWvce6THeGyCFqGRPM1pQrK3ihzkcXo1EpJcJL,73343799,191047097,-117703298,297
2022-05-05 10:07:57-04:00,17529,FhCW2CghBaoo1MkXUXUb4okam8g5beQofgs3WXerNYzn,HWSPdmF3hSnnfVe29Y5rDGSPqbMQv2ug1wYrdwJZNWFK,False,31862411,31862411,963232,48161,915071,Hu94aiQWvce6THeGyCFqGRPM1pQrK3ihzkcXo1EpJcJL,963233,2218392,-1255159,302
2022-05-05 10:20:53-04:00,17530,3CxwyEadyRMxq6XyjjVAK4TB3we6dcLZf3GVCQLSDEPM,Bp12mixLHgc3L6CvzqzsyV4GLMrmxGiydZE4buJwsHmr,True,79807172,15568427,58057,29028,29029,68sueyVfmy5ToEGtLFGDkwebX47xAmzyXE29z8JrmcWv,2976169,8156645,-5180476,372
2022-05-05 10:23:26-04:00,17531,Cb6MEn1MN9XQcVVd3o9J8QdK3cFWxSNETsFzhVJ8jmdh,A6yTKbggUftjbjAVu5YR1M7rg7h78ghbfofmTSnmKNGz,True,1013593497,253398374,1569651,784825,784826,AmTrMPzuTp2BjnjqGNKqz9FTTCdpoKcPAJLwFc8ozcbh,62786064,125259038,-62472974,619
2022-05-05 10:23:30-04:00,17532,4pVzpvQywzjV9y7vR4mR3J1vgurmHCPE4z2jDsJfvMdr,DcxzYh2P27r4ji6rV1BiSiDSYW1zQR7eFLYKA6U4s4RP,True,8938556371,2234639092,6734644,3367322,3367322,2a35JJeTUW1pm6M3e8DHCjp8qr4vbc2cRPhuzZWyFzYd,269385771,459309921,-189924150,301
2022-05-05 10:23:45-04:00,17533,H7rsFRRhZPe2jLex2NkbYYzVtLobvFiqnCd4BUyJVPBB,8bedwDRfSKLP9vUxoXcpHNJzWQemMaf4QGT2mtHFVJFb,True,1392243482,348060870,972838,486419,486419,5HnvdJnCCcmRsm4GkXnYWd4q9RpwuvYDGEUMPkYR3Ts9,38913546,109932575,-71019029,279
2022-05-05 10:23:50-04:00,17534,5xkW7wHTcF5WadNtBBqKPKctVwyQtTqqscivAmxzseCk,7m31ZMZdCn5Gz2q5sETWA7uKA5LsKD7pJHBBqU3g7tCn,True,1830421911,457605477,1386487,693243,693244,2py1FiYeL2f7J3HU36qiJz6TD6HCmiTN36RyxYtapQCZ,55459517,159838940,-104379423,302
2022-05-05 10:23:50-04:00,17535,DHfy6B2AYsqMCxPLBCXMDfQn3Gr2VwJaLFHUZKqpCjsb,EPZpYaY1gCAb8pMtri5veRowBmCrCpTHBMa3Rmgt6S29,False,29846554,29846554,892619,44630,847989,C4UnXuShCvjSMgBAgVNMy1oakxCNk1et27A82fywU112,892619,2651122,-1758503,299
2022-05-05 10:23:51-04:00,17536,3CxwyEadyRMxq6XyjjVAK4TB3we6dcLZf3GVCQLSDEPM,Bp12mixLHgc3L6CvzqzsyV4GLMrmxGiydZE4buJwsHmr,True,63805782,11602185,45188,22594,22594,2a35JJeTUW1pm6M3e8DHCjp8qr4vbc2cRPhuzZWyFzYd,2485149,6841827,-4356678,389
2022-05-05 10:40:25-04:00,17537,Hgs1Lk2ESxULpgcbgayhLdHSDyw5Yr6RiNYhP8q9CHwC,42prjFMA3G8DGZxkgXRDupGkz9GFSxB2mu1ccnEqPhjv,True,595256274,148814068,450804,225402,225402,3zqXX6kzhkbW3d4TwD2CNjMRwxTbREXySekvq37kfCNk,18032191,50477816,-32445625,302
2022-05-05 10:40:29-04:00,17538,DLwEaZipqHmVBD5hc5v1NZtDStHyG4hAMwxywDTGGc2e,28GtwJw67UWfrSKxtuvpzoKzPyKXLgP3GKLm3fHdR566,True,12197499897,3049374974,18850842,9425421,9425421,6UQfSsLooL4pQKQfLtXCutQS2BnF7A7F7ewJopDLmUpc,754033719,1148168545,-394134826,618
2022-05-05 10:41:53-04:00,17539,4pVzpvQywzjV9y7vR4mR3J1vgurmHCPE4z2jDsJfvMdr,DcxzYh2P27r4ji6rV1BiSiDSYW1zQR7eFLYKA6U4s4RP,True,6640184413,1660046103,4972956,2486478,2486478,3zqXX6kzhkbW3d4TwD2CNjMRwxTbREXySekvq37kfCNk,198918261,406060386,-207142125,299
2022-05-05 10:42:14-04:00,17540,Fbkv2mPSqXEAPZnuPHYYDRoshcC2a7eRvwPnSqK2sqv8,7Nha3zQkJsReUU1pzdNKHeSEb3a2xYExwAfr16cxQzRH,True,21462893733,5365723433,33515092,16757546,16757546,A9TwRM1BMxqb8DCC7YNAMV6zPenEJm3HTZBy7wJKK58U,1340603695,2305679453,-965075758,624
2022-05-05 10:43:08-04:00,17541,BaFWQSYQQikWywyGiHgG25hEons9nW5zhvUTzp8oAcYU,7WyiB5TBMB49ctd4cZBExSJyD51JMYnokScjSWixoPdk,True,46819143,4059621,26987,13493,13494,5HnvdJnCCcmRsm4GkXnYWd4q9RpwuvYDGEUMPkYR3Ts9,3112413,4942429,-1830016,664
2022-05-05 10:48:53-04:00,17542,3CxwyEadyRMxq6XyjjVAK4TB3we6dcLZf3GVCQLSDEPM,Bp12mixLHgc3L6CvzqzsyV4GLMrmxGiydZE4buJwsHmr,True,51884041,8670125,35433,17716,17717,2a35JJeTUW1pm6M3e8DHCjp8qr4vbc2cRPhuzZWyFzYd,2120405,5779918,-3659513,408
2022-05-05 10:53:32-04:00,17543,DHv4AsHMRZ6DuPaKEr2cLMNsX2ezT75T9haNgsDngS2b,5pMurvHHPdPKg3R96o1fKBbJh2Mc2tBP6P1e3acB31vQ,True,191038604,47759651,297888,148944,148944,68sueyVfmy5ToEGtLFGDkwebX47xAmzyXE29z8JrmcWv,11915556,19708895,-7793339,623
2022-05-05 10:59:02-04:00,17544,7tFD53kPTqrzjCu1Wji78gUqhoRtCUhsP1pM3DQKT7uG,BJvgPLYBDJrQJdQVowrsMwUGMurq4zTihoFwWoEokfu3,True,55680711004,9535278558,28876498,14438249,14438249,2xTUy2RS74GJMMDnmFaegMzFLn19RVfYG4CibhBmjP1i,1686226553,4209184849,-2522958296,302
2022-05-05 11:02:40-04:00,17545,Cb6MEn1MN9XQcVVd3o9J8QdK3cFWxSNETsFzhVJ8jmdh,A6yTKbggUftjbjAVu5YR1M7rg7h78ghbfofmTSnmKNGz,True,745035465,186258866,1149684,574842,574842,2py1FiYeL2f7J3HU36qiJz6TD6HCmiTN36RyxYtapQCZ,45987366,108038209,-62050843,617
2022-05-05 11:04:20-04:00,17546,4oMasDRj8HWfknmdwt6Mkz3eonr8J2byoiSTRo4sCnFQ,3emcATkEFvDVETiK97eVET2Z2jzkgiiSxX3gu5wsUKPe,True,75017833126,11463286459,75243165,37621582,37621583,A2p75MbAbeUdHkPLkAjgGeiwuu9WPrkMHzjCkDXF1Xr3,4924049717,12972795867,-8048746150,656
2022-05-05 11:04:31-04:00,17547,BaFWQSYQQikWywyGiHgG25hEons9nW5zhvUTzp8oAcYU,7WyiB5TBMB49ctd4cZBExSJyD51JMYnokScjSWixoPdk,True,42286500,3007102,19925,9962,9963,2a35JJeTUW1pm6M3e8DHCjp8qr4vbc2cRPhuzZWyFzYd,2802016,4824977,-2022961,662
2022-05-05 11:05:14-04:00,17548,3CxwyEadyRMxq6XyjjVAK4TB3we6dcLZf3GVCQLSDEPM,Bp12mixLHgc3L6CvzqzsyV4GLMrmxGiydZE4buJwsHmr,True,42954077,6467458,27457,13728,13729,Hu94aiQWvce6THeGyCFqGRPM1pQrK3ihzkcXo1EpJcJL,1823632,4948921,-3125289,424
2022-05-05 11:05:29-04:00,17549,4pVzpvQywzjV9y7vR4mR3J1vgurmHCPE4z2jDsJfvMdr,DcxzYh2P27r4ji6rV1BiSiDSYW1zQR7eFLYKA6U4s4RP,True,4934314795,1233578698,3693631,1846815,1846816,GXyFXZMNk2NFyEzw6JetVqsujqcz2yCixH7n8EpDJYWD,147745267,349466378,-201721111,299
2022-05-05 11:06:20-04:00,17550,5xkW7wHTcF5WadNtBBqKPKctVwyQtTqqscivAmxzseCk,7m31ZMZdCn5Gz2q5sETWA7uKA5LsKD7pJHBBqU3g7tCn,True,1359899959,339974989,1027885,513942,513943,AmTrMPzuTp2BjnjqGNKqz9FTTCdpoKcPAJLwFc8ozcbh,41115411,132345164,-91229753,302
2022-05-05 11:07:05-04:00,17551,7DTi299NL6owDJEkjWY6SZX6MhLB72oU1xr9d5DPUzZp,F8YWvNb45pdhgkfCtrFiPNeS4rtjkjTkBkvL5EoPzYXM,True,373770271,93442567,664971,332485,332486,68sueyVfmy5ToEGtLFGDkwebX47xAmzyXE29z8JrmcWv,26598859,47255211,-20656352,711
2022-05-05 11:07:12-04:00,17552,Cb6MEn1MN9XQcVVd3o9J8QdK3cFWxSNETsFzhVJ8jmdh,A6yTKbggUftjbjAVu5YR1M7rg7h78ghbfofmTSnmKNGz,True,547604754,136901188,841645,420822,420823,72XWPCtRYEDZbddP7d6dHtUBRRDLSJsB2xZTAfefoEVZ,33665837,91396116,-57730279,614
2022-05-05 11:07:14-04:00,17553,BaFWQSYQQikWywyGiHgG25hEons9nW5zhvUTzp8oAcYU,7WyiB5TBMB49ctd4cZBExSJyD51JMYnokScjSWixoPdk,True,38965717,3060322,19735,9867,9868,Hu94aiQWvce6THeGyCFqGRPM1pQrK3ihzkcXo1EpJcJL,2512818,4701052,-2188234,644
2022-05-05 11:07:17-04:00,17554,7tFD53kPTqrzjCu1Wji78gUqhoRtCUhsP1pM3DQKT7uG,BJvgPLYBDJrQJdQVowrsMwUGMurq4zTihoFwWoEokfu3,True,45880425825,7110672977,21536959,10768479,10768480,2a35JJeTUW1pm6M3e8DHCjp8qr4vbc2cRPhuzZWyFzYd,1389636238,3789627963,-2399991725,302
2022-05-05 11:07:24-04:00,17555,Hgs1Lk2ESxULpgcbgayhLdHSDyw5Yr6RiNYhP8q9CHwC,42prjFMA3G8DGZxkgXRDupGkz9GFSxB2mu1ccnEqPhjv,True,441951047,110487761,326920,163460,163460,2a35JJeTUW1pm6M3e8DHCjp8qr4vbc2cRPhuzZWyFzYd,13076832,41905241,-28828409,295
2022-05-05 11:07:25-04:00,17556,4oMasDRj8HWfknmdwt6Mkz3eonr8J2byoiSTRo4sCnFQ,3emcATkEFvDVETiK97eVET2Z2jzkgiiSxX3gu5wsUKPe,True,62865885005,8547822766,56565148,28282574,28282574,2py1FiYeL2f7J3HU36qiJz6TD6HCmiTN36RyxYtapQCZ,4160144890,11639999156,-7479854266,661
2022-05-05 11:07:26-04:00,17557,3CxwyEadyRMxq6XyjjVAK4TB3we6dcLZf3GVCQLSDEPM,Bp12mixLHgc3L6CvzqzsyV4GLMrmxGiydZE4buJwsHmr,True,36338276,2824412,12807,6403,6404,Hu94aiQWvce6THeGyCFqGRPM1pQrK3ihzkcXo1EpJcJL,1647832,4290777,-2642945,453
2022-05-05 11:08:10-04:00,17558,Hgs1Lk2ESxULpgcbgayhLdHSDyw5Yr6RiNYhP8q9CHwC,42prjFMA3G8DGZxkgXRDupGkz9GFSxB2mu1ccnEqPhjv,True,328183523,82045880,236753,118376,118377,C4UnXuShCvjSMgBAgVNMy1oakxCNk1et27A82fywU112,9470149,34372916,-24902767,288
2022-05-05 11:08:10-04:00,17559,7tFD53kPTqrzjCu1Wji78gUqhoRtCUhsP1pM3DQKT7uG,BJvgPLYBDJrQJdQVowrsMwUGMurq4zTihoFwWoEokfu3,True,38498577320,5312549346,15136822,7568411,7568411,C4UnXuShCvjSMgBAgVNMy1oakxCNk1et27A82fywU112,1096923751,3428388312,-2331464561,284
2022-05-05 11:08:16-04:00,17560,3CxwyEadyRMxq6XyjjVAK4TB3we6dcLZf3GVCQLSDEPM,Bp12mixLHgc3L6CvzqzsyV4GLMrmxGiydZE4buJwsHmr,True,33271301,4791889,20054,10027,10027,YQC4EUcgeBi9431viwvzvBbZJW3szeHX4dFmowRDyDw,1392462,4179928,-2787466,418
2022-05-05 11:08:18-04:00,17561,5xkW7wHTcF5WadNtBBqKPKctVwyQtTqqscivAmxzseCk,7m31ZMZdCn5Gz2q5sETWA7uKA5LsKD7pJHBBqU3g7tCn,True,1006046693,251511673,655231,327615,327616,C4UnXuShCvjSMgBAgVNMy1oakxCNk1et27A82fywU112,26209249,108525915,-82316666,260
2022-05-05 11:08:18-04:00,17562,4oMasDRj8HWfknmdwt6Mkz3eonr8J2byoiSTRo4sCnFQ,3emcATkEFvDVETiK97eVET2Z2jzkgiiSxX3gu5wsUKPe,True,53622807221,7029170508,44678182,22339091,22339091,YQC4EUcgeBi9431viwvzvBbZJW3szeHX4dFmowRDyDw,3408324724,10583502271,-7175177547,635
2022-05-05 11:08:21-04:00,17563,7tFD53kPTqrzjCu1Wji78gUqhoRtCUhsP1pM3DQKT7uG,BJvgPLYBDJrQJdQVowrsMwUGMurq4zTihoFwWoEokfu3,True,33106429740,4291835756,12992126,6496063,6496063,2py1FiYeL2f7J3HU36qiJz6TD6HCmiTN36RyxYtapQCZ,1002188695,3133566440,-2131377745,302
2022-05-05 11:08:21-04:00,17564,HqtTbC1LFreGvgfpZe7nCqkNnh8GHPQKosfmc19zb1yi,E39UNiHNkwQEd5GXkCtTPqSorQSB1kLx8kjzK4jdFoi3,True,3682928821,920732205,1977297,988648,988649,3zqXX6kzhkbW3d4TwD2CNjMRwxTbREXySekvq37kfCNk,79091893,395825648,-316733755,214
2022-05-05 11:08:23-04:00,17565,HqtTbC1LFreGvgfpZe7nCqkNnh8GHPQKosfmc19zb1yi,E39UNiHNkwQEd5GXkCtTPqSorQSB1kLx8kjzK4jdFoi3,True,2762196616,690549154,1927864,963932,963932,2py1FiYeL2f7J3HU36qiJz6TD6HCmiTN36RyxYtapQCZ,77114596,314785920,-237671324,279
2022-05-05 11:08:23-04:00,17566,DLwEaZipqHmVBD5hc5v1NZtDStHyG4hAMwxywDTGGc2e,28GtwJw67UWfrSKxtuvpzoKzPyKXLgP3GKLm3fHdR566,True,8968958562,2242239640,13901251,6950625,6950626,68sueyVfmy5ToEGtLFGDkwebX47xAmzyXE29z8JrmcWv,556050061,1031880978,-475830917,619
2022-05-05 11:08:26-04:00,17567,5xkW7wHTcF5WadNtBBqKPKctVwyQtTqqscivAmxzseCk,7m31ZMZdCn5Gz2q5sETWA7uKA5LsKD7pJHBBqU3g7tCn,True,751634346,187908586,566333,283166,283167,68sueyVfmy5ToEGtLFGDkwebX47xAmzyXE29z8JrmcWv,22653344,87300498,-64647154,301
2022-05-05 11:08:26-04:00,17568,7tFD53kPTqrzjCu1Wji78gUqhoRtCUhsP1pM3DQKT7uG,BJvgPLYBDJrQJdQVowrsMwUGMurq4zTihoFwWoEokfu3,True,28520849012,7130212252,17386288,8693144,8693144,GXyFXZMNk2NFyEzw6JetVqsujqcz2yCixH7n8EpDJYWD,695451597,2805444274,-2109992677,243
2022-05-05 11:08:28-04:00,17569,Gf5g7HMy73aPnXXvgQZEiBArL7wXzx7TpivmMRDU8RJS,8ok76N32AxEocuGo7RqeZJ9a45MezH6L1My16N9UfkdA,True,22725688346,3217840631,14025111,7012555,7012556,2py1FiYeL2f7J3HU36qiJz6TD6HCmiTN36RyxYtapQCZ,990509967,3324615192,-2334105225,435
2022-05-05 11:08:28-04:00,17570,3CxwyEadyRMxq6XyjjVAK4TB3we6dcLZf3GVCQLSDEPM,Bp12mixLHgc3L6CvzqzsyV4GLMrmxGiydZE4buJwsHmr,True,28370831,2107814,9389,4694,4695,Hu94aiQWvce6THeGyCFqGRPM1pQrK3ihzkcXo1EpJcJL,1263827,3628151,-2364324,445
2022-05-05 11:08:28-04:00,17571,4pVzpvQywzjV9y7vR4mR3J1vgurmHCPE4z2jDsJfvMdr,DcxzYh2P27r4ji6rV1BiSiDSYW1zQR7eFLYKA6U4s4RP,False,3605443957,3605443957,48759496,2437974,46321522,3zqXX6kzhkbW3d4TwD2CNjMRwxTbREXySekvq37kfCNk,48759496,295645436,-246885940,135
2022-05-05 11:08:29-04:00,17572,A5NXadGWnFZRoHEn1dKTRjcXgWmfMLMyJdpF4rQPZyRR,ALs3Zfotc4c4A6TFDMbd5GM5whK1dTYSnGrHiMBWmApH,True,9381220274,2345305068,14621716,7310858,7310858,68sueyVfmy5ToEGtLFGDkwebX47xAmzyXE29z8JrmcWv,584868645,1203651867,-618783222,623
2022-05-05 11:08:31-04:00,17573,HKrsoo3kUwwYou6vQAjrCccyWvTFm2Wy14hwBxofoV1p,6k2SbUiTFKi8EhZWSbNffGqofwBvr4y2HZsLkGgfq2iX,False,1239251704,1239251704,17923092,896154,17026938,AmTrMPzuTp2BjnjqGNKqz9FTTCdpoKcPAJLwFc8ozcbh,17923092,166464036,-148540944,144
2022-05-05 11:08:32-04:00,17574,6pAs5S7zGX77DHSYUuCxvxbf2FQQHQhbBmAYLd3iJvWS,HNTWEhsrnEe8FeVDpEcxuoD5PnuveB5BwSf3gdBmhzxv,True,265308965,66327241,168265,84132,84133,3zqXX6kzhkbW3d4TwD2CNjMRwxTbREXySekvq37kfCNk,6730639,31583069,-24852430,253
2022-05-05 11:08:35-04:00,17575,F3Hq5hKQ7mh2PiaMDtqTd1xPrGCUszajivFu1pBqvsbk,6pjiEFs1jM2SvY5MCHpESPKg8EmUSPUSvEr19Z1WFy3X,False,35127402,35127402,442243,22112,420131,2a35JJeTUW1pm6M3e8DHCjp8qr4vbc2cRPhuzZWyFzYd,442243,3453098,-3010855,125
2022-05-05 11:08:36-04:00,17576,8Xt3qHjZG3zLxozgM5vPHMVxp8eYFMg89kaVW7vdHKoA,2i8riSsQpfADD9LUVpiBJBfX5qjVAgmZegzfKx6RG9dW,False,9193896,9193896,305173,15258,289915,2a35JJeTUW1pm6M3e8DHCjp8qr4vbc2cRPhuzZWyFzYd,305174,4823992,-4518818,331
2022-05-05 11:08:37-04:00,17577,9qGz5Mh1XNUXqY1vEg5S1ZEMzPFvBLRbp1qaXwxSFMby,D8KnbVXStSUz3QhZGzY5o853ASocjkyu9x682oHgVoZh,True,103809377377,18414784701,61828398,30914199,30914199,2py1FiYeL2f7J3HU36qiJz6TD6HCmiTN36RyxYtapQCZ,3485442614,16585622224,-13100179610,335
2022-05-05 11:08:37-04:00,17578,2ssYxbmFPYBdse9a6NJ26M8hsscYpjv5MyqyYkjftdrL,FKvvXz9eYXW2zgy37eaUW9u2K9LnnDsNx3DcgtATpizY,False,22740816,22740816,632540,31627,600913,Hu94aiQWvce6THeGyCFqGRPM1pQrK3ihzkcXo1EpJcJL,632540,6928917,-6296377,278
2022-05-05 11:08:38-04:00,17579,7tFD53kPTqrzjCu1Wji78gUqhoRtCUhsP1pM3DQKT7uG,BJvgPLYBDJrQJdQVowrsMwUGMurq4zTihoFwWoEokfu3,True,21338467086,2922769230,8573007,4286503,4286504,Hu94aiQWvce6THeGyCFqGRPM1pQrK3ihzkcXo1EpJcJL,625895635,2265207530,-1639311895,293
2022-05-05 11:08:38-04:00,17580,FRbeFwhUYCiHW5oP26mad8KND7CCYDbfnoNxX7GuXVp8,GrzXKxPX2WDka8i2D8sunMUsrsThKasQi8NYLwuCGygV,True,5597050671,529450903,2127653,1063826,1063827,3zqXX6kzhkbW3d4TwD2CNjMRwxTbREXySekvq37kfCNk,224923291,1607276040,-1382352749,401
2022-05-05 11:08:42-04:00,17581,kn4CMFEGiFu6Sw8v7GAZaBNHKe5Mst4Bj2kds1B6Daw,4FAjghUCswqbD6SKVr7Mu9aLcSLxDofiBvxgkZeiVz32,True,44400977,11100243,28828,14414,14414,C4UnXuShCvjSMgBAgVNMy1oakxCNk1et27A82fywU112,1153181,7012298,-5859117,259
2022-05-05 11:08:42-04:00,17582,7zDNgPFeomS1hdQhuY8iGF3nnGMNnx1YrinZJetrefje,AKyG5R6Bac6Fu83ruL9FGpjKCfDKxbP6QfEGbCgqegiV,True,62411402,15376405,41928,20964,20964,3zqXX6kzhkbW3d4TwD2CNjMRwxTbREXySekvq37kfCNk,1701873,7946149,-6244276,272
2022-05-05 11:08:42-04:00,17583,AL8JFS4gjaQx89f9j8wtaNJgV76K8bw1ugvNtgvhgAnb,HJYvG2kGKe8kXgtZSWTWwTmSjxA3XUeCvyT7acoKtS1C,True,125933202350,22941961285,66613177,33306588,33306589,3zqXX6kzhkbW3d4TwD2CNjMRwxTbREXySekvq37kfCNk,3656536014,18946343908,-15289807894,290
2022-05-05 11:08:42-04:00,17584,GPeALajYLrgVJgYb65PQUkFJxzeh4APUesZjy77sMy9j,Hnmv48N2jFXN2TYmyPxTsZf9JtnRoz2PfMEzL67UigXx,True,50677211,12669302,32803,16401,16402,Hu94aiQWvce6THeGyCFqGRPM1pQrK3ihzkcXo1EpJcJL,1312124,9180542,-7868418,258
2022-05-05 11:08:44-04:00,17585,6pAs5S7zGX77DHSYUuCxvxbf2FQQHQhbBmAYLd3iJvWS,HNTWEhsrnEe8FeVDpEcxuoD5PnuveB5BwSf3gdBmhzxv,True,197949895,49487473,138263,69131,69132,68sueyVfmy5ToEGtLFGDkwebX47xAmzyXE29z8JrmcWv,5530545,25202630,-19672085,279
2022-05-05 11:08:45-04:00,17586,68gVM4kjmSYxT1uJW13rYSway8uVLUdcLa7sJuqHQaAf,DshroBQ3da7BcAiQpiFREsLKWbUDrBRmmZRw3Zu2Qfs9,True,10550512239,2637628059,6850139,3425069,3425070,72XWPCtRYEDZbddP7d6dHtUBRRDLSJsB2xZTAfefoEVZ,274005588,1239461948,-965456360,259
2022-05-05 11:08:45-04:00,17587,7frvVhg1eWJpsvG7ndjppb8Bmd1tFq5H1g26UiKZxqTP,3Ugo9b53e6e8PLnvKjqRP8pvvoubSPV6qiKtxey7mrGt,True,268358510,67089627,198820,99410,99410,72XWPCtRYEDZbddP7d6dHtUBRRDLSJsB2xZTAfefoEVZ,7952836,68367503,-60414667,296
2022-05-05 11:08:49-04:00,17588,9RtNbEZ4ZR8T1HFF4cujPVy2kejVBKFo3CPQi8psSa1q,7zwaGb71jKc9y2HKCKy5q2XV2YUphkyU1hkDaab1GBas,True,1553574366,386250427,1002395,501197,501198,AmTrMPzuTp2BjnjqGNKqz9FTTCdpoKcPAJLwFc8ozcbh,40318316,443267625,-402949309,259
2022-05-05 11:08:49-04:00,17589,6K1Xww22wVZuBwP6oYb3DPR5GvdxsQSiZ4WSmejQjyqf,8RoFHjv1TkGFqjKoSwzvyRNMoBP1ma1Hi2jy6FzD4i2g,False,34400814,34400814,787554,39377,748177,Hu94aiQWvce6THeGyCFqGRPM1pQrK3ihzkcXo1EpJcJL,787555,8345342,-7557787,228
2022-05-05 11:08:55-04:00,17590,DHv4AsHMRZ6DuPaKEr2cLMNsX2ezT75T9haNgsDngS2b,5pMurvHHPdPKg3R96o1fKBbJh2Mc2tBP6P1e3acB31vQ,True,140346160,35086540,217135,108567,108568,2a35JJeTUW1pm6M3e8DHCjp8qr4vbc2cRPhuzZWyFzYd,8685402,17463463,-8778061,618
2022-05-05 11:09:13-04:00,17591,Fbkv2mPSqXEAPZnuPHYYDRoshcC2a7eRvwPnSqK2sqv8,7Nha3zQkJsReUU1pzdNKHeSEb3a2xYExwAfr16cxQzRH,True,15771229998,3942807499,24516777,12258388,12258389,2py1FiYeL2f7J3HU36qiJz6TD6HCmiTN36RyxYtapQCZ,980671080,2041264295,-1060593215,621
2022-05-05 11:09:19-04:00,17592,BaFWQSYQQikWywyGiHgG25hEons9nW5zhvUTzp8oAcYU,7WyiB5TBMB49ctd4cZBExSJyD51JMYnokScjSWixoPdk,True,35520637,2897094,19048,9524,9524,68sueyVfmy5ToEGtLFGDkwebX47xAmzyXE29z8JrmcWv,2335451,4379167,-2043716,657
2022-05-05 11:09:25-04:00,17593,HHzMh5pytrUg1LhF8KK3ZLkkANS7TNpeyWavY346J6t9,3cuU35DA5xPy7TfMtBmCn3sMHm6DGsZCUuf2jWkcVyFK,True,1648251236,229207160,1422065,711032,711033,2a35JJeTUW1pm6M3e8DHCjp8qr4vbc2cRPhuzZWyFzYd,102262185,229038662,-126776477,620
2022-05-05 11:09:59-04:00,17594,BaFWQSYQQikWywyGiHgG25hEons9nW5zhvUTzp8oAcYU,7WyiB5TBMB49ctd4cZBExSJyD51JMYnokScjSWixoPdk,True,32446756,2221823,14513,7256,7257,5HnvdJnCCcmRsm4GkXnYWd4q9RpwuvYDGEUMPkYR3Ts9,2119564,4054540,-1934976,653
2022-05-05 11:10:03-04:00,17595,Cb6MEn1MN9XQcVVd3o9J8QdK3cFWxSNETsFzhVJ8jmdh,A6yTKbggUftjbjAVu5YR1M7rg7h78ghbfofmTSnmKNGz,True,402877324,100719331,624948,312474,312474,AmTrMPzuTp2BjnjqGNKqz9FTTCdpoKcPAJLwFc8ozcbh,24997950,76133207,-51135257,620
2022-05-05 11:22:31-04:00,17596,CeoZ82imadaXaJHLw597HxGfaHvefRtAErFLLtcpEYe3,C7Rf33dms1PLrASt1nPWqFiiaX7ZBq76h8RS3JMTR6yX,True,29300289,4003425,26681,13340,13341,68sueyVfmy5ToEGtLFGDkwebX47xAmzyXE29z8JrmcWv,1952835,7784020,-5831185,666
2022-05-05 11:22:37-04:00,17597,CeoZ82imadaXaJHLw597HxGfaHvefRtAErFLLtcpEYe3,C7Rf33dms1PLrASt1nPWqFiiaX7ZBq76h8RS3JMTR6yX,True,25128352,3320789,23227,11613,11614,68sueyVfmy5ToEGtLFGDkwebX47xAmzyXE29z8JrmcWv,1757642,6606249,-4848607,699
2022-05-05 11:22:40-04:00,17598,26wo1RqwKXrNnfgMdZEmkGhnDbURpZcp2hasB5EA5QtD,34gwTVGRrdoaBzLUG6SBwRwBovkjBjCebqVUBan6GDnB,True,30417364161,7604341040,53611743,26805871,26805872,AmTrMPzuTp2BjnjqGNKqz9FTTCdpoKcPAJLwFc8ozcbh,2144469729,10186988957,-8042519228,705
2022-05-05 11:22:46-04:00,17599,DZnaFtxiEHUv3geRGsKufTnCUhkSMbN2M7W4Bwu2LgkM,A38xXBMxA13qQnVB1tcd5USxpfdaUGmkp31FeTmCyb52,True,184034319,24889879,176002,88001,88001,72XWPCtRYEDZbddP7d6dHtUBRRDLSJsB2xZTAfefoEVZ,13013538,77653158,-64639620,707
2022-05-05 11:22:54-04:00,17600,BaFWQSYQQikWywyGiHgG25hEons9nW5zhvUTzp8oAcYU,7WyiB5TBMB49ctd4cZBExSJyD51JMYnokScjSWixoPdk,True,30185785,2271526,14916,7458,7458,Hu94aiQWvce6THeGyCFqGRPM1pQrK3ihzkcXo1EpJcJL,1982271,3928519,-1946248,656
2022-05-05 11:23:53-04:00,17601,26wo1RqwKXrNnfgMdZEmkGhnDbURpZcp2hasB5EA5QtD,34gwTVGRrdoaBzLUG6SBwRwBovkjBjCebqVUBan6GDnB,True,22274910303,5568727575,38818629,19409314,19409315,YQC4EUcgeBi9431viwvzvBbZJW3szeHX4dFmowRDyDw,1552745168,8195639051,-6642893883,697
2022-05-05 11:23:53-04:00,17602,DZnaFtxiEHUv3geRGsKufTnCUhkSMbN2M7W4Bwu2LgkM,A38xXBMxA13qQnVB1tcd5USxpfdaUGmkp31FeTmCyb52,True,156323949,20951889,134257,67128,67129,YQC4EUcgeBi9431viwvzvBbZJW3szeHX4dFmowRDyDw,10017045,72673931,-62656886,640
2022-05-05 11:23:54-04:00,17603,CeoZ82imadaXaJHLw597HxGfaHvefRtAErFLLtcpEYe3,C7Rf33dms1PLrASt1nPWqFiiaX7ZBq76h8RS3JMTR6yX,True,21408353,5352088,33379,16689,16690,C4UnXuShCvjSMgBAgVNMy1oakxCNk1et27A82fywU112,1335205,6275495,-4940290,623
2022-05-05 11:24:02-04:00,17604,BaFWQSYQQikWywyGiHgG25hEons9nW5zhvUTzp8oAcYU,7WyiB5TBMB49ctd4cZBExSJyD51JMYnokScjSWixoPdk,True,27749014,2179793,14370,7185,7185,68sueyVfmy5ToEGtLFGDkwebX47xAmzyXE29z8JrmcWv,1829360,3663274,-1833914,659
2022-05-05 11:25:51-04:00,17605,3CxwyEadyRMxq6XyjjVAK4TB3we6dcLZf3GVCQLSDEPM,Bp12mixLHgc3L6CvzqzsyV4GLMrmxGiydZE4buJwsHmr,True,26177837,3588222,16026,8013,8013,68sueyVfmy5ToEGtLFGDkwebX47xAmzyXE29z8JrmcWv,1169258,3534734,-2365476,446
2022-05-05 11:26:21-04:00,17606,DZnaFtxiEHUv3geRGsKufTnCUhkSMbN2M7W4Bwu2LgkM,A38xXBMxA13qQnVB1tcd5USxpfdaUGmkp31FeTmCyb52,True,134866145,18195385,126507,63253,63254,Hu94aiQWvce6THeGyCFqGRPM1pQrK3ihzkcXo1EpJcJL,9376873,61017850,-51640977,695
2022-05-05 11:27:26-04:00,17607,5tW54mXQxtM7vGc91HrDeDtWkxJeH2uM4yAviqZnMZCN,7Kg5Zwx5afFdLbTifeyKJLSNVj2p9Xf5anbbqQozNzmY,True,1502238173,189876230,1186345,593172,593173,A2p75MbAbeUdHkPLkAjgGeiwuu9WPrkMHzjCkDXF1Xr3,93859751,159530281,-65670530,624
2022-05-05 11:28:47-04:00,17608,3CxwyEadyRMxq6XyjjVAK4TB3we6dcLZf3GVCQLSDEPM,Bp12mixLHgc3L6CvzqzsyV4GLMrmxGiydZE4buJwsHmr,True,22490968,1551942,7276,3638,3638,Hu94aiQWvce6THeGyCFqGRPM1pQrK3ihzkcXo1EpJcJL,1054585,3114219,-2059634,468
2022-05-05 11:29:10-04:00,17609,BaFWQSYQQikWywyGiHgG25hEons9nW5zhvUTzp8oAcYU,7WyiB5TBMB49ctd4cZBExSJyD51JMYnokScjSWixoPdk,True,25249040,1545705,10292,5146,5146,Hu94aiQWvce6THeGyCFqGRPM1pQrK3ihzkcXo1EpJcJL,1681303,3426690,-1745387,665
2022-05-05 11:29:16-04:00,17610,CeoZ82imadaXaJHLw597HxGfaHvefRtAErFLLtcpEYe3,C7Rf33dms1PLrASt1nPWqFiiaX7ZBq76h8RS3JMTR6yX,True,15851094,2106248,14571,7285,7286,2a35JJeTUW1pm6M3e8DHCjp8qr4vbc2cRPhuzZWyFzYd,1096655,5007065,-3910410,691
2022-05-05 11:29:19-04:00,17611,DZnaFtxiEHUv3geRGsKufTnCUhkSMbN2M7W4Bwu2LgkM,A38xXBMxA13qQnVB1tcd5USxpfdaUGmkp31FeTmCyb52,True,115019227,15430822,101944,50972,50972,C4UnXuShCvjSMgBAgVNMy1oakxCNk1et27A82fywU112,7598833,56816572,-49217739,660
2022-05-05 11:29:40-04:00,17612,4oMasDRj8HWfknmdwt6Mkz3eonr8J2byoiSTRo4sCnFQ,3emcATkEFvDVETiK97eVET2Z2jzkgiiSxX3gu5wsUKPe,True,46296032707,6339538980,41984798,20992399,20992399,GXyFXZMNk2NFyEzw6JetVqsujqcz2yCixH7n8EpDJYWD,3066042536,9615963927,-6549921391,662
2022-05-05 11:29:56-04:00,17613,26wo1RqwKXrNnfgMdZEmkGhnDbURpZcp2hasB5EA5QtD,34gwTVGRrdoaBzLUG6SBwRwBovkjBjCebqVUBan6GDnB,True,16342094693,4085523673,28745962,14372981,14372981,AmTrMPzuTp2BjnjqGNKqz9FTTCdpoKcPAJLwFc8ozcbh,1149838504,6536792477,-5386953973,703
2022-05-05 11:29:59-04:00,17614,DZnaFtxiEHUv3geRGsKufTnCUhkSMbN2M7W4Bwu2LgkM,A38xXBMxA13qQnVB1tcd5USxpfdaUGmkp31FeTmCyb52,True,98869080,13262844,90917,45458,45459,C4UnXuShCvjSMgBAgVNMy1oakxCNk1et27A82fywU112,6777564,47789754,-41012190,685
2022-05-05 11:31:45-04:00,17615,BaFWQSYQQikWywyGiHgG25hEons9nW5zhvUTzp8oAcYU,7WyiB5TBMB49ctd4cZBExSJyD51JMYnokScjSWixoPdk,True,23608543,1680853,11113,5556,5557,2a35JJeTUW1pm6M3e8DHCjp8qr4vbc2cRPhuzZWyFzYd,1561003,3212103,-1651100,661
2022-05-05 11:45:58-04:00,17616,7DTi299NL6owDJEkjWY6SZX6MhLB72oU1xr9d5DPUzZp,F8YWvNb45pdhgkfCtrFiPNeS4rtjkjTkBkvL5EoPzYXM,True,273892396,68473099,487464,243732,243732,68sueyVfmy5ToEGtLFGDkwebX47xAmzyXE29z8JrmcWv,19498580,41439966,-21941386,711
2022-05-05 11:49:45-04:00,17617,FRbeFwhUYCiHW5oP26mad8KND7CCYDbfnoNxX7GuXVp8,GrzXKxPX2WDka8i2D8sunMUsrsThKasQi8NYLwuCGygV,True,5045616807,869745636,3461537,1730768,1730769,C4UnXuShCvjSMgBAgVNMy1oakxCNk1et27A82fywU112,200812677,1442872072,-1242059395,397
2022-05-05 11:50:24-04:00,17618,CDVtXFbo4Rg2aHsXKv5P3uRJq9ZTgsRd7GXPTxgH5xv9,6zj37qQnaiJT7xGEZmSKx5yQvisQFcs5KhGsG43SGd5y,True,459469954,50240895,166032,83016,83016,3zqXX6kzhkbW3d4TwD2CNjMRwxTbREXySekvq37kfCNk,15184252,145197559,-130013307,330
2022-05-05 11:50:33-04:00,17619,Hgs1Lk2ESxULpgcbgayhLdHSDyw5Yr6RiNYhP8q9CHwC,42prjFMA3G8DGZxkgXRDupGkz9GFSxB2mu1ccnEqPhjv,True,244264202,61066050,183998,91999,91999,72XWPCtRYEDZbddP7d6dHtUBRRDLSJsB2xZTAfefoEVZ,7359955,27911421,-20551466,301
2022-05-05 11:50:34-04:00,17620,B6Wc3euMqUf6QjzCqDtNeAEUM7MvADFaiReEq9VYH2Qg,2pzhsqXYd5u7h4xTN8bMS3GbicVnJ6KY3MQn7spSXroA,True,45175944,6408698,19403,9701,9702,C4UnXuShCvjSMgBAgVNMy1oakxCNk1et27A82fywU112,1367778,12531644,-11163866,302
2022-05-05 11:50:36-04:00,17621,BhhVhLVZkSd3aHDMd6ojTgtJtbgAdMCA9Xj8jL2GMXoL,G8HUQp2yGSw9T6it5ej91cqkd82naca8heji453g2jEH,True,281361424,38489395,181968,90984,90984,6UQfSsLooL4pQKQfLtXCutQS2BnF7A7F7ewJopDLmUpc,13302157,103554155,-90251998,472
2022-05-05 11:50:59-04:00,17622,3CxwyEadyRMxq6XyjjVAK4TB3we6dcLZf3GVCQLSDEPM,Bp12mixLHgc3L6CvzqzsyV4GLMrmxGiydZE4buJwsHmr,False,20848092,20848092,956373,47818,908555,68sueyVfmy5ToEGtLFGDkwebX47xAmzyXE29z8JrmcWv,956375,3015002,-2058627,458
2022-05-05 11:52:18-04:00,17623,4oMasDRj8HWfknmdwt6Mkz3eonr8J2byoiSTRo4sCnFQ,3emcATkEFvDVETiK97eVET2Z2jzkgiiSxX3gu5wsUKPe,True,39538152915,5149271618,33935687,16967843,16967844,3zqXX6kzhkbW3d4TwD2CNjMRwxTbREXySekvq37kfCNk,2605716926,8748688568,-6142971642,659
2022-05-05 11:52:19-04:00,17624,HqtTbC1LFreGvgfpZe7nCqkNnh8GHPQKosfmc19zb1yi,E39UNiHNkwQEd5GXkCtTPqSorQSB1kLx8kjzK4jdFoi3,True,2057387197,514346799,1523161,761580,761581,2a35JJeTUW1pm6M3e8DHCjp8qr4vbc2cRPhuzZWyFzYd,60926467,253508297,-192581830,296
2022-05-05 11:52:19-04:00,17625,SEndYVMCKAeZUKSqGrMUSqXFmxtA9M1t4eXsUhVsTBF,3fcQQcbkpqodakamn82pFnMxBEPL2Drsg4jJNZ6dx72M,True,358529461,30421987,189591,94795,94796,2a35JJeTUW1pm6M3e8DHCjp8qr4vbc2cRPhuzZWyFzYd,22343796,54737178,-32393382,623
2022-05-05 11:52:20-04:00,17626,DZnaFtxiEHUv3geRGsKufTnCUhkSMbN2M7W4Bwu2LgkM,A38xXBMxA13qQnVB1tcd5USxpfdaUGmkp31FeTmCyb52,True,84953126,11315224,80362,40181,40181,C4UnXuShCvjSMgBAgVNMy1oakxCNk1et27A82fywU112,6033537,44258882,-38225345,710
2022-05-05 11:52:24-04:00,17627,CDVtXFbo4Rg2aHsXKv5P3uRJq9ZTgsRd7GXPTxgH5xv9,6zj37qQnaiJT7xGEZmSKx5yQvisQFcs5KhGsG43SGd5y,True,407861668,44496817,148927,74463,74464,2a35JJeTUW1pm6M3e8DHCjp8qr4vbc2cRPhuzZWyFzYd,13650829,133526819,-119875990,334
2022-05-05 11:52:29-04:00,17628,AggAFLRnGWU7X97a3sWRKV7wDDRiAGn9Q4azmEYXAo1k,Dj4DzvpxgQiRoad1zTXoNTrgGTDHG9NvMeCzzRZSxkvs,True,516092942,86972236,353094,176547,176547,2a35JJeTUW1pm6M3e8DHCjp8qr4vbc2cRPhuzZWyFzYd,20952664,95154966,-74202302,405
2022-05-05 11:52:34-04:00,17629,HEFpdWLZaiQnjftmXgxs6RNzhH72YiMjortxPkKekkvb,5Q8mmxBgVTijNGrWsnoA3VMArLHZEX5MkaigYXHpgXHE,False,252611,252611,10710,535,10175,68sueyVfmy5ToEGtLFGDkwebX47xAmzyXE29z8JrmcWv,10711,171254,-160543,424
2022-05-05 11:52:35-04:00,17630,4PZZxNrWLhNCuT5VJ1DQe3XxQVVwMPrjfUpdeAY8qS7U,A7CvKre7y5VbUN1HneNHmuBv7jWtayV78oozAqaVbQrv,False,25391536,25391536,738782,36939,701843,C4UnXuShCvjSMgBAgVNMy1oakxCNk1et27A82fywU112,738782,12555198,-11816416,290
2022-05-05 11:52:36-04:00,17631,7tFD53kPTqrzjCu1Wji78gUqhoRtCUhsP1pM3DQKT7uG,BJvgPLYBDJrQJdQVowrsMwUGMurq4zTihoFwWoEokfu3,True,18351921563,2389863963,7208511,3604255,3604256,6UQfSsLooL4pQKQfLtXCutQS2BnF7A7F7ewJopDLmUpc,553546335,2030481686,-1476935351,301
2022-05-05 11:52:36-04:00,17632,5xkW7wHTcF5WadNtBBqKPKctVwyQtTqqscivAmxzseCk,7m31ZMZdCn5Gz2q5sETWA7uKA5LsKD7pJHBBqU3g7tCn,True,558153988,139538497,412880,206440,206440,68sueyVfmy5ToEGtLFGDkwebX47xAmzyXE29z8JrmcWv,16515239,70577419,-54062180,295
2022-05-05 11:52:38-04:00,17633,BmFSXZx3HWaTtD7vp7AkUk5DUNjwK1qgLPod13EJz6No,DtLMfV3Xs7AAAQqC1PwL7YAfV6fig8yAMxr9MMxmyCKc,True,228825284,57206321,172817,86408,86409,C4UnXuShCvjSMgBAgVNMy1oakxCNk1et27A82fywU112,6912690,24973998,-18061308,302
2022-05-05 11:52:39-04:00,17634,B6Wc3euMqUf6QjzCqDtNeAEUM7MvADFaiReEq9VYH2Qg,2pzhsqXYd5u7h4xTN8bMS3GbicVnJ6KY3MQn7spSXroA,True,38586015,4878506,14756,7378,7378,C4UnXuShCvjSMgBAgVNMy1oakxCNk1et27A82fywU112,1167144,10856548,-9689404,302
2022-05-05 11:52:56-04:00,17635,CeoZ82imadaXaJHLw597HxGfaHvefRtAErFLLtcpEYe3,C7Rf33dms1PLrASt1nPWqFiiaX7ZBq76h8RS3JMTR6yX,False,13634369,13634369,971606,48580,923026,68sueyVfmy5ToEGtLFGDkwebX47xAmzyXE29z8JrmcWv,971607,4199316,-3227709,712
2022-05-05 11:53:00-04:00,17636,FtF3PVw8YNJseWPMcA2GEuQZ6nni1mq5kYPa2LrSzfkW,4yr1TM2dXrBvLNMpSaoryuGU2P8D3WG1ZCkvVzWFiQRH,True,24390385,1157683,5333,2666,2667,C4UnXuShCvjSMgBAgVNMy1oakxCNk1et27A82fywU112,1123793,14090108,-12966315,460
2022-05-05 11:53:13-04:00,17637,AQr9mVmcXCNQhBVCfx63MwR6c4WqDSC9K2BZqr7N8LCx,CB7TWUaL381ounsLw6neAUaKRxJL9P1HC9uGX5e1Uxod,True,20214921,1131171,5704,2852,2852,2a35JJeTUW1pm6M3e8DHCjp8qr4vbc2cRPhuzZWyFzYd,1019363,8535341,-7515978,504
2022-05-05 11:53:22-04:00,17638,8fVwuVA2CL5sZoHh6Dg4MBpcX3cvoUm7mnitnpQSdPBD,4F4ccaNm1KQu29XvsKvdjFkmpsbWqNvXkV41851EYQyu,False,20272325,20272325,929283,46464,882819,68sueyVfmy5ToEGtLFGDkwebX47xAmzyXE29z8JrmcWv,929284,7838961,-6909677,458
2022-05-05 11:53:22-04:00,17639,3Dc89y1Z6ViLFDoY3vwcJewSjMQam2mSTqPtpxsPZVz5,4NfXm5CTgNUTQd6NPj2hKwjMYDr7a8d5yVC9rV2uTcjA,True,814758301,203689575,1423201,711600,711601,C4UnXuShCvjSMgBAgVNMy1oakxCNk1et27A82fywU112,56928064,211686544,-154758480,698
2022-05-05 11:53:46-04:00,17640,HmspGdpobjC5Vbmo3FcKdw4RLPN7wJKxv3uKqDjVhLee,3YEX8TzdyJyuHo76Kw76imVCJjzrC9m188YuRKvwwSwD,False,5358564,5358564,328249,16412,311837,68sueyVfmy5ToEGtLFGDkwebX47xAmzyXE29z8JrmcWv,328249,3046524,-2718275,612
2022-05-05 11:53:47-04:00,17641,Cb6MEn1MN9XQcVVd3o9J8QdK3cFWxSNETsFzhVJ8jmdh,A6yTKbggUftjbjAVu5YR1M7rg7h78ghbfofmTSnmKNGz,True,295994015,73998503,455225,227612,227613,C4UnXuShCvjSMgBAgVNMy1oakxCNk1et27A82fywU112,18209024,62730744,-44521720,615
2022-05-05 11:54:14-04:00,17642,DZnaFtxiEHUv3geRGsKufTnCUhkSMbN2M7W4Bwu2LgkM,A38xXBMxA13qQnVB1tcd5USxpfdaUGmkp31FeTmCyb52,True,72730384,9748948,67632,33816,33816,C4UnXuShCvjSMgBAgVNMy1oakxCNk1et27A82fywU112,5045657,37226742,-32181085,693
2022-05-05 11:54:36-04:00,17643,FRbeFwhUYCiHW5oP26mad8KND7CCYDbfnoNxX7GuXVp8,GrzXKxPX2WDka8i2D8sunMUsrsThKasQi8NYLwuCGygV,True,4154100492,386912777,1635355,817677,817678,A2p75MbAbeUdHkPLkAjgGeiwuu9WPrkMHzjCkDXF1Xr3,175580461,1256621629,-1081041168,422
2022-05-05 11:54:36-04:00,17644,26wo1RqwKXrNnfgMdZEmkGhnDbURpZcp2hasB5EA5QtD,34gwTVGRrdoaBzLUG6SBwRwBovkjBjCebqVUBan6GDnB,True,11896044083,2974011020,19014140,9507070,9507070,gjBMZYVujDjD1ECG4i97M8Q3gV9ESnwwTSUGropkusj,760565605,5184023241,-4423457636,639
2022-05-05 11:54:41-04:00,17645,8sQzUoiFfBUsfVKdUjUh3xUjwnaCP1Qmw9BGwtH768ZR,8wZxijgcyRwqxiRKMMZhoREAb6iHhRGCgjgZRd5Yp6RP,True,3245232264,652907739,4563526,2281763,2281763,2xTUy2RS74GJMMDnmFaegMzFLn19RVfYG4CibhBmjP1i,226826917,353781837,-126954920,698
2022-05-05 11:54:49-04:00,17646,SEndYVMCKAeZUKSqGrMUSqXFmxtA9M1t4eXsUhVsTBF,3fcQQcbkpqodakamn82pFnMxBEPL2Drsg4jJNZ6dx72M,True,325525352,29095554,182459,91229,91230,DQCvC9mR68hJ3tJsUiddh6JwcBJAmntqGJR2nUsEq7yj,20413911,42193674,-21779763,627
2022-05-05 11:54:55-04:00,17647,5tW54mXQxtM7vGc91HrDeDtWkxJeH2uM4yAviqZnMZCN,7Kg5Zwx5afFdLbTifeyKJLSNVj2p9Xf5anbbqQozNzmY,True,1300608705,140494413,874116,437058,437058,3zqXX6kzhkbW3d4TwD2CNjMRwxTbREXySekvq37kfCNk,80920168,152432162,-71511994,622
2022-05-05 11:54:59-04:00,17648,DZnaFtxiEHUv3geRGsKufTnCUhkSMbN2M7W4Bwu2LgkM,A38xXBMxA13qQnVB1tcd5USxpfdaUGmkp31FeTmCyb52,True,62442469,8378421,59562,29781,29781,68sueyVfmy5ToEGtLFGDkwebX47xAmzyXE29z8JrmcWv,4439058,34380859,-29941801,710
2022-05-05 11:55:04-04:00,17649,4oMasDRj8HWfknmdwt6Mkz3eonr8J2byoiSTRo4sCnFQ,3emcATkEFvDVETiK97eVET2Z2jzkgiiSxX3gu5wsUKPe,True,34045776614,4726113494,30937693,15468846,15468847,3zqXX6kzhkbW3d4TwD2CNjMRwxTbREXySekvq37kfCNk,2228676556,7865814666,-5637138110,654
2022-05-05 11:55:07-04:00,17650,5QxR9QPTADFys9VQNm473RgprTikCXC23vhsBc9ojyAQ,H9zdf8nJ4JCF7jrwGsxiuiFoa14gzDmYsZ5N5ig3UGna,True,1155974102,288993525,873484,436742,436742,A2p75MbAbeUdHkPLkAjgGeiwuu9WPrkMHzjCkDXF1Xr3,34939362,82824944,-47885582,302
2022-05-05 11:55:07-04:00,17651,D8BtQirMEk3W9Pq29B6KkKWrwPfmsUNpwz5npx7aGMLY,J7LMZwaSoh5hbGcwee6oPsnN4ZFD7Zp3LQWkJGNUHRfJ,True,313432204,78358051,541282,270641,270641,C4UnXuShCvjSMgBAgVNMy1oakxCNk1et27A82fywU112,21651317,108047016,-86395699,690
2022-05-05 11:55:10-04:00,17652,68zbVKnneMQqngbNkeLtPEP2ayNhawc1B2hPgqAEqgXK,HqiFpLr4NC7xJz9bEFusq8bCKaoxAQG1xsLxdUAzg8aa,True,202370579,9540894,40290,20145,20145,GXyFXZMNk2NFyEzw6JetVqsujqcz2yCixH7n8EpDJYWD,8546031,90905665,-82359634,422
2022-05-05 11:55:21-04:00,17653,BjCNaM7YbE9SjFi7tzi4677zg1fKXGJwtecz2GWwWuhd,6rNsSrKZezQrLb2whToNjnizpnurDXrobHqfEK3QqU1M,True,45742995,3303163,15253,7626,7627,2a35JJeTUW1pm6M3e8DHCjp8qr4vbc2cRPhuzZWyFzYd,2112337,23814859,-21702522,461
2022-05-05 11:56:27-04:00,17654,BaFWQSYQQikWywyGiHgG25hEons9nW5zhvUTzp8oAcYU,7WyiB5TBMB49ctd4cZBExSJyD51JMYnokScjSWixoPdk,True,21317184,1412078,9357,4678,4679,68sueyVfmy5ToEGtLFGDkwebX47xAmzyXE29z8JrmcWv,1412706,2990452,-1577746,662
2022-05-05 11:57:21-04:00,17655,26wo1RqwKXrNnfgMdZEmkGhnDbURpZcp2hasB5EA5QtD,34gwTVGRrdoaBzLUG6SBwRwBovkjBjCebqVUBan6GDnB,True,8806720345,2201680086,15655968,7827984,7827984,68sueyVfmy5ToEGtLFGDkwebX47xAmzyXE29z8JrmcWv,626238747,4071763612,-3445524865,711
2022-05-05 11:58:58-04:00,17656,DZnaFtxiEHUv3geRGsKufTnCUhkSMbN2M7W4Bwu2LgkM,A38xXBMxA13qQnVB1tcd5USxpfdaUGmkp31FeTmCyb52,True,53484468,7079569,50297,25148,25149,2a35JJeTUW1pm6M3e8DHCjp8qr4vbc2cRPhuzZWyFzYd,3799916,28999340,-25199424,710
2022-05-05 12:01:40-04:00,17657,BaFWQSYQQikWywyGiHgG25hEons9nW5zhvUTzp8oAcYU,7WyiB5TBMB49ctd4cZBExSJyD51JMYnokScjSWixoPdk,True,19946473,1588454,10537,5268,5269,2a35JJeTUW1pm6M3e8DHCjp8qr4vbc2cRPhuzZWyFzYd,1323235,3198683,-1875448,663
2022-05-05 12:09:00-04:00,17658,9ZyfJ3h3FBWxiFxQRNKb376GTeHUfagdqLkGH6gd8qtm,5hFfXHM23QzxHTE6YXvbaJFBQdLpPwX2Ex5N679V1JTw,True,16080676597,1843497349,11839066,5919533,5919533,2xTUy2RS74GJMMDnmFaegMzFLn19RVfYG4CibhBmjP1i,1032712148,3032585345,-1999873197,642
2022-05-05 12:09:24-04:00,17659,BaFWQSYQQikWywyGiHgG25hEons9nW5zhvUTzp8oAcYU,7WyiB5TBMB49ctd4cZBExSJyD51JMYnokScjSWixoPdk,True,18281188,1080917,7131,3565,3566,5HnvdJnCCcmRsm4GkXnYWd4q9RpwuvYDGEUMPkYR3Ts9,1206135,2975093,-1768958,659
2022-05-05 12:11:56-04:00,17660,64Diz8zzEv1jDWnBQPTHPpXwaWf7vjM19RyJmkPy1viQ,G8wkGHRHMtT3mvXBkH3zgsKNs8wbpdiPUS17y4cozhkZ,True,373134580,93283645,581763,290881,290882,2a35JJeTUW1pm6M3e8DHCjp8qr4vbc2cRPhuzZWyFzYd,23270524,38383000,-15112476,623
2022-05-05 12:41:31-04:00,17661,7DTi299NL6owDJEkjWY6SZX6MhLB72oU1xr9d5DPUzZp,F8YWvNb45pdhgkfCtrFiPNeS4rtjkjTkBkvL5EoPzYXM,True,200684859,50171214,357249,178624,178625,2a35JJeTUW1pm6M3e8DHCjp8qr4vbc2cRPhuzZWyFzYd,14289988,35488147,-21198159,712
2022-05-05 13:26:28-04:00,17662,26wo1RqwKXrNnfgMdZEmkGhnDbURpZcp2hasB5EA5QtD,34gwTVGRrdoaBzLUG6SBwRwBovkjBjCebqVUBan6GDnB,True,6453287242,1613321810,11409846,5704923,5704923,72XWPCtRYEDZbddP7d6dHtUBRRDLSJsB2xZTAfefoEVZ,456393864,3199355422,-2742961558,707
2022-05-05 13:44:11-04:00,17663,4ZF1wtHKAnxmEZGACgbgphHvuo5aK4wC4MCNJzLYVkMX,5UXyhRP3Rjsc1RbV8BouJVQoTbWWbuPtVJY15KcHJFCN,True,563983817,140995954,423508,211754,211754,C4UnXuShCvjSMgBAgVNMy1oakxCNk1et27A82fywU112,16940339,132912875,-115972536,300
2022-05-05 13:45:15-04:00,17664,kn4CMFEGiFu6Sw8v7GAZaBNHKe5Mst4Bj2kds1B6Daw,4FAjghUCswqbD6SKVr7Mu9aLcSLxDofiBvxgkZeiVz32,False,33181537,33181537,998640,49932,948708,2a35JJeTUW1pm6M3e8DHCjp8qr4vbc2cRPhuzZWyFzYd,998641,5512189,-4513548,300
2022-05-05 13:45:15-04:00,17665,Hgs1Lk2ESxULpgcbgayhLdHSDyw5Yr6RiNYhP8q9CHwC,42prjFMA3G8DGZxkgXRDupGkz9GFSxB2mu1ccnEqPhjv,True,181410367,45352591,133879,66939,66940,2a35JJeTUW1pm6M3e8DHCjp8qr4vbc2cRPhuzZWyFzYd,5355185,22557102,-17201917,295
2022-05-05 13:45:23-04:00,17666,9XmuJX8mFX29c5uh68kK7ff1mPdvs1orJAgEP6BsVKnq,HfPpizwUoK6uEmMb9LWi464BnvjHQY9cuPppFMp1DKDA,True,872475077,218118769,644858,322429,322429,68sueyVfmy5ToEGtLFGDkwebX47xAmzyXE29z8JrmcWv,25794338,63666216,-37871878,295
2022-05-05 13:45:24-04:00,17667,87yYQuRW91LAqEmqEyYah7obsr4KijRrqsKdK7DGA9w,EJzredSumMNBMTYxMMHocKayWKg3A3621QJ3ArJqro8r,True,475149696,118787424,340431,170215,170216,2a35JJeTUW1pm6M3e8DHCjp8qr4vbc2cRPhuzZWyFzYd,13617268,110264115,-96646847,286
2022-05-05 13:45:36-04:00,17668,5zqXqEjg95BnghcVbHRhYkSTYnzZjUBichgccv1BpS3d,9SuqSxrKpHh9NcNePe4Q3jXvpCmhNnoQv8YAFih3CqMX,True,4510343939,1127585984,3414926,1707463,1707463,3zqXX6kzhkbW3d4TwD2CNjMRwxTbREXySekvq37kfCNk,136597065,1076597011,-939999946,302
2022-05-05 13:45:36-04:00,17669,HqtTbC1LFreGvgfpZe7nCqkNnh8GHPQKosfmc19zb1yi,E39UNiHNkwQEd5GXkCtTPqSorQSB1kLx8kjzK4jdFoi3,True,1530224970,382556242,1157718,578859,578859,2py1FiYeL2f7J3HU36qiJz6TD6HCmiTN36RyxYtapQCZ,46308753,203598714,-157289961,302
2022-05-05 13:48:25-04:00,17670,B6Wc3euMqUf6QjzCqDtNeAEUM7MvADFaiReEq9VYH2Qg,2pzhsqXYd5u7h4xTN8bMS3GbicVnJ6KY3MQn7spSXroA,True,33578792,4733444,14337,7168,7169,68sueyVfmy5ToEGtLFGDkwebX47xAmzyXE29z8JrmcWv,1017139,9693219,-8676080,302
2022-05-05 13:49:07-04:00,17671,5xkW7wHTcF5WadNtBBqKPKctVwyQtTqqscivAmxzseCk,7m31ZMZdCn5Gz2q5sETWA7uKA5LsKD7pJHBBqU3g7tCn,True,414980872,103745218,309793,154896,154897,YQC4EUcgeBi9431viwvzvBbZJW3szeHX4dFmowRDyDw,12391752,56575829,-44184077,298
2022-05-05 13:49:13-04:00,17672,7tFD53kPTqrzjCu1Wji78gUqhoRtCUhsP1pM3DQKT7uG,BJvgPLYBDJrQJdQVowrsMwUGMurq4zTihoFwWoEokfu3,True,15897338599,2199484002,6619910,3309955,3309955,3zqXX6kzhkbW3d4TwD2CNjMRwxTbREXySekvq37kfCNk,478471161,1817074482,-1338603321,300
2022-05-05 13:49:13-04:00,17673,4ZF1wtHKAnxmEZGACgbgphHvuo5aK4wC4MCNJzLYVkMX,5UXyhRP3Rjsc1RbV8BouJVQoTbWWbuPtVJY15KcHJFCN,True,419032998,104758249,314049,157024,157025,5HnvdJnCCcmRsm4GkXnYWd4q9RpwuvYDGEUMPkYR3Ts9,12561966,103499401,-90937435,299
2022-05-05 13:49:15-04:00,17674,BmFSXZx3HWaTtD7vp7AkUk5DUNjwK1qgLPod13EJz6No,DtLMfV3Xs7AAAQqC1PwL7YAfV6fig8yAMxr9MMxmyCKc,True,169939950,42484987,125742,62871,62871,gjBMZYVujDjD1ECG4i97M8Q3gV9ESnwwTSUGropkusj,5029708,20255169,-15225461,295
2022-05-05 13:49:39-04:00,17675,Hgs1Lk2ESxULpgcbgayhLdHSDyw5Yr6RiNYhP8q9CHwC,42prjFMA3G8DGZxkgXRDupGkz9GFSxB2mu1ccnEqPhjv,True,134916318,33729079,101996,50998,50998,68sueyVfmy5ToEGtLFGDkwebX47xAmzyXE29z8JrmcWv,4079848,18123042,-14043194,302
2022-05-05 13:50:10-04:00,17676,FtF3PVw8YNJseWPMcA2GEuQZ6nni1mq5kYPa2LrSzfkW,4yr1TM2dXrBvLNMpSaoryuGU2P8D3WG1ZCkvVzWFiQRH,True,23184506,1157843,5322,2661,2661,2a35JJeTUW1pm6M3e8DHCjp8qr4vbc2cRPhuzZWyFzYd,1065800,13453703,-12387903,459
2022-05-05 13:50:10-04:00,17677,CDVtXFbo4Rg2aHsXKv5P3uRJq9ZTgsRd7GXPTxgH5xv9,6zj37qQnaiJT7xGEZmSKx5yQvisQFcs5KhGsG43SGd5y,True,362085732,37778382,126904,63452,63452,Hu94aiQWvce6THeGyCFqGRPM1pQrK3ihzkcXo1EpJcJL,12163179,114689223,-102526044,335
2022-05-05 13:50:12-04:00,17678,87yYQuRW91LAqEmqEyYah7obsr4KijRrqsKdK7DGA9w,EJzredSumMNBMTYxMMHocKayWKg3A3621QJ3ArJqro8r,True,353725120,88431280,265992,132996,132996,C4UnXuShCvjSMgBAgVNMy1oakxCNk1et27A82fywU112,10639685,85764222,-75124537,300
2022-05-05 13:50:19-04:00,17679,9XmuJX8mFX29c5uh68kK7ff1mPdvs1orJAgEP6BsVKnq,HfPpizwUoK6uEmMb9LWi464BnvjHQY9cuPppFMp1DKDA,True,648798053,162199513,489780,244890,244890,2py1FiYeL2f7J3HU36qiJz6TD6HCmiTN36RyxYtapQCZ,19591225,53559960,-33968735,301
2022-05-05 13:50:33-04:00,17680,9ZyfJ3h3FBWxiFxQRNKb376GTeHUfagdqLkGH6gd8qtm,5hFfXHM23QzxHTE6YXvbaJFBQdLpPwX2Ex5N679V1JTw,True,14127466481,1391234062,8952287,4476143,4476144,68sueyVfmy5ToEGtLFGDkwebX47xAmzyXE29z8JrmcWv,909071681,2879371952,-1970300271,643
2022-05-05 13:50:55-04:00,17681,68zbVKnneMQqngbNkeLtPEP2ayNhawc1B2hPgqAEqgXK,HqiFpLr4NC7xJz9bEFusq8bCKaoxAQG1xsLxdUAzg8aa,True,192304292,9178046,37912,18956,18956,Hu94aiQWvce6THeGyCFqGRPM1pQrK3ihzkcXo1EpJcJL,7943636,87647982,-79704346,413
2022-05-05 13:56:07-04:00,17682,HqtTbC1LFreGvgfpZe7nCqkNnh8GHPQKosfmc19zb1yi,E39UNiHNkwQEd5GXkCtTPqSorQSB1kLx8kjzK4jdFoi3,True,1136903575,284225893,859647,429823,429824,DQCvC9mR68hJ3tJsUiddh6JwcBJAmntqGJR2nUsEq7yj,34385882,163139883,-128754001,302
2022-05-05 13:56:07-04:00,17683,5zqXqEjg95BnghcVbHRhYkSTYnzZjUBichgccv1BpS3d,9SuqSxrKpHh9NcNePe4Q3jXvpCmhNnoQv8YAFih3CqMX,True,3350831504,837707876,2531392,1265696,1265696,6UQfSsLooL4pQKQfLtXCutQS2BnF7A7F7ewJopDLmUpc,101255688,838385598,-737129910,302
2022-05-05 13:56:10-04:00,17684,E3LF7ohKS87kHLW78ViuRuyw7EMuiW3nVn5PRdhU7iBj,DMVXNy2NLb8jMuznjx2syKqvzctrNmQ3PfiUA83CeQR4,True,520781722,130195430,383433,191716,191717,A2p75MbAbeUdHkPLkAjgGeiwuu9WPrkMHzjCkDXF1Xr3,15337325,130175638,-114838313,294
2022-05-05 13:56:13-04:00,17685,BjCNaM7YbE9SjFi7tzi4677zg1fKXGJwtecz2GWwWuhd,6rNsSrKZezQrLb2whToNjnizpnurDXrobHqfEK3QqU1M,True,42267963,5528169,25089,12544,12545,68sueyVfmy5ToEGtLFGDkwebX47xAmzyXE29z8JrmcWv,1918368,21244117,-19325749,453
2022-05-05 13:56:41-04:00,17686,B6Wc3euMqUf6QjzCqDtNeAEUM7MvADFaiReEq9VYH2Qg,2pzhsqXYd5u7h4xTN8bMS3GbicVnJ6KY3MQn7spSXroA,False,28709272,28709272,866725,43336,823389,68sueyVfmy5ToEGtLFGDkwebX47xAmzyXE29z8JrmcWv,866726,8364030,-7497304,301
2022-05-05 13:56:51-04:00,17687,FtF3PVw8YNJseWPMcA2GEuQZ6nni1mq5kYPa2LrSzfkW,4yr1TM2dXrBvLNMpSaoryuGU2P8D3WG1ZCkvVzWFiQRH,False,21955877,21955877,989689,49484,940205,68sueyVfmy5ToEGtLFGDkwebX47xAmzyXE29z8JrmcWv,989692,12570856,-11581164,450
2022-05-05 13:57:12-04:00,17688,GvSTkcR23Yo2or1Di39kGc6zPe9ynBvE3nGbVzWD2Nt3,3L1LohQaKuexSDvXToK8CkrHG5NfhrPC914asuLSSTze,True,38869594,9717398,29393,14696,14697,Hu94aiQWvce6THeGyCFqGRPM1pQrK3ihzkcXo1EpJcJL,1175739,9991385,-8815646,302
2022-05-05 13:57:17-04:00,17689,4TnEB3hdCiM8ZzHLyY9uC84K7Ri7N6KMXEaZDiG44m8C,2fnFP93pDobi9upuPxHTz3gYXwu4yfRxYiFf6d8EAcbD,False,13057202,13057202,395587,19779,375808,68sueyVfmy5ToEGtLFGDkwebX47xAmzyXE29z8JrmcWv,395587,3014074,-2618487,302
2022-05-05 13:58:38-04:00,17690,CDVtXFbo4Rg2aHsXKv5P3uRJq9ZTgsRd7GXPTxgH5xv9,6zj37qQnaiJT7xGEZmSKx5yQvisQFcs5KhGsG43SGd5y,True,323368302,32747757,112382,56191,56191,68sueyVfmy5ToEGtLFGDkwebX47xAmzyXE29z8JrmcWv,11097227,106030800,-94933573,343
2022-05-05 13:58:39-04:00,17691,BhhVhLVZkSd3aHDMd6ojTgtJtbgAdMCA9Xj8jL2GMXoL,G8HUQp2yGSw9T6it5ej91cqkd82naca8heji453g2jEH,True,240818971,29115152,133525,66762,66763,2a35JJeTUW1pm6M3e8DHCjp8qr4vbc2cRPhuzZWyFzYd,11044275,94482471,-83438196,458
2022-05-05 13:58:43-04:00,17692,69MG5oJ1EhRXG1NqiNu3H8dUyAzbJQBmkCGbBnVF8CmQ,EdEAnDujxBwoxX1wdMnFNWAbxv7SzhHv8F2z6dtUtT7M,False,12306341,12306341,371254,18562,352692,2a35JJeTUW1pm6M3e8DHCjp8qr4vbc2cRPhuzZWyFzYd,371254,2671025,-2299771,301
2022-05-05 13:58:56-04:00,17693,AggAFLRnGWU7X97a3sWRKV7wDDRiAGn9Q4azmEYXAo1k,Dj4DzvpxgQiRoad1zTXoNTrgGTDHG9NvMeCzzRZSxkvs,True,426744796,41458212,176250,88125,88125,68sueyVfmy5ToEGtLFGDkwebX47xAmzyXE29z8JrmcWv,18142158,87211689,-69069531,425
2022-05-05 14:00:16-04:00,17694,68zbVKnneMQqngbNkeLtPEP2ayNhawc1B2hPgqAEqgXK,HqiFpLr4NC7xJz9bEFusq8bCKaoxAQG1xsLxdUAzg8aa,True,182580643,16392886,65951,32975,32976,68sueyVfmy5ToEGtLFGDkwebX47xAmzyXE29z8JrmcWv,7345574,82695824,-75350250,402
2022-05-05 14:02:34-04:00,17695,DZnaFtxiEHUv3geRGsKufTnCUhkSMbN2M7W4Bwu2LgkM,A38xXBMxA13qQnVB1tcd5USxpfdaUGmkp31FeTmCyb52,True,45863416,6332096,44221,22110,22111,C4UnXuShCvjSMgBAgVNMy1oakxCNk1et27A82fywU112,3203026,26628045,-23425019,698
2022-05-05 14:02:44-04:00,17696,7tFD53kPTqrzjCu1Wji78gUqhoRtCUhsP1pM3DQKT7uG,BJvgPLYBDJrQJdQVowrsMwUGMurq4zTihoFwWoEokfu3,True,13639096281,1762467359,5314599,2657299,2657300,GXyFXZMNk2NFyEzw6JetVqsujqcz2yCixH7n8EpDJYWD,411277617,1645651202,-1234373585,301
2022-05-05 14:03:39-04:00,17697,BjCNaM7YbE9SjFi7tzi4677zg1fKXGJwtecz2GWwWuhd,6rNsSrKZezQrLb2whToNjnizpnurDXrobHqfEK3QqU1M,True,36605321,2534725,12150,6075,6075,2a35JJeTUW1pm6M3e8DHCjp8qr4vbc2cRPhuzZWyFzYd,1754748,19082360,-17327612,479
2022-05-05 14:03:39-04:00,17698,5xkW7wHTcF5WadNtBBqKPKctVwyQtTqqscivAmxzseCk,7m31ZMZdCn5Gz2q5sETWA7uKA5LsKD7pJHBBqU3g7tCn,True,308272659,77068164,226822,113411,113411,5HnvdJnCCcmRsm4GkXnYWd4q9RpwuvYDGEUMPkYR3Ts9,9072919,45175553,-36102634,294
2022-05-05 14:06:06-04:00,17699,gCNpMXEHPTLvMvyyaYCLJrd8RRGnKAHz7sBD5j7yyBt,9cRU1ZAZRT5Ei4YAmCrPJZMHGsWspcYXTuZH58iexwDv,True,887258761,221814690,663753,331876,331877,2a35JJeTUW1pm6M3e8DHCjp8qr4vbc2cRPhuzZWyFzYd,26550125,106752281,-80202156,299
2022-05-05 14:06:06-04:00,17700,BmFSXZx3HWaTtD7vp7AkUk5DUNjwK1qgLPod13EJz6No,DtLMfV3Xs7AAAQqC1PwL7YAfV6fig8yAMxr9MMxmyCKc,True,126372102,31593025,95055,47527,47528,2a35JJeTUW1pm6M3e8DHCjp8qr4vbc2cRPhuzZWyFzYd,3802228,16304446,-12502218,300
2022-05-05 14:06:06-04:00,17701,CDVtXFbo4Rg2aHsXKv5P3uRJq9ZTgsRd7GXPTxgH5xv9,6zj37qQnaiJT7xGEZmSKx5yQvisQFcs5KhGsG43SGd5y,True,289730591,28170774,97853,48926,48927,Hu94aiQWvce6THeGyCFqGRPM1pQrK3ihzkcXo1EpJcJL,10064095,91290804,-81226709,347
2022-05-05 14:06:08-04:00,17702,HCAGpyYM2NYudMd55Geta13tUbS6eiygnJY5ULHsHAVa,3PPyWhqXrmifWPieLV34bZ1rzi8eEnrDDAF7ifXkXspn,True,251265597,41162865,234892,117446,117446,Hu94aiQWvce6THeGyCFqGRPM1pQrK3ihzkcXo1EpJcJL,14338319,74585709,-60247390,570
2022-05-05 14:06:18-04:00,17703,GsfMt94sB6ATRG3sqN1hxGNoqVbX7U92XoCDxBQ1jfjh,AEwLnKbHYb4eWTPAiXKx56jxStSwCJ3pxhkhfWmjUMAq,False,8783308,8783308,266108,13305,252803,5HnvdJnCCcmRsm4GkXnYWd4q9RpwuvYDGEUMPkYR3Ts9,266109,1857804,-1591695,302
2022-05-05 14:06:19-04:00,17704,4ZF1wtHKAnxmEZGACgbgphHvuo5aK4wC4MCNJzLYVkMX,5UXyhRP3Rjsc1RbV8BouJVQoTbWWbuPtVJY15KcHJFCN,True,311459584,77864896,234655,117327,117328,Hu94aiQWvce6THeGyCFqGRPM1pQrK3ihzkcXo1EpJcJL,9386206,80406221,-71020015,301
2022-05-05 14:06:20-04:00,17705,3pRKRd4i6jepz5HPbSsSFj2YKwYBjgVAk2v7ZMBYZVNR,Fzf7Gx6KJam5A1eny5G49cRS2zZHFt7XMxCx8N1Ej2Jd,True,507900874,126975218,384604,192302,192302,A2p75MbAbeUdHkPLkAjgGeiwuu9WPrkMHzjCkDXF1Xr3,15384177,129635245,-114251068,302
2022-05-05 14:06:22-04:00,17706,68zbVKnneMQqngbNkeLtPEP2ayNhawc1B2hPgqAEqgXK,HqiFpLr4NC7xJz9bEFusq8bCKaoxAQG1xsLxdUAzg8aa,True,165740403,15097488,62203,31101,31102,5HnvdJnCCcmRsm4GkXnYWd4q9RpwuvYDGEUMPkYR3Ts9,6828726,73543325,-66714599,412
2022-05-05 14:06:23-04:00,17707,AQr9mVmcXCNQhBVCfx63MwR6c4WqDSC9K2BZqr7N8LCx,CB7TWUaL381ounsLw6neAUaKRxJL9P1HC9uGX5e1Uxod,False,19020892,19020892,945602,47280,898322,68sueyVfmy5ToEGtLFGDkwebX47xAmzyXE29z8JrmcWv,945604,8277360,-7331756,497
2022-05-05 14:06:29-04:00,17708,9ZyfJ3h3FBWxiFxQRNKb376GTeHUfagdqLkGH6gd8qtm,5hFfXHM23QzxHTE6YXvbaJFBQdLpPwX2Ex5N679V1JTw,True,12653670444,1376049850,8876282,4438141,4438141,A2p75MbAbeUdHkPLkAjgGeiwuu9WPrkMHzjCkDXF1Xr3,816231760,2667897488,-1851665728,645
2022-05-05 14:06:47-04:00,17709,26wo1RqwKXrNnfgMdZEmkGhnDbURpZcp2hasB5EA5QtD,34gwTVGRrdoaBzLUG6SBwRwBovkjBjCebqVUBan6GDnB,True,4715789997,1178947499,8017246,4008623,4008623,2xTUy2RS74GJMMDnmFaegMzFLn19RVfYG4CibhBmjP1i,320689863,2506019866,-2185330003,680
2022-05-05 14:06:51-04:00,17710,Eps7NSYQhiSzaTpTLzx5aoDykXSKtQ6w1JBFuucC8hQp,EeNkTwr26mYEBqYHqoHaBZfybPS2PwcbJsgmQGJY6g89,True,513036310,128259077,388008,194004,194004,3zqXX6kzhkbW3d4TwD2CNjMRwxTbREXySekvq37kfCNk,15520338,129571837,-114051499,302
2022-05-05 14:07:14-04:00,17711,Hgs1Lk2ESxULpgcbgayhLdHSDyw5Yr6RiNYhP8q9CHwC,42prjFMA3G8DGZxkgXRDupGkz9GFSxB2mu1ccnEqPhjv,True,100260932,25065233,75913,37956,37957,68sueyVfmy5ToEGtLFGDkwebX47xAmzyXE29z8JrmcWv,3036554,14495424,-11458870,302
2022-05-05 14:11:16-04:00,17712,7cZhiH7iRxUVTL8x3jnbyj7nDoiEDK2oau86vBa8gfrZ,37BuBSA8thTnab7piguETKrE649E2GPAiiZvLVpkXp5B,False,1556083,1556083,46405,2320,44085,Hu94aiQWvce6THeGyCFqGRPM1pQrK3ihzkcXo1EpJcJL,46405,987824,-941419,298
2022-05-05 14:11:21-04:00,17713,A7j77tzgnQVGtHTa65VtVZqJRYeJvQk7am8NW6e66379,4vJGwEvXU2tGWoWWGwbsYcfKQAMCHbrBMRk4ZVFzneLs,True,56962697474,14240674368,42462000,21231000,21231000,2xTUy2RS74GJMMDnmFaegMzFLn19RVfYG4CibhBmjP1i,1698480005,7804041479,-6105561474,298
2022-05-05 14:11:21-04:00,17714,GpDhvRRae2uiRZ6MnJYnVR2hANNLGFGUDnsQmGjfK8AP,B2pgJ4gPdgzvx2HMJ1wagtthpZebtBk7RD3cF1zqSyT8,True,2027219260,506804815,1455018,727509,727509,68sueyVfmy5ToEGtLFGDkwebX47xAmzyXE29z8JrmcWv,58200745,550893282,-492692537,287
2022-05-05 14:11:23-04:00,17715,87yYQuRW91LAqEmqEyYah7obsr4KijRrqsKdK7DGA9w,EJzredSumMNBMTYxMMHocKayWKg3A3621QJ3ArJqro8r,True,262574094,65643523,190364,95182,95182,68sueyVfmy5ToEGtLFGDkwebX47xAmzyXE29z8JrmcWv,7614576,66678986,-59064410,289
2022-05-05 14:11:27-04:00,17716,9XmuJX8mFX29c5uh68kK7ff1mPdvs1orJAgEP6BsVKnq,HfPpizwUoK6uEmMb9LWi464BnvjHQY9cuPppFMp1DKDA,True,481659938,120414984,352265,176132,176133,C4UnXuShCvjSMgBAgVNMy1oakxCNk1et27A82fywU112,14090614,44509448,-30418834,292
2022-05-05 14:11:27-04:00,17717,CnNbPk9YL7y2PiqMfVvS1789stfDA7ZDk3sArJSw6FwP,9oamN33gGnx3tU9Mnn53yhi6F2Du5AAaSV6uAi69rbib,True,534177186,133544296,380499,190249,190250,C4UnXuShCvjSMgBAgVNMy1oakxCNk1et27A82fywU112,15219976,135945160,-120725184,284
2022-05-05 14:11:38-04:00,17718,BhhVhLVZkSd3aHDMd6ojTgtJtbgAdMCA9Xj8jL2GMXoL,G8HUQp2yGSw9T6it5ej91cqkd82naca8heji453g2jEH,True,209933927,21586550,93807,46903,46904,68sueyVfmy5ToEGtLFGDkwebX47xAmzyXE29z8JrmcWv,9122995,87928956,-78805961,434
2022-05-05 14:11:56-04:00,17719,BjCNaM7YbE9SjFi7tzi4677zg1fKXGJwtecz2GWwWuhd,6rNsSrKZezQrLb2whToNjnizpnurDXrobHqfEK3QqU1M,True,33903815,2472744,11492,5746,5746,Hu94aiQWvce6THeGyCFqGRPM1pQrK3ihzkcXo1EpJcJL,1575817,18256156,-16680339,464
2022-05-05 14:12:04-04:00,17720,1EH82ta3wXUyUwW8VWQnVzSG3r1rHcSj2DvDeTKmp3F,B6aMfucYPbCzWBtauLtgTpwR45wKSK8yqscHJR3F5usu,True,829901363,207475340,616924,308462,308462,GXyFXZMNk2NFyEzw6JetVqsujqcz2yCixH7n8EpDJYWD,24676990,50872539,-26195549,297
2022-05-05 14:12:07-04:00,17721,5zqXqEjg95BnghcVbHRhYkSTYnzZjUBichgccv1BpS3d,9SuqSxrKpHh9NcNePe4Q3jXvpCmhNnoQv8YAFih3CqMX,True,2490174646,622543661,1885034,942517,942517,2xTUy2RS74GJMMDnmFaegMzFLn19RVfYG4CibhBmjP1i,75401371,651311723,-575910352,302
2022-05-05 14:12:08-04:00,17722,E3LF7ohKS87kHLW78ViuRuyw7EMuiW3nVn5PRdhU7iBj,DMVXNy2NLb8jMuznjx2syKqvzctrNmQ3PfiUA83CeQR4,True,387313583,96828395,290575,145287,145288,68sueyVfmy5ToEGtLFGDkwebX47xAmzyXE29z8JrmcWv,11623019,101027218,-89404199,300
2022-05-05 14:12:10-04:00,17723,HqtTbC1LFreGvgfpZe7nCqkNnh8GHPQKosfmc19zb1yi,E39UNiHNkwQEd5GXkCtTPqSorQSB1kLx8kjzK4jdFoi3,True,844699427,211174856,635528,317764,317764,2xTUy2RS74GJMMDnmFaegMzFLn19RVfYG4CibhBmjP1i,25421124,129976849,-104555725,300
2022-05-05 14:13:13-04:00,17724,68zbVKnneMQqngbNkeLtPEP2ayNhawc1B2hPgqAEqgXK,HqiFpLr4NC7xJz9bEFusq8bCKaoxAQG1xsLxdUAzg8aa,True,150205329,7139272,30081,15040,15041,5HnvdJnCCcmRsm4GkXnYWd4q9RpwuvYDGEUMPkYR3Ts9,6328937,69671561,-63342624,421
2022-05-05 14:13:23-04:00,17725,CDVtXFbo4Rg2aHsXKv5P3uRJq9ZTgsRd7GXPTxgH5xv9,6zj37qQnaiJT7xGEZmSKx5yQvisQFcs5KhGsG43SGd5y,True,260715049,24341821,85162,42581,42581,Hu94aiQWvce6THeGyCFqGRPM1pQrK3ihzkcXo1EpJcJL,9121474,84630903,-75509429,349
2022-05-05 14:13:26-04:00,17726,GvSTkcR23Yo2or1Di39kGc6zPe9ynBvE3nGbVzWD2Nt3,3L1LohQaKuexSDvXToK8CkrHG5NfhrPC914asuLSSTze,False,28883929,28883929,873736,43686,830050,Hu94aiQWvce6THeGyCFqGRPM1pQrK3ihzkcXo1EpJcJL,873736,7753754,-6880018,302
2022-05-05 14:13:26-04:00,17727,7tFD53kPTqrzjCu1Wji78gUqhoRtCUhsP1pM3DQKT7uG,BJvgPLYBDJrQJdQVowrsMwUGMurq4zTihoFwWoEokfu3,True,11825204298,1645147671,4932413,2466206,2466207,2py1FiYeL2f7J3HU36qiJz6TD6HCmiTN36RyxYtapQCZ,354538394,1457755613,-1103217219,299
2022-05-05 14:14:18-04:00,17728,AsRi72uQLsBnyQxMBnPEhyQNM7XyNk2RV9GzPMe8PysA,9MqsYTBn6P9zCi5bGCrZurWWysW8XQZJwndHsb227rEW,True,611333845,152833461,450572,225286,225286,3zqXX6kzhkbW3d4TwD2CNjMRwxTbREXySekvq37kfCNk,18022912,159133906,-141110994,294
2022-05-05 14:24:15-04:00,17729,HJ9xavBvosqusXkhsuQNtaKZfWo7wsuNW4v61NmuTpup,Dw4VWUv2B3wsSxsY3U2fAad7ewokgjiFPzigXRDTTDqa,False,25612737,25612737,690245,34512,655733,Hu94aiQWvce6THeGyCFqGRPM1pQrK3ihzkcXo1EpJcJL,690246,3850379,-3160133,269
2022-05-05 14:24:16-04:00,17730,GPeALajYLrgVJgYb65PQUkFJxzeh4APUesZjy77sMy9j,Hnmv48N2jFXN2TYmyPxTsZf9JtnRoz2PfMEzL67UigXx,False,37666218,37666218,929096,46454,882642,Hu94aiQWvce6THeGyCFqGRPM1pQrK3ihzkcXo1EpJcJL,929096,7172197,-6243101,246
2022-05-05 14:24:16-04:00,17731,68gVM4kjmSYxT1uJW13rYSway8uVLUdcLa7sJuqHQaAf,DshroBQ3da7BcAiQpiFREsLKWbUDrBRmmZRw3Zu2Qfs9,True,7848806359,1962201589,5032421,2516210,2516211,A9TwRM1BMxqb8DCC7YNAMV6zPenEJm3HTZBy7wJKK58U,201296851,993385983,-792089132,256
2022-05-05 14:24:18-04:00,17732,9RtNbEZ4ZR8T1HFF4cujPVy2kejVBKFo3CPQi8psSa1q,7zwaGb71jKc9y2HKCKy5q2XV2YUphkyU1hkDaab1GBas,True,1157040546,287190661,714084,357042,357042,3zqXX6kzhkbW3d4TwD2CNjMRwxTbREXySekvq37kfCNk,28769228,341625237,-312856009,248
2022-05-05 14:24:19-04:00,17733,CDVtXFbo4Rg2aHsXKv5P3uRJq9ZTgsRd7GXPTxgH5xv9,6zj37qQnaiJT7xGEZmSKx5yQvisQFcs5KhGsG43SGd5y,True,235490143,20974090,72617,36308,36309,5HnvdJnCCcmRsm4GkXnYWd4q9RpwuvYDGEUMPkYR3Ts9,8153227,73379040,-65225813,346
2022-05-05 14:24:20-04:00,17734,FRbeFwhUYCiHW5oP26mad8KND7CCYDbfnoNxX7GuXVp8,GrzXKxPX2WDka8i2D8sunMUsrsThKasQi8NYLwuCGygV,True,3738207822,645021494,2483878,1241939,1241939,GXyFXZMNk2NFyEzw6JetVqsujqcz2yCixH7n8EpDJYWD,143952642,1122039232,-978086590,385
2022-05-05 14:24:20-04:00,17735,7frvVhg1eWJpsvG7ndjppb8Bmd1tFq5H1g26UiKZxqTP,3Ugo9b53e6e8PLnvKjqRP8pvvoubSPV6qiKtxey7mrGt,True,199087820,49771955,138192,69096,69096,gjBMZYVujDjD1ECG4i97M8Q3gV9ESnwwTSUGropkusj,5527717,53022627,-47494910,277
2022-05-05 14:24:20-04:00,17736,68zbVKnneMQqngbNkeLtPEP2ayNhawc1B2hPgqAEqgXK,HqiFpLr4NC7xJz9bEFusq8bCKaoxAQG1xsLxdUAzg8aa,True,142470112,6870036,27499,13749,13750,C4UnXuShCvjSMgBAgVNMy1oakxCNk1et27A82fywU112,5702911,67239565,-61536654,400
2022-05-05 14:24:20-04:00,17737,7zDNgPFeomS1hdQhuY8iGF3nnGMNnx1YrinZJetrefje,AKyG5R6Bac6Fu83ruL9FGpjKCfDKxbP6QfEGbCgqegiV,True,46476741,11619185,27280,13640,13640,3zqXX6kzhkbW3d4TwD2CNjMRwxTbREXySekvq37kfCNk,1091272,6356424,-5265152,234
2022-05-05 14:24:22-04:00,17738,BePQMfbkFe8vQ54rFkkf2dzXunPq2Xwpibrm1JVzSHLz,8R6rnjVUnMGUxx5sRjnuuyEnfyBGeet7y2jSJwVswyT3,True,140810735955,21744245239,65352153,32676076,32676077,2xTUy2RS74GJMMDnmFaegMzFLn19RVfYG4CibhBmjP1i,4232055311,15454822863,-11222767552,300
2022-05-05 14:24:22-04:00,17739,AggAFLRnGWU7X97a3sWRKV7wDDRiAGn9Q4azmEYXAo1k,Dj4DzvpxgQiRoad1zTXoNTrgGTDHG9NvMeCzzRZSxkvs,True,382473114,64484658,254781,127390,127391,Hu94aiQWvce6THeGyCFqGRPM1pQrK3ihzkcXo1EpJcJL,15111653,75364903,-60253250,395
2022-05-05 14:24:22-04:00,17740,DZnaFtxiEHUv3geRGsKufTnCUhkSMbN2M7W4Bwu2LgkM,A38xXBMxA13qQnVB1tcd5USxpfdaUGmkp31FeTmCyb52,True,39023107,5063516,34392,17196,17196,2a35JJeTUW1pm6M3e8DHCjp8qr4vbc2cRPhuzZWyFzYd,2650592,22640567,-19989975,679
2022-05-05 14:24:22-04:00,17741,CKK8bNCGjTn8qR6JoY5woqo2rrQHPMRawDGNfDsrg4Zd,46jXZ7r4uPrHnRJsnRnXHdDWjjjAbi8smmHbxxLhuwVg,True,156490773,39122693,105384,52692,52692,3zqXX6kzhkbW3d4TwD2CNjMRwxTbREXySekvq37kfCNk,4215382,7808744,-3593362,269
2022-05-05 14:24:22-04:00,17742,EdCSJVDrgnE7PN9GK7t1t7hB79mBrJzyy1mMZL9u5nvM,GTy9uEWcCx4odtr1GLPpntNbdR7wJRYr3wE9P5rAaMw6,True,171159032,42789758,125443,62721,62722,C4UnXuShCvjSMgBAgVNMy1oakxCNk1et27A82fywU112,5017735,18192713,-13174978,293
2022-05-05 14:24:22-04:00,17743,9RtNbEZ4ZR8T1HFF4cujPVy2kejVBKFo3CPQi8psSa1q,7zwaGb71jKc9y2HKCKy5q2XV2YUphkyU1hkDaab1GBas,True,868062135,214946089,650421,325210,325211,A9TwRM1BMxqb8DCC7YNAMV6zPenEJm3HTZBy7wJKK58U,26267394,263088793,-236821399,302
2022-05-05 14:24:26-04:00,17744,4oMasDRj8HWfknmdwt6Mkz3eonr8J2byoiSTRo4sCnFQ,3emcATkEFvDVETiK97eVET2Z2jzkgiiSxX3gu5wsUKPe,True,31930819932,3796173538,25041481,12520740,12520741,A2p75MbAbeUdHkPLkAjgGeiwuu9WPrkMHzjCkDXF1Xr3,2106318485,7184579633,-5078261148,659
2022-05-05 14:24:26-04:00,17745,DZnaFtxiEHUv3geRGsKufTnCUhkSMbN2M7W4Bwu2LgkM,A38xXBMxA13qQnVB1tcd5USxpfdaUGmkp31FeTmCyb52,True,33729893,4675585,33081,16540,16541,Hu94aiQWvce6THeGyCFqGRPM1pQrK3ihzkcXo1EpJcJL,2386502,20623068,-18236566,707
2022-05-05 14:24:28-04:00,17746,GpDhvRRae2uiRZ6MnJYnVR2hANNLGFGUDnsQmGjfK8AP,B2pgJ4gPdgzvx2HMJ1wagtthpZebtBk7RD3cF1zqSyT8,True,1509095216,377273804,1135662,567831,567831,C4UnXuShCvjSMgBAgVNMy1oakxCNk1et27A82fywU112,45426498,426307786,-380881288,301
2022-05-05 14:24:28-04:00,17747,BjCNaM7YbE9SjFi7tzi4677zg1fKXGJwtecz2GWwWuhd,6rNsSrKZezQrLb2whToNjnizpnurDXrobHqfEK3QqU1M,True,31265156,4086897,18279,9139,9140,C4UnXuShCvjSMgBAgVNMy1oakxCNk1et27A82fywU112,1398410,16328551,-14930141,447
2022-05-05 14:24:28-04:00,17748,7tFD53kPTqrzjCu1Wji78gUqhoRtCUhsP1pM3DQKT7uG,BJvgPLYBDJrQJdQVowrsMwUGMurq4zTihoFwWoEokfu3,True,10131618774,1305200061,3879781,1939890,1939891,C4UnXuShCvjSMgBAgVNMy1oakxCNk1et27A82fywU112,301168128,1325675138,-1024507010,297
2022-05-05 14:24:28-04:00,17749,Eps7NSYQhiSzaTpTLzx5aoDykXSKtQ6w1JBFuucC8hQp,EeNkTwr26mYEBqYHqoHaBZfybPS2PwcbJsgmQGJY6g89,True,380769431,95192357,278113,139056,139057,C4UnXuShCvjSMgBAgVNMy1oakxCNk1et27A82fywU112,11124528,100673637,-89549109,292
2022-05-05 14:24:28-04:00,17750,gCNpMXEHPTLvMvyyaYCLJrd8RRGnKAHz7sBD5j7yyBt,9cRU1ZAZRT5Ei4YAmCrPJZMHGsWspcYXTuZH58iexwDv,True,657890114,164472528,458310,229155,229155,C4UnXuShCvjSMgBAgVNMy1oakxCNk1et27A82fywU112,18332415,86045144,-67712729,278
2022-05-05 14:24:29-04:00,17751,DLwEaZipqHmVBD5hc5v1NZtDStHyG4hAMwxywDTGGc2e,28GtwJw67UWfrSKxtuvpzoKzPyKXLgP3GKLm3fHdR566,True,6567611896,1641902974,9577461,4788730,4788731,A2p75MbAbeUdHkPLkAjgGeiwuu9WPrkMHzjCkDXF1Xr3,383098456,899671084,-516572628,583
2022-05-05 14:24:29-04:00,17752,5QxR9QPTADFys9VQNm473RgprTikCXC23vhsBc9ojyAQ,H9zdf8nJ4JCF7jrwGsxiuiFoa14gzDmYsZ5N5ig3UGna,True,858239923,214559980,628251,314125,314126,A9TwRM1BMxqb8DCC7YNAMV6zPenEJm3HTZBy7wJKK58U,25130046,69829810,-44699764,292
2022-05-05 14:24:30-04:00,17753,CDVtXFbo4Rg2aHsXKv5P3uRJq9ZTgsRd7GXPTxgH5xv9,6zj37qQnaiJT7xGEZmSKx5yQvisQFcs5KhGsG43SGd5y,True,213582377,33856843,113291,56645,56646,2a35JJeTUW1pm6M3e8DHCjp8qr4vbc2cRPhuzZWyFzYd,7146934,68230675,-61083741,334
2022-05-05 14:24:31-04:00,17754,3pRKRd4i6jepz5HPbSsSFj2YKwYBjgVAk2v7ZMBYZVNR,Fzf7Gx6KJam5A1eny5G49cRS2zZHFt7XMxCx8N1Ej2Jd,True,376776391,94194097,271257,135628,135629,A9TwRM1BMxqb8DCC7YNAMV6zPenEJm3HTZBy7wJKK58U,10850308,100690509,-89840201,287
2022-05-05 14:24:33-04:00,17755,7zDNgPFeomS1hdQhuY8iGF3nnGMNnx1YrinZJetrefje,AKyG5R6Bac6Fu83ruL9FGpjKCfDKxbP6QfEGbCgqegiV,True,34827728,8540306,25359,12679,12680,3zqXX6kzhkbW3d4TwD2CNjMRwxTbREXySekvq37kfCNk,1034164,5012932,-3978768,296
2022-05-05 14:24:33-04:00,17756,BaFWQSYQQikWywyGiHgG25hEons9nW5zhvUTzp8oAcYU,7WyiB5TBMB49ctd4cZBExSJyD51JMYnokScjSWixoPdk,True,16770655,1219145,7669,3834,3835,C4UnXuShCvjSMgBAgVNMy1oakxCNk1et27A82fywU112,1055083,2733541,-1678458,629
2022-05-05 14:24:33-04:00,17757,68zbVKnneMQqngbNkeLtPEP2ayNhawc1B2hPgqAEqgXK,HqiFpLr4NC7xJz9bEFusq8bCKaoxAQG1xsLxdUAzg8aa,True,135026610,23340929,88192,44096,44096,C4UnXuShCvjSMgBAgVNMy1oakxCNk1et27A82fywU112,5101946,63523763,-58421817,377
2022-05-05 14:24:33-04:00,17758,4ZF1wtHKAnxmEZGACgbgphHvuo5aK4wC4MCNJzLYVkMX,5UXyhRP3Rjsc1RbV8BouJVQoTbWWbuPtVJY15KcHJFCN,True,231045425,57761356,165057,82528,82529,C4UnXuShCvjSMgBAgVNMy1oakxCNk1et27A82fywU112,6602288,62417556,-55815268,285
2022-05-05 14:24:38-04:00,17759,8DSiP9CwJm3AEcH6uuAYFpArRRDLYpDQgjHEvjkUgfg2,ERJ8kuhPRRmUAhSM4oxUheh39YUVVYNgaTt6AdMXcCvL,True,2086140213,521535053,1457979,728989,728990,2xTUy2RS74GJMMDnmFaegMzFLn19RVfYG4CibhBmjP1i,58319167,547549380,-489230213,279
2022-05-05 14:24:38-04:00,17760,BmFSXZx3HWaTtD7vp7AkUk5DUNjwK1qgLPod13EJz6No,DtLMfV3Xs7AAAQqC1PwL7YAfV6fig8yAMxr9MMxmyCKc,True,93696196,23424049,65607,32803,32804,47z82br5WdW2DZajdnPDPSSRRKsyAggqXqK6oPUwTaLf,2624292,13083983,-10459691,280
2022-05-05 14:24:38-04:00,17761,CnNbPk9YL7y2PiqMfVvS1789stfDA7ZDk3sArJSw6FwP,9oamN33gGnx3tU9Mnn53yhi6F2Du5AAaSV6uAi69rbib,True,397602935,99400733,295238,147619,147619,A2p75MbAbeUdHkPLkAjgGeiwuu9WPrkMHzjCkDXF1Xr3,11809522,105386287,-93576765,297
2022-05-05 14:24:38-04:00,17762,9ZyfJ3h3FBWxiFxQRNKb376GTeHUfagdqLkGH6gd8qtm,5hFfXHM23QzxHTE6YXvbaJFBQdLpPwX2Ex5N679V1JTw,True,11176044069,1031825604,6516087,3258043,3258044,A2p75MbAbeUdHkPLkAjgGeiwuu9WPrkMHzjCkDXF1Xr3,705778953,2547467987,-1841689034,631
2022-05-05 14:24:40-04:00,17763,87yYQuRW91LAqEmqEyYah7obsr4KijRrqsKdK7DGA9w,EJzredSumMNBMTYxMMHocKayWKg3A3621QJ3ArJqro8r,True,195417194,48854298,147770,73885,73885,C4UnXuShCvjSMgBAgVNMy1oakxCNk1et27A82fywU112,5910835,51723225,-45812390,302
2022-05-05 14:24:46-04:00,17764,BjCNaM7YbE9SjFi7tzi4677zg1fKXGJwtecz2GWwWuhd,6rNsSrKZezQrLb2whToNjnizpnurDXrobHqfEK3QqU1M,True,27068644,1867657,8765,4382,4383,47z82br5WdW2DZajdnPDPSSRRKsyAggqXqK6oPUwTaLf,1270516,14651583,-13381067,469
2022-05-05 14:24:46-04:00,17765,Hgs1Lk2ESxULpgcbgayhLdHSDyw5Yr6RiNYhP8q9CHwC,42prjFMA3G8DGZxkgXRDupGkz9GFSxB2mu1ccnEqPhjv,True,74341965,18585491,52672,26336,26336,2a35JJeTUW1pm6M3e8DHCjp8qr4vbc2cRPhuzZWyFzYd,2106907,11554888,-9447981,283
2022-05-05 14:24:47-04:00,17766,29JVska5UEG3axs63EmtHpPvkswNEqYpZ3PKMSfupiAG,DCftNBUsuogxyaJe9G9m3eWipH6o3qo4Rn4TuQXdVaBF,True,907297647,226824411,1334619,667309,667310,5HnvdJnCCcmRsm4GkXnYWd4q9RpwuvYDGEUMPkYR3Ts9,53384788,98230789,-44846001,588
2022-05-05 14:24:51-04:00,17767,5xkW7wHTcF5WadNtBBqKPKctVwyQtTqqscivAmxzseCk,7m31ZMZdCn5Gz2q5sETWA7uKA5LsKD7pJHBBqU3g7tCn,True,228334010,57083502,149390,74695,74695,C4UnXuShCvjSMgBAgVNMy1oakxCNk1et27A82fywU112,5975612,35923958,-29948346,261
2022-05-05 14:24:51-04:00,17768,BhhVhLVZkSd3aHDMd6ojTgtJtbgAdMCA9Xj8jL2GMXoL,G8HUQp2yGSw9T6it5ej91cqkd82naca8heji453g2jEH,True,186556658,16001679,62086,31043,31043,68sueyVfmy5ToEGtLFGDkwebX47xAmzyXE29z8JrmcWv,7238469,82783688,-75545219,388
2022-05-05 14:24:51-04:00,17769,AggAFLRnGWU7X97a3sWRKV7wDDRiAGn9Q4azmEYXAo1k,Dj4DzvpxgQiRoad1zTXoNTrgGTDHG9NvMeCzzRZSxkvs,True,316697900,30850929,132155,66077,66078,5HnvdJnCCcmRsm4GkXnYWd4q9RpwuvYDGEUMPkYR3Ts9,13566316,68732223,-55165907,428
2022-05-05 14:24:52-04:00,17770,9XmuJX8mFX29c5uh68kK7ff1mPdvs1orJAgEP6BsVKnq,HfPpizwUoK6uEmMb9LWi464BnvjHQY9cuPppFMp1DKDA,True,357858052,89464513,258786,129393,129393,A9TwRM1BMxqb8DCC7YNAMV6zPenEJm3HTZBy7wJKK58U,10351447,36554535,-26203088,289
2022-05-05 14:24:52-04:00,17771,DX6DNEePMPiHBVFX2rDuFoy1fznGYDx6bUQB6qL6UAAb,FM9PNZ9HFZNPZDmg5mQRuMo9t49kDJEHM2CuZmNo6TnD,True,11613656494,2903414123,8456725,4228362,4228363,A9TwRM1BMxqb8DCC7YNAMV6zPenEJm3HTZBy7wJKK58U,338269021,577329925,-239060904,291
2022-05-05 14:24:53-04:00,17772,A7j77tzgnQVGtHTa65VtVZqJRYeJvQk7am8NW6e66379,4vJGwEvXU2tGWoWWGwbsYcfKQAMCHbrBMRk4ZVFzneLs,True,42315048421,10578762105,31226083,15613041,15613042,Hu94aiQWvce6THeGyCFqGRPM1pQrK3ihzkcXo1EpJcJL,1249043320,6265186659,-5016143339,295
2022-05-05 14:24:55-04:00,17773,BaFWQSYQQikWywyGiHgG25hEons9nW5zhvUTzp8oAcYU,7WyiB5TBMB49ctd4cZBExSJyD51JMYnokScjSWixoPdk,True,15536791,1041478,6922,3461,3461,68sueyVfmy5ToEGtLFGDkwebX47xAmzyXE29z8JrmcWv,1032695,2526473,-1493778,664
2022-05-05 14:25:02-04:00,17774,1EH82ta3wXUyUwW8VWQnVzSG3r1rHcSj2DvDeTKmp3F,B6aMfucYPbCzWBtauLtgTpwR45wKSK8yqscHJR3F5usu,True,616739528,154184882,459339,229669,229670,C4UnXuShCvjSMgBAgVNMy1oakxCNk1et27A82fywU112,18373571,43712665,-25339094,297
2022-05-05 14:25:10-04:00,17775,5tW54mXQxtM7vGc91HrDeDtWkxJeH2uM4yAviqZnMZCN,7Kg5Zwx5afFdLbTifeyKJLSNVj2p9Xf5anbbqQozNzmY,True,1150925488,139434346,852446,426223,426223,A9TwRM1BMxqb8DCC7YNAMV6zPenEJm3HTZBy7wJKK58U,70363026,143740442,-73377416,611
2022-05-05 14:25:14-04:00,17776,7tFD53kPTqrzjCu1Wji78gUqhoRtCUhsP1pM3DQKT7uG,BJvgPLYBDJrQJdQVowrsMwUGMurq4zTihoFwWoEokfu3,True,8794339182,1222441443,3686487,1843243,1843244,Hu94aiQWvce6THeGyCFqGRPM1pQrK3ihzkcXo1EpJcJL,265208816,1168007663,-902798847,301
2022-05-05 14:25:16-04:00,17777,9pzwKSceogMgCeZjstNqHbiLHeQb4mzD4j9kSmNxbe8x,93AY1zEbBweMV2ur9A65vzmSb79Mkrr2Wi1XuLYijSm9,True,94452329,23613082,68640,34320,34320,Hu94aiQWvce6THeGyCFqGRPM1pQrK3ihzkcXo1EpJcJL,2745608,24091961,-21346353,290
2022-05-05 14:25:18-04:00,17778,HqtTbC1LFreGvgfpZe7nCqkNnh8GHPQKosfmc19zb1yi,E39UNiHNkwQEd5GXkCtTPqSorQSB1kLx8kjzK4jdFoi3,True,627689805,156922451,473770,236885,236885,68sueyVfmy5ToEGtLFGDkwebX47xAmzyXE29z8JrmcWv,18950830,103209091,-84258261,301
2022-05-05 14:25:20-04:00,17779,E3LF7ohKS87kHLW78ViuRuyw7EMuiW3nVn5PRdhU7iBj,DMVXNy2NLb8jMuznjx2syKqvzctrNmQ3PfiUA83CeQR4,True,287800388,71950097,216191,108095,108096,68sueyVfmy5ToEGtLFGDkwebX47xAmzyXE29z8JrmcWv,8647644,78387137,-69739493,300
2022-05-05 14:25:21-04:00,17780,aTkGURJptmKNNP6RSXSWsmVbfcriSAJaMuUiT2eZEfb,5qoGxL83PLhrguyk27X8xE6jGitRg5BaQpXzrcfEvCfJ,False,15985653,15985653,976215,48810,927405,C4UnXuShCvjSMgBAgVNMy1oakxCNk1et27A82fywU112,976215,5934636,-4958421,610
2022-05-05 14:25:23-04:00,17781,6pAs5S7zGX77DHSYUuCxvxbf2FQQHQhbBmAYLd3iJvWS,HNTWEhsrnEe8FeVDpEcxuoD5PnuveB5BwSf3gdBmhzxv,True,147435974,36858993,107931,53965,53966,Hu94aiQWvce6THeGyCFqGRPM1pQrK3ihzkcXo1EpJcJL,4317259,20098295,-15781036,292
2022-05-05 14:25:28-04:00,17782,4nj9fNW5K5hZebNaCP8PDTismTb5HK4MsJLUPLsnfN7P,B4UmvQqxb4Sc35L3YzuGR8BSQC2qKd6e4Byxni7ncYkf,True,277850431,69462607,203421,101710,101711,Hu94aiQWvce6THeGyCFqGRPM1pQrK3ihzkcXo1EpJcJL,8136871,33192085,-25055214,292
2022-05-05 14:26:16-04:00,17783,5zqXqEjg95BnghcVbHRhYkSTYnzZjUBichgccv1BpS3d,9SuqSxrKpHh9NcNePe4Q3jXvpCmhNnoQv8YAFih3CqMX,True,1850007198,462501799,1397313,698656,698657,68sueyVfmy5ToEGtLFGDkwebX47xAmzyXE29z8JrmcWv,55892550,505512902,-449620352,302
2022-05-05 14:26:26-04:00,17784,9ZyfJ3h3FBWxiFxQRNKb376GTeHUfagdqLkGH6gd8qtm,5hFfXHM23QzxHTE6YXvbaJFBQdLpPwX2Ex5N679V1JTw,True,10100883238,1025547375,6659663,3329831,3329832,2xTUy2RS74GJMMDnmFaegMzFLn19RVfYG4CibhBmjP1i,655927639,2377908598,-1721980959,649
2022-05-05 14:26:31-04:00,17785,26wo1RqwKXrNnfgMdZEmkGhnDbURpZcp2hasB5EA5QtD,34gwTVGRrdoaBzLUG6SBwRwBovkjBjCebqVUBan6GDnB,True,3468636970,867159242,6111677,3055838,3055839,C4UnXuShCvjSMgBAgVNMy1oakxCNk1et27A82fywU112,244467089,1953856282,-1709389193,704
2022-05-05 14:27:04-04:00,17786,HDmtdNjr3UNmzXfmajyKASLz9wz4YzNrspTMABcr7tXV,bsQ5Ae5oD7dbNjnz49unSovEp4eDGiB2bfdihVZkAtE,True,37771760,9442940,28348,14174,14174,68sueyVfmy5ToEGtLFGDkwebX47xAmzyXE29z8JrmcWv,1133935,3712284,-2578349,300
2022-05-05 14:29:13-04:00,17787,3Dc89y1Z6ViLFDoY3vwcJewSjMQam2mSTqPtpxsPZVz5,4NfXm5CTgNUTQd6NPj2hKwjMYDr7a8d5yVC9rV2uTcjA,True,597555883,149388970,1051776,525888,525888,A2p75MbAbeUdHkPLkAjgGeiwuu9WPrkMHzjCkDXF1Xr3,42071046,171721868,-129650822,704
2022-05-05 14:29:18-04:00,17788,SEndYVMCKAeZUKSqGrMUSqXFmxtA9M1t4eXsUhVsTBF,3fcQQcbkpqodakamn82pFnMxBEPL2Drsg4jJNZ6dx72M,True,290211178,21978717,138366,69183,69183,2a35JJeTUW1pm6M3e8DHCjp8qr4vbc2cRPhuzZWyFzYd,18270241,33923860,-15653619,629
2022-05-05 14:29:19-04:00,17789,DZnaFtxiEHUv3geRGsKufTnCUhkSMbN2M7W4Bwu2LgkM,A38xXBMxA13qQnVB1tcd5USxpfdaUGmkp31FeTmCyb52,True,28729572,3733618,26364,13182,13182,Hu94aiQWvce6THeGyCFqGRPM1pQrK3ihzkcXo1EpJcJL,2028685,17559016,-15530331,706
2022-05-05 14:29:24-04:00,17790,7qxGLMg6ZAxkVjhuj2PY6a5F36k4Efo3aCa99kvTpSKw,wgWcmEebBLbcm9a2jyCiw8nzqbGbfj6zRou4ZZhfWp7,True,166663237,31548103,181849,90924,90925,C4UnXuShCvjSMgBAgVNMy1oakxCNk1et27A82fywU112,9606809,28918547,-19311738,576
2022-05-05 14:29:58-04:00,17791,A5NXadGWnFZRoHEn1dKTRjcXgWmfMLMyJdpF4rQPZyRR,ALs3Zfotc4c4A6TFDMbd5GM5whK1dTYSnGrHiMBWmApH,True,9788539851,2447134962,7273126,3636563,3636563,GXyFXZMNk2NFyEzw6JetVqsujqcz2yCixH7n8EpDJYWD,290925075,487327198,-196402123,297
2022-05-05 14:40:39-04:00,17792,4oMasDRj8HWfknmdwt6Mkz3eonr8J2byoiSTRo4sCnFQ,3emcATkEFvDVETiK97eVET2Z2jzkgiiSxX3gu5wsUKPe,True,27896249219,4175646642,27585123,13792561,13792562,68sueyVfmy5ToEGtLFGDkwebX47xAmzyXE29z8JrmcWv,1842879829,6437982928,-4595103099,660
2022-05-05 15:05:40-04:00,17793,D8BtQirMEk3W9Pq29B6KkKWrwPfmsUNpwz5npx7aGMLY,J7LMZwaSoh5hbGcwee6oPsnN4ZFD7Zp3LQWkJGNUHRfJ,True,230360397,57590099,410739,205369,205370,3zqXX6kzhkbW3d4TwD2CNjMRwxTbREXySekvq37kfCNk,16429569,85951124,-69521555,713
2022-05-05 15:06:52-04:00,17794,DX6DNEePMPiHBVFX2rDuFoy1fznGYDx6bUQB6qL6UAAb,FM9PNZ9HFZNPZDmg5mQRuMo9t49kDJEHM2CuZmNo6TnD,True,8643447863,2160861965,6539718,3269859,3269859,AmTrMPzuTp2BjnjqGNKqz9FTTCdpoKcPAJLwFc8ozcbh,261588732,509356532,-247767800,302
2022-05-05 15:07:33-04:00,17795,9pzwKSceogMgCeZjstNqHbiLHeQb4mzD4j9kSmNxbe8x,93AY1zEbBweMV2ur9A65vzmSb79Mkrr2Wi1XuLYijSm9,True,70302580,17575645,53216,26608,26608,Hu94aiQWvce6THeGyCFqGRPM1pQrK3ihzkcXo1EpJcJL,2128669,18675235,-16546566,302
2022-05-05 15:07:37-04:00,17796,CDVtXFbo4Rg2aHsXKv5P3uRJq9ZTgsRd7GXPTxgH5xv9,6zj37qQnaiJT7xGEZmSKx5yQvisQFcs5KhGsG43SGd5y,True,179423817,6951215,26009,13004,13005,2a35JJeTUW1pm6M3e8DHCjp8qr4vbc2cRPhuzZWyFzYd,6713560,55786914,-49073354,374
2022-05-05 15:07:40-04:00,17797,6pAs5S7zGX77DHSYUuCxvxbf2FQQHQhbBmAYLd3iJvWS,HNTWEhsrnEe8FeVDpEcxuoD5PnuveB5BwSf3gdBmhzxv,True,109695312,27423828,82737,41368,41369,gjBMZYVujDjD1ECG4i97M8Q3gV9ESnwwTSUGropkusj,3309501,16027241,-12717740,301
2022-05-05 15:07:40-04:00,17798,3Dc89y1Z6ViLFDoY3vwcJewSjMQam2mSTqPtpxsPZVz5,4NfXm5CTgNUTQd6NPj2hKwjMYDr7a8d5yVC9rV2uTcjA,True,437625825,109406456,762078,381039,381039,C4UnXuShCvjSMgBAgVNMy1oakxCNk1et27A82fywU112,30483135,138300793,-107817658,696
2022-05-05 15:07:42-04:00,17799,HCAGpyYM2NYudMd55Geta13tUbS6eiygnJY5ULHsHAVa,3PPyWhqXrmifWPieLV34bZ1rzi8eEnrDDAF7ifXkXspn,True,207221790,30460455,164496,82248,82248,2a35JJeTUW1pm6M3e8DHCjp8qr4vbc2cRPhuzZWyFzYd,11190661,66922647,-55731986,540
2022-05-05 15:07:42-04:00,17800,4nj9fNW5K5hZebNaCP8PDTismTb5HK4MsJLUPLsnfN7P,B4UmvQqxb4Sc35L3YzuGR8BSQC2qKd6e4Byxni7ncYkf,True,206617444,51654361,153221,76610,76611,Hu94aiQWvce6THeGyCFqGRPM1pQrK3ihzkcXo1EpJcJL,6128848,26691666,-20562818,296
2022-05-05 15:07:46-04:00,17801,5tW54mXQxtM7vGc91HrDeDtWkxJeH2uM4yAviqZnMZCN,7Kg5Zwx5afFdLbTifeyKJLSNVj2p9Xf5anbbqQozNzmY,True,1004815965,104321842,650018,325009,325009,2py1FiYeL2f7J3HU36qiJz6TD6HCmiTN36RyxYtapQCZ,62609107,135248256,-72639149,623
2022-05-05 15:07:50-04:00,17802,7tFD53kPTqrzjCu1Wji78gUqhoRtCUhsP1pM3DQKT7uG,BJvgPLYBDJrQJdQVowrsMwUGMurq4zTihoFwWoEokfu3,True,7539301882,976021018,2949045,1474522,1474523,GXyFXZMNk2NFyEzw6JetVqsujqcz2yCixH7n8EpDJYWD,227799890,1056164993,-828365103,302
2022-05-05 15:07:59-04:00,17803,5FewDaMC9U7n5EHcto98GaAmDVxDh5SYimuTP6AtfakM,7DAULUoqV7f9hsBzKEhjQPnWaHSqiMWcBqWcdcadaQv4,True,3066226777,335697743,1488325,744162,744163,Hu94aiQWvce6THeGyCFqGRPM1pQrK3ihzkcXo1EpJcJL,135942082,225166232,-89224150,443
2022-05-05 15:08:34-04:00,17804,SEndYVMCKAeZUKSqGrMUSqXFmxtA9M1t4eXsUhVsTBF,3fcQQcbkpqodakamn82pFnMxBEPL2Drsg4jJNZ6dx72M,True,266548594,24215341,150760,75380,75380,Hu94aiQWvce6THeGyCFqGRPM1pQrK3ihzkcXo1EpJcJL,16594907,23689811,-7094904,622
2022-05-05 15:08:43-04:00,17805,64Diz8zzEv1jDWnBQPTHPpXwaWf7vjM19RyJmkPy1viQ,G8wkGHRHMtT3mvXBkH3zgsKNs8wbpdiPUS17y4cozhkZ,True,273855041,68463760,414387,207193,207194,2a35JJeTUW1pm6M3e8DHCjp8qr4vbc2cRPhuzZWyFzYd,16575511,33910820,-17335309,605
2022-05-05 15:08:44-04:00,17806,HDmtdNjr3UNmzXfmajyKASLz9wz4YzNrspTMABcr7tXV,bsQ5Ae5oD7dbNjnz49unSovEp4eDGiB2bfdihVZkAtE,False,28078461,28078461,850572,42528,808044,Hu94aiQWvce6THeGyCFqGRPM1pQrK3ihzkcXo1EpJcJL,850572,3034712,-2184140,302
2022-05-05 15:10:32-04:00,17807,7qxGLMg6ZAxkVjhuj2PY6a5F36k4Efo3aCa99kvTpSKw,wgWcmEebBLbcm9a2jyCiw8nzqbGbfj6zRou4ZZhfWp7,True,133122903,23177432,131497,65748,65749,2a35JJeTUW1pm6M3e8DHCjp8qr4vbc2cRPhuzZWyFzYd,7552782,22791168,-15238386,567
2022-05-05 15:15:41-04:00,17808,FRbeFwhUYCiHW5oP26mad8KND7CCYDbfnoNxX7GuXVp8,GrzXKxPX2WDka8i2D8sunMUsrsThKasQi8NYLwuCGygV,True,3081714755,286747601,1206521,603260,603261,6UQfSsLooL4pQKQfLtXCutQS2BnF7A7F7ewJopDLmUpc,129666537,974637135,-844970598,420
2022-05-05 15:18:00-04:00,17809,68gVM4kjmSYxT1uJW13rYSway8uVLUdcLa7sJuqHQaAf,DshroBQ3da7BcAiQpiFREsLKWbUDrBRmmZRw3Zu2Qfs9,True,5867660530,1466915132,4423178,2211589,2211589,gjBMZYVujDjD1ECG4i97M8Q3gV9ESnwwTSUGropkusj,176927149,792135502,-615208353,301
2022-05-05 15:18:11-04:00,17810,CDVtXFbo4Rg2aHsXKv5P3uRJq9ZTgsRd7GXPTxgH5xv9,6zj37qQnaiJT7xGEZmSKx5yQvisQFcs5KhGsG43SGd5y,True,172012138,13568679,49120,24560,24560,68sueyVfmy5ToEGtLFGDkwebX47xAmzyXE29z8JrmcWv,6227087,57712125,-51485038,362
2022-05-05 15:18:16-04:00,17811,CKK8bNCGjTn8qR6JoY5woqo2rrQHPMRawDGNfDsrg4Zd,46jXZ7r4uPrHnRJsnRnXHdDWjjjAbi8smmHbxxLhuwVg,True,116790117,29197529,88104,44052,44052,3zqXX6kzhkbW3d4TwD2CNjMRwxTbREXySekvq37kfCNk,3524190,6797988,-3273798,301
2022-05-05 15:18:23-04:00,17812,DZnaFtxiEHUv3geRGsKufTnCUhkSMbN2M7W4Bwu2LgkM,A38xXBMxA13qQnVB1tcd5USxpfdaUGmkp31FeTmCyb52,True,24699888,3370515,23286,11643,11643,2a35JJeTUW1pm6M3e8DHCjp8qr4vbc2cRPhuzZWyFzYd,1706542,15981572,-14275030,690
2022-05-05 15:18:58-04:00,17813,AsRi72uQLsBnyQxMBnPEhyQNM7XyNk2RV9GzPMe8PysA,9MqsYTBn6P9zCi5bGCrZurWWysW8XQZJwndHsb227rEW,True,454702634,113675658,342835,171417,171418,Hu94aiQWvce6THeGyCFqGRPM1pQrK3ihzkcXo1EpJcJL,13713429,123348274,-109634845,301
2022-05-05 15:18:58-04:00,17814,Fczxdc24Eav8xcaKRDwWMEwPEzkGyEJ7qGcXYyGZFKVz,8GqweYpec4cnpaJvueF3FGWoaz72BAzpLYXBX7tuuqEt,True,4155949236,1038987309,3143907,1571953,1571954,2xTUy2RS74GJMMDnmFaegMzFLn19RVfYG4CibhBmjP1i,125756298,2186103181,-2060346883,302
2022-05-05 15:18:59-04:00,17815,5xkW7wHTcF5WadNtBBqKPKctVwyQtTqqscivAmxzseCk,7m31ZMZdCn5Gz2q5sETWA7uKA5LsKD7pJHBBqU3g7tCn,True,170576118,42644029,128222,64111,64111,5HnvdJnCCcmRsm4GkXnYWd4q9RpwuvYDGEUMPkYR3Ts9,5128886,28265031,-23136145,300
2022-05-05 15:19:12-04:00,17816,DX6DNEePMPiHBVFX2rDuFoy1fznGYDx6bUQB6qL6UAAb,FM9PNZ9HFZNPZDmg5mQRuMo9t49kDJEHM2CuZmNo6TnD,True,6418880876,1604720219,4783599,2391799,2391800,GXyFXZMNk2NFyEzw6JetVqsujqcz2yCixH7n8EpDJYWD,191343992,441815208,-250471216,298
2022-05-05 15:19:12-04:00,17817,7tFD53kPTqrzjCu1Wji78gUqhoRtCUhsP1pM3DQKT7uG,BJvgPLYBDJrQJdQVowrsMwUGMurq4zTihoFwWoEokfu3,True,6528535091,901726847,2625747,1312873,1312874,AmTrMPzuTp2BjnjqGNKqz9FTTCdpoKcPAJLwFc8ozcbh,190105072,934884202,-744779130,291
2022-05-05 15:19:18-04:00,17818,52Fpixjd4WYTgHTJhMAjZM2WfK1FnvgTBvZnTAtdQS3,FuyHHnw7DJ5ywPedp3kvdNBrNJ2Beyou1VNaP3eeFkK6,False,8816137,8816137,263801,13190,250611,3zqXX6kzhkbW3d4TwD2CNjMRwxTbREXySekvq37kfCNk,263801,1399873,-1136072,299
2022-05-05 20:54:44-04:00,17819,5nALef7nAfNkSQSuTBLwewDby4pUx74Gzqib33Znmmt6,8xNTWK2xNK2xZPpgXfcE4QxPT2i6YvNYakiLgdQ2FqEt,True,2324393706,581098426,1759861,879930,879931,5HnvdJnCCcmRsm4GkXnYWd4q9RpwuvYDGEUMPkYR3Ts9,70394463,116158326,-45763863,302
2022-05-06 00:05:05-04:00,17820,5nALef7nAfNkSQSuTBLwewDby4pUx74Gzqib33Znmmt6,8xNTWK2xNK2xZPpgXfcE4QxPT2i6YvNYakiLgdQ2FqEt,True,1726354501,431588625,1290345,645172,645173,2py1FiYeL2f7J3HU36qiJz6TD6HCmiTN36RyxYtapQCZ,51613807,102923417,-51309610,298
2022-05-06 00:11:39-04:00,17821,DF7yTsT1XTNjTiSadopuDnKdAt4P7Qc4jeY2tAUGk18F,6z2GLxexqxWvGa4vdc3jLMYyMx71PMoa6M4wHoqpeVEB,True,3704559145,926139786,2771629,1385814,1385815,GXyFXZMNk2NFyEzw6JetVqsujqcz2yCixH7n8EpDJYWD,110865175,185176376,-74311201,299
2022-05-06 00:15:10-04:00,17822,gCNpMXEHPTLvMvyyaYCLJrd8RRGnKAHz7sBD5j7yyBt,9cRU1ZAZRT5Ei4YAmCrPJZMHGsWspcYXTuZH58iexwDv,True,490569795,122642448,371577,185788,185789,gjBMZYVujDjD1ECG4i97M8Q3gV9ESnwwTSUGropkusj,14863090,68499430,-53636340,302
2022-05-06 00:22:42-04:00,17823,8DSiP9CwJm3AEcH6uuAYFpArRRDLYpDQgjHEvjkUgfg2,ERJ8kuhPRRmUAhSM4oxUheh39YUVVYNgaTt6AdMXcCvL,True,1554554373,388638593,1157319,578659,578660,2py1FiYeL2f7J3HU36qiJz6TD6HCmiTN36RyxYtapQCZ,46292766,423311249,-377018483,297
2022-05-06 00:22:42-04:00,17824,BmFSXZx3HWaTtD7vp7AkUk5DUNjwK1qgLPod13EJz6No,DtLMfV3Xs7AAAQqC1PwL7YAfV6fig8yAMxr9MMxmyCKc,True,69818318,17454579,52040,26020,26020,2a35JJeTUW1pm6M3e8DHCjp8qr4vbc2cRPhuzZWyFzYd,2081609,10380289,-8298680,298
2022-05-06 00:22:47-04:00,17825,4ZF1wtHKAnxmEZGACgbgphHvuo5aK4wC4MCNJzLYVkMX,5UXyhRP3Rjsc1RbV8BouJVQoTbWWbuPtVJY15KcHJFCN,True,171916451,42979112,125307,62653,62654,2a35JJeTUW1pm6M3e8DHCjp8qr4vbc2cRPhuzZWyFzYd,5012290,48241915,-43229625,291
2022-05-06 00:22:54-04:00,17826,Hgs1Lk2ESxULpgcbgayhLdHSDyw5Yr6RiNYhP8q9CHwC,42prjFMA3G8DGZxkgXRDupGkz9GFSxB2mu1ccnEqPhjv,True,55366831,13841707,41153,20576,20577,2a35JJeTUW1pm6M3e8DHCjp8qr4vbc2cRPhuzZWyFzYd,1646130,9121812,-7475682,297
2022-05-06 00:26:24-04:00,17827,EMFbiJWcw1YdjiDmxj5CsHMyswXyyHeL7cfWKa8dMzHh,2LjnVQF8WSwL8XSNVypW9SouYSRbyH9A7gcw7BFtxuXS,True,489227194,122306798,368305,184152,184153,A2p75MbAbeUdHkPLkAjgGeiwuu9WPrkMHzjCkDXF1Xr3,14732203,136705068,-121972865,301
2022-05-06 00:27:11-04:00,17828,9XmuJX8mFX29c5uh68kK7ff1mPdvs1orJAgEP6BsVKnq,HfPpizwUoK6uEmMb9LWi464BnvjHQY9cuPppFMp1DKDA,True,266451387,66612846,201538,100769,100769,68sueyVfmy5ToEGtLFGDkwebX47xAmzyXE29z8JrmcWv,8061557,29657179,-21595622,302
2022-05-06 00:27:12-04:00,17829,87yYQuRW91LAqEmqEyYah7obsr4KijRrqsKdK7DGA9w,EJzredSumMNBMTYxMMHocKayWKg3A3621QJ3ArJqro8r,True,145225124,36306281,109420,54710,54710,Hu94aiQWvce6THeGyCFqGRPM1pQrK3ihzkcXo1EpJcJL,4376807,40074267,-35697460,301
2022-05-06 00:29:27-04:00,17830,A7j77tzgnQVGtHTa65VtVZqJRYeJvQk7am8NW6e66379,4vJGwEvXU2tGWoWWGwbsYcfKQAMCHbrBMRk4ZVFzneLs,True,31454184024,7863546006,23129297,11564648,11564649,3zqXX6kzhkbW3d4TwD2CNjMRwxTbREXySekvq37kfCNk,925171883,4986193422,-4061021539,294
2022-05-06 00:29:28-04:00,17831,BhhVhLVZkSd3aHDMd6ojTgtJtbgAdMCA9Xj8jL2GMXoL,G8HUQp2yGSw9T6it5ej91cqkd82naca8heji453g2jEH,True,170069467,30287721,118651,59325,59326,Hu94aiQWvce6THeGyCFqGRPM1pQrK3ihzkcXo1EpJcJL,6662475,78716348,-72053873,391
2022-05-06 00:29:28-04:00,17832,1EH82ta3wXUyUwW8VWQnVzSG3r1rHcSj2DvDeTKmp3F,B6aMfucYPbCzWBtauLtgTpwR45wKSK8yqscHJR3F5usu,True,458121075,114530268,333180,166590,166590,68sueyVfmy5ToEGtLFGDkwebX47xAmzyXE29z8JrmcWv,13327210,36768426,-23441216,290
2022-05-06 00:29:30-04:00,17833,HqtTbC1LFreGvgfpZe7nCqkNnh8GHPQKosfmc19zb1yi,E39UNiHNkwQEd5GXkCtTPqSorQSB1kLx8kjzK4jdFoi3,True,466404024,116601006,348937,174468,174469,C4UnXuShCvjSMgBAgVNMy1oakxCNk1et27A82fywU112,13957503,81518281,-67560778,299
2022-05-06 00:29:32-04:00,17834,E3LF7ohKS87kHLW78ViuRuyw7EMuiW3nVn5PRdhU7iBj,DMVXNy2NLb8jMuznjx2syKqvzctrNmQ3PfiUA83CeQR4,True,213848796,53462199,158958,79479,79479,68sueyVfmy5ToEGtLFGDkwebX47xAmzyXE29z8JrmcWv,6358327,60665306,-54306979,297
2022-05-06 00:29:33-04:00,17835,5zqXqEjg95BnghcVbHRhYkSTYnzZjUBichgccv1BpS3d,9SuqSxrKpHh9NcNePe4Q3jXvpCmhNnoQv8YAFih3CqMX,True,1374817424,343704356,1033668,516834,516834,72XWPCtRYEDZbddP7d6dHtUBRRDLSJsB2xZTAfefoEVZ,41346725,391285684,-349938959,300
2022-05-06 00:36:31-04:00,17836,29JVska5UEG3axs63EmtHpPvkswNEqYpZ3PKMSfupiAG,DCftNBUsuogxyaJe9G9m3eWipH6o3qo4Rn4TuQXdVaBF,True,670480646,167620161,1045554,522777,522777,2py1FiYeL2f7J3HU36qiJz6TD6HCmiTN36RyxYtapQCZ,41822198,85479657,-43657459,623
2022-05-06 00:40:35-04:00,17837,BaFWQSYQQikWywyGiHgG25hEons9nW5zhvUTzp8oAcYU,7WyiB5TBMB49ctd4cZBExSJyD51JMYnokScjSWixoPdk,False,14504825,14504825,960925,48046,912879,2a35JJeTUW1pm6M3e8DHCjp8qr4vbc2cRPhuzZWyFzYd,960926,2699260,-1738334,662
2022-05-06 03:36:54-04:00,17838,DLwEaZipqHmVBD5hc5v1NZtDStHyG4hAMwxywDTGGc2e,28GtwJw67UWfrSKxtuvpzoKzPyKXLgP3GKLm3fHdR566,True,6337263258,1584315814,9886876,4943438,4943438,A9TwRM1BMxqb8DCC7YNAMV6zPenEJm3HTZBy7wJKK58U,395475079,761679531,-366204452,624
2022-05-06 03:39:02-04:00,17839,64Diz8zzEv1jDWnBQPTHPpXwaWf7vjM19RyJmkPy1viQ,G8wkGHRHMtT3mvXBkH3zgsKNs8wbpdiPUS17y4cozhkZ,True,201831772,50457943,313078,156539,156539,68sueyVfmy5ToEGtLFGDkwebX47xAmzyXE29z8JrmcWv,12523132,29086938,-16563806,620
2022-05-06 03:39:14-04:00,17840,68zbVKnneMQqngbNkeLtPEP2ayNhawc1B2hPgqAEqgXK,HqiFpLr4NC7xJz9bEFusq8bCKaoxAQG1xsLxdUAzg8aa,True,111388135,5362122,22587,11293,11294,68sueyVfmy5ToEGtLFGDkwebX47xAmzyXE29z8JrmcWv,4692166,53465163,-48772997,421
2022-05-06 03:39:31-04:00,17841,3qaXKaNNT8mpC4KnA868wYkDCojg8ukUVxN19dtfYbPM,5o21p7NCXgv5cYPtBqQVvR3Ses6mHceYgCNmd5VL3tkG,False,20325368,20325368,945712,47285,898427,5HnvdJnCCcmRsm4GkXnYWd4q9RpwuvYDGEUMPkYR3Ts9,945713,7179034,-6233321,465
2022-05-06 03:39:56-04:00,17842,26wo1RqwKXrNnfgMdZEmkGhnDbURpZcp2hasB5EA5QtD,34gwTVGRrdoaBzLUG6SBwRwBovkjBjCebqVUBan6GDnB,True,2542373662,635593415,4487090,2243545,2243545,GXyFXZMNk2NFyEzw6JetVqsujqcz2yCixH7n8EpDJYWD,179483624,1521848291,-1342364667,705
2022-05-06 03:39:56-04:00,17843,442usWu6XpJZvU25bqXeynRrQ15jAzWwU9DWMgHpTn3Q,CtvADKp39bjJf3cPKWNL3wxnhq273fVM4fC5DmEcg5cC,True,1280141144,127659047,549089,274544,274545,2a35JJeTUW1pm6M3e8DHCjp8qr4vbc2cRPhuzZWyFzYd,55061710,406709196,-351647486,430
2022-05-06 03:40:02-04:00,17844,68zbVKnneMQqngbNkeLtPEP2ayNhawc1B2hPgqAEqgXK,HqiFpLr4NC7xJz9bEFusq8bCKaoxAQG1xsLxdUAzg8aa,True,105702986,4948617,20348,10174,10174,Hu94aiQWvce6THeGyCFqGRPM1pQrK3ihzkcXo1EpJcJL,4346552,51648805,-47302253,411
2022-05-06 03:40:29-04:00,17845,29JVska5UEG3axs63EmtHpPvkswNEqYpZ3PKMSfupiAG,DCftNBUsuogxyaJe9G9m3eWipH6o3qo4Rn4TuQXdVaBF,True,492843945,123210986,767447,383723,383724,3zqXX6kzhkbW3d4TwD2CNjMRwxTbREXySekvq37kfCNk,30697899,73474491,-42776592,622
2022-05-06 03:40:29-04:00,17846,HCAGpyYM2NYudMd55Geta13tUbS6eiygnJY5ULHsHAVa,3PPyWhqXrmifWPieLV34bZ1rzi8eEnrDDAF7ifXkXspn,True,174752890,22461629,115339,57669,57670,Hu94aiQWvce6THeGyCFqGRPM1pQrK3ihzkcXo1EpJcJL,8973535,60753680,-51780145,513
2022-05-06 03:40:49-04:00,17847,68zbVKnneMQqngbNkeLtPEP2ayNhawc1B2hPgqAEqgXK,HqiFpLr4NC7xJz9bEFusq8bCKaoxAQG1xsLxdUAzg8aa,True,100396657,9001197,35579,17789,17790,68sueyVfmy5ToEGtLFGDkwebX47xAmzyXE29z8JrmcWv,3968492,48658301,-44689809,395
2022-05-06 03:41:07-04:00,17848,H7wVZszBQdmFuwMUYAw4SSYbjxeFY1QvNBuT8QiqTxZS,CUm235keNKnVd2BaCNp5a6HePtWGMo8dq8S1KXf2KRR4,True,74814830,18703707,51497,25748,25749,68sueyVfmy5ToEGtLFGDkwebX47xAmzyXE29z8JrmcWv,2059900,3748457,-1688557,275
2022-05-06 03:41:07-04:00,17849,7tFD53kPTqrzjCu1Wji78gUqhoRtCUhsP1pM3DQKT7uG,BJvgPLYBDJrQJdQVowrsMwUGMurq4zTihoFwWoEokfu3,True,5608357691,723780498,2152217,1076108,1076109,A2p75MbAbeUdHkPLkAjgGeiwuu9WPrkMHzjCkDXF1Xr3,166768845,834481860,-667713015,297
2022-05-06 03:41:08-04:00,17850,DF7yTsT1XTNjTiSadopuDnKdAt4P7Qc4jeY2tAUGk18F,6z2GLxexqxWvGa4vdc3jLMYyMx71PMoa6M4wHoqpeVEB,True,2752597852,688149463,2053279,1026639,1026640,72XWPCtRYEDZbddP7d6dHtUBRRDLSJsB2xZTAfefoEVZ,82131194,163803741,-81672547,298
2022-05-06 03:41:08-04:00,17851,DZnaFtxiEHUv3geRGsKufTnCUhkSMbN2M7W4Bwu2LgkM,A38xXBMxA13qQnVB1tcd5USxpfdaUGmkp31FeTmCyb52,True,21141940,2697337,19130,9565,9565,C4UnXuShCvjSMgBAgVNMy1oakxCNk1et27A82fywU112,1499495,13552535,-12053040,709
2022-05-06 03:41:11-04:00,17852,BhhVhLVZkSd3aHDMd6ojTgtJtbgAdMCA9Xj8jL2GMXoL,G8HUQp2yGSw9T6it5ej91cqkd82naca8heji453g2jEH,True,138874331,12047515,48874,24437,24437,5HnvdJnCCcmRsm4GkXnYWd4q9RpwuvYDGEUMPkYR3Ts9,5633948,63336249,-57702301,405
2022-05-06 03:41:11-04:00,17853,Fczxdc24Eav8xcaKRDwWMEwPEzkGyEJ7qGcXYyGZFKVz,8GqweYpec4cnpaJvueF3FGWoaz72BAzpLYXBX7tuuqEt,True,3087410309,771852577,2307145,1153572,1153573,AmTrMPzuTp2BjnjqGNKqz9FTTCdpoKcPAJLwFc8ozcbh,92285819,1667314683,-1575028864,298
2022-05-06 03:41:13-04:00,17854,BjCNaM7YbE9SjFi7tzi4677zg1fKXGJwtecz2GWwWuhd,6rNsSrKZezQrLb2whToNjnizpnurDXrobHqfEK3QqU1M,True,25119583,1852844,8643,4321,4322,2a35JJeTUW1pm6M3e8DHCjp8qr4vbc2cRPhuzZWyFzYd,1171863,13990406,-12818543,466
2022-05-06 03:41:14-04:00,17855,AsRi72uQLsBnyQxMBnPEhyQNM7XyNk2RV9GzPMe8PysA,9MqsYTBn6P9zCi5bGCrZurWWysW8XQZJwndHsb227rEW,True,337738600,84434650,249936,124968,124968,3zqXX6kzhkbW3d4TwD2CNjMRwxTbREXySekvq37kfCNk,9997449,95514116,-85516667,296
2022-05-06 03:41:17-04:00,17856,5xkW7wHTcF5WadNtBBqKPKctVwyQtTqqscivAmxzseCk,7m31ZMZdCn5Gz2q5sETWA7uKA5LsKD7pJHBBqU3g7tCn,True,126711990,31677997,93719,46859,46860,2a35JJeTUW1pm6M3e8DHCjp8qr4vbc2cRPhuzZWyFzYd,3748762,22321248,-18572486,295
2022-05-06 03:41:22-04:00,17857,FRbeFwhUYCiHW5oP26mad8KND7CCYDbfnoNxX7GuXVp8,GrzXKxPX2WDka8i2D8sunMUsrsThKasQi8NYLwuCGygV,True,2778256157,481983856,1921855,960927,960928,72XWPCtRYEDZbddP7d6dHtUBRRDLSJsB2xZTAfefoEVZ,110779817,870045045,-759265228,398
2022-05-06 03:41:27-04:00,17858,68zbVKnneMQqngbNkeLtPEP2ayNhawc1B2hPgqAEqgXK,HqiFpLr4NC7xJz9bEFusq8bCKaoxAQG1xsLxdUAzg8aa,True,91186840,8381229,34230,17115,17115,Hu94aiQWvce6THeGyCFqGRPM1pQrK3ihzkcXo1EpJcJL,3724293,43293699,-39569406,408
2022-05-06 03:41:33-04:00,17859,GKbDACVE2yR8WwrMeGfSQuSXLqXR3B1N5YzZ93i5xyeB,B5EEB6xDf7fwwaE6CaJjwsgCNNdUc29tjW1gY2pHiKxq,True,3278572741,478108585,3395590,1697795,1697795,DQCvC9mR68hJ3tJsUiddh6JwcBJAmntqGJR2nUsEq7yj,232848637,1397957433,-1165108796,710
2022-05-06 03:41:33-04:00,17860,CDVtXFbo4Rg2aHsXKv5P3uRJq9ZTgsRd7GXPTxgH5xv9,6zj37qQnaiJT7xGEZmSKx5yQvisQFcs5KhGsG43SGd5y,True,158084514,11722288,42901,21450,21451,C4UnXuShCvjSMgBAgVNMy1oakxCNk1et27A82fywU112,5785660,51224712,-45439052,365
2022-05-06 03:41:37-04:00,17861,gCNpMXEHPTLvMvyyaYCLJrd8RRGnKAHz7sBD5j7yyBt,9cRU1ZAZRT5Ei4YAmCrPJZMHGsWspcYXTuZH58iexwDv,True,364345571,91086392,272276,136138,136138,Hu94aiQWvce6THeGyCFqGRPM1pQrK3ihzkcXo1EpJcJL,10891074,54702350,-43811276,298
2022-05-06 03:41:37-04:00,17862,8DSiP9CwJm3AEcH6uuAYFpArRRDLYpDQgjHEvjkUgfg2,ERJ8kuhPRRmUAhSM4oxUheh39YUVVYNgaTt6AdMXcCvL,True,1155414073,288853518,864363,432181,432182,2a35JJeTUW1pm6M3e8DHCjp8qr4vbc2cRPhuzZWyFzYd,34574553,327865375,-293290822,299
2022-05-06 03:41:48-04:00,17863,GKbDACVE2yR8WwrMeGfSQuSXLqXR3B1N5YzZ93i5xyeB,B5EEB6xDf7fwwaE6CaJjwsgCNNdUc29tjW1gY2pHiKxq,True,2758296054,355519703,2413935,1206967,1206968,Hu94aiQWvce6THeGyCFqGRPM1pQrK3ihzkcXo1EpJcJL,187284945,1137317650,-950032705,678
2022-05-06 03:41:51-04:00,17864,26wo1RqwKXrNnfgMdZEmkGhnDbURpZcp2hasB5EA5QtD,34gwTVGRrdoaBzLUG6SBwRwBovkjBjCebqVUBan6GDnB,True,1840151700,460037925,2709199,1354599,1354600,DA18qE9qesbBqpwNv1M4befYcNQkbSBSeLPTmQzrmbJw,108367987,1182448099,-1074080112,588
2022-05-06 03:41:53-04:00,17865,DZnaFtxiEHUv3geRGsKufTnCUhkSMbN2M7W4Bwu2LgkM,A38xXBMxA13qQnVB1tcd5USxpfdaUGmkp31FeTmCyb52,True,18082378,4520594,27952,13976,13976,5HnvdJnCCcmRsm4GkXnYWd4q9RpwuvYDGEUMPkYR3Ts9,1118140,12266995,-11148855,618
2022-05-06 03:42:01-04:00,17866,BmFSXZx3HWaTtD7vp7AkUk5DUNjwK1qgLPod13EJz6No,DtLMfV3Xs7AAAQqC1PwL7YAfV6fig8yAMxr9MMxmyCKc,True,51901543,12975385,39117,19558,19559,2a35JJeTUW1pm6M3e8DHCjp8qr4vbc2cRPhuzZWyFzYd,1564715,8250968,-6686253,301
2022-05-06 03:42:09-04:00,17867,442usWu6XpJZvU25bqXeynRrQ15jAzWwU9DWMgHpTn3Q,CtvADKp39bjJf3cPKWNL3wxnhq273fVM4fC5DmEcg5cC,True,1144781642,94772772,387542,193771,193771,3zqXX6kzhkbW3d4TwD2CNjMRwxTbREXySekvq37kfCNk,46812166,345235559,-298423393,408
2022-05-06 03:44:11-04:00,17868,9VojCEgzn99QRVPGKn6euGRQbM7Q86GZ6yHJQa7N3gv4,GW4GVNnUtEt68avsowddpmjoUTUyMvxV4c5kY3Gzz9fT,True,29452342,2567972,16035,8017,8018,5HnvdJnCCcmRsm4GkXnYWd4q9RpwuvYDGEUMPkYR3Ts9,1839171,20101676,-18262505,624
2022-05-06 03:45:42-04:00,17869,7frvVhg1eWJpsvG7ndjppb8Bmd1tFq5H1g26UiKZxqTP,3Ugo9b53e6e8PLnvKjqRP8pvvoubSPV6qiKtxey7mrGt,True,148429841,37107460,111814,55907,55907,68sueyVfmy5ToEGtLFGDkwebX47xAmzyXE29z8JrmcWv,4472566,40981365,-36508799,301
2022-05-06 03:47:16-04:00,17870,F5vnN191nY9kUJBtFcm6fUhPDJvUSrSHLvfstesb68rH,9DtiZh3FsVmZA9MRqZhonAN2Pk4rQdcWw8As76DnQ6ee,True,5893594522,1473398630,4455348,2227674,2227674,DQCvC9mR68hJ3tJsUiddh6JwcBJAmntqGJR2nUsEq7yj,178213955,294982163,-116768208,302
2022-05-06 04:44:52-04:00,17871,26wo1RqwKXrNnfgMdZEmkGhnDbURpZcp2hasB5EA5QtD,34gwTVGRrdoaBzLUG6SBwRwBovkjBjCebqVUBan6GDnB,True,1371996869,342999217,2440198,1220099,1220099,A9TwRM1BMxqb8DCC7YNAMV6zPenEJm3HTZBy7wJKK58U,97607933,911659765,-814051832,711
2022-05-06 06:42:10-04:00,17872,GKbDACVE2yR8WwrMeGfSQuSXLqXR3B1N5YzZ93i5xyeB,B5EEB6xDf7fwwaE6CaJjwsgCNNdUc29tjW1gY2pHiKxq,True,2387657220,325693473,2318341,1159170,1159171,2xTUy2RS74GJMMDnmFaegMzFLn19RVfYG4CibhBmjP1i,169957488,938893800,-768936312,711
2022-05-06 06:51:28-04:00,17873,26wo1RqwKXrNnfgMdZEmkGhnDbURpZcp2hasB5EA5QtD,34gwTVGRrdoaBzLUG6SBwRwBovkjBjCebqVUBan6GDnB,True,1005154020,251288505,1783567,891783,891784,Hu94aiQWvce6THeGyCFqGRPM1pQrK3ihzkcXo1EpJcJL,71342704,705935501,-634592797,709
2022-05-06 06:56:48-04:00,17874,EdCSJVDrgnE7PN9GK7t1t7hB79mBrJzyy1mMZL9u5nvM,GTy9uEWcCx4odtr1GLPpntNbdR7wJRYr3wE9P5rAaMw6,True,127332386,31833096,95700,47850,47850,5HnvdJnCCcmRsm4GkXnYWd4q9RpwuvYDGEUMPkYR3Ts9,3828038,14747183,-10919145,300
2022-05-06 06:56:56-04:00,17875,5QxR9QPTADFys9VQNm473RgprTikCXC23vhsBc9ojyAQ,H9zdf8nJ4JCF7jrwGsxiuiFoa14gzDmYsZ5N5ig3UGna,True,638521577,159630394,480152,240076,240076,2a35JJeTUW1pm6M3e8DHCjp8qr4vbc2cRPhuzZWyFzYd,19206087,57914420,-38708333,300
2022-05-06 06:56:59-04:00,17876,7zDNgPFeomS1hdQhuY8iGF3nnGMNnx1YrinZJetrefje,AKyG5R6Bac6Fu83ruL9FGpjKCfDKxbP6QfEGbCgqegiV,False,26077737,26077737,793294,39664,753630,3zqXX6kzhkbW3d4TwD2CNjMRwxTbREXySekvq37kfCNk,793295,4007973,-3214678,304
2022-05-06 06:57:02-04:00,17877,9RtNbEZ4ZR8T1HFF4cujPVy2kejVBKFo3CPQi8psSa1q,7zwaGb71jKc9y2HKCKy5q2XV2YUphkyU1hkDaab1GBas,True,646893603,159674053,475244,237622,237622,gjBMZYVujDjD1ECG4i97M8Q3gV9ESnwwTSUGropkusj,19253789,203460148,-184206359,297
2022-05-06 06:57:04-04:00,17878,AggAFLRnGWU7X97a3sWRKV7wDDRiAGn9Q4azmEYXAo1k,Dj4DzvpxgQiRoad1zTXoNTrgGTDHG9NvMeCzzRZSxkvs,True,284068012,47895238,194756,97378,97378,Hu94aiQWvce6THeGyCFqGRPM1pQrK3ihzkcXo1EpJcJL,11551092,59530612,-47979520,406
2022-05-06 06:57:43-04:00,17879,FRbeFwhUYCiHW5oP26mad8KND7CCYDbfnoNxX7GuXVp8,GrzXKxPX2WDka8i2D8sunMUsrsThKasQi8NYLwuCGygV,True,2283596276,211743346,890476,445238,445238,DA18qE9qesbBqpwNv1M4befYcNQkbSBSeLPTmQzrmbJw,96035590,757637994,-661602404,420
2022-05-06 06:57:52-04:00,17880,3WcJUt8jQ1ngL3ZCGo6dFrc3GmTMTYtzeDva7mri2Tqx,HeG1Pz2oMjqtkfsRMsbqP3VpatnVEQzcWmKDVoFp4Htr,True,18763208,4690802,29245,14622,14623,68sueyVfmy5ToEGtLFGDkwebX47xAmzyXE29z8JrmcWv,1169818,8848598,-7678780,623
2022-05-06 06:57:54-04:00,17881,E4VzeJLsf5Y6t3yNi8VpS8QxhJbJGPhnkNBmU2XoCBs9,63CXyYfevXtrL1QcfQtAhz29xeea5BwWcj6d6BWb4qiB,True,35014681042,8753670260,24853504,12426752,12426752,6UQfSsLooL4pQKQfLtXCutQS2BnF7A7F7ewJopDLmUpc,994140181,11061638662,-10067498481,283
2022-05-06 06:57:54-04:00,17882,DZnaFtxiEHUv3geRGsKufTnCUhkSMbN2M7W4Bwu2LgkM,A38xXBMxA13qQnVB1tcd5USxpfdaUGmkp31FeTmCyb52,False,13425482,13425482,955115,47755,907360,C4UnXuShCvjSMgBAgVNMy1oakxCNk1et27A82fywU112,955116,9453084,-8497968,711
2022-05-06 06:57:54-04:00,17883,68gVM4kjmSYxT1uJW13rYSway8uVLUdcLa7sJuqHQaAf,DshroBQ3da7BcAiQpiFREsLKWbUDrBRmmZRw3Zu2Qfs9,True,4337240467,1084310116,2708838,1354419,1354419,5HnvdJnCCcmRsm4GkXnYWd4q9RpwuvYDGEUMPkYR3Ts9,108353556,634499455,-526145899,249
2022-05-06 06:57:59-04:00,17884,442usWu6XpJZvU25bqXeynRrQ15jAzWwU9DWMgHpTn3Q,CtvADKp39bjJf3cPKWNL3wxnhq273fVM4fC5DmEcg5cC,True,1042549702,189161239,706216,353108,353108,C4UnXuShCvjSMgBAgVNMy1oakxCNk1et27A82fywU112,38922653,298134233,-259211580,373
2022-05-06 06:57:59-04:00,17885,7frvVhg1eWJpsvG7ndjppb8Bmd1tFq5H1g26UiKZxqTP,3Ugo9b53e6e8PLnvKjqRP8pvvoubSPV6qiKtxey7mrGt,True,110145101,27536275,79570,39785,39785,C4UnXuShCvjSMgBAgVNMy1oakxCNk1et27A82fywU112,3182801,31742574,-28559773,288
2022-05-06 06:58:01-04:00,17886,F5vnN191nY9kUJBtFcm6fUhPDJvUSrSHLvfstesb68rH,9DtiZh3FsVmZA9MRqZhonAN2Pk4rQdcWw8As76DnQ6ee,True,4378883042,1094720760,3310476,1655238,1655238,C4UnXuShCvjSMgBAgVNMy1oakxCNk1et27A82fywU112,132419061,262460993,-130041932,302
2022-05-06 06:58:05-04:00,17887,CKK8bNCGjTn8qR6JoY5woqo2rrQHPMRawDGNfDsrg4Zd,46jXZ7r4uPrHnRJsnRnXHdDWjjjAbi8smmHbxxLhuwVg,True,86558160,21639540,59719,29859,29860,2a35JJeTUW1pm6M3e8DHCjp8qr4vbc2cRPhuzZWyFzYd,2388777,5879010,-3490233,275
2022-05-06 06:58:07-04:00,17888,9pzwKSceogMgCeZjstNqHbiLHeQb4mzD4j9kSmNxbe8x,93AY1zEbBweMV2ur9A65vzmSb79Mkrr2Wi1XuLYijSm9,True,52240073,13060018,38811,19405,19406,2a35JJeTUW1pm6M3e8DHCjp8qr4vbc2cRPhuzZWyFzYd,1552443,14449305,-12896862,297
2022-05-06 06:58:16-04:00,17889,4nj9fNW5K5hZebNaCP8PDTismTb5HK4MsJLUPLsnfN7P,B4UmvQqxb4Sc35L3YzuGR8BSQC2qKd6e4Byxni7ncYkf,True,153682734,38420683,114723,57361,57362,2a35JJeTUW1pm6M3e8DHCjp8qr4vbc2cRPhuzZWyFzYd,4588932,21291970,-16703038,298
2022-05-06 06:58:19-04:00,17890,6pAs5S7zGX77DHSYUuCxvxbf2FQQHQhbBmAYLd3iJvWS,HNTWEhsrnEe8FeVDpEcxuoD5PnuveB5BwSf3gdBmhzxv,True,81544935,20386233,61094,30547,30547,C4UnXuShCvjSMgBAgVNMy1oakxCNk1et27A82fywU112,2443788,12708807,-10265019,299
2022-05-06 07:11:14-04:00,17891,AggAFLRnGWU7X97a3sWRKV7wDDRiAGn9Q4azmEYXAo1k,Dj4DzvpxgQiRoad1zTXoNTrgGTDHG9NvMeCzzRZSxkvs,True,234750598,22864275,96714,48357,48357,YQC4EUcgeBi9431viwvzvBbZJW3szeHX4dFmowRDyDw,9929761,54078733,-44148972,422
2022-05-06 07:12:19-04:00,17892,CDVtXFbo4Rg2aHsXKv5P3uRJq9ZTgsRd7GXPTxgH5xv9,6zj37qQnaiJT7xGEZmSKx5yQvisQFcs5KhGsG43SGd5y,True,145964864,5213084,19068,9534,9534,5HnvdJnCCcmRsm4GkXnYWd4q9RpwuvYDGEUMPkYR3Ts9,5339071,48244576,-42905505,365
2022-05-06 07:12:24-04:00,17893,E56pqwjJ773ovVX4fNf5YACoqMTspgSh5YjGNvwTam5h,6sUwG5onnHCjwaff4nrBXxMqJ7tMrA5DYYFF8YdEp6TJ,True,107350404,26837601,79363,39681,39682,C4UnXuShCvjSMgBAgVNMy1oakxCNk1et27A82fywU112,3174541,10322094,-7147553,295
2022-05-06 07:12:40-04:00,17894,HT2SuCbePhjNZaar24uVwihYowCNvSjdvhJ8BRSVw9nX,98Ts4LCnapHVoCJ5PW3Armvh4jvDtpfs3SYRLRxiAgzZ,True,484015270,31738052,157162,78581,78581,2a35JJeTUW1pm6M3e8DHCjp8qr4vbc2cRPhuzZWyFzYd,23967832,174935614,-150967782,495
2022-05-06 07:12:44-04:00,17895,68zbVKnneMQqngbNkeLtPEP2ayNhawc1B2hPgqAEqgXK,HqiFpLr4NC7xJz9bEFusq8bCKaoxAQG1xsLxdUAzg8aa,True,82575569,4014268,16807,8403,8404,5HnvdJnCCcmRsm4GkXnYWd4q9RpwuvYDGEUMPkYR3Ts9,3457473,41002850,-37545377,418
2022-05-06 07:12:46-04:00,17896,GNohZMtk1VAuhLAgNGT8J3HYCKDCiyjvLeAWr64d7Duy,6soTLVj9DzFht8DzvjRfNPAWhZuiDBS5fDE1fpeuDSSz,True,189392881,47348220,294489,147244,147245,C4UnXuShCvjSMgBAgVNMy1oakxCNk1et27A82fywU112,11779581,97361618,-85582037,621
2022-05-06 07:12:53-04:00,17897,7tFD53kPTqrzjCu1Wji78gUqhoRtCUhsP1pM3DQKT7uG,BJvgPLYBDJrQJdQVowrsMwUGMurq4zTihoFwWoEokfu3,True,4867000756,672657520,2024773,1012386,1012387,72XWPCtRYEDZbddP7d6dHtUBRRDLSJsB2xZTAfefoEVZ,146502144,734744298,-588242154,301
2022-05-06 07:12:57-04:00,17898,64Diz8zzEv1jDWnBQPTHPpXwaWf7vjM19RyJmkPy1viQ,G8wkGHRHMtT3mvXBkH3zgsKNs8wbpdiPUS17y4cozhkZ,True,147748604,36937151,213932,106966,106966,Hu94aiQWvce6THeGyCFqGRPM1pQrK3ihzkcXo1EpJcJL,8557302,24606952,-16049650,579
2022-05-06 07:12:57-04:00,17899,HooxSzasW3HMoFJ6sAvRQ75Char1J5aBdJtsqfDV6myp,BCmsWwpGeV4NNfeKZKKydty2uueLGHYTJDk1WErpXsVT,True,853850741,213462685,1332196,666098,666098,3zqXX6kzhkbW3d4TwD2CNjMRwxTbREXySekvq37kfCNk,53287844,131858643,-78570799,624
2022-05-06 07:12:59-04:00,17900,442usWu6XpJZvU25bqXeynRrQ15jAzWwU9DWMgHpTn3Q,CtvADKp39bjJf3cPKWNL3wxnhq273fVM4fC5DmEcg5cC,True,849875527,70499580,287698,143849,143849,C4UnXuShCvjSMgBAgVNMy1oakxCNk1et27A82fywU112,34682168,267239829,-232557661,408
2022-05-06 07:26:25-04:00,17901,CDVtXFbo4Rg2aHsXKv5P3uRJq9ZTgsRd7GXPTxgH5xv9,6zj37qQnaiJT7xGEZmSKx5yQvisQFcs5KhGsG43SGd5y,True,140549528,10081339,36708,18354,18354,5HnvdJnCCcmRsm4GkXnYWd4q9RpwuvYDGEUMPkYR3Ts9,5117751,49688594,-44570843,364
2022-05-06 07:26:51-04:00,17902,4ZF1wtHKAnxmEZGACgbgphHvuo5aK4wC4MCNJzLYVkMX,5UXyhRP3Rjsc1RbV8BouJVQoTbWWbuPtVJY15KcHJFCN,True,127905938,31976484,96164,48082,48082,C4UnXuShCvjSMgBAgVNMy1oakxCNk1et27A82fywU112,3846560,37300492,-33453932,300
2022-05-06 07:26:51-04:00,17903,68zbVKnneMQqngbNkeLtPEP2ayNhawc1B2hPgqAEqgXK,HqiFpLr4NC7xJz9bEFusq8bCKaoxAQG1xsLxdUAzg8aa,True,78348285,3659761,15076,7538,7538,C4UnXuShCvjSMgBAgVNMy1oakxCNk1et27A82fywU112,3227650,39633389,-36405739,411
2022-05-06 07:27:00-04:00,17904,FRbeFwhUYCiHW5oP26mad8KND7CCYDbfnoNxX7GuXVp8,GrzXKxPX2WDka8i2D8sunMUsrsThKasQi8NYLwuCGygV,True,2058852666,356430658,1421128,710564,710564,A2p75MbAbeUdHkPLkAjgGeiwuu9WPrkMHzjCkDXF1Xr3,82088724,676545771,-594457047,398
2022-05-06 07:27:03-04:00,17905,5QxR9QPTADFys9VQNm473RgprTikCXC23vhsBc9ojyAQ,H9zdf8nJ4JCF7jrwGsxiuiFoa14gzDmYsZ5N5ig3UGna,True,474538783,118634695,359192,179596,179596,3zqXX6kzhkbW3d4TwD2CNjMRwxTbREXySekvq37kfCNk,14367686,47765424,-33397738,302
2022-05-06 07:27:03-04:00,17906,4hZG7dM716SxDagiFGwt1gSC99B2QK1emGLV9TJmmuR8,7vjfUWySkyx4Z5qAaRr2VWnVvxHHNsvPj1PirGNSjM6,True,311735323,77933830,487047,243523,243524,3zqXX6kzhkbW3d4TwD2CNjMRwxTbREXySekvq37kfCNk,19481909,209987130,-190505221,624
2022-05-06 07:27:04-04:00,17907,HT2SuCbePhjNZaar24uVwihYowCNvSjdvhJ8BRSVw9nX,98Ts4LCnapHVoCJ5PW3Armvh4jvDtpfs3SYRLRxiAgzZ,True,449828582,31722362,150646,75323,75323,Hu94aiQWvce6THeGyCFqGRPM1pQrK3ihzkcXo1EpJcJL,21362034,174715903,-153353869,474
2022-05-06 07:27:05-04:00,17908,HCAGpyYM2NYudMd55Geta13tUbS6eiygnJY5ULHsHAVa,3PPyWhqXrmifWPieLV34bZ1rzi8eEnrDDAF7ifXkXspn,True,150673822,16621631,79838,39919,39919,68sueyVfmy5ToEGtLFGDkwebX47xAmzyXE29z8JrmcWv,7237342,55780252,-48542910,480
2022-05-06 07:27:06-04:00,17909,Ht5tqGiAf5tF8nRVDnpdvj7B9vNot6ijzykEDtQypxYC,2C7i83GfaXauAsZH3WMFofJdzNCpxeaQvVJ72iQb4fQM,False,14692988,14692988,908637,45431,863206,5HnvdJnCCcmRsm4GkXnYWd4q9RpwuvYDGEUMPkYR3Ts9,908637,7328904,-6420267,618
2022-05-06 07:27:07-04:00,17910,EdCSJVDrgnE7PN9GK7t1t7hB79mBrJzyy1mMZL9u5nvM,GTy9uEWcCx4odtr1GLPpntNbdR7wJRYr3wE9P5rAaMw6,True,94556448,23639112,69708,34854,34854,5HnvdJnCCcmRsm4GkXnYWd4q9RpwuvYDGEUMPkYR3Ts9,2788331,11921106,-9132775,294
2022-05-06 07:27:07-04:00,17911,CDVtXFbo4Rg2aHsXKv5P3uRJq9ZTgsRd7GXPTxgH5xv9,6zj37qQnaiJT7xGEZmSKx5yQvisQFcs5KhGsG43SGd5y,True,130212918,9394124,34815,17407,17408,2a35JJeTUW1pm6M3e8DHCjp8qr4vbc2cRPhuzZWyFzYd,4825772,44753001,-39927229,370
2022-05-06 07:27:07-04:00,17912,Hgs1Lk2ESxULpgcbgayhLdHSDyw5Yr6RiNYhP8q9CHwC,42prjFMA3G8DGZxkgXRDupGkz9GFSxB2mu1ccnEqPhjv,True,41153687,10288421,30765,15382,15383,C4UnXuShCvjSMgBAgVNMy1oakxCNk1et27A82fywU112,1230634,7208863,-5978229,299
2022-05-06 07:27:15-04:00,17913,EVMrznfJS54BZiywDD2WhUtxzicDtbEpm2a5yLrtCgRF,CpzsMYVYvKg8ihrX1cKRw7TDEYwD3kAyiX92hsf2KiTz,True,7780506421,910373846,5224377,2612188,2612189,AmTrMPzuTp2BjnjqGNKqz9FTTCdpoKcPAJLwFc8ozcbh,446501229,4816980925,-4370479696,573
2022-05-06 07:27:16-04:00,17914,EMFbiJWcw1YdjiDmxj5CsHMyswXyyHeL7cfWKa8dMzHh,2LjnVQF8WSwL8XSNVypW9SouYSRbyH9A7gcw7BFtxuXS,True,363211371,90802842,265729,132864,132865,Hu94aiQWvce6THeGyCFqGRPM1pQrK3ihzkcXo1EpJcJL,10629179,105820371,-95191192,292
2022-05-06 07:27:18-04:00,17915,87yYQuRW91LAqEmqEyYah7obsr4KijRrqsKdK7DGA9w,EJzredSumMNBMTYxMMHocKayWKg3A3621QJ3ArJqro8r,True,107870778,26967694,80292,40146,40146,C4UnXuShCvjSMgBAgVNMy1oakxCNk1et27A82fywU112,3211690,31033072,-27821382,297
2022-05-06 07:27:19-04:00,17916,5o4EAqBTiUKn41QhPL5kRjrGTgQVdP7xLtxC7xNxjkwn,E8gDreu3LxW1EHJ8hnqChK9QdffGh5GocJYKdrbYat8E,True,29353021,7338255,45452,22726,22726,YQC4EUcgeBi9431viwvzvBbZJW3szeHX4dFmowRDyDw,1818099,15951862,-14133763,619
2022-05-06 07:27:20-04:00,17917,BKmKy8n1MpB1sdSfuWy7P3c6ReSW8TEWZRsyriz3ujYo,FgRpiZFPz43vDWStgCwRJACiGKtMLkWbTGeTLPeKnnaY,True,364355041,91088760,270659,135329,135330,3zqXX6kzhkbW3d4TwD2CNjMRwxTbREXySekvq37kfCNk,10826369,104816667,-93990298,297
2022-05-06 07:27:22-04:00,17918,BjCNaM7YbE9SjFi7tzi4677zg1fKXGJwtecz2GWwWuhd,6rNsSrKZezQrLb2whToNjnizpnurDXrobHqfEK3QqU1M,True,23146354,3007274,13545,6772,6773,2a35JJeTUW1pm6M3e8DHCjp8qr4vbc2cRPhuzZWyFzYd,1042609,12542737,-11500128,450
2022-05-06 07:27:23-04:00,17919,8sUHtr1dGhr9xBUiUYNknaFnHRW3Xyp2dPEviRia5NTL,CA4Zfp28QYkjaBz4JKKjn8Qrm5qn4VVS75MAxSAqLDqN,False,12899821,12899821,798172,39908,758264,YQC4EUcgeBi9431viwvzvBbZJW3szeHX4dFmowRDyDw,798172,8992197,-8194025,618
2022-05-06 07:27:24-04:00,17920,9RtNbEZ4ZR8T1HFF4cujPVy2kejVBKFo3CPQi8psSa1q,7zwaGb71jKc9y2HKCKy5q2XV2YUphkyU1hkDaab1GBas,True,483080875,118747219,359720,179860,179860,2a35JJeTUW1pm6M3e8DHCjp8qr4vbc2cRPhuzZWyFzYd,14633962,157301927,-142667965,302
2022-05-06 07:27:25-04:00,17921,9XmuJX8mFX29c5uh68kK7ff1mPdvs1orJAgEP6BsVKnq,HfPpizwUoK6uEmMb9LWi464BnvjHQY9cuPppFMp1DKDA,True,197893846,49473461,147533,73766,73767,C4UnXuShCvjSMgBAgVNMy1oakxCNk1et27A82fywU112,5901323,24043381,-18142058,298
2022-05-06 07:27:52-04:00,17922,9VojCEgzn99QRVPGKn6euGRQbM7Q86GZ6yHJQa7N3gv4,GW4GVNnUtEt68avsowddpmjoUTUyMvxV4c5kY3Gzz9fT,True,26734365,2515926,15707,7853,7854,2a35JJeTUW1pm6M3e8DHCjp8qr4vbc2cRPhuzZWyFzYd,1669100,18689853,-17020753,624
2022-05-06 07:28:06-04:00,17923,68zbVKnneMQqngbNkeLtPEP2ayNhawc1B2hPgqAEqgXK,HqiFpLr4NC7xJz9bEFusq8bCKaoxAQG1xsLxdUAzg8aa,True,74459637,6689629,26806,13403,13403,Hu94aiQWvce6THeGyCFqGRPM1pQrK3ihzkcXo1EpJcJL,2983687,37338984,-34355297,400
2022-05-06 07:28:10-04:00,17924,68gVM4kjmSYxT1uJW13rYSway8uVLUdcLa7sJuqHQaAf,DshroBQ3da7BcAiQpiFREsLKWbUDrBRmmZRw3Zu2Qfs9,True,3245465703,811366425,2453500,1226750,1226750,68sueyVfmy5ToEGtLFGDkwebX47xAmzyXE29z8JrmcWv,98140017,500903889,-402763872,302
2022-05-06 07:28:10-04:00,17925,Ga6hKu2mWpMqDboq3ZajdiittrTvDqX9kqMDt2fi3t29,3zUEyHaYdzLGMZxDj2EZLCA6NzL7Ub9BGpE5PGGnw2GD,True,23565618,5891404,36641,18320,18321,C4UnXuShCvjSMgBAgVNMy1oakxCNk1et27A82fywU112,1465670,15400522,-13934852,621
2022-05-06 07:28:11-04:00,17926,93Jp2cnKVsSUcpoNEXmuq3K17MWt7JkW3jx6v5v2UAvN,5bos8dvpCKDxeYbXxRXwEdY8tAMZoL2XhNKUdFKxTrd6,True,253689771,30613699,139206,69603,69603,YQC4EUcgeBi9431viwvzvBbZJW3szeHX4dFmowRDyDw,11535825,157829757,-146293932,454
2022-05-06 07:28:13-04:00,17927,9BjYvRf5A9UK99LvPTHd5DRvxMn2FWYKb5fpDxYDL48S,4kMo5gLVscVqwx6xQTLrn9JaEq1dFqq5Vfiq3Vb15vhi,True,24322171,6080542,37828,18914,18914,5HnvdJnCCcmRsm4GkXnYWd4q9RpwuvYDGEUMPkYR3Ts9,1513125,14691167,-13178042,622
2022-05-06 07:28:15-04:00,17928,H7wVZszBQdmFuwMUYAw4SSYbjxeFY1QvNBuT8QiqTxZS,CUm235keNKnVd2BaCNp5a6HePtWGMo8dq8S1KXf2KRR4,True,55790237,13947559,42160,21080,21080,Hu94aiQWvce6THeGyCFqGRPM1pQrK3ihzkcXo1EpJcJL,1686436,3273789,-1587353,302
2022-05-06 07:28:19-04:00,17929,EvyJwXTqP5N4qPKwDiDTCfjLYgLWz1qEREsarcsZdhYD,CbnajpQJxW3fWpH9dohsipVnZJyUvqy5dYSRDBBaDeEp,True,24322140,6080535,37835,18917,18918,Hu94aiQWvce6THeGyCFqGRPM1pQrK3ihzkcXo1EpJcJL,1513419,14691809,-13178390,622
2022-05-06 07:28:26-04:00,17930,7tFD53kPTqrzjCu1Wji78gUqhoRtCUhsP1pM3DQKT7uG,BJvgPLYBDJrQJdQVowrsMwUGMurq4zTihoFwWoEokfu3,True,4175544407,539765681,1624625,812312,812313,72XWPCtRYEDZbddP7d6dHtUBRRDLSJsB2xZTAfefoEVZ,125678542,657366721,-531688179,300
2022-05-06 07:28:26-04:00,17931,BhhVhLVZkSd3aHDMd6ojTgtJtbgAdMCA9Xj8jL2GMXoL,G8HUQp2yGSw9T6it5ej91cqkd82naca8heji453g2jEH,True,126220855,22543156,88941,44470,44471,5HnvdJnCCcmRsm4GkXnYWd4q9RpwuvYDGEUMPkYR3Ts9,4979946,60351805,-55371859,394
2022-05-06 07:28:36-04:00,17932,CDVtXFbo4Rg2aHsXKv5P3uRJq9ZTgsRd7GXPTxgH5xv9,6zj37qQnaiJT7xGEZmSKx5yQvisQFcs5KhGsG43SGd5y,True,120563894,8662069,32589,16294,16295,2a35JJeTUW1pm6M3e8DHCjp8qr4vbc2cRPhuzZWyFzYd,4536057,41614978,-37078921,376
2022-05-06 07:28:56-04:00,17933,GCNi25P1Ywvfx5JpyxFVV68sRkio7LEhFgY85ZqveKR3,34mxz8fCss7KNAbEi2Wj9z5dTgXCGxuq2vyqzBPChtmq,True,5771764438,1442941109,4364933,2182466,2182467,A2p75MbAbeUdHkPLkAjgGeiwuu9WPrkMHzjCkDXF1Xr3,174597345,1454858596,-1280261251,302
2022-05-06 07:32:09-04:00,17934,A7j77tzgnQVGtHTa65VtVZqJRYeJvQk7am8NW6e66379,4vJGwEvXU2tGWoWWGwbsYcfKQAMCHbrBMRk4ZVFzneLs,True,23380273058,5845068264,17250437,8625218,8625219,DQCvC9mR68hJ3tJsUiddh6JwcBJAmntqGJR2nUsEq7yj,690017513,3955570930,-3265553417,295
2022-05-06 07:32:11-04:00,17935,E3LF7ohKS87kHLW78ViuRuyw7EMuiW3nVn5PRdhU7iBj,DMVXNy2NLb8jMuznjx2syKqvzctrNmQ3PfiUA83CeQR4,True,158876177,39719044,116941,58470,58471,Hu94aiQWvce6THeGyCFqGRPM1pQrK3ihzkcXo1EpJcJL,4677674,46918812,-42241138,294
2022-05-06 07:32:11-04:00,17936,HqtTbC1LFreGvgfpZe7nCqkNnh8GHPQKosfmc19zb1yi,E39UNiHNkwQEd5GXkCtTPqSorQSB1kLx8kjzK4jdFoi3,True,346499631,86624907,257014,128507,128507,68sueyVfmy5ToEGtLFGDkwebX47xAmzyXE29z8JrmcWv,10280588,64256660,-53976072,296
2022-05-06 07:32:11-04:00,17937,HT2SuCbePhjNZaar24uVwihYowCNvSjdvhJ8BRSVw9nX,98Ts4LCnapHVoCJ5PW3Armvh4jvDtpfs3SYRLRxiAgzZ,True,416244527,56778145,263940,131970,131970,2a35JJeTUW1pm6M3e8DHCjp8qr4vbc2cRPhuzZWyFzYd,19349695,161780271,-142430576,464
2022-05-06 07:32:11-04:00,17938,5zqXqEjg95BnghcVbHRhYkSTYnzZjUBichgccv1BpS3d,9SuqSxrKpHh9NcNePe4Q3jXvpCmhNnoQv8YAFih3CqMX,True,1021399090,255349772,763164,381582,381582,5HnvdJnCCcmRsm4GkXnYWd4q9RpwuvYDGEUMPkYR3Ts9,30526588,302714787,-272188199,298
2022-05-06 07:33:35-04:00,17939,AggAFLRnGWU7X97a3sWRKV7wDDRiAGn9Q4azmEYXAo1k,Dj4DzvpxgQiRoad1zTXoNTrgGTDHG9NvMeCzzRZSxkvs,True,210516637,35540016,142880,71440,71440,gjBMZYVujDjD1ECG4i97M8Q3gV9ESnwwTSUGropkusj,8463361,46983918,-38520557,402
2022-05-06 08:31:30-04:00,17940,5XcrJqz4M3F7d5SruWRSWLH8zY6cDVwTXbqcA2Y5YLBS,6gJ1xLxAQ1HW4WRpBx7LhHiQuqqdMvLxSdeeNUS5NFsi,True,234603295,58650823,412116,206058,206058,68sueyVfmy5ToEGtLFGDkwebX47xAmzyXE29z8JrmcWv,16484665,22621575,-6136910,702
2022-05-06 09:35:41-04:00,17941,HT2SuCbePhjNZaar24uVwihYowCNvSjdvhJ8BRSVw9nX,98Ts4LCnapHVoCJ5PW3Armvh4jvDtpfs3SYRLRxiAgzZ,True,357464864,23100409,110299,55149,55150,2a35JJeTUW1pm6M3e8DHCjp8qr4vbc2cRPhuzZWyFzYd,17068129,135843359,-118775230,477
2022-05-06 09:35:44-04:00,17942,DHv4AsHMRZ6DuPaKEr2cLMNsX2ezT75T9haNgsDngS2b,5pMurvHHPdPKg3R96o1fKBbJh2Mc2tBP6P1e3acB31vQ,True,103133089,25783272,159627,79813,79814,68sueyVfmy5ToEGtLFGDkwebX47xAmzyXE29z8JrmcWv,6385116,15095340,-8710224,619
2022-05-06 09:36:00-04:00,17943,CKK8bNCGjTn8qR6JoY5woqo2rrQHPMRawDGNfDsrg4Zd,46jXZ7r4uPrHnRJsnRnXHdDWjjjAbi8smmHbxxLhuwVg,True,64530585,16132646,48518,24259,24259,68sueyVfmy5ToEGtLFGDkwebX47xAmzyXE29z8JrmcWv,1940754,4946719,-3005965,300
2022-05-06 09:36:06-04:00,17944,BSDeCyJsPs6y1pbDVHNq5rs6tdxcrbY3NDjXPBxwRjHz,DjHD3jawBVikzjcQ5dXBRLdUmEeBHKt6JZLhvmjScDku,True,694777156,132767776,399746,199873,199873,DA18qE9qesbBqpwNv1M4befYcNQkbSBSeLPTmQzrmbJw,20918860,234285737,-213366877,301
2022-05-06 09:36:07-04:00,17945,DX6DNEePMPiHBVFX2rDuFoy1fznGYDx6bUQB6qL6UAAb,FM9PNZ9HFZNPZDmg5mQRuMo9t49kDJEHM2CuZmNo6TnD,True,4772451231,1193112807,3515215,1757607,1757608,72XWPCtRYEDZbddP7d6dHtUBRRDLSJsB2xZTAfefoEVZ,140608602,370697908,-230089306,294
2022-05-06 09:36:10-04:00,17946,4oMasDRj8HWfknmdwt6Mkz3eonr8J2byoiSTRo4sCnFQ,3emcATkEFvDVETiK97eVET2Z2jzkgiiSxX3gu5wsUKPe,True,23447121274,2751169410,18207093,9103546,9103547,68sueyVfmy5ToEGtLFGDkwebX47xAmzyXE29z8JrmcWv,1551718063,5887907264,-4336189201,661
2022-05-06 09:36:14-04:00,17947,BjCNaM7YbE9SjFi7tzi4677zg1fKXGJwtecz2GWwWuhd,6rNsSrKZezQrLb2whToNjnizpnurDXrobHqfEK3QqU1M,False,20071037,20071037,960442,48022,912420,5HnvdJnCCcmRsm4GkXnYWd4q9RpwuvYDGEUMPkYR3Ts9,960444,11226697,-10266253,478
2022-05-06 09:36:18-04:00,17948,E4VzeJLsf5Y6t3yNi8VpS8QxhJbJGPhnkNBmU2XoCBs9,63CXyYfevXtrL1QcfQtAhz29xeea5BwWcj6d6BWb4qiB,True,26041421609,6510355402,18739703,9369851,9369852,6UQfSsLooL4pQKQfLtXCutQS2BnF7A7F7ewJopDLmUpc,749588159,8571412270,-7821824111,287
2022-05-06 09:36:18-04:00,17949,FRbeFwhUYCiHW5oP26mad8KND7CCYDbfnoNxX7GuXVp8,GrzXKxPX2WDka8i2D8sunMUsrsThKasQi8NYLwuCGygV,True,1690204658,157568304,637350,318675,318675,2a35JJeTUW1pm6M3e8DHCjp8qr4vbc2cRPhuzZWyFzYd,68367403,587164900,-518797497,404
2022-05-06 09:36:20-04:00,17950,442usWu6XpJZvU25bqXeynRrQ15jAzWwU9DWMgHpTn3Q,CtvADKp39bjJf3cPKWNL3wxnhq273fVM4fC5DmEcg5cC,True,773723898,140423776,521416,260708,260708,2a35JJeTUW1pm6M3e8DHCjp8qr4vbc2cRPhuzZWyFzYd,28729665,231352755,-202623090,371
2022-05-06 09:36:21-04:00,17951,CDVtXFbo4Rg2aHsXKv5P3uRJq9ZTgsRd7GXPTxgH5xv9,6zj37qQnaiJT7xGEZmSKx5yQvisQFcs5KhGsG43SGd5y,True,111595350,3855033,14485,7242,7243,C4UnXuShCvjSMgBAgVNMy1oakxCNk1et27A82fywU112,4193213,39250742,-35057529,375
2022-05-06 09:36:22-04:00,17952,4SQQdHTJUDv8taPXQRvEVJpUu91iCWQsv9su8tfehaQG,33CJXj1pmmatAofRvgt5in9E6SLEuy7tq4jqSwnUWP2A,True,34607035,8651758,53653,26826,26827,C4UnXuShCvjSMgBAgVNMy1oakxCNk1et27A82fywU112,2146138,40818370,-38672232,620
2022-05-06 09:36:25-04:00,17953,F5vnN191nY9kUJBtFcm6fUhPDJvUSrSHLvfstesb68rH,9DtiZh3FsVmZA9MRqZhonAN2Pk4rQdcWw8As76DnQ6ee,True,3251387750,812846937,2408010,1204005,1204005,2a35JJeTUW1pm6M3e8DHCjp8qr4vbc2cRPhuzZWyFzYd,96320424,227272178,-130951754,296
2022-05-06 09:36:25-04:00,17954,7frvVhg1eWJpsvG7ndjppb8Bmd1tFq5H1g26UiKZxqTP,3Ugo9b53e6e8PLnvKjqRP8pvvoubSPV6qiKtxey7mrGt,True,81739599,20434899,55841,27920,27921,C4UnXuShCvjSMgBAgVNMy1oakxCNk1et27A82fywU112,2233662,24523219,-22289557,273
2022-05-06 09:36:26-04:00,17955,DxmkdZiygge1YAwbL8U6LudY3QJkSnZMHThQXkE4Z5qy,Gi8oNcSDphbtosjFudeEPtX88bUnYid1tL9FnXnLfASU,True,269422651,67355662,186692,93346,93346,2a35JJeTUW1pm6M3e8DHCjp8qr4vbc2cRPhuzZWyFzYd,7467716,28332062,-20864346,277
2022-05-06 09:36:27-04:00,17956,gCNpMXEHPTLvMvyyaYCLJrd8RRGnKAHz7sBD5j7yyBt,9cRU1ZAZRT5Ei4YAmCrPJZMHGsWspcYXTuZH58iexwDv,True,270536386,67634096,197061,98530,98531,C4UnXuShCvjSMgBAgVNMy1oakxCNk1et27A82fywU112,7882449,43464956,-35582507,291
2022-05-06 09:36:27-04:00,17957,68zbVKnneMQqngbNkeLtPEP2ayNhawc1B2hPgqAEqgXK,HqiFpLr4NC7xJz9bEFusq8bCKaoxAQG1xsLxdUAzg8aa,True,67366566,9112082,34525,17262,17263,2a35JJeTUW1pm6M3e8DHCjp8qr4vbc2cRPhuzZWyFzYd,2552609,33253303,-30700694,378
2022-05-06 09:36:29-04:00,17958,4ZF1wtHKAnxmEZGACgbgphHvuo5aK4wC4MCNJzLYVkMX,5UXyhRP3Rjsc1RbV8BouJVQoTbWWbuPtVJY15KcHJFCN,True,95009800,23752450,70695,35347,35348,C4UnXuShCvjSMgBAgVNMy1oakxCNk1et27A82fywU112,2827833,28838111,-26010278,297
2022-05-06 09:36:29-04:00,17959,Fczxdc24Eav8xcaKRDwWMEwPEzkGyEJ7qGcXYyGZFKVz,8GqweYpec4cnpaJvueF3FGWoaz72BAzpLYXBX7tuuqEt,True,2290017605,572504401,1608094,804047,804047,2xTUy2RS74GJMMDnmFaegMzFLn19RVfYG4CibhBmjP1i,64323780,1271257095,-1206933315,280
2022-05-06 09:36:31-04:00,17960,DF7yTsT1XTNjTiSadopuDnKdAt4P7Qc4jeY2tAUGk18F,6z2GLxexqxWvGa4vdc3jLMYyMx71PMoa6M4wHoqpeVEB,True,2041430066,510357516,1423931,711965,711966,DA18qE9qesbBqpwNv1M4befYcNQkbSBSeLPTmQzrmbJw,56957279,141295881,-84338602,279
2022-05-06 09:36:31-04:00,17961,EdCSJVDrgnE7PN9GK7t1t7hB79mBrJzyy1mMZL9u5nvM,GTy9uEWcCx4odtr1GLPpntNbdR7wJRYr3wE9P5rAaMw6,True,70274156,17568539,51900,25950,25950,YQC4EUcgeBi9431viwvzvBbZJW3szeHX4dFmowRDyDw,2076022,9569105,-7493083,295
2022-05-06 09:36:33-04:00,17962,8DSiP9CwJm3AEcH6uuAYFpArRRDLYpDQgjHEvjkUgfg2,ERJ8kuhPRRmUAhSM4oxUheh39YUVVYNgaTt6AdMXcCvL,True,857857237,214464309,624096,312048,312048,Hu94aiQWvce6THeGyCFqGRPM1pQrK3ihzkcXo1EpJcJL,24963878,253649454,-228685576,291
2022-05-06 09:36:34-04:00,17963,5xkW7wHTcF5WadNtBBqKPKctVwyQtTqqscivAmxzseCk,7m31ZMZdCn5Gz2q5sETWA7uKA5LsKD7pJHBBqU3g7tCn,True,93975677,23493919,64800,32400,32400,C4UnXuShCvjSMgBAgVNMy1oakxCNk1et27A82fywU112,2592018,17579855,-14987837,275
2022-05-06 09:36:36-04:00,17964,BhhVhLVZkSd3aHDMd6ojTgtJtbgAdMCA9Xj8jL2GMXoL,G8HUQp2yGSw9T6it5ej91cqkd82naca8heji453g2jEH,True,103024562,8943537,36783,18391,18392,47z82br5WdW2DZajdnPDPSSRRKsyAggqXqK6oPUwTaLf,4237244,48645284,-44408040,411
2022-05-06 09:36:40-04:00,17965,5nALef7nAfNkSQSuTBLwewDby4pUx74Gzqib33Znmmt6,8xNTWK2xNK2xZPpgXfcE4QxPT2i6YvNYakiLgdQ2FqEt,True,802320158,200580039,593359,296679,296680,GXyFXZMNk2NFyEzw6JetVqsujqcz2yCixH7n8EpDJYWD,23734372,40056095,-16321723,295
2022-05-06 09:36:41-04:00,17966,CDVtXFbo4Rg2aHsXKv5P3uRJq9ZTgsRd7GXPTxgH5xv9,6zj37qQnaiJT7xGEZmSKx5yQvisQFcs5KhGsG43SGd5y,True,107534955,7470948,27604,13802,13802,Hu94aiQWvce6THeGyCFqGRPM1pQrK3ihzkcXo1EpJcJL,3973366,40278790,-36305424,369
2022-05-06 09:36:41-04:00,17967,7tFD53kPTqrzjCu1Wji78gUqhoRtCUhsP1pM3DQKT7uG,BJvgPLYBDJrQJdQVowrsMwUGMurq4zTihoFwWoEokfu3,True,3620554093,502593635,1506359,753179,753180,2xTUy2RS74GJMMDnmFaegMzFLn19RVfYG4CibhBmjP1i,108514235,579536641,-471022406,299
2022-05-06 09:36:42-04:00,17968,9pzwKSceogMgCeZjstNqHbiLHeQb4mzD4j9kSmNxbe8x,93AY1zEbBweMV2ur9A65vzmSb79Mkrr2Wi1XuLYijSm9,True,38822630,9705657,28719,14359,14360,3zqXX6kzhkbW3d4TwD2CNjMRwxTbREXySekvq37kfCNk,1148794,11178908,-10030114,295
2022-05-06 09:36:43-04:00,17969,82EMpA1hwF9KNQy2ZB2A1HdoEowBu2CoYhW3VmohkSnk,hn67zsTzsAs2aqk6ZjfEeoRygd3CdMeCuR82h9yuiz3,True,610192729,152548182,452426,226213,226213,3zqXX6kzhkbW3d4TwD2CNjMRwxTbREXySekvq37kfCNk,18097055,173789240,-155692185,296
2022-05-06 09:36:43-04:00,17970,GKbDACVE2yR8WwrMeGfSQuSXLqXR3B1N5YzZ93i5xyeB,B5EEB6xDf7fwwaE6CaJjwsgCNNdUc29tjW1gY2pHiKxq,True,2037383766,265795664,1866796,933398,933398,DA18qE9qesbBqpwNv1M4befYcNQkbSBSeLPTmQzrmbJw,143094184,887376470,-744282286,702
2022-05-06 09:36:44-04:00,17971,AsRi72uQLsBnyQxMBnPEhyQNM7XyNk2RV9GzPMe8PysA,9MqsYTBn6P9zCi5bGCrZurWWysW8XQZJwndHsb227rEW,True,250472429,62618107,172585,86292,86293,72FwbpFGoLEazJEdpqNtPNefsadUrimUqma9wSoy4qiS,6903439,73873668,-66970229,275
2022-05-06 09:36:46-04:00,17972,6pAs5S7zGX77DHSYUuCxvxbf2FQQHQhbBmAYLd3iJvWS,HNTWEhsrnEe8FeVDpEcxuoD5PnuveB5BwSf3gdBmhzxv,True,60601564,15150391,45349,22674,22675,C4UnXuShCvjSMgBAgVNMy1oakxCNk1et27A82fywU112,1813984,10069979,-8255995,299
2022-05-06 09:36:47-04:00,17973,BmFSXZx3HWaTtD7vp7AkUk5DUNjwK1qgLPod13EJz6No,DtLMfV3Xs7AAAQqC1PwL7YAfV6fig8yAMxr9MMxmyCKc,True,38524825,9631206,28058,14029,14029,47z82br5WdW2DZajdnPDPSSRRKsyAggqXqK6oPUwTaLf,1122335,6538384,-5416049,291
2022-05-06 09:36:49-04:00,17974,HCAGpyYM2NYudMd55Geta13tUbS6eiygnJY5ULHsHAVa,3PPyWhqXrmifWPieLV34bZ1rzi8eEnrDDAF7ifXkXspn,True,132901761,12362730,55836,27918,27918,2a35JJeTUW1pm6M3e8DHCjp8qr4vbc2cRPhuzZWyFzYd,6002539,51829867,-45827328,451
2022-05-06 09:36:54-04:00,17975,Gwj6CMXQeoWVsmD775Knsm6BmWuysFvSKo78FRLQByb4,6cvChMYj7TfDcnc8hG9H89PABJr2svspqjJSdSGD4RUt,True,30594955,4144699,25783,12891,12892,68sueyVfmy5ToEGtLFGDkwebX47xAmzyXE29z8JrmcWv,1903255,8424725,-6521470,622
2022-05-06 09:36:54-04:00,17976,HT2SuCbePhjNZaar24uVwihYowCNvSjdvhJ8BRSVw9nX,98Ts4LCnapHVoCJ5PW3Armvh4jvDtpfs3SYRLRxiAgzZ,True,333368144,23604310,113016,56508,56508,3zqXX6kzhkbW3d4TwD2CNjMRwxTbREXySekvq37kfCNk,15961519,134982316,-119020797,478
2022-05-06 09:36:54-04:00,17977,Hgs1Lk2ESxULpgcbgayhLdHSDyw5Yr6RiNYhP8q9CHwC,42prjFMA3G8DGZxkgXRDupGkz9GFSxB2mu1ccnEqPhjv,False,30587499,30587499,921165,46058,875107,C4UnXuShCvjSMgBAgVNMy1oakxCNk1et27A82fywU112,921165,5682621,-4761456,301
2022-05-06 09:36:57-04:00,17978,AL8JFS4gjaQx89f9j8wtaNJgV76K8bw1ugvNtgvhgAnb,HJYvG2kGKe8kXgtZSWTWwTmSjxA3XUeCvyT7acoKtS1C,True,121171194102,22079164648,64103343,32051671,32051672,3zqXX6kzhkbW3d4TwD2CNjMRwxTbREXySekvq37kfCNk,3518012976,20852052373,-17334039397,290
2022-05-06 09:36:57-04:00,17979,9qGz5Mh1XNUXqY1vEg5S1ZEMzPFvBLRbp1qaXwxSFMby,D8KnbVXStSUz3QhZGzY5o853ASocjkyu9x682oHgVoZh,True,98771460711,17632559470,56070404,28035202,28035202,72XWPCtRYEDZbddP7d6dHtUBRRDLSJsB2xZTAfefoEVZ,3140868882,18877711525,-15736842643,317
2022-05-06 09:36:57-04:00,17980,DX6DNEePMPiHBVFX2rDuFoy1fznGYDx6bUQB6qL6UAAb,FM9PNZ9HFZNPZDmg5mQRuMo9t49kDJEHM2CuZmNo6TnD,True,3549748523,887437130,2687587,1343793,1343794,DA18qE9qesbBqpwNv1M4befYcNQkbSBSeLPTmQzrmbJw,107503486,309955274,-202451788,302
2022-05-06 09:36:57-04:00,17981,qDomXCaxa3BBJSuLnKRAHvBLMbMcWAzUNXtGDZTSD8F,57ch9yViUFJCGJcWUvNEDU1yGzC6AvPh4Ac3ynWZzLf1,True,17503376,4375844,25757,12878,12879,C4UnXuShCvjSMgBAgVNMy1oakxCNk1et27A82fywU112,1030302,11652119,-10621817,588
2022-05-06 09:36:58-04:00,17982,7BEY9qatFJomsayFmky3h3dAbKhY5XkRGwMobJuxXYhQ,J8MK3tAQKreBUG2reXY6gqr1uhbHhcAZEcxsLQmG5Ntt,True,855410778,213852694,1499045,749522,749523,DA18qE9qesbBqpwNv1M4befYcNQkbSBSeLPTmQzrmbJw,59961805,266088824,-206127019,700
2022-05-06 09:37:01-04:00,17983,BAe9q4b1UwvQi5BHTmVh2GRguY3f9a5fbzXV2WiB93Ag,9uSCD3c3vHYC1i6odskxdugUaoSE5QYA1e8wkkW6aX5W,True,24258587,6064646,36205,18102,18103,C4UnXuShCvjSMgBAgVNMy1oakxCNk1et27A82fywU112,1448232,14689839,-13241607,596
2022-05-06 09:37:01-04:00,17984,9VojCEgzn99QRVPGKn6euGRQbM7Q86GZ6yHJQa7N3gv4,GW4GVNnUtEt68avsowddpmjoUTUyMvxV4c5kY3Gzz9fT,True,24020913,2240326,13556,6778,6778,Hu94aiQWvce6THeGyCFqGRPM1pQrK3ihzkcXo1EpJcJL,1453590,17228103,-15774513,605
2022-05-06 09:37:02-04:00,17985,2pcVNktE3dbyybTuEBSkdwWJS5sFcvYLMEKRQMwZy6eh,61GaKj6fDApZF9B3aTBxTzYk8e22XLFPsQ21pJdvDhBL,True,24241887,6060471,35716,17858,17858,C4UnXuShCvjSMgBAgVNMy1oakxCNk1et27A82fywU112,1428648,14686903,-13258255,589
2022-05-06 09:37:05-04:00,17986,E56pqwjJ773ovVX4fNf5YACoqMTspgSh5YjGNvwTam5h,6sUwG5onnHCjwaff4nrBXxMqJ7tMrA5DYYFF8YdEp6TJ,True,79522757,19880689,52363,26181,26182,C4UnXuShCvjSMgBAgVNMy1oakxCNk1et27A82fywU112,2094539,8445402,-6350863,263
2022-05-06 09:37:06-04:00,17987,Cb6MEn1MN9XQcVVd3o9J8QdK3cFWxSNETsFzhVJ8jmdh,A6yTKbggUftjbjAVu5YR1M7rg7h78ghbfofmTSnmKNGz,True,406439073,101609768,254811,127405,127406,2py1FiYeL2f7J3HU36qiJz6TD6HCmiTN36RyxYtapQCZ,10192453,20117713,-9925260,250
2022-05-06 09:37:07-04:00,17988,4nj9fNW5K5hZebNaCP8PDTismTb5HK4MsJLUPLsnfN7P,B4UmvQqxb4Sc35L3YzuGR8BSQC2qKd6e4Byxni7ncYkf,True,113318836,28329709,62729,31364,31365,C4UnXuShCvjSMgBAgVNMy1oakxCNk1et27A82fywU112,2509184,16980000,-14470816,221
2022-05-06 09:37:08-04:00,17989,DkKumyFA6dGw77wcwd16nWzTEC9McvmasAbmGfQXLkB7,9u6QyrruYFjhyLV5AXYUKkrBggzrxXfNH57smUAap5Ro,True,62234675,13253530,41497,20748,20749,C4UnXuShCvjSMgBAgVNMy1oakxCNk1et27A82fywU112,1948632,13101908,-11153276,313
2022-05-06 09:37:08-04:00,17990,5QxR9QPTADFys9VQNm473RgprTikCXC23vhsBc9ojyAQ,H9zdf8nJ4JCF7jrwGsxiuiFoa14gzDmYsZ5N5ig3UGna,True,352249774,88062443,258927,129463,129464,DA18qE9qesbBqpwNv1M4befYcNQkbSBSeLPTmQzrmbJw,10357088,39067595,-28710507,294
2022-05-06 09:37:09-04:00,17991,CDVtXFbo4Rg2aHsXKv5P3uRJq9ZTgsRd7GXPTxgH5xv9,6zj37qQnaiJT7xGEZmSKx5yQvisQFcs5KhGsG43SGd5y,True,99739598,6960889,25273,12636,12637,68sueyVfmy5ToEGtLFGDkwebX47xAmzyXE29z8JrmcWv,3621353,36486957,-32865604,363
2022-05-06 09:37:12-04:00,17992,4nj9fNW5K5hZebNaCP8PDTismTb5HK4MsJLUPLsnfN7P,B4UmvQqxb4Sc35L3YzuGR8BSQC2qKd6e4Byxni7ncYkf,True,84988899,21247224,61155,30577,30578,YQC4EUcgeBi9431viwvzvBbZJW3szeHX4dFmowRDyDw,2446227,13299747,-10853520,287
2022-05-06 09:37:13-04:00,17993,G85GTorkDswyxv8uxgpP1tr6DbXktiXjjX14VA4L2VVu,3EJ5raXpu6eveda4FjxAeWFNbDbQkgjyKfoFq183UeLC,True,24217594,6054398,36461,18230,18231,72FwbpFGoLEazJEdpqNtPNefsadUrimUqma9wSoy4qiS,1458465,14683928,-13225463,602
2022-05-06 09:37:15-04:00,17994,EneQUyUwfKFNwfdgNRdZBdX2frHixmVDK2GxDRU78QB,Gk8BVo53foZz1tMdLf85ZKpAPeLFZbCqwM6KYhmN6WNc,True,17503284,4375821,26311,13155,13156,72FwbpFGoLEazJEdpqNtPNefsadUrimUqma9wSoy4qiS,1052453,11674594,-10622141,601
2022-05-06 09:37:18-04:00,17995,EVMrznfJS54BZiywDD2WhUtxzicDtbEpm2a5yLrtCgRF,CpzsMYVYvKg8ihrX1cKRw7TDEYwD3kAyiX92hsf2KiTz,True,6812380318,722572202,4060478,2030239,2030239,3zqXX6kzhkbW3d4TwD2CNjMRwxTbREXySekvq37kfCNk,382820194,4296601512,-3913781318,561
2022-05-06 09:37:18-04:00,17996,4YNWVEq2F3gR8XEbUQxJRqzi6i5KSfwf6mVMLPJrnpEd,EE5uomX5guX4ZeHiP6wcoH5C8k3tRGXo18JTWgNDqs1C,True,24238107,6059526,35617,17808,17809,72FwbpFGoLEazJEdpqNtPNefsadUrimUqma9wSoy4qiS,1424708,14687062,-13262354,587
2022-05-06 09:37:19-04:00,17997,GpDhvRRae2uiRZ6MnJYnVR2hANNLGFGUDnsQmGjfK8AP,B2pgJ4gPdgzvx2HMJ1wagtthpZebtBk7RD3cF1zqSyT8,True,1100855915,275213978,795965,397982,397983,2xTUy2RS74GJMMDnmFaegMzFLn19RVfYG4CibhBmjP1i,31838618,348488987,-316650369,289
2022-05-06 09:37:20-04:00,17998,7tFD53kPTqrzjCu1Wji78gUqhoRtCUhsP1pM3DQKT7uG,BJvgPLYBDJrQJdQVowrsMwUGMurq4zTihoFwWoEokfu3,True,3103140563,401793141,1193645,596822,596823,DA18qE9qesbBqpwNv1M4befYcNQkbSBSeLPTmQzrmbJw,92187981,519572632,-427384651,297
2022-05-06 09:37:20-04:00,17999,12GjTFcAZ5rnnR9DwXDUMmjFoyuFa3txDF4PPA4YoAQq,Ebm7YVYTYyMtEBM4STgbyyLuSFTwnnuFDQ1Wysvtj2vR,True,43639704,10909926,66983,33491,33492,2a35JJeTUW1pm6M3e8DHCjp8qr4vbc2cRPhuzZWyFzYd,2679351,12614983,-9935632,613
2022-05-06 09:37:20-04:00,18000,9RtNbEZ4ZR8T1HFF4cujPVy2kejVBKFo3CPQi8psSa1q,7zwaGb71jKc9y2HKCKy5q2XV2YUphkyU1hkDaab1GBas,True,360396843,88093785,252748,126374,126374,DA18qE9qesbBqpwNv1M4befYcNQkbSBSeLPTmQzrmbJw,10340094,121671227,-111331133,286
2022-05-06 09:37:20-04:00,18001,7FL3AxJZcTiCG6Ux7CVc82Nqo4msgmQASGvjfMEgQddc,EzcAwNya2eA7GD8ezmi49bEUP57Fq3w9SwN3uAG4HA2b,True,24240441,6060110,36104,18052,18052,68sueyVfmy5ToEGtLFGDkwebX47xAmzyXE29z8JrmcWv,1444175,14688277,-13244102,595
2022-05-06 09:37:24-04:00,18002,DLwEaZipqHmVBD5hc5v1NZtDStHyG4hAMwxywDTGGc2e,28GtwJw67UWfrSKxtuvpzoKzPyKXLgP3GKLm3fHdR566,True,4655790184,1163947546,7223891,3611945,3611946,DA18qE9qesbBqpwNv1M4befYcNQkbSBSeLPTmQzrmbJw,288955678,661065085,-372109407,620
2022-05-06 09:37:24-04:00,18003,9V7DXwq3RnVnLqRmtWXQJZgU3nHyVMteXAvaVaW3g1b6,94zfTWn693sbx9aaxamLUSHsbXdYxLpZVTvnetJ3SnhT,True,24254700,6063675,35866,17933,17933,C4UnXuShCvjSMgBAgVNMy1oakxCNk1et27A82fywU112,1434678,14680490,-13245812,591
2022-05-06 09:37:26-04:00,18004,68gVM4kjmSYxT1uJW13rYSway8uVLUdcLa7sJuqHQaAf,DshroBQ3da7BcAiQpiFREsLKWbUDrBRmmZRw3Zu2Qfs9,True,2409679085,602419771,1782156,891078,891078,2xTUy2RS74GJMMDnmFaegMzFLn19RVfYG4CibhBmjP1i,71286245,398167037,-326880792,295
2022-05-06 09:37:28-04:00,18005,AggAFLRnGWU7X97a3sWRKV7wDDRiAGn9Q4azmEYXAo1k,Dj4DzvpxgQiRoad1zTXoNTrgGTDHG9NvMeCzzRZSxkvs,True,173926808,17064160,71273,35636,35637,68sueyVfmy5ToEGtLFGDkwebX47xAmzyXE29z8JrmcWv,7264598,42513428,-35248830,417
2022-05-06 09:37:30-04:00,18006,68zbVKnneMQqngbNkeLtPEP2ayNhawc1B2hPgqAEqgXK,HqiFpLr4NC7xJz9bEFusq8bCKaoxAQG1xsLxdUAzg8aa,True,58127347,2737768,11261,5630,5631,C4UnXuShCvjSMgBAgVNMy1oakxCNk1et27A82fywU112,2390947,30329171,-27938224,411
2022-05-06 09:37:31-04:00,18007,93Jp2cnKVsSUcpoNEXmuq3K17MWt7JkW3jx6v5v2UAvN,5bos8dvpCKDxeYbXxRXwEdY8tAMZoL2XhNKUdFKxTrd6,True,221075190,22796142,96803,48401,48402,2a35JJeTUW1pm6M3e8DHCjp8qr4vbc2cRPhuzZWyFzYd,9387999,138296996,-128908997,424
2022-05-06 09:37:37-04:00,18008,CDVtXFbo4Rg2aHsXKv5P3uRJq9ZTgsRd7GXPTxgH5xv9,6zj37qQnaiJT7xGEZmSKx5yQvisQFcs5KhGsG43SGd5y,True,92635000,6432672,23973,11986,11987,2a35JJeTUW1pm6M3e8DHCjp8qr4vbc2cRPhuzZWyFzYd,3452371,34049563,-30597192,372
2022-05-06 09:37:38-04:00,18009,DkKumyFA6dGw77wcwd16nWzTEC9McvmasAbmGfQXLkB7,9u6QyrruYFjhyLV5AXYUKkrBggzrxXfNH57smUAap5Ro,True,48828697,9903404,35588,17794,17794,2a35JJeTUW1pm6M3e8DHCjp8qr4vbc2cRPhuzZWyFzYd,1754687,11978544,-10223857,359
2022-05-06 09:37:39-04:00,18010,Cb6MEn1MN9XQcVVd3o9J8QdK3cFWxSNETsFzhVJ8jmdh,A6yTKbggUftjbjAVu5YR1M7rg7h78ghbfofmTSnmKNGz,True,303700459,75925114,220219,110109,110110,2a35JJeTUW1pm6M3e8DHCjp8qr4vbc2cRPhuzZWyFzYd,8808796,17383687,-8574891,290
2022-05-06 09:37:39-04:00,18011,9qGz5Mh1XNUXqY1vEg5S1ZEMzPFvBLRbp1qaXwxSFMby,D8KnbVXStSUz3QhZGzY5o853ASocjkyu9x682oHgVoZh,True,80900181796,13173643781,46345051,23172525,23172526,gjBMZYVujDjD1ECG4i97M8Q3gV9ESnwwTSUGropkusj,2846079033,16135345353,-13289266320,351
2022-05-06 09:37:42-04:00,18012,7pSnDcmWQwSn6MfHFoAVEwgo7tZvrg2YkToH1hgSr4sT,5jj8izGNSZDY6S7sR5sWp8npcgXPTcTLjeU7mkhtBmqs,True,501342384,91303799,267026,133513,133513,3zqXX6kzhkbW3d4TwD2CNjMRwxTbREXySekvq37kfCNk,14662204,84489335,-69827131,292
2022-05-06 09:37:45-04:00,18013,E56pqwjJ773ovVX4fNf5YACoqMTspgSh5YjGNvwTam5h,6sUwG5onnHCjwaff4nrBXxMqJ7tMrA5DYYFF8YdEp6TJ,True,59315755,14828938,42896,21448,21448,68sueyVfmy5ToEGtLFGDkwebX47xAmzyXE29z8JrmcWv,1715863,6805409,-5089546,289
2022-05-06 09:37:47-04:00,18014,6pAs5S7zGX77DHSYUuCxvxbf2FQQHQhbBmAYLd3iJvWS,HNTWEhsrnEe8FeVDpEcxuoD5PnuveB5BwSf3gdBmhzxv,True,44849415,11212353,29171,14585,14586,YQC4EUcgeBi9431viwvzvBbZJW3szeHX4dFmowRDyDw,1166877,7960684,-6793807,260
2022-05-06 09:37:48-04:00,18015,9pzwKSceogMgCeZjstNqHbiLHeQb4mzD4j9kSmNxbe8x,93AY1zEbBweMV2ur9A65vzmSb79Mkrr2Wi1XuLYijSm9,False,28823198,28823198,826300,41315,784985,3zqXX6kzhkbW3d4TwD2CNjMRwxTbREXySekvq37kfCNk,826300,8642685,-7816385,286
2022-05-06 09:38:21-04:00,18016,3WcJUt8jQ1ngL3ZCGo6dFrc3GmTMTYtzeDva7mri2Tqx,HeG1Pz2oMjqtkfsRMsbqP3VpatnVEQzcWmKDVoFp4Htr,False,13776774,13776774,842185,42109,800076,5HnvdJnCCcmRsm4GkXnYWd4q9RpwuvYDGEUMPkYR3Ts9,842185,6896908,-6054723,611
2022-05-06 09:39:30-04:00,18017,HooxSzasW3HMoFJ6sAvRQ75Char1J5aBdJtsqfDV6myp,BCmsWwpGeV4NNfeKZKKydty2uueLGHYTJDk1WErpXsVT,True,627707547,156926886,979620,489810,489810,YQC4EUcgeBi9431viwvzvBbZJW3szeHX4dFmowRDyDw,39184811,110801450,-71616639,624
2022-05-06 09:40:15-04:00,18018,3S97kmJCtH7xQsdt7jsSyncXZiDQ9W8D8Pe3eT98Xopo,TvE4rh5GFsaAYo4MpkueYkuDPjbbuFmsBCdYyfAikLg,True,17925351,4481337,27870,13935,13935,2a35JJeTUW1pm6M3e8DHCjp8qr4vbc2cRPhuzZWyFzYd,1114830,11314665,-10199835,621
2022-05-06 09:40:39-04:00,18019,87yYQuRW91LAqEmqEyYah7obsr4KijRrqsKdK7DGA9w,EJzredSumMNBMTYxMMHocKayWKg3A3621QJ3ArJqro8r,True,80182169,20045542,60200,30100,30100,2a35JJeTUW1pm6M3e8DHCjp8qr4vbc2cRPhuzZWyFzYd,2408022,23995098,-21587076,300
2022-05-06 09:40:39-04:00,18020,BKmKy8n1MpB1sdSfuWy7P3c6ReSW8TEWZRsyriz3ujYo,FgRpiZFPz43vDWStgCwRJACiGKtMLkWbTGeTLPeKnnaY,True,270832993,67708248,202852,101426,101426,C4UnXuShCvjSMgBAgVNMy1oakxCNk1et27A82fywU112,8114110,81041535,-72927425,299
2022-05-06 09:40:39-04:00,18021,EMFbiJWcw1YdjiDmxj5CsHMyswXyyHeL7cfWKa8dMzHh,2LjnVQF8WSwL8XSNVypW9SouYSRbyH9A7gcw7BFtxuXS,True,269947625,67486906,197356,98678,98678,68sueyVfmy5ToEGtLFGDkwebX47xAmzyXE29z8JrmcWv,7894261,81749969,-73855708,292
2022-05-06 09:40:41-04:00,18022,9XmuJX8mFX29c5uh68kK7ff1mPdvs1orJAgEP6BsVKnq,HfPpizwUoK6uEmMb9LWi464BnvjHQY9cuPppFMp1DKDA,True,147098528,36774632,110685,55342,55343,2a35JJeTUW1pm6M3e8DHCjp8qr4vbc2cRPhuzZWyFzYd,4427418,19356181,-14928763,300
2022-05-06 09:47:15-04:00,18023,4hZG7dM716SxDagiFGwt1gSC99B2QK1emGLV9TJmmuR8,7vjfUWySkyx4Z5qAaRr2VWnVvxHHNsvPj1PirGNSjM6,True,229116428,57279107,356916,178458,178458,Hu94aiQWvce6THeGyCFqGRPM1pQrK3ihzkcXo1EpJcJL,14276679,161842243,-147565564,623
2022-05-06 09:47:29-04:00,18024,5g5EaEMiM2WQcfDpL3R3caYziX9xvGCFs9eVmmQdcgzS,J71CftCqiK1873fkVx9NGc7v7nvRZMYVBkGN3GhSPyeX,True,35930705,8982676,62848,31424,31424,5HnvdJnCCcmRsm4GkXnYWd4q9RpwuvYDGEUMPkYR3Ts9,2513952,12824928,-10310976,699
2022-05-06 09:48:13-04:00,18025,Ai6G7vosJfmkRqtDAkqxRtbzELp6P5xe9r2RH3LYcLZt,8SUpKXakmhi4rYiFKnHYpgaAopomfDqEX6Efew9iM6nk,True,346570163,31862422,133609,66804,66805,gjBMZYVujDjD1ECG4i97M8Q3gV9ESnwwTSUGropkusj,14532867,171235688,-156702821,419
2022-05-06 09:51:40-04:00,18026,D8BtQirMEk3W9Pq29B6KkKWrwPfmsUNpwz5npx7aGMLY,J7LMZwaSoh5hbGcwee6oPsnN4ZFD7Zp3LQWkJGNUHRfJ,True,167300457,41825114,265509,132754,132755,Hu94aiQWvce6THeGyCFqGRPM1pQrK3ihzkcXo1EpJcJL,10620394,68237541,-57617147,634
2022-05-06 09:51:42-04:00,18027,4oMasDRj8HWfknmdwt6Mkz3eonr8J2byoiSTRo4sCnFQ,3emcATkEFvDVETiK97eVET2Z2jzkgiiSxX3gu5wsUKPe,True,20514749276,3097932243,20421208,10210604,10210604,DQCvC9mR68hJ3tJsUiddh6JwcBJAmntqGJR2nUsEq7yj,1352308382,5221762285,-3869453903,659
2022-05-06 09:53:09-04:00,18028,5o4EAqBTiUKn41QhPL5kRjrGTgQVdP7xLtxC7xNxjkwn,E8gDreu3LxW1EHJ8hnqChK9QdffGh5GocJYKdrbYat8E,True,21592580,5398145,33683,16841,16842,Hu94aiQWvce6THeGyCFqGRPM1pQrK3ihzkcXo1EpJcJL,1347333,12369855,-11022522,623
2022-05-06 09:53:12-04:00,18029,5vp63gpRmA7mzAj8czoQsMsNHg1773XwYdwi4f5XC4nE,wqgmuTgVubuFucijWBVJU9tqMgGKHy61DVLEDC46q3H,True,84400306,21100076,125859,62929,62930,68sueyVfmy5ToEGtLFGDkwebX47xAmzyXE29z8JrmcWv,5034362,21507251,-16472889,596
2022-05-06 11:22:32-04:00,18030,5XcrJqz4M3F7d5SruWRSWLH8zY6cDVwTXbqcA2Y5YLBS,6gJ1xLxAQ1HW4WRpBx7LhHiQuqqdMvLxSdeeNUS5NFsi,True,179282032,44820508,318574,159287,159287,68sueyVfmy5ToEGtLFGDkwebX47xAmzyXE29z8JrmcWv,12742989,20678944,-7935955,710
2022-05-06 11:23:26-04:00,18031,31TiU5VAiR77Zec49S5x2Y9EqdyMqi8Gx5T2bLxAazhU,iZkdEaFdSoYXBFEp3GPVJZvg5ZbiVdjNvHaTEvXxUmp,True,88368214230,22092053557,63602091,31801045,31801046,68sueyVfmy5ToEGtLFGDkwebX47xAmzyXE29z8JrmcWv,2544083640,4210858022,-1666774382,287
2022-05-06 11:24:12-04:00,18032,fAJK1wrBhSW297AtFWX2U4rUBf2gkzfQ6UrQL9yHEYW,5pyTFpanSyUCHxeMhJMKtpdrcMSAWc8bFadbyM7q4q4B,True,391250097,97812524,657005,328502,328503,68sueyVfmy5ToEGtLFGDkwebX47xAmzyXE29z8JrmcWv,26280218,40574739,-14294521,671
2022-05-06 11:24:12-04:00,18033,5XcrJqz4M3F7d5SruWRSWLH8zY6cDVwTXbqcA2Y5YLBS,6gJ1xLxAQ1HW4WRpBx7LhHiQuqqdMvLxSdeeNUS5NFsi,True,137206023,34301505,241997,120998,120999,2a35JJeTUW1pm6M3e8DHCjp8qr4vbc2cRPhuzZWyFzYd,9679916,18378489,-8698573,705
2022-05-06 20:03:35-04:00,18034,7GpG8k6hM27vK1R5Sx1v5xUBuF6vybP41dcymjXDi5P7,7Aip6HDcbZ5mvoSucNupRS9enRdGx37F8L432K7V81do,True,5798474630,1449618657,9059136,4529568,4529568,5HnvdJnCCcmRsm4GkXnYWd4q9RpwuvYDGEUMPkYR3Ts9,362365465,1747064435,-1384698970,624
2022-05-06 20:19:38-04:00,18035,DHv4AsHMRZ6DuPaKEr2cLMNsX2ezT75T9haNgsDngS2b,5pMurvHHPdPKg3R96o1fKBbJh2Mc2tBP6P1e3acB31vQ,True,75812941,18953235,117464,58732,58732,68sueyVfmy5ToEGtLFGDkwebX47xAmzyXE29z8JrmcWv,4698597,12768223,-8069626,619
2022-05-06 20:27:41-04:00,18036,DLwEaZipqHmVBD5hc5v1NZtDStHyG4hAMwxywDTGGc2e,28GtwJw67UWfrSKxtuvpzoKzPyKXLgP3GKLm3fHdR566,True,3420704541,855176135,5276193,2638096,2638097,AmTrMPzuTp2BjnjqGNKqz9FTTCdpoKcPAJLwFc8ozcbh,211047750,561434273,-350386523,616
2022-05-06 20:27:41-04:00,18037,12GjTFcAZ5rnnR9DwXDUMmjFoyuFa3txDF4PPA4YoAQq,Ebm7YVYTYyMtEBM4STgbyyLuSFTwnnuFDQ1Wysvtj2vR,True,32054006,8013501,48521,24260,24261,2a35JJeTUW1pm6M3e8DHCjp8qr4vbc2cRPhuzZWyFzYd,1940845,10068358,-8127513,605
2022-05-06 21:25:43-04:00,18038,4T2MDxf43fxhNe8A2aF7G8hFFpPnkeWkMGPRiYVcBo9h,4cjUvZRpju4xAdS8b5CjxhVEk3o52KBGwjkH9hq23u8A,True,154649889,38662472,240192,120096,120096,6L1WYrPiCMyi7XemPww4B4hvpKD1LQKD4RpiSKmrmgSC,9607687,37595810,-27988123,621
2022-05-06 21:27:47-04:00,18039,5vp63gpRmA7mzAj8czoQsMsNHg1773XwYdwi4f5XC4nE,wqgmuTgVubuFucijWBVJU9tqMgGKHy61DVLEDC46q3H,True,62274873,15568718,97248,48624,48624,5HnvdJnCCcmRsm4GkXnYWd4q9RpwuvYDGEUMPkYR3Ts9,3889928,17270013,-13380085,624
2022-05-06 22:36:53-04:00,18040,Bzp3ZUxzRWqW4QoLq9PtKN1HQeSaKXFQrX1G3a4ocrre,H12B3p4v1ZtZ9gaSgpxCJsKXmmEjiqaRZQzexjzAhevo,True,3314979752,378346392,1933830,966915,966915,2xTUy2RS74GJMMDnmFaegMzFLn19RVfYG4CibhBmjP1i,169437565,1030629523,-861191958,511
2022-05-06 23:10:19-04:00,18041,4oMasDRj8HWfknmdwt6Mkz3eonr8J2byoiSTRo4sCnFQ,3emcATkEFvDVETiK97eVET2Z2jzkgiiSxX3gu5wsUKPe,True,17226861504,2034869955,13517796,6758898,6758898,3zqXX6kzhkbW3d4TwD2CNjMRwxTbREXySekvq37kfCNk,1144393570,4769724679,-3625331109,664
2022-05-06 23:28:23-04:00,18042,13GT6eaKWuaLe7wFcybCnUaYgd9DfyzYRN2FcXWgFwpC,CbwmJ7YpnvcqDyUw3L9b7dqXcA8Ju3rYrTdegeaJJbWC,True,147765510,36941377,228234,114117,114117,5HnvdJnCCcmRsm4GkXnYWd4q9RpwuvYDGEUMPkYR3Ts9,9129387,86586026,-77456639,617
2022-05-06 23:28:30-04:00,18043,E6aP64uFjkpvGaWYCAzW95RuURXmGGiCr63yzT8D8Bch,AVLR8LDxMvpjSU4XP7J5JoY8XwFyVu3YqEU45hzp2r8Z,True,17456445,4364111,26864,13432,13432,68sueyVfmy5ToEGtLFGDkwebX47xAmzyXE29z8JrmcWv,1074572,11743264,-10668692,615
2022-05-06 23:29:08-04:00,18044,HDMvxWha3zz9uPwZMRXWJYZNhTHxzwHMoYX4Raog1i31,4erL3sEBdK32eYY5w8vaeih9r1uC1vCrbsV8NxR4asEa,False,12720609,12720609,789201,39460,749741,YQC4EUcgeBi9431viwvzvBbZJW3szeHX4dFmowRDyDw,789201,9162611,-8373410,620
2022-05-06 23:29:26-04:00,18045,5XaryzRdShE48K6xMLJop7ieQVC7gp55MLG5UJ5C6mHA,BpessMA9vcqZMZKdAnR5JsDy6Y4qNpGNnPEc3nKDZLNY,True,17844897,4461224,27802,13901,13901,68sueyVfmy5ToEGtLFGDkwebX47xAmzyXE29z8JrmcWv,1112093,11392305,-10280212,623
2022-05-06 23:31:20-04:00,18046,D8BtQirMEk3W9Pq29B6KkKWrwPfmsUNpwz5npx7aGMLY,J7LMZwaSoh5hbGcwee6oPsnN4ZFD7Zp3LQWkJGNUHRfJ,True,123348801,30837200,206487,103243,103244,6L1WYrPiCMyi7XemPww4B4hvpKD1LQKD4RpiSKmrmgSC,8259502,53602303,-45342801,669
2022-05-06 23:31:26-04:00,18047,4oMasDRj8HWfknmdwt6Mkz3eonr8J2byoiSTRo4sCnFQ,3emcATkEFvDVETiK97eVET2Z2jzkgiiSxX3gu5wsUKPe,True,15051969154,2265242045,14911820,7455910,7455910,72XWPCtRYEDZbddP7d6dHtUBRRDLSJsB2xZTAfefoEVZ,990853379,4235820092,-3244966713,658
2022-05-06 23:31:29-04:00,18048,7qxGLMg6ZAxkVjhuj2PY6a5F36k4Efo3aCa99kvTpSKw,wgWcmEebBLbcm9a2jyCiw8nzqbGbfj6zRou4ZZhfWp7,True,106800595,16796623,93325,46662,46663,5HnvdJnCCcmRsm4GkXnYWd4q9RpwuvYDGEUMPkYR3Ts9,5934095,17772099,-11838004,555
2022-05-06 23:31:50-04:00,18049,BhhVhLVZkSd3aHDMd6ojTgtJtbgAdMCA9Xj8jL2GMXoL,G8HUQp2yGSw9T6it5ej91cqkd82naca8heji453g2jEH,True,93549919,16880031,66047,33023,33024,68sueyVfmy5ToEGtLFGDkwebX47xAmzyXE29z8JrmcWv,3660431,46305167,-42644736,391
2022-05-06 23:58:00-04:00,18050,7GpG8k6hM27vK1R5Sx1v5xUBuF6vybP41dcymjXDi5P7,7Aip6HDcbZ5mvoSucNupRS9enRdGx37F8L432K7V81do,True,4257359032,1064339758,6536092,3268046,3268046,6UQfSsLooL4pQKQfLtXCutQS2BnF7A7F7ewJopDLmUpc,261443701,1391762400,-1130318699,614
2022-05-06 23:58:04-04:00,18051,DHv4AsHMRZ6DuPaKEr2cLMNsX2ezT75T9haNgsDngS2b,5pMurvHHPdPKg3R96o1fKBbJh2Mc2tBP6P1e3acB31vQ,True,55717906,13929476,85863,42931,42932,5HnvdJnCCcmRsm4GkXnYWd4q9RpwuvYDGEUMPkYR3Ts9,3434540,10628606,-7194066,616
2022-05-06 23:58:05-04:00,18052,G7QeYEH5Et1mB2imz2J7ne8MeVhXzYxpdFee6yRD8MeJ,9K1u2L1cidicuNFqQjJnEwzVjEjG81Ka5bEKCkWxCkjT,True,33900886,8475221,51815,25907,25908,68sueyVfmy5ToEGtLFGDkwebX47xAmzyXE29z8JrmcWv,2072602,9805052,-7732450,611
2022-05-07 00:07:01-04:00,18053,9BjYvRf5A9UK99LvPTHd5DRvxMn2FWYKb5fpDxYDL48S,4kMo5gLVscVqwx6xQTLrn9JaEq1dFqq5Vfiq3Vb15vhi,True,17899773,4474943,27946,13973,13973,5HnvdJnCCcmRsm4GkXnYWd4q9RpwuvYDGEUMPkYR3Ts9,1117853,11343260,-10225407,624
2022-05-07 00:07:02-04:00,18054,EvyJwXTqP5N4qPKwDiDTCfjLYgLWz1qEREsarcsZdhYD,CbnajpQJxW3fWpH9dohsipVnZJyUvqy5dYSRDBBaDeEp,True,17899756,4474939,27953,13976,13977,6L1WYrPiCMyi7XemPww4B4hvpKD1LQKD4RpiSKmrmgSC,1118147,11343807,-10225660,624
2022-05-07 00:07:03-04:00,18055,Ga6hKu2mWpMqDboq3ZajdiittrTvDqX9kqMDt2fi3t29,3zUEyHaYdzLGMZxDj2EZLCA6NzL7Ub9BGpE5PGGnw2GD,True,17333095,4333273,26820,13410,13410,YQC4EUcgeBi9431viwvzvBbZJW3szeHX4dFmowRDyDw,1072815,11865091,-10792276,618
2022-05-07 00:08:52-04:00,18056,12GjTFcAZ5rnnR9DwXDUMmjFoyuFa3txDF4PPA4YoAQq,Ebm7YVYTYyMtEBM4STgbyyLuSFTwnnuFDQ1Wysvtj2vR,True,23627323,5906830,36905,18452,18453,68sueyVfmy5ToEGtLFGDkwebX47xAmzyXE29z8JrmcWv,1476227,7985054,-6508827,624
2022-05-07 00:09:13-04:00,18057,BhhVhLVZkSd3aHDMd6ojTgtJtbgAdMCA9Xj8jL2GMXoL,G8HUQp2yGSw9T6it5ej91cqkd82naca8heji453g2jEH,True,76206249,6432190,26406,13203,13203,6L1WYrPiCMyi7XemPww4B4hvpKD1LQKD4RpiSKmrmgSC,3128593,37496869,-34368276,410
2022-05-07 00:10:24-04:00,18058,4oMasDRj8HWfknmdwt6Mkz3eonr8J2byoiSTRo4sCnFQ,3emcATkEFvDVETiK97eVET2Z2jzkgiiSxX3gu5wsUKPe,True,12652723358,1488077207,9899894,4949947,4949947,GXyFXZMNk2NFyEzw6JetVqsujqcz2yCixH7n8EpDJYWD,841761655,3836413195,-2994651540,665
2022-05-07 00:10:35-04:00,18059,DLwEaZipqHmVBD5hc5v1NZtDStHyG4hAMwxywDTGGc2e,28GtwJw67UWfrSKxtuvpzoKzPyKXLgP3GKLm3fHdR566,True,2517137109,629284277,3926718,1963359,1963359,3zqXX6kzhkbW3d4TwD2CNjMRwxTbREXySekvq37kfCNk,157068747,468342569,-311273822,623
2022-05-07 00:12:11-04:00,18060,D8BtQirMEk3W9Pq29B6KkKWrwPfmsUNpwz5npx7aGMLY,J7LMZwaSoh5hbGcwee6oPsnN4ZFD7Zp3LQWkJGNUHRfJ,True,90777099,22694274,157990,78995,78995,C4UnXuShCvjSMgBAgVNMy1oakxCNk1et27A82fywU112,6319628,42063127,-35743499,696
2022-05-07 00:12:12-04:00,18061,EVMrznfJS54BZiywDD2WhUtxzicDtbEpm2a5yLrtCgRF,CpzsMYVYvKg8ihrX1cKRw7TDEYwD3kAyiX92hsf2KiTz,True,6053155473,674191059,3774500,1887250,1887250,gjBMZYVujDjD1ECG4i97M8Q3gV9ESnwwTSUGropkusj,338889640,3774467316,-3435577676,559
2022-05-07 00:12:13-04:00,18062,4T2MDxf43fxhNe8A2aF7G8hFFpPnkeWkMGPRiYVcBo9h,4cjUvZRpju4xAdS8b5CjxhVEk3o52KBGwjkH9hq23u8A,True,113701767,28425441,176763,88381,88382,5HnvdJnCCcmRsm4GkXnYWd4q9RpwuvYDGEUMPkYR3Ts9,7070545,30347491,-23276946,621
2022-05-07 00:12:23-04:00,18063,qDomXCaxa3BBJSuLnKRAHvBLMbMcWAzUNXtGDZTSD8F,57ch9yViUFJCGJcWUvNEDU1yGzC6AvPh4Ac3ynWZzLf1,False,12940857,12940857,807848,40392,767456,5HnvdJnCCcmRsm4GkXnYWd4q9RpwuvYDGEUMPkYR3Ts9,807848,8960896,-8153048,624
2022-05-07 00:12:25-04:00,18064,4YNWVEq2F3gR8XEbUQxJRqzi6i5KSfwf6mVMLPJrnpEd,EE5uomX5guX4ZeHiP6wcoH5C8k3tRGXo18JTWgNDqs1C,True,17903457,4475864,27502,13751,13751,5HnvdJnCCcmRsm4GkXnYWd4q9RpwuvYDGEUMPkYR3Ts9,1100087,11321996,-10221909,614
2022-05-07 00:12:27-04:00,18065,2pcVNktE3dbyybTuEBSkdwWJS5sFcvYLMEKRQMwZy6eh,61GaKj6fDApZF9B3aTBxTzYk8e22XLFPsQ21pJdvDhBL,True,17903439,4475859,27526,13763,13763,68sueyVfmy5ToEGtLFGDkwebX47xAmzyXE29z8JrmcWv,1101075,11322762,-10221687,615
2022-05-07 00:12:27-04:00,18066,9V7DXwq3RnVnLqRmtWXQJZgU3nHyVMteXAvaVaW3g1b6,94zfTWn693sbx9aaxamLUSHsbXdYxLpZVTvnetJ3SnhT,True,17915724,4478931,27740,13870,13870,C4UnXuShCvjSMgBAgVNMy1oakxCNk1et27A82fywU112,1109621,11319300,-10209679,619
2022-05-07 00:12:29-04:00,18067,7FL3AxJZcTiCG6Ux7CVc82Nqo4msgmQASGvjfMEgQddc,EzcAwNya2eA7GD8ezmi49bEUP57Fq3w9SwN3uAG4HA2b,True,17902161,4475540,27900,13950,13950,C4UnXuShCvjSMgBAgVNMy1oakxCNk1et27A82fywU112,1116019,11327284,-10211265,623
2022-05-07 00:12:31-04:00,18068,BAe9q4b1UwvQi5BHTmVh2GRguY3f9a5fbzXV2WiB93Ag,9uSCD3c3vHYC1i6odskxdugUaoSE5QYA1e8wkkW6aX5W,True,17911970,4477992,27904,13952,13952,6L1WYrPiCMyi7XemPww4B4hvpKD1LQKD4RpiSKmrmgSC,1116166,11329361,-10213195,623
2022-05-07 00:12:34-04:00,18069,5vp63gpRmA7mzAj8czoQsMsNHg1773XwYdwi4f5XC4nE,wqgmuTgVubuFucijWBVJU9tqMgGKHy61DVLEDC46q3H,True,45777832,11444458,71495,35747,35748,5HnvdJnCCcmRsm4GkXnYWd4q9RpwuvYDGEUMPkYR3Ts9,2859801,13823222,-10963421,624
2022-05-07 00:12:36-04:00,18070,68zbVKnneMQqngbNkeLtPEP2ayNhawc1B2hPgqAEqgXK,HqiFpLr4NC7xJz9bEFusq8bCKaoxAQG1xsLxdUAzg8aa,True,55217934,4984067,19847,9923,9924,5HnvdJnCCcmRsm4GkXnYWd4q9RpwuvYDGEUMPkYR3Ts9,2198907,28592221,-26393314,398
2022-05-07 00:12:51-04:00,18071,EneQUyUwfKFNwfdgNRdZBdX2frHixmVDK2GxDRU78QB,Gk8BVo53foZz1tMdLf85ZKpAPeLFZbCqwM6KYhmN6WNc,False,12914729,12914729,803386,40169,763217,5HnvdJnCCcmRsm4GkXnYWd4q9RpwuvYDGEUMPkYR3Ts9,803386,8982736,-8179350,622
2022-05-07 00:12:51-04:00,18072,G85GTorkDswyxv8uxgpP1tr6DbXktiXjjX14VA4L2VVu,3EJ5raXpu6eveda4FjxAeWFNbDbQkgjyKfoFq183UeLC,True,17868793,4467198,27843,13921,13922,YQC4EUcgeBi9431viwvzvBbZJW3szeHX4dFmowRDyDw,1113734,11327253,-10213519,623
2022-05-07 00:16:59-04:00,18073,7GpG8k6hM27vK1R5Sx1v5xUBuF6vybP41dcymjXDi5P7,7Aip6HDcbZ5mvoSucNupRS9enRdGx37F8L432K7V81do,True,3133696047,783424011,4886667,2443333,2443334,GXyFXZMNk2NFyEzw6JetVqsujqcz2yCixH7n8EpDJYWD,195466712,1102694571,-907227859,623
2022-05-07 00:17:09-04:00,18074,BhhVhLVZkSd3aHDMd6ojTgtJtbgAdMCA9Xj8jL2GMXoL,G8HUQp2yGSw9T6it5ej91cqkd82naca8heji453g2jEH,True,69383530,12592062,49212,24606,24606,6L1WYrPiCMyi7XemPww4B4hvpKD1LQKD4RpiSKmrmgSC,2711658,35474187,-32762529,390
2022-05-07 00:17:12-04:00,18075,DHv4AsHMRZ6DuPaKEr2cLMNsX2ezT75T9haNgsDngS2b,5pMurvHHPdPKg3R96o1fKBbJh2Mc2tBP6P1e3acB31vQ,True,40979524,10244881,63455,31727,31728,C4UnXuShCvjSMgBAgVNMy1oakxCNk1et27A82fywU112,2538229,8742711,-6204482,619
2022-05-07 00:17:12-04:00,18076,G7QeYEH5Et1mB2imz2J7ne8MeVhXzYxpdFee6yRD8MeJ,9K1u2L1cidicuNFqQjJnEwzVjEjG81Ka5bEKCkWxCkjT,True,24961631,6240407,38895,19447,19448,C4UnXuShCvjSMgBAgVNMy1oakxCNk1et27A82fywU112,1555814,7819196,-6263382,623
2022-05-07 00:17:13-04:00,18077,4oMasDRj8HWfknmdwt6Mkz3eonr8J2byoiSTRo4sCnFQ,3emcATkEFvDVETiK97eVET2Z2jzkgiiSxX3gu5wsUKPe,True,11063172824,1652356809,10908825,5454412,5454413,GXyFXZMNk2NFyEzw6JetVqsujqcz2yCixH7n8EpDJYWD,730388434,3394803537,-2664415103,660
2022-05-07 00:17:15-04:00,18078,68zbVKnneMQqngbNkeLtPEP2ayNhawc1B2hPgqAEqgXK,HqiFpLr4NC7xJz9bEFusq8bCKaoxAQG1xsLxdUAzg8aa,True,50091618,4635062,18846,9423,9423,5HnvdJnCCcmRsm4GkXnYWd4q9RpwuvYDGEUMPkYR3Ts9,2036811,25495682,-23458871,406
2022-05-07 00:17:44-04:00,18079,9VojCEgzn99QRVPGKn6euGRQbM7Q86GZ6yHJQa7N3gv4,GW4GVNnUtEt68avsowddpmjoUTUyMvxV4c5kY3Gzz9fT,True,21715548,1905412,11899,5949,5950,6L1WYrPiCMyi7XemPww4B4hvpKD1LQKD4RpiSKmrmgSC,1356238,15426841,-14070603,624
2022-05-07 00:17:44-04:00,18080,12GjTFcAZ5rnnR9DwXDUMmjFoyuFa3txDF4PPA4YoAQq,Ebm7YVYTYyMtEBM4STgbyyLuSFTwnnuFDQ1Wysvtj2vR,True,17365387,4341346,27105,13552,13553,5HnvdJnCCcmRsm4GkXnYWd4q9RpwuvYDGEUMPkYR3Ts9,1084216,6320948,-5236732,624
2022-05-07 00:18:25-04:00,18081,29JVska5UEG3axs63EmtHpPvkswNEqYpZ3PKMSfupiAG,DCftNBUsuogxyaJe9G9m3eWipH6o3qo4Rn4TuQXdVaBF,True,361502356,90375589,538684,269342,269342,6L1WYrPiCMyi7XemPww4B4hvpKD1LQKD4RpiSKmrmgSC,21547382,61769873,-40222491,596
2022-05-07 00:19:28-04:00,18082,DLwEaZipqHmVBD5hc5v1NZtDStHyG4hAMwxywDTGGc2e,28GtwJw67UWfrSKxtuvpzoKzPyKXLgP3GKLm3fHdR566,True,1849997904,462499476,2882177,1441088,1441089,72XWPCtRYEDZbddP7d6dHtUBRRDLSJsB2xZTAfefoEVZ,115287101,386649011,-271361910,623
2022-05-07 00:21:02-04:00,18083,68zbVKnneMQqngbNkeLtPEP2ayNhawc1B2hPgqAEqgXK,HqiFpLr4NC7xJz9bEFusq8bCKaoxAQG1xsLxdUAzg8aa,True,45336931,2090089,8751,4375,4376,6L1WYrPiCMyi7XemPww4B4hvpKD1LQKD4RpiSKmrmgSC,1898340,24129516,-22231176,418
2022-05-07 00:21:11-04:00,18084,FuhTkUxSaJ7kvuu9LHZaPVfdbKAQSh9W8Zzso1XPKGZp,FLoqPzREreKfRCwqtXs3CJwpTSudmXrVYCRZadWvob7j,True,1988393656,497098414,1502430,751215,751215,A2p75MbAbeUdHkPLkAjgGeiwuu9WPrkMHzjCkDXF1Xr3,60097224,635197294,-575100070,302
2022-05-07 00:27:16-04:00,18085,4T2MDxf43fxhNe8A2aF7G8hFFpPnkeWkMGPRiYVcBo9h,4cjUvZRpju4xAdS8b5CjxhVEk3o52KBGwjkH9hq23u8A,True,83605030,20901257,130562,65281,65281,68sueyVfmy5ToEGtLFGDkwebX47xAmzyXE29z8JrmcWv,5222486,24351605,-19129119,624
2022-05-07 00:39:47-04:00,18086,5vp63gpRmA7mzAj8czoQsMsNHg1773XwYdwi4f5XC4nE,wqgmuTgVubuFucijWBVJU9tqMgGKHy61DVLEDC46q3H,True,33647982,8411995,52572,26286,26286,5HnvdJnCCcmRsm4GkXnYWd4q9RpwuvYDGEUMPkYR3Ts9,2102914,11010891,-8907977,624
2022-05-07 00:40:35-04:00,18087,3S97kmJCtH7xQsdt7jsSyncXZiDQ9W8D8Pe3eT98Xopo,TvE4rh5GFsaAYo4MpkueYkuDPjbbuFmsBCdYyfAikLg,False,13185790,13185790,818441,40922,777519,2a35JJeTUW1pm6M3e8DHCjp8qr4vbc2cRPhuzZWyFzYd,818441,8726552,-7908111,620
2022-05-07 00:47:31-04:00,18088,HXQXfEQe7aCpr6WKh37XaDZsjZcuQPk5t8tWNFgEoK6U,5ufXkCEDwgiXwtyPye4wYVVA3oLW54JVzz4tnXFofto4,True,21657319415,5414329853,16312839,8156419,8156420,A9TwRM1BMxqb8DCC7YNAMV6zPenEJm3HTZBy7wJKK58U,652513564,6682631447,-6030117883,301
2022-05-07 00:47:34-04:00,18089,H7wVZszBQdmFuwMUYAw4SSYbjxeFY1QvNBuT8QiqTxZS,CUm235keNKnVd2BaCNp5a6HePtWGMo8dq8S1KXf2KRR4,True,41444718,10361179,30943,15471,15472,5HnvdJnCCcmRsm4GkXnYWd4q9RpwuvYDGEUMPkYR3Ts9,1237759,2826262,-1588503,298
2022-05-07 00:49:16-04:00,18090,BhhVhLVZkSd3aHDMd6ojTgtJtbgAdMCA9Xj8jL2GMXoL,G8HUQp2yGSw9T6it5ej91cqkd82naca8heji453g2jEH,True,56440416,4690523,19208,9604,9604,5HnvdJnCCcmRsm4GkXnYWd4q9RpwuvYDGEUMPkYR3Ts9,2311394,28801914,-26490520,409
2022-05-07 00:50:24-04:00,18091,A7j77tzgnQVGtHTa65VtVZqJRYeJvQk7am8NW6e66379,4vJGwEvXU2tGWoWWGwbsYcfKQAMCHbrBMRk4ZVFzneLs,True,17392646869,4348161717,13165330,6582665,6582665,6UQfSsLooL4pQKQfLtXCutQS2BnF7A7F7ewJopDLmUpc,526613221,3123615844,-2597002623,302
2022-05-07 00:50:25-04:00,18092,E3LF7ohKS87kHLW78ViuRuyw7EMuiW3nVn5PRdhU7iBj,DMVXNy2NLb8jMuznjx2syKqvzctrNmQ3PfiUA83CeQR4,True,118141813,29535453,88024,44012,44012,C4UnXuShCvjSMgBAgVNMy1oakxCNk1et27A82fywU112,3520997,36217442,-32696445,298
2022-05-07 00:50:26-04:00,18093,HqtTbC1LFreGvgfpZe7nCqkNnh8GHPQKosfmc19zb1yi,E39UNiHNkwQEd5GXkCtTPqSorQSB1kLx8kjzK4jdFoi3,True,257666364,64416591,194049,97024,97025,6L1WYrPiCMyi7XemPww4B4hvpKD1LQKD4RpiSKmrmgSC,7761962,50453553,-42691591,301
2022-05-07 00:50:58-04:00,18094,5zqXqEjg95BnghcVbHRhYkSTYnzZjUBichgccv1BpS3d,9SuqSxrKpHh9NcNePe4Q3jXvpCmhNnoQv8YAFih3CqMX,True,759340881,189835220,572450,286225,286225,72XWPCtRYEDZbddP7d6dHtUBRRDLSJsB2xZTAfefoEVZ,22898004,233758789,-210860785,301
2022-05-07 00:57:26-04:00,18095,EVMrznfJS54BZiywDD2WhUtxzicDtbEpm2a5yLrtCgRF,CpzsMYVYvKg8ihrX1cKRw7TDEYwD3kAyiX92hsf2KiTz,True,5338594295,529286856,2922204,1461102,1461102,AmTrMPzuTp2BjnjqGNKqz9FTTCdpoKcPAJLwFc8ozcbh,294745021,3376172885,-3081427864,552
2022-05-07 00:57:26-04:00,18096,AsRi72uQLsBnyQxMBnPEhyQNM7XyNk2RV9GzPMe8PysA,9MqsYTBn6P9zCi5bGCrZurWWysW8XQZJwndHsb227rEW,True,186813682,46703420,141433,70716,70717,C4UnXuShCvjSMgBAgVNMy1oakxCNk1et27A82fywU112,5657329,56926317,-51268988,302
2022-05-07 00:57:26-04:00,18097,13GT6eaKWuaLe7wFcybCnUaYgd9DfyzYRN2FcXWgFwpC,CbwmJ7YpnvcqDyUw3L9b7dqXcA8Ju3rYrTdegeaJJbWC,True,108674117,27168529,168298,84149,84149,5HnvdJnCCcmRsm4GkXnYWd4q9RpwuvYDGEUMPkYR3Ts9,6731957,66975113,-60243156,619
2022-05-07 00:57:28-04:00,18098,5xkW7wHTcF5WadNtBBqKPKctVwyQtTqqscivAmxzseCk,7m31ZMZdCn5Gz2q5sETWA7uKA5LsKD7pJHBBqU3g7tCn,True,70087978,17521994,53027,26513,26514,5HnvdJnCCcmRsm4GkXnYWd4q9RpwuvYDGEUMPkYR3Ts9,2121101,13755846,-11634745,302
2022-05-07 00:57:47-04:00,18099,Fczxdc24Eav8xcaKRDwWMEwPEzkGyEJ7qGcXYyGZFKVz,8GqweYpec4cnpaJvueF3FGWoaz72BAzpLYXBX7tuuqEt,True,1706712148,426678037,1290349,645174,645175,A9TwRM1BMxqb8DCC7YNAMV6zPenEJm3HTZBy7wJKK58U,51613974,967683009,-916069035,302
2022-05-07 00:58:06-04:00,18100,rTizTweTeG3Li3BFLmtr6GmcHBs9FTcwsPKCWezWmnR,76CqzaphEXgjo9pzBKttaErJ5e9xoZaRKp5ZNB5JCf4x,True,722733142,180683285,533218,266609,266609,A9TwRM1BMxqb8DCC7YNAMV6zPenEJm3HTZBy7wJKK58U,21328736,72915556,-51586820,295
2022-05-07 00:58:10-04:00,18101,4oMasDRj8HWfknmdwt6Mkz3eonr8J2byoiSTRo4sCnFQ,3emcATkEFvDVETiK97eVET2Z2jzkgiiSxX3gu5wsUKPe,True,9299438273,1100911840,7198999,3599499,3599500,GXyFXZMNk2NFyEzw6JetVqsujqcz2yCixH7n8EpDJYWD,608101867,3048773077,-2440671210,653
2022-05-07 00:58:11-04:00,18102,BWta2HTjCwDidjsgv1vPoD3gCHSGf679N1xijEj5jzD3,JEFa5ojXJ95W2NsV5j8qBENTm5n1uGfPDFwLRvebHDVn,True,29207287,7301821,45573,22786,22787,5HnvdJnCCcmRsm4GkXnYWd4q9RpwuvYDGEUMPkYR3Ts9,1822936,15822154,-13999218,624
2022-05-07 00:58:19-04:00,18103,8DSiP9CwJm3AEcH6uuAYFpArRRDLYpDQgjHEvjkUgfg2,ERJ8kuhPRRmUAhSM4oxUheh39YUVVYNgaTt6AdMXcCvL,True,637970463,159492615,470117,235058,235059,2py1FiYeL2f7J3HU36qiJz6TD6HCmiTN36RyxYtapQCZ,18804688,195749250,-176944562,294
2022-05-07 00:58:19-04:00,18104,2HtcCr92gzqZEmnEYKrsC2d2euFz7djLYzqnbDSbhd82,3wKxFATyaQK6kZd2UahQjvL9tzMGuN2767EguLmj1bot,True,27825355,6956333,43049,21524,21525,6L1WYrPiCMyi7XemPww4B4hvpKD1LQKD4RpiSKmrmgSC,1722003,8439200,-6717197,618
2022-05-07 00:58:20-04:00,18105,BmFSXZx3HWaTtD7vp7AkUk5DUNjwK1qgLPod13EJz6No,DtLMfV3Xs7AAAQqC1PwL7YAfV6fig8yAMxr9MMxmyCKc,False,28626581,28626581,822181,41109,781072,5HnvdJnCCcmRsm4GkXnYWd4q9RpwuvYDGEUMPkYR3Ts9,822181,5151271,-4329090,287
2022-05-07 00:58:21-04:00,18106,68zbVKnneMQqngbNkeLtPEP2ayNhawc1B2hPgqAEqgXK,HqiFpLr4NC7xJz9bEFusq8bCKaoxAQG1xsLxdUAzg8aa,True,43095590,2030450,8190,4095,4095,68sueyVfmy5ToEGtLFGDkwebX47xAmzyXE29z8JrmcWv,1738337,23191959,-21453622,403
2022-05-07 00:58:21-04:00,18107,gCNpMXEHPTLvMvyyaYCLJrd8RRGnKAHz7sBD5j7yyBt,9cRU1ZAZRT5Ei4YAmCrPJZMHGsWspcYXTuZH58iexwDv,True,200993157,50248289,143518,71759,71759,5HnvdJnCCcmRsm4GkXnYWd4q9RpwuvYDGEUMPkYR3Ts9,5740741,34337458,-28596717,285
2022-05-07 00:58:22-04:00,18108,GpDhvRRae2uiRZ6MnJYnVR2hANNLGFGUDnsQmGjfK8AP,B2pgJ4gPdgzvx2HMJ1wagtthpZebtBk7RD3cF1zqSyT8,True,819519342,204879835,619381,309690,309691,AmTrMPzuTp2BjnjqGNKqz9FTTCdpoKcPAJLwFc8ozcbh,24775249,268398884,-243623635,302
2022-05-07 00:58:22-04:00,18109,5nALef7nAfNkSQSuTBLwewDby4pUx74Gzqib33Znmmt6,8xNTWK2xNK2xZPpgXfcE4QxPT2i6YvNYakiLgdQ2FqEt,True,596150908,149037727,436161,218080,218081,3zqXX6kzhkbW3d4TwD2CNjMRwxTbREXySekvq37kfCNk,17446462,35282543,-17836081,292
2022-05-07 00:58:22-04:00,18110,82EMpA1hwF9KNQy2ZB2A1HdoEowBu2CoYhW3VmohkSnk,hn67zsTzsAs2aqk6ZjfEeoRygd3CdMeCuR82h9yuiz3,True,453394164,113348541,332853,166426,166427,DA18qE9qesbBqpwNv1M4befYcNQkbSBSeLPTmQzrmbJw,13314130,134337621,-121023491,293
2022-05-07 00:58:26-04:00,18111,4ZF1wtHKAnxmEZGACgbgphHvuo5aK4wC4MCNJzLYVkMX,5UXyhRP3Rjsc1RbV8BouJVQoTbWWbuPtVJY15KcHJFCN,True,70583707,17645926,51775,25887,25888,C4UnXuShCvjSMgBAgVNMy1oakxCNk1et27A82fywU112,2071023,22252473,-20181450,293
2022-05-07 00:58:27-04:00,18112,Gwj6CMXQeoWVsmD775Knsm6BmWuysFvSKo78FRLQByb4,6cvChMYj7TfDcnc8hG9H89PABJr2svspqjJSdSGD4RUt,True,26184867,3114867,19409,9704,9705,68sueyVfmy5ToEGtLFGDkwebX47xAmzyXE29z8JrmcWv,1631714,7023463,-5391749,623
2022-05-07 00:58:45-04:00,18113,EMFbiJWcw1YdjiDmxj5CsHMyswXyyHeL7cfWKa8dMzHh,2LjnVQF8WSwL8XSNVypW9SouYSRbyH9A7gcw7BFtxuXS,True,200827322,50206830,150699,75349,75350,2a35JJeTUW1pm6M3e8DHCjp8qr4vbc2cRPhuzZWyFzYd,6027991,63053959,-57025968,300
2022-05-07 00:58:47-04:00,18114,HT2SuCbePhjNZaar24uVwihYowCNvSjdvhJ8BRSVw9nX,98Ts4LCnapHVoCJ5PW3Armvh4jvDtpfs3SYRLRxiAgzZ,True,308386255,41992062,195637,97818,97819,5HnvdJnCCcmRsm4GkXnYWd4q9RpwuvYDGEUMPkYR3Ts9,14367469,124989383,-110621914,465
2022-05-07 00:59:20-04:00,18115,E6aP64uFjkpvGaWYCAzW95RuURXmGGiCr63yzT8D8Bch,AVLR8LDxMvpjSU4XP7J5JoY8XwFyVu3YqEU45hzp2r8Z,False,12843066,12843066,796172,39808,756364,68sueyVfmy5ToEGtLFGDkwebX47xAmzyXE29z8JrmcWv,796172,9046970,-8250798,619
2022-05-07 00:59:47-04:00,18116,9VojCEgzn99QRVPGKn6euGRQbM7Q86GZ6yHJQa7N3gv4,GW4GVNnUtEt68avsowddpmjoUTUyMvxV4c5kY3Gzz9fT,True,19696037,1866193,11656,5828,5828,68sueyVfmy5ToEGtLFGDkwebX47xAmzyXE29z8JrmcWv,1230240,14350555,-13120315,624
2022-05-07 01:00:27-04:00,18117,87yYQuRW91LAqEmqEyYah7obsr4KijRrqsKdK7DGA9w,EJzredSumMNBMTYxMMHocKayWKg3A3621QJ3ArJqro8r,True,59598891,14899722,44926,22463,22463,68sueyVfmy5ToEGtLFGDkwebX47xAmzyXE29z8JrmcWv,1797047,18525160,-16728113,301
2022-05-07 01:00:27-04:00,18118,BhhVhLVZkSd3aHDMd6ojTgtJtbgAdMCA9Xj8jL2GMXoL,G8HUQp2yGSw9T6it5ej91cqkd82naca8heji453g2jEH,True,51454426,9352480,36251,18125,18126,6L1WYrPiCMyi7XemPww4B4hvpKD1LQKD4RpiSKmrmgSC,1994449,27149606,-25155157,387
2022-05-07 01:00:27-04:00,18119,5XaryzRdShE48K6xMLJop7ieQVC7gp55MLG5UJ5C6mHA,BpessMA9vcqZMZKdAnR5JsDy6Y4qNpGNnPEc3nKDZLNY,False,13114228,13114228,809574,40478,769096,68sueyVfmy5ToEGtLFGDkwebX47xAmzyXE29z8JrmcWv,809574,8789189,-7979615,617
2022-05-07 01:00:28-04:00,18120,9XmuJX8mFX29c5uh68kK7ff1mPdvs1orJAgEP6BsVKnq,HfPpizwUoK6uEmMb9LWi464BnvjHQY9cuPppFMp1DKDA,True,109338854,27334713,82694,41347,41347,68sueyVfmy5ToEGtLFGDkwebX47xAmzyXE29z8JrmcWv,3307770,15489588,-12181818,302
2022-05-07 01:00:28-04:00,18121,BKmKy8n1MpB1sdSfuWy7P3c6ReSW8TEWZRsyriz3ujYo,FgRpiZFPz43vDWStgCwRJACiGKtMLkWbTGeTLPeKnnaY,True,201308717,50327179,151279,75639,75640,gjBMZYVujDjD1ECG4i97M8Q3gV9ESnwwTSUGropkusj,6051187,62563576,-56512389,300
2022-05-07 01:00:32-04:00,18122,FuhTkUxSaJ7kvuu9LHZaPVfdbKAQSh9W8Zzso1XPKGZp,FLoqPzREreKfRCwqtXs3CJwpTSudmXrVYCRZadWvob7j,True,1476684404,369171101,1098055,549027,549028,6L1WYrPiCMyi7XemPww4B4hvpKD1LQKD4RpiSKmrmgSC,43922211,489901428,-445979217,297
2022-05-07 01:00:32-04:00,18123,64Diz8zzEv1jDWnBQPTHPpXwaWf7vjM19RyJmkPy1viQ,G8wkGHRHMtT3mvXBkH3zgsKNs8wbpdiPUS17y4cozhkZ,True,109282703,27320675,168759,84379,84380,5HnvdJnCCcmRsm4GkXnYWd4q9RpwuvYDGEUMPkYR3Ts9,6750373,20317233,-13566860,617
2022-05-07 01:00:34-04:00,18124,HCAGpyYM2NYudMd55Geta13tUbS6eiygnJY5ULHsHAVa,3PPyWhqXrmifWPieLV34bZ1rzi8eEnrDDAF7ifXkXspn,True,119753224,9324542,40018,20009,20009,68sueyVfmy5ToEGtLFGDkwebX47xAmzyXE29z8JrmcWv,5139541,48749442,-43609901,429
2022-05-07 01:00:34-04:00,18125,68zbVKnneMQqngbNkeLtPEP2ayNhawc1B2hPgqAEqgXK,HqiFpLr4NC7xJz9bEFusq8bCKaoxAQG1xsLxdUAzg8aa,True,40967749,3696463,14717,7358,7359,6L1WYrPiCMyi7XemPww4B4hvpKD1LQKD4RpiSKmrmgSC,1631134,21871852,-20240718,398
2022-05-07 02:50:27-04:00,18126,7GpG8k6hM27vK1R5Sx1v5xUBuF6vybP41dcymjXDi5P7,7Aip6HDcbZ5mvoSucNupRS9enRdGx37F8L432K7V81do,True,2303309981,575827495,3584118,1792059,1792059,A2p75MbAbeUdHkPLkAjgGeiwuu9WPrkMHzjCkDXF1Xr3,143364721,870839962,-727475241,622
2022-05-07 02:51:18-04:00,18127,DHv4AsHMRZ6DuPaKEr2cLMNsX2ezT75T9haNgsDngS2b,5pMurvHHPdPKg3R96o1fKBbJh2Mc2tBP6P1e3acB31vQ,True,30144013,7536003,47020,23510,23510,6L1WYrPiCMyi7XemPww4B4hvpKD1LQKD4RpiSKmrmgSC,1880825,7124831,-5244006,623
2022-05-07 02:52:27-04:00,18128,G7QeYEH5Et1mB2imz2J7ne8MeVhXzYxpdFee6yRD8MeJ,9K1u2L1cidicuNFqQjJnEwzVjEjG81Ka5bEKCkWxCkjT,True,18352581,4588145,28656,14328,14328,5HnvdJnCCcmRsm4GkXnYWd4q9RpwuvYDGEUMPkYR3Ts9,1146255,6212441,-5066186,624
2022-05-07 02:56:50-04:00,18129,12GjTFcAZ5rnnR9DwXDUMmjFoyuFa3txDF4PPA4YoAQq,Ebm7YVYTYyMtEBM4STgbyyLuSFTwnnuFDQ1Wysvtj2vR,False,12762716,12762716,794374,39718,754656,2a35JJeTUW1pm6M3e8DHCjp8qr4vbc2cRPhuzZWyFzYd,794374,4983252,-4188878,622
2022-05-07 02:57:09-04:00,18130,4hyYkR4vX3HuybAHHKyLgfseU7qBB5r5xYZ3Ye4ssNaM,8EKhsSKPiaueXNNgPqpyNkAy64bVYaRqiJE1CdryT9wW,False,7225728,7225728,449616,22480,427136,5HnvdJnCCcmRsm4GkXnYWd4q9RpwuvYDGEUMPkYR3Ts9,449616,1576460,-1126844,622
2022-05-07 03:42:46-04:00,18131,GKbDACVE2yR8WwrMeGfSQuSXLqXR3B1N5YzZ93i5xyeB,B5EEB6xDf7fwwaE6CaJjwsgCNNdUc29tjW1gY2pHiKxq,True,1877928558,223030774,1482515,741257,741258,6L1WYrPiCMyi7XemPww4B4hvpKD1LQKD4RpiSKmrmgSC,124828461,189680522,-64852061,664
2022-05-07 03:46:02-04:00,18132,GKbDACVE2yR8WwrMeGfSQuSXLqXR3B1N5YzZ93i5xyeB,B5EEB6xDf7fwwaE6CaJjwsgCNNdUc29tjW1gY2pHiKxq,True,1679940693,248042492,1639383,819691,819692,68sueyVfmy5ToEGtLFGDkwebX47xAmzyXE29z8JrmcWv,111032055,175479920,-64447865,660
2022-05-07 04:15:08-04:00,18133,7ZYFuMZx2mPLo7MBQC6wGmar8zhrC326eiPS3kogSiYb,X2Ng1YJqAdXRLii2SuczPys6kxjbbw77JPU52SDk3P4,True,577393655,144348413,1029995,514997,514998,2a35JJeTUW1pm6M3e8DHCjp8qr4vbc2cRPhuzZWyFzYd,41199813,34819901,6379912,713
2022-05-07 05:27:06-04:00,18134,4nqsW3XCJxzSsDdQzvE3zeM9nqBv8xVdUG8GxFWn6Edf,6eVvNs2rckFeTGkXZgPEGLYg4rmz3MFtoVNPRNmktcrY,True,1229919775,307479943,2189649,1094824,1094825,2py1FiYeL2f7J3HU36qiJz6TD6HCmiTN36RyxYtapQCZ,87585981,118695016,-31109035,712
2022-05-07 06:16:52-04:00,18135,jLcMvWkdEDweLB1otEdmsnL48kQPF5esSKx5WDzrdei,3VtwkSQaVnPv8MFuyDDj6dGQGnuY5GDUY2wYkBFRkfdF,True,25341529023,6335382255,42871245,21435622,21435623,A9TwRM1BMxqb8DCC7YNAMV6zPenEJm3HTZBy7wJKK58U,1714849836,2873505284,-1158655448,676
2022-05-07 07:15:48-04:00,18136,7ZYFuMZx2mPLo7MBQC6wGmar8zhrC326eiPS3kogSiYb,X2Ng1YJqAdXRLii2SuczPys6kxjbbw77JPU52SDk3P4,True,441910229,110477557,782311,391155,391156,6L1WYrPiCMyi7XemPww4B4hvpKD1LQKD4RpiSKmrmgSC,31292476,35403001,-4110525,708
2022-05-07 07:55:25-04:00,18137,5FewDaMC9U7n5EHcto98GaAmDVxDh5SYimuTP6AtfakM,7DAULUoqV7f9hsBzKEhjQPnWaHSqiMWcBqWcdcadaQv4,True,1710318068,427579517,2637326,1318663,1318663,72XWPCtRYEDZbddP7d6dHtUBRRDLSJsB2xZTAfefoEVZ,105493065,163675910,-58182845,616
2022-05-07 08:13:39-04:00,18138,GKbDACVE2yR8WwrMeGfSQuSXLqXR3B1N5YzZ93i5xyeB,B5EEB6xDf7fwwaE6CaJjwsgCNNdUc29tjW1gY2pHiKxq,True,1067494278,178853113,1223599,611799,611800,5HnvdJnCCcmRsm4GkXnYWd4q9RpwuvYDGEUMPkYR3Ts9,73031166,174346415,-101315249,684
2022-05-07 13:33:31-04:00,18139,6cyefDEH1EqWn2RYGMtLj9CPhjXg5eECHsrm3C8fxurr,4o3XrjY3LA63KkjPtNGbwEuq59qXh8WmuEDsD5mfbtMD,True,1257303094,314325773,1933353,966676,966677,2xTUy2RS74GJMMDnmFaegMzFLn19RVfYG4CibhBmjP1i,77334132,170048492,-92714360,615
2022-05-07 16:03:36-04:00,18140,DLwEaZipqHmVBD5hc5v1NZtDStHyG4hAMwxywDTGGc2e,28GtwJw67UWfrSKxtuvpzoKzPyKXLgP3GKLm3fHdR566,True,1359090809,339772702,2101412,1050706,1050706,2xTUy2RS74GJMMDnmFaegMzFLn19RVfYG4CibhBmjP1i,84056484,316014278,-231957794,618
2022-05-07 16:03:36-04:00,18141,4T2MDxf43fxhNe8A2aF7G8hFFpPnkeWkMGPRiYVcBo9h,4cjUvZRpju4xAdS8b5CjxhVEk3o52KBGwjkH9hq23u8A,True,61447251,15361812,95951,47975,47976,Hu94aiQWvce6THeGyCFqGRPM1pQrK3ihzkcXo1EpJcJL,3838079,19441504,-15603425,624
2022-05-07 16:03:40-04:00,18142,5vp63gpRmA7mzAj8czoQsMsNHg1773XwYdwi4f5XC4nE,wqgmuTgVubuFucijWBVJU9tqMgGKHy61DVLEDC46q3H,True,24727174,6181793,38565,19282,19283,6L1WYrPiCMyi7XemPww4B4hvpKD1LQKD4RpiSKmrmgSC,1542608,8732415,-7189807,623
2022-05-07 16:31:39-04:00,18143,4oMasDRj8HWfknmdwt6Mkz3eonr8J2byoiSTRo4sCnFQ,3emcATkEFvDVETiK97eVET2Z2jzkgiiSxX3gu5wsUKPe,True,8132840490,1196312507,7884222,3942111,3942111,AmTrMPzuTp2BjnjqGNKqz9FTTCdpoKcPAJLwFc8ozcbh,535989773,2701570236,-2165580463,659
2022-05-07 16:32:27-04:00,18144,7GpG8k6hM27vK1R5Sx1v5xUBuF6vybP41dcymjXDi5P7,7Aip6HDcbZ5mvoSucNupRS9enRdGx37F8L432K7V81do,True,1692751265,423187816,2632844,1316422,1316422,A9TwRM1BMxqb8DCC7YNAMV6zPenEJm3HTZBy7wJKK58U,105313799,685702847,-580389048,622
2022-05-07 16:33:37-04:00,18145,DHv4AsHMRZ6DuPaKEr2cLMNsX2ezT75T9haNgsDngS2b,5pMurvHHPdPKg3R96o1fKBbJh2Mc2tBP6P1e3acB31vQ,True,22150318,5537579,34489,17244,17245,5HnvdJnCCcmRsm4GkXnYWd4q9RpwuvYDGEUMPkYR3Ts9,1379578,5770283,-4390705,622
2022-05-07 16:33:45-04:00,18146,G7QeYEH5Et1mB2imz2J7ne8MeVhXzYxpdFee6yRD8MeJ,9K1u2L1cidicuNFqQjJnEwzVjEjG81Ka5bEKCkWxCkjT,False,13480182,13480182,835455,41772,793683,2a35JJeTUW1pm6M3e8DHCjp8qr4vbc2cRPhuzZWyFzYd,835455,4919352,-4083897,619
2022-05-07 16:47:00-04:00,18147,DLwEaZipqHmVBD5hc5v1NZtDStHyG4hAMwxywDTGGc2e,28GtwJw67UWfrSKxtuvpzoKzPyKXLgP3GKLm3fHdR566,True,999807346,249951836,1561107,780553,780554,2a35JJeTUW1pm6M3e8DHCjp8qr4vbc2cRPhuzZWyFzYd,62444311,255939420,-193495109,624
2022-05-07 16:49:03-04:00,18148,Fn6J1eMQJoA5rXCwX2HjAF86AowsJfULLuYXVfzgb8aX,6Ett2WPmz4HoWVSVEZD73UzFetd3oFSh7C676MEVYd36,True,565005048,141251262,882520,441260,441260,5HnvdJnCCcmRsm4GkXnYWd4q9RpwuvYDGEUMPkYR3Ts9,35300824,196891780,-161590956,624
2022-05-07 16:49:27-04:00,18149,4Siq98BDakELWP5BzVoEN5tcg1ywRxTYs1aUcfW8spCt,2EBXLTVz1Gk9gS5JcVqCKAP5PatFGw1Vnww65Moz3SUn,True,376137350,94034337,587471,293735,293736,2a35JJeTUW1pm6M3e8DHCjp8qr4vbc2cRPhuzZWyFzYd,23498841,123386527,-99887686,624
2022-05-07 16:49:27-04:00,18150,5vp63gpRmA7mzAj8czoQsMsNHg1773XwYdwi4f5XC4nE,wqgmuTgVubuFucijWBVJU9tqMgGKHy61DVLEDC46q3H,True,18169160,4542290,28195,14097,14098,68sueyVfmy5ToEGtLFGDkwebX47xAmzyXE29z8JrmcWv,1127822,6896405,-5768583,620
2022-05-07 16:49:36-04:00,18151,4oMasDRj8HWfknmdwt6Mkz3eonr8J2byoiSTRo4sCnFQ,3emcATkEFvDVETiK97eVET2Z2jzkgiiSxX3gu5wsUKPe,True,6865874620,833976083,5556526,2778263,2778263,AmTrMPzuTp2BjnjqGNKqz9FTTCdpoKcPAJLwFc8ozcbh,457452188,2399218158,-1941765970,666
2022-05-07 17:11:45-04:00,18152,7GpG8k6hM27vK1R5Sx1v5xUBuF6vybP41dcymjXDi5P7,7Aip6HDcbZ5mvoSucNupRS9enRdGx37F8L432K7V81do,True,1244137209,311034302,1931687,965843,965844,6L1WYrPiCMyi7XemPww4B4hvpKD1LQKD4RpiSKmrmgSC,77267494,538014139,-460746645,621
2022-05-07 17:11:56-04:00,18153,5XcrJqz4M3F7d5SruWRSWLH8zY6cDVwTXbqcA2Y5YLBS,6gJ1xLxAQ1HW4WRpBx7LhHiQuqqdMvLxSdeeNUS5NFsi,True,92305314,23076328,150870,75435,75435,Hu94aiQWvce6THeGyCFqGRPM1pQrK3ihzkcXo1EpJcJL,6034811,9507275,-3472464,653
2022-05-07 17:12:11-04:00,18154,DHv4AsHMRZ6DuPaKEr2cLMNsX2ezT75T9haNgsDngS2b,5pMurvHHPdPKg3R96o1fKBbJh2Mc2tBP6P1e3acB31vQ,True,16283256,4070814,25394,12697,12697,Hu94aiQWvce6THeGyCFqGRPM1pQrK3ihzkcXo1EpJcJL,1015773,4638290,-3622517,623
2022-05-07 17:12:38-04:00,18155,BhhVhLVZkSd3aHDMd6ojTgtJtbgAdMCA9Xj8jL2GMXoL,G8HUQp2yGSw9T6it5ej91cqkd82naca8heji453g2jEH,True,41830059,7104011,28613,14306,14307,2a35JJeTUW1pm6M3e8DHCjp8qr4vbc2cRPhuzZWyFzYd,1684819,22052985,-20368166,402
2022-05-07 17:13:19-04:00,18156,4oMasDRj8HWfknmdwt6Mkz3eonr8J2byoiSTRo4sCnFQ,3emcATkEFvDVETiK97eVET2Z2jzkgiiSxX3gu5wsUKPe,True,5973138583,871782299,5738382,2869191,2869191,2a35JJeTUW1pm6M3e8DHCjp8qr4vbc2cRPhuzZWyFzYd,393173359,2145390240,-1752216881,658
2022-05-07 17:13:56-04:00,18157,Gwj6CMXQeoWVsmD775Knsm6BmWuysFvSKo78FRLQByb4,6cvChMYj7TfDcnc8hG9H89PABJr2svspqjJSdSGD4RUt,True,23057290,2330045,14521,7260,7261,2a35JJeTUW1pm6M3e8DHCjp8qr4vbc2cRPhuzZWyFzYd,1437027,5972306,-4535279,623
2022-05-07 17:13:58-04:00,18158,EvyJwXTqP5N4qPKwDiDTCfjLYgLWz1qEREsarcsZdhYD,CbnajpQJxW3fWpH9dohsipVnZJyUvqy5dYSRDBBaDeEp,False,13173477,13173477,822487,41124,781363,C4UnXuShCvjSMgBAgVNMy1oakxCNk1et27A82fywU112,822487,8743083,-7920596,624
2022-05-07 17:13:58-04:00,18159,Ga6hKu2mWpMqDboq3ZajdiittrTvDqX9kqMDt2fi3t29,3zUEyHaYdzLGMZxDj2EZLCA6NzL7Ub9BGpE5PGGnw2GD,False,12756415,12756415,786739,39336,747403,C4UnXuShCvjSMgBAgVNMy1oakxCNk1et27A82fywU112,786739,9124364,-8337625,616
2022-05-07 17:14:01-04:00,18160,9BjYvRf5A9UK99LvPTHd5DRvxMn2FWYKb5fpDxYDL48S,4kMo5gLVscVqwx6xQTLrn9JaEq1dFqq5Vfiq3Vb15vhi,False,13173405,13173405,822115,41105,781010,C4UnXuShCvjSMgBAgVNMy1oakxCNk1et27A82fywU112,822115,8742606,-7920491,624
2022-05-07 17:14:19-04:00,18161,DHfy6B2AYsqMCxPLBCXMDfQn3Gr2VwJaLFHUZKqpCjsb,EPZpYaY1gCAb8pMtri5veRowBmCrCpTHBMa3Rmgt6S29,True,1638752393,409688098,1169120,584560,584560,2a35JJeTUW1pm6M3e8DHCjp8qr4vbc2cRPhuzZWyFzYd,46764837,78312238,-31547401,285
2022-05-07 17:14:19-04:00,18162,68zbVKnneMQqngbNkeLtPEP2ayNhawc1B2hPgqAEqgXK,HqiFpLr4NC7xJz9bEFusq8bCKaoxAQG1xsLxdUAzg8aa,True,37162130,3478982,14057,7028,7029,2a35JJeTUW1pm6M3e8DHCjp8qr4vbc2cRPhuzZWyFzYd,1501629,19502393,-18000764,404
2022-05-07 17:17:27-04:00,18163,93Jp2cnKVsSUcpoNEXmuq3K17MWt7JkW3jx6v5v2UAvN,5bos8dvpCKDxeYbXxRXwEdY8tAMZoL2XhNKUdFKxTrd6,True,197062935,16578415,66525,33262,33263,Hu94aiQWvce6THeGyCFqGRPM1pQrK3ihzkcXo1EpJcJL,7907644,123329047,-115421403,401
2022-04-30 21:15:50-04:00,17140,GD6Hw8ZErxFJeA5PunxorcUNN5v9gM77mWPjHT3Mx2Bw,EmreHG5gVyyL7iVhoxq8GcmzPV7V6SBxVNZajutC5HAF,True,144938145,36234536,249266,124633,124633,2a35JJeTUW1pm6M3e8DHCjp8qr4vbc2cRPhuzZWyFzYd,9970666,39153481,-29182815,687
2022-04-30 21:15:58-04:00,17141,5bF9tSdmHqni2jdMMbLfiE5jxHtX8WoJXNXxMuykuojW,FrRNyeq1GrnBbAdBeEMPKX6yv54KJLhTpoPBB3irxDei,True,177051885,44262971,306680,153340,153340,2a35JJeTUW1pm6M3e8DHCjp8qr4vbc2cRPhuzZWyFzYd,12267205,50268902,-38001697,692
2022-04-30 21:17:24-04:00,17142,2yH4iJWVSDWHGjm5J95sbsRbHGA81VNPaox8xz8DWQaG,EHUYNPTqdUDGi3TBrr5BjDByCzLKq27CECCFUNyGRbQR,True,150686405,37671601,267134,133567,133567,68sueyVfmy5ToEGtLFGDkwebX47xAmzyXE29z8JrmcWv,10685376,39624525,-28939149,709
2022-04-30 21:19:54-04:00,17143,7VPQAQJ1b25pFeJTeyxitfbJXXGP2wMKiHsfCLA97vrK,3M7r9CzKmUPcT1b6SXsz6MQq61tPXWCUSVsuRek3f8Rk,True,9261805909,1607692749,11360260,5680130,5680130,68sueyVfmy5ToEGtLFGDkwebX47xAmzyXE29z8JrmcWv,654456706,1447086042,-792629336,706
2022-04-30 21:19:54-04:00,17144,BTXyxGnrKr9qhFyMSVYQa6gpkcE16SoY1G4FHxXCf7HK,AdNjtbQ6Sbu9uuU19tHdCGD17stQhEhgR1S5Nwkj8xrV,True,791158988,197789747,1383391,691695,691696,68sueyVfmy5ToEGtLFGDkwebX47xAmzyXE29z8JrmcWv,55335660,162714975,-107379315,699
2022-04-30 21:19:59-04:00,17145,5B3nic6AUDSiweK5kgbwd6W9DqqX9tJ1zUSQHNWPe24b,2cpauDZ4j1ACSoFfR55NNEVh9quRiVcSFF7Zq3L26U8a,True,4590543214,1147635803,6971173,3485586,3485587,68sueyVfmy5ToEGtLFGDkwebX47xAmzyXE29z8JrmcWv,278846936,959581192,-680734256,607
2022-04-30 21:19:59-04:00,17146,DZnaFtxiEHUv3geRGsKufTnCUhkSMbN2M7W4Bwu2LgkM,A38xXBMxA13qQnVB1tcd5USxpfdaUGmkp31FeTmCyb52,True,2546729611,357640746,2349230,1174615,1174615,68sueyVfmy5ToEGtLFGDkwebX47xAmzyXE29z8JrmcWv,167286728,535740412,-368453684,656
2022-04-30 21:19:59-04:00,17147,GD6Hw8ZErxFJeA5PunxorcUNN5v9gM77mWPjHT3Mx2Bw,EmreHG5gVyyL7iVhoxq8GcmzPV7V6SBxVNZajutC5HAF,True,106390546,26597636,185208,92604,92604,68sueyVfmy5ToEGtLFGDkwebX47xAmzyXE29z8JrmcWv,7408337,31610393,-24202056,696
2022-04-30 21:22:22-04:00,17148,DZnaFtxiEHUv3geRGsKufTnCUhkSMbN2M7W4Bwu2LgkM,A38xXBMxA13qQnVB1tcd5USxpfdaUGmkp31FeTmCyb52,True,2179385314,278200793,1981577,990788,990789,68sueyVfmy5ToEGtLFGDkwebX47xAmzyXE29z8JrmcWv,155233947,458933533,-303699586,712
2022-04-30 21:22:22-04:00,17149,FU7X4DWnGTbxwXULBq3v9SACzYhQyFGqsXjUDzyFqiem,925BaEnWxTfEv4oQb9Xf1wyyEEWEr8kXeSdXTtRfShfw,True,35644646,8911161,55019,27509,27510,68sueyVfmy5ToEGtLFGDkwebX47xAmzyXE29z8JrmcWv,2200777,13363522,-11162745,617
2022-04-30 21:22:28-04:00,17150,5bF9tSdmHqni2jdMMbLfiE5jxHtX8WoJXNXxMuykuojW,FrRNyeq1GrnBbAdBeEMPKX6yv54KJLhTpoPBB3irxDei,True,129586356,32396589,218949,109474,109475,68sueyVfmy5ToEGtLFGDkwebX47xAmzyXE29z8JrmcWv,8757967,40464641,-31706674,675
2022-04-30 21:23:38-04:00,17151,2yH4iJWVSDWHGjm5J95sbsRbHGA81VNPaox8xz8DWQaG,EHUYNPTqdUDGi3TBrr5BjDByCzLKq27CECCFUNyGRbQR,True,110025553,27506388,185724,92862,92862,68sueyVfmy5ToEGtLFGDkwebX47xAmzyXE29z8JrmcWv,7428991,32124628,-24695637,675
2022-04-30 21:23:46-04:00,17152,5B3nic6AUDSiweK5kgbwd6W9DqqX9tJ1zUSQHNWPe24b,2cpauDZ4j1ACSoFfR55NNEVh9quRiVcSFF7Zq3L26U8a,True,3403079548,850769887,5801197,2900598,2900599,68sueyVfmy5ToEGtLFGDkwebX47xAmzyXE29z8JrmcWv,232047900,784249395,-552201495,681
2022-04-30 21:23:47-04:00,17153,5QxR9QPTADFys9VQNm473RgprTikCXC23vhsBc9ojyAQ,H9zdf8nJ4JCF7jrwGsxiuiFoa14gzDmYsZ5N5ig3UGna,True,42891213,10722803,72845,36422,36423,68sueyVfmy5ToEGtLFGDkwebX47xAmzyXE29z8JrmcWv,2913801,11752571,-8838770,679
2022-04-30 21:25:12-04:00,17154,9XuUGP13n5xuMtUYhAH1fe9jFKK7FjgTzcuJqDfV1gqC,AFNffLzWzrg7vgdwxyHeaSc6kUtqYPV8pRvdUx8wt7x3,True,47557726206,3489775609,17342176,8671088,8671088,68sueyVfmy5ToEGtLFGDkwebX47xAmzyXE29z8JrmcWv,2363345332,5715201959,-3351856627,496
2022-04-30 21:26:15-04:00,17155,4ix593T9wKzayR8FqXFc2xZjNiEXM1MafowMVgP9c3AU,Go4gJoYfXXZjxNH4PFd9knsSCjDkgw5QQy7KzgUrUb2n,True,83629461,20907365,142642,71321,71321,68sueyVfmy5ToEGtLFGDkwebX47xAmzyXE29z8JrmcWv,5705706,31937676,-26231970,682
2022-04-30 21:26:17-04:00,17156,5zSoXxVZYYQAtq3urfcUQmJkjFDBXkUJYSNFdq759Tof,3C459gJnmj4EYTG3tDFJEEf1aAT915sxRLs2THEdQqha,True,160438673,40109668,277928,138964,138964,68sueyVfmy5ToEGtLFGDkwebX47xAmzyXE29z8JrmcWv,11117145,73252316,-62135171,692
2022-04-30 21:26:20-04:00,17157,BTXyxGnrKr9qhFyMSVYQa6gpkcE16SoY1G4FHxXCf7HK,AdNjtbQ6Sbu9uuU19tHdCGD17stQhEhgR1S5Nwkj8xrV,True,578816410,144704102,984985,492492,492493,68sueyVfmy5ToEGtLFGDkwebX47xAmzyXE29z8JrmcWv,39399438,134540285,-95140847,680
2022-04-30 21:26:20-04:00,17158,DZnaFtxiEHUv3geRGsKufTnCUhkSMbN2M7W4Bwu2LgkM,A38xXBMxA13qQnVB1tcd5USxpfdaUGmkp31FeTmCyb52,True,1877994026,261938369,1814073,907036,907037,68sueyVfmy5ToEGtLFGDkwebX47xAmzyXE29z8JrmcWv,130061875,438719363,-308657488,692
2022-04-30 21:26:55-04:00,17159,26wo1RqwKXrNnfgMdZEmkGhnDbURpZcp2hasB5EA5QtD,34gwTVGRrdoaBzLUG6SBwRwBovkjBjCebqVUBan6GDnB,True,77405646342,19351411585,136768971,68384485,68384486,A9TwRM1BMxqb8DCC7YNAMV6zPenEJm3HTZBy7wJKK58U,5470758852,17955482519,-12484723667,706
2022-04-30 21:27:28-04:00,17160,DEYKQVQEyKTJgJHjDpx3MQH9CG5EQ7KXL8WkiySJRdwc,GhPFddgHMCFvUaY3RKGbEackBki3evMEyt1hUD4X1JYc,True,3128038617,782009654,4632039,2316019,2316020,68sueyVfmy5ToEGtLFGDkwebX47xAmzyXE29z8JrmcWv,185281595,998334117,-813052522,592
2022-04-30 21:27:28-04:00,17161,5bF9tSdmHqni2jdMMbLfiE5jxHtX8WoJXNXxMuykuojW,FrRNyeq1GrnBbAdBeEMPKX6yv54KJLhTpoPBB3irxDei,False,92530938,92530938,3880189,194009,3686180,68sueyVfmy5ToEGtLFGDkwebX47xAmzyXE29z8JrmcWv,3880189,32320604,-28440415,419
2022-04-30 21:27:28-04:00,17162,BTXyxGnrKr9qhFyMSVYQa6gpkcE16SoY1G4FHxXCf7HK,AdNjtbQ6Sbu9uuU19tHdCGD17stQhEhgR1S5Nwkj8xrV,True,420689447,105172361,624789,312394,312395,68sueyVfmy5ToEGtLFGDkwebX47xAmzyXE29z8JrmcWv,24991592,109799832,-84808240,594
2022-04-30 21:27:29-04:00,17163,BWta2HTjCwDidjsgv1vPoD3gCHSGf679N1xijEj5jzD3,JEFa5ojXJ95W2NsV5j8qBENTm5n1uGfPDFwLRvebHDVn,True,39727361,9931840,61283,30641,30642,68sueyVfmy5ToEGtLFGDkwebX47xAmzyXE29z8JrmcWv,2451340,20332542,-17881202,617
2022-04-30 21:27:29-04:00,17164,2HtcCr92gzqZEmnEYKrsC2d2euFz7djLYzqnbDSbhd82,3wKxFATyaQK6kZd2UahQjvL9tzMGuN2767EguLmj1bot,True,37880758,9470183,58642,29321,29321,68sueyVfmy5ToEGtLFGDkwebX47xAmzyXE29z8JrmcWv,2345729,10521623,-8175894,619
2022-04-30 21:27:31-04:00,17165,5B3nic6AUDSiweK5kgbwd6W9DqqX9tJ1zUSQHNWPe24b,2cpauDZ4j1ACSoFfR55NNEVh9quRiVcSFF7Zq3L26U8a,False,2444459132,2444459132,118396174,5919808,112476366,68sueyVfmy5ToEGtLFGDkwebX47xAmzyXE29z8JrmcWv,118396174,641418105,-523021931,484
2022-04-30 21:27:31-04:00,17166,4ix593T9wKzayR8FqXFc2xZjNiEXM1MafowMVgP9c3AU,Go4gJoYfXXZjxNH4PFd9knsSCjDkgw5QQy7KzgUrUb2n,True,60379689,15094922,80516,40258,40258,68sueyVfmy5ToEGtLFGDkwebX47xAmzyXE29z8JrmcWv,3220657,25237741,-22017084,533
2022-04-30 21:27:32-04:00,17167,F2AU2PjaSmHxWWhkz8XxMggkCMWbMVgawt89tSnYS6RL,ET9febRJiW197DYMaJbgk3kWsAeFv5f4peQ4vFCVppK6,True,1129130022,282282505,1944304,972152,972152,68sueyVfmy5ToEGtLFGDkwebX47xAmzyXE29z8JrmcWv,77772190,175954679,-98182489,688
2022-04-30 21:27:32-04:00,17168,DZnaFtxiEHUv3geRGsKufTnCUhkSMbN2M7W4Bwu2LgkM,A38xXBMxA13qQnVB1tcd5USxpfdaUGmkp31FeTmCyb52,True,1580048376,395012093,2306012,1153006,1153006,68sueyVfmy5ToEGtLFGDkwebX47xAmzyXE29z8JrmcWv,92240521,374687112,-282446591,583
2022-04-30 21:27:33-04:00,17169,HCAGpyYM2NYudMd55Geta13tUbS6eiygnJY5ULHsHAVa,3PPyWhqXrmifWPieLV34bZ1rzi8eEnrDDAF7ifXkXspn,True,498036516,101768980,645817,322908,322909,68sueyVfmy5ToEGtLFGDkwebX47xAmzyXE29z8JrmcWv,31604991,111221455,-79616464,634
2022-04-30 21:27:33-04:00,17170,9XuUGP13n5xuMtUYhAH1fe9jFKK7FjgTzcuJqDfV1gqC,AFNffLzWzrg7vgdwxyHeaSc6kUtqYPV8pRvdUx8wt7x3,True,43533099636,8705830540,36219758,18109879,18109879,68sueyVfmy5ToEGtLFGDkwebX47xAmzyXE29z8JrmcWv,1811152195,5633583090,-3822430895,416
2022-04-30 21:27:33-04:00,17171,68zbVKnneMQqngbNkeLtPEP2ayNhawc1B2hPgqAEqgXK,HqiFpLr4NC7xJz9bEFusq8bCKaoxAQG1xsLxdUAzg8aa,True,246150351,22911420,86019,43009,43010,68sueyVfmy5ToEGtLFGDkwebX47xAmzyXE29z8JrmcWv,9241523,106998423,-97756900,375
2022-04-30 21:27:34-04:00,17172,GD6Hw8ZErxFJeA5PunxorcUNN5v9gM77mWPjHT3Mx2Bw,EmreHG5gVyyL7iVhoxq8GcmzPV7V6SBxVNZajutC5HAF,False,75341110,75341110,2771329,138566,2632763,68sueyVfmy5ToEGtLFGDkwebX47xAmzyXE29z8JrmcWv,2771329,25375719,-22604390,367
2022-04-30 21:27:34-04:00,17173,5XMSf6nTr2km7UuU48qq8TB24G1TBoQVW9MhBkK2tgbF,bgyCWqQ2ucQiG45xDetzbvte3xFHhKJ84EHrAnQiVEN,True,37465240,9366310,53771,26885,26886,68sueyVfmy5ToEGtLFGDkwebX47xAmzyXE29z8JrmcWv,2150868,25189880,-23039012,574
2022-04-30 21:27:34-04:00,17174,2yH4iJWVSDWHGjm5J95sbsRbHGA81VNPaox8xz8DWQaG,EHUYNPTqdUDGi3TBrr5BjDByCzLKq27CECCFUNyGRbQR,False,78798515,78798515,3522617,176130,3346487,68sueyVfmy5ToEGtLFGDkwebX47xAmzyXE29z8JrmcWv,3522617,25766119,-22243502,447
2022-04-30 21:27:34-04:00,17175,AK8KFprmWXtUTpgruZZX7YvQMKybkNV18FGoWdqndEEj,3Nz7CzTMfSs1XcFxACXRo8XUDgBTzTXq8fk6ZbKBYoMS,True,253236148,63309037,352387,176193,176194,68sueyVfmy5ToEGtLFGDkwebX47xAmzyXE29z8JrmcWv,14095506,53662760,-39567254,556
2022-04-30 21:27:34-04:00,17176,5QxR9QPTADFys9VQNm473RgprTikCXC23vhsBc9ojyAQ,H9zdf8nJ4JCF7jrwGsxiuiFoa14gzDmYsZ5N5ig3UGna,False,30737373,30737373,1409919,70495,1339424,68sueyVfmy5ToEGtLFGDkwebX47xAmzyXE29z8JrmcWv,1409919,9470202,-8060283,458
2022-04-30 21:27:34-04:00,17177,4ix593T9wKzayR8FqXFc2xZjNiEXM1MafowMVgP9c3AU,Go4gJoYfXXZjxNH4PFd9knsSCjDkgw5QQy7KzgUrUb2n,True,45270728,11317682,78152,39076,39076,68sueyVfmy5ToEGtLFGDkwebX47xAmzyXE29z8JrmcWv,3126102,19653341,-16527239,690
2022-04-30 21:27:36-04:00,17178,5zSoXxVZYYQAtq3urfcUQmJkjFDBXkUJYSNFdq759Tof,3C459gJnmj4EYTG3tDFJEEf1aAT915sxRLs2THEdQqha,True,115800602,28950150,157770,78885,78885,68sueyVfmy5ToEGtLFGDkwebX47xAmzyXE29z8JrmcWv,6310814,57443313,-51132499,544
2022-04-30 21:27:38-04:00,17179,7VPQAQJ1b25pFeJTeyxitfbJXXGP2wMKiHsfCLA97vrK,3M7r9CzKmUPcT1b6SXsz6MQq61tPXWCUSVsuRek3f8Rk,False,7372666482,7372666482,361649767,18082488,343567279,68sueyVfmy5ToEGtLFGDkwebX47xAmzyXE29z8JrmcWv,361649768,1283043600,-921393832,490
2022-04-30 21:27:40-04:00,17180,5zSoXxVZYYQAtq3urfcUQmJkjFDBXkUJYSNFdq759Tof,3C459gJnmj4EYTG3tDFJEEf1aAT915sxRLs2THEdQqha,True,86285457,21571364,139701,69850,69851,68sueyVfmy5ToEGtLFGDkwebX47xAmzyXE29z8JrmcWv,5588049,44503918,-38915869,647
2022-04-30 21:27:40-04:00,17181,3Dc89y1Z6ViLFDoY3vwcJewSjMQam2mSTqPtpxsPZVz5,4NfXm5CTgNUTQd6NPj2hKwjMYDr7a8d5yVC9rV2uTcjA,True,1313688088,328422022,2140740,1070370,1070370,68sueyVfmy5ToEGtLFGDkwebX47xAmzyXE29z8JrmcWv,85629620,221513385,-135883765,651
2022-04-30 21:27:40-04:00,17182,BTXyxGnrKr9qhFyMSVYQa6gpkcE16SoY1G4FHxXCf7HK,AdNjtbQ6Sbu9uuU19tHdCGD17stQhEhgR1S5Nwkj8xrV,True,312715020,78178755,539118,269559,269559,68sueyVfmy5ToEGtLFGDkwebX47xAmzyXE29z8JrmcWv,21564737,87989455,-66424718,689
2022-04-30 21:27:40-04:00,17183,DZnaFtxiEHUv3geRGsKufTnCUhkSMbN2M7W4Bwu2LgkM,A38xXBMxA13qQnVB1tcd5USxpfdaUGmkp31FeTmCyb52,True,1178210435,153004823,1079265,539632,539633,68sueyVfmy5ToEGtLFGDkwebX47xAmzyXE29z8JrmcWv,83108661,301870099,-218761438,705
2022-04-30 21:27:40-04:00,17184,CeoZ82imadaXaJHLw597HxGfaHvefRtAErFLLtcpEYe3,C7Rf33dms1PLrASt1nPWqFiiaX7ZBq76h8RS3JMTR6yX,True,54991085,8006706,55940,27970,27970,68sueyVfmy5ToEGtLFGDkwebX47xAmzyXE29z8JrmcWv,3842101,10743530,-6901429,698
2022-04-30 21:27:45-04:00,17185,9XuUGP13n5xuMtUYhAH1fe9jFKK7FjgTzcuJqDfV1gqC,AFNffLzWzrg7vgdwxyHeaSc6kUtqYPV8pRvdUx8wt7x3,True,34742937636,2162723576,10523872,5261936,5261936,68sueyVfmy5ToEGtLFGDkwebX47xAmzyXE29z8JrmcWv,1690600977,5402719427,-3712118450,486
2022-04-30 21:28:01-04:00,17186,DEYKQVQEyKTJgJHjDpx3MQH9CG5EQ7KXL8WkiySJRdwc,GhPFddgHMCFvUaY3RKGbEackBki3evMEyt1hUD4X1JYc,True,2320503957,580125989,3878113,1939056,1939057,68sueyVfmy5ToEGtLFGDkwebX47xAmzyXE29z8JrmcWv,155124550,791393728,-636269178,668
2022-04-30 21:28:18-04:00,17187,HT2SuCbePhjNZaar24uVwihYowCNvSjdvhJ8BRSVw9nX,98Ts4LCnapHVoCJ5PW3Armvh4jvDtpfs3SYRLRxiAgzZ,True,1172237966,79464377,279272,139636,139636,gjBMZYVujDjD1ECG4i97M8Q3gV9ESnwwTSUGropkusj,41197546,374056954,-332859408,351
2022-04-30 21:28:38-04:00,17188,3qaXKaNNT8mpC4KnA868wYkDCojg8ukUVxN19dtfYbPM,5o21p7NCXgv5cYPtBqQVvR3Ses6mHceYgCNmd5VL3tkG,True,25363362,3327662,15130,7565,7565,68sueyVfmy5ToEGtLFGDkwebX47xAmzyXE29z8JrmcWv,1153299,8084369,-6931070,454
2022-04-30 21:28:38-04:00,17189,SEndYVMCKAeZUKSqGrMUSqXFmxtA9M1t4eXsUhVsTBF,3fcQQcbkpqodakamn82pFnMxBEPL2Drsg4jJNZ6dx72M,True,647853627,67597178,408721,204360,204361,68sueyVfmy5ToEGtLFGDkwebX47xAmzyXE29z8JrmcWv,39172004,118798788,-79626784,604
2022-04-30 21:28:39-04:00,17190,68RZsaAJib9kw5xnnt9QhvsAa1DGJzww1MKqACsMvxGr,3z8H2C111LCABJymwxJAG9boicBXcJXq3ft6jqmV9rSw,False,11660810,11660810,768005,38400,729605,68sueyVfmy5ToEGtLFGDkwebX47xAmzyXE29z8JrmcWv,768005,4946601,-4178596,658
2022-04-30 21:28:46-04:00,17191,442usWu6XpJZvU25bqXeynRrQ15jAzWwU9DWMgHpTn3Q,CtvADKp39bjJf3cPKWNL3wxnhq273fVM4fC5DmEcg5cC,True,1905659359,350567536,1309165,654582,654583,68sueyVfmy5ToEGtLFGDkwebX47xAmzyXE29z8JrmcWv,71165319,479552846,-408387527,373
2022-04-30 21:29:10-04:00,17192,HT2SuCbePhjNZaar24uVwihYowCNvSjdvhJ8BRSVw9nX,98Ts4LCnapHVoCJ5PW3Armvh4jvDtpfs3SYRLRxiAgzZ,True,1091858279,67227593,246305,123152,123153,68sueyVfmy5ToEGtLFGDkwebX47xAmzyXE29z8JrmcWv,40002964,347747812,-307744848,366
2022-04-30 21:30:04-04:00,17193,GPxK4UCtUp9rPcETBeVtjTje2GCrpA1bGZEJDyqXvkyb,FScTTU3P6dh3ptbcJRfbpsgeyRQQKFyamiKFJQkLfD2Y,True,739610336,103615942,643153,321576,321577,68sueyVfmy5ToEGtLFGDkwebX47xAmzyXE29z8JrmcWv,45908314,141396770,-95488456,620
2022-04-30 21:30:11-04:00,17194,J6ndjmic8buVqwa4URRRgv2iTc4ekbYUHdcpa3DUCufN,7qvvczUw8ngwdQae49BiQwQmdV2SSWsAVV2tmZYL7gw6,True,53009704,13252426,82619,41309,41310,68sueyVfmy5ToEGtLFGDkwebX47xAmzyXE29z8JrmcWv,3304790,34217423,-30912633,623
2022-04-30 21:30:13-04:00,17195,68zbVKnneMQqngbNkeLtPEP2ayNhawc1B2hPgqAEqgXK,HqiFpLr4NC7xJz9bEFusq8bCKaoxAQG1xsLxdUAzg8aa,True,223145630,20450711,83052,41526,41526,68sueyVfmy5ToEGtLFGDkwebX47xAmzyXE29z8JrmcWv,9062203,95856029,-86793826,406
2022-04-30 21:31:26-04:00,17196,AXBfrbCpYAWKN5jgDVVMiKXscQ96YtotKV3DT6XSzm9o,Dh3SiHAqrQzPQnTLRMxtBn2EFyHNgyfnYGpgcuNGTvyL,True,183985806,45996451,284817,142408,142409,68sueyVfmy5ToEGtLFGDkwebX47xAmzyXE29z8JrmcWv,11392695,81986871,-70594176,619
2022-04-30 21:33:31-04:00,17197,B6Wc3euMqUf6QjzCqDtNeAEUM7MvADFaiReEq9VYH2Qg,2pzhsqXYd5u7h4xTN8bMS3GbicVnJ6KY3MQn7spSXroA,True,110005785,15848476,47952,23976,23976,68sueyVfmy5ToEGtLFGDkwebX47xAmzyXE29z8JrmcWv,3328440,26780908,-23452468,302
2022-04-30 21:33:54-04:00,17198,HCAGpyYM2NYudMd55Geta13tUbS6eiygnJY5ULHsHAVa,3PPyWhqXrmifWPieLV34bZ1rzi8eEnrDDAF7ifXkXspn,True,388335990,74343894,440845,220422,220423,68sueyVfmy5ToEGtLFGDkwebX47xAmzyXE29z8JrmcWv,23027628,97264730,-74237102,592
2022-04-30 21:37:23-04:00,17199,5zSoXxVZYYQAtq3urfcUQmJkjFDBXkUJYSNFdq759Tof,3C459gJnmj4EYTG3tDFJEEf1aAT915sxRLs2THEdQqha,True,63191586,15797896,98146,49073,49073,68sueyVfmy5ToEGtLFGDkwebX47xAmzyXE29z8JrmcWv,3925841,34636091,-30710250,621
2022-04-30 21:37:25-04:00,17200,BTXyxGnrKr9qhFyMSVYQa6gpkcE16SoY1G4FHxXCf7HK,AdNjtbQ6Sbu9uuU19tHdCGD17stQhEhgR1S5Nwkj8xrV,True,229030418,57257604,387994,193997,193997,68sueyVfmy5ToEGtLFGDkwebX47xAmzyXE29z8JrmcWv,15519772,70853383,-55333611,677
2022-04-30 21:37:30-04:00,17201,4ix593T9wKzayR8FqXFc2xZjNiEXM1MafowMVgP9c3AU,Go4gJoYfXXZjxNH4PFd9knsSCjDkgw5QQy7KzgUrUb2n,True,32935156,8233789,50751,25375,25376,68sueyVfmy5ToEGtLFGDkwebX47xAmzyXE29z8JrmcWv,2030060,15443597,-13413537,616
2022-04-30 21:37:30-04:00,17202,DEYKQVQEyKTJgJHjDpx3MQH9CG5EQ7KXL8WkiySJRdwc,GhPFddgHMCFvUaY3RKGbEackBki3evMEyt1hUD4X1JYc,True,1703314597,425828649,2854576,1427288,1427288,68sueyVfmy5ToEGtLFGDkwebX47xAmzyXE29z8JrmcWv,114183066,628982758,-514799692,670
2022-04-30 21:37:32-04:00,17203,DZnaFtxiEHUv3geRGsKufTnCUhkSMbN2M7W4Bwu2LgkM,A38xXBMxA13qQnVB1tcd5USxpfdaUGmkp31FeTmCyb52,True,1014350056,138168088,969483,484741,484742,68sueyVfmy5ToEGtLFGDkwebX47xAmzyXE29z8JrmcWv,71173840,287007107,-215833267,701
2022-04-30 21:37:44-04:00,17204,5UDGqNpkcMDjByBNi7WYMg8VJ81EzNJu48zsXbW9irSd,FmtUoQNiG25v8sn4pveM6wAWvja9u6FvZ2gdxWHSRjur,True,47888752,11972188,67131,33565,33566,68sueyVfmy5ToEGtLFGDkwebX47xAmzyXE29z8JrmcWv,2685252,25698380,-23013128,560
2022-04-30 21:37:44-04:00,17205,SEndYVMCKAeZUKSqGrMUSqXFmxtA9M1t4eXsUhVsTBF,3fcQQcbkpqodakamn82pFnMxBEPL2Drsg4jJNZ6dx72M,True,574136191,113802667,651864,325932,325932,68sueyVfmy5ToEGtLFGDkwebX47xAmzyXE29z8JrmcWv,32886755,109948105,-77061350,572
2022-04-30 21:37:44-04:00,17206,9aiCspGbT2sQ2i1baA8W8dqrf4eXTctJv9mZoNqB8H38,BayC5iE67qEXYoK4toPFgGcSUr8qohMHtZKiRm4b4Apv,True,2324193996,581048499,3425125,1712562,1712563,68sueyVfmy5ToEGtLFGDkwebX47xAmzyXE29z8JrmcWv,137005007,1561794542,-1424789535,589
2022-04-30 21:37:55-04:00,17207,4SQQdHTJUDv8taPXQRvEVJpUu91iCWQsv9su8tfehaQG,33CJXj1pmmatAofRvgt5in9E6SLEuy7tq4jqSwnUWP2A,True,63884391,15971097,99454,49727,49727,68sueyVfmy5ToEGtLFGDkwebX47xAmzyXE29z8JrmcWv,3978165,70367828,-66389663,622
2022-04-30 21:38:05-04:00,17208,3vksavY8WtjeR782H7yxd3cjWWhXzHRrAyB3kwTiMkNu,5k6mtkyDwR7yMf1p83sSRwFLHfRKoPutQJsYVwKa4o5e,True,24110496,6027624,37644,18822,18822,68sueyVfmy5ToEGtLFGDkwebX47xAmzyXE29z8JrmcWv,1505784,14895823,-13390039,624
2022-04-30 21:39:22-04:00,17209,5T4jHXRqVtbW652b2fPLSvwskATYsKFhZNEYgHjdgobp,59NBuPsARxZk4GZqabXZA3nyZkBNDuJmALWsCpD4xas9,True,24105699,6026424,37536,18768,18768,C4UnXuShCvjSMgBAgVNMy1oakxCNk1et27A82fywU112,1501477,14896003,-13394526,622
2022-04-30 21:39:29-04:00,17210,FtF3PVw8YNJseWPMcA2GEuQZ6nni1mq5kYPa2LrSzfkW,4yr1TM2dXrBvLNMpSaoryuGU2P8D3WG1ZCkvVzWFiQRH,True,34931700,2820950,14407,7203,7204,C4UnXuShCvjSMgBAgVNMy1oakxCNk1et27A82fywU112,1784043,20916995,-19132952,510
2022-04-30 21:41:12-04:00,17211,EyNCsqWu8zLyuRnXSbzJWnWZg7ZLjb4oJSZFdDSkbXmT,6rMMMkZibUHXYs8hXY3FmG4rgBx6gWDRGJwR2bP2t6ZD,True,37637342830,9409335707,64601014,32300507,32300507,C4UnXuShCvjSMgBAgVNMy1oakxCNk1et27A82fywU112,2584040591,9954991712,-7370951121,686
2022-04-30 21:41:17-04:00,17212,9XuUGP13n5xuMtUYhAH1fe9jFKK7FjgTzcuJqDfV1gqC,AFNffLzWzrg7vgdwxyHeaSc6kUtqYPV8pRvdUx8wt7x3,True,32434432289,4593172584,21727783,10863891,10863892,C4UnXuShCvjSMgBAgVNMy1oakxCNk1et27A82fywU112,1534295334,4650540963,-3116245629,473
2022-04-30 21:41:37-04:00,17213,4ix593T9wKzayR8FqXFc2xZjNiEXM1MafowMVgP9c3AU,Go4gJoYfXXZjxNH4PFd9knsSCjDkgw5QQy7KzgUrUb2n,True,24424830,6106207,42569,21284,21285,C4UnXuShCvjSMgBAgVNMy1oakxCNk1et27A82fywU112,1702772,12039583,-10336811,697
2022-04-30 21:41:38-04:00,17214,5zSoXxVZYYQAtq3urfcUQmJkjFDBXkUJYSNFdq759Tof,3C459gJnmj4EYTG3tDFJEEf1aAT915sxRLs2THEdQqha,True,46860289,11715072,82357,41178,41179,C4UnXuShCvjSMgBAgVNMy1oakxCNk1et27A82fywU112,3294294,26860850,-23566556,703
2022-04-30 21:42:44-04:00,17215,CDVtXFbo4Rg2aHsXKv5P3uRJq9ZTgsRd7GXPTxgH5xv9,6zj37qQnaiJT7xGEZmSKx5yQvisQFcs5KhGsG43SGd5y,True,874163087,108453042,343378,171689,171689,68sueyVfmy5ToEGtLFGDkwebX47xAmzyXE29z8JrmcWv,27677284,281106946,-253429662,316
2022-04-30 21:44:16-04:00,17216,AK8KFprmWXtUTpgruZZX7YvQMKybkNV18FGoWdqndEEj,3Nz7CzTMfSs1XcFxACXRo8XUDgBTzTXq8fk6ZbKBYoMS,True,187898029,46974507,292850,146425,146425,2a35JJeTUW1pm6M3e8DHCjp8qr4vbc2cRPhuzZWyFzYd,11714037,43421226,-31707189,623
2022-04-30 21:44:17-04:00,17217,3qaXKaNNT8mpC4KnA868wYkDCojg8ukUVxN19dtfYbPM,5o21p7NCXgv5cYPtBqQVvR3Ses6mHceYgCNmd5VL3tkG,True,21944406,1550005,7394,3697,3697,2a35JJeTUW1pm6M3e8DHCjp8qr4vbc2cRPhuzZWyFzYd,1046875,7642510,-6595635,477
2022-04-30 21:44:38-04:00,17218,442usWu6XpJZvU25bqXeynRrQ15jAzWwU9DWMgHpTn3Q,CtvADKp39bjJf3cPKWNL3wxnhq273fVM4fC5DmEcg5cC,True,1547531282,262279386,1055801,527900,527901,C4UnXuShCvjSMgBAgVNMy1oakxCNk1et27A82fywU112,62295613,438966893,-376671280,402
2022-04-30 23:59:17-04:00,17219,EyNCsqWu8zLyuRnXSbzJWnWZg7ZLjb4oJSZFdDSkbXmT,6rMMMkZibUHXYs8hXY3FmG4rgBx6gWDRGJwR2bP2t6ZD,True,42218482208,10554620552,74758435,37379217,37379218,gjBMZYVujDjD1ECG4i97M8Q3gV9ESnwwTSUGropkusj,2990337414,8222829265,-5232491851,708
2022-05-01 00:14:49-04:00,17220,FRbeFwhUYCiHW5oP26mad8KND7CCYDbfnoNxX7GuXVp8,GrzXKxPX2WDka8i2D8sunMUsrsThKasQi8NYLwuCGygV,True,7565054995,721561790,3072396,1536198,1536198,68sueyVfmy5ToEGtLFGDkwebX47xAmzyXE29z8JrmcWv,322118607,2061532173,-1739413566,425
2022-05-01 00:21:45-04:00,17221,5BjBPqumCb9KC82ZNNch3dcRzbpGdRLJneru7o9a1D9R,FuZtBWKktxFu4yoiLVMzxq8fMhQyN8SGzGPz49xs3m6P,True,28157141,2314902,9452,4726,4726,68sueyVfmy5ToEGtLFGDkwebX47xAmzyXE29z8JrmcWv,1149748,11433445,-10283697,408
2022-05-01 01:17:13-04:00,17222,3RpbaFEL5ZYrQBPpaAeCUXs43Ssdr5Tm4ScMGtp6XbYF,CpKGwcVZrd3vKTNhdF8xNsd77FT3QxQWb7xFQxiyPB5p,True,4146846412,1036711603,6476292,3238146,3238146,3zqXX6kzhkbW3d4TwD2CNjMRwxTbREXySekvq37kfCNk,259051710,1549491685,-1290439975,624
2022-05-01 01:20:35-04:00,17223,D5VZNThkv6XD6bimPshD2J3PvbPXgCbivZuPfkVxgdjc,8C77LmMk4C3KvyEb1N3scdbAgwN7J45nAcv9tkL5namB,True,764584860,191146215,1194084,597042,597042,3zqXX6kzhkbW3d4TwD2CNjMRwxTbREXySekvq37kfCNk,47763365,289886741,-242123376,624
2022-05-01 01:22:59-04:00,17224,FhCW2CghBaoo1MkXUXUb4okam8g5beQofgs3WXerNYzn,HWSPdmF3hSnnfVe29Y5rDGSPqbMQv2ug1wYrdwJZNWFK,True,39154400,9788600,29630,14815,14815,68sueyVfmy5ToEGtLFGDkwebX47xAmzyXE29z8JrmcWv,1185222,3745826,-2560604,302
2022-05-01 03:23:10-04:00,17225,7frvVhg1eWJpsvG7ndjppb8Bmd1tFq5H1g26UiKZxqTP,3Ugo9b53e6e8PLnvKjqRP8pvvoubSPV6qiKtxey7mrGt,True,360698078,90174519,271014,135507,135507,A2p75MbAbeUdHkPLkAjgGeiwuu9WPrkMHzjCkDXF1Xr3,10840571,88499954,-77659383,300
2022-05-01 03:23:12-04:00,17226,4PZZxNrWLhNCuT5VJ1DQe3XxQVVwMPrjfUpdeAY8qS7U,A7CvKre7y5VbUN1HneNHmuBv7jWtayV78oozAqaVbQrv,True,34148720,8537180,25680,12840,12840,2a35JJeTUW1pm6M3e8DHCjp8qr4vbc2cRPhuzZWyFzYd,1027225,16489034,-15461809,300
2022-05-01 05:05:08-04:00,17227,HT2SuCbePhjNZaar24uVwihYowCNvSjdvhJ8BRSVw9nX,98Ts4LCnapHVoCJ5PW3Armvh4jvDtpfs3SYRLRxiAgzZ,True,1031342128,147676163,676125,338062,338063,2a35JJeTUW1pm6M3e8DHCjp8qr4vbc2cRPhuzZWyFzYd,47219301,340112132,-292892831,457
2022-05-01 05:08:50-04:00,17228,EyNCsqWu8zLyuRnXSbzJWnWZg7ZLjb4oJSZFdDSkbXmT,6rMMMkZibUHXYs8hXY3FmG4rgBx6gWDRGJwR2bP2t6ZD,True,39262647734,9815661933,69790758,34895379,34895379,GXyFXZMNk2NFyEzw6JetVqsujqcz2yCixH7n8EpDJYWD,2791630323,7010343650,-4218713327,711
2022-05-01 05:12:27-04:00,17229,8fVwuVA2CL5sZoHh6Dg4MBpcX3cvoUm7mnitnpQSdPBD,4F4ccaNm1KQu29XvsKvdjFkmpsbWqNvXkV41851EYQyu,True,27407948,1942277,9120,4560,4560,2a35JJeTUW1pm6M3e8DHCjp8qr4vbc2cRPhuzZWyFzYd,1286961,10121665,-8834704,469
2022-05-01 05:14:12-04:00,17230,5BjBPqumCb9KC82ZNNch3dcRzbpGdRLJneru7o9a1D9R,FuZtBWKktxFu4yoiLVMzxq8fMhQyN8SGzGPz49xs3m6P,False,25697154,25697154,994981,49749,945232,68sueyVfmy5ToEGtLFGDkwebX47xAmzyXE29z8JrmcWv,994982,10335257,-9340275,387
2022-05-01 05:56:53-04:00,17231,HT2SuCbePhjNZaar24uVwihYowCNvSjdvhJ8BRSVw9nX,98Ts4LCnapHVoCJ5PW3Armvh4jvDtpfs3SYRLRxiAgzZ,True,879356013,59742605,286924,143462,143462,DQCvC9mR68hJ3tJsUiddh6JwcBJAmntqGJR2nUsEq7yj,42232674,291715210,-249482536,480
2022-05-01 06:07:25-04:00,17232,HC1b8nLcDMKUUawsUAtBZWcnUPar8hnPj62SzRkm2gwN,D35pnirxqPaBJGF4HA6netazEE3nb68kkbC6CzvLJ7bd,True,24064702,6016175,37593,18796,18797,2a35JJeTUW1pm6M3e8DHCjp8qr4vbc2cRPhuzZWyFzYd,1503752,14939495,-13435743,624
2022-05-01 06:07:34-04:00,17233,AQr9mVmcXCNQhBVCfx63MwR6c4WqDSC9K2BZqr7N8LCx,CB7TWUaL381ounsLw6neAUaKRxJL9P1HC9uGX5e1Uxod,True,25742158,1480864,7343,3671,3672,C4UnXuShCvjSMgBAgVNMy1oakxCNk1et27A82fywU112,1276639,10671387,-9394748,495
2022-05-01 06:11:08-04:00,17234,9VojCEgzn99QRVPGKn6euGRQbM7Q86GZ6yHJQa7N3gv4,GW4GVNnUtEt68avsowddpmjoUTUyMvxV4c5kY3Gzz9fT,True,48882568,4428739,27615,13807,13808,68sueyVfmy5ToEGtLFGDkwebX47xAmzyXE29z8JrmcWv,3048143,31952372,-28904229,623
2022-05-01 06:12:29-04:00,17235,6tzQa5NhTz3pFvHujaTa5yN8zsoog7ZN4uLebjoaS6MH,8X1n5LHfXQJw3V6TcXe38tGBUEC7hC432P1jaigACBKE,True,23995098,5998774,37402,18701,18701,2a35JJeTUW1pm6M3e8DHCjp8qr4vbc2cRPhuzZWyFzYd,1496109,15001147,-13505038,623
2022-05-01 06:13:27-04:00,17236,HT2SuCbePhjNZaar24uVwihYowCNvSjdvhJ8BRSVw9nX,98Ts4LCnapHVoCJ5PW3Armvh4jvDtpfs3SYRLRxiAgzZ,True,816192440,49250696,232166,116083,116083,GXyFXZMNk2NFyEzw6JetVqsujqcz2yCixH7n8EpDJYWD,38475127,271999055,-233523928,471
2022-05-01 06:37:22-04:00,17237,31TiU5VAiR77Zec49S5x2Y9EqdyMqi8Gx5T2bLxAazhU,iZkdEaFdSoYXBFEp3GPVJZvg5ZbiVdjNvHaTEvXxUmp,True,11735041030,2933760257,20876781,10438390,10438391,2a35JJeTUW1pm6M3e8DHCjp8qr4vbc2cRPhuzZWyFzYd,835071257,604748579,230322678,711
2022-05-01 06:57:09-04:00,17238,HDMvxWha3zz9uPwZMRXWJYZNhTHxzwHMoYX4Raog1i31,4erL3sEBdK32eYY5w8vaeih9r1uC1vCrbsV8NxR4asEa,True,31800876,7950219,49242,24621,24621,2a35JJeTUW1pm6M3e8DHCjp8qr4vbc2cRPhuzZWyFzYd,1969693,20169356,-18199663,619
2022-05-01 08:08:13-04:00,17239,3AkvQbPAHEzH3GUxq2AvXqjBUXhFCNRy37SVgrNHQ2Yr,J54M4DSHnerw8hc7dzU4zu8eMTeFtGnecKWKerWEvi9E,True,17699444,4424861,27490,13745,13745,C4UnXuShCvjSMgBAgVNMy1oakxCNk1et27A82fywU112,1099609,11525332,-10425723,621
2022-05-01 08:08:19-04:00,17240,2TX5VVdU5eEyJvmhZw3kryUeoC7TnKwoTerd8g2y3TPu,5y3GUw6HECEDFf6FshpeqFV2QhCr3EDs4ouYYhWSq4C,True,17019673,4254918,26591,13295,13296,68sueyVfmy5ToEGtLFGDkwebX47xAmzyXE29z8JrmcWv,1063673,10741314,-9677641,624
2022-05-01 08:08:19-04:00,17241,2KNEkmiSdvP33dQtxfa9jUuPeD31jHXqCC4mWiJAohmo,7ae3EWN4UafWPYs9ToMrGHmjwJyiWxpVqHfrQ8KvYfkt,True,17699412,4424853,27644,13822,13822,2a35JJeTUW1pm6M3e8DHCjp8qr4vbc2cRPhuzZWyFzYd,1105764,11531750,-10425986,624
2022-05-01 08:09:06-04:00,17242,8sUHtr1dGhr9xBUiUYNknaFnHRW3Xyp2dPEviRia5NTL,CA4Zfp28QYkjaBz4JKKjn8Qrm5qn4VVS75MAxSAqLDqN,True,23757845,5939461,37119,18559,18560,2a35JJeTUW1pm6M3e8DHCjp8qr4vbc2cRPhuzZWyFzYd,1484788,15227071,-13742283,624
2022-05-01 08:48:20-04:00,17243,qDomXCaxa3BBJSuLnKRAHvBLMbMcWAzUNXtGDZTSD8F,57ch9yViUFJCGJcWUvNEDU1yGzC6AvPh4Ac3ynWZzLf1,True,32329910,8082477,50456,25228,25228,2a35JJeTUW1pm6M3e8DHCjp8qr4vbc2cRPhuzZWyFzYd,2018269,19688624,-17670355,624
2022-05-01 08:53:57-04:00,17244,EyNCsqWu8zLyuRnXSbzJWnWZg7ZLjb4oJSZFdDSkbXmT,6rMMMkZibUHXYs8hXY3FmG4rgBx6gWDRGJwR2bP2t6ZD,True,28670927169,7167731792,48737526,24368763,24368763,A9TwRM1BMxqb8DCC7YNAMV6zPenEJm3HTZBy7wJKK58U,1949501042,6023101718,-4073600676,679
2022-05-01 08:54:10-04:00,17245,F4hN7ecndZ8Gr5KQNSFaSrMGawMasz7jfWTLTMpk7gaB,AJ23FpXSGjipcqywk88WGsKfqfiiUjPzZLsvLtBAhB12,True,572268124,76297181,512797,256398,256399,2a35JJeTUW1pm6M3e8DHCjp8qr4vbc2cRPhuzZWyFzYd,38462488,125227145,-86764657,672
2022-05-01 08:54:13-04:00,17246,EyNCsqWu8zLyuRnXSbzJWnWZg7ZLjb4oJSZFdDSkbXmT,6rMMMkZibUHXYs8hXY3FmG4rgBx6gWDRGJwR2bP2t6ZD,True,21100828125,5275207031,37459906,18729953,18729953,6UQfSsLooL4pQKQfLtXCutQS2BnF7A7F7ewJopDLmUpc,1498396264,5030601165,-3532204901,710
2022-05-01 08:54:17-04:00,17247,DZnaFtxiEHUv3geRGsKufTnCUhkSMbN2M7W4Bwu2LgkM,A38xXBMxA13qQnVB1tcd5USxpfdaUGmkp31FeTmCyb52,True,862266758,116102395,775365,387682,387683,C4UnXuShCvjSMgBAgVNMy1oakxCNk1et27A82fywU112,57584683,243102898,-185518215,667
2022-05-01 08:54:17-04:00,17248,5zSoXxVZYYQAtq3urfcUQmJkjFDBXkUJYSNFdq759Tof,3C459gJnmj4EYTG3tDFJEEf1aAT915sxRLs2THEdQqha,True,34099912,8524978,56091,28045,28046,C4UnXuShCvjSMgBAgVNMy1oakxCNk1et27A82fywU112,2243657,20964141,-18720484,657
2022-05-01 08:54:17-04:00,17249,4ix593T9wKzayR8FqXFc2xZjNiEXM1MafowMVgP9c3AU,Go4gJoYfXXZjxNH4PFd9knsSCjDkgw5QQy7KzgUrUb2n,True,17773474,4443368,28880,14440,14440,C4UnXuShCvjSMgBAgVNMy1oakxCNk1et27A82fywU112,1155200,9453025,-8297825,649
2022-05-01 08:54:18-04:00,17250,EneQUyUwfKFNwfdgNRdZBdX2frHixmVDK2GxDRU78QB,Gk8BVo53foZz1tMdLf85ZKpAPeLFZbCqwM6KYhmN6WNc,True,32286388,8071597,50324,25162,25162,2a35JJeTUW1pm6M3e8DHCjp8qr4vbc2cRPhuzZWyFzYd,2012990,19727283,-17714293,623
2022-05-01 08:54:20-04:00,17251,3vksavY8WtjeR782H7yxd3cjWWhXzHRrAyB3kwTiMkNu,5k6mtkyDwR7yMf1p83sSRwFLHfRKoPutQJsYVwKa4o5e,True,17695946,4423986,27604,13802,13802,2a35JJeTUW1pm6M3e8DHCjp8qr4vbc2cRPhuzZWyFzYd,1104194,11533667,-10429473,623
2022-05-01 08:54:24-04:00,17252,5T4jHXRqVtbW652b2fPLSvwskATYsKFhZNEYgHjdgobp,59NBuPsARxZk4GZqabXZA3nyZkBNDuJmALWsCpD4xas9,True,17695930,4423982,27589,13794,13795,2a35JJeTUW1pm6M3e8DHCjp8qr4vbc2cRPhuzZWyFzYd,1103576,11532834,-10429258,623
2022-05-01 08:54:25-04:00,17253,BjCNaM7YbE9SjFi7tzi4677zg1fKXGJwtecz2GWwWuhd,6rNsSrKZezQrLb2whToNjnizpnurDXrobHqfEK3QqU1M,True,76963689,10307602,46379,23189,23190,2a35JJeTUW1pm6M3e8DHCjp8qr4vbc2cRPhuzZWyFzYd,3463000,35999158,-32536158,449
2022-05-01 08:54:54-04:00,17254,FgN4MoQn7NQXUv5ok1TY8QsWs3kwyK3tjZzkPAe8EsWe,7576owqSfZKV1mzJgpdY5HEYzvnBSk46yRfpJ76oqjnJ,False,32697948,32697948,988681,49434,939247,2a35JJeTUW1pm6M3e8DHCjp8qr4vbc2cRPhuzZWyFzYd,988682,5516108,-4527426,302
2022-05-01 08:55:03-04:00,17255,FtF3PVw8YNJseWPMcA2GEuQZ6nni1mq5kYPa2LrSzfkW,4yr1TM2dXrBvLNMpSaoryuGU2P8D3WG1ZCkvVzWFiQRH,True,31915796,2068208,10335,5167,5168,2a35JJeTUW1pm6M3e8DHCjp8qr4vbc2cRPhuzZWyFzYd,1595006,18919291,-17324285,499
2022-05-01 08:55:05-04:00,17256,HC1b8nLcDMKUUawsUAtBZWcnUPar8hnPj62SzRkm2gwN,D35pnirxqPaBJGF4HA6netazEE3nb68kkbC6CzvLJ7bd,True,17685901,4421475,27567,13783,13784,2a35JJeTUW1pm6M3e8DHCjp8qr4vbc2cRPhuzZWyFzYd,1102706,11542157,-10439451,623
2022-05-01 08:55:25-04:00,17257,3WcJUt8jQ1ngL3ZCGo6dFrc3GmTMTYtzeDva7mri2Tqx,HeG1Pz2oMjqtkfsRMsbqP3VpatnVEQzcWmKDVoFp4Htr,True,25444491,6361122,39737,19868,19869,C4UnXuShCvjSMgBAgVNMy1oakxCNk1et27A82fywU112,1589480,11400958,-9811478,624
2022-05-01 08:55:37-04:00,17258,6zLsQakpDaa2cggm9g5BbrrUY3e6tsEEi4jQYrB1GucR,HYs4PktD8Kh89iDVTSnoHwMY619mffCwo9Uog8u17KbK,True,38481163,9620290,29089,14544,14545,2a35JJeTUW1pm6M3e8DHCjp8qr4vbc2cRPhuzZWyFzYd,1163582,13817405,-12653823,302
2022-05-01 08:55:56-04:00,17259,5NVD6QvomTAD35yNxSFZw4DhF2hCtV8drkbnGhBVtK5y,3JzkyPnREvoFZLL9JZuuDEnee3nuKcrqY3xLuXsmHwRo,False,94611,94611,5862,293,5569,2a35JJeTUW1pm6M3e8DHCjp8qr4vbc2cRPhuzZWyFzYd,5862,99145,-93283,619
2022-05-01 08:56:06-04:00,17260,5zqXqEjg95BnghcVbHRhYkSTYnzZjUBichgccv1BpS3d,9SuqSxrKpHh9NcNePe4Q3jXvpCmhNnoQv8YAFih3CqMX,True,14745776266,3686444066,11138934,5569467,5569467,A9TwRM1BMxqb8DCC7YNAMV6zPenEJm3HTZBy7wJKK58U,445557382,2918061916,-2472504534,302
2022-05-01 08:56:28-04:00,17261,3FF2rhr1RuT7UR7MmmGtrhfYbh6kbc5UXq51KmqFLZnq,AEmSYLt1dQ8suLugC4Lcw4kF3dG9GYcEfX54hEAKfmv5,False,436708,436708,27042,1352,25690,2a35JJeTUW1pm6M3e8DHCjp8qr4vbc2cRPhuzZWyFzYd,27042,258378,-231336,619
2022-05-01 08:56:28-04:00,17262,9VojCEgzn99QRVPGKn6euGRQbM7Q86GZ6yHJQa7N3gv4,GW4GVNnUtEt68avsowddpmjoUTUyMvxV4c5kY3Gzz9fT,True,44182976,4115963,25599,12799,12800,2a35JJeTUW1pm6M3e8DHCjp8qr4vbc2cRPhuzZWyFzYd,2747964,29312345,-26564381,621
2022-05-01 08:56:33-04:00,17263,6tzQa5NhTz3pFvHujaTa5yN8zsoog7ZN4uLebjoaS6MH,8X1n5LHfXQJw3V6TcXe38tGBUEC7hC432P1jaigACBKE,True,17639494,4409873,27526,13763,13763,2a35JJeTUW1pm6M3e8DHCjp8qr4vbc2cRPhuzZWyFzYd,1101050,11586677,-10485627,624
2022-05-01 08:56:33-04:00,17264,8fVwuVA2CL5sZoHh6Dg4MBpcX3cvoUm7mnitnpQSdPBD,4F4ccaNm1KQu29XvsKvdjFkmpsbWqNvXkV41851EYQyu,True,25345142,1611385,7340,3670,3670,5HnvdJnCCcmRsm4GkXnYWd4q9RpwuvYDGEUMPkYR3Ts9,1154667,8838579,-7683912,455
2022-05-01 08:56:42-04:00,17265,CDVtXFbo4Rg2aHsXKv5P3uRJq9ZTgsRd7GXPTxgH5xv9,6zj37qQnaiJT7xGEZmSKx5yQvisQFcs5KhGsG43SGd5y,True,762541603,89691973,284181,142090,142091,GXyFXZMNk2NFyEzw6JetVqsujqcz2yCixH7n8EpDJYWD,24160516,239582791,-215422275,316
2022-05-01 09:19:50-04:00,17266,3S97kmJCtH7xQsdt7jsSyncXZiDQ9W8D8Pe3eT98Xopo,TvE4rh5GFsaAYo4MpkueYkuDPjbbuFmsBCdYyfAikLg,True,32973302,8243325,51150,25575,25575,2a35JJeTUW1pm6M3e8DHCjp8qr4vbc2cRPhuzZWyFzYd,2046030,19072980,-17026950,620
2022-05-01 09:21:02-04:00,17267,DZnaFtxiEHUv3geRGsKufTnCUhkSMbN2M7W4Bwu2LgkM,A38xXBMxA13qQnVB1tcd5USxpfdaUGmkp31FeTmCyb52,True,741559560,99494247,701352,350676,350676,A2p75MbAbeUdHkPLkAjgGeiwuu9WPrkMHzjCkDXF1Xr3,52273863,233397312,-181123449,704
2022-05-01 09:21:40-04:00,17268,13GT6eaKWuaLe7wFcybCnUaYgd9DfyzYRN2FcXWgFwpC,CbwmJ7YpnvcqDyUw3L9b7dqXcA8Ju3rYrTdegeaJJbWC,True,271926028,67981507,424295,212147,212148,2a35JJeTUW1pm6M3e8DHCjp8qr4vbc2cRPhuzZWyFzYd,16971815,145435787,-128463972,624
2022-05-01 09:53:14-04:00,17269,9XuUGP13n5xuMtUYhAH1fe9jFKK7FjgTzcuJqDfV1gqC,AFNffLzWzrg7vgdwxyHeaSc6kUtqYPV8pRvdUx8wt7x3,True,19040432976,3204702864,20932934,10466467,10466467,A9TwRM1BMxqb8DCC7YNAMV6zPenEJm3HTZBy7wJKK58U,1243710142,4136993871,-2893283729,653
2022-05-01 09:56:37-04:00,17270,F4hN7ecndZ8Gr5KQNSFaSrMGawMasz7jfWTLTMpk7gaB,AJ23FpXSGjipcqywk88WGsKfqfiiUjPzZLsvLtBAhB12,True,506465552,68513810,467144,233572,233572,5HnvdJnCCcmRsm4GkXnYWd4q9RpwuvYDGEUMPkYR3Ts9,34532125,95591861,-61059736,681
2022-05-01 09:56:53-04:00,17271,BmFSXZx3HWaTtD7vp7AkUk5DUNjwK1qgLPod13EJz6No,DtLMfV3Xs7AAAQqC1PwL7YAfV6fig8yAMxr9MMxmyCKc,True,4323520179,1080880044,3245055,1622527,1622528,A9TwRM1BMxqb8DCC7YNAMV6zPenEJm3HTZBy7wJKK58U,129802216,223960158,-94157942,300
2022-05-01 10:13:35-04:00,17272,9XuUGP13n5xuMtUYhAH1fe9jFKK7FjgTzcuJqDfV1gqC,AFNffLzWzrg7vgdwxyHeaSc6kUtqYPV8pRvdUx8wt7x3,True,15937448473,2441366908,15647382,7823691,7823691,A9TwRM1BMxqb8DCC7YNAMV6zPenEJm3HTZBy7wJKK58U,1021474322,4028659374,-3007185052,640
2022-05-01 10:42:38-04:00,17273,BmFSXZx3HWaTtD7vp7AkUk5DUNjwK1qgLPod13EJz6No,DtLMfV3Xs7AAAQqC1PwL7YAfV6fig8yAMxr9MMxmyCKc,True,3272764942,818191235,2413547,1206773,1206774,5HnvdJnCCcmRsm4GkXnYWd4q9RpwuvYDGEUMPkYR3Ts9,96541898,197431823,-100889925,294
2022-05-01 13:03:54-04:00,17274,9XuUGP13n5xuMtUYhAH1fe9jFKK7FjgTzcuJqDfV1gqC,AFNffLzWzrg7vgdwxyHeaSc6kUtqYPV8pRvdUx8wt7x3,True,14163006491,1922450858,12738020,6369010,6369010,5HnvdJnCCcmRsm4GkXnYWd4q9RpwuvYDGEUMPkYR3Ts9,938430625,3904548855,-2966118230,662
2022-05-01 13:05:11-04:00,17275,BmFSXZx3HWaTtD7vp7AkUk5DUNjwK1qgLPod13EJz6No,DtLMfV3Xs7AAAQqC1PwL7YAfV6fig8yAMxr9MMxmyCKc,True,1354791431,338697857,1018237,509118,509119,2py1FiYeL2f7J3HU36qiJz6TD6HCmiTN36RyxYtapQCZ,40729494,73043034,-32313540,300
2022-05-01 13:07:10-04:00,17276,4Aec17wPWwDyUnrdhxAmmSVu1t6PsGRHcfBsCEShaAXF,5X748QphXuNtxbvpzysG69KA5msRvm413avZP6zwv6kk,True,1359071935,339767983,1023775,511887,511888,2xTUy2RS74GJMMDnmFaegMzFLn19RVfYG4CibhBmjP1i,40951032,68026128,-27075096,301
2022-05-01 13:29:48-04:00,17277,BmFSXZx3HWaTtD7vp7AkUk5DUNjwK1qgLPod13EJz6No,DtLMfV3Xs7AAAQqC1PwL7YAfV6fig8yAMxr9MMxmyCKc,True,1006790862,251697715,760213,380106,380107,2a35JJeTUW1pm6M3e8DHCjp8qr4vbc2cRPhuzZWyFzYd,30408545,63961530,-33552985,302
2022-05-01 13:32:01-04:00,17278,4Aec17wPWwDyUnrdhxAmmSVu1t6PsGRHcfBsCEShaAXF,5X748QphXuNtxbvpzysG69KA5msRvm413avZP6zwv6kk,True,1009652659,252413164,756899,378449,378450,2xTUy2RS74GJMMDnmFaegMzFLn19RVfYG4CibhBmjP1i,30275964,60248739,-29972775,299
2022-05-01 13:42:20-04:00,17279,fAJK1wrBhSW297AtFWX2U4rUBf2gkzfQ6UrQL9yHEYW,5pyTFpanSyUCHxeMhJMKtpdrcMSAWc8bFadbyM7q4q4B,True,291258781,72814695,218438,109219,109219,2a35JJeTUW1pm6M3e8DHCjp8qr4vbc2cRPhuzZWyFzYd,8737535,15341267,-6603732,299
2022-05-01 13:57:47-04:00,17280,F3Hq5hKQ7mh2PiaMDtqTd1xPrGCUszajivFu1pBqvsbk,6pjiEFs1jM2SvY5MCHpESPKg8EmUSPUSvEr19Z1WFy3X,True,47910883,11977720,35643,17821,17822,C4UnXuShCvjSMgBAgVNMy1oakxCNk1et27A82fywU112,1425724,4365810,-2940086,297
2022-05-01 14:12:31-04:00,17281,BmFSXZx3HWaTtD7vp7AkUk5DUNjwK1qgLPod13EJz6No,DtLMfV3Xs7AAAQqC1PwL7YAfV6fig8yAMxr9MMxmyCKc,True,748135850,187033962,566317,283158,283159,gjBMZYVujDjD1ECG4i97M8Q3gV9ESnwwTSUGropkusj,22652694,54783195,-32130501,302
2022-05-01 14:22:52-04:00,17282,4Aec17wPWwDyUnrdhxAmmSVu1t6PsGRHcfBsCEShaAXF,5X748QphXuNtxbvpzysG69KA5msRvm413avZP6zwv6kk,True,749062803,187265700,532597,266298,266299,gjBMZYVujDjD1ECG4i97M8Q3gV9ESnwwTSUGropkusj,21303890,51968650,-30664760,284
2022-05-01 14:23:08-04:00,17283,4hZG7dM716SxDagiFGwt1gSC99B2QK1emGLV9TJmmuR8,7vjfUWySkyx4Z5qAaRr2VWnVvxHHNsvPj1PirGNSjM6,True,422182895,105545723,649319,324659,324660,3zqXX6kzhkbW3d4TwD2CNjMRwxTbREXySekvq37kfCNk,25972772,273440153,-247467381,615
2022-05-01 14:25:16-04:00,17284,Ht5tqGiAf5tF8nRVDnpdvj7B9vNot6ijzykEDtQypxYC,2C7i83GfaXauAsZH3WMFofJdzNCpxeaQvVJ72iQb4fQM,True,19912911,4978227,30633,15316,15317,2a35JJeTUW1pm6M3e8DHCjp8qr4vbc2cRPhuzZWyFzYd,1225346,9463432,-8238086,615
2022-05-01 14:26:32-04:00,17285,AQr9mVmcXCNQhBVCfx63MwR6c4WqDSC9K2BZqr7N8LCx,CB7TWUaL381ounsLw6neAUaKRxJL9P1HC9uGX5e1Uxod,True,24180872,1296119,6348,3174,3174,C4UnXuShCvjSMgBAgVNMy1oakxCNk1et27A82fywU112,1184490,9719650,-8535160,489
2022-05-01 14:26:53-04:00,17286,FtF3PVw8YNJseWPMcA2GEuQZ6nni1mq5kYPa2LrSzfkW,4yr1TM2dXrBvLNMpSaoryuGU2P8D3WG1ZCkvVzWFiQRH,True,29725824,2010331,9858,4929,4929,C4UnXuShCvjSMgBAgVNMy1oakxCNk1et27A82fywU112,1457787,17353614,-15895827,490
2022-05-01 14:26:55-04:00,17287,5o4EAqBTiUKn41QhPL5kRjrGTgQVdP7xLtxC7xNxjkwn,E8gDreu3LxW1EHJ8hnqChK9QdffGh5GocJYKdrbYat8E,True,39773516,9943379,61127,30563,30564,C4UnXuShCvjSMgBAgVNMy1oakxCNk1et27A82fywU112,2445105,20653936,-18208831,614
2022-05-01 14:27:09-04:00,17288,E6aP64uFjkpvGaWYCAzW95RuURXmGGiCr63yzT8D8Bch,AVLR8LDxMvpjSU4XP7J5JoY8XwFyVu3YqEU45hzp2r8Z,True,32106302,8026575,49545,24772,24773,C4UnXuShCvjSMgBAgVNMy1oakxCNk1et27A82fywU112,1981818,19875683,-17893865,617
2022-05-01 14:27:51-04:00,17289,fAJK1wrBhSW297AtFWX2U4rUBf2gkzfQ6UrQL9yHEYW,5pyTFpanSyUCHxeMhJMKtpdrcMSAWc8bFadbyM7q4q4B,True,216478514,54119628,163559,81779,81780,5HnvdJnCCcmRsm4GkXnYWd4q9RpwuvYDGEUMPkYR3Ts9,6542391,13461465,-6919074,302
2022-05-01 14:27:52-04:00,17290,kn4CMFEGiFu6Sw8v7GAZaBNHKe5Mst4Bj2kds1B6Daw,4FAjghUCswqbD6SKVr7Mu9aLcSLxDofiBvxgkZeiVz32,True,93727904,12956004,38929,19464,19465,2a35JJeTUW1pm6M3e8DHCjp8qr4vbc2cRPhuzZWyFzYd,2816304,13270380,-10454076,300
2022-05-01 14:28:05-04:00,17291,HT2SuCbePhjNZaar24uVwihYowCNvSjdvhJ8BRSVw9nX,98Ts4LCnapHVoCJ5PW3Armvh4jvDtpfs3SYRLRxiAgzZ,True,763751270,109561490,500005,250002,250003,3zqXX6kzhkbW3d4TwD2CNjMRwxTbREXySekvq37kfCNk,34855357,264290617,-229435260,456
2022-05-01 14:28:11-04:00,17292,HDMvxWha3zz9uPwZMRXWJYZNhTHxzwHMoYX4Raog1i31,4erL3sEBdK32eYY5w8vaeih9r1uC1vCrbsV8NxR4asEa,True,23375061,5843765,35962,17981,17981,2a35JJeTUW1pm6M3e8DHCjp8qr4vbc2cRPhuzZWyFzYd,1438496,15563871,-14125375,615
2022-05-01 14:28:11-04:00,17293,BjCNaM7YbE9SjFi7tzi4677zg1fKXGJwtecz2GWwWuhd,6rNsSrKZezQrLb2whToNjnizpnurDXrobHqfEK3QqU1M,True,66392821,4460424,21132,10566,10566,2a35JJeTUW1pm6M3e8DHCjp8qr4vbc2cRPhuzZWyFzYd,3145596,32633480,-29487884,473
2022-05-01 14:28:14-04:00,17294,5XaryzRdShE48K6xMLJop7ieQVC7gp55MLG5UJ5C6mHA,BpessMA9vcqZMZKdAnR5JsDy6Y4qNpGNnPEc3nKDZLNY,True,32821862,8205465,51135,25567,25568,2a35JJeTUW1pm6M3e8DHCjp8qr4vbc2cRPhuzZWyFzYd,2045426,19223681,-17178255,623
2022-05-01 18:22:11-04:00,17295,4ix593T9wKzayR8FqXFc2xZjNiEXM1MafowMVgP9c3AU,Go4gJoYfXXZjxNH4PFd9knsSCjDkgw5QQy7KzgUrUb2n,False,13122086,13122086,925314,46265,879049,2a35JJeTUW1pm6M3e8DHCjp8qr4vbc2cRPhuzZWyFzYd,925314,7356741,-6431427,705
2022-05-01 18:22:14-04:00,17296,5zSoXxVZYYQAtq3urfcUQmJkjFDBXkUJYSNFdq759Tof,3C459gJnmj4EYTG3tDFJEEf1aAT915sxRLs2THEdQqha,True,25167776,6291944,44846,22423,22423,68sueyVfmy5ToEGtLFGDkwebX47xAmzyXE29z8JrmcWv,1793866,16241533,-14447667,712
2022-05-01 18:22:18-04:00,17297,9XuUGP13n5xuMtUYhAH1fe9jFKK7FjgTzcuJqDfV1gqC,AFNffLzWzrg7vgdwxyHeaSc6kUtqYPV8pRvdUx8wt7x3,True,6631332796,1657833199,11754954,5877477,5877477,2py1FiYeL2f7J3HU36qiJz6TD6HCmiTN36RyxYtapQCZ,470198169,677874497,-207676328,709
2022-05-01 18:23:15-04:00,17298,F4hN7ecndZ8Gr5KQNSFaSrMGawMasz7jfWTLTMpk7gaB,AJ23FpXSGjipcqywk88WGsKfqfiiUjPzZLsvLtBAhB12,True,421390594,55516544,395075,197537,197538,3zqXX6kzhkbW3d4TwD2CNjMRwxTbREXySekvq37kfCNk,29987711,100916488,-70928777,711
2022-05-01 18:24:06-04:00,17299,EyNCsqWu8zLyuRnXSbzJWnWZg7ZLjb4oJSZFdDSkbXmT,6rMMMkZibUHXYs8hXY3FmG4rgBx6gWDRGJwR2bP2t6ZD,False,15081028107,15081028107,724739749,36236987,688502762,A2p75MbAbeUdHkPLkAjgGeiwuu9WPrkMHzjCkDXF1Xr3,724739749,4160297756,-3435558007,480
2022-05-01 18:24:20-04:00,17300,9XuUGP13n5xuMtUYhAH1fe9jFKK7FjgTzcuJqDfV1gqC,AFNffLzWzrg7vgdwxyHeaSc6kUtqYPV8pRvdUx8wt7x3,True,4798891578,1199722894,7095879,3547939,3547940,6UQfSsLooL4pQKQfLtXCutQS2BnF7A7F7ewJopDLmUpc,283835196,617881984,-334046788,591
2022-05-01 18:24:20-04:00,17301,DZnaFtxiEHUv3geRGsKufTnCUhkSMbN2M7W4Bwu2LgkM,A38xXBMxA13qQnVB1tcd5USxpfdaUGmkp31FeTmCyb52,True,629352428,157338107,975422,487711,487711,2a35JJeTUW1pm6M3e8DHCjp8qr4vbc2cRPhuzZWyFzYd,39016921,195534485,-156517564,619
2022-05-01 18:24:23-04:00,17302,F4hN7ecndZ8Gr5KQNSFaSrMGawMasz7jfWTLTMpk7gaB,AJ23FpXSGjipcqywk88WGsKfqfiiUjPzZLsvLtBAhB12,True,359743200,49762659,332116,166058,166058,68sueyVfmy5ToEGtLFGDkwebX47xAmzyXE29z8JrmcWv,24009346,76938979,-52929633,667
2022-05-01 18:24:23-04:00,17303,5zSoXxVZYYQAtq3urfcUQmJkjFDBXkUJYSNFdq759Tof,3C459gJnmj4EYTG3tDFJEEf1aAT915sxRLs2THEdQqha,True,18127728,4531932,25022,12511,12511,5HnvdJnCCcmRsm4GkXnYWd4q9RpwuvYDGEUMPkYR3Ts9,1000916,12584852,-11583936,552
2022-05-01 18:59:08-04:00,17304,Cb6MEn1MN9XQcVVd3o9J8QdK3cFWxSNETsFzhVJ8jmdh,A6yTKbggUftjbjAVu5YR1M7rg7h78ghbfofmTSnmKNGz,True,1875127778,468781944,1416679,708339,708340,2py1FiYeL2f7J3HU36qiJz6TD6HCmiTN36RyxYtapQCZ,56667192,91852468,-35185276,302
2022-05-02 00:56:16-04:00,17305,31TiU5VAiR77Zec49S5x2Y9EqdyMqi8Gx5T2bLxAazhU,iZkdEaFdSoYXBFEp3GPVJZvg5ZbiVdjNvHaTEvXxUmp,True,12022950153,3005737538,21428025,10714012,10714013,A2p75MbAbeUdHkPLkAjgGeiwuu9WPrkMHzjCkDXF1Xr3,857121022,1160320989,-303199967,712
2022-05-02 02:19:10-04:00,17306,D85pWm1LS9MvtR4f3QhkFLvNUhZLQ2NZBFQTyAVnmigm,CRN85DYkJJi6irhtVAf4qcJU3ijVodWdXgWe7Fs6Ahka,True,365337488,91334372,649759,324879,324880,2a35JJeTUW1pm6M3e8DHCjp8qr4vbc2cRPhuzZWyFzYd,25990375,33867631,-7877256,711
2022-05-02 04:22:27-04:00,17307,8qq2gfbca7JXvq4gViBBVT2QAbM4MvBMEQLXgn8UUTvt,3o5jpBVYdFFEYrGRdCUkLrUC85wsuTKgy8iYwnpZyC1B,True,83618908,10942542,49477,24738,24739,2a35JJeTUW1pm6M3e8DHCjp8qr4vbc2cRPhuzZWyFzYd,3780891,44668334,-40887443,452
2022-05-02 04:31:26-04:00,17308,8qq2gfbca7JXvq4gViBBVT2QAbM4MvBMEQLXgn8UUTvt,3o5jpBVYdFFEYrGRdCUkLrUC85wsuTKgy8iYwnpZyC1B,True,72369678,5160740,24687,12343,12344,2a35JJeTUW1pm6M3e8DHCjp8qr4vbc2cRPhuzZWyFzYd,3461988,45553521,-42091533,478
2022-05-02 05:58:29-04:00,17309,F2AU2PjaSmHxWWhkz8XxMggkCMWbMVgawt89tSnYS6RL,ET9febRJiW197DYMaJbgk3kWsAeFv5f4peQ4vFCVppK6,True,2178728319,544682079,1618893,809446,809447,6UQfSsLooL4pQKQfLtXCutQS2BnF7A7F7ewJopDLmUpc,64755747,108216018,-43460271,297
2022-05-02 06:19:24-04:00,17310,F2AU2PjaSmHxWWhkz8XxMggkCMWbMVgawt89tSnYS6RL,ET9febRJiW197DYMaJbgk3kWsAeFv5f4peQ4vFCVppK6,True,1620045670,405011417,1225071,612535,612536,2xTUy2RS74GJMMDnmFaegMzFLn19RVfYG4CibhBmjP1i,49002871,95637822,-46634951,302
2022-05-02 06:51:22-04:00,17311,F4hN7ecndZ8Gr5KQNSFaSrMGawMasz7jfWTLTMpk7gaB,AJ23FpXSGjipcqywk88WGsKfqfiiUjPzZLsvLtBAhB12,True,312368477,40295635,287677,143838,143839,2a35JJeTUW1pm6M3e8DHCjp8qr4vbc2cRPhuzZWyFzYd,22300587,82565218,-60264631,713
2022-05-02 06:52:35-04:00,17312,8qq2gfbca7JXvq4gViBBVT2QAbM4MvBMEQLXgn8UUTvt,3o5jpBVYdFFEYrGRdCUkLrUC85wsuTKgy8iYwnpZyC1B,True,66628020,4667549,21795,10897,10898,2a35JJeTUW1pm6M3e8DHCjp8qr4vbc2cRPhuzZWyFzYd,3111262,40126485,-37015223,466
2022-05-02 07:12:23-04:00,17313,3AkvQbPAHEzH3GUxq2AvXqjBUXhFCNRy37SVgrNHQ2Yr,J54M4DSHnerw8hc7dzU4zu8eMTeFtGnecKWKerWEvi9E,False,13026298,13026298,810549,40527,770022,2a35JJeTUW1pm6M3e8DHCjp8qr4vbc2cRPhuzZWyFzYd,810549,8878137,-8067588,622
2022-05-02 07:12:41-04:00,17314,2KNEkmiSdvP33dQtxfa9jUuPeD31jHXqCC4mWiJAohmo,7ae3EWN4UafWPYs9ToMrGHmjwJyiWxpVqHfrQ8KvYfkt,False,13020319,13020319,810595,40529,770066,2a35JJeTUW1pm6M3e8DHCjp8qr4vbc2cRPhuzZWyFzYd,810595,8884335,-8073740,622
2022-05-02 07:12:50-04:00,17315,A5NXadGWnFZRoHEn1dKTRjcXgWmfMLMyJdpF4rQPZyRR,ALs3Zfotc4c4A6TFDMbd5GM5whK1dTYSnGrHiMBWmApH,True,8656416285,2164104071,6199861,3099930,3099931,DQCvC9mR68hJ3tJsUiddh6JwcBJAmntqGJR2nUsEq7yj,247994473,431063810,-183069337,286
2022-05-02 07:12:52-04:00,17316,1EH82ta3wXUyUwW8VWQnVzSG3r1rHcSj2DvDeTKmp3F,B6aMfucYPbCzWBtauLtgTpwR45wKSK8yqscHJR3F5usu,True,614369818,153592454,450871,225435,225436,2a35JJeTUW1pm6M3e8DHCjp8qr4vbc2cRPhuzZWyFzYd,18034865,34357372,-16322507,293
2022-05-02 07:12:54-04:00,17317,2TX5VVdU5eEyJvmhZw3kryUeoC7TnKwoTerd8g2y3TPu,5y3GUw6HECEDFf6FshpeqFV2QhCr3EDs4ouYYhWSq4C,False,12518164,12518164,777716,38885,738831,2a35JJeTUW1pm6M3e8DHCjp8qr4vbc2cRPhuzZWyFzYd,777716,8282547,-7504831,621
2022-05-02 07:13:16-04:00,17318,8sUHtr1dGhr9xBUiUYNknaFnHRW3Xyp2dPEviRia5NTL,CA4Zfp28QYkjaBz4JKKjn8Qrm5qn4VVS75MAxSAqLDqN,True,17477785,4369446,27230,13615,13615,5HnvdJnCCcmRsm4GkXnYWd4q9RpwuvYDGEUMPkYR3Ts9,1089219,11736548,-10647329,623
2022-05-02 07:13:28-04:00,17319,BAkPsWHtpVcEGqUgKTKjwZ6d5aaUcaUhdgYxBnpSTDW2,BDwDmVaZnXh22sf8nsDtjVfgxMAswbM3PW3si3k4nbRK,True,5306214314,1326553578,3972915,1986457,1986458,2xTUy2RS74GJMMDnmFaegMzFLn19RVfYG4CibhBmjP1i,158916607,978097564,-819180957,299
2022-05-02 07:14:08-04:00,17320,BmFSXZx3HWaTtD7vp7AkUk5DUNjwK1qgLPod13EJz6No,DtLMfV3Xs7AAAQqC1PwL7YAfV6fig8yAMxr9MMxmyCKc,True,555888521,138972130,408832,204416,204416,A2p75MbAbeUdHkPLkAjgGeiwuu9WPrkMHzjCkDXF1Xr3,16353319,45669302,-29315983,294
2022-05-02 07:15:25-04:00,17321,Ga6hKu2mWpMqDboq3ZajdiittrTvDqX9kqMDt2fi3t29,3zUEyHaYdzLGMZxDj2EZLCA6NzL7Ub9BGpE5PGGnw2GD,True,31907093,7976773,49523,24761,24762,3zqXX6kzhkbW3d4TwD2CNjMRwxTbREXySekvq37kfCNk,1980957,20074448,-18093491,620
2022-05-02 07:15:34-04:00,17322,9BjYvRf5A9UK99LvPTHd5DRvxMn2FWYKb5fpDxYDL48S,4kMo5gLVscVqwx6xQTLrn9JaEq1dFqq5Vfiq3Vb15vhi,True,32929981,8232495,51097,25548,25549,3zqXX6kzhkbW3d4TwD2CNjMRwxTbREXySekvq37kfCNk,2043903,19114162,-17070259,620
2022-05-02 07:15:34-04:00,17323,EvyJwXTqP5N4qPKwDiDTCfjLYgLWz1qEREsarcsZdhYD,CbnajpQJxW3fWpH9dohsipVnZJyUvqy5dYSRDBBaDeEp,True,32929925,8232481,51104,25552,25552,3zqXX6kzhkbW3d4TwD2CNjMRwxTbREXySekvq37kfCNk,2044193,19114931,-17070738,620
2022-05-02 07:15:36-04:00,17324,5zSoXxVZYYQAtq3urfcUQmJkjFDBXkUJYSNFdq759Tof,3C459gJnmj4EYTG3tDFJEEf1aAT915sxRLs2THEdQqha,False,13561284,13561284,946065,47303,898762,2a35JJeTUW1pm6M3e8DHCjp8qr4vbc2cRPhuzZWyFzYd,946065,9668574,-8722509,697
2022-05-02 07:15:38-04:00,17325,DaTBWfTXVs87zi3dTqVh5XzgXwiWQRjchLuJDAatuFFZ,2D7FhqNNaNmrPuvYmkh1WidD3CuqwRoMWJ6FQoPtzN9c,False,6643308,6643308,410863,20543,390320,2a35JJeTUW1pm6M3e8DHCjp8qr4vbc2cRPhuzZWyFzYd,410863,8779133,-8368270,618
2022-05-02 07:15:51-04:00,17326,F2AU2PjaSmHxWWhkz8XxMggkCMWbMVgawt89tSnYS6RL,ET9febRJiW197DYMaJbgk3kWsAeFv5f4peQ4vFCVppK6,True,1203635592,300908898,906996,453498,453498,DQCvC9mR68hJ3tJsUiddh6JwcBJAmntqGJR2nUsEq7yj,36279858,82676676,-46396818,301
2022-05-02 07:16:03-04:00,17327,9V7DXwq3RnVnLqRmtWXQJZgU3nHyVMteXAvaVaW3g1b6,94zfTWn693sbx9aaxamLUSHsbXdYxLpZVTvnetJ3SnhT,True,32958594,8239648,51436,25718,25718,2a35JJeTUW1pm6M3e8DHCjp8qr4vbc2cRPhuzZWyFzYd,2057471,19099515,-17042044,624
2022-05-02 07:16:03-04:00,17328,4YNWVEq2F3gR8XEbUQxJRqzi6i5KSfwf6mVMLPJrnpEd,EE5uomX5guX4ZeHiP6wcoH5C8k3tRGXo18JTWgNDqs1C,True,32935906,8233976,51168,25584,25584,C4UnXuShCvjSMgBAgVNMy1oakxCNk1et27A82fywU112,2046736,19111399,-17064663,621
2022-05-02 07:16:03-04:00,17329,2pcVNktE3dbyybTuEBSkdwWJS5sFcvYLMEKRQMwZy6eh,61GaKj6fDApZF9B3aTBxTzYk8e22XLFPsQ21pJdvDhBL,True,32935850,8233962,51171,25585,25586,2a35JJeTUW1pm6M3e8DHCjp8qr4vbc2cRPhuzZWyFzYd,2046857,19111151,-17064294,621
2022-05-02 07:16:03-04:00,17330,qDomXCaxa3BBJSuLnKRAHvBLMbMcWAzUNXtGDZTSD8F,57ch9yViUFJCGJcWUvNEDU1yGzC6AvPh4Ac3ynWZzLf1,True,23780587,5945146,36914,18457,18457,C4UnXuShCvjSMgBAgVNMy1oakxCNk1et27A82fywU112,1476565,15196210,-13719645,620
2022-05-02 07:37:16-04:00,17331,BAe9q4b1UwvQi5BHTmVh2GRguY3f9a5fbzXV2WiB93Ag,9uSCD3c3vHYC1i6odskxdugUaoSE5QYA1e8wkkW6aX5W,True,32944195,8236048,51407,25703,25704,2a35JJeTUW1pm6M3e8DHCjp8qr4vbc2cRPhuzZWyFzYd,2056310,19112329,-17056019,624
2022-05-02 07:37:37-04:00,17332,7FL3AxJZcTiCG6Ux7CVc82Nqo4msgmQASGvjfMEgQddc,EzcAwNya2eA7GD8ezmi49bEUP57Fq3w9SwN3uAG4HA2b,True,32914588,8228647,51198,25599,25599,C4UnXuShCvjSMgBAgVNMy1oakxCNk1et27A82fywU112,2047921,19112679,-17064758,622
2022-05-02 07:37:46-04:00,17333,EneQUyUwfKFNwfdgNRdZBdX2frHixmVDK2GxDRU78QB,Gk8BVo53foZz1tMdLf85ZKpAPeLFZbCqwM6KYhmN6WNc,True,23760296,5940074,37094,18547,18547,2a35JJeTUW1pm6M3e8DHCjp8qr4vbc2cRPhuzZWyFzYd,1483769,15224016,-13740247,624
2022-05-02 07:38:00-04:00,17334,5T4jHXRqVtbW652b2fPLSvwskATYsKFhZNEYgHjdgobp,59NBuPsARxZk4GZqabXZA3nyZkBNDuJmALWsCpD4xas9,False,13013576,13013576,804237,40211,764026,2a35JJeTUW1pm6M3e8DHCjp8qr4vbc2cRPhuzZWyFzYd,804237,8884563,-8080326,617
2022-05-02 07:38:00-04:00,17335,G85GTorkDswyxv8uxgpP1tr6DbXktiXjjX14VA4L2VVu,3EJ5raXpu6eveda4FjxAeWFNbDbQkgjyKfoFq183UeLC,True,32837727,8209431,50669,25334,25335,2a35JJeTUW1pm6M3e8DHCjp8qr4vbc2cRPhuzZWyFzYd,2026766,19113070,-17086304,617
2022-05-02 07:38:07-04:00,17336,3vksavY8WtjeR782H7yxd3cjWWhXzHRrAyB3kwTiMkNu,5k6mtkyDwR7yMf1p83sSRwFLHfRKoPutQJsYVwKa4o5e,False,13007495,13007495,798747,39937,758810,2a35JJeTUW1pm6M3e8DHCjp8qr4vbc2cRPhuzZWyFzYd,798747,8885327,-8086580,614
2022-05-02 07:40:23-04:00,17337,HC1b8nLcDMKUUawsUAtBZWcnUPar8hnPj62SzRkm2gwN,D35pnirxqPaBJGF4HA6netazEE3nb68kkbC6CzvLJ7bd,False,13011195,13011195,808510,40425,768085,C4UnXuShCvjSMgBAgVNMy1oakxCNk1et27A82fywU112,808510,8891340,-8082830,621
2022-05-02 07:45:58-04:00,17338,4SQQdHTJUDv8taPXQRvEVJpUu91iCWQsv9su8tfehaQG,33CJXj1pmmatAofRvgt5in9E6SLEuy7tq4jqSwnUWP2A,True,46973358,11743339,73091,36545,36546,2a35JJeTUW1pm6M3e8DHCjp8qr4vbc2cRPhuzZWyFzYd,2923674,53655942,-50732268,622
2022-05-02 07:56:56-04:00,17339,CQUTdvx2e9xnsgabMvJ2CEnXFeZ54C5NqZjCtCgpfkKP,FSuQ9an52w77Fra9JqvkwHTtp9uvAx4SgCYBYLc5SgsR,False,4288,4288,267,13,254,2a35JJeTUW1pm6M3e8DHCjp8qr4vbc2cRPhuzZWyFzYd,267,2301,-2034,622
2022-05-02 07:57:05-04:00,17340,6tzQa5NhTz3pFvHujaTa5yN8zsoog7ZN4uLebjoaS6MH,8X1n5LHfXQJw3V6TcXe38tGBUEC7hC432P1jaigACBKE,False,12980610,12980610,811115,40555,770560,2a35JJeTUW1pm6M3e8DHCjp8qr4vbc2cRPhuzZWyFzYd,811115,8924357,-8113242,624
2022-05-02 07:57:10-04:00,17341,9VojCEgzn99QRVPGKn6euGRQbM7Q86GZ6yHJQa7N3gv4,GW4GVNnUtEt68avsowddpmjoUTUyMvxV4c5kY3Gzz9fT,True,39863613,3585745,22409,11204,11205,2a35JJeTUW1pm6M3e8DHCjp8qr4vbc2cRPhuzZWyFzYd,2491329,26247483,-23756154,624
2022-05-02 07:58:02-04:00,17342,3S97kmJCtH7xQsdt7jsSyncXZiDQ9W8D8Pe3eT98Xopo,TvE4rh5GFsaAYo4MpkueYkuDPjbbuFmsBCdYyfAikLg,True,24260669,6065167,37547,18773,18774,2a35JJeTUW1pm6M3e8DHCjp8qr4vbc2cRPhuzZWyFzYd,1501914,14741468,-13239554,619
2022-05-02 08:42:08-04:00,17343,DZnaFtxiEHUv3geRGsKufTnCUhkSMbN2M7W4Bwu2LgkM,A38xXBMxA13qQnVB1tcd5USxpfdaUGmkp31FeTmCyb52,True,466460631,65153734,455207,227603,227604,2a35JJeTUW1pm6M3e8DHCjp8qr4vbc2cRPhuzZWyFzYd,32590043,155549206,-122959163,698
2022-05-02 09:36:15-04:00,17344,D8BtQirMEk3W9Pq29B6KkKWrwPfmsUNpwz5npx7aGMLY,J7LMZwaSoh5hbGcwee6oPsnN4ZFD7Zp3LQWkJGNUHRfJ,True,1088557442,272139360,1939698,969849,969849,GXyFXZMNk2NFyEzw6JetVqsujqcz2yCixH7n8EpDJYWD,77587938,252269220,-174681282,712
2022-05-02 09:37:11-04:00,17345,6zLsQakpDaa2cggm9g5BbrrUY3e6tsEEi4jQYrB1GucR,HYs4PktD8Kh89iDVTSnoHwMY619mffCwo9Uog8u17KbK,False,28629489,28629489,866373,43318,823055,2a35JJeTUW1pm6M3e8DHCjp8qr4vbc2cRPhuzZWyFzYd,866373,10588141,-9721768,302
2022-05-02 09:37:52-04:00,17346,5zqXqEjg95BnghcVbHRhYkSTYnzZjUBichgccv1BpS3d,9SuqSxrKpHh9NcNePe4Q3jXvpCmhNnoQv8YAFih3CqMX,True,10971079065,2742769766,8301854,4150927,4150927,GXyFXZMNk2NFyEzw6JetVqsujqcz2yCixH7n8EpDJYWD,332074197,2276771549,-1944697352,302
2022-05-02 09:38:31-04:00,17347,13GT6eaKWuaLe7wFcybCnUaYgd9DfyzYRN2FcXWgFwpC,CbwmJ7YpnvcqDyUw3L9b7dqXcA8Ju3rYrTdegeaJJbWC,True,200089212,50022303,311228,155614,155614,2a35JJeTUW1pm6M3e8DHCjp8qr4vbc2cRPhuzZWyFzYd,12449129,112654539,-100205410,622
2022-05-02 12:36:23-04:00,17348,SEndYVMCKAeZUKSqGrMUSqXFmxtA9M1t4eXsUhVsTBF,3fcQQcbkpqodakamn82pFnMxBEPL2Drsg4jJNZ6dx72M,True,469736582,52782356,335084,167542,167542,2a35JJeTUW1pm6M3e8DHCjp8qr4vbc2cRPhuzZWyFzYd,29820849,78788171,-48967322,634
2022-05-02 12:47:45-04:00,17349,DZnaFtxiEHUv3geRGsKufTnCUhkSMbN2M7W4Bwu2LgkM,A38xXBMxA13qQnVB1tcd5USxpfdaUGmkp31FeTmCyb52,True,397141927,51852904,365633,182816,182817,C4UnXuShCvjSMgBAgVNMy1oakxCNk1et27A82fywU112,28003883,149903996,-121900113,705
2022-05-02 12:47:50-04:00,17350,26wo1RqwKXrNnfgMdZEmkGhnDbURpZcp2hasB5EA5QtD,34gwTVGRrdoaBzLUG6SBwRwBovkjBjCebqVUBan6GDnB,True,56546519961,14136629990,97487567,48743783,48743784,2a35JJeTUW1pm6M3e8DHCjp8qr4vbc2cRPhuzZWyFzYd,3899502681,15184719371,-11285216690,689
2022-05-02 12:47:55-04:00,17351,CeoZ82imadaXaJHLw597HxGfaHvefRtAErFLLtcpEYe3,C7Rf33dms1PLrASt1nPWqFiiaX7ZBq76h8RS3JMTR6yX,True,46373822,6043123,41426,20713,20713,C4UnXuShCvjSMgBAgVNMy1oakxCNk1et27A82fywU112,3178980,10097329,-6918349,685
2022-05-02 12:49:56-04:00,17352,SEndYVMCKAeZUKSqGrMUSqXFmxtA9M1t4eXsUhVsTBF,3fcQQcbkpqodakamn82pFnMxBEPL2Drsg4jJNZ6dx72M,True,413681742,39178281,248005,124002,124003,2a35JJeTUW1pm6M3e8DHCjp8qr4vbc2cRPhuzZWyFzYd,26186825,65124155,-38937330,633
2022-05-02 12:51:33-04:00,17353,29JVska5UEG3axs63EmtHpPvkswNEqYpZ3PKMSfupiAG,DCftNBUsuogxyaJe9G9m3eWipH6o3qo4Rn4TuQXdVaBF,True,54381497,10022518,40953,20476,20477,2a35JJeTUW1pm6M3e8DHCjp8qr4vbc2cRPhuzZWyFzYd,2222134,10522490,-8300356,408
2022-05-02 12:51:39-04:00,17354,DZnaFtxiEHUv3geRGsKufTnCUhkSMbN2M7W4Bwu2LgkM,A38xXBMxA13qQnVB1tcd5USxpfdaUGmkp31FeTmCyb52,True,341368444,46804870,325191,162595,162596,2a35JJeTUW1pm6M3e8DHCjp8qr4vbc2cRPhuzZWyFzYd,23717671,124423754,-100706083,694
2022-05-02 12:53:13-04:00,17355,CeoZ82imadaXaJHLw597HxGfaHvefRtAErFLLtcpEYe3,C7Rf33dms1PLrASt1nPWqFiiaX7ZBq76h8RS3JMTR6yX,True,40050480,5492951,39188,19594,19594,2a35JJeTUW1pm6M3e8DHCjp8qr4vbc2cRPhuzZWyFzYd,2857335,9648734,-6791399,713
2022-05-02 12:53:30-04:00,17356,26wo1RqwKXrNnfgMdZEmkGhnDbURpZcp2hasB5EA5QtD,34gwTVGRrdoaBzLUG6SBwRwBovkjBjCebqVUBan6GDnB,True,41500690614,10375172653,72320393,36160196,36160197,C4UnXuShCvjSMgBAgVNMy1oakxCNk1et27A82fywU112,2892815757,12498231190,-9605415433,697
2022-05-02 12:53:30-04:00,17357,DZnaFtxiEHUv3geRGsKufTnCUhkSMbN2M7W4Bwu2LgkM,A38xXBMxA13qQnVB1tcd5USxpfdaUGmkp31FeTmCyb52,True,290066116,38435797,250372,125186,125186,2a35JJeTUW1pm6M3e8DHCjp8qr4vbc2cRPhuzZWyFzYd,18895022,118118164,-99223142,651
2022-05-02 12:53:49-04:00,17358,29JVska5UEG3axs63EmtHpPvkswNEqYpZ3PKMSfupiAG,DCftNBUsuogxyaJe9G9m3eWipH6o3qo4Rn4TuQXdVaBF,True,44049421,3501086,14875,7437,7438,2a35JJeTUW1pm6M3e8DHCjp8qr4vbc2cRPhuzZWyFzYd,1871623,8564599,-6692976,424
2022-05-02 13:03:03-04:00,17359,A5NXadGWnFZRoHEn1dKTRjcXgWmfMLMyJdpF4rQPZyRR,ALs3Zfotc4c4A6TFDMbd5GM5whK1dTYSnGrHiMBWmApH,True,6445140973,1611285243,4796173,2398086,2398087,A2p75MbAbeUdHkPLkAjgGeiwuu9WPrkMHzjCkDXF1Xr3,191846944,376943673,-185096729,297
2022-05-02 13:04:19-04:00,17360,29JVska5UEG3axs63EmtHpPvkswNEqYpZ3PKMSfupiAG,DCftNBUsuogxyaJe9G9m3eWipH6o3qo4Rn4TuQXdVaBF,True,40334990,7448977,30349,15174,15175,2a35JJeTUW1pm6M3e8DHCjp8qr4vbc2cRPhuzZWyFzYd,1643402,8319832,-6676430,407
2022-05-02 13:04:38-04:00,17361,HT2SuCbePhjNZaar24uVwihYowCNvSjdvhJ8BRSVw9nX,98Ts4LCnapHVoCJ5PW3Armvh4jvDtpfs3SYRLRxiAgzZ,True,651961150,44380656,214684,107342,107342,2a35JJeTUW1pm6M3e8DHCjp8qr4vbc2cRPhuzZWyFzYd,31537640,226214067,-194676427,483
2022-05-02 13:04:39-04:00,17362,BmFSXZx3HWaTtD7vp7AkUk5DUNjwK1qgLPod13EJz6No,DtLMfV3Xs7AAAQqC1PwL7YAfV6fig8yAMxr9MMxmyCKc,True,413202409,103300602,301296,150648,150648,2a35JJeTUW1pm6M3e8DHCjp8qr4vbc2cRPhuzZWyFzYd,12051860,37755484,-25703624,291
2022-05-02 13:35:48-04:00,17363,CeoZ82imadaXaJHLw597HxGfaHvefRtAErFLLtcpEYe3,C7Rf33dms1PLrASt1nPWqFiiaX7ZBq76h8RS3JMTR6yX,True,34107328,4470084,31066,15533,15533,68sueyVfmy5ToEGtLFGDkwebX47xAmzyXE29z8JrmcWv,2370414,8232300,-5861886,694
2022-05-02 13:35:51-04:00,17364,DZnaFtxiEHUv3geRGsKufTnCUhkSMbN2M7W4Bwu2LgkM,A38xXBMxA13qQnVB1tcd5USxpfdaUGmkp31FeTmCyb52,True,250646596,34215364,241857,120928,120929,68sueyVfmy5ToEGtLFGDkwebX47xAmzyXE29z8JrmcWv,17717435,98632111,-80914676,706
2022-05-02 13:37:28-04:00,17365,F2AU2PjaSmHxWWhkz8XxMggkCMWbMVgawt89tSnYS6RL,ET9febRJiW197DYMaJbgk3kWsAeFv5f4peQ4vFCVppK6,True,894596508,223649127,671377,335688,335689,GXyFXZMNk2NFyEzw6JetVqsujqcz2yCixH7n8EpDJYWD,26855094,69795180,-42940086,300
2022-05-02 13:39:09-04:00,17366,HCAGpyYM2NYudMd55Geta13tUbS6eiygnJY5ULHsHAVa,3PPyWhqXrmifWPieLV34bZ1rzi8eEnrDDAF7ifXkXspn,True,309321055,54976895,325780,162890,162890,3zqXX6kzhkbW3d4TwD2CNjMRwxTbREXySekvq37kfCNk,18329655,85264061,-66934406,592
2022-05-02 13:40:19-04:00,17367,3zVmiyif8VbqUW7dAeEMYJYrg8r5pCeBfALsdgu6kgFJ,FwzrxNbJsiCQwqayaDhwkbm9TRG11bK6fWs5Dn75da9a,True,641174159,160293539,485580,242790,242790,DQCvC9mR68hJ3tJsUiddh6JwcBJAmntqGJR2nUsEq7yj,19423218,138962067,-119538849,302
2022-05-02 13:42:25-04:00,17368,HT2SuCbePhjNZaar24uVwihYowCNvSjdvhJ8BRSVw9nX,98Ts4LCnapHVoCJ5PW3Armvh4jvDtpfs3SYRLRxiAgzZ,True,604988114,37211035,176713,88356,88357,2a35JJeTUW1pm6M3e8DHCjp8qr4vbc2cRPhuzZWyFzYd,28730576,211037557,-182306981,474
2022-05-02 13:42:25-04:00,17369,29JVska5UEG3axs63EmtHpPvkswNEqYpZ3PKMSfupiAG,DCftNBUsuogxyaJe9G9m3eWipH6o3qo4Rn4TuQXdVaBF,True,32678346,2607055,11211,5605,5606,68sueyVfmy5ToEGtLFGDkwebX47xAmzyXE29z8JrmcWv,1405386,6783861,-5378475,430
2022-05-02 13:42:40-04:00,17370,D8BtQirMEk3W9Pq29B6KkKWrwPfmsUNpwz5npx7aGMLY,J7LMZwaSoh5hbGcwee6oPsnN4ZFD7Zp3LQWkJGNUHRfJ,True,797069420,199267355,1412881,706440,706441,2xTUy2RS74GJMMDnmFaegMzFLn19RVfYG4CibhBmjP1i,56515269,206990261,-150474992,709
2022-05-02 13:43:19-04:00,17371,BjCNaM7YbE9SjFi7tzi4677zg1fKXGJwtecz2GWwWuhd,6rNsSrKZezQrLb2whToNjnizpnurDXrobHqfEK3QqU1M,True,61737683,4386988,20395,10197,10198,68sueyVfmy5ToEGtLFGDkwebX47xAmzyXE29z8JrmcWv,2870241,31059880,-28189639,464
2022-05-02 13:43:36-04:00,17372,F5vnN191nY9kUJBtFcm6fUhPDJvUSrSHLvfstesb68rH,9DtiZh3FsVmZA9MRqZhonAN2Pk4rQdcWw8As76DnQ6ee,True,3913073296,978268324,6932651,3466325,3466326,GXyFXZMNk2NFyEzw6JetVqsujqcz2yCixH7n8EpDJYWD,277306057,484255853,-206949796,708
2022-05-02 13:45:53-04:00,17373,B6Wc3euMqUf6QjzCqDtNeAEUM7MvADFaiReEq9VYH2Qg,2pzhsqXYd5u7h4xTN8bMS3GbicVnJ6KY3MQn7spSXroA,True,93807702,12008057,36292,18146,18146,68sueyVfmy5ToEGtLFGDkwebX47xAmzyXE29z8JrmcWv,2835163,23457904,-20622741,302
2022-05-02 13:45:54-04:00,17374,5zqXqEjg95BnghcVbHRhYkSTYnzZjUBichgccv1BpS3d,9SuqSxrKpHh9NcNePe4Q3jXvpCmhNnoQv8YAFih3CqMX,True,8149948789,2037487197,6080658,3040329,3040329,A2p75MbAbeUdHkPLkAjgGeiwuu9WPrkMHzjCkDXF1Xr3,243226340,1781267565,-1538041225,298
2022-05-02 13:46:02-04:00,17375,9VojCEgzn99QRVPGKn6euGRQbM7Q86GZ6yHJQa7N3gv4,GW4GVNnUtEt68avsowddpmjoUTUyMvxV4c5kY3Gzz9fT,True,36068366,3321554,20615,10307,10308,5HnvdJnCCcmRsm4GkXnYWd4q9RpwuvYDGEUMPkYR3Ts9,2238626,24510391,-22271765,620
2022-05-02 13:46:33-04:00,17376,DZnaFtxiEHUv3geRGsKufTnCUhkSMbN2M7W4Bwu2LgkM,A38xXBMxA13qQnVB1tcd5USxpfdaUGmkp31FeTmCyb52,True,214236910,28013463,199816,99908,99908,C4UnXuShCvjSMgBAgVNMy1oakxCNk1et27A82fywU112,15281256,93015602,-77734346,713
2022-05-02 13:46:42-04:00,17377,8qq2gfbca7JXvq4gViBBVT2QAbM4MvBMEQLXgn8UUTvt,3o5jpBVYdFFEYrGRdCUkLrUC85wsuTKgy8iYwnpZyC1B,True,61042056,8094140,36748,18374,18374,68sueyVfmy5ToEGtLFGDkwebX47xAmzyXE29z8JrmcWv,2771398,34207036,-31435638,454
2022-05-02 13:46:55-04:00,17378,A5NXadGWnFZRoHEn1dKTRjcXgWmfMLMyJdpF4rQPZyRR,ALs3Zfotc4c4A6TFDMbd5GM5whK1dTYSnGrHiMBWmApH,True,4791083579,1197770894,3606965,1803482,1803483,gjBMZYVujDjD1ECG4i97M8Q3gV9ESnwwTSUGropkusj,144278620,326222810,-181944190,301
2022-05-02 13:46:55-04:00,17379,3CxwyEadyRMxq6XyjjVAK4TB3we6dcLZf3GVCQLSDEPM,Bp12mixLHgc3L6CvzqzsyV4GLMrmxGiydZE4buJwsHmr,True,53704191,10911365,38757,19378,19379,2a35JJeTUW1pm6M3e8DHCjp8qr4vbc2cRPhuzZWyFzYd,1907619,9880739,-7973120,355
2022-05-02 13:47:04-04:00,17380,CDVtXFbo4Rg2aHsXKv5P3uRJq9ZTgsRd7GXPTxgH5xv9,6zj37qQnaiJT7xGEZmSKx5yQvisQFcs5KhGsG43SGd5y,True,671188766,79649525,256067,128033,128034,3zqXX6kzhkbW3d4TwD2CNjMRwxTbREXySekvq37kfCNk,21578212,218588545,-197010333,321
2022-05-02 13:47:07-04:00,17381,HT2SuCbePhjNZaar24uVwihYowCNvSjdvhJ8BRSVw9nX,98Ts4LCnapHVoCJ5PW3Armvh4jvDtpfs3SYRLRxiAgzZ,True,565111863,80426770,368447,184223,184224,3zqXX6kzhkbW3d4TwD2CNjMRwxTbREXySekvq37kfCNk,25888647,205672478,-179783831,458
2022-05-02 13:47:09-04:00,17382,BjCNaM7YbE9SjFi7tzi4677zg1fKXGJwtecz2GWwWuhd,6rNsSrKZezQrLb2whToNjnizpnurDXrobHqfEK3QqU1M,True,57096554,7549486,34320,17160,17160,68sueyVfmy5ToEGtLFGDkwebX47xAmzyXE29z8JrmcWv,2595705,27624072,-25028367,454
2022-05-02 13:52:05-04:00,17383,kn4CMFEGiFu6Sw8v7GAZaBNHKe5Mst4Bj2kds1B6Daw,4FAjghUCswqbD6SKVr7Mu9aLcSLxDofiBvxgkZeiVz32,True,80422970,10594679,30996,15498,15498,2a35JJeTUW1pm6M3e8DHCjp8qr4vbc2cRPhuzZWyFzYd,2352946,11281161,-8928215,292
2022-05-02 14:12:49-04:00,17384,E6aP64uFjkpvGaWYCAzW95RuURXmGGiCr63yzT8D8Bch,AVLR8LDxMvpjSU4XP7J5JoY8XwFyVu3YqEU45hzp2r8Z,True,23650177,5912544,36764,18382,18382,C4UnXuShCvjSMgBAgVNMy1oakxCNk1et27A82fywU112,1470586,15320567,-13849981,621
2022-05-02 14:13:21-04:00,17385,DLwEaZipqHmVBD5hc5v1NZtDStHyG4hAMwxywDTGGc2e,28GtwJw67UWfrSKxtuvpzoKzPyKXLgP3GKLm3fHdR566,True,4904464485,1226116121,7567210,3783605,3783605,6UQfSsLooL4pQKQfLtXCutQS2BnF7A7F7ewJopDLmUpc,302688439,346555776,-43867337,617
2022-05-02 14:13:35-04:00,17386,HDMvxWha3zz9uPwZMRXWJYZNhTHxzwHMoYX4Raog1i31,4erL3sEBdK32eYY5w8vaeih9r1uC1vCrbsV8NxR4asEa,True,17217540,4304385,26633,13316,13317,2a35JJeTUW1pm6M3e8DHCjp8qr4vbc2cRPhuzZWyFzYd,1065332,11973137,-10907805,618
2022-05-02 14:13:42-04:00,17387,AggAFLRnGWU7X97a3sWRKV7wDDRiAGn9Q4azmEYXAo1k,Dj4DzvpxgQiRoad1zTXoNTrgGTDHG9NvMeCzzRZSxkvs,True,573971793,55189996,235235,117617,117618,2xTUy2RS74GJMMDnmFaegMzFLn19RVfYG4CibhBmjP1i,24464303,111570992,-87106689,426
2022-05-02 14:13:44-04:00,17388,5XaryzRdShE48K6xMLJop7ieQVC7gp55MLG5UJ5C6mHA,BpessMA9vcqZMZKdAnR5JsDy6Y4qNpGNnPEc3nKDZLNY,True,24159180,6039795,37603,18801,18802,C4UnXuShCvjSMgBAgVNMy1oakxCNk1et27A82fywU112,1504153,14845094,-13340941,622
2022-05-02 14:14:20-04:00,17389,9VojCEgzn99QRVPGKn6euGRQbM7Q86GZ6yHJQa7N3gv4,GW4GVNnUtEt68avsowddpmjoUTUyMvxV4c5kY3Gzz9fT,True,32559951,3009147,18758,9379,9379,2a35JJeTUW1pm6M3e8DHCjp8qr4vbc2cRPhuzZWyFzYd,2029702,22530296,-20500594,623
2022-05-02 14:14:28-04:00,17390,GNohZMtk1VAuhLAgNGT8J3HYCKDCiyjvLeAWr64d7Duy,6soTLVj9DzFht8DzvjRfNPAWhZuiDBS5fDE1fpeuDSSz,True,257075239,64268809,400806,200403,200403,68sueyVfmy5ToEGtLFGDkwebX47xAmzyXE29z8JrmcWv,16032258,125587781,-109555523,623
2022-05-02 14:14:46-04:00,17391,AQr9mVmcXCNQhBVCfx63MwR6c4WqDSC9K2BZqr7N8LCx,CB7TWUaL381ounsLw6neAUaKRxJL9P1HC9uGX5e1Uxod,True,22816755,2550616,12254,6127,6127,2a35JJeTUW1pm6M3e8DHCjp8qr4vbc2cRPhuzZWyFzYd,1096239,8941550,-7845311,480
2022-05-02 14:14:54-04:00,17392,8qq2gfbca7JXvq4gViBBVT2QAbM4MvBMEQLXgn8UUTvt,3o5jpBVYdFFEYrGRdCUkLrUC85wsuTKgy8iYwnpZyC1B,True,52767417,3696846,17501,8750,8751,2a35JJeTUW1pm6M3e8DHCjp8qr4vbc2cRPhuzZWyFzYd,2498057,34984365,-32486308,473
2022-05-02 14:14:57-04:00,17393,CBEv8v9XZrgFT8UdEdd813XnRVv9R7GB5PLMyG8UWGC8,4uNcMEcQpJdThpisgNrttkQJTUFTsjEr25qgjkm4titC,True,97633046,9968844,43271,21635,21636,2a35JJeTUW1pm6M3e8DHCjp8qr4vbc2cRPhuzZWyFzYd,4237945,11206356,-6968411,434
2022-05-02 14:21:00-04:00,17394,BjCNaM7YbE9SjFi7tzi4677zg1fKXGJwtecz2GWwWuhd,6rNsSrKZezQrLb2whToNjnizpnurDXrobHqfEK3QqU1M,True,49334527,3420358,16263,8131,8132,2a35JJeTUW1pm6M3e8DHCjp8qr4vbc2cRPhuzZWyFzYd,2345858,24921887,-22576029,475
2022-05-02 14:43:23-04:00,17395,B6Wc3euMqUf6QjzCqDtNeAEUM7MvADFaiReEq9VYH2Qg,2pzhsqXYd5u7h4xTN8bMS3GbicVnJ6KY3MQn7spSXroA,True,81456891,11400154,34257,17128,17129,68sueyVfmy5ToEGtLFGDkwebX47xAmzyXE29z8JrmcWv,2447789,21150459,-18702670,300
2022-05-02 14:43:30-04:00,17396,BmFSXZx3HWaTtD7vp7AkUk5DUNjwK1qgLPod13EJz6No,DtLMfV3Xs7AAAQqC1PwL7YAfV6fig8yAMxr9MMxmyCKc,True,307490552,76872638,232697,116348,116349,2a35JJeTUW1pm6M3e8DHCjp8qr4vbc2cRPhuzZWyFzYd,9307893,30998353,-21690460,302
2022-05-02 15:33:35-04:00,17397,Cb6MEn1MN9XQcVVd3o9J8QdK3cFWxSNETsFzhVJ8jmdh,A6yTKbggUftjbjAVu5YR1M7rg7h78ghbfofmTSnmKNGz,True,6664160839,1666040209,4825357,2412678,2412679,2a35JJeTUW1pm6M3e8DHCjp8qr4vbc2cRPhuzZWyFzYd,193014315,291244969,-98230654,289
2022-05-02 18:00:23-04:00,17398,Cb6MEn1MN9XQcVVd3o9J8QdK3cFWxSNETsFzhVJ8jmdh,A6yTKbggUftjbjAVu5YR1M7rg7h78ghbfofmTSnmKNGz,True,5037092246,1259273061,3770042,1885021,1885021,C4UnXuShCvjSMgBAgVNMy1oakxCNk1et27A82fywU112,150801706,263802495,-113000789,299
2022-05-02 18:14:56-04:00,17399,31TiU5VAiR77Zec49S5x2Y9EqdyMqi8Gx5T2bLxAazhU,iZkdEaFdSoYXBFEp3GPVJZvg5ZbiVdjNvHaTEvXxUmp,True,31576738008,7894184502,23293782,11646891,11646891,2xTUy2RS74GJMMDnmFaegMzFLn19RVfYG4CibhBmjP1i,931751309,1646503627,-714752318,295
2022-05-02 23:03:57-04:00,17400,F5vnN191nY9kUJBtFcm6fUhPDJvUSrSHLvfstesb68rH,9DtiZh3FsVmZA9MRqZhonAN2Pk4rQdcWw8As76DnQ6ee,True,4927244818,1231811204,8736277,4368138,4368139,5HnvdJnCCcmRsm4GkXnYWd4q9RpwuvYDGEUMPkYR3Ts9,349451106,503399850,-153948744,709
2022-05-02 23:09:33-04:00,17401,9LVUwUZAj1tVfFbxqyjfS73xNQbr9ACCt5Sf8sbzHzYR,4yxrmZHHmGBDVEEcdnEkhsXpiM6kSku9Efk11ARgLhks,True,1219657028152,74508357655,464842457,232421228,232421229,3zqXX6kzhkbW3d4TwD2CNjMRwxTbREXySekvq37kfCNk,76091916093,25831407287,50260508806,623
2022-05-02 23:37:39-04:00,17402,9LVUwUZAj1tVfFbxqyjfS73xNQbr9ACCt5Sf8sbzHzYR,4yxrmZHHmGBDVEEcdnEkhsXpiM6kSku9Efk11ARgLhks,True,1149150177523,75600215703,471209802,235604901,235604901,5HnvdJnCCcmRsm4GkXnYWd4q9RpwuvYDGEUMPkYR3Ts9,71625566610,33621346208,38004220402,623
2022-05-02 23:39:06-04:00,17403,DBNKpnC6eW8eA3VqaWZbt3KXa95DdPZQ3Km6CC8Q6cLp,5tJHDSihcfJDaTdmF3se6n8CdkajiguaDRUFoSb6XNtC,True,10791193876,1593175092,7846180,3923090,3923090,gjBMZYVujDjD1ECG4i97M8Q3gV9ESnwwTSUGropkusj,531452295,1655486824,-1124034529,492
2022-05-02 23:47:08-04:00,17404,DBNKpnC6eW8eA3VqaWZbt3KXa95DdPZQ3Km6CC8Q6cLp,5tJHDSihcfJDaTdmF3se6n8CdkajiguaDRUFoSb6XNtC,True,9283769640,1216319033,5736588,2868294,2868294,2a35JJeTUW1pm6M3e8DHCjp8qr4vbc2cRPhuzZWyFzYd,437855259,1393279881,-955424622,471
2022-05-03 00:17:45-04:00,17405,9LVUwUZAj1tVfFbxqyjfS73xNQbr9ACCt5Sf8sbzHzYR,4yxrmZHHmGBDVEEcdnEkhsXpiM6kSku9Efk11ARgLhks,True,1077448511379,96183495161,600447115,300223557,300223558,5HnvdJnCCcmRsm4GkXnYWd4q9RpwuvYDGEUMPkYR3Ts9,67262148252,39255640915,28006507337,624
2022-05-03 07:55:11-04:00,17406,EnWyeq6uuqbcNJ9rRxBmyADxFtJuJLqBEpZ5fCAuuA5r,AqzckBF3sjpbuxGiPzYs11DWwSV6Y4NGdc9hGgn5UoJC,True,270171267705,32745195619,207028342,103514171,103514171,6UQfSsLooL4pQKQfLtXCutQS2BnF7A7F7ewJopDLmUpc,17081317987,28941387117,-11860069130,632
2022-05-03 11:24:07-04:00,17407,31TiU5VAiR77Zec49S5x2Y9EqdyMqi8Gx5T2bLxAazhU,iZkdEaFdSoYXBFEp3GPVJZvg5ZbiVdjNvHaTEvXxUmp,True,11551593411,2887898352,19975540,9987770,9987770,C4UnXuShCvjSMgBAgVNMy1oakxCNk1et27A82fywU112,799021638,1112837486,-313815848,691
2022-05-03 11:24:30-04:00,17408,5nALef7nAfNkSQSuTBLwewDby4pUx74Gzqib33Znmmt6,8xNTWK2xNK2xZPpgXfcE4QxPT2i6YvNYakiLgdQ2FqEt,True,428030746,107007686,749309,374654,374655,5HnvdJnCCcmRsm4GkXnYWd4q9RpwuvYDGEUMPkYR3Ts9,29972372,41237592,-11265220,700
