ts,record_id,user_authority,user,partial,base_asset_value,base_asset_value_closed,liquidation_fee,fee_to_liquidator,fee_to_insurance_fund,liquidator,total_collateral,collateral,unrealized_pnl,margin_ratio
2022-01-23 23:40:53-05:00,9217,4nhdidD6SASYzwZ7mUnWKyP4xyWXhdBe2gp5F4qDtLrL,HLk6YPhVidsn3i8HfoASvoim1ztxb4bi8JnioiyvorpV,True,4088214,1022053,6378,3189,3189,HfEnetJ7uBSmZWCjBNxdvv9HEC5nsW4wDV7wu6WnhWan,255139,3997199,-3742060,624
2022-01-23 23:40:53-05:00,9218,4yhW5mBsFVNgQ5QQc2Yg65guctPsTSXcERbzmYM6rdnL,5uJnMZ6DWA9bMSvHvS5zomwtt1sv7YCWq3GDJh77YC3q,True,715939,178984,1114,557,557,HfEnetJ7uBSmZWCjBNxdvv9HEC5nsW4wDV7wu6WnhWan,44590,722096,-677506,622
2022-01-23 23:40:54-05:00,9219,E8iuHK2DErFnMAYfWmNoix4jVb4WDG8Sc41hBycLUxbd,77Zoru23JmnK5EJ8eURonQoEpJcLP4edabjD8MR8NKdX,True,11286292,2821573,17541,8770,8771,HfEnetJ7uBSmZWCjBNxdvv9HEC5nsW4wDV7wu6WnhWan,701667,11362210,-10660543,621
2022-01-23 23:40:54-05:00,9220,GcjcaWoMUcGkLaJBx3svxtzwGNn5SLcFrwaLqnpadUZY,Ep9sDjTMMasVjKdshsE88uk3mWYkKuMTVRooVJWvCq9F,True,11066263,2766565,17217,8608,8609,HfEnetJ7uBSmZWCjBNxdvv9HEC5nsW4wDV7wu6WnhWan,688710,11128378,-10439668,622
2022-01-23 23:40:54-05:00,9221,96StvqZyFUPtyMr4o9s7K4V29RSNyRpVi76vNwxG5rUf,GZKXFSFq4aGiTaqovtxqNCCVGkAFNXPh4Hep1ZMwdZ8g,True,64608,16152,100,50,50,HfEnetJ7uBSmZWCjBNxdvv9HEC5nsW4wDV7wu6WnhWan,4023,103864,-99841,622
2022-01-23 23:40:54-05:00,9222,GwYr2DmtMVLWxVz6kVSXR6rvxL4x3DXtvNC7taswSWHN,2otMHa7JT1twPSSN6XF9fqGkKrEK8nnuMFZG1TtAgFQk,True,4962,1240,7,3,4,HfEnetJ7uBSmZWCjBNxdvv9HEC5nsW4wDV7wu6WnhWan,309,4894,-4585,622
2022-01-23 23:40:54-05:00,9223,5iRLEmB6qBHqkJBPyyubnd9f1TpRr4EY8BTxuHUREeLB,GkY73KL6HJ4ycdggFtYWALBgmTRZVCx66P2ZJ7E8ENwC,True,621311,155327,968,484,484,HfEnetJ7uBSmZWCjBNxdvv9HEC5nsW4wDV7wu6WnhWan,38722,625054,-586332,623
2022-01-23 23:40:54-05:00,9224,HZSJVNb6g4o52N7pAJCLkGjur8evF5Ex1sAx7uUxUDdm,8LQHKhXStrwcd6f4AxaTVcrGdYpGjQz8vWf5JXsAzcsp,True,836843,209210,1301,650,651,HfEnetJ7uBSmZWCjBNxdvv9HEC5nsW4wDV7wu6WnhWan,52079,842818,-790739,622
2022-01-23 23:41:22-05:00,9225,EPWsutEpgpcz776maq552k8QhDKdmkSfAED5E3jgpTdY,CCwGZYDvqoHEBBtSSieAJgy5e3k4jYrpjyDffypwnWxu,True,30213723,7553430,46230,23115,23115,3zqXX6kzhkbW3d4TwD2CNjMRwxTbREXySekvq37kfCNk,1849238,29369766,-27520528,612
2022-01-23 23:41:22-05:00,9226,9T6bCVf7AshQP1NNbsF3eCdbChKbcfrFUPFWUXRijY5M,4ZFq3kdwaUhiotXCXzDFjVCAP3udzGsx5CicgLLXd4PR,True,408024218,102006054,625321,312660,312661,3zqXX6kzhkbW3d4TwD2CNjMRwxTbREXySekvq37kfCNk,25012845,219913627,-194900782,613
2022-01-23 23:41:22-05:00,9227,9wsQcvpqPp8c9q42RntWDNbqNCnmJeW4GMG2AtKAHkBu,EMqRbzGvXTU1LtmoSw9uSrpTX2L4tpJQAMJJJ4duvzf5,True,103141851,25785462,158032,79016,79016,3zqXX6kzhkbW3d4TwD2CNjMRwxTbREXySekvq37kfCNk,6321308,55659457,-49338149,612
2022-01-23 23:41:22-05:00,9228,8GdYhwX26GRmVfGFCbJ3MJrH1UdneN2FNRUexhLsqprN,DpUTHSVucDPyCWoLCdpm8EFRZFiKL88tmnSiWG2TRpS8,True,651800,162950,998,499,499,3zqXX6kzhkbW3d4TwD2CNjMRwxTbREXySekvq37kfCNk,39958,653634,-613676,613
2022-01-23 23:41:22-05:00,9229,6Bq55LtGCEeGqh4JrFLCmmGc2iJfTTBJixivqH78aGSE,DSNrCgWJeNe2P9tAQu5FvCueTzNKDKds7wzuwTQSMRG,True,19191,4797,29,14,15,3zqXX6kzhkbW3d4TwD2CNjMRwxTbREXySekvq37kfCNk,1174,17894,-16720,611
2022-01-23 23:41:22-05:00,9230,CEtpqFD4BbeiNfaXyLLYEapY2mWgE26H5q6H34tWwRuD,BVqRyqwGFPzSkk1H2finiyfaL3LScbEiQGk3mihirxqs,True,535264,133816,826,413,413,HfEnetJ7uBSmZWCjBNxdvv9HEC5nsW4wDV7wu6WnhWan,33044,530922,-497878,617
2022-01-23 23:41:22-05:00,9231,8YMEydGnQH9W5AEXFGquFkb1bcf3PcxiMvYBSMPXKJyQ,3CmWH8eYtkmHNisqMmMBLff6C6z6ZcSj38KoQ34DPUE7,True,570366,142591,883,441,442,HfEnetJ7uBSmZWCjBNxdvv9HEC5nsW4wDV7wu6WnhWan,35354,533634,-498280,619
2022-01-23 23:41:22-05:00,9232,5FgPU7KpsDnx4Xc1UdQoLPR7MDd5cBkJXW2Q8ctopMZR,9GWzAZFVfTY8WjTYvDAE2YcAjgeKiDXgToK76KBZF7Rv,True,960748,240187,1482,741,741,HfEnetJ7uBSmZWCjBNxdvv9HEC5nsW4wDV7wu6WnhWan,59293,935624,-876331,617
2022-01-23 23:41:22-05:00,9233,BMawc4jLJMER4ryGcwdm27H3MU8JQCiSfwb9onVfYDpr,5ciaGDuaB3rBKvV7MphT2eMkCUxBzWZc7zYXQM7vbQ46,True,4271790,1067947,6573,3286,3287,HfEnetJ7uBSmZWCjBNxdvv9HEC5nsW4wDV7wu6WnhWan,262938,4177344,-3914406,615
2022-01-23 23:41:22-05:00,9234,HZJyrD4eqM4nKnyRh2JAs1sC2TaJxFhNPixBdK7PLMuS,Hycz71z4tEsKUogJnefT2GN3MPCLdTJdv9B6T82Ngw2u,True,3136444,784111,4900,2450,2450,HfEnetJ7uBSmZWCjBNxdvv9HEC5nsW4wDV7wu6WnhWan,196033,3176711,-2980678,625
2022-01-23 23:41:22-05:00,9235,8xjstKJD2RopRxxRP8JbMYRmpBKgSZivMFRXXRZ5syPh,HUfevkvBsm5SDpxnZ4NBD8Re7LvqBQLrx5UWXCeYTBgK,True,1076389,269097,1659,829,830,HfEnetJ7uBSmZWCjBNxdvv9HEC5nsW4wDV7wu6WnhWan,66385,1049403,-983018,616
2022-01-23 23:41:22-05:00,9236,6kt64nJRnYaWMi9GbpZaUuhbToAVRd7FUMTGASAAJrve,2Sdxv9ZtogNcVbJwBPxKmVjwAiKyX5GHEfnRmFcydQ1G,True,84588839,21147209,131191,65595,65596,HfEnetJ7uBSmZWCjBNxdvv9HEC5nsW4wDV7wu6WnhWan,5247663,76072024,-70824361,620
2022-01-23 23:41:22-05:00,9237,8nXbrdjjaHB73CRPRenGEQj73wbtEFGDwXsehRGMhsap,43pvdcJ6f27wz94D6ZboKwRJYbyvYCrjsJhYsvk7LJCM,True,180125,45031,277,138,139,HfEnetJ7uBSmZWCjBNxdvv9HEC5nsW4wDV7wu6WnhWan,11100,116874,-105774,616
2022-01-23 23:41:22-05:00,9238,Hqzz5RdbkkmMPCVdxF3Q3sLuh7XVJHEwAP6zpz7pCwTj,TNwXSETgrJGM9S5zbBY3mMWKbPFskbKjPAhBrWFNfuK,True,649576,162394,999,499,500,HfEnetJ7uBSmZWCjBNxdvv9HEC5nsW4wDV7wu6WnhWan,39968,652603,-612635,615
2022-01-23 23:41:23-05:00,9239,4eaXYcx5ayhTq9TmmQFgLDjy6p3z93txUN97v8PTSh1J,J3vgUnjDUy5ngrmrs6FwpZTexxJNxXM1UjsHvsgw9g9y,True,726799,181699,1117,558,559,3zqXX6kzhkbW3d4TwD2CNjMRwxTbREXySekvq37kfCNk,44704,732103,-687399,615
2022-01-23 23:41:23-05:00,9240,2AAWghW6BUAFBtF3R6hB9uoqMc5oUDkU8FTd2JrXKema,798cfEUZ2YhXwNTNjXMS4Z2J8gAHaK4zZwpMkq2HzWWM,True,3912755720,978188930,6085852,3042926,3042926,HfEnetJ7uBSmZWCjBNxdvv9HEC5nsW4wDV7wu6WnhWan,243434106,2610516929,-2367082823,622
2022-01-23 23:41:23-05:00,9241,HpRYrL8HzCPaBJTLFgZmYg2aXBnBQUpf1mikVkzkY56z,8DzHRd8qWcEjnX6cefwYtgRGpQJUaw9QPjyfAsN7j33r,True,7413160,1853290,11439,5719,5720,HfEnetJ7uBSmZWCjBNxdvv9HEC5nsW4wDV7wu6WnhWan,457583,7281293,-6823710,617
2022-01-23 23:41:23-05:00,9242,CygwJ5Z1ZP6xfjN1ZGH7yw8b2oYvf6JTpenXx7A5yFdt,59VKgJtBCTb3Pji7BWtqttisBYVVCnWtyEn5Eba5r52Y,True,12661377,3165344,19686,9843,9843,HfEnetJ7uBSmZWCjBNxdvv9HEC5nsW4wDV7wu6WnhWan,787448,11854190,-11066742,621
2022-01-23 23:41:23-05:00,9243,Bt37YbHvD2M8zcGmanksKy8MCi4Qzto7hEnGRJyNvWyg,4WGRnDhpoY4zJi74iJyALasETpJNJMCJtf9aWJUVrHQv,True,927442022,231860505,1424067,712033,712034,HfEnetJ7uBSmZWCjBNxdvv9HEC5nsW4wDV7wu6WnhWan,56962717,499785695,-442822978,614
2022-01-23 23:41:23-05:00,9244,3R2wxFQwjCqUwwxJmp9tNrT6osYFpB5gczq2QYik6QYm,7At5Ej3ZsynfWr56FYrd4P4Y6UtD8FHA4gCFB8TaAyaG,True,728894,182223,1137,568,569,HfEnetJ7uBSmZWCjBNxdvv9HEC5nsW4wDV7wu6WnhWan,45481,732883,-687402,623
2022-01-23 23:41:23-05:00,9245,43EtYHdVkdBxHTtFR3QWVgvCKj1SqsAf7xLY2yphsv1x,8WJbP4mVJWYuN1dVzHpRg7YR2nBELB4Krkq8Zch8sp4g,True,888648,222162,1364,682,682,3zqXX6kzhkbW3d4TwD2CNjMRwxTbREXySekvq37kfCNk,54563,831937,-777374,614
2022-01-23 23:41:23-05:00,9246,2DHhfXSzcuSwsKfAYLMuWuD17w84mCwNer9fcBNLTpSc,89BVfDycKjdSkQzFVqCXd5c16DntdND7WsqoZtCafYFH,True,34865028,8716257,54051,27025,27026,HfEnetJ7uBSmZWCjBNxdvv9HEC5nsW4wDV7wu6WnhWan,2162053,34032901,-31870848,620
2022-01-23 23:41:23-05:00,9247,45AiuRBbmupfwYXqsWwKHtmEWN8XNJDUSHwHL3b6PvHc,CfvwVkxYPP3jqK2dpAvSRFA1513E9ti84mEpYgtkzFUt,True,1238825,309706,1923,961,962,HfEnetJ7uBSmZWCjBNxdvv9HEC5nsW4wDV7wu6WnhWan,76924,1202085,-1125161,620
2022-01-23 23:41:24-05:00,9248,DD1a8rMoUCwmEiLKRN43VpdqL8Qgfr5yi92ejQxDVRMo,3vMJVNAuyRhM9jkaEZARhwbR6MerR5UmcgoZ9c5bs1VS,True,13294946,3323736,20397,10198,10199,3zqXX6kzhkbW3d4TwD2CNjMRwxTbREXySekvq37kfCNk,815912,13407100,-12591188,613
2022-01-23 23:41:24-05:00,9249,4cNmhgaMic1xBiaDJ6phrQuXmm8WfF1qjyYMqZcKG4c9,43vgfXiLTtcs1bkrcDar2iz9M6RMbGqbA6BMkBHdh7T4,True,682939,170734,1057,528,529,HfEnetJ7uBSmZWCjBNxdvv9HEC5nsW4wDV7wu6WnhWan,42292,691535,-649243,619
2022-01-23 23:41:24-05:00,9250,Fw2e6jxKVeFcJSe9MyVhSz3dUdJQLs3XULHrT1mtMU9U,591U5bexgLRJXygtK5fpCRXcZEq89KgewFTdfPkti8bY,True,85985450,21496362,131657,65828,65829,HfEnetJ7uBSmZWCjBNxdvv9HEC5nsW4wDV7wu6WnhWan,5266317,77291936,-72025619,612
2022-01-23 23:41:24-05:00,9251,446VESPwhh16pG3VcpgraT83MoqWy87qgU36mKZC8BsW,SmUPkPpnnRfSH3tcKUnbpK6HHNJtLfvMiUWk9eUwkNy,True,30027052,7506763,46157,23078,23079,3zqXX6kzhkbW3d4TwD2CNjMRwxTbREXySekvq37kfCNk,1846292,29204518,-27358226,614
2022-01-23 23:41:25-05:00,9252,6aW9dhnTNerVd1MPv5GrcYqgjVPE9LsNCGYSJSrNdgS8,8kmJu2UxTk2T37sqxDSrf6pDWhJZRxfRdJB7DLeoWddJ,True,24065642,6016410,37177,18588,18589,HfEnetJ7uBSmZWCjBNxdvv9HEC5nsW4wDV7wu6WnhWan,1487113,23012881,-21525768,617
2022-01-23 23:41:25-05:00,9253,28YQqynu5oRud5xEcsDvAaGhJhgpiVJSTNeMwkrbpbyv,9zYqRWiRatbohCdBfV3PrAxp8v1kwgbvV9ta4RJRRp68,True,29602589,7400647,45435,22717,22718,HfEnetJ7uBSmZWCjBNxdvv9HEC5nsW4wDV7wu6WnhWan,1817428,28781468,-26964040,613
2022-01-23 23:41:25-05:00,9254,HxhVxMpFpKzeuC6Z6CpsuUhPHdHUzvpMNYJ8LpQ3NYCp,8KyiipC39iU15zVErVvj6hdhbv89STsexrB8dVw3RcLs,True,763459,190864,1191,595,596,HfEnetJ7uBSmZWCjBNxdvv9HEC5nsW4wDV7wu6WnhWan,47640,768499,-720859,624
2022-01-23 23:41:25-05:00,9255,4qWzk4JP2gEsTP252Y4SJrjSmfRBxDfE4ZdbPmwavfb2,CAgDhCNVyy61FG2YPMnm9zxgY56s2UqPhvssH5G1LjXP,True,77726990,19431747,120868,60434,60434,3zqXX6kzhkbW3d4TwD2CNjMRwxTbREXySekvq37kfCNk,4834732,69551878,-64717146,622
2022-01-23 23:41:25-05:00,9256,C1tcxAjMzZaFVcF2ke2nSyiCjcLBwsz5yKXShy5MB14h,GYkrJj2zHVZuzPC45MbuevYkRJHdeL4Sqj9SWqZfUdiE,True,38018129,9504532,58325,29162,29163,3zqXX6kzhkbW3d4TwD2CNjMRwxTbREXySekvq37kfCNk,2333020,36806170,-34473150,613
2022-01-23 23:41:25-05:00,9257,Gfe4UgUGqvzcehSbETrWwLRAcqzFnkTrs6vJx8h6kTxi,7exMQ8sLti4Pmb2ZQtZhyuWRuQ6pq7XSXL9sCcWTqCvF,True,59086015,14771503,91516,45758,45758,3zqXX6kzhkbW3d4TwD2CNjMRwxTbREXySekvq37kfCNk,3660645,58413357,-54752712,619
2022-01-23 23:41:25-05:00,9258,43wwd6zLB8yKfXEu7rtbeDFhKBuxFR66MnyhTKW3zqa3,A9t6AMvVNenwWymz3QMtdUuuGYjjTPLaA9bhRjTzNY9h,True,11324029,2831007,17408,8704,8704,3zqXX6kzhkbW3d4TwD2CNjMRwxTbREXySekvq37kfCNk,696321,11417819,-10721498,614
2022-01-23 23:41:26-05:00,9259,EmXaq1sxmAZUiwYW6LXpKtKFZXu5MzQ3sK4MEAojDK1h,HuAsa5G2wJi8Ah9stxEmggwcB5zW1QjBsP3Ndgke7r8X,True,972969,243242,1504,752,752,3zqXX6kzhkbW3d4TwD2CNjMRwxTbREXySekvq37kfCNk,60163,978565,-918402,618
2022-01-23 23:41:44-05:00,9260,8GhXRNmsEgFgKPhGNNgEPUywVzW3bE7uZRWys2P1yNeJ,Bvi5vD5fhRFNdVhEXsSv9vkJzyQzgEswFHBxowkUEgF,True,6275398,1568849,9769,4884,4885,HfEnetJ7uBSmZWCjBNxdvv9HEC5nsW4wDV7wu6WnhWan,390789,6264166,-5873377,622
2022-01-23 23:41:44-05:00,9261,9WRDBHzD4aNHw5qvrhc6nqXCBLA5D7YYP8TvSrLksXd6,GwxWNmv9XDkqQsx7DfCMccFjVik8asPnFU9gtnb4UVx,True,562988,140747,862,431,431,3zqXX6kzhkbW3d4TwD2CNjMRwxTbREXySekvq37kfCNk,34491,567043,-532552,612
2022-01-23 23:41:44-05:00,9262,AzLdwyd8Q4V3iMaSwWgvWwQ9nCs7X7YV2YKpd6CH33nP,BYjeXF5YkcJy3mNMbvfHzXTtyjkc4U53hM5tvfERUH8y,True,723245,180811,1129,564,565,HfEnetJ7uBSmZWCjBNxdvv9HEC5nsW4wDV7wu6WnhWan,45188,727729,-682541,624
2022-01-23 23:41:44-05:00,9263,7afnF1MkAootZGWc7zsMVLpBuve83hGmvAHkfmwgsq5A,HKdJE8bReznq1Qxqd5iZ4nWQGCk62Vo5TpkRD51bpbGp,True,747106,186776,1143,571,572,3zqXX6kzhkbW3d4TwD2CNjMRwxTbREXySekvq37kfCNk,45722,752316,-706594,611
2022-01-23 23:41:44-05:00,9264,AECUZGm5DjFvbLZEUYhepSPg1Wa7hBjxF9e7ZRBzRPhm,Ar7e1iLKAqa54QiQnXifvnETixDZT1T8KL5YWJA8Ykv1,True,881233,220308,1369,684,685,HfEnetJ7uBSmZWCjBNxdvv9HEC5nsW4wDV7wu6WnhWan,54774,886858,-832084,621
2022-01-23 23:41:44-05:00,9265,68F35fonSGS1P6LMYmAmeoM8kC6Z78NabMqYLeCZr9GJ,8apmWSZdS8s1ScoNVj4AvSJsbQCj1drU3HL74khuANT2,True,773764,193441,1188,594,594,HfEnetJ7uBSmZWCjBNxdvv9HEC5nsW4wDV7wu6WnhWan,47552,778457,-730905,614
2022-01-23 23:41:44-05:00,9266,C1CsbgQFvEvSXzuVHTr39tQHr3drDhjxeYiotd8eNocF,4rAaTCAMj5VpgNVKiYizabH7cMLhEA12seu2QXQNTyV3,True,2150797,537698,3361,1680,1681,HfEnetJ7uBSmZWCjBNxdvv9HEC5nsW4wDV7wu6WnhWan,134468,964094,-829626,625
2022-01-23 23:42:00-05:00,9267,G8nRLTWTT5aD7q7TcSa2mw7p12GUuHDVq5ev4vyXbdKi,3DmQyungZMK4T1a1PgXh5shBskwP69tTLmZPh7HZ76vh,True,1063190,265797,1663,831,832,3zqXX6kzhkbW3d4TwD2CNjMRwxTbREXySekvq37kfCNk,66552,1070167,-1003615,625
2022-01-23 23:42:03-05:00,9268,8VQ21PFXdHBNmiZiF18LyGvsRSpr13vkyktfembNCe3m,5exbVC7vaGFeHEGAx7epYfMaU932QafqzfhFm5FKAq2H,True,657219,164304,1013,506,507,HfEnetJ7uBSmZWCjBNxdvv9HEC5nsW4wDV7wu6WnhWan,40553,662537,-621984,617
2022-01-23 23:42:04-05:00,9269,EAUFD16wab8qRMJ4H6updHGt4xFqgRCDeRHVCsLCTSTL,8vkfYSyCyBY9g4TZrp52jUcQj6udy9xAaA4fioRE2RXx,True,435418880,108854720,675925,337962,337963,3zqXX6kzhkbW3d4TwD2CNjMRwxTbREXySekvq37kfCNk,27037026,247565280,-220528254,620
2022-01-23 23:42:04-05:00,9270,Dqnxcekm1QfxGQ2FSJ6SjFiwmaQRWEjW9WTJQG4AjEpE,9JiMtjm5AJqngosRg787FiN8NyuBPuAPD2jYpRQkAc1d,True,946413,236603,1472,736,736,HfEnetJ7uBSmZWCjBNxdvv9HEC5nsW4wDV7wu6WnhWan,58904,954884,-895980,622
2022-01-23 23:42:04-05:00,9271,ANXYsUNpZ34dBt7cp6HEE7oi2pTKsbj7B5TeFHKPbHBU,2pqeP4fuMREosHcfWUecEBssp1GM4isihNjn7ALUD51d,True,884176,221044,1382,691,691,HfEnetJ7uBSmZWCjBNxdvv9HEC5nsW4wDV7wu6WnhWan,55295,891814,-836519,625
2022-01-23 23:42:04-05:00,9272,9QZvB1Gqhk5PKt3MoJMjZL3FaU2bTbTDcVw3nF316zh7,DGJWGr9RCWkzdWn21mWG7NyUN8uuvSQbA53HojFJe1rH,True,9355876,2338969,14629,7314,7315,HfEnetJ7uBSmZWCjBNxdvv9HEC5nsW4wDV7wu6WnhWan,585163,9090688,-8505525,625
2022-01-23 23:42:04-05:00,9273,AiLCB8xw3k5FXdJE1T42PLFhHrz1bLTKpNekR61a915N,HB7CNWxLipWAc6MPGq9wV4TT7AYjiELA5T3onYeVqBbU,True,14608135,3652033,22842,11421,11421,HfEnetJ7uBSmZWCjBNxdvv9HEC5nsW4wDV7wu6WnhWan,913684,14868340,-13954656,625
2022-01-23 23:42:15-05:00,9274,2ZX5NexeuZq25mAfBFDrwd44UfKhWgzmSwdhWFmo48c7,CpNnhSqg7EHn9g84gHoo831sVrAe5SkwNaEZAash4CXs,True,4911650,1227912,7570,3785,3785,HfEnetJ7uBSmZWCjBNxdvv9HEC5nsW4wDV7wu6WnhWan,302819,5001056,-4698237,616
2022-01-23 23:42:15-05:00,9275,69byqtDPmgEY1NqKBCR95CEPVHRUxgbNW9Y4P4HjQ7ND,E47T4q4zMGzNL6vDxgWdLn3EQbW3WfVryr8Jsymy1hAL,True,1197698,299424,1831,915,916,3zqXX6kzhkbW3d4TwD2CNjMRwxTbREXySekvq37kfCNk,73260,1102592,-1029332,611
2022-01-23 23:42:15-05:00,9276,DjbEch16uzdDtujFUeqxjquTTS3JXzEys8e9ogUv3aTy,6N8eKb3kfcbJEUZKZERiFiUR4hubB635D8Sotiji2TU8,True,87402847,21850711,135089,67544,67545,HfEnetJ7uBSmZWCjBNxdvv9HEC5nsW4wDV7wu6WnhWan,5403564,79356278,-73952714,618
2022-01-23 23:42:15-05:00,9277,4eba4qAmwfqmihaYvTWFU9hm4VYrKvNhNywHNyimQJNK,G1DyxJcNQD8u4KGfnwxttyrJMfse1FBAsofioEMdTS9U,True,4505601,1126400,6959,3479,3480,HfEnetJ7uBSmZWCjBNxdvv9HEC5nsW4wDV7wu6WnhWan,278360,4581822,-4303462,617
2022-01-23 23:42:15-05:00,9278,D6qMab7uevXTa89ssv4BRyHwrw3FYpNimAmX2VH2uf4B,8ZauZ5dAp7kyawkPdxi4mqfempFHubJebfBenQdDektD,True,397050,99262,613,306,307,HfEnetJ7uBSmZWCjBNxdvv9HEC5nsW4wDV7wu6WnhWan,24535,417335,-392800,617
2022-01-23 23:42:15-05:00,9279,HoJ3Re4BmCYKMJx2RUYtoHfg8ncEy3iFqvWJDGKqfMBV,2qg4FMcurNDVRzXYKwpzEYapxFECnAyU2oGmxQCSf3hf,True,597759,149439,929,464,465,HfEnetJ7uBSmZWCjBNxdvv9HEC5nsW4wDV7wu6WnhWan,37167,629061,-591894,621
2022-01-23 23:42:15-05:00,9280,HRN438yBJSX72GV4E3JYLKpwQcnZXgAoB2VkmgXzEKDE,4jEn7ssEM8ZUjAyaKogEb3uyMmbZJ1a7WGCPNgh1Xfty,True,654218,163554,1017,508,509,HfEnetJ7uBSmZWCjBNxdvv9HEC5nsW4wDV7wu6WnhWan,40711,567748,-527037,622
2022-01-23 23:42:16-05:00,9281,AnqmmhzVDCNq4dE4VvYkPDGB9nMXr4ykqvUhwxhR21pd,CcMeofCvvrDaBzgAGzoPwRt5eQmzdB1z2Y6UiwGqhFbG,True,8355946,2088986,12890,6445,6445,3zqXX6kzhkbW3d4TwD2CNjMRwxTbREXySekvq37kfCNk,515614,10391069,-9875455,617
2022-01-23 23:42:16-05:00,9282,GM22yjVoBCzgBcVTT5EcgRhVWiXVV82kSj1dPCbegKWj,CDDy8JmJMwJyx1YAvEPpj8AYxCpngRovf3wWfVzao5Rc,True,428962,107240,660,330,330,HfEnetJ7uBSmZWCjBNxdvv9HEC5nsW4wDV7wu6WnhWan,26439,230586,-204147,616
2022-01-23 23:42:16-05:00,9283,6VBYUiLyQXvvsDmq1vh1oJ5VeA89tGgxtkgFfofc372m,35pyoeRA4duKX7njdYny3KffM2xaxuWUZGRUMQJ5iAiu,True,84158822,21039705,131414,65707,65707,3zqXX6kzhkbW3d4TwD2CNjMRwxTbREXySekvq37kfCNk,5256577,76324272,-71067695,624
2022-01-23 23:42:16-05:00,9284,6X5por58mMECmNZQEWpo8M8aA1eHJqr5LNeV9vC7GW5e,DPB2C5UB2Ls1kNzbs1GP33junQvhUyFJWP75RoYjqByn,True,38667632,9666908,59161,29580,29581,3zqXX6kzhkbW3d4TwD2CNjMRwxTbREXySekvq37kfCNk,2366477,62291940,-59925463,612
2022-01-23 23:42:16-05:00,9285,CM95f7KjJuAf1xVTWhu3wrp6BfMz116FbgkxBhcRNs4k,EG55wkH5NcoasfBUYhD5D2dc2uvo11dZ3uTu5wgs4gf2,True,1268335,317083,1955,977,978,HfEnetJ7uBSmZWCjBNxdvv9HEC5nsW4wDV7wu6WnhWan,78208,1228524,-1150316,616
2022-01-23 23:42:16-05:00,9286,8XcMucCQpWfNtbdCYnKuabk91NQ9wfYp7byk496CwU9n,DLrApDfWcyMqufEFZm9PvddsMoiediT58X8e8pxpnzrk,True,1189905,297476,1834,917,917,3zqXX6kzhkbW3d4TwD2CNjMRwxTbREXySekvq37kfCNk,73364,1158293,-1084929,616
2022-01-23 23:42:16-05:00,9287,DiPSJvnnEwg1En7HJfEsKrUbBgtUf4KzGMyMCZDQSYgp,s8UVC6vPBofuXUS6RW1aQmZ8C35PrC5r4A6ugmvzLGB,True,4033,1008,6,3,3,3zqXX6kzhkbW3d4TwD2CNjMRwxTbREXySekvq37kfCNk,252,3249,-2997,624
2022-01-23 23:42:16-05:00,9288,9hB3EPuj4SrSrpAzHvExDb6mzh2vNGGVbj7qqfRjeao4,9725jRXGPRUuo1dijvv8mwzvSu1ed4y5hi9FAQNwb8dG,True,12332396,3083099,19073,9536,9537,HfEnetJ7uBSmZWCjBNxdvv9HEC5nsW4wDV7wu6WnhWan,762947,12455316,-11692369,618
2022-01-23 23:42:16-05:00,9289,3oCun4gm3k8sXxVxiYM8okGi8iCXH9LvDkHf9PBQWYXR,E1np1dZ7jUm811ddvy1jQerBwGSYb5BbZWnUHeotvrfH,True,2239724,559931,3447,1723,1724,HfEnetJ7uBSmZWCjBNxdvv9HEC5nsW4wDV7wu6WnhWan,137913,930116,-792203,615
2022-01-23 23:42:16-05:00,9290,Go3ne58krEsFsZ5yu9EBT7od15VCYmtbs1KhumRMTiXS,HCvwQ7HjmmeDXrguZQPrAbJjcCJzHqVZK2JMSFkFDWfe,True,248679,62169,383,191,192,3zqXX6kzhkbW3d4TwD2CNjMRwxTbREXySekvq37kfCNk,15331,261530,-246199,616
2022-01-23 23:42:17-05:00,9291,4HDEN1Thxm9RbdE8pXnLP4QksVdXfp7Fa9nAnMRzr7oR,8gD3DbF6VhPTCgk3A4G7iA4f3DPH598Hj7TRJ2FebMCq,True,937331,234332,1449,724,725,3zqXX6kzhkbW3d4TwD2CNjMRwxTbREXySekvq37kfCNk,57993,913435,-855442,618
2022-01-23 23:42:17-05:00,9292,6b7Ro2myM4HcUDqyyW9NEqTWPz8BWpH4eNFSQQci37So,7r7j7rSsa6YZcTuRPfs3KP44MVqUA4Q5NeJGmx84wbHq,True,305342,76335,472,236,236,HfEnetJ7uBSmZWCjBNxdvv9HEC5nsW4wDV7wu6WnhWan,18895,319287,-300392,618
2022-01-23 23:42:17-05:00,9293,6kscNwPWgKoW7MHRkB4ajxWF3DXLmXjmx9KjDnzikhfs,D49nf79UmrALDKnAa5kf94nZUffzJW7anLm4hVrFG2b4,True,20825034,5206258,32477,16238,16239,3zqXX6kzhkbW3d4TwD2CNjMRwxTbREXySekvq37kfCNk,1299115,19625572,-18326457,623
2022-01-23 23:42:17-05:00,9294,Bbd196A866Y9rQWQFt4YGg2R6Jqj7WQGXWPDmrNtPcKf,5gmWk1KwLoRHnhkjxps4Ad6aVk4ZpcfC3McZCWDVCUbu,True,695819,173954,1072,536,536,3zqXX6kzhkbW3d4TwD2CNjMRwxTbREXySekvq37kfCNk,42917,729844,-686927,616
2022-01-23 23:42:17-05:00,9295,SCtptafLHdkTiYC3e9sv853xNnusHLpoMPxTc1zUVC8,2HF9ggN6EbkYGz3Ajj7tB8m5YF3Yj77Vy96DMFSz5C7j,True,3369312,842328,5214,2607,2607,HfEnetJ7uBSmZWCjBNxdvv9HEC5nsW4wDV7wu6WnhWan,208581,3166135,-2957554,619
2022-01-23 23:42:59-05:00,9296,CcfycMNGUqZLA6EEqtDdftSbQhTL11SYn3LxQqJ23Xgh,Ce7NW9CpB9qGYLf8XUDW49ERutoxtjZSjs54xrzF1fYN,True,1180269,295067,1813,906,907,HfEnetJ7uBSmZWCjBNxdvv9HEC5nsW4wDV7wu6WnhWan,72540,1149124,-1076584,614
2022-01-23 23:42:59-05:00,9297,9cRx2sGeqENLrNkvzLSnuD161JshSav6pNg9c7pYLi8f,13ryjUoWLejTLDQKh1m69VFD31onMx8yhzCKhqbeU6s6,True,3338116,834529,5189,2594,2595,HfEnetJ7uBSmZWCjBNxdvv9HEC5nsW4wDV7wu6WnhWan,207575,3276046,-3068471,621
2022-01-23 23:42:59-05:00,9298,2YPm4Ex9mNHX4CuNAUjkrXgoLFaZs6r1X6asYYUnvPyj,BatsG1UFq8ryYuFFcdnDyFWFPUV5P6w2VQpRup5oUey5,True,861439,215359,1334,667,667,HfEnetJ7uBSmZWCjBNxdvv9HEC5nsW4wDV7wu6WnhWan,53394,838532,-785138,619
2022-01-23 23:43:00-05:00,9299,GqFbV89UYbQ6aEW1bSvGnnsDtTPQfHPTHzisXPhLnaTC,6X7j3nqmugRyVVw83uSzgiPaemEscc8VdsnPEKDz4fg2,True,582259,145564,903,451,452,HfEnetJ7uBSmZWCjBNxdvv9HEC5nsW4wDV7wu6WnhWan,36146,588600,-552454,620
2022-01-23 23:43:00-05:00,9300,DakevNrDK5fAUGkLdrWHrsLZm8hEZBqkzUiwJouaDPPY,73nFhK7cygPgwKveXrdXcQVte8n1z3iBe4nmUVTGfFmv,True,49214478,12303619,76696,38348,38348,HfEnetJ7uBSmZWCjBNxdvv9HEC5nsW4wDV7wu6WnhWan,3067841,32945803,-29877962,623
2022-01-23 23:43:00-05:00,9301,3gdApRPkUGEqmLvTYf4WQJCnmTVmiEU2wCQG26QMpqKf,HpP2yxq3KfYByT4q4p2mLaELnPdW6kmEY9EqZaBZuUNR,True,829399,207349,1292,646,646,HfEnetJ7uBSmZWCjBNxdvv9HEC5nsW4wDV7wu6WnhWan,51689,804119,-752430,623
2022-01-23 23:43:00-05:00,9302,APbpwRCB9tfma8yoi8upe633XZBtNwc5zVxXVjLwhg8s,BBwryuZZ8msiSFNmGkh13Wgg1PoSutY2Ftgz8odcxPm4,True,6583623,1645905,10241,5120,5121,HfEnetJ7uBSmZWCjBNxdvv9HEC5nsW4wDV7wu6WnhWan,409646,6164638,-5754992,622
2022-01-23 23:43:00-05:00,9303,CK1SjmBjrW7m1QVZbVZsVZgwEcxw8BTkckkzrZDrDdxW,M6vnBg1TPRhLu7sghkxtf5TkSLw5JhgoDmbGoyEYgR9,True,1391282,347820,2136,1068,1068,HfEnetJ7uBSmZWCjBNxdvv9HEC5nsW4wDV7wu6WnhWan,85451,1349305,-1263854,614
2022-01-23 23:43:33-05:00,9304,BmLG3dPSnL9hL2okZcNVsHgzuWYCrWLdXW8z5Jd2gyvF,HXwhov5Re9b8D4XHULcVSdgBNfbtZ7KMhMRqSTcQTbno,True,1862509,465627,2875,1437,1438,HfEnetJ7uBSmZWCjBNxdvv9HEC5nsW4wDV7wu6WnhWan,115021,1897151,-1782130,617
2022-01-23 23:43:34-05:00,9305,4pmhvxJcmebxtqN6RwVb9UbEtxpFXpuVN67Q74W6YAg3,B9fk51SEQmLbMDpQJV15f9gyCZhvEBWRXeLMnnmMqvfg,True,1685,421,2,1,1,HfEnetJ7uBSmZWCjBNxdvv9HEC5nsW4wDV7wu6WnhWan,105,1674,-1569,623
2022-01-23 23:43:34-05:00,9306,76gdRvg74fv6A9vA8ukNPqWKkmKY6KLAAKBGvbNE2AXC,5n88nkWZiCtWyWPrgfJozgkxtU9HMSggrxHkLoTQp1QR,True,2265,566,3,1,2,HfEnetJ7uBSmZWCjBNxdvv9HEC5nsW4wDV7wu6WnhWan,141,2266,-2125,622
2022-01-23 23:43:34-05:00,9307,75NA5QiXEHG4caSB9BpafGZPA9eT9S6MhKTFM6eHjz8H,FmoxAVw2zdG6qbyaXKy6gsvi1XY8ZVbSgUNbjsp9EpVd,True,1468775,367193,2288,1144,1144,HfEnetJ7uBSmZWCjBNxdvv9HEC5nsW4wDV7wu6WnhWan,91537,1363805,-1272268,623
2022-01-23 23:43:34-05:00,9308,HUe9LgGBjMeNxGyeCtmXr2XbWVFhHXrvgc2XSqCwN11D,7Z1nR9GgezBXsDX5wW3BBarfMRMZV28rX6MeLRuWtycG,True,12645223,3161305,19416,9708,9708,3zqXX6kzhkbW3d4TwD2CNjMRwxTbREXySekvq37kfCNk,776646,11859543,-11082897,614
2022-01-23 23:43:34-05:00,9309,51VhgthsxrRRr2PT5gLnDfL1A3soqwCxA1UzH9vRUGTh,4QCcd7hfsydQ63LH7Lqsp8oVXw7HuKamzQf8VMH6Lgu2,True,1103960,275990,1725,862,863,3zqXX6kzhkbW3d4TwD2CNjMRwxTbREXySekvq37kfCNk,69039,1070646,-1001607,625
2022-01-23 23:43:34-05:00,9310,57Vsw8jXaaoLriYEkvPAVyq66r4a4zMfLWbDaTBMjFzC,7AVDWUTHa6729UkXgCXASphSmrLvXYGAA9ygTMSqvwvY,True,703709,175927,1099,549,550,3zqXX6kzhkbW3d4TwD2CNjMRwxTbREXySekvq37kfCNk,43963,709304,-665341,624
2022-01-23 23:43:34-05:00,9311,BZn1DDE568UHeL2Qniv9EDT1yAAWvPJcTtSw4K4GQx44,CCaroU4YwKvYgibMsRPdEBxeDbzcNC4s5ZthxrhywSm5,True,1433871,358467,2227,1113,1114,HfEnetJ7uBSmZWCjBNxdvv9HEC5nsW4wDV7wu6WnhWan,89098,1386247,-1297149,621
2022-01-23 23:43:35-05:00,9312,JDg1bbHkYeznDUtSBLhagRJ45aSzeSF5V8iDRJCay9wL,8n7ic28zq5PjJtRcM7Fcy5vLW2YVXw4EWMK6UAt2zh3V,True,16050616,4012654,25119,12559,12560,3zqXX6kzhkbW3d4TwD2CNjMRwxTbREXySekvq37kfCNk,1004767,15563468,-14558701,625
2022-01-23 23:46:13-05:00,9313,yWK6vFZq58uYYiHscQTPSBqTDrWEW1SVbqe8NszoTEN,6H1zT5ifGaMKjdvZmptuDYf4Vou7tntdZQPVzQ4hWyjg,True,17463859,4365964,27312,13656,13656,3zqXX6kzhkbW3d4TwD2CNjMRwxTbREXySekvq37kfCNk,1092512,9874911,-8782399,625
2022-01-23 23:46:13-05:00,9314,CxePQ6ZEn2NCLYgGegSeFX1PyBuczP9j5v131VQSPh1c,9gPk7qTRb5JHqBXRKp3uZfhA2VjQAJDQHTzYXGLUdAUC,True,1283393,320848,2008,1004,1004,3zqXX6kzhkbW3d4TwD2CNjMRwxTbREXySekvq37kfCNk,80326,1245885,-1165559,625
2022-01-23 23:49:21-05:00,9315,52hhBAuVyifMNFKGQmSitc8smiEgscXQMzVuZj55j7E5,6B5DBJx9NLytR3fkrYqe5W5ek4rUWsR4nPsRTvRfRwzC,True,23698139,5924534,37018,18509,18509,HfEnetJ7uBSmZWCjBNxdvv9HEC5nsW4wDV7wu6WnhWan,1480725,23840202,-22359477,624
2022-01-23 23:49:23-05:00,9316,Gk4mpwDEggypoPjyrZcFDbHT8WBwspC5AbQ5uDgaQufL,GTDi3mKTcw1NfwbYx8s8YCkzqbaJUM8YUwYifNr9sjgH,True,128313547,32078386,200230,100115,100115,HfEnetJ7uBSmZWCjBNxdvv9HEC5nsW4wDV7wu6WnhWan,8009238,79361546,-71352308,624
2022-01-23 23:50:40-05:00,9317,Fs8MQLaMyr1Q96HsZivKLY7Kjdeu2ZoB2n3VTZ15KbSn,DREfCs5CTVNUUF8H3hD8CWvtxztiYxoLYh8HUWDecMyZ,True,22244910,5561227,34739,17369,17370,HfEnetJ7uBSmZWCjBNxdvv9HEC5nsW4wDV7wu6WnhWan,1389577,22394434,-21004857,624
2022-01-23 23:50:40-05:00,9318,9XHC2Ycm9f56cDYxRPVKYiYWGKA4y7Utpv3e9gpMsZq3,HpqAdpkzWqoJUNqmHEnn4PZwSB6C6jt8FJZQtZtFqXWA,True,6328088,1582022,9883,4941,4942,HfEnetJ7uBSmZWCjBNxdvv9HEC5nsW4wDV7wu6WnhWan,395337,5931301,-5535964,624
2022-01-23 23:55:17-05:00,9319,3EgUBHBeKWegibDcCsTGaGehnwHYvpMbcPaT1UTbwQ49,Hxd4dsnLD8uHnG7KR7GVmKXBcpN1egMUvoTccPvBcaYA,True,23535236,5883809,36831,18415,18416,HfEnetJ7uBSmZWCjBNxdvv9HEC5nsW4wDV7wu6WnhWan,1473264,23677683,-22204419,625
2022-01-23 23:55:29-05:00,9320,7A1v7bFDJwxM7XomePFyRh58SMHxrNSkM3fJygd8pQUN,DL9jCFHaM8BXJ5KE1YJHXNCbXgSdRgt18MHhAgC6TNmg,True,1717897,429474,2686,1343,1343,HfEnetJ7uBSmZWCjBNxdvv9HEC5nsW4wDV7wu6WnhWan,107452,1597373,-1489921,625
2022-01-23 23:55:50-05:00,9321,FwTGq3BeMLyRFRa5r4E6nySLgoLNcNdqJsCQxA2i6uh6,88w6ti3WSriyu2FvNjVfrLpGyU5PUvaiJyqrAGPM8TKp,True,680494,170123,1053,526,527,HfEnetJ7uBSmZWCjBNxdvv9HEC5nsW4wDV7wu6WnhWan,42142,687362,-645220,619
2022-01-23 23:55:50-05:00,9322,7EtGovzHsbD8cKGqq4R5rvKBbncR4Kc7CDkTjof2QBMf,8ShjeNWM2vcvUF9yYztYCHUQfcGsyg2A1LyWiPbQDDvq,True,136955,34238,208,104,104,HfEnetJ7uBSmZWCjBNxdvv9HEC5nsW4wDV7wu6WnhWan,8341,138331,-129990,609
2022-01-23 23:55:50-05:00,9323,68qWTKE41JPQMbF7zwqoELSVn2XbjcUMA4UTfER4fcz6,HrDYnhxX1Gm72Kq9H9k44xUfxqELLkC2yoEkkR3LEEHM,True,433496248,108374062,653747,326873,326874,HfEnetJ7uBSmZWCjBNxdvv9HEC5nsW4wDV7wu6WnhWan,26149886,242933638,-216783752,603
2022-01-23 23:55:50-05:00,9324,HfwGSiwGiyDFaTS2usYRp82zSmPPQqZukbw2d1BuFs5w,ArtgZbmA33k8Y3EfR6oMJiqT72MUrVBQqifPBdcnrzea,True,424022,106005,642,321,321,HfEnetJ7uBSmZWCjBNxdvv9HEC5nsW4wDV7wu6WnhWan,25694,255307,-229613,605
2022-01-23 23:55:51-05:00,9325,8HWpccoTmPZ9MsrxtvQ5BV5y8a8WBAB1Sxx2WAiYKRLH,9chtr2Nqg77CCCnjC5JqENmUBNxpDHVH6BG3wojn9gHQ,True,790873,197718,1223,611,612,HfEnetJ7uBSmZWCjBNxdvv9HEC5nsW4wDV7wu6WnhWan,48952,810426,-761474,618
2022-01-23 23:55:51-05:00,9326,8CzXrg1YZ9XYqyMtDKtz9GU4fMhZiprbJDJGZerdmHeV,32dMLNjnC9uqHU8hXEsuRb3incAKkBEJNm2uHkKweNMs,True,912569278,228142319,1414264,707132,707132,HfEnetJ7uBSmZWCjBNxdvv9HEC5nsW4wDV7wu6WnhWan,56570581,911783055,-855212474,619
2022-01-23 23:55:51-05:00,9327,8d4LtUwpkNSKRUdFbxhbeeaVc8hABhwjUExt3QgEVQbz,BieULGWXC1yEtuK9y27SMo9ApNDo6jLjxs5egr1Ebsda,True,3515954,878988,5404,2702,2702,HfEnetJ7uBSmZWCjBNxdvv9HEC5nsW4wDV7wu6WnhWan,216190,3659533,-3443343,614
2022-01-23 23:55:51-05:00,9328,3PPCwAjj8GNphb3cRs7kP1QVghEUX6gWUH3M4JarQsTD,28UR4WKAziiJmPwas5E5JrY3WaUrR2NkYYXCKuxPHTMR,True,189503140,47375785,291464,145732,145732,HfEnetJ7uBSmZWCjBNxdvv9HEC5nsW4wDV7wu6WnhWan,11658582,178090278,-166431696,615
2022-01-24 00:07:11-05:00,9329,HukFwJRwbT4R5P1YBDg61HphUfBHLiiawpvwf7C8VYzR,ATQqXSEQcZJL1hjfbQZ2ihUuRbxG6fJppJhv7ycWEhPd,True,1071924153,267981038,1658923,829461,829462,HfEnetJ7uBSmZWCjBNxdvv9HEC5nsW4wDV7wu6WnhWan,66356934,824937272,-758580338,619
2022-01-24 00:07:11-05:00,9330,3sGCWcgPY7TzRCkFR1uuY8KcUzVRbdTyFYxh7V1csNMX,CcRFNnG2uhyLwhNAbX4U49jkMeC11kJtVhhyqDWdDK5r,True,15278249,3819562,23852,11926,11926,HfEnetJ7uBSmZWCjBNxdvv9HEC5nsW4wDV7wu6WnhWan,954088,15573346,-14619258,624
2022-01-24 00:07:11-05:00,9331,23FjS7S6hwPkaBsziThnqwAqy3dZvDYvNLdCKfxp7Jr4,CpGixAiKhjCWJ8tD8hWxuSUeU7mQeoZU5TVdqsAEMvLQ,True,50339917,12584979,77096,38548,38548,HfEnetJ7uBSmZWCjBNxdvv9HEC5nsW4wDV7wu6WnhWan,3083879,74231779,-71147900,612
2022-01-24 00:07:11-05:00,9332,4oop1mjCh1Ao9NoWAUacAGc75GxiRTXr8KJ3NtzZ7btf,BfntjUunXBhnrKmocQ7pZr3wwxruRGudMyWQYC2MUhei,True,2212459,553114,3385,1692,1693,3zqXX6kzhkbW3d4TwD2CNjMRwxTbREXySekvq37kfCNk,135427,2194028,-2058601,612
2022-01-24 00:07:11-05:00,9333,9Hz4p7gcfDbXBJp8KzhaBBPh9i7xe9kun7zLfDtqPe6c,2bJ43Lep6kp6WY7Ct56oiscKnAbdtC265G5yRvRPFThU,True,1962459,490614,3056,1528,1528,HfEnetJ7uBSmZWCjBNxdvv9HEC5nsW4wDV7wu6WnhWan,122263,1348513,-1226250,623
2022-01-24 00:07:12-05:00,9334,2EkjFzKuqQaT9iLsf4qHnXM6rnbj7ftEyzzRsWx6D347,9NpHNbrRJF3U8Ub4KraPHhhZpyZk9Teo836dJSktJMEV,True,4752489,1188122,7427,3713,3714,HfEnetJ7uBSmZWCjBNxdvv9HEC5nsW4wDV7wu6WnhWan,297082,2925300,-2628218,625
2022-01-24 00:07:12-05:00,9335,A4Q7Vrc9M3GtEXNUSiVBFkansyf5sKBtSeVT92WFacqv,EWLNfsTKqzkd7KAhnrPRre4Dyk6exb3H9wSbrJuyWprg,True,13674203,3418550,21310,10655,10655,HfEnetJ7uBSmZWCjBNxdvv9HEC5nsW4wDV7wu6WnhWan,852408,13925783,-13073375,623
2022-01-24 00:07:12-05:00,9336,ymyzGH4Qc7HH5PbKpVphCbsQgLLXyGkPcXamQJuNj5C,8oTLHaV2XzbKXNWRuUjCfHjUn61Pw93LYK14m9q2VDpZ,True,28417,7104,44,22,22,3zqXX6kzhkbW3d4TwD2CNjMRwxTbREXySekvq37kfCNk,1772,27325,-25553,623
2022-01-24 00:07:12-05:00,9337,EBpxGcrs4eWAbBU5rEjFxbr24MjUstZQRMV9jK4q8kMp,EYVd6pztEuz8PC7rUnJ1AjVZ81WWpynyn2qEKtveqrHG,True,937877,234469,1443,721,722,HfEnetJ7uBSmZWCjBNxdvv9HEC5nsW4wDV7wu6WnhWan,57729,946583,-888854,615
2022-01-24 00:07:15-05:00,9338,2ZSfbqxhiCTDrDPeRhoWayTZHNmW7ajVXBCxpFS4eGBF,3ZmWsPdQD7qfSMGKQSNhmBtuH7S6qMFRc8oEmBcHXEiR,True,536620,134155,839,419,420,3zqXX6kzhkbW3d4TwD2CNjMRwxTbREXySekvq37kfCNk,33588,558854,-525266,625
2022-01-24 00:07:22-05:00,9339,FYdUiU3rPpbYKWnEpekQQsocSJKjXmscohi4v6DYqix7,daPyq9YdunQJhhLoW5ifhJ7UFPTtRZhGs4JwE1nqZhN,True,539669,134917,834,417,417,3zqXX6kzhkbW3d4TwD2CNjMRwxTbREXySekvq37kfCNk,33391,562418,-529027,618
2022-01-24 00:07:23-05:00,9340,As81koHnSP9quoXuUVNHp3VR3Qaks8HLa4sFgJDocYiF,AMVm8dXia5s974VgZSbeE6uPDgyXDHZFyJ2W1J1CWvKW,True,15019749,3754937,23357,11678,11679,HfEnetJ7uBSmZWCjBNxdvv9HEC5nsW4wDV7wu6WnhWan,934280,15278152,-14343872,622
2022-01-24 00:07:23-05:00,9341,U3vvMQ4X4aKzVYfhMw1V1p58HRqaLnuXozqmmefYeD9,7JA94MArkNCFRhBq8f5a32DgMF6aPdFsoC5HvXDQ6NuR,True,648380,162095,1012,506,506,HfEnetJ7uBSmZWCjBNxdvv9HEC5nsW4wDV7wu6WnhWan,40519,753358,-712839,624
2022-01-24 00:07:23-05:00,9342,FdYFnEYtFQKcZPmzUqnvNLzozxdR1emtkmvnYcMgYykS,7arWNJQf2cWxerjhLgQh9CJxwTat1efnr5KmhuD7Qnv4,True,417319,104329,648,324,324,HfEnetJ7uBSmZWCjBNxdvv9HEC5nsW4wDV7wu6WnhWan,25953,435361,-409408,621
2022-01-24 00:07:23-05:00,9343,CJpe9bNHxS63QMaGJhmnr4u7eTo6e5GApZQZyPtXLAkk,EMVL4sDfVXwGEoGEYwLp8D6itfy3eu4FZBAj1kMz6uXa,True,14331583,3582895,22341,11170,11171,HfEnetJ7uBSmZWCjBNxdvv9HEC5nsW4wDV7wu6WnhWan,893675,14591000,-13697325,623
2022-01-24 00:07:25-05:00,9344,AvpYg74EBhwAXE8rcdGkpwmbBMRyVidF6zMRSFtWAVC6,4WgpqTp4r9wMpMptYMNbvCaP2faBnVr6FdShCAobetpL,True,531981,132995,830,415,415,3zqXX6kzhkbW3d4TwD2CNjMRwxTbREXySekvq37kfCNk,33236,554671,-521435,624
2022-01-24 00:07:25-05:00,9345,BLJgLzizx2yLgd12pVBAHTMqn9J5JA3JHCF8PnLnPyUk,HhDmwMysBFWhXnd3mrV31w75WBRKBS8wJSiEMZgqdUSp,True,2110112,527528,3292,1646,1646,3zqXX6kzhkbW3d4TwD2CNjMRwxTbREXySekvq37kfCNk,131690,2249621,-2117931,624
2022-01-24 00:07:26-05:00,9346,5y8ZSWUnrm4B3emh7vLQKTh89vHtCvXqUhk7fJBA52is,Bu1AoKU2QQWpGH54ZzugvvACB3E1d3VvymnegNmTgHqg,True,15023514,3755878,23325,11662,11663,HfEnetJ7uBSmZWCjBNxdvv9HEC5nsW4wDV7wu6WnhWan,933032,15273138,-14340106,621
2022-01-24 00:07:36-05:00,9347,Aop82qT6CwZbomif4QowqP3VaSHKB1837B2yNKqw4tER,65BVa4jrCx9etU5eXBAXT2PVnwVot2HLWGYyNXbVJDFk,True,7365379,1841344,11356,5678,5678,HfEnetJ7uBSmZWCjBNxdvv9HEC5nsW4wDV7wu6WnhWan,454259,7503719,-7049460,616
2022-01-24 00:07:36-05:00,9348,BrHRMouGRz3LBNzd9anfdYMhWfg8yUPHL4PqJ8WdEDFS,4uzoLa3mC2VYHAPBoHLX4gTjPTC28rPf2fvEGtJWPYc,True,67969,16992,104,52,52,HfEnetJ7uBSmZWCjBNxdvv9HEC5nsW4wDV7wu6WnhWan,4184,107106,-102922,615
2022-01-24 00:07:36-05:00,9349,5V5gFVMYSwGYfHFecRoHg8G22Rg4bXfVK2FSRTMhPQty,73raXd5MvixmDvJRnVjRL7yQaHZGFRiC9aBxL9ysiRvy,True,59246848,14811712,91416,45708,45708,3zqXX6kzhkbW3d4TwD2CNjMRwxTbREXySekvq37kfCNk,3656660,31900277,-28243617,617
2022-01-24 00:07:36-05:00,9350,92vHa65f4WpuqzSCMESDMPxZ2yfLxXJMMPYLof75EiN,3QZvcV1wL2ZYnw9yY9sbhiCP3dYYHeUZB7gcqtSutuLK,True,340185925,85046481,520528,260264,260264,3zqXX6kzhkbW3d4TwD2CNjMRwxTbREXySekvq37kfCNk,20821158,190585233,-169764075,612
2022-01-24 00:07:36-05:00,9351,FV9CBGGTbppLnBKh79f2LzD1diTiS5g6u89FcpZHZmnK,Fe7mtmCUziFqbbYTvrhAcAq1Ub7YLfTJRtQ1hG7GzJD1,True,11218,2804,17,8,9,HfEnetJ7uBSmZWCjBNxdvv9HEC5nsW4wDV7wu6WnhWan,696,10920,-10224,620
2022-01-24 00:07:36-05:00,9352,7EvJoetxJVTgpJXqE1VC3fZN1CQ5xdWdv29yCiDuH9gU,6RTEusjGEHNDdMj75qkpzYHjHZ3R2XN5xvptCwkRJz5j,True,600359,150089,938,469,469,3zqXX6kzhkbW3d4TwD2CNjMRwxTbREXySekvq37kfCNk,37527,627147,-589620,625
2022-01-24 00:07:36-05:00,9353,8ARSFh2vPjz7M1pjNqFRsRrHFGwVsUNnD7kLbqhmMrZR,9TGsutLwHv259Le8zfZ75FM4eLZffi6itgWBgYqeKkAy,True,3587326,896831,5537,2768,2769,HfEnetJ7uBSmZWCjBNxdvv9HEC5nsW4wDV7wu6WnhWan,221519,3720980,-3499461,617
2022-01-24 00:07:36-05:00,9354,9kYkFDNE3qD6s73fn8kJowgqbDZoDSw22XaUJ7rTD43D,E8zJz8pT2c9aZsxe4kLMNs4bY7skt38SU5wK5JTqbGr6,True,8220813,2055203,12837,6418,6419,HfEnetJ7uBSmZWCjBNxdvv9HEC5nsW4wDV7wu6WnhWan,513509,8589874,-8076365,624
2022-01-24 00:07:36-05:00,9355,FF8rqfM9PTEjYiVFy8jS81weDRwdaYooux2uSa2LexrJ,JBk1JghH1gged1YpDbkczFXP9ka5ivYSkaYoVbbXD4kg,True,386708,96677,601,300,301,HfEnetJ7uBSmZWCjBNxdvv9HEC5nsW4wDV7wu6WnhWan,24078,430102,-406024,622
2022-01-24 00:07:39-05:00,9356,3tQBuHwr3V8AZu8Yqhg1UfmnFoxzkUq9UeGeLm41UHy4,9cESwduiHBgrxZK1hN1eAFwnyfxw3FEHezTa8Ue5Kpye,True,43102007,10775501,67343,33671,33672,3zqXX6kzhkbW3d4TwD2CNjMRwxTbREXySekvq37kfCNk,2693742,29644682,-26950940,624
2022-01-24 00:07:40-05:00,9357,DMgD2KCEhTGFLUZ5GnfNcwfiiwKYbyVpoWiN6knMkCAf,5KU2vgBkPTNVHsSULjgX7ZkZS56U3Dy3xqLTxL5sUZJ3,True,2939714,734928,4600,2300,2300,3zqXX6kzhkbW3d4TwD2CNjMRwxTbREXySekvq37kfCNk,184012,3776062,-3592050,625
2022-01-24 00:07:40-05:00,9358,HGJoZvLakWfSDFwuvShNBc4kCf7nP7VqzyM3mELpbFEf,12Qn5jin7QvsBngXqYAv4UstyG3b6nRf1jsLp9Dp8G7k,True,33426,8356,52,26,26,3zqXX6kzhkbW3d4TwD2CNjMRwxTbREXySekvq37kfCNk,2090,35634,-33544,625
2022-01-24 00:07:54-05:00,9359,73PpLzJmAimmqtjGpRcYHua8t6wx3gYiiXFvQxnSDMJV,CRCpLcS8LNKX22co94spJBXEes9Fnh5rYBvbVEte4JXA,True,62843672,15710918,97109,48554,48555,HfEnetJ7uBSmZWCjBNxdvv9HEC5nsW4wDV7wu6WnhWan,3884397,58601421,-54717024,618
2022-01-24 00:07:56-05:00,9360,4SX2pj4eHRwFMtyDCrMZ8ZT6ASAMi7yfZWZnccw5dGn8,Ads49ZqvTmPHxfzNYm4oJb4HBYhwS6vXQbarqmpUi5VZ,True,435796,108949,667,333,334,3zqXX6kzhkbW3d4TwD2CNjMRwxTbREXySekvq37kfCNk,26704,456151,-429447,612
2022-01-24 00:07:57-05:00,9361,9BMHbUs4d3qX49fnroHv2FTPDs4yoDFrvDMqf8p9U4pE,2yL7zwMr7qVG5Sdwkf7z6ppnNqt1ASppBbmxwYjfFY6Z,True,8311619,2077904,12761,6380,6381,HfEnetJ7uBSmZWCjBNxdvv9HEC5nsW4wDV7wu6WnhWan,510458,8701347,-8190889,614
2022-01-24 00:07:57-05:00,9362,BJV5jbowrbELXfDvfMovaQy4PiRf12pLYHimW9bgzW5X,6WXrWso5FvLx7RMCFBzrbzh5qevKkk2LJAihUfWXxXzB,True,44547,11136,68,34,34,HfEnetJ7uBSmZWCjBNxdvv9HEC5nsW4wDV7wu6WnhWan,2736,70761,-68025,614
2022-01-24 00:07:57-05:00,9363,2FEbsetZMkRqLjSC8GBbgecKgX5T1T1fci2sLQux29p8,H722Fcd6DkTFRZxqQWbPDufBfXEgmFfhiEpQZWhxwYv1,True,9943,2485,15,7,8,3zqXX6kzhkbW3d4TwD2CNjMRwxTbREXySekvq37kfCNk,610,9719,-9109,613
2022-01-24 00:07:58-05:00,9364,EBnMKbaJEjNXjt14hxssR8wd3Ua37McPQxUZnKxxbgtd,FAALK2LRFhg98ezHEBFrgrzxTg66eZpmo7ctKDEck8q5,True,940909,235227,1451,725,726,HfEnetJ7uBSmZWCjBNxdvv9HEC5nsW4wDV7wu6WnhWan,58049,896751,-838702,616
2022-01-24 00:07:58-05:00,9365,EPWsutEpgpcz776maq552k8QhDKdmkSfAED5E3jgpTdY,CCwGZYDvqoHEBBtSSieAJgy5e3k4jYrpjyDffypwnWxu,True,22259209,5564802,34731,17365,17366,HfEnetJ7uBSmZWCjBNxdvv9HEC5nsW4wDV7wu6WnhWan,1389243,22430738,-21041495,624
2022-01-24 00:07:58-05:00,9366,B4Uc39nKzz9wBRQsCkMR4A7RwTJ8rSuwpR6EQn2AesRb,H49bGZgatRZVpj6QufZRVgYrQtH7LpdbiqKBs23151m,True,53257,13314,82,41,41,HfEnetJ7uBSmZWCjBNxdvv9HEC5nsW4wDV7wu6WnhWan,3303,90694,-87391,620
2022-01-24 00:07:58-05:00,9367,HZSJVNb6g4o52N7pAJCLkGjur8evF5Ex1sAx7uUxUDdm,8LQHKhXStrwcd6f4AxaTVcrGdYpGjQz8vWf5JXsAzcsp,True,615557,153889,958,479,479,HfEnetJ7uBSmZWCjBNxdvv9HEC5nsW4wDV7wu6WnhWan,38352,643484,-605132,623
2022-01-24 00:07:58-05:00,9368,95urWGJ4HN1bTarbDi8Dpj4K4ms7dovs8gwaYdaSLC6e,2THhqxjhXjp2Zui9ML2MzAbGN4dsfa3dkdqzC8LYhnbQ,True,783537,195884,1215,607,608,HfEnetJ7uBSmZWCjBNxdvv9HEC5nsW4wDV7wu6WnhWan,48638,792023,-743385,620
2022-01-24 00:07:58-05:00,9369,3NhNdphQiKwgHTmTJc4qVhp3aWjqnwMTYbRW1y9CZrZg,BNpP1sKPAr7Dk1ymSrupge9KGMVpk4LfjTjawgi9YaC5,True,3135366,783841,4832,2416,2416,HfEnetJ7uBSmZWCjBNxdvv9HEC5nsW4wDV7wu6WnhWan,193300,3197584,-3004284,616
2022-01-24 00:07:58-05:00,9370,96StvqZyFUPtyMr4o9s7K4V29RSNyRpVi76vNwxG5rUf,GZKXFSFq4aGiTaqovtxqNCCVGkAFNXPh4Hep1ZMwdZ8g,True,47524,11881,74,37,37,HfEnetJ7uBSmZWCjBNxdvv9HEC5nsW4wDV7wu6WnhWan,2964,78778,-75814,623
2022-01-24 00:07:58-05:00,9371,9rgrRAMcGSarfz8xXckw1LjkemMwwjzJLApPjpfY2XZ3,BRtNdDDtCiNDYDERZTBCefUiYvjShucRX1hxEBLyeggT,True,422613,105653,655,327,328,HfEnetJ7uBSmZWCjBNxdvv9HEC5nsW4wDV7wu6WnhWan,26213,441502,-415289,620
2022-01-24 00:07:58-05:00,9372,BYvjENe16Ta77PqGV7JKEWrsqCTfkMGYwTSG5gXneDvd,EvxAXgvhPC6QkNurbK7vWyTApGo8J2R4EgMAknkHVU3d,True,6364,1591,9,4,5,HfEnetJ7uBSmZWCjBNxdvv9HEC5nsW4wDV7wu6WnhWan,392,8321,-7929,615
2022-01-24 00:07:58-05:00,9373,E8iuHK2DErFnMAYfWmNoix4jVb4WDG8Sc41hBycLUxbd,77Zoru23JmnK5EJ8eURonQoEpJcLP4edabjD8MR8NKdX,True,8302548,2075637,12930,6465,6465,3zqXX6kzhkbW3d4TwD2CNjMRwxTbREXySekvq37kfCNk,517226,8674807,-8157581,622
2022-01-24 00:07:58-05:00,9374,6sK2PQyTvStxT9qigrFaPmf9GSe4X4wLb4ig7izrzwaB,6iyTuXdnBiLrKPCat7ajRnUq2245L9bbJrHAvsnyFx8e,True,3650,912,5,2,3,3zqXX6kzhkbW3d4TwD2CNjMRwxTbREXySekvq37kfCNk,227,3739,-3512,621
2022-01-24 00:07:59-05:00,9375,4yhW5mBsFVNgQ5QQc2Yg65guctPsTSXcERbzmYM6rdnL,5uJnMZ6DWA9bMSvHvS5zomwtt1sv7YCWq3GDJh77YC3q,True,526668,131667,822,411,411,3zqXX6kzhkbW3d4TwD2CNjMRwxTbREXySekvq37kfCNk,32889,551307,-518418,624
2022-01-24 00:07:59-05:00,9376,5iRLEmB6qBHqkJBPyyubnd9f1TpRr4EY8BTxuHUREeLB,GkY73KL6HJ4ycdggFtYWALBgmTRZVCx66P2ZJ7E8ENwC,True,457056,114264,714,357,357,3zqXX6kzhkbW3d4TwD2CNjMRwxTbREXySekvq37kfCNk,28566,477244,-448678,625
2022-01-24 00:07:59-05:00,9377,6Bq55LtGCEeGqh4JrFLCmmGc2iJfTTBJixivqH78aGSE,DSNrCgWJeNe2P9tAQu5FvCueTzNKDKds7wzuwTQSMRG,True,14140,3535,22,11,11,3zqXX6kzhkbW3d4TwD2CNjMRwxTbREXySekvq37kfCNk,883,13678,-12795,624
2022-01-24 00:07:59-05:00,9378,GcjcaWoMUcGkLaJBx3svxtzwGNn5SLcFrwaLqnpadUZY,Ep9sDjTMMasVjKdshsE88uk3mWYkKuMTVRooVJWvCq9F,True,8140690,2035172,12696,6348,6348,HfEnetJ7uBSmZWCjBNxdvv9HEC5nsW4wDV7wu6WnhWan,507848,8496611,-7988763,623
2022-01-24 00:07:59-05:00,9379,6Z6y2QLJUZ5s6zdjanJcKprTAotx8tqr9DRNqqycMeS4,JCYwt8MHVaBb14GB2qAvDWwYVMaL7VTxyNEt7Eo5Zy8x,True,438574,109643,675,337,338,3zqXX6kzhkbW3d4TwD2CNjMRwxTbREXySekvq37kfCNk,27022,457873,-430851,616
2022-01-24 00:08:02-05:00,9380,9wsQcvpqPp8c9q42RntWDNbqNCnmJeW4GMG2AtKAHkBu,EMqRbzGvXTU1LtmoSw9uSrpTX2L4tpJQAMJJJ4duvzf5,True,75989612,18997403,118830,59415,59415,3zqXX6kzhkbW3d4TwD2CNjMRwxTbREXySekvq37kfCNk,4753207,43123722,-38370515,625
2022-01-24 00:08:02-05:00,9381,4nhdidD6SASYzwZ7mUnWKyP4xyWXhdBe2gp5F4qDtLrL,HLk6YPhVidsn3i8HfoASvoim1ztxb4bi8JnioiyvorpV,True,3007225,751806,4702,2351,2351,3zqXX6kzhkbW3d4TwD2CNjMRwxTbREXySekvq37kfCNk,188112,3053594,-2865482,625
2022-01-24 00:08:02-05:00,9382,Fw2e6jxKVeFcJSe9MyVhSz3dUdJQLs3XULHrT1mtMU9U,591U5bexgLRJXygtK5fpCRXcZEq89KgewFTdfPkti8bY,True,63356394,15839098,99146,49573,49573,3zqXX6kzhkbW3d4TwD2CNjMRwxTbREXySekvq37kfCNk,3965871,59117888,-55152017,625
2022-01-24 00:08:02-05:00,9383,8GdYhwX26GRmVfGFCbJ3MJrH1UdneN2FNRUexhLsqprN,DpUTHSVucDPyCWoLCdpm8EFRZFiKL88tmnSiWG2TRpS8,True,480212,120053,751,375,376,3zqXX6kzhkbW3d4TwD2CNjMRwxTbREXySekvq37kfCNk,30049,498945,-468896,625
2022-01-24 00:08:02-05:00,9384,9T6bCVf7AshQP1NNbsF3eCdbChKbcfrFUPFWUXRijY5M,4ZFq3kdwaUhiotXCXzDFjVCAP3udzGsx5CicgLLXd4PR,True,300609707,75152426,470195,235097,235098,3zqXX6kzhkbW3d4TwD2CNjMRwxTbREXySekvq37kfCNk,18807803,170393803,-151586000,625
2022-01-24 00:08:24-05:00,9385,43EtYHdVkdBxHTtFR3QWVgvCKj1SqsAf7xLY2yphsv1x,8WJbP4mVJWYuN1dVzHpRg7YR2nBELB4Krkq8Zch8sp4g,True,653757,163439,1002,501,501,3zqXX6kzhkbW3d4TwD2CNjMRwxTbREXySekvq37kfCNk,40097,635857,-595760,613
2022-01-24 00:08:24-05:00,9386,28YQqynu5oRud5xEcsDvAaGhJhgpiVJSTNeMwkrbpbyv,9zYqRWiRatbohCdBfV3PrAxp8v1kwgbvV9ta4RJRRp68,True,21777996,5444499,33390,16695,16695,3zqXX6kzhkbW3d4TwD2CNjMRwxTbREXySekvq37kfCNk,1335621,21982611,-20646990,613
2022-01-24 00:08:26-05:00,9387,DD1a8rMoUCwmEiLKRN43VpdqL8Qgfr5yi92ejQxDVRMo,3vMJVNAuyRhM9jkaEZARhwbR6MerR5UmcgoZ9c5bs1VS,True,9780770,2445192,14987,7493,7494,3zqXX6kzhkbW3d4TwD2CNjMRwxTbREXySekvq37kfCNk,599495,10233330,-9633835,612
2022-01-24 00:08:26-05:00,9388,CygwJ5Z1ZP6xfjN1ZGH7yw8b2oYvf6JTpenXx7A5yFdt,59VKgJtBCTb3Pji7BWtqttisBYVVCnWtyEn5Eba5r52Y,True,9314473,2328618,14522,7261,7261,HfEnetJ7uBSmZWCjBNxdvv9HEC5nsW4wDV7wu6WnhWan,580888,9062508,-8481620,623
2022-01-24 00:08:26-05:00,9389,C1tcxAjMzZaFVcF2ke2nSyiCjcLBwsz5yKXShy5MB14h,GYkrJj2zHVZuzPC45MbuevYkRJHdeL4Sqj9SWqZfUdiE,True,27964790,6991197,42748,21374,21374,3zqXX6kzhkbW3d4TwD2CNjMRwxTbREXySekvq37kfCNk,1709932,28113624,-26403692,611
2022-01-24 00:08:26-05:00,9390,Gfe4UgUGqvzcehSbETrWwLRAcqzFnkTrs6vJx8h6kTxi,7exMQ8sLti4Pmb2ZQtZhyuWRuQ6pq7XSXL9sCcWTqCvF,True,43461611,10865402,67285,33642,33643,3zqXX6kzhkbW3d4TwD2CNjMRwxTbREXySekvq37kfCNk,2691429,44608919,-41917490,619
2022-01-24 00:08:26-05:00,9391,8xjstKJD2RopRxxRP8JbMYRmpBKgSZivMFRXXRZ5syPh,HUfevkvBsm5SDpxnZ4NBD8Re7LvqBQLrx5UWXCeYTBgK,True,791788,197947,1219,609,610,HfEnetJ7uBSmZWCjBNxdvv9HEC5nsW4wDV7wu6WnhWan,48771,801540,-752769,615
2022-01-24 00:08:26-05:00,9392,Bt37YbHvD2M8zcGmanksKy8MCi4Qzto7hEnGRJyNvWyg,4WGRnDhpoY4zJi74iJyALasETpJNJMCJtf9aWJUVrHQv,True,682294749,170573687,1046563,523281,523282,HfEnetJ7uBSmZWCjBNxdvv9HEC5nsW4wDV7wu6WnhWan,41862549,387276656,-345414107,613
2022-01-24 00:08:26-05:00,9393,4cNmhgaMic1xBiaDJ6phrQuXmm8WfF1qjyYMqZcKG4c9,43vgfXiLTtcs1bkrcDar2iz9M6RMbGqbA6BMkBHdh7T4,True,502414,125603,778,389,389,HfEnetJ7uBSmZWCjBNxdvv9HEC5nsW4wDV7wu6WnhWan,31158,527883,-496725,620
2022-01-24 00:08:26-05:00,9394,BMawc4jLJMER4ryGcwdm27H3MU8JQCiSfwb9onVfYDpr,5ciaGDuaB3rBKvV7MphT2eMkCUxBzWZc7zYXQM7vbQ46,True,3142267,785566,4824,2412,2412,3zqXX6kzhkbW3d4TwD2CNjMRwxTbREXySekvq37kfCNk,192996,3190378,-2997382,614
2022-01-24 00:08:26-05:00,9395,4qWzk4JP2gEsTP252Y4SJrjSmfRBxDfE4ZdbPmwavfb2,CAgDhCNVyy61FG2YPMnm9zxgY56s2UqPhvssH5G1LjXP,True,57172250,14293062,88956,44478,44478,HfEnetJ7uBSmZWCjBNxdvv9HEC5nsW4wDV7wu6WnhWan,3558248,53219189,-49660941,622
2022-01-24 00:08:26-05:00,9396,43wwd6zLB8yKfXEu7rtbeDFhKBuxFR66MnyhTKW3zqa3,A9t6AMvVNenwWymz3QMtdUuuGYjjTPLaA9bhRjTzNY9h,True,8329422,2082355,12764,6382,6382,3zqXX6kzhkbW3d4TwD2CNjMRwxTbREXySekvq37kfCNk,510561,8715287,-8204726,612
2022-01-24 00:08:26-05:00,9397,7afnF1MkAootZGWc7zsMVLpBuve83hGmvAHkfmwgsq5A,HKdJE8bReznq1Qxqd5iZ4nWQGCk62Vo5TpkRD51bpbGp,True,550428,137607,859,429,430,3zqXX6kzhkbW3d4TwD2CNjMRwxTbREXySekvq37kfCNk,34363,574212,-539849,624
2022-01-24 00:08:26-05:00,9398,9WRDBHzD4aNHw5qvrhc6nqXCBLA5D7YYP8TvSrLksXd6,GwxWNmv9XDkqQsx7DfCMccFjVik8asPnFU9gtnb4UVx,True,414779,103694,648,324,324,HfEnetJ7uBSmZWCjBNxdvv9HEC5nsW4wDV7wu6WnhWan,25931,432808,-406877,625
2022-01-24 00:08:26-05:00,9399,8YMEydGnQH9W5AEXFGquFkb1bcf3PcxiMvYBSMPXKJyQ,3CmWH8eYtkmHNisqMmMBLff6C6z6ZcSj38KoQ34DPUE7,True,419553,104888,650,325,325,3zqXX6kzhkbW3d4TwD2CNjMRwxTbREXySekvq37kfCNk,26010,407943,-381933,619
2022-01-24 00:08:26-05:00,9400,6aW9dhnTNerVd1MPv5GrcYqgjVPE9LsNCGYSJSrNdgS8,8kmJu2UxTk2T37sqxDSrf6pDWhJZRxfRdJB7DLeoWddJ,True,17704243,4426060,27371,13685,13686,3zqXX6kzhkbW3d4TwD2CNjMRwxTbREXySekvq37kfCNk,1094845,17584170,-16489325,618
2022-01-24 00:08:26-05:00,9401,GwYr2DmtMVLWxVz6kVSXR6rvxL4x3DXtvNC7taswSWHN,2otMHa7JT1twPSSN6XF9fqGkKrEK8nnuMFZG1TtAgFQk,True,3645,911,5,2,3,3zqXX6kzhkbW3d4TwD2CNjMRwxTbREXySekvq37kfCNk,223,3740,-3517,611
2022-01-24 00:08:26-05:00,9402,45AiuRBbmupfwYXqsWwKHtmEWN8XNJDUSHwHL3b6PvHc,CfvwVkxYPP3jqK2dpAvSRFA1513E9ti84mEpYgtkzFUt,True,911357,227839,1417,708,709,HfEnetJ7uBSmZWCjBNxdvv9HEC5nsW4wDV7wu6WnhWan,56719,918353,-861634,622
2022-01-24 00:08:26-05:00,9403,446VESPwhh16pG3VcpgraT83MoqWy87qgU36mKZC8BsW,SmUPkPpnnRfSH3tcKUnbpK6HHNJtLfvMiUWk9eUwkNy,True,22089821,5522455,33926,16963,16963,HfEnetJ7uBSmZWCjBNxdvv9HEC5nsW4wDV7wu6WnhWan,1357063,22306215,-20949152,614
2022-01-24 00:08:26-05:00,9404,5FgPU7KpsDnx4Xc1UdQoLPR7MDd5cBkJXW2Q8ctopMZR,9GWzAZFVfTY8WjTYvDAE2YcAjgeKiDXgToK76KBZF7Rv,True,706711,176677,1088,544,544,3zqXX6kzhkbW3d4TwD2CNjMRwxTbREXySekvq37kfCNk,43558,714657,-671099,616
2022-01-24 00:08:26-05:00,9405,EmXaq1sxmAZUiwYW6LXpKtKFZXu5MzQ3sK4MEAojDK1h,HuAsa5G2wJi8Ah9stxEmggwcB5zW1QjBsP3Ndgke7r8X,True,715669,178917,1104,552,552,HfEnetJ7uBSmZWCjBNxdvv9HEC5nsW4wDV7wu6WnhWan,44193,747053,-702860,617
2022-01-24 00:08:26-05:00,9406,Hqzz5RdbkkmMPCVdxF3Q3sLuh7XVJHEwAP6zpz7pCwTj,TNwXSETgrJGM9S5zbBY3mMWKbPFskbKjPAhBrWFNfuK,True,477818,119454,733,366,367,3zqXX6kzhkbW3d4TwD2CNjMRwxTbREXySekvq37kfCNk,29333,498174,-468841,613
2022-01-24 00:08:26-05:00,9407,HpRYrL8HzCPaBJTLFgZmYg2aXBnBQUpf1mikVkzkY56z,8DzHRd8qWcEjnX6cefwYtgRGpQJUaw9QPjyfAsN7j33r,True,5453464,1363366,8415,4207,4208,HfEnetJ7uBSmZWCjBNxdvv9HEC5nsW4wDV7wu6WnhWan,336627,5560817,-5224190,617
2022-01-24 00:08:26-05:00,9408,8nXbrdjjaHB73CRPRenGEQj73wbtEFGDwXsehRGMhsap,43pvdcJ6f27wz94D6ZboKwRJYbyvYCrjsJhYsvk7LJCM,True,132498,33124,203,101,102,3zqXX6kzhkbW3d4TwD2CNjMRwxTbREXySekvq37kfCNk,8152,90080,-81928,615
2022-01-24 00:08:28-05:00,9409,6kt64nJRnYaWMi9GbpZaUuhbToAVRd7FUMTGASAAJrve,2Sdxv9ZtogNcVbJwBPxKmVjwAiKyX5GHEfnRmFcydQ1G,True,62222291,15555572,96540,48270,48270,3zqXX6kzhkbW3d4TwD2CNjMRwxTbREXySekvq37kfCNk,3861628,58199344,-54337716,620
2022-01-24 00:08:28-05:00,9410,CEtpqFD4BbeiNfaXyLLYEapY2mWgE26H5q6H34tWwRuD,BVqRyqwGFPzSkk1H2finiyfaL3LScbEiQGk3mihirxqs,True,393731,98432,606,303,303,HfEnetJ7uBSmZWCjBNxdvv9HEC5nsW4wDV7wu6WnhWan,24277,405403,-381126,616
2022-01-24 00:08:28-05:00,9411,2AAWghW6BUAFBtF3R6hB9uoqMc5oUDkU8FTd2JrXKema,798cfEUZ2YhXwNTNjXMS4Z2J8gAHaK4zZwpMkq2HzWWM,True,2878403245,719600811,4488551,2244275,2244276,3zqXX6kzhkbW3d4TwD2CNjMRwxTbREXySekvq37kfCNk,179542041,2011213073,-1831671032,623
2022-01-24 00:08:28-05:00,9412,4eaXYcx5ayhTq9TmmQFgLDjy6p3z93txUN97v8PTSh1J,J3vgUnjDUy5ngrmrs6FwpZTexxJNxXM1UjsHvsgw9g9y,True,534589,133647,819,409,410,3zqXX6kzhkbW3d4TwD2CNjMRwxTbREXySekvq37kfCNk,32771,558833,-526062,613
2022-01-24 00:08:28-05:00,9413,2DHhfXSzcuSwsKfAYLMuWuD17w84mCwNer9fcBNLTpSc,89BVfDycKjdSkQzFVqCXd5c16DntdND7WsqoZtCafYFH,True,25647244,6411811,39796,19898,19898,3zqXX6kzhkbW3d4TwD2CNjMRwxTbREXySekvq37kfCNk,1591840,25996522,-24404682,620
2022-01-24 00:08:28-05:00,9414,HxhVxMpFpKzeuC6Z6CpsuUhPHdHUzvpMNYJ8LpQ3NYCp,8KyiipC39iU15zVErVvj6hdhbv89STsexrB8dVw3RcLs,True,561526,140381,876,438,438,3zqXX6kzhkbW3d4TwD2CNjMRwxTbREXySekvq37kfCNk,35060,586775,-551715,624
2022-01-24 00:08:32-05:00,9415,3R2wxFQwjCqUwwxJmp9tNrT6osYFpB5gczq2QYik6QYm,7At5Ej3ZsynfWr56FYrd4P4Y6UtD8FHA4gCFB8TaAyaG,True,536185,134046,838,419,419,3zqXX6kzhkbW3d4TwD2CNjMRwxTbREXySekvq37kfCNk,33553,559592,-526039,625
2022-01-24 00:09:55-05:00,9416,HZJyrD4eqM4nKnyRh2JAs1sC2TaJxFhNPixBdK7PLMuS,Hycz71z4tEsKUogJnefT2GN3MPCLdTJdv9B6T82Ngw2u,True,2306252,576563,3593,1796,1797,3zqXX6kzhkbW3d4TwD2CNjMRwxTbREXySekvq37kfCNk,143736,2425326,-2281590,623
2022-01-24 00:09:56-05:00,9417,68F35fonSGS1P6LMYmAmeoM8kC6Z78NabMqYLeCZr9GJ,8apmWSZdS8s1ScoNVj4AvSJsbQCj1drU3HL74khuANT2,True,569854,142463,889,444,445,HfEnetJ7uBSmZWCjBNxdvv9HEC5nsW4wDV7wu6WnhWan,35570,594218,-558648,624
2022-01-22 10:17:36-05:00,8394,7tDiadLeMrob7yD6R5SDskYn41tnQZVPjEc6W2vv6irK,AHZidccE9ERBcipuRQ2iGM9kHRpTnty7UNuYTFurvXB7,True,44094708,11023677,68399,34199,34200,4BnQKPLuE3DMTtxp8MjUBytgnhvxqq3ZTqZHTVZo4JJh,2735970,18723233,-15987263,620
2022-01-22 10:17:36-05:00,8395,GHn96Ev7UmKJWqch3H3wzXpRT7qLg5FBuSBJAATVED1f,BXBSUddfz9MThXqk4517M7YVRDGdTm4pC6G4ipT69TMV,True,7518829,1879707,11645,5822,5823,HfEnetJ7uBSmZWCjBNxdvv9HEC5nsW4wDV7wu6WnhWan,465818,3018848,-2553030,619
2022-01-22 10:17:37-05:00,8396,2niazdR63iWLyZ3ABWZVAnJiEjVyDyLGo4jZ6wh3j2Zz,4RvU5UtyE5CqMStPciiCTdhYCdaUUfdKSYS5nkATs1qn,True,9432563,2358140,14587,7293,7294,3zqXX6kzhkbW3d4TwD2CNjMRwxTbREXySekvq37kfCNk,583484,3804024,-3220540,618
2022-01-22 10:17:37-05:00,8397,6uZobpBuFcQeYgZ4dApFi6iy4DB9GLHP1AAsQcCj6212,SGGFiPjjhscwroiWMqY4jTAHFw8eakpsEv35wNoHUPY,True,12941652,3235412,20219,10109,10110,4BnQKPLuE3DMTtxp8MjUBytgnhvxqq3ZTqZHTVZo4JJh,808775,4587378,-3778603,624
2022-01-22 10:17:38-05:00,8398,6k9unyyhVTrGhAhBrFjgumRfBtKFRBrVaeWtYB56LgEg,3n9VYUH53fxmwFwdYKT9xAZYDzjodhMsJ5iGAoJTqCt4,True,9433417,2358354,14633,7316,7317,3zqXX6kzhkbW3d4TwD2CNjMRwxTbREXySekvq37kfCNk,585357,3805043,-3219686,620
2022-01-22 10:18:03-05:00,8399,9XHC2Ycm9f56cDYxRPVKYiYWGKA4y7Utpv3e9gpMsZq3,HpqAdpkzWqoJUNqmHEnn4PZwSB6C6jt8FJZQtZtFqXWA,True,21327018,5331754,33266,16633,16633,HfEnetJ7uBSmZWCjBNxdvv9HEC5nsW4wDV7wu6WnhWan,1330656,17499863,-16169207,623
2022-01-22 10:18:28-05:00,8400,7jvKp6onXyWgwsFrFWj4hYTXJsYYD6ot5mn6rPFuJriy,J7N6HiozevJVTiY9hDEUs2ud5BwT5QSE7wnMBS1w5ie2,True,1054057,263513,1649,824,825,HfEnetJ7uBSmZWCjBNxdvv9HEC5nsW4wDV7wu6WnhWan,65982,917136,-851154,625
2022-01-22 10:18:31-05:00,8401,3EgUBHBeKWegibDcCsTGaGehnwHYvpMbcPaT1UTbwQ49,Hxd4dsnLD8uHnG7KR7GVmKXBcpN1egMUvoTccPvBcaYA,True,79207492,19801873,123689,61844,61845,3zqXX6kzhkbW3d4TwD2CNjMRwxTbREXySekvq37kfCNk,4947571,70299648,-65352077,624
2022-01-22 10:18:31-05:00,8402,Fs8MQLaMyr1Q96HsZivKLY7Kjdeu2ZoB2n3VTZ15KbSn,DREfCs5CTVNUUF8H3hD8CWvtxztiYxoLYh8HUWDecMyZ,True,74849030,18712257,116592,58296,58296,3zqXX6kzhkbW3d4TwD2CNjMRwxTbREXySekvq37kfCNk,4663688,66504981,-61841293,623
2022-01-22 10:18:32-05:00,8403,BZn1DDE568UHeL2Qniv9EDT1yAAWvPJcTtSw4K4GQx44,CCaroU4YwKvYgibMsRPdEBxeDbzcNC4s5ZthxrhywSm5,True,4821103,1205275,7459,3729,3730,3zqXX6kzhkbW3d4TwD2CNjMRwxTbREXySekvq37kfCNk,298386,4108638,-3810252,618
2022-01-22 10:18:33-05:00,8404,57Vsw8jXaaoLriYEkvPAVyq66r4a4zMfLWbDaTBMjFzC,7AVDWUTHa6729UkXgCXASphSmrLvXYGAA9ygTMSqvwvY,True,2366081,591520,3667,1833,1834,HfEnetJ7uBSmZWCjBNxdvv9HEC5nsW4wDV7wu6WnhWan,146702,2107484,-1960782,620
2022-01-22 10:18:33-05:00,8405,52hhBAuVyifMNFKGQmSitc8smiEgscXQMzVuZj55j7E5,6B5DBJx9NLytR3fkrYqe5W5ek4rUWsR4nPsRTvRfRwzC,True,79722837,19930709,124054,62027,62027,3zqXX6kzhkbW3d4TwD2CNjMRwxTbREXySekvq37kfCNk,4962162,70803797,-65841635,622
2022-01-22 10:19:37-05:00,8406,8T4WK27RvWVGqPuNqY6whk1fmU4vd5qaUQPZG1GJ79bh,DvSz7knS8N3K7L6JhQf1s4mJSyxB8uJXNQXtyjJn8QRL,True,3038345,759585,4719,2359,2360,HfEnetJ7uBSmZWCjBNxdvv9HEC5nsW4wDV7wu6WnhWan,188767,2403031,-2214264,621
2022-01-22 10:20:03-05:00,8407,HGAFdundf5voDqeh9g7d6Q9mgMf8eEg898QMRBqwPZ6C,deanBuZXWBHEe2TGfP37S9aMBEnEgmZoyRJjAvruzfA,True,2088292,522072,3248,1624,1624,HfEnetJ7uBSmZWCjBNxdvv9HEC5nsW4wDV7wu6WnhWan,129925,1875051,-1745126,622
2022-01-22 10:20:57-05:00,8408,DWTaeNeq5x83cBvKUz2jZfXDz5z4F5wbSZLNv7smnjvd,9pQGArZnJV4Fu8tBVEfknmmfmrRv5RKV2u58BJBuhzpF,True,3100585,775146,4838,2419,2419,HfEnetJ7uBSmZWCjBNxdvv9HEC5nsW4wDV7wu6WnhWan,193548,2098643,-1905095,624
2022-01-22 10:20:57-05:00,8409,6kqKSyVVF4xxUbsvBCkY1kt4XcKzb98eSaqNw5fxSLtw,4T9DKFUmkcPG7mM3CKzW3m81LqqpU7oFTv35Pha4zHNe,True,55040147,13760036,85629,42814,42815,HfEnetJ7uBSmZWCjBNxdvv9HEC5nsW4wDV7wu6WnhWan,3425184,38352011,-34926827,622
2022-01-22 10:23:13-05:00,8410,3c4tj9J8QwB3exFchWei43nBh5xsYRZxEUfayi3JvYgm,Fyw1TEEDKhLFo16qxDsttsAwSkrfzpDe8Dmm3atEeXyN,True,2936153,734038,4585,2292,2293,3zqXX6kzhkbW3d4TwD2CNjMRwxTbREXySekvq37kfCNk,183435,2502478,-2319043,624
2022-01-22 10:24:00-05:00,8411,64Diz8zzEv1jDWnBQPTHPpXwaWf7vjM19RyJmkPy1viQ,G8wkGHRHMtT3mvXBkH3zgsKNs8wbpdiPUS17y4cozhkZ,True,489008965,122252240,765177,382588,382589,3zqXX6kzhkbW3d4TwD2CNjMRwxTbREXySekvq37kfCNk,30607090,143699869,-113092779,625
2022-01-22 10:25:34-05:00,8412,DC4UVUDFWL3gVtgkX9hPtFgtxaA8DH5p94i4k9U3wyWv,3HCWqVvQQfRgSKitsTjGTduJ82ointZUSNtj13uea4kD,True,12767011,3191752,19884,9942,9942,4BnQKPLuE3DMTtxp8MjUBytgnhvxqq3ZTqZHTVZo4JJh,795394,10518837,-9723443,623
2022-01-22 10:26:55-05:00,8413,HmspGdpobjC5Vbmo3FcKdw4RLPN7wJKxv3uKqDjVhLee,3YEX8TzdyJyuHo76Kw76imVCJjzrC9m188YuRKvwwSwD,True,35725269,8931317,55621,27810,27811,HfEnetJ7uBSmZWCjBNxdvv9HEC5nsW4wDV7wu6WnhWan,2224854,13415131,-11190277,622
2022-01-22 10:27:15-05:00,8414,2sPD4f4d3CCeFSwSC5vAGS3YoTsTGypYKfDeoJczebop,HWCRpcq2sXqJL7Vi8MtipQDwGSViE73bUxS36ETmvnP2,True,1307398,326849,2038,1019,1019,HfEnetJ7uBSmZWCjBNxdvv9HEC5nsW4wDV7wu6WnhWan,81530,719900,-638370,623
2022-01-22 10:28:07-05:00,8415,GKKRAsYGdcf47eFThG4KwhNv7egeHRuc2wmTh4kqpego,4ippJxgnqCtdtGzCkdZoYwv68fiXNSqQcgrnaHdXZDUa,True,47626001,11906499,74265,37132,37133,HfEnetJ7uBSmZWCjBNxdvv9HEC5nsW4wDV7wu6WnhWan,2970615,30810922,-27840307,623
2022-01-22 10:28:08-05:00,8416,Cv5oVktxmqbU1SxraxH67NEWMKnjgA18R832Fhe9h74a,Cs7xBD4BDiohyopnaYDDChUtR9vmx7uwot6Qp9beQLzt,True,29547174,7386792,46076,23038,23038,3zqXX6kzhkbW3d4TwD2CNjMRwxTbREXySekvq37kfCNk,1843040,11007794,-9164754,623
2022-01-22 10:28:23-05:00,8417,BJUNK2orMVx6mYsD9pnQzmsEh95ZF2NWPm9KJ1ZM67Qn,FpxLa3DwWrspYvHVsScSDcscHB2eBHGxRrQ4gVvn4VW,True,1711482213,427870553,2676280,1338140,1338140,4BnQKPLuE3DMTtxp8MjUBytgnhvxqq3ZTqZHTVZo4JJh,107051224,454883544,-347832320,625
2022-01-22 10:28:25-05:00,8418,GufVttJatW8NLeztT1NRQSLZpQNRk45kaG41p3QcWhx7,GTJUsWoWRyeafYJVhx2aRo8NE94U5UrBjaehmJ4PRUhn,True,930044,232511,1454,727,727,4BnQKPLuE3DMTtxp8MjUBytgnhvxqq3ZTqZHTVZo4JJh,58191,553279,-495088,625
2022-01-22 10:28:35-05:00,8419,BJaaH1SK1pF2kZQzmYpLFfDtm52CR9a5rd39RAPtLe8q,HUsT5FVxaisdnCvG1BQxX6zffjfL2Rwx5mMo5y8SDV7e,True,1294757,323688,2024,1012,1012,4BnQKPLuE3DMTtxp8MjUBytgnhvxqq3ZTqZHTVZo4JJh,80968,757918,-676950,625
2022-01-22 10:28:37-05:00,8420,3Xbsek5MsEGoWr3G9yhuohREr26B2vSQcjqXdspTFHta,2rPxkUiMo9wGDq8EvAiwY3ngRpKmL223cBWWNTYoBmFp,True,3512481,878120,5495,2747,2748,4BnQKPLuE3DMTtxp8MjUBytgnhvxqq3ZTqZHTVZo4JJh,219827,1937108,-1717281,625
2022-01-22 10:29:15-05:00,8421,8swGZMrPrLAxZd7MxTbkCL13k3DmAJUw41jCp6Xo6awW,3fKnX7yTNXAT4uMmXVdTy47ALJT8h8YSD3WiBb4BGuzH,True,7693320,1923330,11888,5944,5944,3zqXX6kzhkbW3d4TwD2CNjMRwxTbREXySekvq37kfCNk,475538,5876675,-5401137,618
2022-01-22 10:29:23-05:00,8422,4rwzdgkP7REWtQxRf9ftWKYXs1QoZQQBo6YQvNJYjZBY,4EmBTVv6MbdPC6WqTNrSABrP9aTZPrDSPxy9a2KbVgqu,True,3619804973,904951243,5641520,2820760,2820760,HfEnetJ7uBSmZWCjBNxdvv9HEC5nsW4wDV7wu6WnhWan,225660832,1449466242,-1223805410,623
2022-01-22 10:29:26-05:00,8423,5inuJkWfHc2MtCqy2toH5VR4VzT43A7t2wTagA2ft91B,6kXdkHMTcY1PodfiSdMGX7X4KqvcTJWMf5amCskLPCXy,True,12890511,3222627,19861,9930,9931,3zqXX6kzhkbW3d4TwD2CNjMRwxTbREXySekvq37kfCNk,794462,7959151,-7164689,616
2022-01-22 10:29:26-05:00,8424,DDuXUcRDez68Tx651sVKxjubhTdNHkuarbeDEKFp5HRs,DNWcrd23zaT7LuXHuhPVqqAvLVpEzoqebr4sho45CphT,True,1115555,278888,1723,861,862,3zqXX6kzhkbW3d4TwD2CNjMRwxTbREXySekvq37kfCNk,68931,464972,-396041,617
2022-01-22 10:29:28-05:00,8425,DkvR2xUPMyXWGGkUSmDSfhp7RtvMkfbT1ThKCS3TwrXd,F7jYV6TtT1LZ5XCNn1zkbUfNMo4gGcQUczAQy1jLHpaW,True,20155967,5038991,31069,15534,15535,3zqXX6kzhkbW3d4TwD2CNjMRwxTbREXySekvq37kfCNk,1242796,15180630,-13937834,616
2022-01-22 10:29:28-05:00,8426,DY6k3Dkwe18iLneaT8Xo3VpJWB6V4jWwQQjoDvEzdg2j,3GGV7S9FpRQGbARBXkvGFVqLrmw8JvYAcpnR1aKVUY2f,True,409759,102439,632,316,316,3zqXX6kzhkbW3d4TwD2CNjMRwxTbREXySekvq37kfCNk,25298,383872,-358574,617
2022-01-22 10:29:35-05:00,8427,46TNhGwBVzedW8xSb9UY94HNeSom9iGiZzAjrKHiRM2G,7JVTiqNYeKHbyzRkKtvSEpqLPKykZso8cGUr3sX1j7QF,True,3496602,874150,5259,2629,2630,3zqXX6kzhkbW3d4TwD2CNjMRwxTbREXySekvq37kfCNk,210374,2206243,-1995869,601
2022-01-22 10:30:36-05:00,8428,J3ggP7ZxL8HRh3CBp5iYG2WgjLyNSAWYT46uC9VYDLCz,2FqTRiRPiLvdAH2BS5vroVntpsSXvTJEn5UHWmtKHzh9,True,973012,243253,1512,756,756,3zqXX6kzhkbW3d4TwD2CNjMRwxTbREXySekvq37kfCNk,60512,603992,-543480,621
2022-01-22 10:30:37-05:00,8429,9WJBnVi84E926j7xEd566WzrZJkPJWRgmEnYj9vyjuad,4dLaFS5F7TGyLdwuJLMGkz3bSL53aHzd9ZfpNmhHxXeF,True,508385,127096,794,397,397,HfEnetJ7uBSmZWCjBNxdvv9HEC5nsW4wDV7wu6WnhWan,31764,435382,-403618,624
2022-01-22 10:30:39-05:00,8430,CxLFMBDFkoMvpK9YUf7WtCq6hn7k3QACAuetAnGjU6KA,2gE52a1GWQnS6ifV6eVtKQyr13LXP5Jdt3yG9SjGPJPF,True,40214925,10053731,62912,31456,31456,3zqXX6kzhkbW3d4TwD2CNjMRwxTbREXySekvq37kfCNk,2516487,18617054,-16100567,625
2022-01-22 10:30:44-05:00,8431,JDg1bbHkYeznDUtSBLhagRJ45aSzeSF5V8iDRJCay9wL,8n7ic28zq5PjJtRcM7Fcy5vLW2YVXw4EWMK6UAt2zh3V,True,53908681,13477170,84126,42063,42063,3zqXX6kzhkbW3d4TwD2CNjMRwxTbREXySekvq37kfCNk,3365079,46196799,-42831720,624
2022-01-22 10:30:44-05:00,8432,75NA5QiXEHG4caSB9BpafGZPA9eT9S6MhKTFM6eHjz8H,FmoxAVw2zdG6qbyaXKy6gsvi1XY8ZVbSgUNbjsp9EpVd,True,4933128,1233282,7694,3847,3847,3zqXX6kzhkbW3d4TwD2CNjMRwxTbREXySekvq37kfCNk,307771,4037676,-3729905,623
2022-01-22 10:30:49-05:00,8433,2SNV9Q6vzQP5XxxqSrwXpQdRvk45FPiqLXmhNZzbLt1k,6dLG3ojK5Unm1mBh9aDZfryvoT2a6cSuWA8CxXy3oi7n,True,45863450,11465860,71103,35551,35552,4BnQKPLuE3DMTtxp8MjUBytgnhvxqq3ZTqZHTVZo4JJh,2844122,32065982,-29221860,620
2022-01-22 10:30:49-05:00,8434,woTXSsDkL9TQNxc3zwxSPagVijX7PE24bgKjvxexRwQ,A5M5EEPfDgvAxGLhpNgfn8AzPmyXxmPVgkEKnyoVzsz6,True,134346,33586,209,104,105,4BnQKPLuE3DMTtxp8MjUBytgnhvxqq3ZTqZHTVZo4JJh,8392,143693,-135301,624
2022-01-22 10:32:01-05:00,8435,HELPNUwAqTX7gfHS4cnJnqXFM6Rb156tYcpsitKR9iDu,3RdfgDvLvsdZG5Cf6hKiKMQMqfidyxHzjYvUx1FZpeHQ,True,3209258,802314,5010,2505,2505,4BnQKPLuE3DMTtxp8MjUBytgnhvxqq3ZTqZHTVZo4JJh,200439,3671780,-3471341,624
2022-01-22 10:32:36-05:00,8436,7EtGovzHsbD8cKGqq4R5rvKBbncR4Kc7CDkTjof2QBMf,8ShjeNWM2vcvUF9yYztYCHUQfcGsyg2A1LyWiPbQDDvq,True,461578,115394,722,361,361,HfEnetJ7uBSmZWCjBNxdvv9HEC5nsW4wDV7wu6WnhWan,28894,410983,-382089,625
2022-01-22 10:32:38-05:00,8437,HfwGSiwGiyDFaTS2usYRp82zSmPPQqZukbw2d1BuFs5w,ArtgZbmA33k8Y3EfR6oMJiqT72MUrVBQqifPBdcnrzea,True,1429097,357274,2233,1116,1117,HfEnetJ7uBSmZWCjBNxdvv9HEC5nsW4wDV7wu6WnhWan,89328,726032,-636704,625
2022-01-22 10:32:41-05:00,8438,7A1v7bFDJwxM7XomePFyRh58SMHxrNSkM3fJygd8pQUN,DL9jCFHaM8BXJ5KE1YJHXNCbXgSdRgt18MHhAgC6TNmg,True,5771816,1442954,8975,4487,4488,HfEnetJ7uBSmZWCjBNxdvv9HEC5nsW4wDV7wu6WnhWan,359025,4725490,-4366465,622
2022-01-22 10:32:51-05:00,8439,FwTGq3BeMLyRFRa5r4E6nySLgoLNcNdqJsCQxA2i6uh6,88w6ti3WSriyu2FvNjVfrLpGyU5PUvaiJyqrAGPM8TKp,True,2289785,572446,3538,1769,1769,4BnQKPLuE3DMTtxp8MjUBytgnhvxqq3ZTqZHTVZo4JJh,141530,2041644,-1900114,618
2022-01-22 10:32:59-05:00,8440,3PPCwAjj8GNphb3cRs7kP1QVghEUX6gWUH3M4JarQsTD,28UR4WKAziiJmPwas5E5JrY3WaUrR2NkYYXCKuxPHTMR,True,637611588,159402897,983427,491713,491714,3zqXX6kzhkbW3d4TwD2CNjMRwxTbREXySekvq37kfCNk,39337089,526635306,-487298217,616
2022-01-22 10:32:59-05:00,8441,4oop1mjCh1Ao9NoWAUacAGc75GxiRTXr8KJ3NtzZ7btf,BfntjUunXBhnrKmocQ7pZr3wwxruRGudMyWQYC2MUhei,True,7456809,1864202,11589,5794,5795,4BnQKPLuE3DMTtxp8MjUBytgnhvxqq3ZTqZHTVZo4JJh,463566,6505403,-6041837,621
2022-01-22 10:32:59-05:00,8442,EBpxGcrs4eWAbBU5rEjFxbr24MjUstZQRMV9jK4q8kMp,EYVd6pztEuz8PC7rUnJ1AjVZ81WWpynyn2qEKtveqrHG,True,3160994,790248,4927,2463,2464,4BnQKPLuE3DMTtxp8MjUBytgnhvxqq3ZTqZHTVZo4JJh,197111,2809477,-2612366,623
2022-01-22 10:33:00-05:00,8443,6fqbSyhh3PPdgRcLraHb7Jahj9s1oHHeX3SsjNSsGa6t,GpRUow48TYgttdYfsygbgjYQcmHyYjWETUDjDVphEgwq,True,4235195624,1058798905,6567121,3283560,3283561,3zqXX6kzhkbW3d4TwD2CNjMRwxTbREXySekvq37kfCNk,262684846,1941074368,-1678389522,620
2022-01-22 10:33:00-05:00,8444,FdYFnEYtFQKcZPmzUqnvNLzozxdR1emtkmvnYcMgYykS,7arWNJQf2cWxerjhLgQh9CJxwTat1efnr5KmhuD7Qnv4,True,1407535,351883,2201,1100,1101,3zqXX6kzhkbW3d4TwD2CNjMRwxTbREXySekvq37kfCNk,88071,1293390,-1205319,625
2022-01-22 10:33:09-05:00,8445,3sGCWcgPY7TzRCkFR1uuY8KcUzVRbdTyFYxh7V1csNMX,CcRFNnG2uhyLwhNAbX4U49jkMeC11kJtVhhyqDWdDK5r,True,51490724,12872681,80567,40283,40284,3zqXX6kzhkbW3d4TwD2CNjMRwxTbREXySekvq37kfCNk,3222709,46222725,-43000016,625
2022-01-22 10:33:16-05:00,8446,CyWBZ1xJ9LahUnPesbXLZ4Rr5UyWAHgVFYwfrnhyrkNL,2Lpk87Xth8ZL5J9BfzmMpEE3x76FDrrrmdKiCNkSVip2,True,3314526,828631,5183,2591,2592,3zqXX6kzhkbW3d4TwD2CNjMRwxTbREXySekvq37kfCNk,207338,2441777,-2234439,625
2022-01-22 10:33:19-05:00,8447,A4Q7Vrc9M3GtEXNUSiVBFkansyf5sKBtSeVT92WFacqv,EWLNfsTKqzkd7KAhnrPRre4Dyk6exb3H9wSbrJuyWprg,True,46080034,11520008,72036,36018,36018,3zqXX6kzhkbW3d4TwD2CNjMRwxTbREXySekvq37kfCNk,2881459,41336865,-38455406,625
2022-01-22 10:37:52-05:00,8448,FtF3PVw8YNJseWPMcA2GEuQZ6nni1mq5kYPa2LrSzfkW,4yr1TM2dXrBvLNMpSaoryuGU2P8D3WG1ZCkvVzWFiQRH,True,2573895712,643473926,4025811,2012905,2012906,3zqXX6kzhkbW3d4TwD2CNjMRwxTbREXySekvq37kfCNk,161032441,1195779260,-1034746819,625
2022-01-22 10:40:29-05:00,8449,AvwHizRhHUSahmvSg4jmTUErc7vAFSmkRAEsiKhXfW1m,3UrWYx8y9N5o9GYneSe6zyyHRTZzxwvcipQfHHYh7tEs,True,18737,4684,29,14,15,3zqXX6kzhkbW3d4TwD2CNjMRwxTbREXySekvq37kfCNk,1166,15867,-14701,622
2022-01-22 10:41:24-05:00,8450,9Hz4p7gcfDbXBJp8KzhaBBPh9i7xe9kun7zLfDtqPe6c,2bJ43Lep6kp6WY7Ct56oiscKnAbdtC265G5yRvRPFThU,True,6612946,1653236,10347,5173,5174,HfEnetJ7uBSmZWCjBNxdvv9HEC5nsW4wDV7wu6WnhWan,413893,3878830,-3464937,625
2022-01-22 10:41:24-05:00,8451,ymyzGH4Qc7HH5PbKpVphCbsQgLLXyGkPcXamQJuNj5C,8oTLHaV2XzbKXNWRuUjCfHjUn61Pw93LYK14m9q2VDpZ,True,95754,23938,149,74,75,4BnQKPLuE3DMTtxp8MjUBytgnhvxqq3ZTqZHTVZo4JJh,5991,80799,-74808,625
2022-01-22 10:42:13-05:00,8452,2ZSfbqxhiCTDrDPeRhoWayTZHNmW7ajVXBCxpFS4eGBF,3ZmWsPdQD7qfSMGKQSNhmBtuH7S6qMFRc8oEmBcHXEiR,True,1807997,451999,2829,1414,1415,3zqXX6kzhkbW3d4TwD2CNjMRwxTbREXySekvq37kfCNk,113166,1661240,-1548074,625
2022-01-22 10:42:15-05:00,8453,5y8ZSWUnrm4B3emh7vLQKTh89vHtCvXqUhk7fJBA52is,Bu1AoKU2QQWpGH54ZzugvvACB3E1d3VvymnegNmTgHqg,True,50656849,12664212,79269,39634,39635,3zqXX6kzhkbW3d4TwD2CNjMRwxTbREXySekvq37kfCNk,3170797,45317348,-42146551,625
2022-01-22 10:44:02-05:00,8454,BrHRMouGRz3LBNzd9anfdYMhWfg8yUPHL4PqJ8WdEDFS,4uzoLa3mC2VYHAPBoHLX4gTjPTC28rPf2fvEGtJWPYc,True,423323,105830,656,328,328,3zqXX6kzhkbW3d4TwD2CNjMRwxTbREXySekvq37kfCNk,26254,599634,-573380,620
2022-01-22 10:44:02-05:00,8455,As81koHnSP9quoXuUVNHp3VR3Qaks8HLa4sFgJDocYiF,AMVm8dXia5s974VgZSbeE6uPDgyXDHZFyJ2W1J1CWvKW,True,50611794,12652948,78489,39244,39245,3zqXX6kzhkbW3d4TwD2CNjMRwxTbREXySekvq37kfCNk,3139560,45331167,-42191607,620
2022-01-22 10:44:02-05:00,8456,BLJgLzizx2yLgd12pVBAHTMqn9J5JA3JHCF8PnLnPyUk,HhDmwMysBFWhXnd3mrV31w75WBRKBS8wJSiEMZgqdUSp,True,7110419,1777604,11097,5548,5549,3zqXX6kzhkbW3d4TwD2CNjMRwxTbREXySekvq37kfCNk,443918,6696185,-6252267,624
2022-01-22 10:44:02-05:00,8457,CJpe9bNHxS63QMaGJhmnr4u7eTo6e5GApZQZyPtXLAkk,EMVL4sDfVXwGEoGEYwLp8D6itfy3eu4FZBAj1kMz6uXa,True,48292855,12073213,74974,37487,37487,4BnQKPLuE3DMTtxp8MjUBytgnhvxqq3ZTqZHTVZo4JJh,2998999,43291197,-40292198,621
2022-01-22 10:44:02-05:00,8458,FYdUiU3rPpbYKWnEpekQQsocSJKjXmscohi4v6DYqix7,daPyq9YdunQJhhLoW5ifhJ7UFPTtRZhGs4JwE1nqZhN,True,1818514,454628,2825,1412,1413,3zqXX6kzhkbW3d4TwD2CNjMRwxTbREXySekvq37kfCNk,113002,1672084,-1559082,621
2022-01-22 10:44:02-05:00,8459,AvpYg74EBhwAXE8rcdGkpwmbBMRyVidF6zMRSFtWAVC6,4WgpqTp4r9wMpMptYMNbvCaP2faBnVr6FdShCAobetpL,True,1792607,448151,2793,1396,1397,4BnQKPLuE3DMTtxp8MjUBytgnhvxqq3ZTqZHTVZo4JJh,111730,1648428,-1536698,623
2022-01-22 10:44:05-05:00,8460,U3vvMQ4X4aKzVYfhMw1V1p58HRqaLnuXozqmmefYeD9,7JA94MArkNCFRhBq8f5a32DgMF6aPdFsoC5HvXDQ6NuR,True,2183251,545812,3380,1690,1690,4BnQKPLuE3DMTtxp8MjUBytgnhvxqq3ZTqZHTVZo4JJh,135238,2254098,-2118860,619
2022-01-22 10:44:07-05:00,8461,7EvJoetxJVTgpJXqE1VC3fZN1CQ5xdWdv29yCiDuH9gU,6RTEusjGEHNDdMj75qkpzYHjHZ3R2XN5xvptCwkRJz5j,True,2024716,506179,3168,1584,1584,3zqXX6kzhkbW3d4TwD2CNjMRwxTbREXySekvq37kfCNk,126720,1862909,-1736189,625
2022-01-22 10:44:07-05:00,8462,4SX2pj4eHRwFMtyDCrMZ8ZT6ASAMi7yfZWZnccw5dGn8,Ads49ZqvTmPHxfzNYm4oJb4HBYhwS6vXQbarqmpUi5VZ,True,1472201,368050,2300,1150,1150,HfEnetJ7uBSmZWCjBNxdvv9HEC5nsW4wDV7wu6WnhWan,92032,1354414,-1262382,625
2022-01-22 10:44:07-05:00,8463,FV9CBGGTbppLnBKh79f2LzD1diTiS5g6u89FcpZHZmnK,Fe7mtmCUziFqbbYTvrhAcAq1Ub7YLfTJRtQ1hG7GzJD1,True,37829,9457,58,29,29,4BnQKPLuE3DMTtxp8MjUBytgnhvxqq3ZTqZHTVZo4JJh,2352,32278,-29926,621
2022-01-22 10:44:08-05:00,8464,Aop82qT6CwZbomif4QowqP3VaSHKB1837B2yNKqw4tER,65BVa4jrCx9etU5eXBAXT2PVnwVot2HLWGYyNXbVJDFk,True,24839611,6209902,38574,19287,19287,3zqXX6kzhkbW3d4TwD2CNjMRwxTbREXySekvq37kfCNk,1542969,22261326,-20718357,621
2022-01-22 10:44:11-05:00,8465,2FEbsetZMkRqLjSC8GBbgecKgX5T1T1fci2sLQux29p8,H722Fcd6DkTFRZxqQWbPDufBfXEgmFfhiEpQZWhxwYv1,True,33586,8396,52,26,26,4BnQKPLuE3DMTtxp8MjUBytgnhvxqq3ZTqZHTVZo4JJh,2102,28715,-26613,625
2022-01-22 10:44:13-05:00,8466,5V5gFVMYSwGYfHFecRoHg8G22Rg4bXfVK2FSRTMhPQty,73raXd5MvixmDvJRnVjRL7yQaHZGFRiC9aBxL9ysiRvy,True,199806907,49951726,310532,155266,155266,3zqXX6kzhkbW3d4TwD2CNjMRwxTbREXySekvq37kfCNk,12421318,89125930,-76704612,621
2022-01-22 10:47:01-05:00,8467,9kYkFDNE3qD6s73fn8kJowgqbDZoDSw22XaUJ7rTD43D,E8zJz8pT2c9aZsxe4kLMNs4bY7skt38SU5wK5JTqbGr6,True,27705497,6926374,42928,21464,21464,4BnQKPLuE3DMTtxp8MjUBytgnhvxqq3ZTqZHTVZo4JJh,1717133,25518718,-23801585,619
2022-01-22 10:47:02-05:00,8468,3tQBuHwr3V8AZu8Yqhg1UfmnFoxzkUq9UeGeLm41UHy4,9cESwduiHBgrxZK1hN1eAFwnyfxw3FEHezTa8Ue5Kpye,True,145182224,36295556,223427,111713,111714,3zqXX6kzhkbW3d4TwD2CNjMRwxTbREXySekvq37kfCNk,8937117,85155891,-76218774,615
2022-01-22 10:47:03-05:00,8469,HGJoZvLakWfSDFwuvShNBc4kCf7nP7VqzyM3mELpbFEf,12Qn5jin7QvsBngXqYAv4UstyG3b6nRf1jsLp9Dp8G7k,True,112586,28146,173,86,87,3zqXX6kzhkbW3d4TwD2CNjMRwxTbREXySekvq37kfCNk,6923,105977,-99054,614
2022-01-22 10:47:03-05:00,8470,8cRrU1NzNpjL3k2BwjW3VixAcX6VFc29KHr4KZg8cs2Y,6KhaewfwKyT5fkQvfiDqKzGWEPbuP9H5NfxEUXVx14U4,True,168453764,42113441,258585,129292,129293,3zqXX6kzhkbW3d4TwD2CNjMRwxTbREXySekvq37kfCNk,10343424,36189660,-25846236,614
2022-01-22 10:47:04-05:00,8471,9BMHbUs4d3qX49fnroHv2FTPDs4yoDFrvDMqf8p9U4pE,2yL7zwMr7qVG5Sdwkf7z6ppnNqt1ASppBbmxwYjfFY6Z,True,28039856,7009964,43113,21556,21557,3zqXX6kzhkbW3d4TwD2CNjMRwxTbREXySekvq37kfCNk,1724552,25840722,-24116170,615
2022-01-22 10:47:05-05:00,8472,6Z6y2QLJUZ5s6zdjanJcKprTAotx8tqr9DRNqqycMeS4,JCYwt8MHVaBb14GB2qAvDWwYVMaL7VTxyNEt7Eo5Zy8x,True,1479438,369859,2278,1139,1139,3zqXX6kzhkbW3d4TwD2CNjMRwxTbREXySekvq37kfCNk,91122,1359484,-1268362,615
2022-01-22 10:47:05-05:00,8473,FF8rqfM9PTEjYiVFy8jS81weDRwdaYooux2uSa2LexrJ,JBk1JghH1gged1YpDbkczFXP9ka5ivYSkaYoVbbXD4kg,True,1302397,325599,1998,999,999,3zqXX6kzhkbW3d4TwD2CNjMRwxTbREXySekvq37kfCNk,79945,1282964,-1203019,613
2022-01-22 10:47:05-05:00,8474,BJV5jbowrbELXfDvfMovaQy4PiRf12pLYHimW9bgzW5X,6WXrWso5FvLx7RMCFBzrbzh5qevKkk2LJAihUfWXxXzB,True,150279,37569,231,115,116,3zqXX6kzhkbW3d4TwD2CNjMRwxTbREXySekvq37kfCNk,9255,214742,-205487,615
2022-01-22 10:47:05-05:00,8475,Fw2e6jxKVeFcJSe9MyVhSz3dUdJQLs3XULHrT1mtMU9U,591U5bexgLRJXygtK5fpCRXcZEq89KgewFTdfPkti8bY,True,213730979,53432744,334262,167131,167131,4BnQKPLuE3DMTtxp8MjUBytgnhvxqq3ZTqZHTVZo4JJh,13370511,174182378,-160811867,625
2022-01-22 10:47:05-05:00,8476,B4Uc39nKzz9wBRQsCkMR4A7RwTJ8rSuwpR6EQn2AesRb,H49bGZgatRZVpj6QufZRVgYrQtH7LpdbiqKBs23151m,True,179663,44915,279,139,140,3zqXX6kzhkbW3d4TwD2CNjMRwxTbREXySekvq37kfCNk,11169,276008,-264839,621
2022-01-22 10:47:05-05:00,8477,6sK2PQyTvStxT9qigrFaPmf9GSe4X4wLb4ig7izrzwaB,6iyTuXdnBiLrKPCat7ajRnUq2245L9bbJrHAvsnyFx8e,True,12308,3077,18,9,9,3zqXX6kzhkbW3d4TwD2CNjMRwxTbREXySekvq37kfCNk,759,11074,-10315,616
2022-01-22 10:47:05-05:00,8478,BYvjENe16Ta77PqGV7JKEWrsqCTfkMGYwTSG5gXneDvd,EvxAXgvhPC6QkNurbK7vWyTApGo8J2R4EgMAknkHVU3d,True,21465,5366,33,16,17,3zqXX6kzhkbW3d4TwD2CNjMRwxTbREXySekvq37kfCNk,1324,25014,-23690,616
2022-01-22 10:47:05-05:00,8479,DMgD2KCEhTGFLUZ5GnfNcwfiiwKYbyVpoWiN6knMkCAf,5KU2vgBkPTNVHsSULjgX7ZkZS56U3Dy3xqLTxL5sUZJ3,True,9901880,2475470,15236,7618,7618,3zqXX6kzhkbW3d4TwD2CNjMRwxTbREXySekvq37kfCNk,609469,11351174,-10741705,615
2022-01-22 10:47:07-05:00,8480,GwYr2DmtMVLWxVz6kVSXR6rvxL4x3DXtvNC7taswSWHN,2otMHa7JT1twPSSN6XF9fqGkKrEK8nnuMFZG1TtAgFQk,True,12312,3078,19,9,10,3zqXX6kzhkbW3d4TwD2CNjMRwxTbREXySekvq37kfCNk,763,11074,-10311,619
2022-01-22 10:47:09-05:00,8481,3NhNdphQiKwgHTmTJc4qVhp3aWjqnwMTYbRW1y9CZrZg,BNpP1sKPAr7Dk1ymSrupge9KGMVpk4LfjTjawgi9YaC5,True,10570506,2642626,16239,8119,8120,3zqXX6kzhkbW3d4TwD2CNjMRwxTbREXySekvq37kfCNk,649563,9483362,-8833799,614
2022-01-22 10:47:10-05:00,8482,EBnMKbaJEjNXjt14hxssR8wd3Ua37McPQxUZnKxxbgtd,FAALK2LRFhg98ezHEBFrgrzxTg66eZpmo7ctKDEck8q5,True,3172158,793039,4874,2437,2437,3zqXX6kzhkbW3d4TwD2CNjMRwxTbREXySekvq37kfCNk,194975,2647252,-2452277,614
2022-01-22 10:47:11-05:00,8483,96StvqZyFUPtyMr4o9s7K4V29RSNyRpVi76vNwxG5rUf,GZKXFSFq4aGiTaqovtxqNCCVGkAFNXPh4Hep1ZMwdZ8g,True,160219,40054,247,123,124,3zqXX6kzhkbW3d4TwD2CNjMRwxTbREXySekvq37kfCNk,9902,239478,-229576,618
2022-01-22 10:47:11-05:00,8484,73PpLzJmAimmqtjGpRcYHua8t6wx3gYiiXFvQxnSDMJV,CRCpLcS8LNKX22co94spJBXEes9Fnh5rYBvbVEte4JXA,True,211866972,52966743,330024,165012,165012,4BnQKPLuE3DMTtxp8MjUBytgnhvxqq3ZTqZHTVZo4JJh,13200990,172881658,-159680668,623
2022-01-22 10:47:11-05:00,8485,CEtpqFD4BbeiNfaXyLLYEapY2mWgE26H5q6H34tWwRuD,BVqRyqwGFPzSkk1H2finiyfaL3LScbEiQGk3mihirxqs,True,1329483,332370,2071,1035,1036,4BnQKPLuE3DMTtxp8MjUBytgnhvxqq3ZTqZHTVZo4JJh,82865,1202299,-1119434,623
2022-01-22 10:47:13-05:00,8486,8GdYhwX26GRmVfGFCbJ3MJrH1UdneN2FNRUexhLsqprN,DpUTHSVucDPyCWoLCdpm8EFRZFiKL88tmnSiWG2TRpS8,True,1618936,404734,2515,1257,1258,3zqXX6kzhkbW3d4TwD2CNjMRwxTbREXySekvq37kfCNk,100602,1481304,-1380702,621
2022-01-22 10:47:14-05:00,8487,95urWGJ4HN1bTarbDi8Dpj4K4ms7dovs8gwaYdaSLC6e,2THhqxjhXjp2Zui9ML2MzAbGN4dsfa3dkdqzC8LYhnbQ,True,2641585,660396,4125,2062,2063,4BnQKPLuE3DMTtxp8MjUBytgnhvxqq3ZTqZHTVZo4JJh,165014,2349239,-2184225,624
2022-01-22 10:47:15-05:00,8488,E8iuHK2DErFnMAYfWmNoix4jVb4WDG8Sc41hBycLUxbd,77Zoru23JmnK5EJ8eURonQoEpJcLP4edabjD8MR8NKdX,True,27988530,6997132,43729,21864,21865,3zqXX6kzhkbW3d4TwD2CNjMRwxTbREXySekvq37kfCNk,1749160,25782716,-24033556,624
2022-01-22 10:47:16-05:00,8489,9rgrRAMcGSarfz8xXckw1LjkemMwwjzJLApPjpfY2XZ3,BRtNdDDtCiNDYDERZTBCefUiYvjShucRX1hxEBLyeggT,True,1424775,356193,2222,1111,1111,3zqXX6kzhkbW3d4TwD2CNjMRwxTbREXySekvq37kfCNk,88912,1312303,-1223391,624
2022-01-22 10:47:22-05:00,8490,4yhW5mBsFVNgQ5QQc2Yg65guctPsTSXcERbzmYM6rdnL,5uJnMZ6DWA9bMSvHvS5zomwtt1sv7YCWq3GDJh77YC3q,True,1774295,443573,2754,1377,1377,3zqXX6kzhkbW3d4TwD2CNjMRwxTbREXySekvq37kfCNk,110167,1638842,-1528675,620
2022-01-22 10:47:26-05:00,8491,43wwd6zLB8yKfXEu7rtbeDFhKBuxFR66MnyhTKW3zqa3,A9t6AMvVNenwWymz3QMtdUuuGYjjTPLaA9bhRjTzNY9h,True,28107247,7026811,43887,21943,21944,4BnQKPLuE3DMTtxp8MjUBytgnhvxqq3ZTqZHTVZo4JJh,1755500,25904275,-24148775,624
2022-01-22 10:47:26-05:00,8492,4nhdidD6SASYzwZ7mUnWKyP4xyWXhdBe2gp5F4qDtLrL,HLk6YPhVidsn3i8HfoASvoim1ztxb4bi8JnioiyvorpV,True,10131725,2532931,15749,7874,7875,3zqXX6kzhkbW3d4TwD2CNjMRwxTbREXySekvq37kfCNk,629976,9058890,-8428914,621
2022-01-22 10:47:26-05:00,8493,HZSJVNb6g4o52N7pAJCLkGjur8evF5Ex1sAx7uUxUDdm,8LQHKhXStrwcd6f4AxaTVcrGdYpGjQz8vWf5JXsAzcsp,True,2073930,518482,3217,1608,1609,3zqXX6kzhkbW3d4TwD2CNjMRwxTbREXySekvq37kfCNk,128690,1912725,-1784035,620
2022-01-22 10:47:26-05:00,8494,C1tcxAjMzZaFVcF2ke2nSyiCjcLBwsz5yKXShy5MB14h,GYkrJj2zHVZuzPC45MbuevYkRJHdeL4Sqj9SWqZfUdiE,True,94363806,23590951,147246,73623,73623,4BnQKPLuE3DMTtxp8MjUBytgnhvxqq3ZTqZHTVZo4JJh,5889858,83356835,-77466977,624
2022-01-22 10:47:26-05:00,8495,5iRLEmB6qBHqkJBPyyubnd9f1TpRr4EY8BTxuHUREeLB,GkY73KL6HJ4ycdggFtYWALBgmTRZVCx66P2ZJ7E8ENwC,True,1539777,384944,2390,1195,1195,3zqXX6kzhkbW3d4TwD2CNjMRwxTbREXySekvq37kfCNk,95605,1418382,-1322777,620
2022-01-22 10:47:26-05:00,8496,6Bq55LtGCEeGqh4JrFLCmmGc2iJfTTBJixivqH78aGSE,DSNrCgWJeNe2P9tAQu5FvCueTzNKDKds7wzuwTQSMRG,True,47633,11908,74,37,37,3zqXX6kzhkbW3d4TwD2CNjMRwxTbREXySekvq37kfCNk,2963,40444,-37481,622
2022-01-22 10:47:26-05:00,8497,43EtYHdVkdBxHTtFR3QWVgvCKj1SqsAf7xLY2yphsv1x,8WJbP4mVJWYuN1dVzHpRg7YR2nBELB4Krkq8Zch8sp4g,True,2206028,551507,3448,1724,1724,3zqXX6kzhkbW3d4TwD2CNjMRwxTbREXySekvq37kfCNk,137938,1880993,-1743055,625
2022-01-22 10:47:27-05:00,8498,GcjcaWoMUcGkLaJBx3svxtzwGNn5SLcFrwaLqnpadUZY,Ep9sDjTMMasVjKdshsE88uk3mWYkKuMTVRooVJWvCq9F,True,27425187,6856296,42555,21277,21278,3zqXX6kzhkbW3d4TwD2CNjMRwxTbREXySekvq37kfCNk,1702225,25254021,-23551796,620
2022-01-22 10:47:27-05:00,8499,4eaXYcx5ayhTq9TmmQFgLDjy6p3z93txUN97v8PTSh1J,J3vgUnjDUy5ngrmrs6FwpZTexxJNxXM1UjsHvsgw9g9y,True,1804055,451013,2818,1409,1409,3zqXX6kzhkbW3d4TwD2CNjMRwxTbREXySekvq37kfCNk,112749,1660861,-1548112,624
2022-01-22 10:47:27-05:00,8500,DD1a8rMoUCwmEiLKRN43VpdqL8Qgfr5yi92ejQxDVRMo,3vMJVNAuyRhM9jkaEZARhwbR6MerR5UmcgoZ9c5bs1VS,True,33004038,8251009,51538,25769,25769,3zqXX6kzhkbW3d4TwD2CNjMRwxTbREXySekvq37kfCNk,2061528,30417157,-28355629,624
2022-01-22 10:47:27-05:00,8501,EPWsutEpgpcz776maq552k8QhDKdmkSfAED5E3jgpTdY,CCwGZYDvqoHEBBtSSieAJgy5e3k4jYrpjyDffypwnWxu,True,74995053,18748763,116887,58443,58444,HfEnetJ7uBSmZWCjBNxdvv9HEC5nsW4wDV7wu6WnhWan,4675509,66531762,-61856253,623
2022-01-22 10:48:04-05:00,8502,5FgPU7KpsDnx4Xc1UdQoLPR7MDd5cBkJXW2Q8ctopMZR,9GWzAZFVfTY8WjTYvDAE2YcAjgeKiDXgToK76KBZF7Rv,True,2384347,596086,3725,1862,1863,3zqXX6kzhkbW3d4TwD2CNjMRwxTbREXySekvq37kfCNk,149019,2119224,-1970205,624
2022-01-22 10:48:04-05:00,8503,2AAWghW6BUAFBtF3R6hB9uoqMc5oUDkU8FTd2JrXKema,798cfEUZ2YhXwNTNjXMS4Z2J8gAHaK4zZwpMkq2HzWWM,True,9706008192,2426502048,15160707,7580353,7580354,HfEnetJ7uBSmZWCjBNxdvv9HEC5nsW4wDV7wu6WnhWan,606428291,5782529095,-5176100804,624
2022-01-22 10:48:04-05:00,8504,8nXbrdjjaHB73CRPRenGEQj73wbtEFGDwXsehRGMhsap,43pvdcJ6f27wz94D6ZboKwRJYbyvYCrjsJhYsvk7LJCM,True,446935,111733,696,348,348,4BnQKPLuE3DMTtxp8MjUBytgnhvxqq3ZTqZHTVZo4JJh,27857,258598,-230741,623
2022-01-22 10:48:05-05:00,8505,8xjstKJD2RopRxxRP8JbMYRmpBKgSZivMFRXXRZ5syPh,HUfevkvBsm5SDpxnZ4NBD8Re7LvqBQLrx5UWXCeYTBgK,True,2670800,667700,4163,2081,2082,3zqXX6kzhkbW3d4TwD2CNjMRwxTbREXySekvq37kfCNk,166539,2377286,-2210747,623
2022-01-22 10:48:07-05:00,8506,446VESPwhh16pG3VcpgraT83MoqWy87qgU36mKZC8BsW,SmUPkPpnnRfSH3tcKUnbpK6HHNJtLfvMiUWk9eUwkNy,True,74512741,18628185,116086,58043,58043,3zqXX6kzhkbW3d4TwD2CNjMRwxTbREXySekvq37kfCNk,4643465,66154839,-61511374,623
2022-01-22 10:48:07-05:00,8507,28YQqynu5oRud5xEcsDvAaGhJhgpiVJSTNeMwkrbpbyv,9zYqRWiRatbohCdBfV3PrAxp8v1kwgbvV9ta4RJRRp68,True,73459403,18364850,114369,57184,57185,3zqXX6kzhkbW3d4TwD2CNjMRwxTbREXySekvq37kfCNk,4574789,65199007,-60624218,622
2022-01-22 10:48:12-05:00,8508,HpRYrL8HzCPaBJTLFgZmYg2aXBnBQUpf1mikVkzkY56z,8DzHRd8qWcEjnX6cefwYtgRGpQJUaw9QPjyfAsN7j33r,True,18395474,4598868,28702,14351,14351,3zqXX6kzhkbW3d4TwD2CNjMRwxTbREXySekvq37kfCNk,1148097,16499254,-15351157,624
2022-01-22 10:48:12-05:00,8509,6aW9dhnTNerVd1MPv5GrcYqgjVPE9LsNCGYSJSrNdgS8,8kmJu2UxTk2T37sqxDSrf6pDWhJZRxfRdJB7DLeoWddJ,True,59719254,14929813,93209,46604,46605,3zqXX6kzhkbW3d4TwD2CNjMRwxTbREXySekvq37kfCNk,3728385,52077494,-48349109,624
2022-01-22 10:48:12-05:00,8510,2DHhfXSzcuSwsKfAYLMuWuD17w84mCwNer9fcBNLTpSc,89BVfDycKjdSkQzFVqCXd5c16DntdND7WsqoZtCafYFH,True,86517571,21629392,135356,67678,67678,4BnQKPLuE3DMTtxp8MjUBytgnhvxqq3ZTqZHTVZo4JJh,5414255,77085088,-71670833,625
2022-01-22 10:48:50-05:00,8511,4qWzk4JP2gEsTP252Y4SJrjSmfRBxDfE4ZdbPmwavfb2,CAgDhCNVyy61FG2YPMnm9zxgY56s2UqPhvssH5G1LjXP,True,192836495,48209123,301541,150770,150771,4BnQKPLuE3DMTtxp8MjUBytgnhvxqq3ZTqZHTVZo4JJh,12061660,156868965,-144807305,625
2022-01-22 10:49:08-05:00,8512,Hqzz5RdbkkmMPCVdxF3Q3sLuh7XVJHEwAP6zpz7pCwTj,TNwXSETgrJGM9S5zbBY3mMWKbPFskbKjPAhBrWFNfuK,True,1610356,402589,2509,1254,1255,4BnQKPLuE3DMTtxp8MjUBytgnhvxqq3ZTqZHTVZo4JJh,100389,1481930,-1381541,623
2022-01-22 10:49:08-05:00,8513,6kt64nJRnYaWMi9GbpZaUuhbToAVRd7FUMTGASAAJrve,2Sdxv9ZtogNcVbJwBPxKmVjwAiKyX5GHEfnRmFcydQ1G,True,209701074,52425268,324603,162301,162302,4BnQKPLuE3DMTtxp8MjUBytgnhvxqq3ZTqZHTVZo4JJh,12984139,171668065,-158683926,619
2022-01-22 10:49:08-05:00,8514,BMawc4jLJMER4ryGcwdm27H3MU8JQCiSfwb9onVfYDpr,5ciaGDuaB3rBKvV7MphT2eMkCUxBzWZc7zYXQM7vbQ46,True,10590089,2647522,16512,8256,8256,3zqXX6kzhkbW3d4TwD2CNjMRwxTbREXySekvq37kfCNk,660491,9474707,-8814216,623
2022-01-22 10:49:08-05:00,8515,3qnPsgqW11AcDEmyjmJquPcPLyE3EdJQuVLJ5kinDrd3,86rZadBB7emKio76aFTahpbrFtxd9tqZ4Mxgzaavq2xU,True,1096,274,1,0,1,HfEnetJ7uBSmZWCjBNxdvv9HEC5nsW4wDV7wu6WnhWan,68,1010,-942,620
2022-01-22 10:49:08-05:00,8516,DE8c5VWwgCqQnUMSyMZEbKazQAsSjY52L85yojCr57X5,6ycUU1Tc7HG3J8hE6jwkRFCkdbEqyU95ZKY6HbfnYcGo,True,5933,1483,9,4,5,3zqXX6kzhkbW3d4TwD2CNjMRwxTbREXySekvq37kfCNk,368,5346,-4978,620
2022-01-22 10:49:10-05:00,8517,HxhVxMpFpKzeuC6Z6CpsuUhPHdHUzvpMNYJ8LpQ3NYCp,8KyiipC39iU15zVErVvj6hdhbv89STsexrB8dVw3RcLs,True,1892582,473145,2937,1468,1469,3zqXX6kzhkbW3d4TwD2CNjMRwxTbREXySekvq37kfCNk,117484,1743278,-1625794,620
2022-01-22 10:49:27-05:00,8518,9WRDBHzD4aNHw5qvrhc6nqXCBLA5D7YYP8TvSrLksXd6,GwxWNmv9XDkqQsx7DfCMccFjVik8asPnFU9gtnb4UVx,True,1396994,349248,2179,1089,1090,HfEnetJ7uBSmZWCjBNxdvv9HEC5nsW4wDV7wu6WnhWan,87188,1287020,-1199832,624
2022-01-22 10:49:29-05:00,8519,4cNmhgaMic1xBiaDJ6phrQuXmm8WfF1qjyYMqZcKG4c9,43vgfXiLTtcs1bkrcDar2iz9M6RMbGqbA6BMkBHdh7T4,True,1692150,423037,2627,1313,1314,3zqXX6kzhkbW3d4TwD2CNjMRwxTbREXySekvq37kfCNk,105085,1570694,-1465609,621
2022-01-22 10:49:30-05:00,8520,CygwJ5Z1ZP6xfjN1ZGH7yw8b2oYvf6JTpenXx7A5yFdt,59VKgJtBCTb3Pji7BWtqttisBYVVCnWtyEn5Eba5r52Y,True,31370996,7842749,48800,24400,24400,3zqXX6kzhkbW3d4TwD2CNjMRwxTbREXySekvq37kfCNk,1952015,26825399,-24873384,622
2022-01-22 10:49:35-05:00,8521,45AiuRBbmupfwYXqsWwKHtmEWN8XNJDUSHwHL3b6PvHc,CfvwVkxYPP3jqK2dpAvSRFA1513E9ti84mEpYgtkzFUt,True,3069491,767372,4771,2385,2386,3zqXX6kzhkbW3d4TwD2CNjMRwxTbREXySekvq37kfCNk,190852,2724876,-2534024,621
2022-01-22 10:49:35-05:00,8522,EmXaq1sxmAZUiwYW6LXpKtKFZXu5MzQ3sK4MEAojDK1h,HuAsa5G2wJi8Ah9stxEmggwcB5zW1QjBsP3Ndgke7r8X,True,2410408,602602,3736,1868,1868,HfEnetJ7uBSmZWCjBNxdvv9HEC5nsW4wDV7wu6WnhWan,149479,2222313,-2072834,620
2022-01-22 10:49:36-05:00,8523,7afnF1MkAootZGWc7zsMVLpBuve83hGmvAHkfmwgsq5A,HKdJE8bReznq1Qxqd5iZ4nWQGCk62Vo5TpkRD51bpbGp,True,1853865,463466,2892,1446,1446,3zqXX6kzhkbW3d4TwD2CNjMRwxTbREXySekvq37kfCNk,115682,1707614,-1591932,624
2022-01-22 10:50:03-05:00,8524,Dqnxcekm1QfxGQ2FSJ6SjFiwmaQRWEjW9WTJQG4AjEpE,9JiMtjm5AJqngosRg787FiN8NyuBPuAPD2jYpRQkAc1d,True,2341593,585398,3530,1765,1765,3zqXX6kzhkbW3d4TwD2CNjMRwxTbREXySekvq37kfCNk,141216,2166768,-2025552,603
2022-01-22 10:50:03-05:00,8525,2ZX5NexeuZq25mAfBFDrwd44UfKhWgzmSwdhWFmo48c7,CpNnhSqg7EHn9g84gHoo831sVrAe5SkwNaEZAash4CXs,True,12171435,3042858,18499,9249,9250,4BnQKPLuE3DMTtxp8MjUBytgnhvxqq3ZTqZHTVZo4JJh,739973,11347517,-10607544,607
2022-01-22 10:50:03-05:00,8526,D6qMab7uevXTa89ssv4BRyHwrw3FYpNimAmX2VH2uf4B,8ZauZ5dAp7kyawkPdxi4mqfempFHubJebfBenQdDektD,True,983919,245979,1501,750,751,3zqXX6kzhkbW3d4TwD2CNjMRwxTbREXySekvq37kfCNk,60075,948382,-888307,610
2022-01-22 10:50:03-05:00,8527,HZJyrD4eqM4nKnyRh2JAs1sC2TaJxFhNPixBdK7PLMuS,Hycz71z4tEsKUogJnefT2GN3MPCLdTJdv9B6T82Ngw2u,True,7735689,1933922,11438,5719,5719,3zqXX6kzhkbW3d4TwD2CNjMRwxTbREXySekvq37kfCNk,457520,7221666,-6764146,591
2022-01-22 10:50:03-05:00,8528,CcfycMNGUqZLA6EEqtDdftSbQhTL11SYn3LxQqJ23Xgh,Ce7NW9CpB9qGYLf8XUDW49ERutoxtjZSjs54xrzF1fYN,True,2929387,732346,4564,2282,2282,4BnQKPLuE3DMTtxp8MjUBytgnhvxqq3ZTqZHTVZo4JJh,182592,2602776,-2420184,623
2022-01-22 10:50:03-05:00,8529,8VQ21PFXdHBNmiZiF18LyGvsRSpr13vkyktfembNCe3m,5exbVC7vaGFeHEGAx7epYfMaU932QafqzfhFm5FKAq2H,True,1626061,406515,2442,1221,1221,4BnQKPLuE3DMTtxp8MjUBytgnhvxqq3ZTqZHTVZo4JJh,97703,1503820,-1406117,600
2022-01-22 10:50:03-05:00,8530,AiLCB8xw3k5FXdJE1T42PLFhHrz1bLTKpNekR61a915N,HB7CNWxLipWAc6MPGq9wV4TT7AYjiELA5T3onYeVqBbU,True,36143064,9035766,54627,27313,27314,4BnQKPLuE3DMTtxp8MjUBytgnhvxqq3ZTqZHTVZo4JJh,2185116,33746380,-31561264,604
2022-01-22 10:50:03-05:00,8531,3R2wxFQwjCqUwwxJmp9tNrT6osYFpB5gczq2QYik6QYm,7At5Ej3ZsynfWr56FYrd4P4Y6UtD8FHA4gCFB8TaAyaG,True,1797922,449480,2657,1328,1329,3zqXX6kzhkbW3d4TwD2CNjMRwxTbREXySekvq37kfCNk,106300,1665516,-1559216,591
2022-01-22 10:50:03-05:00,8532,6X5por58mMECmNZQEWpo8M8aA1eHJqr5LNeV9vC7GW5e,DPB2C5UB2Ls1kNzbs1GP33junQvhUyFJWP75RoYjqByn,True,95821165,23955291,144924,72462,72462,4BnQKPLuE3DMTtxp8MjUBytgnhvxqq3ZTqZHTVZo4JJh,5796960,143677399,-137880439,604
2022-01-22 10:50:09-05:00,8533,9hB3EPuj4SrSrpAzHvExDb6mzh2vNGGVbj7qqfRjeao4,9725jRXGPRUuo1dijvv8mwzvSu1ed4y5hi9FAQNwb8dG,True,30560622,7640155,46674,23337,23337,4BnQKPLuE3DMTtxp8MjUBytgnhvxqq3ZTqZHTVZo4JJh,1866988,28253904,-26386916,610
2022-01-22 10:50:09-05:00,8534,4pmhvxJcmebxtqN6RwVb9UbEtxpFXpuVN67Q74W6YAg3,B9fk51SEQmLbMDpQJV15f9gyCZhvEBWRXeLMnnmMqvfg,True,4186,1046,6,3,3,4BnQKPLuE3DMTtxp8MjUBytgnhvxqq3ZTqZHTVZo4JJh,262,3780,-3518,625
2022-01-22 10:50:09-05:00,8535,3oCun4gm3k8sXxVxiYM8okGi8iCXH9LvDkHf9PBQWYXR,E1np1dZ7jUm811ddvy1jQerBwGSYb5BbZWnUHeotvrfH,True,5550210,1387552,8528,4264,4264,4BnQKPLuE3DMTtxp8MjUBytgnhvxqq3ZTqZHTVZo4JJh,341126,1977699,-1636573,614
2022-01-22 10:50:09-05:00,8536,6VBYUiLyQXvvsDmq1vh1oJ5VeA89tGgxtkgFfofc372m,35pyoeRA4duKX7njdYny3KffM2xaxuWUZGRUMQJ5iAiu,True,208549521,52137380,323143,161571,161572,4BnQKPLuE3DMTtxp8MjUBytgnhvxqq3ZTqZHTVZo4JJh,12925725,172318704,-159392979,619
2022-01-22 10:50:09-05:00,8537,4HDEN1Thxm9RbdE8pXnLP4QksVdXfp7Fa9nAnMRzr7oR,8gD3DbF6VhPTCgk3A4G7iA4f3DPH598Hj7TRJ2FebMCq,True,2322766,580691,3535,1767,1768,3zqXX6kzhkbW3d4TwD2CNjMRwxTbREXySekvq37kfCNk,141416,2068174,-1926758,608
2022-01-22 10:50:09-05:00,8538,HoJ3Re4BmCYKMJx2RUYtoHfg8ncEy3iFqvWJDGKqfMBV,2qg4FMcurNDVRzXYKwpzEYapxFECnAyU2oGmxQCSf3hf,True,1481282,370320,2267,1133,1134,3zqXX6kzhkbW3d4TwD2CNjMRwxTbREXySekvq37kfCNk,90686,1429315,-1338629,612
2022-01-22 10:50:09-05:00,8539,6kscNwPWgKoW7MHRkB4ajxWF3DXLmXjmx9KjDnzikhfs,D49nf79UmrALDKnAa5kf94nZUffzJW7anLm4hVrFG2b4,True,51605729,12901432,79116,39558,39558,3zqXX6kzhkbW3d4TwD2CNjMRwxTbREXySekvq37kfCNk,3164650,44362328,-41197678,613
2022-01-22 10:50:09-05:00,8540,8XcMucCQpWfNtbdCYnKuabk91NQ9wfYp7byk496CwU9n,DLrApDfWcyMqufEFZm9PvddsMoiediT58X8e8pxpnzrk,True,2948660,737165,4533,2266,2267,3zqXX6kzhkbW3d4TwD2CNjMRwxTbREXySekvq37kfCNk,181343,2624871,-2443528,615
2022-01-22 10:50:09-05:00,8541,EAUFD16wab8qRMJ4H6updHGt4xFqgRCDeRHVCsLCTSTL,8vkfYSyCyBY9g4TZrp52jUcQj6udy9xAaA4fioRE2RXx,True,1077227879,269306969,1621234,810617,810617,4BnQKPLuE3DMTtxp8MjUBytgnhvxqq3ZTqZHTVZo4JJh,64849399,542419184,-477569785,602
2022-01-22 10:50:09-05:00,8542,AzLdwyd8Q4V3iMaSwWgvWwQ9nCs7X7YV2YKpd6CH33nP,BYjeXF5YkcJy3mNMbvfHzXTtyjkc4U53hM5tvfERUH8y,True,1786565,446641,2668,1334,1334,3zqXX6kzhkbW3d4TwD2CNjMRwxTbREXySekvq37kfCNk,106736,1652400,-1545664,597
2022-01-22 10:50:09-05:00,8543,4eba4qAmwfqmihaYvTWFU9hm4VYrKvNhNywHNyimQJNK,G1DyxJcNQD8u4KGfnwxttyrJMfse1FBAsofioEMdTS9U,True,11164880,2791220,17176,8588,8588,4BnQKPLuE3DMTtxp8MjUBytgnhvxqq3ZTqZHTVZo4JJh,687055,10402904,-9715849,615
2022-01-22 10:50:09-05:00,8544,68F35fonSGS1P6LMYmAmeoM8kC6Z78NabMqYLeCZr9GJ,8apmWSZdS8s1ScoNVj4AvSJsbQCj1drU3HL74khuANT2,True,1910127,477531,2809,1404,1405,4BnQKPLuE3DMTtxp8MjUBytgnhvxqq3ZTqZHTVZo4JJh,112394,1768886,-1656492,588
2022-01-22 10:50:09-05:00,8545,AECUZGm5DjFvbLZEUYhepSPg1Wa7hBjxF9e7ZRBzRPhm,Ar7e1iLKAqa54QiQnXifvnETixDZT1T8KL5YWJA8Ykv1,True,2175428,543857,3217,1608,1609,4BnQKPLuE3DMTtxp8MjUBytgnhvxqq3ZTqZHTVZo4JJh,128696,2014459,-1885763,591
2022-01-22 10:50:11-05:00,8546,JCagxpXPs6wVRUWbNBPCZ4uLCkZsachnofN7SZEEwGwB,5uGj1TBCkc7FV4ffdBJg31yLcCxkQLxRExjcinnJUow9,True,1076294108,269073527,1652530,826265,826265,3zqXX6kzhkbW3d4TwD2CNjMRwxTbREXySekvq37kfCNk,66101217,899064052,-832962835,614
2022-01-22 10:50:11-05:00,8547,SCtptafLHdkTiYC3e9sv853xNnusHLpoMPxTc1zUVC8,2HF9ggN6EbkYGz3Ajj7tB8m5YF3Yj77Vy96DMFSz5C7j,True,8343736,2085934,12646,6323,6323,3zqXX6kzhkbW3d4TwD2CNjMRwxTbREXySekvq37kfCNk,505850,7159118,-6653268,606
2022-01-22 10:50:11-05:00,8548,G8nRLTWTT5aD7q7TcSa2mw7p12GUuHDVq5ev4vyXbdKi,3DmQyungZMK4T1a1PgXh5shBskwP69tTLmZPh7HZ76vh,True,2625159,656289,3899,1949,1950,HfEnetJ7uBSmZWCjBNxdvv9HEC5nsW4wDV7wu6WnhWan,155991,2429914,-2273923,594
2022-01-22 10:50:11-05:00,8549,GM22yjVoBCzgBcVTT5EcgRhVWiXVV82kSj1dPCbegKWj,CDDy8JmJMwJyx1YAvEPpj8AYxCpngRovf3wWfVzao5Rc,True,1062272,265568,1619,809,810,HfEnetJ7uBSmZWCjBNxdvv9HEC5nsW4wDV7wu6WnhWan,64761,503186,-438425,609
2022-01-22 10:50:13-05:00,8550,DjbEch16uzdDtujFUeqxjquTTS3JXzEys8e9ogUv3aTy,6N8eKb3kfcbJEUZKZERiFiUR4hubB635D8Sotiji2TU8,True,216440287,54110071,330537,165268,165269,3zqXX6kzhkbW3d4TwD2CNjMRwxTbREXySekvq37kfCNk,13221487,179251655,-166030168,610
2022-01-22 10:50:13-05:00,8551,69byqtDPmgEY1NqKBCR95CEPVHRUxgbNW9Y4P4HjQ7ND,E47T4q4zMGzNL6vDxgWdLn3EQbW3WfVryr8Jsymy1hAL,True,2965939,741484,4448,2224,2224,3zqXX6kzhkbW3d4TwD2CNjMRwxTbREXySekvq37kfCNk,177944,2490884,-2312940,599
2022-01-22 10:50:13-05:00,8552,ANXYsUNpZ34dBt7cp6HEE7oi2pTKsbj7B5TeFHKPbHBU,2pqeP4fuMREosHcfWUecEBssp1GM4isihNjn7ALUD51d,True,2186100,546525,3276,1638,1638,3zqXX6kzhkbW3d4TwD2CNjMRwxTbREXySekvq37kfCNk,131054,2023634,-1892580,599
2022-01-22 10:50:14-05:00,8553,GqFbV89UYbQ6aEW1bSvGnnsDtTPQfHPTHzisXPhLnaTC,6X7j3nqmugRyVVw83uSzgiPaemEscc8VdsnPEKDz4fg2,True,1444150,361037,2242,1121,1121,3zqXX6kzhkbW3d4TwD2CNjMRwxTbREXySekvq37kfCNk,89699,1335230,-1245531,621
2022-01-22 10:50:15-05:00,8554,HdRgh9niYSd3YKCxzGdusYFquiVoFTP2mEGEzJJL5Nii,78C68Gbb1jYFQmYNCHHjL52keEKMXtGukmBwT7ahon4B,True,198395804,49598950,308183,154091,154092,4BnQKPLuE3DMTtxp8MjUBytgnhvxqq3ZTqZHTVZo4JJh,12327324,154552379,-142225055,621
2022-01-22 10:50:15-05:00,8555,9QZvB1Gqhk5PKt3MoJMjZL3FaU2bTbTDcVw3nF316zh7,DGJWGr9RCWkzdWn21mWG7NyUN8uuvSQbA53HojFJe1rH,True,23132059,5783014,34669,17334,17335,3zqXX6kzhkbW3d4TwD2CNjMRwxTbREXySekvq37kfCNk,1386789,20592837,-19206048,599
2022-01-22 10:50:15-05:00,8556,8trkirSQNdMmAcJdeswxs5cPjH8dD6U4eJtWiAdMsrDB,HaSzpQ45x2MipfN17U6jGBxX8tXboomVDhXNSrnEfLDr,True,59375,14843,91,45,46,3zqXX6kzhkbW3d4TwD2CNjMRwxTbREXySekvq37kfCNk,3676,48141,-44465,619
2022-01-22 10:50:17-05:00,8557,DiPSJvnnEwg1En7HJfEsKrUbBgtUf4KzGMyMCZDQSYgp,s8UVC6vPBofuXUS6RW1aQmZ8C35PrC5r4A6ugmvzLGB,True,9984,2496,15,7,8,3zqXX6kzhkbW3d4TwD2CNjMRwxTbREXySekvq37kfCNk,612,7284,-6672,612
2022-01-22 10:50:17-05:00,8558,9cRx2sGeqENLrNkvzLSnuD161JshSav6pNg9c7pYLi8f,13ryjUoWLejTLDQKh1m69VFD31onMx8yhzCKhqbeU6s6,True,8279356,2069839,12865,6432,6433,4BnQKPLuE3DMTtxp8MjUBytgnhvxqq3ZTqZHTVZo4JJh,514611,7421232,-6906621,621
2022-01-22 10:50:17-05:00,8559,2YPm4Ex9mNHX4CuNAUjkrXgoLFaZs6r1X6asYYUnvPyj,BatsG1UFq8ryYuFFcdnDyFWFPUV5P6w2VQpRup5oUey5,True,2136579,534144,3314,1657,1657,4BnQKPLuE3DMTtxp8MjUBytgnhvxqq3ZTqZHTVZo4JJh,132596,1899005,-1766409,620
2022-01-22 10:50:17-05:00,8560,Go3ne58krEsFsZ5yu9EBT7od15VCYmtbs1KhumRMTiXS,HCvwQ7HjmmeDXrguZQPrAbJjcCJzHqVZK2JMSFkFDWfe,True,615821,153955,928,464,464,72FwbpFGoLEazJEdpqNtPNefsadUrimUqma9wSoy4qiS,37132,594350,-557218,602
2022-01-22 10:51:16-05:00,8561,Bbd196A866Y9rQWQFt4YGg2R6Jqj7WQGXWPDmrNtPcKf,5gmWk1KwLoRHnhkjxps4Ad6aVk4ZpcfC3McZCWDVCUbu,True,1708312,427078,2344,1172,1172,4BnQKPLuE3DMTtxp8MjUBytgnhvxqq3ZTqZHTVZo4JJh,93774,1663072,-1569298,548
2022-01-22 10:51:16-05:00,8562,CM95f7KjJuAf1xVTWhu3wrp6BfMz116FbgkxBhcRNs4k,EG55wkH5NcoasfBUYhD5D2dc2uvo11dZ3uTu5wgs4gf2,True,3113901,778475,4272,2136,2136,4BnQKPLuE3DMTtxp8MjUBytgnhvxqq3ZTqZHTVZo4JJh,170907,2790095,-2619188,548
2022-01-22 10:51:16-05:00,8563,6b7Ro2myM4HcUDqyyW9NEqTWPz8BWpH4eNFSQQci37So,7r7j7rSsa6YZcTuRPfs3KP44MVqUA4Q5NeJGmx84wbHq,True,749648,187412,1030,515,515,4BnQKPLuE3DMTtxp8MjUBytgnhvxqq3ZTqZHTVZo4JJh,41217,727375,-686158,549
2022-01-22 10:51:16-05:00,8564,HRN438yBJSX72GV4E3JYLKpwQcnZXgAoB2VkmgXzEKDE,4jEn7ssEM8ZUjAyaKogEb3uyMmbZJ1a7WGCPNgh1Xfty,True,1606171,401542,2193,1096,1097,4BnQKPLuE3DMTtxp8MjUBytgnhvxqq3ZTqZHTVZo4JJh,87736,1281565,-1193829,546
2022-01-22 10:51:19-05:00,8565,H6fVnghBUSJRKp2mxSG7Fq2Lr4dE3YMS7yM1XTrxoe3Z,JjgtLi79grUZXofhWukB1yNXZkXFMUX5jm9HcXNDsB6,True,154153,38538,212,106,106,3zqXX6kzhkbW3d4TwD2CNjMRwxTbREXySekvq37kfCNk,8518,121612,-113094,552
2022-01-22 10:51:19-05:00,8566,EL9JxeMvWWLTdVC5QrZzSSgApEwv1nDhZc6yNmH9G8ad,EqSQLSFx1eKkTYAdv5XhekttqVh7TappXAHuv9EedCXq,False,715,715,35,1,34,3zqXX6kzhkbW3d4TwD2CNjMRwxTbREXySekvq37kfCNk,35,659,-624,489
2022-01-22 10:51:23-05:00,8567,52hhBAuVyifMNFKGQmSitc8smiEgscXQMzVuZj55j7E5,6B5DBJx9NLytR3fkrYqe5W5ek4rUWsR4nPsRTvRfRwzC,True,58395117,14598779,86027,43013,43014,4BnQKPLuE3DMTtxp8MjUBytgnhvxqq3ZTqZHTVZo4JJh,3441097,54219425,-50778328,589
2022-01-22 10:51:23-05:00,8568,75NA5QiXEHG4caSB9BpafGZPA9eT9S6MhKTFM6eHjz8H,FmoxAVw2zdG6qbyaXKy6gsvi1XY8ZVbSgUNbjsp9EpVd,True,3617295,904323,5438,2719,2719,4BnQKPLuE3DMTtxp8MjUBytgnhvxqq3ZTqZHTVZo4JJh,217526,3097507,-2879981,601
2022-01-22 10:51:23-05:00,8569,CxePQ6ZEn2NCLYgGegSeFX1PyBuczP9j5v131VQSPh1c,9gPk7qTRb5JHqBXRKp3uZfhA2VjQAJDQHTzYXGLUdAUC,True,3161154,790288,4523,2261,2262,4BnQKPLuE3DMTtxp8MjUBytgnhvxqq3ZTqZHTVZo4JJh,180945,2824705,-2643760,572
2022-01-22 10:51:23-05:00,8570,HfwGSiwGiyDFaTS2usYRp82zSmPPQqZukbw2d1BuFs5w,ArtgZbmA33k8Y3EfR6oMJiqT72MUrVBQqifPBdcnrzea,True,1048753,262188,1600,800,800,4BnQKPLuE3DMTtxp8MjUBytgnhvxqq3ZTqZHTVZo4JJh,64025,564624,-500599,610
2022-01-22 10:51:23-05:00,8571,3EgUBHBeKWegibDcCsTGaGehnwHYvpMbcPaT1UTbwQ49,Hxd4dsnLD8uHnG7KR7GVmKXBcpN1egMUvoTccPvBcaYA,True,58017365,14504341,85890,42945,42945,4BnQKPLuE3DMTtxp8MjUBytgnhvxqq3ZTqZHTVZo4JJh,3435628,53838029,-50402401,592
2022-01-22 10:51:23-05:00,8572,JDg1bbHkYeznDUtSBLhagRJ45aSzeSF5V8iDRJCay9wL,8n7ic28zq5PjJtRcM7Fcy5vLW2YVXw4EWMK6UAt2zh3V,True,39529345,9882336,59469,29734,29735,4BnQKPLuE3DMTtxp8MjUBytgnhvxqq3ZTqZHTVZo4JJh,2378787,35404784,-33025997,601
2022-01-22 10:51:23-05:00,8573,7feC64HZfQpniey2iXsMMgQXnfcunJus74DiKDeKaEUw,GstsCxAiBBEUrXNkvZZ9Sg4vNK916PsKe2Mx6e4M6dU7,True,40311,10077,60,30,30,4BnQKPLuE3DMTtxp8MjUBytgnhvxqq3ZTqZHTVZo4JJh,2435,33401,-30966,604
2022-01-22 10:51:23-05:00,8574,BZn1DDE568UHeL2Qniv9EDT1yAAWvPJcTtSw4K4GQx44,CCaroU4YwKvYgibMsRPdEBxeDbzcNC4s5ZthxrhywSm5,True,3531328,882832,5160,2580,2580,4BnQKPLuE3DMTtxp8MjUBytgnhvxqq3ZTqZHTVZo4JJh,206427,3148618,-2942191,584
2022-01-22 10:51:23-05:00,8575,DakevNrDK5fAUGkLdrWHrsLZm8hEZBqkzUiwJouaDPPY,73nFhK7cygPgwKveXrdXcQVte8n1z3iBe4nmUVTGfFmv,True,121015070,30253767,169708,84854,84854,4BnQKPLuE3DMTtxp8MjUBytgnhvxqq3ZTqZHTVZo4JJh,6788351,73251102,-66462751,560
2022-01-22 10:51:23-05:00,8576,57Vsw8jXaaoLriYEkvPAVyq66r4a4zMfLWbDaTBMjFzC,7AVDWUTHa6729UkXgCXASphSmrLvXYGAA9ygTMSqvwvY,True,1733086,433271,2539,1269,1270,4BnQKPLuE3DMTtxp8MjUBytgnhvxqq3ZTqZHTVZo4JJh,101560,1613623,-1512063,586
2022-01-22 10:51:23-05:00,8577,7EtGovzHsbD8cKGqq4R5rvKBbncR4Kc7CDkTjof2QBMf,8ShjeNWM2vcvUF9yYztYCHUQfcGsyg2A1LyWiPbQDDvq,True,338731,84682,517,258,259,4BnQKPLuE3DMTtxp8MjUBytgnhvxqq3ZTqZHTVZo4JJh,20719,314740,-294021,611
2022-01-22 10:51:23-05:00,8578,Br1j5Ftafei7ysu5SmqVZSoRe4uS4qCPeKSPHg55pyiE,G8fc7QvXjfkgBFvAVUgJFQS3VaF1biL9rktBExGa87Ks,True,124405497,31101373,192124,96062,96062,4BnQKPLuE3DMTtxp8MjUBytgnhvxqq3ZTqZHTVZo4JJh,7684969,88286963,-80601994,617
2022-01-22 10:51:23-05:00,8579,C1CsbgQFvEvSXzuVHTr39tQHr3drDhjxeYiotd8eNocF,4rAaTCAMj5VpgNVKiYizabH7cMLhEA12seu2QXQNTyV3,True,2885899,721474,4485,2242,2243,4BnQKPLuE3DMTtxp8MjUBytgnhvxqq3ZTqZHTVZo4JJh,179411,1267406,-1087995,621
2022-01-22 10:51:23-05:00,8580,CK1SjmBjrW7m1QVZbVZsVZgwEcxw8BTkckkzrZDrDdxW,M6vnBg1TPRhLu7sghkxtf5TkSLw5JhgoDmbGoyEYgR9,True,3421080,855270,4763,2381,2382,4BnQKPLuE3DMTtxp8MjUBytgnhvxqq3ZTqZHTVZo4JJh,190532,3063103,-2872571,556
2022-01-22 10:51:23-05:00,8581,FwTGq3BeMLyRFRa5r4E6nySLgoLNcNdqJsCQxA2i6uh6,88w6ti3WSriyu2FvNjVfrLpGyU5PUvaiJyqrAGPM8TKp,True,1683072,420768,2593,1296,1297,3zqXX6kzhkbW3d4TwD2CNjMRwxTbREXySekvq37kfCNk,103725,1563078,-1459353,616
2022-01-22 10:51:23-05:00,8582,4oop1mjCh1Ao9NoWAUacAGc75GxiRTXr8KJ3NtzZ7btf,BfntjUunXBhnrKmocQ7pZr3wwxruRGudMyWQYC2MUhei,True,5481093,1370273,8511,4255,4256,3zqXX6kzhkbW3d4TwD2CNjMRwxTbREXySekvq37kfCNk,340463,4983357,-4642894,621
2022-01-22 10:51:23-05:00,8583,46TNhGwBVzedW8xSb9UY94HNeSom9iGiZzAjrKHiRM2G,7JVTiqNYeKHbyzRkKtvSEpqLPKykZso8cGUr3sX1j7QF,True,2578505,644625,4029,2014,2015,4BnQKPLuE3DMTtxp8MjUBytgnhvxqq3ZTqZHTVZo4JJh,161168,1702019,-1540851,625
2022-01-22 10:51:23-05:00,8584,Frobc1KZTVcsyfwyKwSpHJobxmiJBomzHhGCLdrzdAz8,HziyKP9uxWCuXddtbRzWMczHNdgyQB5UXQZj4MnMm14,True,4592336,1148083,7024,3512,3512,4BnQKPLuE3DMTtxp8MjUBytgnhvxqq3ZTqZHTVZo4JJh,280995,2489594,-2208599,611
2022-01-22 10:51:23-05:00,8585,HGAFdundf5voDqeh9g7d6Q9mgMf8eEg898QMRBqwPZ6C,deanBuZXWBHEe2TGfP37S9aMBEnEgmZoyRJjAvruzfA,True,1534679,383669,2378,1189,1189,4BnQKPLuE3DMTtxp8MjUBytgnhvxqq3ZTqZHTVZo4JJh,95136,1435524,-1340388,619
2022-01-22 10:51:24-05:00,8586,Fs8MQLaMyr1Q96HsZivKLY7Kjdeu2ZoB2n3VTZ15KbSn,DREfCs5CTVNUUF8H3hD8CWvtxztiYxoLYh8HUWDecMyZ,True,54821199,13705299,80788,40394,40394,3zqXX6kzhkbW3d4TwD2CNjMRwxTbREXySekvq37kfCNk,3231522,50928146,-47696624,589
2022-01-22 10:51:24-05:00,8587,76gdRvg74fv6A9vA8ukNPqWKkmKY6KLAAKBGvbNE2AXC,5n88nkWZiCtWyWPrgfJozgkxtU9HMSggrxHkLoTQp1QR,True,5577,1394,7,3,4,3zqXX6kzhkbW3d4TwD2CNjMRwxTbREXySekvq37kfCNk,314,5136,-4822,563
2022-01-22 10:51:26-05:00,8588,7A1v7bFDJwxM7XomePFyRh58SMHxrNSkM3fJygd8pQUN,DL9jCFHaM8BXJ5KE1YJHXNCbXgSdRgt18MHhAgC6TNmg,True,4235388,1058847,6414,3207,3207,3zqXX6kzhkbW3d4TwD2CNjMRwxTbREXySekvq37kfCNk,256576,3624900,-3368324,605
2022-01-22 10:51:26-05:00,8589,9XHC2Ycm9f56cDYxRPVKYiYWGKA4y7Utpv3e9gpMsZq3,HpqAdpkzWqoJUNqmHEnn4PZwSB6C6jt8FJZQtZtFqXWA,True,15595196,3898799,22433,11216,11217,3zqXX6kzhkbW3d4TwD2CNjMRwxTbREXySekvq37kfCNk,897322,13424303,-12526981,575
2022-01-22 10:51:26-05:00,8590,3PPCwAjj8GNphb3cRs7kP1QVghEUX6gWUH3M4JarQsTD,28UR4WKAziiJmPwas5E5JrY3WaUrR2NkYYXCKuxPHTMR,True,468672612,117168153,720439,360219,360220,3zqXX6kzhkbW3d4TwD2CNjMRwxTbREXySekvq37kfCNk,28817583,403832885,-375015302,614
2022-01-22 10:51:26-05:00,8591,APbpwRCB9tfma8yoi8upe633XZBtNwc5zVxXVjLwhg8s,BBwryuZZ8msiSFNmGkh13Wgg1PoSutY2Ftgz8odcxPm4,True,16187510,4046877,22690,11345,11345,3zqXX6kzhkbW3d4TwD2CNjMRwxTbREXySekvq37kfCNk,907607,13967161,-13059554,560
2022-01-22 10:51:26-05:00,8592,BmLG3dPSnL9hL2okZcNVsHgzuWYCrWLdXW8z5Jd2gyvF,HXwhov5Re9b8D4XHULcVSdgBNfbtZ7KMhMRqSTcQTbno,True,4586611,1146652,6488,3244,3244,3zqXX6kzhkbW3d4TwD2CNjMRwxTbREXySekvq37kfCNk,259521,4312040,-4052519,565
2022-01-22 10:51:26-05:00,8593,HUe9LgGBjMeNxGyeCtmXr2XbWVFhHXrvgc2XSqCwN11D,7Z1nR9GgezBXsDX5wW3BBarfMRMZV28rX6MeLRuWtycG,True,31140083,7785020,43875,21937,21938,4BnQKPLuE3DMTtxp8MjUBytgnhvxqq3ZTqZHTVZo4JJh,1755014,26859310,-25104296,563
2022-01-22 10:51:26-05:00,8594,HabA6MLjygaKE6i9Sad4c6B8rnyobMYbtFext51rCmHj,516FG8YJxZmnGfvzWiV3TcwSF7UDdwWefjZkmi3R2SPX,True,148905667,37226416,232736,116368,116368,3zqXX6kzhkbW3d4TwD2CNjMRwxTbREXySekvq37kfCNk,9309457,78089957,-68780500,625
2022-01-22 10:51:27-05:00,8595,8xQ3tsWVUe75EG1HmocULJ3kh52utveoFMEPotTGrKno,i3SKW3ywrwYucX9ySEx1C4zaUKGnzLerP3V38437NyV,True,724010,181001,1079,539,540,3zqXX6kzhkbW3d4TwD2CNjMRwxTbREXySekvq37kfCNk,43165,771683,-728518,596
2022-01-22 10:51:27-05:00,8596,EBpxGcrs4eWAbBU5rEjFxbr24MjUstZQRMV9jK4q8kMp,EYVd6pztEuz8PC7rUnJ1AjVZ81WWpynyn2qEKtveqrHG,True,2323441,580860,3621,1810,1811,3zqXX6kzhkbW3d4TwD2CNjMRwxTbREXySekvq37kfCNk,144879,2151460,-2006581,623
2022-01-22 10:51:31-05:00,8597,51VhgthsxrRRr2PT5gLnDfL1A3soqwCxA1UzH9vRUGTh,4QCcd7hfsydQ63LH7Lqsp8oVXw7HuKamzQf8VMH6Lgu2,True,2718603,679650,3881,1940,1941,3zqXX6kzhkbW3d4TwD2CNjMRwxTbREXySekvq37kfCNk,155240,2427599,-2272359,571
2022-01-22 10:51:31-05:00,8598,3gdApRPkUGEqmLvTYf4WQJCnmTVmiEU2wCQG26QMpqKf,HpP2yxq3KfYByT4q4p2mLaELnPdW6kmEY9EqZaBZuUNR,True,2039279,509819,2860,1430,1430,3zqXX6kzhkbW3d4TwD2CNjMRwxTbREXySekvq37kfCNk,114421,1824652,-1710231,561
2022-01-22 10:51:31-05:00,8599,8HWpccoTmPZ9MsrxtvQ5BV5y8a8WBAB1Sxx2WAiYKRLH,9chtr2Nqg77CCCnjC5JqENmUBNxpDHVH6BG3wojn9gHQ,True,1955939,488984,3010,1505,1505,3zqXX6kzhkbW3d4TwD2CNjMRwxTbREXySekvq37kfCNk,120416,1844105,-1723689,615
2022-01-22 10:51:46-05:00,8600,D58t4uTjFumsUeYFaKnpV8BRTEQEqKXBreFTdwGrott7,67p6kHDfVqQijfcwugvZK59c3aRRH9x3eHxruqH8WEqF,True,6944533,1736132,10855,5427,5428,3zqXX6kzhkbW3d4TwD2CNjMRwxTbREXySekvq37kfCNk,434224,3357222,-2922998,625
2022-01-22 10:51:49-05:00,8601,3sGCWcgPY7TzRCkFR1uuY8KcUzVRbdTyFYxh7V1csNMX,CcRFNnG2uhyLwhNAbX4U49jkMeC11kJtVhhyqDWdDK5r,True,37844066,9461016,59204,29602,29602,3zqXX6kzhkbW3d4TwD2CNjMRwxTbREXySekvq37kfCNk,2368165,35392192,-33024027,625
2022-01-22 10:51:50-05:00,8602,FdYFnEYtFQKcZPmzUqnvNLzozxdR1emtkmvnYcMgYykS,7arWNJQf2cWxerjhLgQh9CJxwTat1efnr5KmhuD7Qnv4,True,1034493,258623,1617,808,809,3zqXX6kzhkbW3d4TwD2CNjMRwxTbREXySekvq37kfCNk,64711,989861,-925150,625
2022-01-22 10:51:53-05:00,8603,A4Q7Vrc9M3GtEXNUSiVBFkansyf5sKBtSeVT92WFacqv,EWLNfsTKqzkd7KAhnrPRre4Dyk6exb3H9wSbrJuyWprg,True,33870896,8467724,53007,26503,26504,3zqXX6kzhkbW3d4TwD2CNjMRwxTbREXySekvq37kfCNk,2120293,31651009,-29530716,625
2022-01-22 10:53:13-05:00,8604,BjCNaM7YbE9SjFi7tzi4677zg1fKXGJwtecz2GWwWuhd,6rNsSrKZezQrLb2whToNjnizpnurDXrobHqfEK3QqU1M,True,657180869,164295216,1022413,511206,511207,HfEnetJ7uBSmZWCjBNxdvv9HEC5nsW4wDV7wu6WnhWan,40896521,326655299,-285758778,622
2022-01-22 10:53:22-05:00,8605,FuoFPNTdYVDkSHaBac6UC1aNJXafSNTvFJuBCdrgQQrH,ApBS1Fx83tcECMzDV6wEzEzEdg4e2hgj3djtjRUoSKK5,True,39470646,9867660,60698,30349,30349,3zqXX6kzhkbW3d4TwD2CNjMRwxTbREXySekvq37kfCNk,2427933,27990203,-25562270,615
2022-01-22 10:54:45-05:00,8606,BCGTaPQxGEMjD7xUxwfwmVVYJ9CEGH33yJRi3QjwyiLE,JBct1cZ9a959UKwABBEefwxZnGTAAGLzyUdXrXqGGCZd,True,87234983,21808745,134668,67334,67334,HfEnetJ7uBSmZWCjBNxdvv9HEC5nsW4wDV7wu6WnhWan,5386722,55278159,-49891437,617
2022-01-22 10:54:50-05:00,8607,woTXSsDkL9TQNxc3zwxSPagVijX7PE24bgKjvxexRwQ,A5M5EEPfDgvAxGLhpNgfn8AzPmyXxmPVgkEKnyoVzsz6,True,98739,24684,154,77,77,3zqXX6kzhkbW3d4TwD2CNjMRwxTbREXySekvq37kfCNk,6162,109660,-103498,624
2022-01-22 10:56:34-05:00,8608,5Tf1yqxsjGf6ALPmGxxFzjmmXgP2jVVHuPqkuqLCi4uu,9cWJzD8QLERJZJJTpXkDEfsTK3geNZQoigTuCL4a3PLG,True,331736817,82934204,514783,257391,257392,3zqXX6kzhkbW3d4TwD2CNjMRwxTbREXySekvq37kfCNk,20591329,130237701,-109646372,620
2022-01-22 10:56:50-05:00,8609,5BJnMHFSiQjHRGFJDW1jnqCfkHHYWnQzmmccy9eA4jNj,9517JGYsPmvgPUM9pFRD2vipHmdgE578F7jA7Qq6jorm,True,118824074,29706018,185793,92896,92897,3zqXX6kzhkbW3d4TwD2CNjMRwxTbREXySekvq37kfCNk,7431725,39784789,-32353064,625
2022-01-22 10:58:37-05:00,8610,98pwBGgiSDuwuas6WYW2hc9qUxfULwvNE34aixaxbxXY,BLrjKxekjThtJ9rKtQxs1Y4rZ225EE2Q16VkP9TkThyV,True,7339147,1834786,11464,5732,5732,HfEnetJ7uBSmZWCjBNxdvv9HEC5nsW4wDV7wu6WnhWan,458577,3014136,-2555559,624
2022-01-22 11:00:22-05:00,8611,28JujYG1mbpYSjF7LNqXpup17TXb45VJHhhnFMVXtft2,DAqyVExAtmsovPGrkpkFDxm6T7pKWLztfh9iPjTNDqrd,True,11611990,2902997,17989,8994,8995,3zqXX6kzhkbW3d4TwD2CNjMRwxTbREXySekvq37kfCNk,719596,4763684,-4044088,619
2022-01-22 11:00:53-05:00,8612,HEFpdWLZaiQnjftmXgxs6RNzhH72YiMjortxPkKekkvb,5Q8mmxBgVTijNGrWsnoA3VMArLHZEX5MkaigYXHpgXHE,True,12746109,3186526,19709,9854,9855,4BnQKPLuE3DMTtxp8MjUBytgnhvxqq3ZTqZHTVZo4JJh,788364,5432469,-4644105,618
2022-01-22 11:02:11-05:00,8613,GBpe8E33cNkFmMUuP3WjhDBBuQz7MHaDkpCJjGFaFkvu,3QYFKkgzZ1PKKAxCh4hMhgqrupoCcfRVkjuJZRWVZo3H,True,5439734,1359933,8511,4255,4256,3zqXX6kzhkbW3d4TwD2CNjMRwxTbREXySekvq37kfCNk,340454,3149844,-2809390,625
2022-01-22 11:02:25-05:00,8614,FgQrRo4eGQAonSsFfQgnp8trGGqGZCLeGX6yvJnMnTjd,8KhemHLBY6nGmo3xMDedW2wnCSxQq6LwbTExif4sUSxx,True,45468727,11367181,70989,35494,35495,72FwbpFGoLEazJEdpqNtPNefsadUrimUqma9wSoy4qiS,2839585,17169028,-14329443,624
2022-01-22 11:02:52-05:00,8615,C21232Uu2r4AmbR3mzrEKF5ZHoFDZbCmy88x8u6cLyZV,8sppny1HRFKX6LuqT6KDn1x9wS7z61K9V5akSuAimxgS,True,865377618,216344404,1345594,672797,672797,4BnQKPLuE3DMTtxp8MjUBytgnhvxqq3ZTqZHTVZo4JJh,53823785,243133286,-189309501,621
2022-01-22 11:02:54-05:00,8616,4WSiQCTqMvpSYvrbenQGFoV6fuDALSWMwZZ9MgP82fwb,6Y5GdgKErVfXrabSTi89X7xCEsZnoqDqwFD4hZ3FVtfN,True,9979909,2494977,15592,7796,7796,HfEnetJ7uBSmZWCjBNxdvv9HEC5nsW4wDV7wu6WnhWan,623692,6632335,-6008643,624
2022-01-22 11:03:06-05:00,8617,7CSCMFa9W52tBDVUbXbc3woAy3GByeA1wPJdp3MgznPa,3447ptuVFu6G8B6N63RmS8mRv4n9PfHneypHLvbeaGLn,True,1405139,351283,2192,1096,1096,3zqXX6kzhkbW3d4TwD2CNjMRwxTbREXySekvq37kfCNk,87703,1259294,-1171591,624
2022-01-22 11:03:15-05:00,8618,2jDRvE3pQNjWy1NRFa4tzB3KmU5UkbUCHw8sQRFujo66,C4zNi2szDrEEh4coTF3WRUghfP4ZwAVVSYTLWfkejQRu,True,8583053,2145762,13189,6594,6595,3zqXX6kzhkbW3d4TwD2CNjMRwxTbREXySekvq37kfCNk,527561,6372012,-5844451,614
2022-01-22 11:03:15-05:00,8619,6rpuf35EHPrQ3LVPUcdfRTh3igu9wvRcfvoA6uSMNmYq,B1aor5NFukbUeT5tzi9oXgRGxcRoojff8sfbwzmwywBq,True,8746281,2186570,13311,6655,6656,3zqXX6kzhkbW3d4TwD2CNjMRwxTbREXySekvq37kfCNk,532465,4680984,-4148519,608
2022-01-22 11:03:18-05:00,8620,BgN75npBkPws5uiFE9RAujmPuZyAv2MQUPmfmJ1YCCij,78UFLNDn782TY2P4F5kRkMRC2s3gw8ak7sRQZRWNq82D,True,7940505,1985126,12383,6191,6192,4BnQKPLuE3DMTtxp8MjUBytgnhvxqq3ZTqZHTVZo4JJh,495351,3231224,-2735873,623
2022-01-22 11:03:20-05:00,8621,399591e8XgY52yCMorCQ2WL6dQZTC485ZooHtmGuirhZ,JCiXAooFmKmEPQ2S7C8iSk6CLcTyrPEe1SsPSLyUGySe,True,35396,8849,54,27,27,3zqXX6kzhkbW3d4TwD2CNjMRwxTbREXySekvq37kfCNk,2189,33387,-31198,618
2022-01-22 11:03:20-05:00,8622,8otVEtwXkAdnt5XmBzL8hmzAgRcaDDxiuqpRxY6ZhR24,7333dFedtBjo3yhbp2bU1XbAfdDeBvvCd9QKitYVUU7v,True,359719513,89929878,551462,275731,275731,4BnQKPLuE3DMTtxp8MjUBytgnhvxqq3ZTqZHTVZo4JJh,22058484,89054335,-66995851,613
2022-01-22 11:03:20-05:00,8623,BgnsCfJ54ReunUtwPJLzkW4PWnqpBDWGNYxsW5PvDrbK,KpMqEkQ9dKMgCevsEK895wHd3fCLRPSzDmJSv3tKU4u,True,479612266,119903066,736683,368341,368342,4BnQKPLuE3DMTtxp8MjUBytgnhvxqq3ZTqZHTVZo4JJh,29467322,331057462,-301590140,614
2022-01-22 11:03:20-05:00,8624,8E3K7vCHJ2xjdFofPRGLbMxrkm8UYEi926QmXPAFwsqe,4qHUDA1c43Dg4qi1ZPKqmpGYiEMUZ6r4UuzB5ftHCEhW,True,46890768,11722692,71953,35976,35977,4BnQKPLuE3DMTtxp8MjUBytgnhvxqq3ZTqZHTVZo4JJh,2878137,40559589,-37681452,613
2022-01-22 11:03:23-05:00,8625,8eTH6eJyyVeMno3UQkffeBg32xofKsQfkhLhXdtaf87s,BCFC7CPXrQPsUfJb2eYSht8GhaApWHpc49AeCXqaYq13,True,7399030,1849757,11535,5767,5768,4BnQKPLuE3DMTtxp8MjUBytgnhvxqq3ZTqZHTVZo4JJh,461427,3392739,-2931312,623
2022-01-22 11:03:24-05:00,8626,B2hN3Lt5pFbUyfEUc5s48hkxUJ5rr2SeFxgdGdQ8pDD2,7bZJCCud253j9g411HQUDXUAADcwd5yJWznoTChBdB2H,True,200985165,50246291,314389,157194,157195,3zqXX6kzhkbW3d4TwD2CNjMRwxTbREXySekvq37kfCNk,12575566,76344270,-63768704,625
2022-01-22 11:04:20-05:00,8627,9Hz4p7gcfDbXBJp8KzhaBBPh9i7xe9kun7zLfDtqPe6c,2bJ43Lep6kp6WY7Ct56oiscKnAbdtC265G5yRvRPFThU,True,4862415,1215603,7553,3776,3777,HfEnetJ7uBSmZWCjBNxdvv9HEC5nsW4wDV7wu6WnhWan,302142,2998141,-2695999,621
2022-01-22 11:04:22-05:00,8628,AvpYg74EBhwAXE8rcdGkpwmbBMRyVidF6zMRSFtWAVC6,4WgpqTp4r9wMpMptYMNbvCaP2faBnVr6FdShCAobetpL,True,1319112,329778,2061,1030,1031,3zqXX6kzhkbW3d4TwD2CNjMRwxTbREXySekvq37kfCNk,82479,1260348,-1177869,625
2022-01-22 11:04:22-05:00,8629,2EkjFzKuqQaT9iLsf4qHnXM6rnbj7ftEyzzRsWx6D347,9NpHNbrRJF3U8Ub4KraPHhhZpyZk9Teo836dJSktJMEV,True,11775314,2943828,18304,9152,9152,3zqXX6kzhkbW3d4TwD2CNjMRwxTbREXySekvq37kfCNk,732199,6451885,-5719686,621
2022-01-22 11:04:22-05:00,8630,BrHRMouGRz3LBNzd9anfdYMhWfg8yUPHL4PqJ8WdEDFS,4uzoLa3mC2VYHAPBoHLX4gTjPTC28rPf2fvEGtJWPYc,True,311507,77876,483,241,242,3zqXX6kzhkbW3d4TwD2CNjMRwxTbREXySekvq37kfCNk,19349,455372,-436023,621
2022-01-22 11:04:26-05:00,8631,2ZSfbqxhiCTDrDPeRhoWayTZHNmW7ajVXBCxpFS4eGBF,3ZmWsPdQD7qfSMGKQSNhmBtuH7S6qMFRc8oEmBcHXEiR,True,1329578,332394,2069,1034,1035,HfEnetJ7uBSmZWCjBNxdvv9HEC5nsW4wDV7wu6WnhWan,82794,1270270,-1187476,622
2022-01-22 11:04:29-05:00,8632,ymyzGH4Qc7HH5PbKpVphCbsQgLLXyGkPcXamQJuNj5C,8oTLHaV2XzbKXNWRuUjCfHjUn61Pw93LYK14m9q2VDpZ,True,70404,17601,109,54,55,3zqXX6kzhkbW3d4TwD2CNjMRwxTbREXySekvq37kfCNk,4371,61890,-57519,620
2022-01-22 11:04:31-05:00,8633,CJpe9bNHxS63QMaGJhmnr4u7eTo6e5GApZQZyPtXLAkk,EMVL4sDfVXwGEoGEYwLp8D6itfy3eu4FZBAj1kMz6uXa,True,35534611,8883652,55223,27611,27612,3zqXX6kzhkbW3d4TwD2CNjMRwxTbREXySekvq37kfCNk,2208958,33113172,-30904214,621
2022-01-22 11:04:31-05:00,8634,5y8ZSWUnrm4B3emh7vLQKTh89vHtCvXqUhk7fJBA52is,Bu1AoKU2QQWpGH54ZzugvvACB3E1d3VvymnegNmTgHqg,True,37250213,9312553,57940,28970,28970,3zqXX6kzhkbW3d4TwD2CNjMRwxTbREXySekvq37kfCNk,2317617,34669991,-32352374,622
2022-01-22 11:04:32-05:00,8635,FYdUiU3rPpbYKWnEpekQQsocSJKjXmscohi4v6DYqix7,daPyq9YdunQJhhLoW5ifhJ7UFPTtRZhGs4JwE1nqZhN,True,1338089,334522,2081,1040,1041,3zqXX6kzhkbW3d4TwD2CNjMRwxTbREXySekvq37kfCNk,83249,1278359,-1195110,622
2022-01-22 11:04:32-05:00,8636,As81koHnSP9quoXuUVNHp3VR3Qaks8HLa4sFgJDocYiF,AMVm8dXia5s974VgZSbeE6uPDgyXDHZFyJ2W1J1CWvKW,True,37240820,9310205,57789,28894,28895,HfEnetJ7uBSmZWCjBNxdvv9HEC5nsW4wDV7wu6WnhWan,2311566,34673335,-32361769,620
2022-01-22 11:05:53-05:00,8637,U3vvMQ4X4aKzVYfhMw1V1p58HRqaLnuXozqmmefYeD9,7JA94MArkNCFRhBq8f5a32DgMF6aPdFsoC5HvXDQ6NuR,True,1606608,401652,2491,1245,1246,3zqXX6kzhkbW3d4TwD2CNjMRwxTbREXySekvq37kfCNk,99669,1719647,-1619978,620
2022-01-22 11:05:53-05:00,8638,BLJgLzizx2yLgd12pVBAHTMqn9J5JA3JHCF8PnLnPyUk,HhDmwMysBFWhXnd3mrV31w75WBRKBS8wJSiEMZgqdUSp,True,5228603,1307150,8104,4052,4052,3zqXX6kzhkbW3d4TwD2CNjMRwxTbREXySekvq37kfCNk,324187,5117601,-4793414,620
2022-01-22 11:05:53-05:00,8639,Aop82qT6CwZbomif4QowqP3VaSHKB1837B2yNKqw4tER,65BVa4jrCx9etU5eXBAXT2PVnwVot2HLWGYyNXbVJDFk,True,18278944,4569736,28454,14227,14227,3zqXX6kzhkbW3d4TwD2CNjMRwxTbREXySekvq37kfCNk,1138170,17027713,-15889543,622
2022-01-22 11:05:53-05:00,8640,FV9CBGGTbppLnBKh79f2LzD1diTiS5g6u89FcpZHZmnK,Fe7mtmCUziFqbbYTvrhAcAq1Ub7YLfTJRtQ1hG7GzJD1,True,27838,6959,43,21,22,3zqXX6kzhkbW3d4TwD2CNjMRwxTbREXySekvq37kfCNk,1737,24716,-22979,623
2022-01-22 11:05:53-05:00,8641,8cRrU1NzNpjL3k2BwjW3VixAcX6VFc29KHr4KZg8cs2Y,6KhaewfwKyT5fkQvfiDqKzGWEPbuP9H5NfxEUXVx14U4,True,124130987,31032746,194262,97131,97131,3zqXX6kzhkbW3d4TwD2CNjMRwxTbREXySekvq37kfCNk,7770510,29364778,-21594268,625
2022-01-22 11:05:53-05:00,8642,FF8rqfM9PTEjYiVFy8jS81weDRwdaYooux2uSa2LexrJ,JBk1JghH1gged1YpDbkczFXP9ka5ivYSkaYoVbbXD4kg,True,959714,239928,1501,750,751,3zqXX6kzhkbW3d4TwD2CNjMRwxTbREXySekvq37kfCNk,60052,979401,-919349,625
2022-01-22 11:05:56-05:00,8643,5V5gFVMYSwGYfHFecRoHg8G22Rg4bXfVK2FSRTMhPQty,73raXd5MvixmDvJRnVjRL7yQaHZGFRiC9aBxL9ysiRvy,True,147033844,36758461,229127,114563,114564,3zqXX6kzhkbW3d4TwD2CNjMRwxTbREXySekvq37kfCNk,9165083,69515309,-60350226,623
2022-01-22 11:06:01-05:00,8644,A4tDE948CPFPh1UwHb8sXryfKktbxZ8BCkqXgA5DJHA8,3zXeKMrsEpCe5fQumLNzCgpxcG1kLJFEAtJuqxLsC6ZG,True,2860733,715183,4393,2196,2197,3zqXX6kzhkbW3d4TwD2CNjMRwxTbREXySekvq37kfCNk,175754,2223198,-2047444,614
2022-01-22 11:06:01-05:00,8645,4uygLJDk9DFCifJ56YwMrEsvd3oQNq8tYSLnMCyWorS6,GimL4uKGvg3FFmFQSWzAcjstv3Vmk5NMgDGMKTuXYVpB,True,17128497,4282124,26331,13165,13166,4BnQKPLuE3DMTtxp8MjUBytgnhvxqq3ZTqZHTVZo4JJh,1053248,12703851,-11650603,614
2022-01-22 11:06:01-05:00,8646,8kJu5aqVSmW8FSZR9h6F75ftn9V2U9uMLBEKeqRaC855,FhVHByujkvwwtjTVpZ4mqSUqoMoBgeLUc5H7rbz3FgAt,True,2918307,729576,4507,2253,2254,3zqXX6kzhkbW3d4TwD2CNjMRwxTbREXySekvq37kfCNk,180298,2759680,-2579382,617
2022-01-22 11:06:04-05:00,8647,FnAT8HKGgisYfeAbxKU2gSbCp8KbZHULRpaJX1NVijHy,2u637Crc2QzfSJmCnRNqeib3aZQVn4NGncpgM3Ph6jvm,True,1132437,283109,1768,884,884,72FwbpFGoLEazJEdpqNtPNefsadUrimUqma9wSoy4qiS,70729,728972,-658243,624
2022-01-22 11:06:04-05:00,8648,CpxZ136k95cVjGqkJnNpDZKUgrJrfg8HrFDZPL6BgsK4,Fo7HtcrneUTsnGqygsxPQ63G5rayYodYT65xP6B6HusH,True,51429683,12857420,80270,40135,40135,3zqXX6kzhkbW3d4TwD2CNjMRwxTbREXySekvq37kfCNk,3210827,18873477,-15662650,624
2022-01-22 11:06:04-05:00,8649,D9VKhnfLLCrntDGFYSfoxFaY76VnHmYZ1ZbyFXdKdibz,2hRCRH2pMDyQGYcXHa8Y6BZo6FbcGZf5VJC1v8Bp6tGa,True,3036701,759175,4703,2351,2352,72FwbpFGoLEazJEdpqNtPNefsadUrimUqma9wSoy4qiS,188144,2127115,-1938971,619
2022-01-22 11:06:51-05:00,8650,9BMHbUs4d3qX49fnroHv2FTPDs4yoDFrvDMqf8p9U4pE,2yL7zwMr7qVG5Sdwkf7z6ppnNqt1ASppBbmxwYjfFY6Z,True,20656069,5164017,32253,16126,16127,3zqXX6kzhkbW3d4TwD2CNjMRwxTbREXySekvq37kfCNk,1290140,19751103,-18460963,624
2022-01-22 11:06:51-05:00,8651,4SX2pj4eHRwFMtyDCrMZ8ZT6ASAMi7yfZWZnccw5dGn8,Ads49ZqvTmPHxfzNYm4oJb4HBYhwS6vXQbarqmpUi5VZ,True,1083042,270760,1692,846,846,HfEnetJ7uBSmZWCjBNxdvv9HEC5nsW4wDV7wu6WnhWan,67707,1035604,-967897,625
2022-01-22 11:06:52-05:00,8652,3tQBuHwr3V8AZu8Yqhg1UfmnFoxzkUq9UeGeLm41UHy4,9cESwduiHBgrxZK1hN1eAFwnyfxw3FEHezTa8Ue5Kpye,True,106950145,26737536,167166,83583,83583,4BnQKPLuE3DMTtxp8MjUBytgnhvxqq3ZTqZHTVZo4JJh,6686679,65787533,-59100854,625
2022-01-22 11:06:53-05:00,8653,DMgD2KCEhTGFLUZ5GnfNcwfiiwKYbyVpoWiN6knMkCAf,5KU2vgBkPTNVHsSULjgX7ZkZS56U3Dy3xqLTxL5sUZJ3,True,7294415,1823603,11401,5700,5701,3zqXX6kzhkbW3d4TwD2CNjMRwxTbREXySekvq37kfCNk,456067,8644343,-8188276,625
2022-01-22 11:06:53-05:00,8654,BJV5jbowrbELXfDvfMovaQy4PiRf12pLYHimW9bgzW5X,6WXrWso5FvLx7RMCFBzrbzh5qevKkk2LJAihUfWXxXzB,True,110706,27676,173,86,87,4BnQKPLuE3DMTtxp8MjUBytgnhvxqq3ZTqZHTVZo4JJh,6927,163048,-156121,625
2022-01-22 11:06:53-05:00,8655,HGJoZvLakWfSDFwuvShNBc4kCf7nP7VqzyM3mELpbFEf,12Qn5jin7QvsBngXqYAv4UstyG3b6nRf1jsLp9Dp8G7k,True,82939,20734,129,64,65,3zqXX6kzhkbW3d4TwD2CNjMRwxTbREXySekvq37kfCNk,5179,80972,-75793,624
2022-01-22 11:06:53-05:00,8656,9kYkFDNE3qD6s73fn8kJowgqbDZoDSw22XaUJ7rTD43D,E8zJz8pT2c9aZsxe4kLMNs4bY7skt38SU5wK5JTqbGr6,True,20396013,5099003,31845,15922,15923,3zqXX6kzhkbW3d4TwD2CNjMRwxTbREXySekvq37kfCNk,1273839,19508150,-18234311,624
2022-01-22 11:06:56-05:00,8657,6Z6y2QLJUZ5s6zdjanJcKprTAotx8tqr9DRNqqycMeS4,JCYwt8MHVaBb14GB2qAvDWwYVMaL7VTxyNEt7Eo5Zy8x,True,1089851,272462,1704,852,852,3zqXX6kzhkbW3d4TwD2CNjMRwxTbREXySekvq37kfCNk,68194,1039195,-971001,625
2022-01-22 11:10:09-05:00,8658,7FB6X8YgiDn7YK9bZZmcFyzhuvVLVWPCfBbenwMXhx5,2EaDCpL9MpAKuiC2bvUCGRfvqYvgVXGFHXt35QdNakfG,True,6595376,1648844,9450,4725,4725,4BnQKPLuE3DMTtxp8MjUBytgnhvxqq3ZTqZHTVZo4JJh,378020,1689405,-1311385,573
2022-01-22 11:10:09-05:00,8659,2MbNCikBC3fdwqJKfMK1FjPg7wT3xWMXmN88XuikJ8r9,5eG6U5x63YYMpE7iwwu1TPcZapvQMyKczvtnFfST1BH3,True,4630,1157,6,3,3,3zqXX6kzhkbW3d4TwD2CNjMRwxTbREXySekvq37kfCNk,279,2816,-2537,602
2022-01-22 11:10:13-05:00,8660,9yDHiv4vGbQWYby3dAMCdVnwiYgXBV1jV6WCzKYUPiUs,FPyemR1VdBnhxW2V7j7EkQyhzW894bCb3f6wRUMSn6jB,True,140645475,35161368,208938,104469,104469,4BnQKPLuE3DMTtxp8MjUBytgnhvxqq3ZTqZHTVZo4JJh,8357543,49196189,-40838646,594
2022-01-22 11:16:37-05:00,8661,AvwHizRhHUSahmvSg4jmTUErc7vAFSmkRAEsiKhXfW1m,3UrWYx8y9N5o9GYneSe6zyyHRTZzxwvcipQfHHYh7tEs,False,11112,11112,0,0,0,3zqXX6kzhkbW3d4TwD2CNjMRwxTbREXySekvq37kfCNk,0,12153,-13968,0
2022-01-22 11:49:23-05:00,8662,BgNgALwBEuiumVgiXRmBZRnyFrr9QTDy2maHzsNwNHGf,ag35Ec2uFtqkarizCxFyhM2SPBuUwfmLRhAdFEWFCNa,True,2333772,583443,3632,1816,1816,3zqXX6kzhkbW3d4TwD2CNjMRwxTbREXySekvq37kfCNk,145308,1188805,-1043497,622
2022-01-22 11:59:40-05:00,8663,DXEJNyHSCbGZezXHy2xQaSzd37dwJs4dMTgt5VF5UZAG,7fCYM9DWrAX7vgZ11CwQMNd5NU8FB1yrbctxHaPYshpB,True,3903957,975989,6008,3004,3004,HfEnetJ7uBSmZWCjBNxdvv9HEC5nsW4wDV7wu6WnhWan,240348,1675218,-1434870,615
2022-01-22 12:00:28-05:00,8664,4vW2Q76fdGmfhU2Tx3R2XQkGcQUi6hSM9ixvK5RWvurJ,w8cGbqVpVr6WHSRJFXv469RMgRB3ty3TGpkVXRs7K7H,True,8255541,2063885,12892,6446,6446,HfEnetJ7uBSmZWCjBNxdvv9HEC5nsW4wDV7wu6WnhWan,515702,3157761,-2642059,624
2022-01-22 12:00:31-05:00,8665,AoPQqPjLPi8fZiLkhMGLRj6oD5k2asrvJtCkpW19DvGr,H5Sgmf1VuY13iHjPuLJ2q9wtSdkXG1AQsEv2eq6zzm8Y,True,45704717,11426179,71321,35660,35661,3zqXX6kzhkbW3d4TwD2CNjMRwxTbREXySekvq37kfCNk,2852872,13390555,-10537683,624
2022-01-22 12:00:31-05:00,8666,DDsY5V3F9wnEGBoQFCEf1hvEYuKUaJdysbc7TxhNqe9G,5oBCGzvy8odB8MCxCUvPDqYCnTyteZ4Yy1JDroroygbi,True,6241500,1560375,9742,4871,4871,HfEnetJ7uBSmZWCjBNxdvv9HEC5nsW4wDV7wu6WnhWan,389715,2588997,-2199282,624
2022-01-22 12:00:54-05:00,8667,7Dm3syN4P2mbBLFKyHTrtnSWY4hadGXiKB9EekTdT68S,HF97QS1dqarPMWgNmtcoaq6z3rpJnzAAAfc1PP4FwRhV,True,2370366,592591,3707,1853,1854,3zqXX6kzhkbW3d4TwD2CNjMRwxTbREXySekvq37kfCNk,148300,819593,-671293,625
2022-01-22 12:06:21-05:00,8668,J6jBKPDR6R5cLMqLufw3zoVfheNYs1KF7C4Ft2dakXeA,6wTTLK675Ym6toJRp7tYaUZzisWfgGjSp3X3yJ31xiKt,True,6198266,1549566,9649,4824,4825,HfEnetJ7uBSmZWCjBNxdvv9HEC5nsW4wDV7wu6WnhWan,385984,3031361,-2645377,622
2022-01-22 12:09:17-05:00,8669,H6fVnghBUSJRKp2mxSG7Fq2Lr4dE3YMS7yM1XTrxoe3Z,JjgtLi79grUZXofhWukB1yNXZkXFMUX5jm9HcXNDsB6,False,112595,112595,5110,255,4855,HfEnetJ7uBSmZWCjBNxdvv9HEC5nsW4wDV7wu6WnhWan,5110,92951,-87841,453
2022-01-22 12:11:59-05:00,8670,GjQQ2fQ7mrGjWZwjVYFUKp9NM1LmfkhEo675ovU5SPa8,ECgVUMRY5nB4MALs5drDyipF7YohCPuJpj2UegCs7HMn,False,113229,113229,5285,264,5021,HfEnetJ7uBSmZWCjBNxdvv9HEC5nsW4wDV7wu6WnhWan,5285,106460,-101175,466
2022-01-22 12:13:17-05:00,8671,B9WJfmrYEkVH3L1UWz4qqWpaexHydymbzvEfwNVtB9BV,6mQb4yzGq8jE1NbweKCKSbevnnYVhHYxyc6Gz2a5kJLn,True,28414744,7103686,44218,22109,22109,HfEnetJ7uBSmZWCjBNxdvv9HEC5nsW4wDV7wu6WnhWan,1768755,11111891,-9343136,622
2022-01-22 12:13:19-05:00,8672,BJaaH1SK1pF2kZQzmYpLFfDtm52CR9a5rd39RAPtLe8q,HUsT5FVxaisdnCvG1BQxX6zffjfL2Rwx5mMo5y8SDV7e,True,952670,238166,1479,739,740,DddJ7EWCmYEEZETCBNgAUSg81Ls6fZtiAaY5ekJ5sXx1,59199,585312,-526113,621
2022-01-22 12:13:19-05:00,8673,A1VornXbzK5rFgsy9D4qThcPnYVP8AB9RRzWsV1h6L17,9M4dQgz1zWrtKHqZMt9w7PbM9CvmyjhY5ZZ6jjajMzqm,True,4150748,1037687,6478,3239,3239,DddJ7EWCmYEEZETCBNgAUSg81Ls6fZtiAaY5ekJ5sXx1,259122,1719223,-1460101,624
2022-01-22 12:17:40-05:00,8674,8Xt3qHjZG3zLxozgM5vPHMVxp8eYFMg89kaVW7vdHKoA,2i8riSsQpfADD9LUVpiBJBfX5qjVAgmZegzfKx6RG9dW,True,99994451,24998612,156343,78171,78172,3zqXX6kzhkbW3d4TwD2CNjMRwxTbREXySekvq37kfCNk,6253747,43231220,-36977473,625
2022-01-22 12:18:15-05:00,8675,EDSf2w1UyGvbgMuxyoXL58ifR1dviZinnLBYnFmgjcNG,DFenkzbL9SUjs9cSCaHJ1eXK75mHfk3GSPRFs8TSzrFV,True,79158299,19789574,122966,61483,61483,3zqXX6kzhkbW3d4TwD2CNjMRwxTbREXySekvq37kfCNk,4918679,37746721,-32828042,621
2022-01-22 12:18:54-05:00,8676,2MbNCikBC3fdwqJKfMK1FjPg7wT3xWMXmN88XuikJ8r9,5eG6U5x63YYMpE7iwwu1TPcZapvQMyKczvtnFfST1BH3,False,1134,1134,0,0,0,DddJ7EWCmYEEZETCBNgAUSg81Ls6fZtiAaY5ekJ5sXx1,0,2175,-4243,0
2022-01-22 12:19:26-05:00,8677,2JXP6KUwPSmCrXT2uQRqSoCwH8RLYWwmqYsj3zXtv9xF,4qcFVgugXsHVQzFRP2he9CVzvv47xqgokJjigee8oPpP,True,210236701,52559175,326720,163360,163360,HfEnetJ7uBSmZWCjBNxdvv9HEC5nsW4wDV7wu6WnhWan,13068822,77649335,-64580513,621
2022-01-22 12:20:18-05:00,8678,4ne6vC7qdxQYHJCsaeFAKZrKdFt2SwXGHQ3jrMHqt4DL,Cf1dLHY2WXH9rXbRKq5TT8THbdo9SdNUZq4rYhRCF9z,True,1280986,320246,1957,978,979,4BnQKPLuE3DMTtxp8MjUBytgnhvxqq3ZTqZHTVZo4JJh,78318,756968,-678650,611
2022-01-22 12:20:18-05:00,8679,EAtQUZAkQxwJF779DwPcWHZ455FzYX8mzm1uV5LBnhPB,8h8t6GW1Y7xMBfWpfyFfUVBP4apMbJVNg7igZUYZLsyr,True,7822791,1955697,12180,6090,6090,3zqXX6kzhkbW3d4TwD2CNjMRwxTbREXySekvq37kfCNk,487200,3340766,-2853566,622
2022-01-22 12:20:32-05:00,8680,EXP61AETWHw3kHSjrJH1jQBt6cXR9Zebz34Cueb3KAzg,2JT9GrgdUKjuQQtXvZqevbjFquUQBMYDoADmBjDKWXj3,True,31741581,7935395,49421,24710,24711,4BnQKPLuE3DMTtxp8MjUBytgnhvxqq3ZTqZHTVZo4JJh,1976855,18275801,-16298946,622
2022-01-22 12:23:44-05:00,8681,8trFFwvXKKMwMx952ugCZmqyw29e1HxEKBuQmFn8ZwTf,FsD7gCvHXM3QchQiDcd292ksy5afZMWApneNTat5ndeS,True,25291141,6322785,39454,19727,19727,DddJ7EWCmYEEZETCBNgAUSg81Ls6fZtiAaY5ekJ5sXx1,1578171,9900282,-8322111,624
2022-01-22 12:23:44-05:00,8682,FS5xx53Bo65G21gJLta7LEEiS132VJM1kGpUzuqyfzoy,2kbTLjdBBA9K1coxKmwmYbjq2heSnuNg4Nh2EfVNYgwj,True,7358769,1839691,11506,5753,5753,DddJ7EWCmYEEZETCBNgAUSg81Ls6fZtiAaY5ekJ5sXx1,460244,3644695,-3184451,625
2022-01-22 12:28:54-05:00,8683,5acohGZShYQVNGZEfy7pTyX7E8MzqRDwByhFL1H53UNv,4Z454ZseKbWGEtdrE9eotbDZ7o9VHhooMYriTfSFHiGt,True,194045235,48511307,303557,151778,151779,HfEnetJ7uBSmZWCjBNxdvv9HEC5nsW4wDV7wu6WnhWan,12142289,64516484,-52374195,625
2022-01-22 12:29:31-05:00,8684,HwosLQgDY1xtHQRQ4hzroPQHFWssPzTj5vRkP37FcviB,HKTNEYNXrephNkH7apbobK4mcQXcNayQA4W1NgM6sLr8,True,1517162,379290,2362,1181,1181,3zqXX6kzhkbW3d4TwD2CNjMRwxTbREXySekvq37kfCNk,94497,912580,-818083,622
2022-01-22 12:29:33-05:00,8685,BYvjENe16Ta77PqGV7JKEWrsqCTfkMGYwTSG5gXneDvd,EvxAXgvhPC6QkNurbK7vWyTApGo8J2R4EgMAknkHVU3d,True,15814,3953,24,12,12,DddJ7EWCmYEEZETCBNgAUSg81Ls6fZtiAaY5ekJ5sXx1,982,19036,-18054,620
2022-01-22 12:29:33-05:00,8686,7EvJoetxJVTgpJXqE1VC3fZN1CQ5xdWdv29yCiDuH9gU,6RTEusjGEHNDdMj75qkpzYHjHZ3R2XN5xvptCwkRJz5j,True,1489614,372403,2309,1154,1155,DddJ7EWCmYEEZETCBNgAUSg81Ls6fZtiAaY5ekJ5sXx1,92360,1423426,-1331066,620
2022-01-22 12:29:33-05:00,8687,3NhNdphQiKwgHTmTJc4qVhp3aWjqnwMTYbRW1y9CZrZg,BNpP1sKPAr7Dk1ymSrupge9KGMVpk4LfjTjawgi9YaC5,True,7792599,1948149,12154,6077,6077,DddJ7EWCmYEEZETCBNgAUSg81Ls6fZtiAaY5ekJ5sXx1,486170,7246803,-6760633,623
2022-01-22 12:29:33-05:00,8688,6sK2PQyTvStxT9qigrFaPmf9GSe4X4wLb4ig7izrzwaB,6iyTuXdnBiLrKPCat7ajRnUq2245L9bbJrHAvsnyFx8e,True,9068,2267,14,7,7,4BnQKPLuE3DMTtxp8MjUBytgnhvxqq3ZTqZHTVZo4JJh,565,8465,-7900,623
2022-01-22 12:29:33-05:00,8689,2FEbsetZMkRqLjSC8GBbgecKgX5T1T1fci2sLQux29p8,H722Fcd6DkTFRZxqQWbPDufBfXEgmFfhiEpQZWhxwYv1,True,24710,6177,38,19,19,HfEnetJ7uBSmZWCjBNxdvv9HEC5nsW4wDV7wu6WnhWan,1533,21974,-20441,620
2022-01-22 12:29:33-05:00,8690,EBnMKbaJEjNXjt14hxssR8wd3Ua37McPQxUZnKxxbgtd,FAALK2LRFhg98ezHEBFrgrzxTg66eZpmo7ctKDEck8q5,True,2338522,584630,3648,1824,1824,HfEnetJ7uBSmZWCjBNxdvv9HEC5nsW4wDV7wu6WnhWan,145941,2025747,-1879806,624
2022-01-22 12:29:40-05:00,8691,GwYr2DmtMVLWxVz6kVSXR6rvxL4x3DXtvNC7taswSWHN,2otMHa7JT1twPSSN6XF9fqGkKrEK8nnuMFZG1TtAgFQk,True,9070,2267,14,7,7,3zqXX6kzhkbW3d4TwD2CNjMRwxTbREXySekvq37kfCNk,567,8465,-7898,625
2022-01-22 12:29:46-05:00,8692,96StvqZyFUPtyMr4o9s7K4V29RSNyRpVi76vNwxG5rUf,GZKXFSFq4aGiTaqovtxqNCCVGkAFNXPh4Hep1ZMwdZ8g,True,118060,29515,184,92,92,HfEnetJ7uBSmZWCjBNxdvv9HEC5nsW4wDV7wu6WnhWan,7371,181660,-174289,624
2022-01-22 12:29:47-05:00,8693,B4Uc39nKzz9wBRQsCkMR4A7RwTJ8rSuwpR6EQn2AesRb,H49bGZgatRZVpj6QufZRVgYrQtH7LpdbiqKBs23151m,True,132302,33075,206,103,103,DddJ7EWCmYEEZETCBNgAUSg81Ls6fZtiAaY5ekJ5sXx1,8243,209320,-201077,623
2022-01-22 12:34:07-05:00,8694,2mfcg17QocKKvDcqDH88TwxHRiS8dAQiJAGoAh1brns9,8aQLELBgaA9eXsxSciMjxWv8B1hpbUPfLwqVjEnasZbe,True,13845230,3461307,21560,10780,10780,HfEnetJ7uBSmZWCjBNxdvv9HEC5nsW4wDV7wu6WnhWan,862409,6021519,-5159110,622
2022-01-22 12:34:09-05:00,8695,GNkEoVMpNAgfyDBZ986MR9BEVc485xpLuZWwSCyZk5zJ,AT2eiaMyZNHZGqgTdie8QjLWCTrWSdkRmQxU2vZNgtDs,True,4979682,1244920,7755,3877,3878,HfEnetJ7uBSmZWCjBNxdvv9HEC5nsW4wDV7wu6WnhWan,310214,1833295,-1523081,622
2022-01-22 12:36:39-05:00,8696,4SQQdHTJUDv8taPXQRvEVJpUu91iCWQsv9su8tfehaQG,33CJXj1pmmatAofRvgt5in9E6SLEuy7tq4jqSwnUWP2A,True,205181866,51295466,320779,160389,160390,HfEnetJ7uBSmZWCjBNxdvv9HEC5nsW4wDV7wu6WnhWan,12831190,219375938,-206544748,625
2022-01-22 12:36:45-05:00,8697,GQviUdocJ1s4FsVDDexanvo5yQWRZgwwkGJBCg7TMtJC,HAX4VAKgQpKtm1149iRgtzvUaUkiXWcA1bJ9ERu6tXkd,True,6868854,1717213,10695,5347,5348,3zqXX6kzhkbW3d4TwD2CNjMRwxTbREXySekvq37kfCNk,427803,2930127,-2502324,622
2022-01-22 12:40:12-05:00,8698,73PpLzJmAimmqtjGpRcYHua8t6wx3gYiiXFvQxnSDMJV,CRCpLcS8LNKX22co94spJBXEes9Fnh5rYBvbVEte4JXA,True,156027231,39006807,243999,121999,122000,DddJ7EWCmYEEZETCBNgAUSg81Ls6fZtiAaY5ekJ5sXx1,9759991,132394102,-122634111,625
2022-01-22 12:40:12-05:00,8699,8GdYhwX26GRmVfGFCbJ3MJrH1UdneN2FNRUexhLsqprN,DpUTHSVucDPyCWoLCdpm8EFRZFiKL88tmnSiWG2TRpS8,True,1192245,298061,1857,928,929,HfEnetJ7uBSmZWCjBNxdvv9HEC5nsW4wDV7wu6WnhWan,74312,1131796,-1057484,623
2022-01-22 12:40:12-05:00,8700,CEtpqFD4BbeiNfaXyLLYEapY2mWgE26H5q6H34tWwRuD,BVqRyqwGFPzSkk1H2finiyfaL3LScbEiQGk3mihirxqs,True,979081,244770,1531,765,766,DddJ7EWCmYEEZETCBNgAUSg81Ls6fZtiAaY5ekJ5sXx1,61269,918878,-857609,625
2022-01-22 12:40:12-05:00,8701,Fw2e6jxKVeFcJSe9MyVhSz3dUdJQLs3XULHrT1mtMU9U,591U5bexgLRJXygtK5fpCRXcZEq89KgewFTdfPkti8bY,True,157296892,39324223,244874,122437,122437,HfEnetJ7uBSmZWCjBNxdvv9HEC5nsW4wDV7wu6WnhWan,9794992,133405858,-123610866,622
2022-01-22 12:40:20-05:00,8702,3MEiFqy4F9nBW8gHxvGjv7norSBHwxhbzzNKngPk1RHq,2tcsJ4NUJegcEfHNwWPh979yKjKmq568CpNm5iWGbuoR,True,814540,203634,1274,637,637,DddJ7EWCmYEEZETCBNgAUSg81Ls6fZtiAaY5ekJ5sXx1,50968,545734,-494766,625
2022-01-22 12:41:09-05:00,8703,9rgrRAMcGSarfz8xXckw1LjkemMwwjzJLApPjpfY2XZ3,BRtNdDDtCiNDYDERZTBCefUiYvjShucRX1hxEBLyeggT,True,1049163,262290,1641,820,821,DddJ7EWCmYEEZETCBNgAUSg81Ls6fZtiAaY5ekJ5sXx1,65671,1002635,-936964,625
2022-01-22 12:41:52-05:00,8704,GcjcaWoMUcGkLaJBx3svxtzwGNn5SLcFrwaLqnpadUZY,Ep9sDjTMMasVjKdshsE88uk3mWYkKuMTVRooVJWvCq9F,True,20203760,5050940,31592,15796,15796,DddJ7EWCmYEEZETCBNgAUSg81Ls6fZtiAaY5ekJ5sXx1,1263715,19292705,-18028990,625
2022-01-22 12:41:59-05:00,8705,4yhW5mBsFVNgQ5QQc2Yg65guctPsTSXcERbzmYM6rdnL,5uJnMZ6DWA9bMSvHvS5zomwtt1sv7YCWq3GDJh77YC3q,True,1307094,326773,2044,1022,1022,DddJ7EWCmYEEZETCBNgAUSg81Ls6fZtiAaY5ekJ5sXx1,81791,1251927,-1170136,625
2022-01-22 12:41:59-05:00,8706,5iRLEmB6qBHqkJBPyyubnd9f1TpRr4EY8BTxuHUREeLB,GkY73KL6HJ4ycdggFtYWALBgmTRZVCx66P2ZJ7E8ENwC,True,1134331,283582,1774,887,887,HfEnetJ7uBSmZWCjBNxdvv9HEC5nsW4wDV7wu6WnhWan,70983,1083569,-1012586,625
2022-01-22 12:42:00-05:00,8707,HZSJVNb6g4o52N7pAJCLkGjur8evF5Ex1sAx7uUxUDdm,8LQHKhXStrwcd6f4AxaTVcrGdYpGjQz8vWf5JXsAzcsp,True,1527832,381958,2388,1194,1194,3zqXX6kzhkbW3d4TwD2CNjMRwxTbREXySekvq37kfCNk,95526,1461169,-1365643,625
2022-01-22 12:42:00-05:00,8708,95urWGJ4HN1bTarbDi8Dpj4K4ms7dovs8gwaYdaSLC6e,2THhqxjhXjp2Zui9ML2MzAbGN4dsfa3dkdqzC8LYhnbQ,True,1944762,486190,3037,1518,1519,3zqXX6kzhkbW3d4TwD2CNjMRwxTbREXySekvq37kfCNk,121495,1796092,-1674597,624
2022-01-22 12:42:00-05:00,8709,E8iuHK2DErFnMAYfWmNoix4jVb4WDG8Sc41hBycLUxbd,77Zoru23JmnK5EJ8eURonQoEpJcLP4edabjD8MR8NKdX,True,20605451,5151362,32201,16100,16101,HfEnetJ7uBSmZWCjBNxdvv9HEC5nsW4wDV7wu6WnhWan,1288047,19699173,-18411126,625
2022-01-22 12:42:21-05:00,8710,B5CTBTggmGFvGFSunjbB4C9tLKcYcULehmEiEXRihY2J,FX3ebF8P89rZBWfR74PDWUzxnLuDkUDgGcPYCBD5sMUG,True,21449873,5362467,33537,16768,16769,3zqXX6kzhkbW3d4TwD2CNjMRwxTbREXySekvq37kfCNk,1341492,11928034,-10586542,625
2022-01-22 12:43:26-05:00,8711,7tDiadLeMrob7yD6R5SDskYn41tnQZVPjEc6W2vv6irK,AHZidccE9ERBcipuRQ2iGM9kHRpTnty7UNuYTFurvXB7,True,32487778,8121944,50596,25298,25298,HfEnetJ7uBSmZWCjBNxdvv9HEC5nsW4wDV7wu6WnhWan,2023873,14597616,-12573743,622
2022-01-22 12:43:26-05:00,8712,2niazdR63iWLyZ3ABWZVAnJiEjVyDyLGo4jZ6wh3j2Zz,4RvU5UtyE5CqMStPciiCTdhYCdaUUfdKSYS5nkATs1qn,True,6949651,1737412,10779,5389,5390,HfEnetJ7uBSmZWCjBNxdvv9HEC5nsW4wDV7wu6WnhWan,431195,2971375,-2540180,620
2022-01-22 12:43:26-05:00,8713,6k9unyyhVTrGhAhBrFjgumRfBtKFRBrVaeWtYB56LgEg,3n9VYUH53fxmwFwdYKT9xAZYDzjodhMsJ5iGAoJTqCt4,True,6950282,1737570,10825,5412,5413,3zqXX6kzhkbW3d4TwD2CNjMRwxTbREXySekvq37kfCNk,433012,2972560,-2539548,623
2022-01-22 12:43:26-05:00,8714,GHn96Ev7UmKJWqch3H3wzXpRT7qLg5FBuSBJAATVED1f,BXBSUddfz9MThXqk4517M7YVRDGdTm4pC6G4ipT69TMV,True,5539659,1384914,8610,4305,4305,HfEnetJ7uBSmZWCjBNxdvv9HEC5nsW4wDV7wu6WnhWan,344404,2358641,-2014237,621
2022-01-22 12:44:30-05:00,8715,6Bq55LtGCEeGqh4JrFLCmmGc2iJfTTBJixivqH78aGSE,DSNrCgWJeNe2P9tAQu5FvCueTzNKDKds7wzuwTQSMRG,True,35081,8770,54,27,27,HfEnetJ7uBSmZWCjBNxdvv9HEC5nsW4wDV7wu6WnhWan,2192,30948,-28756,624
2022-01-22 12:44:30-05:00,8716,4nhdidD6SASYzwZ7mUnWKyP4xyWXhdBe2gp5F4qDtLrL,HLk6YPhVidsn3i8HfoASvoim1ztxb4bi8JnioiyvorpV,True,7461720,1865430,11644,5822,5822,HfEnetJ7uBSmZWCjBNxdvv9HEC5nsW4wDV7wu6WnhWan,465766,6924528,-6458762,624
2022-01-22 12:45:35-05:00,8717,C1tcxAjMzZaFVcF2ke2nSyiCjcLBwsz5yKXShy5MB14h,GYkrJj2zHVZuzPC45MbuevYkRJHdeL4Sqj9SWqZfUdiE,True,69476231,17369057,108498,54249,54249,HfEnetJ7uBSmZWCjBNxdvv9HEC5nsW4wDV7wu6WnhWan,4339927,63736911,-59396984,624
2022-01-22 12:45:35-05:00,8718,DD1a8rMoUCwmEiLKRN43VpdqL8Qgfr5yi92ejQxDVRMo,3vMJVNAuyRhM9jkaEZARhwbR6MerR5UmcgoZ9c5bs1VS,True,24299529,6074882,37984,18992,18992,HfEnetJ7uBSmZWCjBNxdvv9HEC5nsW4wDV7wu6WnhWan,1519395,23239634,-21720239,625
2022-01-22 12:45:35-05:00,8719,EPWsutEpgpcz776maq552k8QhDKdmkSfAED5E3jgpTdY,CCwGZYDvqoHEBBtSSieAJgy5e3k4jYrpjyDffypwnWxu,True,55215859,13803964,86097,43048,43049,HfEnetJ7uBSmZWCjBNxdvv9HEC5nsW4wDV7wu6WnhWan,3443900,50866601,-47422701,623
2022-01-22 12:45:36-05:00,8720,43wwd6zLB8yKfXEu7rtbeDFhKBuxFR66MnyhTKW3zqa3,A9t6AMvVNenwWymz3QMtdUuuGYjjTPLaA9bhRjTzNY9h,True,20694112,5173528,32342,16171,16171,3zqXX6kzhkbW3d4TwD2CNjMRwxTbREXySekvq37kfCNk,1293698,19791616,-18497918,625
2022-01-22 12:45:36-05:00,8721,4eaXYcx5ayhTq9TmmQFgLDjy6p3z93txUN97v8PTSh1J,J3vgUnjDUy5ngrmrs6FwpZTexxJNxXM1UjsHvsgw9g9y,True,1328249,332062,2077,1038,1039,HfEnetJ7uBSmZWCjBNxdvv9HEC5nsW4wDV7wu6WnhWan,83111,1268989,-1185878,625
2022-01-22 12:45:53-05:00,8722,Gfe4UgUGqvzcehSbETrWwLRAcqzFnkTrs6vJx8h6kTxi,7exMQ8sLti4Pmb2ZQtZhyuWRuQ6pq7XSXL9sCcWTqCvF,True,107945083,26986270,168866,84433,84433,DddJ7EWCmYEEZETCBNgAUSg81Ls6fZtiAaY5ekJ5sXx1,6754656,101189130,-94434474,625
2022-01-22 12:45:56-05:00,8723,8nXbrdjjaHB73CRPRenGEQj73wbtEFGDwXsehRGMhsap,43pvdcJ6f27wz94D6ZboKwRJYbyvYCrjsJhYsvk7LJCM,True,329087,82271,513,256,257,HfEnetJ7uBSmZWCjBNxdvv9HEC5nsW4wDV7wu6WnhWan,20544,199716,-179172,624
2022-01-22 12:45:56-05:00,8724,6aW9dhnTNerVd1MPv5GrcYqgjVPE9LsNCGYSJSrNdgS8,8kmJu2UxTk2T37sqxDSrf6pDWhJZRxfRdJB7DLeoWddJ,True,43972602,10993150,68779,34389,34390,HfEnetJ7uBSmZWCjBNxdvv9HEC5nsW4wDV7wu6WnhWan,2751190,39829912,-37078722,625
2022-01-22 12:45:56-05:00,8725,28YQqynu5oRud5xEcsDvAaGhJhgpiVJSTNeMwkrbpbyv,9zYqRWiRatbohCdBfV3PrAxp8v1kwgbvV9ta4RJRRp68,True,54089640,13522410,84322,42161,42161,HfEnetJ7uBSmZWCjBNxdvv9HEC5nsW4wDV7wu6WnhWan,3372911,49846065,-46473154,623
2022-01-22 12:45:56-05:00,8726,43EtYHdVkdBxHTtFR3QWVgvCKj1SqsAf7xLY2yphsv1x,8WJbP4mVJWYuN1dVzHpRg7YR2nBELB4Krkq8Zch8sp4g,True,1623726,405931,2530,1265,1265,HfEnetJ7uBSmZWCjBNxdvv9HEC5nsW4wDV7wu6WnhWan,101216,1439303,-1338087,623
2022-01-22 12:45:56-05:00,8727,8xjstKJD2RopRxxRP8JbMYRmpBKgSZivMFRXXRZ5syPh,HUfevkvBsm5SDpxnZ4NBD8Re7LvqBQLrx5UWXCeYTBgK,True,1966555,491638,3070,1535,1535,HfEnetJ7uBSmZWCjBNxdvv9HEC5nsW4wDV7wu6WnhWan,122829,1817435,-1694606,624
2022-01-22 12:45:56-05:00,8728,446VESPwhh16pG3VcpgraT83MoqWy87qgU36mKZC8BsW,SmUPkPpnnRfSH3tcKUnbpK6HHNJtLfvMiUWk9eUwkNy,True,54865084,13716271,85603,42801,42802,HfEnetJ7uBSmZWCjBNxdvv9HEC5nsW4wDV7wu6WnhWan,3424127,50577209,-47153082,624
2022-01-22 12:45:56-05:00,8729,HpRYrL8HzCPaBJTLFgZmYg2aXBnBQUpf1mikVkzkY56z,8DzHRd8qWcEjnX6cefwYtgRGpQJUaw9QPjyfAsN7j33r,True,13544931,3386232,21175,10587,10588,HfEnetJ7uBSmZWCjBNxdvv9HEC5nsW4wDV7wu6WnhWan,847037,12612085,-11765048,625
2022-01-22 12:45:57-05:00,8730,5FgPU7KpsDnx4Xc1UdQoLPR7MDd5cBkJXW2Q8ctopMZR,9GWzAZFVfTY8WjTYvDAE2YcAjgeKiDXgToK76KBZF7Rv,True,1755280,438820,2740,1370,1370,3zqXX6kzhkbW3d4TwD2CNjMRwxTbREXySekvq37kfCNk,109633,1620269,-1510636,624
2022-01-22 12:46:28-05:00,8731,7ayTm4uC5VbtMt9w6g9tFban4fYVwbqCzJZpiFMjmBiB,BvidnEZHHtXVhtgv4qFKThEaFZsFmyAuDVqZQwMppjSg,True,2991924671,747981167,4676941,2338470,2338471,HfEnetJ7uBSmZWCjBNxdvv9HEC5nsW4wDV7wu6WnhWan,187077675,1789688004,-1602610329,625
2022-01-22 12:49:35-05:00,8732,8YMEydGnQH9W5AEXFGquFkb1bcf3PcxiMvYBSMPXKJyQ,3CmWH8eYtkmHNisqMmMBLff6C6z6ZcSj38KoQ34DPUE7,True,1041890,260472,1628,814,814,HfEnetJ7uBSmZWCjBNxdvv9HEC5nsW4wDV7wu6WnhWan,65125,923043,-857918,625
2022-01-22 12:49:35-05:00,8733,6kt64nJRnYaWMi9GbpZaUuhbToAVRd7FUMTGASAAJrve,2Sdxv9ZtogNcVbJwBPxKmVjwAiKyX5GHEfnRmFcydQ1G,True,154518300,38629575,241650,120825,120825,HfEnetJ7uBSmZWCjBNxdvv9HEC5nsW4wDV7wu6WnhWan,9666038,131437090,-121771052,625
2022-01-22 12:49:37-05:00,8734,2AAWghW6BUAFBtF3R6hB9uoqMc5oUDkU8FTd2JrXKema,798cfEUZ2YhXwNTNjXMS4Z2J8gAHaK4zZwpMkq2HzWWM,True,7145574031,1786393507,11160473,5580236,5580237,3zqXX6kzhkbW3d4TwD2CNjMRwxTbREXySekvq37kfCNk,446418958,4463548979,-4017130021,624
2022-01-22 12:49:39-05:00,8735,2DHhfXSzcuSwsKfAYLMuWuD17w84mCwNer9fcBNLTpSc,89BVfDycKjdSkQzFVqCXd5c16DntdND7WsqoZtCafYFH,True,63685059,15921264,99462,49731,49731,HfEnetJ7uBSmZWCjBNxdvv9HEC5nsW4wDV7wu6WnhWan,3978500,58934853,-54956353,624
2022-01-22 12:49:40-05:00,8736,4qWzk4JP2gEsTP252Y4SJrjSmfRBxDfE4ZdbPmwavfb2,CAgDhCNVyy61FG2YPMnm9zxgY56s2UqPhvssH5G1LjXP,True,141955262,35488815,221779,110889,110890,HfEnetJ7uBSmZWCjBNxdvv9HEC5nsW4wDV7wu6WnhWan,8871171,120149267,-111278096,624
2022-01-22 12:51:45-05:00,8737,HxhVxMpFpKzeuC6Z6CpsuUhPHdHUzvpMNYJ8LpQ3NYCp,8KyiipC39iU15zVErVvj6hdhbv89STsexrB8dVw3RcLs,True,1394273,348568,2181,1090,1091,3zqXX6kzhkbW3d4TwD2CNjMRwxTbREXySekvq37kfCNk,87254,1331765,-1244511,625
2022-01-22 12:52:30-05:00,8738,DYCYiQFH9QHzCo3eAw1pFoDu7pzwFMo1E2WDZjVFRz5w,CPh4FWsGak1kd1WFEH9qBjNhnun3R2tHtZA57zW8ugn5,False,1207412,1207412,60362,3018,57344,3zqXX6kzhkbW3d4TwD2CNjMRwxTbREXySekvq37kfCNk,60362,1090995,-1030633,499
2022-01-22 12:53:06-05:00,8739,36ByQojnxEckWdQTjqHfxKqCx9yjqWQsPsZyqaN72UWR,AZoirtS1fjX61agRM64tqThVinnJTh3BWgiHyNHPTgZP,False,19367,19367,962,48,914,HfEnetJ7uBSmZWCjBNxdvv9HEC5nsW4wDV7wu6WnhWan,962,18406,-17444,496
2022-01-22 12:53:06-05:00,8740,cG5VSSaBpjNdRLMQT7dmotpcWRTfdmJZYdWsrzNzRTE,5RESxV6aZenjAdaqw1jxoYSGttpLrNuZiRJy2WeLAVJv,True,65309659,16327414,101699,50849,50850,DddJ7EWCmYEEZETCBNgAUSg81Ls6fZtiAaY5ekJ5sXx1,4067965,41849155,-37781190,622
2022-01-22 12:53:06-05:00,8741,9KD2AifD5wFD4QkHYuawXbJgLWHrfj2QPF3fT8jhGVA5,Ga9gAqmkuHbqrr31sUFPqa1xa5WNxLWJWGPUaMxQqLdj,True,32136,8034,50,25,25,DddJ7EWCmYEEZETCBNgAUSg81Ls6fZtiAaY5ekJ5sXx1,2004,30737,-28733,623
2022-01-22 12:53:06-05:00,8742,72L76qDRMK3M7X52zuuB9GVyvFFLDBZwFMpVjWjghXzA,4m2ZVuemUctu1edv4YJVAcjXzKwpbCmBujzoUmLDeA7h,True,11697098,2924274,18111,9055,9056,HfEnetJ7uBSmZWCjBNxdvv9HEC5nsW4wDV7wu6WnhWan,724451,5399250,-4674799,619
2022-01-22 12:53:09-05:00,8743,9otCHuzKcxUCC4EgPJkio8Df5gXWB6DtZQnZvWtPfsh6,8cNPdP8rA9sBpcKpmCNcp4W2AYonYdFNoyVmboT6y1Bb,True,217063102,54265775,339197,169598,169599,HfEnetJ7uBSmZWCjBNxdvv9HEC5nsW4wDV7wu6WnhWan,13567916,81508994,-67941078,625
2022-01-22 12:53:19-05:00,8744,AUH6YGBV8tDVX1E1WTo92Mubfx1DGsqfGeyUBqxo4fSr,33QZgMwmW32WuvmxD8XNbmF9ea88bLe3YTtNwHV73Wwu,True,6892240,1723060,10707,5353,5354,3zqXX6kzhkbW3d4TwD2CNjMRwxTbREXySekvq37kfCNk,428317,4512068,-4083751,621
2022-01-22 12:53:30-05:00,8745,H3394S5wdbwXB4scjGAY8NsXxCdGy1Xebct18s42FM1K,Hz84L1EquzhCvBJP75ScKug46hYGdNMVNH16AdG4y5D8,True,1548334,387083,2397,1198,1199,HfEnetJ7uBSmZWCjBNxdvv9HEC5nsW4wDV7wu6WnhWan,95910,1116021,-1020111,619
2022-01-22 12:53:31-05:00,8746,FsMiJiJZibohKoV5QRisWCjzuFd86xSxFb4m73AQmu93,7p3TSKBaG9SV2YNDnhutQKacPKpTTmgsEfzmK51t6sYb,True,6881086,1720271,10669,5334,5335,3zqXX6kzhkbW3d4TwD2CNjMRwxTbREXySekvq37kfCNk,426764,4446705,-4019941,620
2022-01-22 12:53:33-05:00,8747,4MSyrHopFkuaCEEvLAUV9cJfVre6cLAx5sJF5LEMSCTX,6HhLHoswuDKrcixShWCDcquW6PgmbS5FidEnkM3bwuJQ,True,1695131,423782,2646,1323,1323,3zqXX6kzhkbW3d4TwD2CNjMRwxTbREXySekvq37kfCNk,105877,727130,-621253,624
2022-01-22 12:53:33-05:00,8748,4Eh2J8pz6nSz2E2BaPSMbDNhEovGA4QRmNtzAJPw9ZRi,CrHeEQC5KpQFLGhz2EpLYWgk7kWsqLPvEfLsSQvUxv61,True,23252247,5813061,35974,17987,17987,3zqXX6kzhkbW3d4TwD2CNjMRwxTbREXySekvq37kfCNk,1438980,15686793,-14247813,618
2022-01-22 12:53:33-05:00,8749,3Xbsek5MsEGoWr3G9yhuohREr26B2vSQcjqXdspTFHta,2rPxkUiMo9wGDq8EvAiwY3ngRpKmL223cBWWNTYoBmFp,True,2585865,646466,4025,2012,2013,HfEnetJ7uBSmZWCjBNxdvv9HEC5nsW4wDV7wu6WnhWan,161014,1497472,-1336458,622
2022-01-22 12:53:35-05:00,8750,3VdSA9CED9f5swRwHX2U15U7J6Muaq8VPnCNy9CaGDHe,2YYstfnfdYic5NWmEbcUEHpccNUVd1EhuCkExvMsoMk8,True,165288,41322,256,128,128,HfEnetJ7uBSmZWCjBNxdvv9HEC5nsW4wDV7wu6WnhWan,10243,156926,-146683,619
2022-01-22 12:53:42-05:00,8751,3R2wxFQwjCqUwwxJmp9tNrT6osYFpB5gczq2QYik6QYm,7At5Ej3ZsynfWr56FYrd4P4Y6UtD8FHA4gCFB8TaAyaG,True,1326602,331650,1994,997,997,HfEnetJ7uBSmZWCjBNxdvv9HEC5nsW4wDV7wu6WnhWan,79770,1271023,-1191253,601
2022-01-22 12:53:43-05:00,8752,HZJyrD4eqM4nKnyRh2JAs1sC2TaJxFhNPixBdK7PLMuS,Hycz71z4tEsKUogJnefT2GN3MPCLdTJdv9B6T82Ngw2u,True,5707796,1426949,8584,4292,4292,HfEnetJ7uBSmZWCjBNxdvv9HEC5nsW4wDV7wu6WnhWan,343361,5510443,-5167082,601
2022-01-22 12:53:43-05:00,8753,CygwJ5Z1ZP6xfjN1ZGH7yw8b2oYvf6JTpenXx7A5yFdt,59VKgJtBCTb3Pji7BWtqttisBYVVCnWtyEn5Eba5r52Y,True,23043505,5760876,34578,17289,17289,3zqXX6kzhkbW3d4TwD2CNjMRwxTbREXySekvq37kfCNk,1383147,20522941,-19139794,600
2022-01-22 12:53:43-05:00,8754,AECUZGm5DjFvbLZEUYhepSPg1Wa7hBjxF9e7ZRBzRPhm,Ar7e1iLKAqa54QiQnXifvnETixDZT1T8KL5YWJA8Ykv1,True,1606229,401557,2441,1220,1221,HfEnetJ7uBSmZWCjBNxdvv9HEC5nsW4wDV7wu6WnhWan,97675,1537340,-1439665,608
2022-01-22 12:53:43-05:00,8755,DE8c5VWwgCqQnUMSyMZEbKazQAsSjY52L85yojCr57X5,6ycUU1Tc7HG3J8hE6jwkRFCkdbEqyU95ZKY6HbfnYcGo,True,4355,1088,6,3,3,3zqXX6kzhkbW3d4TwD2CNjMRwxTbREXySekvq37kfCNk,258,4087,-3829,592
2022-01-22 12:53:43-05:00,8756,7afnF1MkAootZGWc7zsMVLpBuve83hGmvAHkfmwgsq5A,HKdJE8bReznq1Qxqd5iZ4nWQGCk62Vo5TpkRD51bpbGp,True,1361752,340438,2051,1025,1026,HfEnetJ7uBSmZWCjBNxdvv9HEC5nsW4wDV7wu6WnhWan,82056,1304653,-1222597,602
2022-01-22 12:53:43-05:00,8757,4HDEN1Thxm9RbdE8pXnLP4QksVdXfp7Fa9nAnMRzr7oR,8gD3DbF6VhPTCgk3A4G7iA4f3DPH598Hj7TRJ2FebMCq,True,1713871,428467,2676,1338,1338,HfEnetJ7uBSmZWCjBNxdvv9HEC5nsW4wDV7wu6WnhWan,107050,1580324,-1473274,624
2022-01-22 12:53:43-05:00,8758,EmXaq1sxmAZUiwYW6LXpKtKFZXu5MzQ3sK4MEAojDK1h,HuAsa5G2wJi8Ah9stxEmggwcB5zW1QjBsP3Ndgke7r8X,True,1770560,442640,2644,1322,1322,3zqXX6kzhkbW3d4TwD2CNjMRwxTbREXySekvq37kfCNk,105783,1697655,-1591872,597
2022-01-22 12:53:43-05:00,8759,Go3ne58krEsFsZ5yu9EBT7od15VCYmtbs1KhumRMTiXS,HCvwQ7HjmmeDXrguZQPrAbJjcCJzHqVZK2JMSFkFDWfe,True,454700,113675,708,354,354,HfEnetJ7uBSmZWCjBNxdvv9HEC5nsW4wDV7wu6WnhWan,28341,453422,-425081,623
2022-01-22 12:53:43-05:00,8760,Hqzz5RdbkkmMPCVdxF3Q3sLuh7XVJHEwAP6zpz7pCwTj,TNwXSETgrJGM9S5zbBY3mMWKbPFskbKjPAhBrWFNfuK,True,1182118,295529,1760,880,880,3zqXX6kzhkbW3d4TwD2CNjMRwxTbREXySekvq37kfCNk,70419,1132225,-1061806,595
2022-01-22 12:53:43-05:00,8761,9WRDBHzD4aNHw5qvrhc6nqXCBLA5D7YYP8TvSrLksXd6,GwxWNmv9XDkqQsx7DfCMccFjVik8asPnFU9gtnb4UVx,True,1026159,256539,1546,773,773,3zqXX6kzhkbW3d4TwD2CNjMRwxTbREXySekvq37kfCNk,61849,983311,-921462,602
2022-01-22 12:53:43-05:00,8762,4cNmhgaMic1xBiaDJ6phrQuXmm8WfF1qjyYMqZcKG4c9,43vgfXiLTtcs1bkrcDar2iz9M6RMbGqbA6BMkBHdh7T4,True,1242965,310741,1860,930,930,HfEnetJ7uBSmZWCjBNxdvv9HEC5nsW4wDV7wu6WnhWan,74405,1199761,-1125356,598
2022-01-22 12:53:43-05:00,8763,EAUFD16wab8qRMJ4H6updHGt4xFqgRCDeRHVCsLCTSTL,8vkfYSyCyBY9g4TZrp52jUcQj6udy9xAaA4fioRE2RXx,True,794859639,198714909,1223707,611853,611854,HfEnetJ7uBSmZWCjBNxdvv9HEC5nsW4wDV7wu6WnhWan,48948301,420199964,-371251663,615
2022-01-22 12:53:43-05:00,8764,AnqmmhzVDCNq4dE4VvYkPDGB9nMXr4ykqvUhwxhR21pd,CcMeofCvvrDaBzgAGzoPwRt5eQmzdB1z2Y6UiwGqhFbG,True,15278214,3819553,23882,11941,11941,3zqXX6kzhkbW3d4TwD2CNjMRwxTbREXySekvq37kfCNk,955313,18088465,-17133152,625
2022-01-22 12:53:45-05:00,8765,AiLCB8xw3k5FXdJE1T42PLFhHrz1bLTKpNekR61a915N,HB7CNWxLipWAc6MPGq9wV4TT7AYjiELA5T3onYeVqBbU,True,26667789,6666947,41252,20626,20626,HfEnetJ7uBSmZWCjBNxdvv9HEC5nsW4wDV7wu6WnhWan,1650097,25760574,-24110477,618
2022-01-22 12:53:45-05:00,8766,6X5por58mMECmNZQEWpo8M8aA1eHJqr5LNeV9vC7GW5e,DPB2C5UB2Ls1kNzbs1GP33junQvhUyFJWP75RoYjqByn,True,70700767,17675191,109463,54731,54732,HfEnetJ7uBSmZWCjBNxdvv9HEC5nsW4wDV7wu6WnhWan,4378540,108954152,-104575612,619
2022-01-22 12:53:45-05:00,8767,68F35fonSGS1P6LMYmAmeoM8kC6Z78NabMqYLeCZr9GJ,8apmWSZdS8s1ScoNVj4AvSJsbQCj1drU3HL74khuANT2,True,1410316,352579,2128,1064,1064,HfEnetJ7uBSmZWCjBNxdvv9HEC5nsW4wDV7wu6WnhWan,85143,1349793,-1264650,603
2022-01-22 12:53:45-05:00,8768,7jvKp6onXyWgwsFrFWj4hYTXJsYYD6ot5mn6rPFuJriy,J7N6HiozevJVTiY9hDEUs2ud5BwT5QSE7wnMBS1w5ie2,True,775351,193837,1201,600,601,HfEnetJ7uBSmZWCjBNxdvv9HEC5nsW4wDV7wu6WnhWan,48040,701600,-653560,619
2022-01-22 12:53:45-05:00,8769,ANXYsUNpZ34dBt7cp6HEE7oi2pTKsbj7B5TeFHKPbHBU,2pqeP4fuMREosHcfWUecEBssp1GM4isihNjn7ALUD51d,True,1614100,403525,2495,1247,1248,HfEnetJ7uBSmZWCjBNxdvv9HEC5nsW4wDV7wu6WnhWan,99829,1544740,-1444911,618
2022-01-22 12:53:46-05:00,8770,69byqtDPmgEY1NqKBCR95CEPVHRUxgbNW9Y4P4HjQ7ND,E47T4q4zMGzNL6vDxgWdLn3EQbW3WfVryr8Jsymy1hAL,True,2189892,547473,3389,1694,1695,3zqXX6kzhkbW3d4TwD2CNjMRwxTbREXySekvq37kfCNk,135576,1904846,-1769270,619
2022-01-22 12:53:46-05:00,8771,9QZvB1Gqhk5PKt3MoJMjZL3FaU2bTbTDcVw3nF316zh7,DGJWGr9RCWkzdWn21mWG7NyUN8uuvSQbA53HojFJe1rH,True,17079528,4269882,26410,13205,13205,HfEnetJ7uBSmZWCjBNxdvv9HEC5nsW4wDV7wu6WnhWan,1056419,15730481,-14674062,618
2022-01-22 12:53:46-05:00,8772,8VQ21PFXdHBNmiZiF18LyGvsRSpr13vkyktfembNCe3m,5exbVC7vaGFeHEGAx7epYfMaU932QafqzfhFm5FKAq2H,True,1199768,299942,1841,920,921,3zqXX6kzhkbW3d4TwD2CNjMRwxTbREXySekvq37kfCNk,73644,1148011,-1074367,613
2022-01-22 12:53:47-05:00,8773,AzLdwyd8Q4V3iMaSwWgvWwQ9nCs7X7YV2YKpd6CH33nP,BYjeXF5YkcJy3mNMbvfHzXTtyjkc4U53hM5tvfERUH8y,True,1318236,329559,2009,1004,1005,3zqXX6kzhkbW3d4TwD2CNjMRwxTbREXySekvq37kfCNk,80360,1261297,-1180937,609
2022-01-22 12:53:50-05:00,8774,2ZX5NexeuZq25mAfBFDrwd44UfKhWgzmSwdhWFmo48c7,CpNnhSqg7EHn9g84gHoo831sVrAe5SkwNaEZAash4CXs,True,8980536,2245134,13991,6995,6996,HfEnetJ7uBSmZWCjBNxdvv9HEC5nsW4wDV7wu6WnhWan,559666,8663368,-8103702,623
2022-01-22 12:53:50-05:00,8775,Dqnxcekm1QfxGQ2FSJ6SjFiwmaQRWEjW9WTJQG4AjEpE,9JiMtjm5AJqngosRg787FiN8NyuBPuAPD2jYpRQkAc1d,True,1727714,431928,2663,1331,1332,3zqXX6kzhkbW3d4TwD2CNjMRwxTbREXySekvq37kfCNk,106557,1654203,-1547646,616
2022-01-22 12:53:53-05:00,8776,BMawc4jLJMER4ryGcwdm27H3MU8JQCiSfwb9onVfYDpr,5ciaGDuaB3rBKvV7MphT2eMkCUxBzWZc7zYXQM7vbQ46,True,7773773,1943443,11581,5790,5791,HfEnetJ7uBSmZWCjBNxdvv9HEC5nsW4wDV7wu6WnhWan,463268,7242727,-6779459,595
2022-01-22 12:53:53-05:00,8777,G8nRLTWTT5aD7q7TcSa2mw7p12GUuHDVq5ev4vyXbdKi,3DmQyungZMK4T1a1PgXh5shBskwP69tTLmZPh7HZ76vh,True,1938267,484566,2962,1481,1481,HfEnetJ7uBSmZWCjBNxdvv9HEC5nsW4wDV7wu6WnhWan,118518,1854565,-1736047,611
2022-01-22 12:53:54-05:00,8778,45AiuRBbmupfwYXqsWwKHtmEWN8XNJDUSHwHL3b6PvHc,CfvwVkxYPP3jqK2dpAvSRFA1513E9ti84mEpYgtkzFUt,True,2254643,563660,3378,1689,1689,3zqXX6kzhkbW3d4TwD2CNjMRwxTbREXySekvq37kfCNk,135149,2083144,-1947995,599
2022-01-22 12:54:36-05:00,8779,2rLWe1XADCU93guPU6WgSW6x56gYNfif9bm11V93mJnv,BEGhQRm3fgSHeBtk2DYrXEBPKPRvS3sHyTNopmoBJxMs,True,10037420909,2509355227,15702918,7851459,7851459,HfEnetJ7uBSmZWCjBNxdvv9HEC5nsW4wDV7wu6WnhWan,628116724,4712727602,-4084610878,625
2022-01-22 12:54:47-05:00,8780,64Diz8zzEv1jDWnBQPTHPpXwaWf7vjM19RyJmkPy1viQ,G8wkGHRHMtT3mvXBkH3zgsKNs8wbpdiPUS17y4cozhkZ,True,360065610,90016401,562465,281232,281233,HfEnetJ7uBSmZWCjBNxdvv9HEC5nsW4wDV7wu6WnhWan,22498615,114011012,-91512397,624
2022-01-22 12:54:49-05:00,8781,SCtptafLHdkTiYC3e9sv853xNnusHLpoMPxTc1zUVC8,2HF9ggN6EbkYGz3Ajj7tB8m5YF3Yj77Vy96DMFSz5C7j,True,6157999,1539499,9598,4799,4799,DddJ7EWCmYEEZETCBNgAUSg81Ls6fZtiAaY5ekJ5sXx1,383957,5473713,-5089756,623
2022-01-22 12:54:49-05:00,8782,HoJ3Re4BmCYKMJx2RUYtoHfg8ncEy3iFqvWJDGKqfMBV,2qg4FMcurNDVRzXYKwpzEYapxFECnAyU2oGmxQCSf3hf,True,1092504,273126,1707,853,854,HfEnetJ7uBSmZWCjBNxdvv9HEC5nsW4wDV7wu6WnhWan,68286,1090717,-1022431,625
2022-01-22 12:54:49-05:00,8783,HRN438yBJSX72GV4E3JYLKpwQcnZXgAoB2VkmgXzEKDE,4jEn7ssEM8ZUjAyaKogEb3uyMmbZJ1a7WGCPNgh1Xfty,True,1195691,298922,1869,934,935,HfEnetJ7uBSmZWCjBNxdvv9HEC5nsW4wDV7wu6WnhWan,74772,979083,-904311,625
2022-01-22 12:54:49-05:00,8784,D6qMab7uevXTa89ssv4BRyHwrw3FYpNimAmX2VH2uf4B,8ZauZ5dAp7kyawkPdxi4mqfempFHubJebfBenQdDektD,True,725674,181418,1129,564,565,HfEnetJ7uBSmZWCjBNxdvv9HEC5nsW4wDV7wu6WnhWan,45196,723694,-678498,622
2022-01-22 12:54:50-05:00,8785,9hB3EPuj4SrSrpAzHvExDb6mzh2vNGGVbj7qqfRjeao4,9725jRXGPRUuo1dijvv8mwzvSu1ed4y5hi9FAQNwb8dG,True,22539550,5634887,35120,17560,17560,HfEnetJ7uBSmZWCjBNxdvv9HEC5nsW4wDV7wu6WnhWan,1404828,21575947,-20171119,623
2022-01-22 12:54:56-05:00,8786,6kscNwPWgKoW7MHRkB4ajxWF3DXLmXjmx9KjDnzikhfs,D49nf79UmrALDKnAa5kf94nZUffzJW7anLm4hVrFG2b4,True,38058847,9514711,59542,29771,29771,HfEnetJ7uBSmZWCjBNxdvv9HEC5nsW4wDV7wu6WnhWan,2381710,33925457,-31543747,625
2022-01-22 12:55:27-05:00,8787,A36aouot1oFLUtswuBUM4EVcis9chKaSJu53MRoPDjab,33U9gpq1RRFMGWDrWa3ezXXkwgBewdAS6QGgGVPtGvqb,True,8875050,2218762,13861,6930,6931,HfEnetJ7uBSmZWCjBNxdvv9HEC5nsW4wDV7wu6WnhWan,554445,5713922,-5159477,624
2022-01-22 12:55:35-05:00,8788,EitU96ThqHErybDn2j1NY6JHkqV1R3mWM1uWH7wYKr1T,2p9eYbLyBqXrhHtRKp1jJb7VGjCmb4LkA6kzqLr1ijet,True,3844318,961079,5995,2997,2998,HfEnetJ7uBSmZWCjBNxdvv9HEC5nsW4wDV7wu6WnhWan,239825,2352918,-2113093,623
2022-01-22 12:56:06-05:00,8789,28JujYG1mbpYSjF7LNqXpup17TXb45VJHhhnFMVXtft2,DAqyVExAtmsovPGrkpkFDxm6T7pKWLztfh9iPjTNDqrd,True,8546482,2136620,13316,6658,6658,HfEnetJ7uBSmZWCjBNxdvv9HEC5nsW4wDV7wu6WnhWan,532640,3728221,-3195581,623
2022-01-22 12:56:06-05:00,8790,G3vArDs7nb18se4xMZ68oMHmTAsYP63x8dfY57jAogwp,EY7J8Hw8jWbryw11CYdPVUSdAoDGGNEfacqghVnJn3JK,True,19982740,4995685,31160,15580,15580,HfEnetJ7uBSmZWCjBNxdvv9HEC5nsW4wDV7wu6WnhWan,1246418,8707578,-7461160,623
2022-01-22 12:56:14-05:00,8791,98pwBGgiSDuwuas6WYW2hc9qUxfULwvNE34aixaxbxXY,BLrjKxekjThtJ9rKtQxs1Y4rZ225EE2Q16VkP9TkThyV,True,5403271,1350817,8398,4199,4199,3zqXX6kzhkbW3d4TwD2CNjMRwxTbREXySekvq37kfCNk,335940,2353701,-2017761,621
2022-01-22 12:56:52-05:00,8792,3JrhHRs4UkkuMoCrQAaAGKZQrWoU72zWArnDGxKFESzH,8yREVE3kMYB7UAwtUDnTDK3egXTuTsN4igtJ5yeHYkCP,True,33849777,8462443,52735,26367,26368,HfEnetJ7uBSmZWCjBNxdvv9HEC5nsW4wDV7wu6WnhWan,2109412,15847289,-13737877,623
2022-01-22 12:57:58-05:00,8793,5NVD6QvomTAD35yNxSFZw4DhF2hCtV8drkbnGhBVtK5y,3JzkyPnREvoFZLL9JZuuDEnee3nuKcrqY3xLuXsmHwRo,True,304110,76027,474,237,237,HfEnetJ7uBSmZWCjBNxdvv9HEC5nsW4wDV7wu6WnhWan,18984,308695,-289711,624
2022-01-22 12:57:59-05:00,8794,F9s8a7Cpiw5dw3a2aNFMofqwyDWNXvDLnSdJzoj1gRiV,GpKsQKJD79KBRWdCTkyi4zX7NaoCWsLUjrKxAwJB6o6s,True,152022,38005,237,118,119,HfEnetJ7uBSmZWCjBNxdvv9HEC5nsW4wDV7wu6WnhWan,9509,99453,-89944,625
2022-01-22 12:58:44-05:00,8795,3oCun4gm3k8sXxVxiYM8okGi8iCXH9LvDkHf9PBQWYXR,E1np1dZ7jUm811ddvy1jQerBwGSYb5BbZWnUHeotvrfH,True,4078734,1019683,6059,3029,3030,HfEnetJ7uBSmZWCjBNxdvv9HEC5nsW4wDV7wu6WnhWan,242396,1553751,-1311355,594
2022-01-22 12:58:44-05:00,8796,2YPm4Ex9mNHX4CuNAUjkrXgoLFaZs6r1X6asYYUnvPyj,BatsG1UFq8ryYuFFcdnDyFWFPUV5P6w2VQpRup5oUey5,True,1571210,392802,2390,1195,1195,HfEnetJ7uBSmZWCjBNxdvv9HEC5nsW4wDV7wu6WnhWan,95639,1451672,-1356033,608
2022-01-22 12:58:44-05:00,8797,6fqbSyhh3PPdgRcLraHb7Jahj9s1oHHeX3SsjNSsGa6t,GpRUow48TYgttdYfsygbgjYQcmHyYjWETUDjDVphEgwq,True,3114440463,778610115,4742835,2371417,2371418,HfEnetJ7uBSmZWCjBNxdvv9HEC5nsW4wDV7wu6WnhWan,189713408,1510584716,-1320871308,609
2022-01-22 12:58:44-05:00,8798,51VhgthsxrRRr2PT5gLnDfL1A3soqwCxA1UzH9vRUGTh,4QCcd7hfsydQ63LH7Lqsp8oVXw7HuKamzQf8VMH6Lgu2,True,2016635,504158,3148,1574,1574,HfEnetJ7uBSmZWCjBNxdvv9HEC5nsW4wDV7wu6WnhWan,125937,1852526,-1726589,624
2022-01-22 12:58:44-05:00,8799,DjbEch16uzdDtujFUeqxjquTTS3JXzEys8e9ogUv3aTy,6N8eKb3kfcbJEUZKZERiFiUR4hubB635D8Sotiji2TU8,True,159160959,39790239,236917,118458,118459,4BnQKPLuE3DMTtxp8MjUBytgnhvxqq3ZTqZHTVZo4JJh,9476695,137169224,-127692529,595
2022-01-22 12:58:44-05:00,8800,GM22yjVoBCzgBcVTT5EcgRhVWiXVV82kSj1dPCbegKWj,CDDy8JmJMwJyx1YAvEPpj8AYxCpngRovf3wWfVzao5Rc,True,781143,195285,1159,579,580,4BnQKPLuE3DMTtxp8MjUBytgnhvxqq3ZTqZHTVZo4JJh,46379,390759,-344380,593
2022-01-22 12:58:44-05:00,8801,Bbd196A866Y9rQWQFt4YGg2R6Jqj7WQGXWPDmrNtPcKf,5gmWk1KwLoRHnhkjxps4Ad6aVk4ZpcfC3McZCWDVCUbu,True,1267098,316774,1883,941,942,4BnQKPLuE3DMTtxp8MjUBytgnhvxqq3ZTqZHTVZo4JJh,75344,1266454,-1191110,594
2022-01-22 12:58:44-05:00,8802,76gdRvg74fv6A9vA8ukNPqWKkmKY6KLAAKBGvbNE2AXC,5n88nkWZiCtWyWPrgfJozgkxtU9HMSggrxHkLoTQp1QR,True,4137,1034,6,3,3,HfEnetJ7uBSmZWCjBNxdvv9HEC5nsW4wDV7wu6WnhWan,255,3919,-3664,616
2022-01-22 12:58:44-05:00,8803,3gdApRPkUGEqmLvTYf4WQJCnmTVmiEU2wCQG26QMpqKf,HpP2yxq3KfYByT4q4p2mLaELnPdW6kmEY9EqZaBZuUNR,True,1512714,378178,2312,1156,1156,3zqXX6kzhkbW3d4TwD2CNjMRwxTbREXySekvq37kfCNk,92487,1391908,-1299421,611
2022-01-22 12:58:44-05:00,8804,APbpwRCB9tfma8yoi8upe633XZBtNwc5zVxXVjLwhg8s,BBwryuZZ8msiSFNmGkh13Wgg1PoSutY2Ftgz8odcxPm4,True,12007671,3001917,18336,9168,9168,3zqXX6kzhkbW3d4TwD2CNjMRwxTbREXySekvq37kfCNk,733472,10661105,-9927633,610
2022-01-22 12:58:44-05:00,8805,DiPSJvnnEwg1En7HJfEsKrUbBgtUf4KzGMyMCZDQSYgp,s8UVC6vPBofuXUS6RW1aQmZ8C35PrC5r4A6ugmvzLGB,True,7342,1835,11,5,6,HfEnetJ7uBSmZWCjBNxdvv9HEC5nsW4wDV7wu6WnhWan,440,5591,-5151,599
2022-01-22 12:58:44-05:00,8806,4eba4qAmwfqmihaYvTWFU9hm4VYrKvNhNywHNyimQJNK,G1DyxJcNQD8u4KGfnwxttyrJMfse1FBAsofioEMdTS9U,True,8204749,2051187,12208,6104,6104,HfEnetJ7uBSmZWCjBNxdvv9HEC5nsW4wDV7wu6WnhWan,488339,7944139,-7455800,595
2022-01-22 12:58:44-05:00,8807,9cRx2sGeqENLrNkvzLSnuD161JshSav6pNg9c7pYLi8f,13ryjUoWLejTLDQKh1m69VFD31onMx8yhzCKhqbeU6s6,True,6088281,1522070,9278,4639,4639,HfEnetJ7uBSmZWCjBNxdvv9HEC5nsW4wDV7wu6WnhWan,371139,5672342,-5301203,609
2022-01-22 12:58:44-05:00,8808,CM95f7KjJuAf1xVTWhu3wrp6BfMz116FbgkxBhcRNs4k,EG55wkH5NcoasfBUYhD5D2dc2uvo11dZ3uTu5wgs4gf2,True,2309657,577414,3432,1716,1716,HfEnetJ7uBSmZWCjBNxdvv9HEC5nsW4wDV7wu6WnhWan,137311,2127472,-1990161,594
2022-01-22 12:58:44-05:00,8809,CcfycMNGUqZLA6EEqtDdftSbQhTL11SYn3LxQqJ23Xgh,Ce7NW9CpB9qGYLf8XUDW49ERutoxtjZSjs54xrzF1fYN,True,2152653,538163,3258,1629,1629,HfEnetJ7uBSmZWCjBNxdvv9HEC5nsW4wDV7wu6WnhWan,130327,1989854,-1859527,605
2022-01-22 12:58:44-05:00,8810,6VBYUiLyQXvvsDmq1vh1oJ5VeA89tGgxtkgFfofc372m,35pyoeRA4duKX7njdYny3KffM2xaxuWUZGRUMQJ5iAiu,True,153253321,38313330,230196,115098,115098,HfEnetJ7uBSmZWCjBNxdvv9HEC5nsW4wDV7wu6WnhWan,9207857,131912010,-122704153,600
2022-01-22 12:58:47-05:00,8811,HUe9LgGBjMeNxGyeCtmXr2XbWVFhHXrvgc2XSqCwN11D,7Z1nR9GgezBXsDX5wW3BBarfMRMZV28rX6MeLRuWtycG,True,23099211,5774802,35493,17746,17747,HfEnetJ7uBSmZWCjBNxdvv9HEC5nsW4wDV7wu6WnhWan,1419731,20503820,-19084089,614
2022-01-22 12:58:47-05:00,8812,BmLG3dPSnL9hL2okZcNVsHgzuWYCrWLdXW8z5Jd2gyvF,HXwhov5Re9b8D4XHULcVSdgBNfbtZ7KMhMRqSTcQTbno,True,3402270,850567,5252,2626,2626,HfEnetJ7uBSmZWCjBNxdvv9HEC5nsW4wDV7wu6WnhWan,210107,3287187,-3077080,617
2022-01-22 12:58:47-05:00,8813,8XcMucCQpWfNtbdCYnKuabk91NQ9wfYp7byk496CwU9n,DLrApDfWcyMqufEFZm9PvddsMoiediT58X8e8pxpnzrk,True,2166827,541706,3220,1610,1610,3zqXX6kzhkbW3d4TwD2CNjMRwxTbREXySekvq37kfCNk,128807,2006122,-1877315,594
2022-01-22 12:58:47-05:00,8814,DakevNrDK5fAUGkLdrWHrsLZm8hEZBqkzUiwJouaDPPY,73nFhK7cygPgwKveXrdXcQVte8n1z3iBe4nmUVTGfFmv,True,89760058,22440014,136980,68490,68490,HfEnetJ7uBSmZWCjBNxdvv9HEC5nsW4wDV7wu6WnhWan,5479229,56327716,-50848487,610
2022-01-22 12:58:47-05:00,8815,4pmhvxJcmebxtqN6RwVb9UbEtxpFXpuVN67Q74W6YAg3,B9fk51SEQmLbMDpQJV15f9gyCZhvEBWRXeLMnnmMqvfg,True,3077,769,4,2,2,3zqXX6kzhkbW3d4TwD2CNjMRwxTbREXySekvq37kfCNk,189,2892,-2703,614
2022-01-22 12:58:48-05:00,8816,CxePQ6ZEn2NCLYgGegSeFX1PyBuczP9j5v131VQSPh1c,9gPk7qTRb5JHqBXRKp3uZfhA2VjQAJDQHTzYXGLUdAUC,True,2344696,586174,3666,1833,1833,3zqXX6kzhkbW3d4TwD2CNjMRwxTbREXySekvq37kfCNk,146643,2155634,-2008991,625
2022-01-22 12:58:48-05:00,8817,6b7Ro2myM4HcUDqyyW9NEqTWPz8BWpH4eNFSQQci37So,7r7j7rSsa6YZcTuRPfs3KP44MVqUA4Q5NeJGmx84wbHq,True,556029,139007,828,414,414,HfEnetJ7uBSmZWCjBNxdvv9HEC5nsW4wDV7wu6WnhWan,33125,553951,-520826,595
2022-01-22 12:58:48-05:00,8818,7dmoK7QPki7R66SPQST4veUgVfnJbVToxxBPZveECiwK,4vh4REBDm5zBDmcjRCD9zNsny1HGneu7B2co4dSJNLL6,True,4168726,1042181,6436,3218,3218,3zqXX6kzhkbW3d4TwD2CNjMRwxTbREXySekvq37kfCNk,257456,3885112,-3627656,617
2022-01-22 12:58:50-05:00,8819,GqFbV89UYbQ6aEW1bSvGnnsDtTPQfHPTHzisXPhLnaTC,6X7j3nqmugRyVVw83uSzgiPaemEscc8VdsnPEKDz4fg2,True,1061957,265489,1616,808,808,HfEnetJ7uBSmZWCjBNxdvv9HEC5nsW4wDV7wu6WnhWan,64667,1019973,-955306,608
2022-01-22 12:58:50-05:00,8820,CK1SjmBjrW7m1QVZbVZsVZgwEcxw8BTkckkzrZDrDdxW,M6vnBg1TPRhLu7sghkxtf5TkSLw5JhgoDmbGoyEYgR9,True,2537502,634375,3838,1919,1919,HfEnetJ7uBSmZWCjBNxdvv9HEC5nsW4wDV7wu6WnhWan,153555,2336292,-2182737,605
2022-01-22 12:59:32-05:00,8821,9XHC2Ycm9f56cDYxRPVKYiYWGKA4y7Utpv3e9gpMsZq3,HpqAdpkzWqoJUNqmHEnn4PZwSB6C6jt8FJZQtZtFqXWA,True,11558223,2889555,17972,8986,8986,HfEnetJ7uBSmZWCjBNxdvv9HEC5nsW4wDV7wu6WnhWan,718908,10252322,-9533414,621
2022-01-22 12:59:46-05:00,8822,FtF3PVw8YNJseWPMcA2GEuQZ6nni1mq5kYPa2LrSzfkW,4yr1TM2dXrBvLNMpSaoryuGU2P8D3WG1ZCkvVzWFiQRH,True,1894911982,473727994,2964331,1482165,1482166,3zqXX6kzhkbW3d4TwD2CNjMRwxTbREXySekvq37kfCNk,118573246,930171326,-811598080,625
2022-01-22 13:00:52-05:00,8823,243SAnGxchCVB1LQAUF4SsozR86yDwEdg2QQpbWGsMYe,5u8sNkb2oEQjUXJAB3yGStmv3Uwz16gBgExBo5myVK4b,True,879098,219774,1374,687,687,HfEnetJ7uBSmZWCjBNxdvv9HEC5nsW4wDV7wu6WnhWan,54992,512623,-457631,625
2022-01-22 13:02:03-05:00,8824,33CE2t84MhG7SMsphhZaxvwFVRbK5wcUMUdEw8UBhoq8,DjNko7SbbK9nQT4K5oBWKiSiXiYS9Rv1k5vT3PNiMyaf,True,4862021,1215505,7212,3606,3606,HfEnetJ7uBSmZWCjBNxdvv9HEC5nsW4wDV7wu6WnhWan,288505,2921484,-2632979,593
2022-01-22 13:02:05-05:00,8825,9yDHiv4vGbQWYby3dAMCdVnwiYgXBV1jV6WCzKYUPiUs,FPyemR1VdBnhxW2V7j7EkQyhzW894bCb3f6wRUMSn6jB,True,103848908,25962227,158881,79440,79441,3zqXX6kzhkbW3d4TwD2CNjMRwxTbREXySekvq37kfCNk,6355248,38619842,-32264594,611
2022-01-22 13:02:05-05:00,8826,7FB6X8YgiDn7YK9bZZmcFyzhuvVLVWPCfBbenwMXhx5,2EaDCpL9MpAKuiC2bvUCGRfvqYvgVXGFHXt35QdNakfG,True,4869800,1217450,7110,3555,3555,HfEnetJ7uBSmZWCjBNxdvv9HEC5nsW4wDV7wu6WnhWan,284422,1344694,-1060272,584
2022-01-22 13:02:10-05:00,8827,9Ft21UZ66egkMCtZprBPc72WF1aj2fQwLs6XJWPXUbUV,6DGSgHegc23W5MQ6hqSsSSdwNvRqU3piR9GBoZ6fU23f,True,67936257,16984064,106309,53154,53155,HfEnetJ7uBSmZWCjBNxdvv9HEC5nsW4wDV7wu6WnhWan,4252385,30291923,-26039538,625
2022-01-22 13:02:30-05:00,8828,BZn1DDE568UHeL2Qniv9EDT1yAAWvPJcTtSw4K4GQx44,CCaroU4YwKvYgibMsRPdEBxeDbzcNC4s5ZthxrhywSm5,True,2616583,654145,4081,2040,2041,HfEnetJ7uBSmZWCjBNxdvv9HEC5nsW4wDV7wu6WnhWan,163240,2401797,-2238557,623
2022-01-22 13:02:30-05:00,8829,57Vsw8jXaaoLriYEkvPAVyq66r4a4zMfLWbDaTBMjFzC,7AVDWUTHa6729UkXgCXASphSmrLvXYGAA9ygTMSqvwvY,True,1284156,321039,2009,1004,1005,HfEnetJ7uBSmZWCjBNxdvv9HEC5nsW4wDV7wu6WnhWan,80362,1230070,-1149708,625
2022-01-22 13:02:36-05:00,8830,2aK454FrEuA6JQZo2hLUabd4E6wyQtVuJWw2rWz2pGVy,3dJvhEh7kykf8hCCWQRarh2s5ybJUAzbaPdDUmX4XokW,True,101941382,25485345,158768,79384,79384,HfEnetJ7uBSmZWCjBNxdvv9HEC5nsW4wDV7wu6WnhWan,6350735,28970333,-22619598,622
2022-01-22 13:02:48-05:00,8831,BjCNaM7YbE9SjFi7tzi4677zg1fKXGJwtecz2GWwWuhd,6rNsSrKZezQrLb2whToNjnizpnurDXrobHqfEK3QqU1M,True,484557276,121139318,757349,378674,378675,3zqXX6kzhkbW3d4TwD2CNjMRwxTbREXySekvq37kfCNk,30293989,252944854,-222650865,625
2022-01-22 13:03:08-05:00,8832,Dng7By2saPu5TVxcvXidBe71ggBo8tiHkAXPi4kKL1tk,75ufEJmHbLHffphL7tvAXhGyftKLr1z2PXXoB2GGY5fG,True,23717538,5929384,36858,18429,18429,HfEnetJ7uBSmZWCjBNxdvv9HEC5nsW4wDV7wu6WnhWan,1474357,8612964,-7138607,621
2022-01-22 13:03:28-05:00,8833,25NUDrsdLhS3fcARLiTMbbmZHvvzvzPj9xAdoN8sJBN3,8baNRGHfYRcLdhbHNuH72ofAWM9UojqhTMLnbBayzGnW,True,2635498,658874,4101,2050,2051,HfEnetJ7uBSmZWCjBNxdvv9HEC5nsW4wDV7wu6WnhWan,164079,1566593,-1402514,622
2022-01-22 13:04:10-05:00,8834,5BJnMHFSiQjHRGFJDW1jnqCfkHHYWnQzmmccy9eA4jNj,9517JGYsPmvgPUM9pFRD2vipHmdgE578F7jA7Qq6jorm,True,87599378,21899844,136803,68401,68402,HfEnetJ7uBSmZWCjBNxdvv9HEC5nsW4wDV7wu6WnhWan,5472126,31255892,-25783766,624
2022-01-22 13:04:10-05:00,8835,4Enpw9W2mWGnNYagYQ8WW29RLSs4R5YX4qXCsVqMFeHn,9QwbJmm9QDKXyc4ZViq74BfS35zzewEceXQNnFCgczXu,True,255143682,63785920,399013,199506,199507,3zqXX6kzhkbW3d4TwD2CNjMRwxTbREXySekvq37kfCNk,15960543,94540543,-78580000,625
2022-01-22 13:04:27-05:00,8836,GqPZDwm3EWGMiVy7BY6qHM4Vzt2B9vW3Zs1CLScrtjAD,63h2HEdkmc54a8txd4LZ69TUBLR6VphxBoXLx6hjCLg4,True,744842979,186210744,1164440,582220,582220,HfEnetJ7uBSmZWCjBNxdvv9HEC5nsW4wDV7wu6WnhWan,46577624,202410067,-155832443,625
2022-01-22 13:04:42-05:00,8837,5kwvkEtRFFD84j4ntVgxkacadgJaFvQ9JLhJqzLR7Y3G,GpMMkTv9T7y8DTiizuoJUsWvnSk3GSxADjRMGyYpryxm,True,774085,193521,1198,599,599,HfEnetJ7uBSmZWCjBNxdvv9HEC5nsW4wDV7wu6WnhWan,47926,485059,-437133,619
2022-01-22 13:04:42-05:00,8838,zLTuMVfVswjMkhyvjaXnvjcKXv5xNk3iSWSjRGpVqXf,J3D8NHUJCiSjvFYfJ5Es4YDhF1KcPZWRUmCQ5L92t8eB,True,10485659,2621414,16342,8171,8171,HfEnetJ7uBSmZWCjBNxdvv9HEC5nsW4wDV7wu6WnhWan,653698,3532043,-2878345,623
2022-01-22 13:04:42-05:00,8839,6VJcr3VAEcEZaHEpt48QL8QxHKABufVp8n2JSEVTLh9U,8naR6kiySKj3vai9dCetdgCnCHgf2oyLjGqKTJ3Lz64Y,True,79689975,19922493,124628,62314,62314,HfEnetJ7uBSmZWCjBNxdvv9HEC5nsW4wDV7wu6WnhWan,4985128,62053499,-57068371,625
2022-01-22 13:04:42-05:00,8840,GYgxUfZ19oSyHuovGRA6gBJT32goSxCrKR8hQQdBsrRG,2r8c6SU74hRq7xEmYBJ92WoSB6v6XCAXR3JcDznfCxkN,True,711865576,177966394,1110735,555367,555368,HfEnetJ7uBSmZWCjBNxdvv9HEC5nsW4wDV7wu6WnhWan,44429436,532442660,-488013224,624
2022-01-22 13:04:44-05:00,8841,8xvLGVeDmhVYQhN2ZpWkVG9jCrukRsNQ4926a4TMiZqa,9ciBySSjvADwp47WkETiFWZKVTFL8Hf1XvK7aSxhcgQS,True,611600,152900,952,476,476,3zqXX6kzhkbW3d4TwD2CNjMRwxTbREXySekvq37kfCNk,38102,464559,-426457,622
2022-01-22 13:04:45-05:00,8842,AWvHDdb2ikqV8wc7qQ8azbvNTZdixMNxhQjhQdhayYtR,9EpgEPBb1nog6aQeFdMXfSRiLSnzGQFQ39mbLdCxgYTv,True,1135452,283863,1755,877,878,3zqXX6kzhkbW3d4TwD2CNjMRwxTbREXySekvq37kfCNk,70211,706621,-636410,618
2022-01-22 13:05:55-05:00,8843,Fs8MQLaMyr1Q96HsZivKLY7Kjdeu2ZoB2n3VTZ15KbSn,DREfCs5CTVNUUF8H3hD8CWvtxztiYxoLYh8HUWDecMyZ,True,40600667,10150166,63514,31757,31757,HfEnetJ7uBSmZWCjBNxdvv9HEC5nsW4wDV7wu6WnhWan,2540580,38828327,-36287747,625
2022-01-22 13:05:55-05:00,8844,52hhBAuVyifMNFKGQmSitc8smiEgscXQMzVuZj55j7E5,6B5DBJx9NLytR3fkrYqe5W5ek4rUWsR4nPsRTvRfRwzC,True,43244430,10811107,67551,33775,33776,3zqXX6kzhkbW3d4TwD2CNjMRwxTbREXySekvq37kfCNk,2702060,41337765,-38635705,624
2022-01-22 13:06:22-05:00,8845,5eMLdQ4gYA5iqvTXSNdGvctHp7s5VpyFuwtJKqx6chBc,Ckxc5K39nkBNXBTmFTM8J48R7wGqNm3vHKZu4G5baumZ,True,8040722,2010180,12582,6291,6291,HfEnetJ7uBSmZWCjBNxdvv9HEC5nsW4wDV7wu6WnhWan,503288,5368157,-4864869,625
2022-01-22 13:06:23-05:00,8846,HpDwBPWZHfLzJUvTTABTA6qddyLLJiVTfqBx5gUktSUb,BqXLpaAeTNfNSeevfdazNqTgqEXj6Edgp8txWvCoxEz6,True,21426148,5356537,33389,16694,16695,3zqXX6kzhkbW3d4TwD2CNjMRwxTbREXySekvq37kfCNk,1335591,19061575,-17725984,623
2022-01-22 13:06:29-05:00,8847,56488NdcUy6Hi6X5SLs2GFtW5pG4u5wJpH7vHdxTCx4z,tGgXjJeVr3W2m3T2NXPCqpBEd6HJKE2cRsgCyiDZQy4,True,4428534,1107132,6915,3457,3458,3zqXX6kzhkbW3d4TwD2CNjMRwxTbREXySekvq37kfCNk,276633,2975382,-2698749,624
2022-01-22 13:08:09-05:00,8848,CYkojG4q1SnizNs59qsYTEBU1c11XC8nteMhxRbwhCBq,A9MsPy3aeMzdQUWXK6qmWLiZfKREiBrSVaJAKp2nEcSt,True,551286,137821,858,429,429,HfEnetJ7uBSmZWCjBNxdvv9HEC5nsW4wDV7wu6WnhWan,34350,392705,-358355,623
2022-01-22 13:08:09-05:00,8849,JDeYjCLpfnzcfxDFgHf4aBcHsajwdR14GUaKAA9euzVf,EJbvKoyMZcoCx4vWa61uMbW2vr6mUhrgEuECdteVBuZZ,True,190926,47731,298,149,149,HfEnetJ7uBSmZWCjBNxdvv9HEC5nsW4wDV7wu6WnhWan,11949,185982,-174033,625
2022-01-22 13:08:10-05:00,8850,78EeyPYzQjrmW6z9VGhRci6ihMUZb5rtpXo3GAxugf55,9AgZ45TMxaqwWGVWSgnEkvio3s6fXtHjAVRVCA7Zgsd2,True,1362208,340552,2128,1064,1064,HfEnetJ7uBSmZWCjBNxdvv9HEC5nsW4wDV7wu6WnhWan,85151,864641,-779490,625
2022-01-22 13:08:12-05:00,8851,HdRgh9niYSd3YKCxzGdusYFquiVoFTP2mEGEzJJL5Nii,78C68Gbb1jYFQmYNCHHjL52keEKMXtGukmBwT7ahon4B,True,146181575,36545393,228535,114267,114268,3zqXX6kzhkbW3d4TwD2CNjMRwxTbREXySekvq37kfCNk,9141427,118426051,-109284624,625
2022-01-22 13:09:27-05:00,8852,3EgUBHBeKWegibDcCsTGaGehnwHYvpMbcPaT1UTbwQ49,Hxd4dsnLD8uHnG7KR7GVmKXBcpN1egMUvoTccPvBcaYA,True,42947637,10736909,67097,33548,33549,HfEnetJ7uBSmZWCjBNxdvv9HEC5nsW4wDV7wu6WnhWan,2683902,41051140,-38367238,624
2022-01-22 13:09:54-05:00,8853,9UKMqQgFYdJb5vXVqPhA8CAMRY1eifgWivANiKQqj3yb,DpE3uNQUZbyYnqjpfHWqp9CHqPBs2uTQLRM6AtzF6Por,True,8136318,2034079,12651,6325,6326,3zqXX6kzhkbW3d4TwD2CNjMRwxTbREXySekvq37kfCNk,506059,3324554,-2818495,621
2022-01-22 13:09:59-05:00,8854,3ogBPSRcKfmwzgumVDHBkXLi1eCsEFG2xzSJgD4LQDNy,7TXyqWgJqfe71MSWFA2n7ufZbUdzf7JJoWej8FNNtMXo,True,516432,129108,806,403,403,HfEnetJ7uBSmZWCjBNxdvv9HEC5nsW4wDV7wu6WnhWan,32262,370777,-338515,624
2022-01-22 13:09:59-05:00,8855,G5NLYTLxDZfJFKsJdMeWS8Ez95ZFwR5AX4hKhnfVJvoE,AwrC3pKhTeEDr1HCTWoKWjadteZccvqcisbC7vxTjn7w,True,13125673,3281418,20432,10216,10216,HfEnetJ7uBSmZWCjBNxdvv9HEC5nsW4wDV7wu6WnhWan,817291,12377988,-11560697,622
2022-01-22 13:09:59-05:00,8856,7hTjPRQSYAoWHhtpsVz2oKK5SAuFJd8dPHShKgKJq8dy,6DcHcrtcXR88d8e2KahhAiWTeRznNfF8oXLHmh5wE7wz,True,23426319,5856579,36481,18240,18241,HfEnetJ7uBSmZWCjBNxdvv9HEC5nsW4wDV7wu6WnhWan,1459249,16764803,-15305554,622
2022-01-22 13:09:59-05:00,8857,95yx3SCWcW9Cp8oSEDV68kGXRKWGyNdYUtNb5UnWMGBD,7PncaFWqW2iKR6EUKf78EW6LLZr7ZWU5b2d2rP22fsU3,True,6698051,1674512,10422,5211,5211,HfEnetJ7uBSmZWCjBNxdvv9HEC5nsW4wDV7wu6WnhWan,416892,4968856,-4551964,622
2022-01-22 13:09:59-05:00,8858,CbhrZUdan1axNDFUrX1ZuEohfNMEGrszKSkk6pppVQuw,DHEAjJNtuEePezYAv77thWabbVxxqQpfuiC6moRSrpG1,True,2268585,567146,3534,1767,1767,HfEnetJ7uBSmZWCjBNxdvv9HEC5nsW4wDV7wu6WnhWan,141392,2148810,-2007418,623
2022-01-22 13:09:59-05:00,8859,Bsr6kx1B6BSEd5UnJ7Z61M49iUb3bFrDVhiEtMVtPDF2,3CFd1pUJAJPA9fobwn4Jj2mRju1CWmoop4Mh4znypNWT,True,717685,179421,1119,559,560,HfEnetJ7uBSmZWCjBNxdvv9HEC5nsW4wDV7wu6WnhWan,44771,506095,-461324,623
2022-01-22 13:10:43-05:00,8860,GxFxvEUdWofneMmVvhCSScH9V6Zia5WJ2J9q6CpPnaq3,ATLykiHDii3Lw53MoZXwqu1FbBNPJbVNVGe2SoQMjVmY,True,23123,5780,36,18,18,4BnQKPLuE3DMTtxp8MjUBytgnhvxqq3ZTqZHTVZo4JJh,1445,23471,-22026,624
2022-01-22 13:10:44-05:00,8861,3FF2rhr1RuT7UR7MmmGtrhfYbh6kbc5UXq51KmqFLZnq,AEmSYLt1dQ8suLugC4Lcw4kF3dG9GYcEfX54hEAKfmv5,True,1404294,351073,2188,1094,1094,HfEnetJ7uBSmZWCjBNxdvv9HEC5nsW4wDV7wu6WnhWan,87553,794601,-707048,623
2022-01-22 13:11:05-05:00,8862,8JtUn4uue4WzrySwnDQ74qzzWaKsoo11MbMvRh1ePDJN,8iahKConWg6fyZrkoze5eeujyNHA26AybYBpHwUr76Cu,True,15864272,3966068,24689,12344,12345,HfEnetJ7uBSmZWCjBNxdvv9HEC5nsW4wDV7wu6WnhWan,987566,10700338,-9712772,622
2022-01-22 13:11:07-05:00,8863,2pKygdXJnjZBFfrZgDasmHQQgw8LgycmBBRuaoCU72cz,DXsomQ5yWw2ceZMbaCVsSaE4hKm9W6Gy785JG75Aaz18,True,1263359,315839,1956,978,978,HfEnetJ7uBSmZWCjBNxdvv9HEC5nsW4wDV7wu6WnhWan,78245,715051,-636806,619
2022-01-22 13:11:07-05:00,8864,72woixtGAuGazCMfsYfYBYLP7FuRj8Fwz9fynFo4MCE4,5237BmWkKf58PBeTUEiu3Ld5uKXEe8wcrJRmCnUoWWku,True,5044523,1261130,7892,3946,3946,HfEnetJ7uBSmZWCjBNxdvv9HEC5nsW4wDV7wu6WnhWan,315687,3232154,-2916467,625
2022-01-22 13:14:05-05:00,8865,CmvNNpdGVDGujBadaMmgKc8xgFfyV6G9PNEjD8zEND6L,EzmfinKBZ8TXoSugyTqdEdHWrHdTdpHQtc1TApfaNfDR,True,632317577,158079394,979439,489719,489720,HfEnetJ7uBSmZWCjBNxdvv9HEC5nsW4wDV7wu6WnhWan,39177593,533957019,-494779426,619
2022-01-22 13:14:38-05:00,8866,6pUtYz474QrpATEZnfb3iFbTKYA65pNyKAo4TQZAjtqe,8dipRUXvxJiDLdHEtCPkso4vErbVwshHQiRfvSngBS9J,True,8622248879,2155562218,13472698,6736349,6736349,HfEnetJ7uBSmZWCjBNxdvv9HEC5nsW4wDV7wu6WnhWan,538907937,3527694902,-2988786965,625
2022-01-22 13:15:13-05:00,8867,F1G1Yb2jhT1hULYuNM9QMuNNA6vHZ2Wg4LhFGWsJmr78,2oF52s77UVwjbZMLmxyNsGRZ36RHqSJiV5VL7FzoWgyB,True,63347455,15836863,97942,48971,48971,HfEnetJ7uBSmZWCjBNxdvv9HEC5nsW4wDV7wu6WnhWan,3917689,31554859,-27637170,618
2022-01-22 13:15:17-05:00,8868,CyWBZ1xJ9LahUnPesbXLZ4Rr5UyWAHgVFYwfrnhyrkNL,2Lpk87Xth8ZL5J9BfzmMpEE3x76FDrrrmdKiCNkSVip2,True,2439877,609968,3814,1907,1907,HfEnetJ7uBSmZWCjBNxdvv9HEC5nsW4wDV7wu6WnhWan,152584,1874435,-1721851,625
2022-01-22 13:15:17-05:00,8869,8trkirSQNdMmAcJdeswxs5cPjH8dD6U4eJtWiAdMsrDB,HaSzpQ45x2MipfN17U6jGBxX8tXboomVDhXNSrnEfLDr,True,43720,10929,67,33,34,HfEnetJ7uBSmZWCjBNxdvv9HEC5nsW4wDV7wu6WnhWan,2708,36871,-34163,619
2022-01-22 13:15:19-05:00,8870,4KMzwWHPeW51cxu4nMpbqCaqo96dMqaHWyRCGQktfQfd,F7q4GNYcbnZa8dJ4qovQwjmxpKpdEmdxQMXRPb9nQupa,True,23370598,5842648,36553,18276,18277,HfEnetJ7uBSmZWCjBNxdvv9HEC5nsW4wDV7wu6WnhWan,1462159,8648934,-7186775,625
2022-01-22 13:15:19-05:00,8871,D64rDiWT3YG28fCgXCmbNjYa2JakZbpKQ1D2XuLChUfV,8WmMWq8cTsGQym5pUbHm9dPCpJugBeWUMVERYFGLxWHj,True,873138,218284,1339,669,670,3zqXX6kzhkbW3d4TwD2CNjMRwxTbREXySekvq37kfCNk,53564,589742,-536178,613
2022-01-22 13:15:21-05:00,8872,6mCEvqP1YwHZNUT9orECs4tE3YzfD2Hfa5FTt9TLo8DH,ApWyeUDzPp6TBczuStvXxEAivhVVJrqC1rodNTNKNFR3,True,7878240,1969560,12293,6146,6147,4BnQKPLuE3DMTtxp8MjUBytgnhvxqq3ZTqZHTVZo4JJh,491752,4354545,-3862793,624
2022-01-22 13:15:23-05:00,8873,Fani89KviVFZek4si6YZ3apVuM2kSqVUijDnLBqtvJEH,EpC29dECx1cLC69bj2ncG3jFp7obPaxbH7F6mju27cwL,True,536849,134212,826,413,413,HfEnetJ7uBSmZWCjBNxdvv9HEC5nsW4wDV7wu6WnhWan,33053,234292,-201239,615
2022-01-22 13:17:09-05:00,8874,8GdYhwX26GRmVfGFCbJ3MJrH1UdneN2FNRUexhLsqprN,DpUTHSVucDPyCWoLCdpm8EFRZFiKL88tmnSiWG2TRpS8,True,877015,219253,1364,682,682,HfEnetJ7uBSmZWCjBNxdvv9HEC5nsW4wDV7wu6WnhWan,54582,864865,-810283,622
2022-01-22 13:17:09-05:00,8875,Gk4mpwDEggypoPjyrZcFDbHT8WBwspC5AbQ5uDgaQufL,GTDi3mKTcw1NfwbYx8s8YCkzqbaJUM8YUwYifNr9sjgH,True,232138975,58034743,326944,163472,163472,HfEnetJ7uBSmZWCjBNxdvv9HEC5nsW4wDV7wu6WnhWan,13077771,135898796,-122821025,563
2022-01-22 13:17:09-05:00,8876,3PPCwAjj8GNphb3cRs7kP1QVghEUX6gWUH3M4JarQsTD,28UR4WKAziiJmPwas5E5JrY3WaUrR2NkYYXCKuxPHTMR,True,344126908,86031727,497701,248850,248851,HGs4J6Z7HAtWs2TLcPDnA7yyFzHWxCXDCgvasqEVZzkk,19908076,308550200,-288642124,578
2022-01-22 13:17:09-05:00,8877,B4Uc39nKzz9wBRQsCkMR4A7RwTJ8rSuwpR6EQn2AesRb,H49bGZgatRZVpj6QufZRVgYrQtH7LpdbiqKBs23151m,True,97264,24316,149,74,75,HfEnetJ7uBSmZWCjBNxdvv9HEC5nsW4wDV7wu6WnhWan,5996,158768,-152772,616
2022-01-22 13:17:11-05:00,8878,CEtpqFD4BbeiNfaXyLLYEapY2mWgE26H5q6H34tWwRuD,BVqRyqwGFPzSkk1H2finiyfaL3LScbEiQGk3mihirxqs,True,720203,180050,1126,563,563,3zqXX6kzhkbW3d4TwD2CNjMRwxTbREXySekvq37kfCNk,45052,702368,-657316,625
2022-01-22 13:17:11-05:00,8879,96StvqZyFUPtyMr4o9s7K4V29RSNyRpVi76vNwxG5rUf,GZKXFSFq4aGiTaqovtxqNCCVGkAFNXPh4Hep1ZMwdZ8g,True,86794,21698,134,67,67,HfEnetJ7uBSmZWCjBNxdvv9HEC5nsW4wDV7wu6WnhWan,5367,137836,-132469,618
2022-01-22 13:17:11-05:00,8880,75NA5QiXEHG4caSB9BpafGZPA9eT9S6MhKTFM6eHjz8H,FmoxAVw2zdG6qbyaXKy6gsvi1XY8ZVbSgUNbjsp9EpVd,True,2655797,663949,3716,1858,1858,HfEnetJ7uBSmZWCjBNxdvv9HEC5nsW4wDV7wu6WnhWan,148651,2365813,-2217162,559
2022-01-22 13:17:11-05:00,8881,7EvJoetxJVTgpJXqE1VC3fZN1CQ5xdWdv29yCiDuH9gU,6RTEusjGEHNDdMj75qkpzYHjHZ3R2XN5xvptCwkRJz5j,True,1095131,273782,1677,838,839,HfEnetJ7uBSmZWCjBNxdvv9HEC5nsW4wDV7wu6WnhWan,67092,1087473,-1020381,612
2022-01-22 13:17:11-05:00,8882,3NhNdphQiKwgHTmTJc4qVhp3aWjqnwMTYbRW1y9CZrZg,BNpP1sKPAr7Dk1ymSrupge9KGMVpk4LfjTjawgi9YaC5,True,5728942,1432235,8847,4423,4424,HfEnetJ7uBSmZWCjBNxdvv9HEC5nsW4wDV7wu6WnhWan,353910,5539895,-5185985,617
2022-01-22 13:17:12-05:00,8883,3qnPsgqW11AcDEmyjmJquPcPLyE3EdJQuVLJ5kinDrd3,86rZadBB7emKio76aFTahpbrFtxd9tqZ4Mxgzaavq2xU,False,793,793,37,1,36,3zqXX6kzhkbW3d4TwD2CNjMRwxTbREXySekvq37kfCNk,37,773,-736,466
2022-01-22 13:17:14-05:00,8884,GwYr2DmtMVLWxVz6kVSXR6rvxL4x3DXtvNC7taswSWHN,2otMHa7JT1twPSSN6XF9fqGkKrEK8nnuMFZG1TtAgFQk,True,6669,1667,10,5,5,HfEnetJ7uBSmZWCjBNxdvv9HEC5nsW4wDV7wu6WnhWan,414,6473,-6059,620
2022-01-22 13:17:14-05:00,8885,7EtGovzHsbD8cKGqq4R5rvKBbncR4Kc7CDkTjof2QBMf,8ShjeNWM2vcvUF9yYztYCHUQfcGsyg2A1LyWiPbQDDvq,True,248816,62204,359,179,180,HfEnetJ7uBSmZWCjBNxdvv9HEC5nsW4wDV7wu6WnhWan,14383,240133,-225750,578
2022-01-22 13:17:14-05:00,8886,8HWpccoTmPZ9MsrxtvQ5BV5y8a8WBAB1Sxx2WAiYKRLH,9chtr2Nqg77CCCnjC5JqENmUBNxpDHVH6BG3wojn9gHQ,True,1436849,359212,2097,1048,1049,HfEnetJ7uBSmZWCjBNxdvv9HEC5nsW4wDV7wu6WnhWan,83914,1406788,-1322874,584
2022-01-22 13:17:14-05:00,8887,BYvjENe16Ta77PqGV7JKEWrsqCTfkMGYwTSG5gXneDvd,EvxAXgvhPC6QkNurbK7vWyTApGo8J2R4EgMAknkHVU3d,True,11627,2906,17,8,9,HfEnetJ7uBSmZWCjBNxdvv9HEC5nsW4wDV7wu6WnhWan,715,14491,-13776,614
2022-01-22 13:17:14-05:00,8888,HabA6MLjygaKE6i9Sad4c6B8rnyobMYbtFext51rCmHj,516FG8YJxZmnGfvzWiV3TcwSF7UDdwWefjZkmi3R2SPX,True,109701207,27425300,171325,85662,85663,HfEnetJ7uBSmZWCjBNxdvv9HEC5nsW4wDV7wu6WnhWan,6853015,60416554,-53563539,624
2022-01-22 13:17:14-05:00,8889,8xQ3tsWVUe75EG1HmocULJ3kh52utveoFMEPotTGrKno,i3SKW3ywrwYucX9ySEx1C4zaUKGnzLerP3V38437NyV,True,534188,133547,801,400,401,HfEnetJ7uBSmZWCjBNxdvv9HEC5nsW4wDV7wu6WnhWan,32070,587282,-555212,600
2022-01-22 13:17:14-05:00,8890,ymyzGH4Qc7HH5PbKpVphCbsQgLLXyGkPcXamQJuNj5C,8oTLHaV2XzbKXNWRuUjCfHjUn61Pw93LYK14m9q2VDpZ,True,51714,12928,77,38,39,4BnQKPLuE3DMTtxp8MjUBytgnhvxqq3ZTqZHTVZo4JJh,3096,47325,-44229,598
2022-01-22 13:17:14-05:00,8891,HfwGSiwGiyDFaTS2usYRp82zSmPPQqZukbw2d1BuFs5w,ArtgZbmA33k8Y3EfR6oMJiqT72MUrVBQqifPBdcnrzea,True,770357,192589,1110,555,555,HfEnetJ7uBSmZWCjBNxdvv9HEC5nsW4wDV7wu6WnhWan,44402,436060,-391658,576
2022-01-22 13:17:14-05:00,8892,7A1v7bFDJwxM7XomePFyRh58SMHxrNSkM3fJygd8pQUN,DL9jCFHaM8BXJ5KE1YJHXNCbXgSdRgt18MHhAgC6TNmg,True,3111304,777826,4439,2219,2220,4BnQKPLuE3DMTtxp8MjUBytgnhvxqq3ZTqZHTVZo4JJh,177592,2769073,-2591481,570
2022-01-22 13:17:15-05:00,8893,FwTGq3BeMLyRFRa5r4E6nySLgoLNcNdqJsCQxA2i6uh6,88w6ti3WSriyu2FvNjVfrLpGyU5PUvaiJyqrAGPM8TKp,True,1236300,309075,1805,902,903,HfEnetJ7uBSmZWCjBNxdvv9HEC5nsW4wDV7wu6WnhWan,72214,1192734,-1120520,584
2022-01-22 13:17:15-05:00,8894,EBnMKbaJEjNXjt14hxssR8wd3Ua37McPQxUZnKxxbgtd,FAALK2LRFhg98ezHEBFrgrzxTg66eZpmo7ctKDEck8q5,True,1719226,429806,2656,1328,1328,HfEnetJ7uBSmZWCjBNxdvv9HEC5nsW4wDV7wu6WnhWan,106247,1550769,-1444522,617
2022-01-22 13:17:15-05:00,8895,JDg1bbHkYeznDUtSBLhagRJ45aSzeSF5V8iDRJCay9wL,8n7ic28zq5PjJtRcM7Fcy5vLW2YVXw4EWMK6UAt2zh3V,True,29036161,7259040,41000,20500,20500,3zqXX6kzhkbW3d4TwD2CNjMRwxTbREXySekvq37kfCNk,1640031,27020400,-25380369,564
2022-01-22 13:17:15-05:00,8896,AvpYg74EBhwAXE8rcdGkpwmbBMRyVidF6zMRSFtWAVC6,4WgpqTp4r9wMpMptYMNbvCaP2faBnVr6FdShCAobetpL,True,968882,242220,1462,731,731,4BnQKPLuE3DMTtxp8MjUBytgnhvxqq3ZTqZHTVZo4JJh,58519,962374,-903855,603
2022-01-22 13:17:15-05:00,8897,U3vvMQ4X4aKzVYfhMw1V1p58HRqaLnuXozqmmefYeD9,7JA94MArkNCFRhBq8f5a32DgMF6aPdFsoC5HvXDQ6NuR,True,1180876,295219,1783,891,892,4BnQKPLuE3DMTtxp8MjUBytgnhvxqq3ZTqZHTVZo4JJh,71334,1310398,-1239064,604
2022-01-22 13:17:17-05:00,8898,5V5gFVMYSwGYfHFecRoHg8G22Rg4bXfVK2FSRTMhPQty,73raXd5MvixmDvJRnVjRL7yQaHZGFRiC9aBxL9ysiRvy,True,108072317,27018079,164285,82142,82143,3zqXX6kzhkbW3d4TwD2CNjMRwxTbREXySekvq37kfCNk,6571433,54037408,-47465975,608
2022-01-22 13:17:17-05:00,8899,2ZSfbqxhiCTDrDPeRhoWayTZHNmW7ajVXBCxpFS4eGBF,3ZmWsPdQD7qfSMGKQSNhmBtuH7S6qMFRc8oEmBcHXEiR,True,976567,244141,1466,733,733,3zqXX6kzhkbW3d4TwD2CNjMRwxTbREXySekvq37kfCNk,58650,969875,-911225,600
2022-01-22 13:17:17-05:00,8900,BrHRMouGRz3LBNzd9anfdYMhWfg8yUPHL4PqJ8WdEDFS,4uzoLa3mC2VYHAPBoHLX4gTjPTC28rPf2fvEGtJWPYc,True,228801,57200,342,171,171,3zqXX6kzhkbW3d4TwD2CNjMRwxTbREXySekvq37kfCNk,13695,345544,-331849,598
2022-01-22 13:17:17-05:00,8901,Fw2e6jxKVeFcJSe9MyVhSz3dUdJQLs3XULHrT1mtMU9U,591U5bexgLRJXygtK5fpCRXcZEq89KgewFTdfPkti8bY,True,115761537,28940384,181151,90575,90576,HfEnetJ7uBSmZWCjBNxdvv9HEC5nsW4wDV7wu6WnhWan,7246065,102165694,-94919629,625
2022-01-22 13:17:17-05:00,8902,2FEbsetZMkRqLjSC8GBbgecKgX5T1T1fci2sLQux29p8,H722Fcd6DkTFRZxqQWbPDufBfXEgmFfhiEpQZWhxwYv1,True,18166,4541,27,13,14,HfEnetJ7uBSmZWCjBNxdvv9HEC5nsW4wDV7wu6WnhWan,1114,16813,-15699,613
2022-01-22 13:17:18-05:00,8903,9Hz4p7gcfDbXBJp8KzhaBBPh9i7xe9kun7zLfDtqPe6c,2bJ43Lep6kp6WY7Ct56oiscKnAbdtC265G5yRvRPFThU,True,3571403,892850,5346,2673,2673,3zqXX6kzhkbW3d4TwD2CNjMRwxTbREXySekvq37kfCNk,213845,2311254,-2097409,598
2022-01-22 13:17:18-05:00,8904,FYdUiU3rPpbYKWnEpekQQsocSJKjXmscohi4v6DYqix7,daPyq9YdunQJhhLoW5ifhJ7UFPTtRZhGs4JwE1nqZhN,True,982880,245720,1475,737,738,4BnQKPLuE3DMTtxp8MjUBytgnhvxqq3ZTqZHTVZo4JJh,59013,976033,-917020,600
2022-01-22 13:17:18-05:00,8905,EBpxGcrs4eWAbBU5rEjFxbr24MjUstZQRMV9jK4q8kMp,EYVd6pztEuz8PC7rUnJ1AjVZ81WWpynyn2qEKtveqrHG,True,1706806,426701,2536,1268,1268,3zqXX6kzhkbW3d4TwD2CNjMRwxTbREXySekvq37kfCNk,101460,1642172,-1540712,594
2022-01-22 13:17:18-05:00,8906,9kYkFDNE3qD6s73fn8kJowgqbDZoDSw22XaUJ7rTD43D,E8zJz8pT2c9aZsxe4kLMNs4bY7skt38SU5wK5JTqbGr6,True,14995712,3748928,22957,11478,11479,4BnQKPLuE3DMTtxp8MjUBytgnhvxqq3ZTqZHTVZo4JJh,918293,14895332,-13977039,612
2022-01-22 13:17:18-05:00,8907,A4Q7Vrc9M3GtEXNUSiVBFkansyf5sKBtSeVT92WFacqv,EWLNfsTKqzkd7KAhnrPRre4Dyk6exb3H9wSbrJuyWprg,True,24885132,6221283,37264,18632,18632,3zqXX6kzhkbW3d4TwD2CNjMRwxTbREXySekvq37kfCNk,1490591,24156685,-22666094,598
2022-01-22 13:17:18-05:00,8908,FF8rqfM9PTEjYiVFy8jS81weDRwdaYooux2uSa2LexrJ,JBk1JghH1gged1YpDbkczFXP9ka5ivYSkaYoVbbXD4kg,True,705400,176350,1077,538,539,3zqXX6kzhkbW3d4TwD2CNjMRwxTbREXySekvq37kfCNk,43112,747011,-703899,611
2022-01-22 13:17:19-05:00,8909,8cRrU1NzNpjL3k2BwjW3VixAcX6VFc29KHr4KZg8cs2Y,6KhaewfwKyT5fkQvfiDqKzGWEPbuP9H5NfxEUXVx14U4,True,91237531,22809382,139480,69740,69740,3zqXX6kzhkbW3d4TwD2CNjMRwxTbREXySekvq37kfCNk,5579231,23635785,-18056554,611
2022-01-22 13:17:19-05:00,8910,BLJgLzizx2yLgd12pVBAHTMqn9J5JA3JHCF8PnLnPyUk,HhDmwMysBFWhXnd3mrV31w75WBRKBS8wJSiEMZgqdUSp,True,3843058,960764,5798,2899,2899,4BnQKPLuE3DMTtxp8MjUBytgnhvxqq3ZTqZHTVZo4JJh,231947,3905404,-3673457,603
2022-01-22 13:17:19-05:00,8911,FV9CBGGTbppLnBKh79f2LzD1diTiS5g6u89FcpZHZmnK,Fe7mtmCUziFqbbYTvrhAcAq1Ub7YLfTJRtQ1hG7GzJD1,True,20461,5115,31,15,16,3zqXX6kzhkbW3d4TwD2CNjMRwxTbREXySekvq37kfCNk,1246,18899,-17653,608
2022-01-22 13:17:19-05:00,8912,6sK2PQyTvStxT9qigrFaPmf9GSe4X4wLb4ig7izrzwaB,6iyTuXdnBiLrKPCat7ajRnUq2245L9bbJrHAvsnyFx8e,True,6666,1666,10,5,5,3zqXX6kzhkbW3d4TwD2CNjMRwxTbREXySekvq37kfCNk,411,6472,-6061,616
2022-01-22 13:17:19-05:00,8913,3tQBuHwr3V8AZu8Yqhg1UfmnFoxzkUq9UeGeLm41UHy4,9cESwduiHBgrxZK1hN1eAFwnyfxw3FEHezTa8Ue5Kpye,True,78632429,19658107,120546,60273,60273,3zqXX6kzhkbW3d4TwD2CNjMRwxTbREXySekvq37kfCNk,4821857,50727817,-45905960,613
2022-01-22 13:17:20-05:00,8914,8ARSFh2vPjz7M1pjNqFRsRrHFGwVsUNnD7kLbqhmMrZR,9TGsutLwHv259Le8zfZ75FM4eLZffi6itgWBgYqeKkAy,True,6545628,1636407,9987,4993,4994,3zqXX6kzhkbW3d4TwD2CNjMRwxTbREXySekvq37kfCNk,399506,6452605,-6053099,610
2022-01-22 13:17:21-05:00,8915,2EkjFzKuqQaT9iLsf4qHnXM6rnbj7ftEyzzRsWx6D347,9NpHNbrRJF3U8Ub4KraPHhhZpyZk9Teo836dJSktJMEV,True,8651420,2162855,13022,6511,6511,3zqXX6kzhkbW3d4TwD2CNjMRwxTbREXySekvq37kfCNk,520908,4990741,-4469833,602
2022-01-22 13:17:27-05:00,8916,DMgD2KCEhTGFLUZ5GnfNcwfiiwKYbyVpoWiN6knMkCAf,5KU2vgBkPTNVHsSULjgX7ZkZS56U3Dy3xqLTxL5sUZJ3,True,5364633,1341158,8261,4130,4131,3zqXX6kzhkbW3d4TwD2CNjMRwxTbREXySekvq37kfCNk,330475,6577863,-6247388,616
2022-01-22 13:17:27-05:00,8917,Aop82qT6CwZbomif4QowqP3VaSHKB1837B2yNKqw4tER,65BVa4jrCx9etU5eXBAXT2PVnwVot2HLWGYyNXbVJDFk,True,13439141,3359785,20489,10244,10245,3zqXX6kzhkbW3d4TwD2CNjMRwxTbREXySekvq37kfCNk,819578,13006808,-12187230,609
2022-01-22 13:17:27-05:00,8918,HGJoZvLakWfSDFwuvShNBc4kCf7nP7VqzyM3mELpbFEf,12Qn5jin7QvsBngXqYAv4UstyG3b6nRf1jsLp9Dp8G7k,True,60998,15249,93,46,47,4BnQKPLuE3DMTtxp8MjUBytgnhvxqq3ZTqZHTVZo4JJh,3752,61805,-58053,615
2022-01-22 13:17:28-05:00,8919,3sGCWcgPY7TzRCkFR1uuY8KcUzVRbdTyFYxh7V1csNMX,CcRFNnG2uhyLwhNAbX4U49jkMeC11kJtVhhyqDWdDK5r,True,27814657,6953664,41875,20937,20938,3zqXX6kzhkbW3d4TwD2CNjMRwxTbREXySekvq37kfCNk,1675032,27011467,-25336435,602
2022-01-22 13:17:28-05:00,8920,4oop1mjCh1Ao9NoWAUacAGc75GxiRTXr8KJ3NtzZ7btf,BfntjUunXBhnrKmocQ7pZr3wwxruRGudMyWQYC2MUhei,True,4028764,1007191,6010,3005,3005,HfEnetJ7uBSmZWCjBNxdvv9HEC5nsW4wDV7wu6WnhWan,240406,3804634,-3564228,596
2022-01-22 13:17:31-05:00,8921,5y8ZSWUnrm4B3emh7vLQKTh89vHtCvXqUhk7fJBA52is,Bu1AoKU2QQWpGH54ZzugvvACB3E1d3VvymnegNmTgHqg,True,27378037,6844509,41479,20739,20740,HfEnetJ7uBSmZWCjBNxdvv9HEC5nsW4wDV7wu6WnhWan,1659177,26483102,-24823925,606
2022-01-22 13:17:31-05:00,8922,4SX2pj4eHRwFMtyDCrMZ8ZT6ASAMi7yfZWZnccw5dGn8,Ads49ZqvTmPHxfzNYm4oJb4HBYhwS6vXQbarqmpUi5VZ,True,796753,199188,1232,616,616,3zqXX6kzhkbW3d4TwD2CNjMRwxTbREXySekvq37kfCNk,49297,790750,-741453,618
2022-01-22 13:17:31-05:00,8923,BJV5jbowrbELXfDvfMovaQy4PiRf12pLYHimW9bgzW5X,6WXrWso5FvLx7RMCFBzrbzh5qevKkk2LJAihUfWXxXzB,True,81443,20360,126,63,63,3zqXX6kzhkbW3d4TwD2CNjMRwxTbREXySekvq37kfCNk,5046,123725,-118679,619
2022-01-22 13:17:31-05:00,8924,6Z6y2QLJUZ5s6zdjanJcKprTAotx8tqr9DRNqqycMeS4,JCYwt8MHVaBb14GB2qAvDWwYVMaL7VTxyNEt7Eo5Zy8x,True,802082,200520,1249,624,625,HfEnetJ7uBSmZWCjBNxdvv9HEC5nsW4wDV7wu6WnhWan,49986,793545,-743559,623
2022-01-22 13:17:32-05:00,8925,9BMHbUs4d3qX49fnroHv2FTPDs4yoDFrvDMqf8p9U4pE,2yL7zwMr7qVG5Sdwkf7z6ppnNqt1ASppBbmxwYjfFY6Z,True,15206908,3801727,23751,11875,11876,3zqXX6kzhkbW3d4TwD2CNjMRwxTbREXySekvq37kfCNk,950055,15080929,-14130874,624
2022-01-22 13:17:34-05:00,8926,CJpe9bNHxS63QMaGJhmnr4u7eTo6e5GApZQZyPtXLAkk,EMVL4sDfVXwGEoGEYwLp8D6itfy3eu4FZBAj1kMz6uXa,True,26141750,6535437,40138,20069,20069,HfEnetJ7uBSmZWCjBNxdvv9HEC5nsW4wDV7wu6WnhWan,1605531,25292920,-23687389,614
2022-01-22 13:17:38-05:00,8927,FdYFnEYtFQKcZPmzUqnvNLzozxdR1emtkmvnYcMgYykS,7arWNJQf2cWxerjhLgQh9CJxwTat1efnr5KmhuD7Qnv4,True,761308,190327,1168,584,584,HfEnetJ7uBSmZWCjBNxdvv9HEC5nsW4wDV7wu6WnhWan,46741,755167,-708426,613
2022-01-22 13:17:38-05:00,8928,As81koHnSP9quoXuUVNHp3VR3Qaks8HLa4sFgJDocYiF,AMVm8dXia5s974VgZSbeE6uPDgyXDHZFyJ2W1J1CWvKW,True,27400220,6850055,42062,21031,21031,4BnQKPLuE3DMTtxp8MjUBytgnhvxqq3ZTqZHTVZo4JJh,1682515,26484258,-24801743,614
2022-01-22 13:22:38-05:00,8929,F6wpqqx576XRuYo8y6XPLYphojrQtK4VvdY79Jk6My5N,38VbNLaQzLFcVqHuSR9zn9UX3Yv9SCVy1mrwmxX9PpVQ,True,60159177,15039794,94073,47036,47037,HfEnetJ7uBSmZWCjBNxdvv9HEC5nsW4wDV7wu6WnhWan,3762938,15092123,-11329185,625
2022-01-22 13:25:05-05:00,8930,H3x9b27yHVdCxvtDf7mmJxkNeubcmQMwfAkLTYADPWNv,HGVCCz23rWx78vrTB2wvm2aesbLZuYFhhNuznGiSSAyA,True,282927843,70731960,442633,221316,221317,HfEnetJ7uBSmZWCjBNxdvv9HEC5nsW4wDV7wu6WnhWan,17705334,110389745,-92684411,625
2022-01-22 13:25:05-05:00,8931,CYQr97qwLjGnmEy6vVgs3eL7omwG6UfFbhTv7gBty5z9,DJJ9UqSZUTgyt2yWAkUnGFDuox3xYFQUuorLa7qPdM88,True,22745651,5686412,35335,17667,17668,HfEnetJ7uBSmZWCjBNxdvv9HEC5nsW4wDV7wu6WnhWan,1413431,8661780,-7248349,621
2022-01-22 13:27:29-05:00,8932,D7XummfEc3NTK4qMvZegV3FrYuqc8mNgnQu3ujwemZtg,HHiRcecqzW7sGFTio7Ph6TYv3dGt64KWv4DEKgKm84fQ,True,40318,10079,62,31,31,HfEnetJ7uBSmZWCjBNxdvv9HEC5nsW4wDV7wu6WnhWan,2507,41142,-38635,621
2022-01-22 13:27:34-05:00,8933,4hZG7dM716SxDagiFGwt1gSC99B2QK1emGLV9TJmmuR8,7vjfUWySkyx4Z5qAaRr2VWnVvxHHNsvPj1PirGNSjM6,True,1357666581,339416645,2100187,1050093,1050094,HfEnetJ7uBSmZWCjBNxdvv9HEC5nsW4wDV7wu6WnhWan,84007504,842642521,-758635017,618
2022-01-22 13:27:35-05:00,8934,DvuRmJkfn6FQczUKgYeaSCqwy2NTMunuAKNrnmxMvnzS,7LpWTX9dgBtW75kfEoB5WuNsDwEdw5s8CYSHh3J4qagM,True,456845,114211,707,353,354,HfEnetJ7uBSmZWCjBNxdvv9HEC5nsW4wDV7wu6WnhWan,28300,468997,-440697,619
2022-01-22 13:27:36-05:00,8935,JCagxpXPs6wVRUWbNBPCZ4uLCkZsachnofN7SZEEwGwB,5uGj1TBCkc7FV4ffdBJg31yLcCxkQLxRExjcinnJUow9,True,793985469,198496366,1242221,621110,621111,HfEnetJ7uBSmZWCjBNxdvv9HEC5nsW4wDV7wu6WnhWan,49688875,687655904,-637967029,625
2022-01-22 13:27:38-05:00,8936,FV3G5EsSmyiLAAoREhgDXwvzbxoyDeq4Mwfj4jK5fJ7U,5nhzbJmm5JAwGDpTZoenkM1u3XtMY4uN7Qsm3vFGtRJE,True,444553,111138,692,346,346,HfEnetJ7uBSmZWCjBNxdvv9HEC5nsW4wDV7wu6WnhWan,27707,260689,-232982,623
2022-01-22 13:30:34-05:00,8937,5Tf1yqxsjGf6ALPmGxxFzjmmXgP2jVVHuPqkuqLCi4uu,9cWJzD8QLERJZJJTpXkDEfsTK3geNZQoigTuCL4a3PLG,True,244377927,61094481,382250,191125,191125,HfEnetJ7uBSmZWCjBNxdvv9HEC5nsW4wDV7wu6WnhWan,15290019,101952573,-86662554,625
2022-01-22 13:30:48-05:00,8938,2rLWe1XADCU93guPU6WgSW6x56gYNfif9bm11V93mJnv,BEGhQRm3fgSHeBtk2DYrXEBPKPRvS3sHyTNopmoBJxMs,True,7381379373,1845344843,11495733,5747866,5747867,HfEnetJ7uBSmZWCjBNxdvv9HEC5nsW4wDV7wu6WnhWan,459829338,3672270460,-3212441122,622
2022-01-22 13:30:48-05:00,8939,C1rjefgArnN3nBn5Wu3yXij2wAyGWFtWdjGNLR9vpjmj,GsLCESLzYGZ1brEh8RJrZttE7hxcpSq7iUqdhwJhnDVB,True,894268,223567,1399,699,700,3zqXX6kzhkbW3d4TwD2CNjMRwxTbREXySekvq37kfCNk,55971,760871,-704900,625
2022-01-22 13:33:44-05:00,8940,Frobc1KZTVcsyfwyKwSpHJobxmiJBomzHhGCLdrzdAz8,HziyKP9uxWCuXddtbRzWMczHNdgyQB5UXQZj4MnMm14,True,3387709,846927,5298,2649,2649,HfEnetJ7uBSmZWCjBNxdvv9HEC5nsW4wDV7wu6WnhWan,211942,1924938,-1712996,625
2022-01-22 13:34:09-05:00,8941,6NJFN855M3Q3RLTDNo57gTgAmwPD6G2E3WvMb1m5eNCN,3YpqNnonsvXaRT4nCC3G5FZx1jjVtbDPc36LiR6WK5jR,True,1856692,464173,2889,1444,1445,HfEnetJ7uBSmZWCjBNxdvv9HEC5nsW4wDV7wu6WnhWan,115583,1792433,-1676850,622
2022-01-22 13:34:09-05:00,8942,HHHj6EinpgAJeZkDXfsvCo3UXnmAdiAZNvPSUfVPc5Sg,3gx9c31MDtJtByxkUuWcqf1oARnZTjpx3QtxsM1Xb6Gp,True,18343777,4585944,28445,14222,14223,HfEnetJ7uBSmZWCjBNxdvv9HEC5nsW4wDV7wu6WnhWan,1137801,12212190,-11074389,620
2022-01-22 13:34:11-05:00,8943,8T4WK27RvWVGqPuNqY6whk1fmU4vd5qaUQPZG1GJ79bh,DvSz7knS8N3K7L6JhQf1s4mJSyxB8uJXNQXtyjJn8QRL,True,2235547,558885,3467,1733,1734,HfEnetJ7uBSmZWCjBNxdvv9HEC5nsW4wDV7wu6WnhWan,138687,1842601,-1703914,620
2022-01-22 13:34:11-05:00,8944,H1Z83zVoskNuBvYao1FjdLfETfhPpQFQUkniJfGxbaNz,EVqbBRV6Zy1tPLRevxpAykp8Mvv6tDZVTc4RmCKw4Gq1,True,49213232,12303308,76512,38256,38256,HfEnetJ7uBSmZWCjBNxdvv9HEC5nsW4wDV7wu6WnhWan,3060496,36905470,-33844974,621
2022-01-22 13:34:11-05:00,8945,HEFpdWLZaiQnjftmXgxs6RNzhH72YiMjortxPkKekkvb,5Q8mmxBgVTijNGrWsnoA3VMArLHZEX5MkaigYXHpgXHE,True,9387032,2346757,14612,7306,7306,HfEnetJ7uBSmZWCjBNxdvv9HEC5nsW4wDV7wu6WnhWan,584480,4240115,-3655635,622
2022-01-22 13:36:07-05:00,8946,GufVttJatW8NLeztT1NRQSLZpQNRk45kaG41p3QcWhx7,GTJUsWoWRyeafYJVhx2aRo8NE94U5UrBjaehmJ4PRUhn,True,684171,171042,1068,534,534,HfEnetJ7uBSmZWCjBNxdvv9HEC5nsW4wDV7wu6WnhWan,42728,427407,-384679,624
2022-01-22 13:36:09-05:00,8947,6kqKSyVVF4xxUbsvBCkY1kt4XcKzb98eSaqNw5fxSLtw,4T9DKFUmkcPG7mM3CKzW3m81LqqpU7oFTv35Pha4zHNe,True,40486105,10121526,62681,31340,31341,HfEnetJ7uBSmZWCjBNxdvv9HEC5nsW4wDV7wu6WnhWan,2507258,29496571,-26989313,619
2022-01-22 13:36:09-05:00,8948,DWTaeNeq5x83cBvKUz2jZfXDz5z4F5wbSZLNv7smnjvd,9pQGArZnJV4Fu8tBVEfknmmfmrRv5RKV2u58BJBuhzpF,True,2280688,570172,3545,1772,1773,HfEnetJ7uBSmZWCjBNxdvv9HEC5nsW4wDV7wu6WnhWan,141802,1615376,-1473574,621
2022-01-22 13:37:07-05:00,8949,BJaaH1SK1pF2kZQzmYpLFfDtm52CR9a5rd39RAPtLe8q,HUsT5FVxaisdnCvG1BQxX6zffjfL2Rwx5mMo5y8SDV7e,True,701049,175262,1094,547,547,HfEnetJ7uBSmZWCjBNxdvv9HEC5nsW4wDV7wu6WnhWan,43789,449278,-405489,624
2022-01-22 13:37:18-05:00,8950,5FgPU7KpsDnx4Xc1UdQoLPR7MDd5cBkJXW2Q8ctopMZR,9GWzAZFVfTY8WjTYvDAE2YcAjgeKiDXgToK76KBZF7Rv,True,1287296,321824,1917,958,959,HfEnetJ7uBSmZWCjBNxdvv9HEC5nsW4wDV7wu6WnhWan,76691,1238833,-1162142,595
2022-01-22 13:37:18-05:00,8951,Gfe4UgUGqvzcehSbETrWwLRAcqzFnkTrs6vJx8h6kTxi,7exMQ8sLti4Pmb2ZQtZhyuWRuQ6pq7XSXL9sCcWTqCvF,True,79165053,19791263,118204,59102,59102,3zqXX6kzhkbW3d4TwD2CNjMRwxTbREXySekvq37kfCNk,4728188,77347976,-72619788,597
2022-01-22 13:37:18-05:00,8952,43wwd6zLB8yKfXEu7rtbeDFhKBuxFR66MnyhTKW3zqa3,A9t6AMvVNenwWymz3QMtdUuuGYjjTPLaA9bhRjTzNY9h,True,15172256,3793064,22519,11259,11260,HfEnetJ7uBSmZWCjBNxdvv9HEC5nsW4wDV7wu6WnhWan,900793,15122567,-14221774,593
2022-01-22 13:37:18-05:00,8953,Gs3WP18hbzNpbBgiU39e6tfkggfCKRyNqPqJQcthuHFD,4XAY25YUma6gUdG2GdbXeivum3t21g93ZagfWGTZYkWZ,False,321971,321971,16049,802,15247,3zqXX6kzhkbW3d4TwD2CNjMRwxTbREXySekvq37kfCNk,16049,264491,-248442,498
2022-01-22 13:37:18-05:00,8954,8GhXRNmsEgFgKPhGNNgEPUywVzW3bE7uZRWys2P1yNeJ,Bvi5vD5fhRFNdVhEXsSv9vkJzyQzgEswFHBxowkUEgF,True,8421601,2105400,12871,6435,6436,3zqXX6kzhkbW3d4TwD2CNjMRwxTbREXySekvq37kfCNk,514840,8291602,-7776762,611
2022-01-22 13:37:18-05:00,8955,AwzEZdWCsm74G3ChJPpYJ3JDhNzbcAoznnBW4veubndv,nvjiDwGDTkBKBVjk3Yhe6n4xDTVssFcqHiBKdUPNhNt,True,21862,5465,33,16,17,3zqXX6kzhkbW3d4TwD2CNjMRwxTbREXySekvq37kfCNk,1322,11816,-10494,604
2022-01-22 13:37:19-05:00,8956,DD1a8rMoUCwmEiLKRN43VpdqL8Qgfr5yi92ejQxDVRMo,3vMJVNAuyRhM9jkaEZARhwbR6MerR5UmcgoZ9c5bs1VS,True,17815594,4453898,26449,13224,13225,4BnQKPLuE3DMTtxp8MjUBytgnhvxqq3ZTqZHTVZo4JJh,1057991,17757233,-16699242,593
2022-01-22 13:37:19-05:00,8957,43EtYHdVkdBxHTtFR3QWVgvCKj1SqsAf7xLY2yphsv1x,8WJbP4mVJWYuN1dVzHpRg7YR2nBELB4Krkq8Zch8sp4g,True,1190812,297703,1768,884,884,HfEnetJ7uBSmZWCjBNxdvv9HEC5nsW4wDV7wu6WnhWan,70743,1101292,-1030549,594
2022-01-22 13:37:19-05:00,8958,7feC64HZfQpniey2iXsMMgQXnfcunJus74DiKDeKaEUw,GstsCxAiBBEUrXNkvZZ9Sg4vNK916PsKe2Mx6e4M6dU7,True,29747,7436,45,22,23,3zqXX6kzhkbW3d4TwD2CNjMRwxTbREXySekvq37kfCNk,1825,25538,-23713,613
2022-01-22 13:37:19-05:00,8959,Hqzz5RdbkkmMPCVdxF3Q3sLuh7XVJHEwAP6zpz7pCwTj,TNwXSETgrJGM9S5zbBY3mMWKbPFskbKjPAhBrWFNfuK,True,870358,217589,1293,646,647,HfEnetJ7uBSmZWCjBNxdvv9HEC5nsW4wDV7wu6WnhWan,51727,864314,-812587,594
2022-01-22 13:37:19-05:00,8960,AzLdwyd8Q4V3iMaSwWgvWwQ9nCs7X7YV2YKpd6CH33nP,BYjeXF5YkcJy3mNMbvfHzXTtyjkc4U53hM5tvfERUH8y,True,970596,242649,1487,743,744,HfEnetJ7uBSmZWCjBNxdvv9HEC5nsW4wDV7wu6WnhWan,59488,963272,-903784,612
2022-01-22 13:37:19-05:00,8961,9WRDBHzD4aNHw5qvrhc6nqXCBLA5D7YYP8TvSrLksXd6,GwxWNmv9XDkqQsx7DfCMccFjVik8asPnFU9gtnb4UVx,True,755530,188882,1140,570,570,3zqXX6kzhkbW3d4TwD2CNjMRwxTbREXySekvq37kfCNk,45604,750792,-705188,603
2022-01-22 13:37:19-05:00,8962,2jDRvE3pQNjWy1NRFa4tzB3KmU5UkbUCHw8sQRFujo66,C4zNi2szDrEEh4coTF3WRUghfP4ZwAVVSYTLWfkejQRu,True,6324692,1581173,9895,4947,4948,HfEnetJ7uBSmZWCjBNxdvv9HEC5nsW4wDV7wu6WnhWan,395819,4891760,-4495941,625
2022-01-22 13:37:19-05:00,8963,4qWzk4JP2gEsTP252Y4SJrjSmfRBxDfE4ZdbPmwavfb2,CAgDhCNVyy61FG2YPMnm9zxgY56s2UqPhvssH5G1LjXP,True,104140147,26035036,155977,77988,77989,HfEnetJ7uBSmZWCjBNxdvv9HEC5nsW4wDV7wu6WnhWan,6239109,92024264,-85785155,599
2022-01-22 13:37:19-05:00,8964,G8nRLTWTT5aD7q7TcSa2mw7p12GUuHDVq5ev4vyXbdKi,3DmQyungZMK4T1a1PgXh5shBskwP69tTLmZPh7HZ76vh,True,1427114,356778,2195,1097,1098,HfEnetJ7uBSmZWCjBNxdvv9HEC5nsW4wDV7wu6WnhWan,87819,1416443,-1328624,615
2022-01-22 13:37:19-05:00,8965,4nhdidD6SASYzwZ7mUnWKyP4xyWXhdBe2gp5F4qDtLrL,HLk6YPhVidsn3i8HfoASvoim1ztxb4bi8JnioiyvorpV,True,5469074,1367268,8062,4031,4031,3zqXX6kzhkbW3d4TwD2CNjMRwxTbREXySekvq37kfCNk,322496,5293785,-4971289,589
2022-01-22 13:37:19-05:00,8966,HZSJVNb6g4o52N7pAJCLkGjur8evF5Ex1sAx7uUxUDdm,8LQHKhXStrwcd6f4AxaTVcrGdYpGjQz8vWf5JXsAzcsp,True,1119501,279875,1646,823,823,4BnQKPLuE3DMTtxp8MjUBytgnhvxqq3ZTqZHTVZo4JJh,65863,1116469,-1050606,588
2022-01-22 13:37:19-05:00,8967,6aW9dhnTNerVd1MPv5GrcYqgjVPE9LsNCGYSJSrNdgS8,8kmJu2UxTk2T37sqxDSrf6pDWhJZRxfRdJB7DLeoWddJ,True,32248610,8062152,48139,24069,24070,HfEnetJ7uBSmZWCjBNxdvv9HEC5nsW4wDV7wu6WnhWan,1925563,30465476,-28539913,597
2022-01-22 13:37:19-05:00,8968,DE8c5VWwgCqQnUMSyMZEbKazQAsSjY52L85yojCr57X5,6ycUU1Tc7HG3J8hE6jwkRFCkdbEqyU95ZKY6HbfnYcGo,True,3207,801,4,2,2,4BnQKPLuE3DMTtxp8MjUBytgnhvxqq3ZTqZHTVZo4JJh,190,3123,-2933,592
2022-01-22 13:37:19-05:00,8969,EAUFD16wab8qRMJ4H6updHGt4xFqgRCDeRHVCsLCTSTL,8vkfYSyCyBY9g4TZrp52jUcQj6udy9xAaA4fioRE2RXx,True,585239238,146309809,908678,454339,454339,HfEnetJ7uBSmZWCjBNxdvv9HEC5nsW4wDV7wu6WnhWan,36347125,325698650,-289351525,621
2022-01-22 13:37:19-05:00,8970,45AiuRBbmupfwYXqsWwKHtmEWN8XNJDUSHwHL3b6PvHc,CfvwVkxYPP3jqK2dpAvSRFA1513E9ti84mEpYgtkzFUt,True,1660033,415008,2487,1243,1244,4BnQKPLuE3DMTtxp8MjUBytgnhvxqq3ZTqZHTVZo4JJh,99483,1591430,-1491947,599
2022-01-22 13:37:19-05:00,8971,6X5por58mMECmNZQEWpo8M8aA1eHJqr5LNeV9vC7GW5e,DPB2C5UB2Ls1kNzbs1GP33junQvhUyFJWP75RoYjqByn,True,52055026,13013756,81413,40706,40707,4BnQKPLuE3DMTtxp8MjUBytgnhvxqq3ZTqZHTVZo4JJh,3256547,82658906,-79402359,625
2022-01-22 13:37:19-05:00,8972,3R2wxFQwjCqUwwxJmp9tNrT6osYFpB5gczq2QYik6QYm,7At5Ej3ZsynfWr56FYrd4P4Y6UtD8FHA4gCFB8TaAyaG,True,976721,244180,1468,734,734,HfEnetJ7uBSmZWCjBNxdvv9HEC5nsW4wDV7wu6WnhWan,58758,970430,-911672,601
2022-01-22 13:37:19-05:00,8973,8YMEydGnQH9W5AEXFGquFkb1bcf3PcxiMvYBSMPXKJyQ,3CmWH8eYtkmHNisqMmMBLff6C6z6ZcSj38KoQ34DPUE7,True,764211,191052,1141,570,571,4BnQKPLuE3DMTtxp8MjUBytgnhvxqq3ZTqZHTVZo4JJh,45674,706321,-660647,597
2022-01-22 13:37:19-05:00,8974,68F35fonSGS1P6LMYmAmeoM8kC6Z78NabMqYLeCZr9GJ,8apmWSZdS8s1ScoNVj4AvSJsbQCj1drU3HL74khuANT2,True,1038376,259594,1570,785,785,HfEnetJ7uBSmZWCjBNxdvv9HEC5nsW4wDV7wu6WnhWan,62817,1030666,-967849,604
2022-01-22 13:37:19-05:00,8975,ANXYsUNpZ34dBt7cp6HEE7oi2pTKsbj7B5TeFHKPbHBU,2pqeP4fuMREosHcfWUecEBssp1GM4isihNjn7ALUD51d,True,1188416,297104,1855,927,928,4BnQKPLuE3DMTtxp8MjUBytgnhvxqq3ZTqZHTVZo4JJh,74217,1180060,-1105843,624
2022-01-22 13:37:19-05:00,8976,2DHhfXSzcuSwsKfAYLMuWuD17w84mCwNer9fcBNLTpSc,89BVfDycKjdSkQzFVqCXd5c16DntdND7WsqoZtCafYFH,True,46719235,11679808,69920,34960,34960,HfEnetJ7uBSmZWCjBNxdvv9HEC5nsW4wDV7wu6WnhWan,2796801,45058687,-42261886,598
2022-01-22 13:37:23-05:00,8977,5iRLEmB6qBHqkJBPyyubnd9f1TpRr4EY8BTxuHUREeLB,GkY73KL6HJ4ycdggFtYWALBgmTRZVCx66P2ZJ7E8ENwC,True,831156,207789,1223,611,612,HfEnetJ7uBSmZWCjBNxdvv9HEC5nsW4wDV7wu6WnhWan,48946,827980,-779034,588
2022-01-22 13:37:23-05:00,8978,EPWsutEpgpcz776maq552k8QhDKdmkSfAED5E3jgpTdY,CCwGZYDvqoHEBBtSSieAJgy5e3k4jYrpjyDffypwnWxu,True,40481716,10120429,59874,29937,29937,HfEnetJ7uBSmZWCjBNxdvv9HEC5nsW4wDV7wu6WnhWan,2394978,38892229,-36497251,591
2022-01-22 13:37:23-05:00,8979,4cNmhgaMic1xBiaDJ6phrQuXmm8WfF1qjyYMqZcKG4c9,43vgfXiLTtcs1bkrcDar2iz9M6RMbGqbA6BMkBHdh7T4,True,915141,228785,1368,684,684,HfEnetJ7uBSmZWCjBNxdvv9HEC5nsW4wDV7wu6WnhWan,54724,915825,-861101,597
2022-01-22 13:37:23-05:00,8980,69byqtDPmgEY1NqKBCR95CEPVHRUxgbNW9Y4P4HjQ7ND,E47T4q4zMGzNL6vDxgWdLn3EQbW3WfVryr8Jsymy1hAL,True,1612352,403088,2520,1260,1260,HfEnetJ7uBSmZWCjBNxdvv9HEC5nsW4wDV7wu6WnhWan,100820,1457840,-1357020,625
2022-01-22 13:37:23-05:00,8981,HxhVxMpFpKzeuC6Z6CpsuUhPHdHUzvpMNYJ8LpQ3NYCp,8KyiipC39iU15zVErVvj6hdhbv89STsexrB8dVw3RcLs,True,1022880,255720,1535,767,768,HfEnetJ7uBSmZWCjBNxdvv9HEC5nsW4wDV7wu6WnhWan,61424,1017633,-956209,600
2022-01-22 13:37:23-05:00,8982,9QZvB1Gqhk5PKt3MoJMjZL3FaU2bTbTDcVw3nF316zh7,DGJWGr9RCWkzdWn21mWG7NyUN8uuvSQbA53HojFJe1rH,True,12575152,3143788,19634,9817,9817,3zqXX6kzhkbW3d4TwD2CNjMRwxTbREXySekvq37kfCNk,785374,12025419,-11240045,624
2022-01-22 13:37:23-05:00,8983,Dqnxcekm1QfxGQ2FSJ6SjFiwmaQRWEjW9WTJQG4AjEpE,9JiMtjm5AJqngosRg787FiN8NyuBPuAPD2jYpRQkAc1d,True,1272065,318016,1978,989,989,3zqXX6kzhkbW3d4TwD2CNjMRwxTbREXySekvq37kfCNk,79148,1263605,-1184457,622
2022-01-22 13:37:23-05:00,8984,2AAWghW6BUAFBtF3R6hB9uoqMc5oUDkU8FTd2JrXKema,798cfEUZ2YhXwNTNjXMS4Z2J8gAHaK4zZwpMkq2HzWWM,True,5241973133,1310493283,7845567,3922783,3922784,HfEnetJ7uBSmZWCjBNxdvv9HEC5nsW4wDV7wu6WnhWan,313822705,3444503393,-3130680688,598
2022-01-22 13:37:23-05:00,8985,8xjstKJD2RopRxxRP8JbMYRmpBKgSZivMFRXXRZ5syPh,HUfevkvBsm5SDpxnZ4NBD8Re7LvqBQLrx5UWXCeYTBgK,True,1442051,360512,2143,1071,1072,HfEnetJ7uBSmZWCjBNxdvv9HEC5nsW4wDV7wu6WnhWan,85730,1389552,-1303822,594
2022-01-22 13:37:23-05:00,8986,C1tcxAjMzZaFVcF2ke2nSyiCjcLBwsz5yKXShy5MB14h,GYkrJj2zHVZuzPC45MbuevYkRJHdeL4Sqj9SWqZfUdiE,True,50930966,12732741,75353,37676,37677,HfEnetJ7uBSmZWCjBNxdvv9HEC5nsW4wDV7wu6WnhWan,3014143,48738161,-45724018,591
2022-01-22 13:37:23-05:00,8987,EmXaq1sxmAZUiwYW6LXpKtKFZXu5MzQ3sK4MEAojDK1h,HuAsa5G2wJi8Ah9stxEmggwcB5zW1QjBsP3Ndgke7r8X,True,1303439,325859,1940,970,970,HfEnetJ7uBSmZWCjBNxdvv9HEC5nsW4wDV7wu6WnhWan,77607,1295993,-1218386,595
2022-01-22 13:37:23-05:00,8988,E8iuHK2DErFnMAYfWmNoix4jVb4WDG8Sc41hBycLUxbd,77Zoru23JmnK5EJ8eURonQoEpJcLP4edabjD8MR8NKdX,True,15096476,3774119,22151,11075,11076,3zqXX6kzhkbW3d4TwD2CNjMRwxTbREXySekvq37kfCNk,886057,15052022,-14165965,586
2022-01-22 13:37:23-05:00,8989,4eaXYcx5ayhTq9TmmQFgLDjy6p3z93txUN97v8PTSh1J,J3vgUnjDUy5ngrmrs6FwpZTexxJNxXM1UjsHvsgw9g9y,True,973701,243425,1444,722,722,3zqXX6kzhkbW3d4TwD2CNjMRwxTbREXySekvq37kfCNk,57763,969658,-911895,593
2022-01-22 13:37:23-05:00,8990,CygwJ5Z1ZP6xfjN1ZGH7yw8b2oYvf6JTpenXx7A5yFdt,59VKgJtBCTb3Pji7BWtqttisBYVVCnWtyEn5Eba5r52Y,True,16964007,4241001,25406,12703,12703,HfEnetJ7uBSmZWCjBNxdvv9HEC5nsW4wDV7wu6WnhWan,1016265,15689741,-14673476,599
2022-01-22 13:37:24-05:00,8991,446VESPwhh16pG3VcpgraT83MoqWy87qgU36mKZC8BsW,SmUPkPpnnRfSH3tcKUnbpK6HHNJtLfvMiUWk9eUwkNy,True,40231829,10057957,59727,29863,29864,3zqXX6kzhkbW3d4TwD2CNjMRwxTbREXySekvq37kfCNk,2389091,38670931,-36281840,593
2022-01-22 13:37:24-05:00,8992,28YQqynu5oRud5xEcsDvAaGhJhgpiVJSTNeMwkrbpbyv,9zYqRWiRatbohCdBfV3PrAxp8v1kwgbvV9ta4RJRRp68,True,39663124,9915781,58812,29406,29406,3zqXX6kzhkbW3d4TwD2CNjMRwxTbREXySekvq37kfCNk,2352493,38111508,-35759015,593
2022-01-22 13:37:24-05:00,8993,8nXbrdjjaHB73CRPRenGEQj73wbtEFGDwXsehRGMhsap,43pvdcJ6f27wz94D6ZboKwRJYbyvYCrjsJhYsvk7LJCM,True,241315,60328,358,179,179,4BnQKPLuE3DMTtxp8MjUBytgnhvxqq3ZTqZHTVZo4JJh,14336,154217,-139881,594
2022-01-22 13:37:24-05:00,8994,AECUZGm5DjFvbLZEUYhepSPg1Wa7hBjxF9e7ZRBzRPhm,Ar7e1iLKAqa54QiQnXifvnETixDZT1T8KL5YWJA8Ykv1,True,1182460,295615,1801,900,901,3zqXX6kzhkbW3d4TwD2CNjMRwxTbREXySekvq37kfCNk,72069,1174031,-1101962,609
2022-01-22 13:37:24-05:00,8995,7afnF1MkAootZGWc7zsMVLpBuve83hGmvAHkfmwgsq5A,HKdJE8bReznq1Qxqd5iZ4nWQGCk62Vo5TpkRD51bpbGp,True,1002483,250620,1509,754,755,3zqXX6kzhkbW3d4TwD2CNjMRwxTbREXySekvq37kfCNk,60366,996146,-935780,602
2022-01-22 13:37:24-05:00,8996,8VQ21PFXdHBNmiZiF18LyGvsRSpr13vkyktfembNCe3m,5exbVC7vaGFeHEGAx7epYfMaU932QafqzfhFm5FKAq2H,True,883253,220813,1362,681,681,HfEnetJ7uBSmZWCjBNxdvv9HEC5nsW4wDV7wu6WnhWan,54518,876867,-822349,617
2022-01-22 13:37:26-05:00,8997,HZJyrD4eqM4nKnyRh2JAs1sC2TaJxFhNPixBdK7PLMuS,Hycz71z4tEsKUogJnefT2GN3MPCLdTJdv9B6T82Ngw2u,True,4201914,1050478,6311,3155,3156,3zqXX6kzhkbW3d4TwD2CNjMRwxTbREXySekvq37kfCNk,252455,4206701,-3954246,600
2022-01-22 13:37:26-05:00,8998,GcjcaWoMUcGkLaJBx3svxtzwGNn5SLcFrwaLqnpadUZY,Ep9sDjTMMasVjKdshsE88uk3mWYkKuMTVRooVJWvCq9F,True,14802133,3700533,21737,10868,10869,3zqXX6kzhkbW3d4TwD2CNjMRwxTbREXySekvq37kfCNk,869498,14741934,-13872436,587
2022-01-22 13:37:26-05:00,8999,73PpLzJmAimmqtjGpRcYHua8t6wx3gYiiXFvQxnSDMJV,CRCpLcS8LNKX22co94spJBXEes9Fnh5rYBvbVEte4JXA,True,114276900,28569225,167007,83503,83504,HfEnetJ7uBSmZWCjBNxdvv9HEC5nsW4wDV7wu6WnhWan,6680297,101399746,-94719449,584
2022-01-22 13:37:27-05:00,9000,HpRYrL8HzCPaBJTLFgZmYg2aXBnBQUpf1mikVkzkY56z,8DzHRd8qWcEjnX6cefwYtgRGpQJUaw9QPjyfAsN7j33r,True,9932274,2483068,14785,7392,7393,HfEnetJ7uBSmZWCjBNxdvv9HEC5nsW4wDV7wu6WnhWan,591427,9641642,-9050215,595
2022-01-22 13:37:27-05:00,9001,9rgrRAMcGSarfz8xXckw1LjkemMwwjzJLApPjpfY2XZ3,BRtNdDDtCiNDYDERZTBCefUiYvjShucRX1hxEBLyeggT,True,768493,192123,1125,562,563,HfEnetJ7uBSmZWCjBNxdvv9HEC5nsW4wDV7wu6WnhWan,45031,766135,-721104,585
2022-01-22 13:37:27-05:00,9002,4yhW5mBsFVNgQ5QQc2Yg65guctPsTSXcERbzmYM6rdnL,5uJnMZ6DWA9bMSvHvS5zomwtt1sv7YCWq3GDJh77YC3q,True,957630,239407,1407,703,704,3zqXX6kzhkbW3d4TwD2CNjMRwxTbREXySekvq37kfCNk,56284,956578,-900294,587
2022-01-22 13:37:27-05:00,9003,6kt64nJRnYaWMi9GbpZaUuhbToAVRd7FUMTGASAAJrve,2Sdxv9ZtogNcVbJwBPxKmVjwAiKyX5GHEfnRmFcydQ1G,True,113323654,28330913,169197,84598,84599,HfEnetJ7uBSmZWCjBNxdvv9HEC5nsW4wDV7wu6WnhWan,6767915,100661611,-93893696,597
2022-01-22 13:37:27-05:00,9004,AiLCB8xw3k5FXdJE1T42PLFhHrz1bLTKpNekR61a915N,HB7CNWxLipWAc6MPGq9wV4TT7AYjiELA5T3onYeVqBbU,True,19632306,4908076,30611,15305,15306,4BnQKPLuE3DMTtxp8MjUBytgnhvxqq3ZTqZHTVZo4JJh,1224475,19675880,-18451405,623
2022-01-22 13:37:27-05:00,9005,6Bq55LtGCEeGqh4JrFLCmmGc2iJfTTBJixivqH78aGSE,DSNrCgWJeNe2P9tAQu5FvCueTzNKDKds7wzuwTQSMRG,True,25709,6427,37,18,19,4BnQKPLuE3DMTtxp8MjUBytgnhvxqq3ZTqZHTVZo4JJh,1516,23686,-22170,589
2022-01-22 13:37:29-05:00,9006,BMawc4jLJMER4ryGcwdm27H3MU8JQCiSfwb9onVfYDpr,5ciaGDuaB3rBKvV7MphT2eMkCUxBzWZc7zYXQM7vbQ46,True,5722912,1430728,8491,4245,4246,HfEnetJ7uBSmZWCjBNxdvv9HEC5nsW4wDV7wu6WnhWan,339654,5531668,-5192014,593
2022-01-22 13:37:29-05:00,9007,95urWGJ4HN1bTarbDi8Dpj4K4ms7dovs8gwaYdaSLC6e,2THhqxjhXjp2Zui9ML2MzAbGN4dsfa3dkdqzC8LYhnbQ,True,1424807,356201,2088,1044,1044,HfEnetJ7uBSmZWCjBNxdvv9HEC5nsW4wDV7wu6WnhWan,83544,1373258,-1289714,586
2022-01-22 13:38:40-05:00,9008,GM22yjVoBCzgBcVTT5EcgRhVWiXVV82kSj1dPCbegKWj,CDDy8JmJMwJyx1YAvEPpj8AYxCpngRovf3wWfVzao5Rc,True,577233,144308,903,451,452,HfEnetJ7uBSmZWCjBNxdvv9HEC5nsW4wDV7wu6WnhWan,36130,303041,-266911,625
2022-01-22 13:38:53-05:00,9009,EDSf2w1UyGvbgMuxyoXL58ifR1dviZinnLBYnFmgjcNG,DFenkzbL9SUjs9cSCaHJ1eXK75mHfk3GSPRFs8TSzrFV,True,58194830,14548707,89428,44714,44714,HfEnetJ7uBSmZWCjBNxdvv9HEC5nsW4wDV7wu6WnhWan,3577157,29372227,-25795070,614
2022-01-22 13:38:53-05:00,9010,6uZobpBuFcQeYgZ4dApFi6iy4DB9GLHP1AAsQcCj6212,SGGFiPjjhscwroiWMqY4jTAHFw8eakpsEv35wNoHUPY,True,9533144,2383285,14855,7427,7428,4BnQKPLuE3DMTtxp8MjUBytgnhvxqq3ZTqZHTVZo4JJh,594228,3601281,-3007053,623
2022-01-22 13:39:33-05:00,9011,4ne6vC7qdxQYHJCsaeFAKZrKdFt2SwXGHQ3jrMHqt4DL,Cf1dLHY2WXH9rXbRKq5TT8THbdo9SdNUZq4rYhRCF9z,True,943840,235960,1468,734,734,HfEnetJ7uBSmZWCjBNxdvv9HEC5nsW4wDV7wu6WnhWan,58737,584625,-525888,622
2022-01-22 13:39:50-05:00,9012,3oCun4gm3k8sXxVxiYM8okGi8iCXH9LvDkHf9PBQWYXR,E1np1dZ7jUm811ddvy1jQerBwGSYb5BbZWnUHeotvrfH,True,3012897,753224,4693,2346,2347,HfEnetJ7uBSmZWCjBNxdvv9HEC5nsW4wDV7wu6WnhWan,187752,1217423,-1029671,623
2022-01-22 13:39:51-05:00,9013,DjbEch16uzdDtujFUeqxjquTTS3JXzEys8e9ogUv3aTy,6N8eKb3kfcbJEUZKZERiFiUR4hubB635D8Sotiji2TU8,True,117574231,29393557,183709,91854,91855,HfEnetJ7uBSmZWCjBNxdvv9HEC5nsW4wDV7wu6WnhWan,7348399,104914646,-97566247,625
2022-01-22 13:39:51-05:00,9014,D58t4uTjFumsUeYFaKnpV8BRTEQEqKXBreFTdwGrott7,67p6kHDfVqQijfcwugvZK59c3aRRH9x3eHxruqH8WEqF,True,5113056,1278263,7992,3996,3996,3zqXX6kzhkbW3d4TwD2CNjMRwxTbREXySekvq37kfCNk,319706,2607302,-2287596,625
2022-01-22 13:39:53-05:00,9015,Go3ne58krEsFsZ5yu9EBT7od15VCYmtbs1KhumRMTiXS,HCvwQ7HjmmeDXrguZQPrAbJjcCJzHqVZK2JMSFkFDWfe,True,334524,83631,521,260,261,3zqXX6kzhkbW3d4TwD2CNjMRwxTbREXySekvq37kfCNk,20863,346175,-325312,623
2022-01-22 13:39:53-05:00,9016,8XcMucCQpWfNtbdCYnKuabk91NQ9wfYp7byk496CwU9n,DLrApDfWcyMqufEFZm9PvddsMoiediT58X8e8pxpnzrk,True,1600667,400166,2496,1248,1248,3zqXX6kzhkbW3d4TwD2CNjMRwxTbREXySekvq37kfCNk,99842,1532284,-1432442,623
2022-01-22 13:39:53-05:00,9017,4HDEN1Thxm9RbdE8pXnLP4QksVdXfp7Fa9nAnMRzr7oR,8gD3DbF6VhPTCgk3A4G7iA4f3DPH598Hj7TRJ2FebMCq,True,1260902,315225,1971,985,986,3zqXX6kzhkbW3d4TwD2CNjMRwxTbREXySekvq37kfCNk,78855,1208314,-1129459,625
2022-01-22 13:39:53-05:00,9018,CM95f7KjJuAf1xVTWhu3wrp6BfMz116FbgkxBhcRNs4k,EG55wkH5NcoasfBUYhD5D2dc2uvo11dZ3uTu5wgs4gf2,True,1706170,426542,2660,1330,1330,3zqXX6kzhkbW3d4TwD2CNjMRwxTbREXySekvq37kfCNk,106430,1625125,-1518695,623
2022-01-22 13:39:53-05:00,9019,6b7Ro2myM4HcUDqyyW9NEqTWPz8BWpH4eNFSQQci37So,7r7j7rSsa6YZcTuRPfs3KP44MVqUA4Q5NeJGmx84wbHq,True,410747,102686,642,321,321,3zqXX6kzhkbW3d4TwD2CNjMRwxTbREXySekvq37kfCNk,25691,422586,-396895,625
2022-01-22 13:39:54-05:00,9020,2ZX5NexeuZq25mAfBFDrwd44UfKhWgzmSwdhWFmo48c7,CpNnhSqg7EHn9g84gHoo831sVrAe5SkwNaEZAash4CXs,True,6607144,1651786,10302,5151,5151,HfEnetJ7uBSmZWCjBNxdvv9HEC5nsW4wDV7wu6WnhWan,412085,6618122,-6206037,623
2022-01-22 13:39:54-05:00,9021,Bbd196A866Y9rQWQFt4YGg2R6Jqj7WQGXWPDmrNtPcKf,5gmWk1KwLoRHnhkjxps4Ad6aVk4ZpcfC3McZCWDVCUbu,True,936019,234004,1460,730,730,HfEnetJ7uBSmZWCjBNxdvv9HEC5nsW4wDV7wu6WnhWan,58401,966040,-907639,623
2022-01-22 13:39:57-05:00,9022,EAtQUZAkQxwJF779DwPcWHZ455FzYX8mzm1uV5LBnhPB,8h8t6GW1Y7xMBfWpfyFfUVBP4apMbJVNg7igZUYZLsyr,True,5756329,1439082,8995,4497,4498,4BnQKPLuE3DMTtxp8MjUBytgnhvxqq3ZTqZHTVZo4JJh,359829,2610771,-2250942,625
2022-01-22 13:39:57-05:00,9023,GBpe8E33cNkFmMUuP3WjhDBBuQz7MHaDkpCJjGFaFkvu,3QYFKkgzZ1PKKAxCh4hMhgqrupoCcfRVkjuJZRWVZo3H,True,4003274,1000818,6257,3128,3129,4BnQKPLuE3DMTtxp8MjUBytgnhvxqq3ZTqZHTVZo4JJh,250289,2433860,-2183571,625
2022-01-22 13:39:57-05:00,9024,4eba4qAmwfqmihaYvTWFU9hm4VYrKvNhNywHNyimQJNK,G1DyxJcNQD8u4KGfnwxttyrJMfse1FBAsofioEMdTS9U,True,6060938,1515234,9465,4732,4733,HfEnetJ7uBSmZWCjBNxdvv9HEC5nsW4wDV7wu6WnhWan,378616,6063092,-5684476,624
2022-01-22 13:40:24-05:00,9025,EXP61AETWHw3kHSjrJH1jQBt6cXR9Zebz34Cueb3KAzg,2JT9GrgdUKjuQQtXvZqevbjFquUQBMYDoADmBjDKWXj3,True,23350824,5837706,36352,18176,18176,4BnQKPLuE3DMTtxp8MjUBytgnhvxqq3ZTqZHTVZo4JJh,1454101,14133698,-12679597,622
2022-01-22 13:40:35-05:00,9026,8swGZMrPrLAxZd7MxTbkCL13k3DmAJUw41jCp6Xo6awW,3fKnX7yTNXAT4uMmXVdTy47ALJT8h8YSD3WiBb4BGuzH,True,5660480,1415120,8719,4359,4360,HfEnetJ7uBSmZWCjBNxdvv9HEC5nsW4wDV7wu6WnhWan,348779,4509146,-4160367,616
2022-01-22 13:40:35-05:00,9027,GQviUdocJ1s4FsVDDexanvo5yQWRZgwwkGJBCg7TMtJC,HAX4VAKgQpKtm1149iRgtzvUaUkiXWcA1bJ9ERu6tXkd,True,5054298,1263574,7896,3948,3948,HfEnetJ7uBSmZWCjBNxdvv9HEC5nsW4wDV7wu6WnhWan,315873,2289961,-1974088,624
2022-01-22 13:40:35-05:00,9028,5inuJkWfHc2MtCqy2toH5VR4VzT43A7t2wTagA2ft91B,6kXdkHMTcY1PodfiSdMGX7X4KqvcTJWMf5amCskLPCXy,True,9496765,2374191,14862,7431,7431,HfEnetJ7uBSmZWCjBNxdvv9HEC5nsW4wDV7wu6WnhWan,594488,6139135,-5544647,625
2022-01-22 13:40:36-05:00,9029,7CSCMFa9W52tBDVUbXbc3woAy3GByeA1wPJdp3MgznPa,3447ptuVFu6G8B6N63RmS8mRv4n9PfHneypHLvbeaGLn,True,1033653,258412,1606,803,803,4BnQKPLuE3DMTtxp8MjUBytgnhvxqq3ZTqZHTVZo4JJh,64242,963143,-898901,621
2022-01-22 13:40:59-05:00,9030,SCtptafLHdkTiYC3e9sv853xNnusHLpoMPxTc1zUVC8,2HF9ggN6EbkYGz3Ajj7tB8m5YF3Yj77Vy96DMFSz5C7j,True,4527898,1131974,7002,3501,3501,HfEnetJ7uBSmZWCjBNxdvv9HEC5nsW4wDV7wu6WnhWan,280100,4188021,-3907921,618
2022-01-22 13:41:04-05:00,9031,6VBYUiLyQXvvsDmq1vh1oJ5VeA89tGgxtkgFfofc372m,35pyoeRA4duKX7njdYny3KffM2xaxuWUZGRUMQJ5iAiu,True,113097401,28274350,176092,88046,88046,4BnQKPLuE3DMTtxp8MjUBytgnhvxqq3ZTqZHTVZo4JJh,7043703,100914742,-93871039,622
2022-01-22 13:41:05-05:00,9032,HoJ3Re4BmCYKMJx2RUYtoHfg8ncEy3iFqvWJDGKqfMBV,2qg4FMcurNDVRzXYKwpzEYapxFECnAyU2oGmxQCSf3hf,True,803302,200825,1246,623,623,HfEnetJ7uBSmZWCjBNxdvv9HEC5nsW4wDV7wu6WnhWan,49855,832755,-782900,620
2022-01-22 13:41:06-05:00,9033,HRN438yBJSX72GV4E3JYLKpwQcnZXgAoB2VkmgXzEKDE,4jEn7ssEM8ZUjAyaKogEb3uyMmbZJ1a7WGCPNgh1Xfty,True,879175,219793,1364,682,682,HfEnetJ7uBSmZWCjBNxdvv9HEC5nsW4wDV7wu6WnhWan,54599,750428,-695829,621
2022-01-22 13:41:07-05:00,9034,9hB3EPuj4SrSrpAzHvExDb6mzh2vNGGVbj7qqfRjeao4,9725jRXGPRUuo1dijvv8mwzvSu1ed4y5hi9FAQNwb8dG,True,16573011,4143252,25616,12808,12808,HfEnetJ7uBSmZWCjBNxdvv9HEC5nsW4wDV7wu6WnhWan,1024668,16484668,-15460000,618
2022-01-22 13:41:07-05:00,9035,AnqmmhzVDCNq4dE4VvYkPDGB9nMXr4ykqvUhwxhR21pd,CcMeofCvvrDaBzgAGzoPwRt5eQmzdB1z2Y6UiwGqhFbG,True,11229185,2807296,17322,8661,8661,HfEnetJ7uBSmZWCjBNxdvv9HEC5nsW4wDV7wu6WnhWan,692884,13772229,-13079345,617
2022-01-22 13:41:07-05:00,9036,D6qMab7uevXTa89ssv4BRyHwrw3FYpNimAmX2VH2uf4B,8ZauZ5dAp7kyawkPdxi4mqfempFHubJebfBenQdDektD,True,533577,133394,823,411,412,HfEnetJ7uBSmZWCjBNxdvv9HEC5nsW4wDV7wu6WnhWan,32957,552511,-519554,617
2022-01-22 13:41:08-05:00,9037,DiPSJvnnEwg1En7HJfEsKrUbBgtUf4KzGMyMCZDQSYgp,s8UVC6vPBofuXUS6RW1aQmZ8C35PrC5r4A6ugmvzLGB,True,5418,1354,8,4,4,HfEnetJ7uBSmZWCjBNxdvv9HEC5nsW4wDV7wu6WnhWan,336,4289,-3953,620
2022-01-22 13:41:08-05:00,9038,6kscNwPWgKoW7MHRkB4ajxWF3DXLmXjmx9KjDnzikhfs,D49nf79UmrALDKnAa5kf94nZUffzJW7anLm4hVrFG2b4,True,27985911,6996477,43533,21766,21767,4BnQKPLuE3DMTtxp8MjUBytgnhvxqq3ZTqZHTVZo4JJh,1741334,25957392,-24216058,622
2022-01-22 13:41:24-05:00,9039,BH36ueAULprzjj6WabTgvivEcrx3VdDn8DTxSoro8Zym,6yydJKEmtZjUwURrs9gQ7EGkB86nK28ZDJQqNMgbPosA,True,117383712,29345927,183483,91741,91742,4BnQKPLuE3DMTtxp8MjUBytgnhvxqq3ZTqZHTVZo4JJh,7339356,62132822,-54793466,625
2022-01-22 13:41:39-05:00,9040,2SNV9Q6vzQP5XxxqSrwXpQdRvk45FPiqLXmhNZzbLt1k,6dLG3ojK5Unm1mBh9aDZfryvoT2a6cSuWA8CxXy3oi7n,True,33784413,8446102,52854,26427,26427,HfEnetJ7uBSmZWCjBNxdvv9HEC5nsW4wDV7wu6WnhWan,2114173,24643761,-22529588,625
2022-01-22 13:42:15-05:00,9041,DakevNrDK5fAUGkLdrWHrsLZm8hEZBqkzUiwJouaDPPY,73nFhK7cygPgwKveXrdXcQVte8n1z3iBe4nmUVTGfFmv,True,66170803,16542700,103487,51743,51744,HfEnetJ7uBSmZWCjBNxdvv9HEC5nsW4wDV7wu6WnhWan,4139494,43425201,-39285707,625
2022-01-22 13:42:15-05:00,9042,9cRx2sGeqENLrNkvzLSnuD161JshSav6pNg9c7pYLi8f,13ryjUoWLejTLDQKh1m69VFD31onMx8yhzCKhqbeU6s6,True,4488228,1122057,7006,3503,3503,4BnQKPLuE3DMTtxp8MjUBytgnhvxqq3ZTqZHTVZo4JJh,280249,4334136,-4053887,624
2022-01-22 13:42:15-05:00,9043,CK1SjmBjrW7m1QVZbVZsVZgwEcxw8BTkckkzrZDrDdxW,M6vnBg1TPRhLu7sghkxtf5TkSLw5JhgoDmbGoyEYgR9,True,1870636,467659,2892,1446,1446,HfEnetJ7uBSmZWCjBNxdvv9HEC5nsW4wDV7wu6WnhWan,115714,1785259,-1669545,618
2022-01-22 13:42:17-05:00,9044,2YPm4Ex9mNHX4CuNAUjkrXgoLFaZs6r1X6asYYUnvPyj,BatsG1UFq8ryYuFFcdnDyFWFPUV5P6w2VQpRup5oUey5,True,1158237,289559,1803,901,902,HfEnetJ7uBSmZWCjBNxdvv9HEC5nsW4wDV7wu6WnhWan,72142,1109339,-1037197,622
2022-01-22 13:42:18-05:00,9045,CcfycMNGUqZLA6EEqtDdftSbQhTL11SYn3LxQqJ23Xgh,Ce7NW9CpB9qGYLf8XUDW49ERutoxtjZSjs54xrzF1fYN,True,1586917,396729,2455,1227,1228,3zqXX6kzhkbW3d4TwD2CNjMRwxTbREXySekvq37kfCNk,98213,1520432,-1422219,618
2022-01-22 13:42:20-05:00,9046,GqFbV89UYbQ6aEW1bSvGnnsDtTPQfHPTHzisXPhLnaTC,6X7j3nqmugRyVVw83uSzgiPaemEscc8VdsnPEKDz4fg2,True,782870,195717,1220,610,610,4BnQKPLuE3DMTtxp8MjUBytgnhvxqq3ZTqZHTVZo4JJh,48820,778898,-730078,623
2022-01-22 14:00:01-05:00,9047,DkvR2xUPMyXWGGkUSmDSfhp7RtvMkfbT1ThKCS3TwrXd,F7jYV6TtT1LZ5XCNn1zkbUfNMo4gGcQUczAQy1jLHpaW,True,14847693,3711923,23209,11604,11605,HfEnetJ7uBSmZWCjBNxdvv9HEC5nsW4wDV7wu6WnhWan,928371,11651057,-10722686,625
2022-01-22 14:00:01-05:00,9048,DDuXUcRDez68Tx651sVKxjubhTdNHkuarbeDEKFp5HRs,DNWcrd23zaT7LuXHuhPVqqAvLVpEzoqebr4sho45CphT,True,821224,205306,1274,637,637,HfEnetJ7uBSmZWCjBNxdvv9HEC5nsW4wDV7wu6WnhWan,50987,363462,-312475,620
2022-01-22 14:00:57-05:00,9049,BjCNaM7YbE9SjFi7tzi4677zg1fKXGJwtecz2GWwWuhd,6rNsSrKZezQrLb2whToNjnizpnurDXrobHqfEK3QqU1M,True,356240731,89060182,554745,277372,277373,HfEnetJ7uBSmZWCjBNxdvv9HEC5nsW4wDV7wu6WnhWan,22189833,196357109,-174167276,622
2022-01-22 14:00:57-05:00,9050,HUe9LgGBjMeNxGyeCtmXr2XbWVFhHXrvgc2XSqCwN11D,7Z1nR9GgezBXsDX5wW3BBarfMRMZV28rX6MeLRuWtycG,True,17033183,4258295,26620,13310,13310,HfEnetJ7uBSmZWCjBNxdvv9HEC5nsW4wDV7wu6WnhWan,1064828,15669130,-14604302,625
2022-01-22 14:00:57-05:00,9051,3gdApRPkUGEqmLvTYf4WQJCnmTVmiEU2wCQG26QMpqKf,HpP2yxq3KfYByT4q4p2mLaELnPdW6kmEY9EqZaBZuUNR,True,1115459,278864,1731,865,866,HfEnetJ7uBSmZWCjBNxdvv9HEC5nsW4wDV7wu6WnhWan,69253,1062897,-993644,620
2022-01-22 14:00:59-05:00,9052,APbpwRCB9tfma8yoi8upe633XZBtNwc5zVxXVjLwhg8s,BBwryuZZ8msiSFNmGkh13Wgg1PoSutY2Ftgz8odcxPm4,True,8854327,2213581,13726,6863,6863,HfEnetJ7uBSmZWCjBNxdvv9HEC5nsW4wDV7wu6WnhWan,549059,8146214,-7597155,620
2022-01-22 14:01:56-05:00,9053,4rwzdgkP7REWtQxRf9ftWKYXs1QoZQQBo6YQvNJYjZBY,4EmBTVv6MbdPC6WqTNrSABrP9aTZPrDSPxy9a2KbVgqu,True,2662760347,665690086,4102988,2051494,2051494,3zqXX6kzhkbW3d4TwD2CNjMRwxTbREXySekvq37kfCNk,164119557,1134725369,-970605812,616
2022-01-22 14:01:56-05:00,9054,DY6k3Dkwe18iLneaT8Xo3VpJWB6V4jWwQQjoDvEzdg2j,3GGV7S9FpRQGbARBXkvGFVqLrmw8JvYAcpnR1aKVUY2f,True,301603,75400,462,231,231,3zqXX6kzhkbW3d4TwD2CNjMRwxTbREXySekvq37kfCNk,18518,293167,-274649,613
2022-01-22 14:01:57-05:00,9055,GGcsY84pkqUn2xySuLYrUUg8gWMBWgfHaQ7rK42NoZaH,4EyjJvctL9WBQiauD2Eaf2Hus8htYzHxP5GR2HsUfuks,True,77857024,19464255,121238,60619,60619,4BnQKPLuE3DMTtxp8MjUBytgnhvxqq3ZTqZHTVZo4JJh,4849548,41755012,-36905464,622
2022-01-22 14:02:38-05:00,9056,9WJBnVi84E926j7xEd566WzrZJkPJWRgmEnYj9vyjuad,4dLaFS5F7TGyLdwuJLMGkz3bSL53aHzd9ZfpNmhHxXeF,True,374173,93543,582,291,291,HfEnetJ7uBSmZWCjBNxdvv9HEC5nsW4wDV7wu6WnhWan,23319,333149,-309830,623
2022-01-22 14:02:40-05:00,9057,J3ggP7ZxL8HRh3CBp5iYG2WgjLyNSAWYT46uC9VYDLCz,2FqTRiRPiLvdAH2BS5vroVntpsSXvTJEn5UHWmtKHzh9,True,716140,179035,1108,554,554,HfEnetJ7uBSmZWCjBNxdvv9HEC5nsW4wDV7wu6WnhWan,44357,465587,-421230,619
2022-01-22 14:02:41-05:00,9058,Dcitj55ABpkgXvpnPCssy8GgKF46xd1GLaRMyPWoW6G8,62znTXs74bywWfcXptJkvwYuuTxgen8bhYaCnG8Z7y2B,True,610185856,152546464,950753,475376,475377,3zqXX6kzhkbW3d4TwD2CNjMRwxTbREXySekvq37kfCNk,38030135,307291779,-269261644,623
2022-01-22 14:02:43-05:00,9059,FgQrRo4eGQAonSsFfQgnp8trGGqGZCLeGX6yvJnMnTjd,8KhemHLBY6nGmo3xMDedW2wnCSxQq6LwbTExif4sUSxx,True,33458204,8364551,52204,26102,26102,3zqXX6kzhkbW3d4TwD2CNjMRwxTbREXySekvq37kfCNk,2088181,13478708,-11390527,624
2022-01-22 14:02:43-05:00,9060,6rpuf35EHPrQ3LVPUcdfRTh3igu9wvRcfvoA6uSMNmYq,B1aor5NFukbUeT5tzi9oXgRGxcRoojff8sfbwzmwywBq,True,6449789,1612447,10052,5026,5026,4BnQKPLuE3DMTtxp8MjUBytgnhvxqq3ZTqZHTVZo4JJh,402086,3623402,-3221316,623
2022-01-22 14:02:43-05:00,9061,CxLFMBDFkoMvpK9YUf7WtCq6hn7k3QACAuetAnGjU6KA,2gE52a1GWQnS6ifV6eVtKQyr13LXP5Jdt3yG9SjGPJPF,True,29596473,7399118,46162,23081,23081,4BnQKPLuE3DMTtxp8MjUBytgnhvxqq3ZTqZHTVZo4JJh,1846491,14486723,-12640232,623
2022-01-22 14:02:56-05:00,9062,CLVUzXSNsQnX7n5cvxMuTjyMSjy1pNpPnWejFaeuonvb,BXZzBujr8DAUcGJcHQBaz1ZSwkATAHg3NX3bLnrjQpLh,True,16478245,4119561,25574,12787,12787,3zqXX6kzhkbW3d4TwD2CNjMRwxTbREXySekvq37kfCNk,1022995,4725221,-3702226,620
2022-01-22 14:03:05-05:00,9063,DC4UVUDFWL3gVtgkX9hPtFgtxaA8DH5p94i4k9U3wyWv,3HCWqVvQQfRgSKitsTjGTduJ82ointZUSNtj13uea4kD,True,9414366,2353591,14730,7365,7365,4BnQKPLuE3DMTtxp8MjUBytgnhvxqq3ZTqZHTVZo4JJh,589229,8042709,-7453480,625
2022-01-22 14:03:25-05:00,9064,3c4tj9J8QwB3exFchWei43nBh5xsYRZxEUfayi3JvYgm,Fyw1TEEDKhLFo16qxDsttsAwSkrfzpDe8Dmm3atEeXyN,True,2164134,541033,3375,1687,1688,3zqXX6kzhkbW3d4TwD2CNjMRwxTbREXySekvq37kfCNk,135033,1912297,-1777264,623
2022-01-22 14:06:16-05:00,9065,5BJnMHFSiQjHRGFJDW1jnqCfkHHYWnQzmmccy9eA4jNj,9517JGYsPmvgPUM9pFRD2vipHmdgE578F7jA7Qq6jorm,True,64399786,16099946,99327,49663,49664,4BnQKPLuE3DMTtxp8MjUBytgnhvxqq3ZTqZHTVZo4JJh,3973086,24610821,-20637735,616
2022-01-22 14:10:41-05:00,9066,8otVEtwXkAdnt5XmBzL8hmzAgRcaDDxiuqpRxY6ZhR24,7333dFedtBjo3yhbp2bU1XbAfdDeBvvCd9QKitYVUU7v,True,265170971,66292742,414860,207430,207430,4BnQKPLuE3DMTtxp8MjUBytgnhvxqq3ZTqZHTVZo4JJh,16594401,71465731,-54871330,625
2022-01-22 14:11:21-05:00,9067,Cv5oVktxmqbU1SxraxH67NEWMKnjgA18R832Fhe9h74a,Cs7xBD4BDiohyopnaYDDChUtR9vmx7uwot6Qp9beQLzt,True,21768236,5442058,33956,16978,16978,HfEnetJ7uBSmZWCjBNxdvv9HEC5nsW4wDV7wu6WnhWan,1358253,8623982,-7265729,623
2022-01-22 14:11:21-05:00,9068,BgnsCfJ54ReunUtwPJLzkW4PWnqpBDWGNYxsW5PvDrbK,KpMqEkQ9dKMgCevsEK895wHd3fCLRPSzDmJSv3tKU4u,True,353368822,88342205,549957,274978,274979,HfEnetJ7uBSmZWCjBNxdvv9HEC5nsW4wDV7wu6WnhWan,21998304,254545388,-232547084,622
2022-01-22 14:11:21-05:00,9069,8E3K7vCHJ2xjdFofPRGLbMxrkm8UYEi926QmXPAFwsqe,4qHUDA1c43Dg4qi1ZPKqmpGYiEMUZ6r4UuzB5ftHCEhW,True,34540632,8635158,53510,26755,26755,3zqXX6kzhkbW3d4TwD2CNjMRwxTbREXySekvq37kfCNk,2140422,31029105,-28888683,619
2022-01-22 14:11:35-05:00,9070,399591e8XgY52yCMorCQ2WL6dQZTC485ZooHtmGuirhZ,JCiXAooFmKmEPQ2S7C8iSk6CLcTyrPEe1SsPSLyUGySe,True,26071,6517,40,20,20,3zqXX6kzhkbW3d4TwD2CNjMRwxTbREXySekvq37kfCNk,1631,25506,-23875,625
2022-01-22 14:17:02-05:00,9071,76gdRvg74fv6A9vA8ukNPqWKkmKY6KLAAKBGvbNE2AXC,5n88nkWZiCtWyWPrgfJozgkxtU9HMSggrxHkLoTQp1QR,True,3049,762,4,2,2,HfEnetJ7uBSmZWCjBNxdvv9HEC5nsW4wDV7wu6WnhWan,190,2993,-2803,623
2022-01-22 14:17:04-05:00,9072,BmLG3dPSnL9hL2okZcNVsHgzuWYCrWLdXW8z5Jd2gyvF,HXwhov5Re9b8D4XHULcVSdgBNfbtZ7KMhMRqSTcQTbno,True,2507391,626847,3909,1954,1955,HfEnetJ7uBSmZWCjBNxdvv9HEC5nsW4wDV7wu6WnhWan,156392,2508516,-2352124,623
2022-01-22 14:18:43-05:00,9073,BgNgALwBEuiumVgiXRmBZRnyFrr9QTDy2maHzsNwNHGf,ag35Ec2uFtqkarizCxFyhM2SPBuUwfmLRhAdFEWFCNa,True,1718706,429676,2672,1336,1336,HfEnetJ7uBSmZWCjBNxdvv9HEC5nsW4wDV7wu6WnhWan,106888,921135,-814247,621
2022-01-22 14:19:31-05:00,9074,A1j2G5FZRyWSjFt6dK87WHhLkQrPUVqHaM3KhSzhAKDT,2fMiHLYm4pL3YCd8aveTR4mT9uVxztQeMwb5eRZb4wUW,False,16953,16953,839,41,798,HfEnetJ7uBSmZWCjBNxdvv9HEC5nsW4wDV7wu6WnhWan,839,13956,-13117,494
2022-01-22 14:19:32-05:00,9075,BgN75npBkPws5uiFE9RAujmPuZyAv2MQUPmfmJ1YCCij,78UFLNDn782TY2P4F5kRkMRC2s3gw8ak7sRQZRWNq82D,True,5844699,1461174,9145,4572,4573,3zqXX6kzhkbW3d4TwD2CNjMRwxTbREXySekvq37kfCNk,365800,2528389,-2162589,625
2022-01-22 14:19:32-05:00,9076,HwosLQgDY1xtHQRQ4hzroPQHFWssPzTj5vRkP37FcviB,HKTNEYNXrephNkH7apbobK4mcQXcNayQA4W1NgM6sLr8,True,1115947,278986,1730,865,865,3zqXX6kzhkbW3d4TwD2CNjMRwxTbREXySekvq37kfCNk,69210,704699,-635489,620
2022-01-22 14:19:40-05:00,9077,B2hN3Lt5pFbUyfEUc5s48hkxUJ5rr2SeFxgdGdQ8pDD2,7bZJCCud253j9g411HQUDXUAADcwd5yJWznoTChBdB2H,True,147898225,36974556,231406,115703,115703,4BnQKPLuE3DMTtxp8MjUBytgnhvxqq3ZTqZHTVZo4JJh,9256278,59925458,-50669180,625
2022-01-22 14:19:40-05:00,9078,A4tDE948CPFPh1UwHb8sXryfKktbxZ8BCkqXgA5DJHA8,3zXeKMrsEpCe5fQumLNzCgpxcG1kLJFEAtJuqxLsC6ZG,True,2108009,527002,3286,1643,1643,HfEnetJ7uBSmZWCjBNxdvv9HEC5nsW4wDV7wu6WnhWan,131479,1704604,-1573125,623
2022-01-22 14:19:41-05:00,9079,G25vsB3sDqRhHoSK4KwR1TywfrJDtpejVbbevEG9sQ9a,5xFC3Hm13magnAA9GD1EnwC9PrPoEfQ7omEa9p9zCrB1,False,7242181,7242181,360380,18019,342361,3zqXX6kzhkbW3d4TwD2CNjMRwxTbREXySekvq37kfCNk,360380,3459495,-3099115,497
2022-01-22 14:19:41-05:00,9080,4uygLJDk9DFCifJ56YwMrEsvd3oQNq8tYSLnMCyWorS6,GimL4uKGvg3FFmFQSWzAcjstv3Vmk5NMgDGMKTuXYVpB,True,12621580,3155395,19702,9851,9851,HfEnetJ7uBSmZWCjBNxdvv9HEC5nsW4wDV7wu6WnhWan,788108,9750873,-8962765,624
2022-01-22 14:19:41-05:00,9081,8eTH6eJyyVeMno3UQkffeBg32xofKsQfkhLhXdtaf87s,BCFC7CPXrQPsUfJb2eYSht8GhaApWHpc49AeCXqaYq13,True,5444481,1361120,8476,4238,4238,3zqXX6kzhkbW3d4TwD2CNjMRwxTbREXySekvq37kfCNk,339054,2642334,-2303280,622
2022-01-22 14:19:47-05:00,9082,D9VKhnfLLCrntDGFYSfoxFaY76VnHmYZ1ZbyFXdKdibz,2hRCRH2pMDyQGYcXHa8Y6BZo6FbcGZf5VJC1v8Bp6tGa,True,2236063,559015,3487,1743,1744,HfEnetJ7uBSmZWCjBNxdvv9HEC5nsW4wDV7wu6WnhWan,139493,1635185,-1495692,623
2022-01-22 14:19:48-05:00,9083,8kJu5aqVSmW8FSZR9h6F75ftn9V2U9uMLBEKeqRaC855,FhVHByujkvwwtjTVpZ4mqSUqoMoBgeLUc5H7rbz3FgAt,True,2148872,537218,3338,1669,1669,HfEnetJ7uBSmZWCjBNxdvv9HEC5nsW4wDV7wu6WnhWan,133544,2107941,-1974397,621
2022-01-22 14:20:03-05:00,9084,4pmhvxJcmebxtqN6RwVb9UbEtxpFXpuVN67Q74W6YAg3,B9fk51SEQmLbMDpQJV15f9gyCZhvEBWRXeLMnnmMqvfg,True,2267,566,3,1,2,HfEnetJ7uBSmZWCjBNxdvv9HEC5nsW4wDV7wu6WnhWan,141,2210,-2069,621
2022-01-22 14:20:30-05:00,9085,FnAT8HKGgisYfeAbxKU2gSbCp8KbZHULRpaJX1NVijHy,2u637Crc2QzfSJmCnRNqeib3aZQVn4NGncpgM3Ph6jvm,True,832694,208173,1285,642,643,HfEnetJ7uBSmZWCjBNxdvv9HEC5nsW4wDV7wu6WnhWan,51401,561718,-510317,617
2022-01-22 14:20:33-05:00,9086,cG5VSSaBpjNdRLMQT7dmotpcWRTfdmJZYdWsrzNzRTE,5RESxV6aZenjAdaqw1jxoYSGttpLrNuZiRJy2WeLAVJv,True,48049371,12012342,74886,37443,37443,HfEnetJ7uBSmZWCjBNxdvv9HEC5nsW4wDV7wu6WnhWan,2995473,32264494,-29269021,623
2022-01-22 14:20:33-05:00,9087,72L76qDRMK3M7X52zuuB9GVyvFFLDBZwFMpVjWjghXzA,4m2ZVuemUctu1edv4YJVAcjXzKwpbCmBujzoUmLDeA7h,True,8605712,2151428,13310,6655,6655,HfEnetJ7uBSmZWCjBNxdvv9HEC5nsW4wDV7wu6WnhWan,532437,4205656,-3673219,618
2022-01-22 14:20:33-05:00,9088,GKKRAsYGdcf47eFThG4KwhNv7egeHRuc2wmTh4kqpego,4ippJxgnqCtdtGzCkdZoYwv68fiXNSqQcgrnaHdXZDUa,True,35095721,8773929,54793,27396,27397,HfEnetJ7uBSmZWCjBNxdvv9HEC5nsW4wDV7wu6WnhWan,2191744,23695793,-21504049,624
2022-01-22 14:20:33-05:00,9089,CpxZ136k95cVjGqkJnNpDZKUgrJrfg8HrFDZPL6BgsK4,Fo7HtcrneUTsnGqygsxPQ63G5rayYodYT65xP6B6HusH,True,37816716,9454179,58323,29161,29162,HfEnetJ7uBSmZWCjBNxdvv9HEC5nsW4wDV7wu6WnhWan,2332923,14835588,-12502665,616
2022-01-22 14:20:34-05:00,9090,9KD2AifD5wFD4QkHYuawXbJgLWHrfj2QPF3fT8jhGVA5,Ga9gAqmkuHbqrr31sUFPqa1xa5WNxLWJWGPUaMxQqLdj,True,23643,5910,36,18,18,HfEnetJ7uBSmZWCjBNxdvv9HEC5nsW4wDV7wu6WnhWan,1477,23487,-22010,624
2022-01-22 14:20:52-05:00,9091,GHn96Ev7UmKJWqch3H3wzXpRT7qLg5FBuSBJAATVED1f,BXBSUddfz9MThXqk4517M7YVRDGdTm4pC6G4ipT69TMV,True,4080926,1020231,6384,3192,3192,4BnQKPLuE3DMTtxp8MjUBytgnhvxqq3ZTqZHTVZo4JJh,255389,1839887,-1584498,625
2022-01-22 14:20:52-05:00,9092,2niazdR63iWLyZ3ABWZVAnJiEjVyDyLGo4jZ6wh3j2Zz,4RvU5UtyE5CqMStPciiCTdhYCdaUUfdKSYS5nkATs1qn,True,5119628,1279907,7988,3994,3994,HfEnetJ7uBSmZWCjBNxdvv9HEC5nsW4wDV7wu6WnhWan,319542,2317290,-1997748,624
2022-01-22 14:21:06-05:00,9093,2sPD4f4d3CCeFSwSC5vAGS3YoTsTGypYKfDeoJczebop,HWCRpcq2sXqJL7Vi8MtipQDwGSViE73bUxS36ETmvnP2,True,963754,240938,1502,751,751,HfEnetJ7uBSmZWCjBNxdvv9HEC5nsW4wDV7wu6WnhWan,60096,555670,-495574,623
2022-01-22 14:21:37-05:00,9094,FtF3PVw8YNJseWPMcA2GEuQZ6nni1mq5kYPa2LrSzfkW,4yr1TM2dXrBvLNMpSaoryuGU2P8D3WG1ZCkvVzWFiQRH,True,1394947668,348736915,2182568,1091284,1091284,HfEnetJ7uBSmZWCjBNxdvv9HEC5nsW4wDV7wu6WnhWan,87302751,722253318,-634950567,625
2022-01-22 14:22:08-05:00,9095,AUH6YGBV8tDVX1E1WTo92Mubfx1DGsqfGeyUBqxo4fSr,33QZgMwmW32WuvmxD8XNbmF9ea88bLe3YTtNwHV73Wwu,True,5066529,1266632,7773,3886,3887,4BnQKPLuE3DMTtxp8MjUBytgnhvxqq3ZTqZHTVZo4JJh,310955,3476423,-3165468,613
2022-01-22 14:22:08-05:00,9096,9otCHuzKcxUCC4EgPJkio8Df5gXWB6DtZQnZvWtPfsh6,8cNPdP8rA9sBpcKpmCNcp4W2AYonYdFNoyVmboT6y1Bb,True,159445073,39861268,243760,121880,121880,4BnQKPLuE3DMTtxp8MjUBytgnhvxqq3ZTqZHTVZo4JJh,9750432,64060826,-54310394,611
2022-01-22 14:22:10-05:00,9097,H3394S5wdbwXB4scjGAY8NsXxCdGy1Xebct18s42FM1K,Hz84L1EquzhCvBJP75ScKug46hYGdNMVNH16AdG4y5D8,True,1139122,284780,1762,881,881,4BnQKPLuE3DMTtxp8MjUBytgnhvxqq3ZTqZHTVZo4JJh,70484,857697,-787213,618
2022-01-22 14:22:10-05:00,9098,FsMiJiJZibohKoV5QRisWCjzuFd86xSxFb4m73AQmu93,7p3TSKBaG9SV2YNDnhutQKacPKpTTmgsEfzmK51t6sYb,True,5062474,1265618,7843,3921,3922,HfEnetJ7uBSmZWCjBNxdvv9HEC5nsW4wDV7wu6WnhWan,313753,3427054,-3113301,619
2022-01-22 14:22:11-05:00,9099,4Eh2J8pz6nSz2E2BaPSMbDNhEovGA4QRmNtzAJPw9ZRi,CrHeEQC5KpQFLGhz2EpLYWgk7kWsqLPvEfLsSQvUxv61,True,17106909,4276727,26430,13215,13215,4BnQKPLuE3DMTtxp8MjUBytgnhvxqq3ZTqZHTVZo4JJh,1057207,12075378,-11018171,618
2022-01-22 14:22:11-05:00,9100,3VdSA9CED9f5swRwHX2U15U7J6Muaq8VPnCNy9CaGDHe,2YYstfnfdYic5NWmEbcUEHpccNUVd1EhuCkExvMsoMk8,True,121604,30401,188,94,94,HfEnetJ7uBSmZWCjBNxdvv9HEC5nsW4wDV7wu6WnhWan,7529,119904,-112375,619
2022-01-22 14:22:12-05:00,9101,4MSyrHopFkuaCEEvLAUV9cJfVre6cLAx5sJF5LEMSCTX,6HhLHoswuDKrcixShWCDcquW6PgmbS5FidEnkM3bwuJQ,True,1247120,311780,1950,975,975,HfEnetJ7uBSmZWCjBNxdvv9HEC5nsW4wDV7wu6WnhWan,78017,568187,-490170,625
2022-01-22 14:23:35-05:00,9102,6k9unyyhVTrGhAhBrFjgumRfBtKFRBrVaeWtYB56LgEg,3n9VYUH53fxmwFwdYKT9xAZYDzjodhMsJ5iGAoJTqCt4,True,5116736,1279184,7948,3974,3974,HfEnetJ7uBSmZWCjBNxdvv9HEC5nsW4wDV7wu6WnhWan,317948,2318587,-2000639,621
2022-01-22 14:26:05-05:00,9103,EitU96ThqHErybDn2j1NY6JHkqV1R3mWM1uWH7wYKr1T,2p9eYbLyBqXrhHtRKp1jJb7VGjCmb4LkA6kzqLr1ijet,True,2828405,707101,4419,2209,2210,HfEnetJ7uBSmZWCjBNxdvv9HEC5nsW4wDV7wu6WnhWan,176760,1816415,-1639655,624
2022-01-22 14:26:39-05:00,9104,CxePQ6ZEn2NCLYgGegSeFX1PyBuczP9j5v131VQSPh1c,9gPk7qTRb5JHqBXRKp3uZfhA2VjQAJDQHTzYXGLUdAUC,True,1725627,431406,2680,1340,1340,HfEnetJ7uBSmZWCjBNxdvv9HEC5nsW4wDV7wu6WnhWan,107222,1646861,-1539639,621
2022-01-22 14:26:39-05:00,9105,51VhgthsxrRRr2PT5gLnDfL1A3soqwCxA1UzH9vRUGTh,4QCcd7hfsydQ63LH7Lqsp8oVXw7HuKamzQf8VMH6Lgu2,True,1484170,371042,2300,1150,1150,3zqXX6kzhkbW3d4TwD2CNjMRwxTbREXySekvq37kfCNk,92022,1415272,-1323250,620
2022-01-22 14:26:41-05:00,9106,9XHC2Ycm9f56cDYxRPVKYiYWGKA4y7Utpv3e9gpMsZq3,HpqAdpkzWqoJUNqmHEnn4PZwSB6C6jt8FJZQtZtFqXWA,True,8513790,2128447,13298,6649,6649,HfEnetJ7uBSmZWCjBNxdvv9HEC5nsW4wDV7wu6WnhWan,531944,7836886,-7304942,624
2022-01-22 14:27:19-05:00,9107,3MEiFqy4F9nBW8gHxvGjv7norSBHwxhbzzNKngPk1RHq,2tcsJ4NUJegcEfHNwWPh979yKjKmq568CpNm5iWGbuoR,True,599204,149799,929,464,465,3zqXX6kzhkbW3d4TwD2CNjMRwxTbREXySekvq37kfCNk,37170,419949,-382779,620
2022-01-22 14:27:19-05:00,9108,Fs8MQLaMyr1Q96HsZivKLY7Kjdeu2ZoB2n3VTZ15KbSn,DREfCs5CTVNUUF8H3hD8CWvtxztiYxoLYh8HUWDecMyZ,True,29669792,7417448,41774,20887,20887,3zqXX6kzhkbW3d4TwD2CNjMRwxTbREXySekvq37kfCNk,1670985,29667530,-27996545,563
2022-01-22 14:27:19-05:00,9109,FS5xx53Bo65G21gJLta7LEEiS132VJM1kGpUzuqyfzoy,2kbTLjdBBA9K1coxKmwmYbjq2heSnuNg4Nh2EfVNYgwj,True,5404853,1351213,8140,4070,4070,4BnQKPLuE3DMTtxp8MjUBytgnhvxqq3ZTqZHTVZo4JJh,325634,2828199,-2502565,602
2022-01-22 14:27:19-05:00,9110,7EtGovzHsbD8cKGqq4R5rvKBbncR4Kc7CDkTjof2QBMf,8ShjeNWM2vcvUF9yYztYCHUQfcGsyg2A1LyWiPbQDDvq,True,183313,45828,264,132,132,3zqXX6kzhkbW3d4TwD2CNjMRwxTbREXySekvq37kfCNk,10569,183181,-172612,576
2022-01-22 14:27:19-05:00,9111,HGAFdundf5voDqeh9g7d6Q9mgMf8eEg898QMRBqwPZ6C,deanBuZXWBHEe2TGfP37S9aMBEnEgmZoyRJjAvruzfA,True,1130296,282574,1753,876,877,3zqXX6kzhkbW3d4TwD2CNjMRwxTbREXySekvq37kfCNk,70133,1096140,-1026007,620
2022-01-22 14:27:19-05:00,9112,9gY3X17t7jarkWhnSEHPR51U9nVv8Dv99NqpCi3ewuPf,4Z6TdTW1d4JFRZqZyWA9X7upKhJwVPSfTQjFp14M59uv,True,92371359,23092839,144068,72034,72034,4BnQKPLuE3DMTtxp8MjUBytgnhvxqq3ZTqZHTVZo4JJh,5762738,93391379,-87628641,623
2022-01-22 14:27:19-05:00,9113,7jvKp6onXyWgwsFrFWj4hYTXJsYYD6ot5mn6rPFuJriy,J7N6HiozevJVTiY9hDEUs2ud5BwT5QSE7wnMBS1w5ie2,True,571283,142820,891,445,446,4BnQKPLuE3DMTtxp8MjUBytgnhvxqq3ZTqZHTVZo4JJh,35668,536070,-500402,624
2022-01-22 14:27:19-05:00,9114,4SX2pj4eHRwFMtyDCrMZ8ZT6ASAMi7yfZWZnccw5dGn8,Ads49ZqvTmPHxfzNYm4oJb4HBYhwS6vXQbarqmpUi5VZ,True,586657,146664,916,458,458,4BnQKPLuE3DMTtxp8MjUBytgnhvxqq3ZTqZHTVZo4JJh,36656,603655,-566999,624
2022-01-22 14:27:19-05:00,9115,HGJoZvLakWfSDFwuvShNBc4kCf7nP7VqzyM3mELpbFEf,12Qn5jin7QvsBngXqYAv4UstyG3b6nRf1jsLp9Dp8G7k,True,44927,11231,69,34,35,3zqXX6kzhkbW3d4TwD2CNjMRwxTbREXySekvq37kfCNk,2799,47162,-44363,623
2022-01-22 14:27:19-05:00,9116,FYdUiU3rPpbYKWnEpekQQsocSJKjXmscohi4v6DYqix7,daPyq9YdunQJhhLoW5ifhJ7UFPTtRZhGs4JwE1nqZhN,True,724133,181033,1097,548,549,3zqXX6kzhkbW3d4TwD2CNjMRwxTbREXySekvq37kfCNk,43892,744685,-700793,606
2022-01-22 14:27:20-05:00,9117,75NA5QiXEHG4caSB9BpafGZPA9eT9S6MhKTFM6eHjz8H,FmoxAVw2zdG6qbyaXKy6gsvi1XY8ZVbSgUNbjsp9EpVd,True,1957575,489393,2724,1362,1362,4BnQKPLuE3DMTtxp8MjUBytgnhvxqq3ZTqZHTVZo4JJh,108988,1806134,-1697146,556
2022-01-22 14:27:20-05:00,9118,8cRrU1NzNpjL3k2BwjW3VixAcX6VFc29KHr4KZg8cs2Y,6KhaewfwKyT5fkQvfiDqKzGWEPbuP9H5NfxEUXVx14U4,True,67219103,16804775,104330,52165,52165,HfEnetJ7uBSmZWCjBNxdvv9HEC5nsW4wDV7wu6WnhWan,4173222,18924763,-14751541,620
2022-01-22 14:27:23-05:00,9119,7dmoK7QPki7R66SPQST4veUgVfnJbVToxxBPZveECiwK,4vh4REBDm5zBDmcjRCD9zNsny1HGneu7B2co4dSJNLL6,True,3069361,767340,4734,2367,2367,HfEnetJ7uBSmZWCjBNxdvv9HEC5nsW4wDV7wu6WnhWan,189368,2967296,-2777928,616
2022-01-22 14:27:23-05:00,9120,ymyzGH4Qc7HH5PbKpVphCbsQgLLXyGkPcXamQJuNj5C,8oTLHaV2XzbKXNWRuUjCfHjUn61Pw93LYK14m9q2VDpZ,True,38101,9525,57,28,29,HfEnetJ7uBSmZWCjBNxdvv9HEC5nsW4wDV7wu6WnhWan,2302,36160,-33858,604
2022-01-22 14:27:23-05:00,9121,As81koHnSP9quoXuUVNHp3VR3Qaks8HLa4sFgJDocYiF,AMVm8dXia5s974VgZSbeE6uPDgyXDHZFyJ2W1J1CWvKW,True,20153589,5038397,30666,15333,15333,HfEnetJ7uBSmZWCjBNxdvv9HEC5nsW4wDV7wu6WnhWan,1226643,20224538,-18997895,608
2022-01-22 14:27:23-05:00,9122,2FEbsetZMkRqLjSC8GBbgecKgX5T1T1fci2sLQux29p8,H722Fcd6DkTFRZxqQWbPDufBfXEgmFfhiEpQZWhxwYv1,True,13385,3346,20,10,10,HfEnetJ7uBSmZWCjBNxdvv9HEC5nsW4wDV7wu6WnhWan,836,12852,-12016,624
2022-01-22 14:27:23-05:00,9123,3sGCWcgPY7TzRCkFR1uuY8KcUzVRbdTyFYxh7V1csNMX,CcRFNnG2uhyLwhNAbX4U49jkMeC11kJtVhhyqDWdDK5r,True,20484638,5121159,30982,15491,15491,HfEnetJ7uBSmZWCjBNxdvv9HEC5nsW4wDV7wu6WnhWan,1239285,20617979,-19378694,604
2022-01-22 14:27:23-05:00,9124,HfwGSiwGiyDFaTS2usYRp82zSmPPQqZukbw2d1BuFs5w,ArtgZbmA33k8Y3EfR6oMJiqT72MUrVBQqifPBdcnrzea,True,567553,141888,814,407,407,4BnQKPLuE3DMTtxp8MjUBytgnhvxqq3ZTqZHTVZo4JJh,32592,336551,-303959,574
2022-01-22 14:27:23-05:00,9125,FdYFnEYtFQKcZPmzUqnvNLzozxdR1emtkmvnYcMgYykS,7arWNJQf2cWxerjhLgQh9CJxwTat1efnr5KmhuD7Qnv4,True,559961,139990,851,425,426,HfEnetJ7uBSmZWCjBNxdvv9HEC5nsW4wDV7wu6WnhWan,34075,576415,-542340,608
2022-01-22 14:27:23-05:00,9126,HukFwJRwbT4R5P1YBDg61HphUfBHLiiawpvwf7C8VYzR,ATQqXSEQcZJL1hjfbQZ2ihUuRbxG6fJppJhv7ycWEhPd,True,1437128091,359282022,2157312,1078656,1078656,HfEnetJ7uBSmZWCjBNxdvv9HEC5nsW4wDV7wu6WnhWan,86292487,1089799704,-1003507217,600
2022-01-22 14:27:23-05:00,9127,7EvJoetxJVTgpJXqE1VC3fZN1CQ5xdWdv29yCiDuH9gU,6RTEusjGEHNDdMj75qkpzYHjHZ3R2XN5xvptCwkRJz5j,True,806802,201700,1254,627,627,4BnQKPLuE3DMTtxp8MjUBytgnhvxqq3ZTqZHTVZo4JJh,50179,830013,-779834,621
2022-01-22 14:27:23-05:00,9128,9Hz4p7gcfDbXBJp8KzhaBBPh9i7xe9kun7zLfDtqPe6c,2bJ43Lep6kp6WY7Ct56oiscKnAbdtC265G5yRvRPFThU,True,2631132,657783,3970,1985,1985,HfEnetJ7uBSmZWCjBNxdvv9HEC5nsW4wDV7wu6WnhWan,158828,1779307,-1620479,603
2022-01-22 14:27:23-05:00,9129,FF8rqfM9PTEjYiVFy8jS81weDRwdaYooux2uSa2LexrJ,JBk1JghH1gged1YpDbkczFXP9ka5ivYSkaYoVbbXD4kg,True,519684,129921,805,402,403,HfEnetJ7uBSmZWCjBNxdvv9HEC5nsW4wDV7wu6WnhWan,32225,569516,-537291,620
2022-01-22 14:27:23-05:00,9130,5y8ZSWUnrm4B3emh7vLQKTh89vHtCvXqUhk7fJBA52is,Bu1AoKU2QQWpGH54ZzugvvACB3E1d3VvymnegNmTgHqg,True,20158020,5039505,30623,15311,15312,4BnQKPLuE3DMTtxp8MjUBytgnhvxqq3ZTqZHTVZo4JJh,1224952,20218416,-18993464,607
2022-01-22 14:27:23-05:00,9131,CJpe9bNHxS63QMaGJhmnr4u7eTo6e5GApZQZyPtXLAkk,EMVL4sDfVXwGEoGEYwLp8D6itfy3eu4FZBAj1kMz6uXa,True,19229595,4807398,29305,14652,14653,4BnQKPLuE3DMTtxp8MjUBytgnhvxqq3ZTqZHTVZo4JJh,1172231,19314502,-18142271,609
2022-01-22 14:27:23-05:00,9132,57Vsw8jXaaoLriYEkvPAVyq66r4a4zMfLWbDaTBMjFzC,7AVDWUTHa6729UkXgCXASphSmrLvXYGAA9ygTMSqvwvY,True,937868,234467,1307,653,654,3zqXX6kzhkbW3d4TwD2CNjMRwxTbREXySekvq37kfCNk,52302,939833,-887531,557
2022-01-22 14:27:23-05:00,9133,BZn1DDE568UHeL2Qniv9EDT1yAAWvPJcTtSw4K4GQx44,CCaroU4YwKvYgibMsRPdEBxeDbzcNC4s5ZthxrhywSm5,True,1910991,477747,2651,1325,1326,3zqXX6kzhkbW3d4TwD2CNjMRwxTbREXySekvq37kfCNk,106078,1836444,-1730366,555
2022-01-22 14:27:24-05:00,9134,yWK6vFZq58uYYiHscQTPSBqTDrWEW1SVbqe8NszoTEN,6H1zT5ifGaMKjdvZmptuDYf4Vou7tntdZQPVzQ4hWyjg,True,23277993,5819498,32546,16273,16273,HfEnetJ7uBSmZWCjBNxdvv9HEC5nsW4wDV7wu6WnhWan,1301877,13018884,-11717007,559
2022-01-22 14:27:24-05:00,9135,FwTGq3BeMLyRFRa5r4E6nySLgoLNcNdqJsCQxA2i6uh6,88w6ti3WSriyu2FvNjVfrLpGyU5PUvaiJyqrAGPM8TKp,True,910803,227700,1330,665,665,HfEnetJ7uBSmZWCjBNxdvv9HEC5nsW4wDV7wu6WnhWan,53209,910022,-856813,584
2022-01-22 14:27:24-05:00,9136,EBpxGcrs4eWAbBU5rEjFxbr24MjUstZQRMV9jK4q8kMp,EYVd6pztEuz8PC7rUnJ1AjVZ81WWpynyn2qEKtveqrHG,True,1257441,314360,1879,939,940,HfEnetJ7uBSmZWCjBNxdvv9HEC5nsW4wDV7wu6WnhWan,75185,1253384,-1178199,597
2022-01-22 14:27:25-05:00,9137,Aop82qT6CwZbomif4QowqP3VaSHKB1837B2yNKqw4tER,65BVa4jrCx9etU5eXBAXT2PVnwVot2HLWGYyNXbVJDFk,True,9897985,2474496,15231,7615,7616,3zqXX6kzhkbW3d4TwD2CNjMRwxTbREXySekvq37kfCNk,609254,9931051,-9321797,615
2022-01-22 14:27:25-05:00,9138,BLJgLzizx2yLgd12pVBAHTMqn9J5JA3JHCF8PnLnPyUk,HhDmwMysBFWhXnd3mrV31w75WBRKBS8wJSiEMZgqdUSp,True,2831269,707817,4317,2158,2159,3zqXX6kzhkbW3d4TwD2CNjMRwxTbREXySekvq37kfCNk,172703,2978822,-2806119,609
2022-01-22 14:27:28-05:00,9139,9Ngb4UJjvSm9zbTN4RYRFWBzTPVWQh7C2hFiDvwPsDBd,EamTKaoTYJo9RUMQC7MjS1HJrVPYipR2cv6nYpgBLnPr,True,385957326,96489331,583505,291752,291753,3zqXX6kzhkbW3d4TwD2CNjMRwxTbREXySekvq37kfCNk,23340204,164961512,-141621308,604
2022-01-22 14:27:28-05:00,9140,A4Q7Vrc9M3GtEXNUSiVBFkansyf5sKBtSeVT92WFacqv,EWLNfsTKqzkd7KAhnrPRre4Dyk6exb3H9wSbrJuyWprg,True,18333304,4583326,27677,13838,13839,3zqXX6kzhkbW3d4TwD2CNjMRwxTbREXySekvq37kfCNk,1107104,18437230,-17330126,603
2022-01-22 14:27:28-05:00,9141,9kYkFDNE3qD6s73fn8kJowgqbDZoDSw22XaUJ7rTD43D,E8zJz8pT2c9aZsxe4kLMNs4bY7skt38SU5wK5JTqbGr6,True,11047588,2761897,17167,8583,8584,3zqXX6kzhkbW3d4TwD2CNjMRwxTbREXySekvq37kfCNk,686693,11368672,-10681979,621
2022-01-22 14:27:28-05:00,9142,8ARSFh2vPjz7M1pjNqFRsRrHFGwVsUNnD7kLbqhmMrZR,9TGsutLwHv259Le8zfZ75FM4eLZffi6itgWBgYqeKkAy,True,4820849,1205212,7425,3712,3713,3zqXX6kzhkbW3d4TwD2CNjMRwxTbREXySekvq37kfCNk,297025,4925223,-4628198,616
2022-01-22 14:27:28-05:00,9143,AvpYg74EBhwAXE8rcdGkpwmbBMRyVidF6zMRSFtWAVC6,4WgpqTp4r9wMpMptYMNbvCaP2faBnVr6FdShCAobetpL,True,713788,178447,1089,544,545,3zqXX6kzhkbW3d4TwD2CNjMRwxTbREXySekvq37kfCNk,43573,734339,-690766,610
2022-01-22 14:27:28-05:00,9144,BrHRMouGRz3LBNzd9anfdYMhWfg8yUPHL4PqJ8WdEDFS,4uzoLa3mC2VYHAPBoHLX4gTjPTC28rPf2fvEGtJWPYc,True,168561,42140,254,127,127,3zqXX6kzhkbW3d4TwD2CNjMRwxTbREXySekvq37kfCNk,10169,262097,-251928,603
2022-01-22 14:27:28-05:00,9145,woTXSsDkL9TQNxc3zwxSPagVijX7PE24bgKjvxexRwQ,A5M5EEPfDgvAxGLhpNgfn8AzPmyXxmPVgkEKnyoVzsz6,True,72582,18145,109,54,55,3zqXX6kzhkbW3d4TwD2CNjMRwxTbREXySekvq37kfCNk,4388,83486,-79098,604
2022-01-22 14:27:33-05:00,9146,JDg1bbHkYeznDUtSBLhagRJ45aSzeSF5V8iDRJCay9wL,8n7ic28zq5PjJtRcM7Fcy5vLW2YVXw4EWMK6UAt2zh3V,True,21391299,5347824,29872,14936,14936,HfEnetJ7uBSmZWCjBNxdvv9HEC5nsW4wDV7wu6WnhWan,1194916,20616028,-19421112,558
2022-01-22 14:27:33-05:00,9147,52hhBAuVyifMNFKGQmSitc8smiEgscXQMzVuZj55j7E5,6B5DBJx9NLytR3fkrYqe5W5ek4rUWsR4nPsRTvRfRwzC,True,31600435,7900108,44364,22182,22182,HfEnetJ7uBSmZWCjBNxdvv9HEC5nsW4wDV7wu6WnhWan,1774597,31584293,-29809696,561
2022-01-22 14:27:33-05:00,9148,U3vvMQ4X4aKzVYfhMw1V1p58HRqaLnuXozqmmefYeD9,7JA94MArkNCFRhBq8f5a32DgMF6aPdFsoC5HvXDQ6NuR,True,869965,217491,1327,663,664,HfEnetJ7uBSmZWCjBNxdvv9HEC5nsW4wDV7wu6WnhWan,53116,998107,-944991,610
2022-01-22 14:27:33-05:00,9149,3PPCwAjj8GNphb3cRs7kP1QVghEUX6gWUH3M4JarQsTD,28UR4WKAziiJmPwas5E5JrY3WaUrR2NkYYXCKuxPHTMR,True,253643477,63410869,368543,184271,184272,3zqXX6kzhkbW3d4TwD2CNjMRwxTbREXySekvq37kfCNk,14741754,235676775,-220935021,581
2022-01-22 14:27:33-05:00,9150,FV9CBGGTbppLnBKh79f2LzD1diTiS5g6u89FcpZHZmnK,Fe7mtmCUziFqbbYTvrhAcAq1Ub7YLfTJRtQ1hG7GzJD1,True,15074,3768,23,11,12,3zqXX6kzhkbW3d4TwD2CNjMRwxTbREXySekvq37kfCNk,931,14444,-13513,617
2022-01-22 14:27:35-05:00,9151,C677yCM22B68au4GspK56Y31pWEpPjt3J9XVMZW7Tiuk,8F3uEiy9fHW1TjPP7GibRuXmLWReJDC3rxdyTLGGdLW7,True,12704,3176,18,9,9,3zqXX6kzhkbW3d4TwD2CNjMRwxTbREXySekvq37kfCNk,742,12580,-11838,584
2022-01-22 14:27:35-05:00,9152,23FjS7S6hwPkaBsziThnqwAqy3dZvDYvNLdCKfxp7Jr4,CpGixAiKhjCWJ8tD8hWxuSUeU7mQeoZU5TVdqsAEMvLQ,True,67491181,16872795,100490,50245,50245,3zqXX6kzhkbW3d4TwD2CNjMRwxTbREXySekvq37kfCNk,4019625,98512082,-94492457,595
2022-01-22 14:27:35-05:00,9153,9BMHbUs4d3qX49fnroHv2FTPDs4yoDFrvDMqf8p9U4pE,2yL7zwMr7qVG5Sdwkf7z6ppnNqt1ASppBbmxwYjfFY6Z,True,11188324,2797081,17496,8748,8748,3zqXX6kzhkbW3d4TwD2CNjMRwxTbREXySekvq37kfCNk,699879,11514896,-10815017,625
2022-01-22 14:27:35-05:00,9154,8HWpccoTmPZ9MsrxtvQ5BV5y8a8WBAB1Sxx2WAiYKRLH,9chtr2Nqg77CCCnjC5JqENmUBNxpDHVH6BG3wojn9gHQ,True,1058534,264633,1545,772,773,3zqXX6kzhkbW3d4TwD2CNjMRwxTbREXySekvq37kfCNk,61809,1073069,-1011260,583
2022-01-22 14:27:35-05:00,9155,HdRgh9niYSd3YKCxzGdusYFquiVoFTP2mEGEzJJL5Nii,78C68Gbb1jYFQmYNCHHjL52keEKMXtGukmBwT7ahon4B,True,107231828,26807956,160809,80404,80405,3zqXX6kzhkbW3d4TwD2CNjMRwxTbREXySekvq37kfCNk,6432381,90800513,-84368132,599
2022-01-22 14:27:35-05:00,9156,2EkjFzKuqQaT9iLsf4qHnXM6rnbj7ftEyzzRsWx6D347,9NpHNbrRJF3U8Ub4KraPHhhZpyZk9Teo836dJSktJMEV,True,6371701,1592925,9639,4819,4820,HfEnetJ7uBSmZWCjBNxdvv9HEC5nsW4wDV7wu6WnhWan,385573,3854813,-3469240,605
2022-01-22 14:27:35-05:00,9157,4oop1mjCh1Ao9NoWAUacAGc75GxiRTXr8KJ3NtzZ7btf,BfntjUunXBhnrKmocQ7pZr3wwxruRGudMyWQYC2MUhei,True,2966261,741565,4413,2206,2207,3zqXX6kzhkbW3d4TwD2CNjMRwxTbREXySekvq37kfCNk,176548,2905032,-2728484,595
2022-01-22 14:27:36-05:00,9158,3tQBuHwr3V8AZu8Yqhg1UfmnFoxzkUq9UeGeLm41UHy4,9cESwduiHBgrxZK1hN1eAFwnyfxw3FEHezTa8Ue5Kpye,True,57929461,14482365,90172,45086,45086,3zqXX6kzhkbW3d4TwD2CNjMRwxTbREXySekvq37kfCNk,3606909,39081318,-35474409,622
2022-01-22 14:27:36-05:00,9159,5V5gFVMYSwGYfHFecRoHg8G22Rg4bXfVK2FSRTMhPQty,73raXd5MvixmDvJRnVjRL7yQaHZGFRiC9aBxL9ysiRvy,True,79617518,19904379,122558,61279,61279,HfEnetJ7uBSmZWCjBNxdvv9HEC5nsW4wDV7wu6WnhWan,4902339,41938674,-37036335,615
2022-01-22 14:27:38-05:00,9160,Gk4mpwDEggypoPjyrZcFDbHT8WBwspC5AbQ5uDgaQufL,GTDi3mKTcw1NfwbYx8s8YCkzqbaJUM8YUwYifNr9sjgH,True,171097993,42774498,239956,119978,119978,HfEnetJ7uBSmZWCjBNxdvv9HEC5nsW4wDV7wu6WnhWan,9598263,104720924,-95122661,560
2022-01-22 14:27:38-05:00,9161,3EgUBHBeKWegibDcCsTGaGehnwHYvpMbcPaT1UTbwQ49,Hxd4dsnLD8uHnG7KR7GVmKXBcpN1egMUvoTccPvBcaYA,True,31395557,7848889,44369,22184,22185,3zqXX6kzhkbW3d4TwD2CNjMRwxTbREXySekvq37kfCNk,1774785,31365413,-29590628,565
2022-01-22 14:27:38-05:00,9162,7A1v7bFDJwxM7XomePFyRh58SMHxrNSkM3fJygd8pQUN,DL9jCFHaM8BXJ5KE1YJHXNCbXgSdRgt18MHhAgC6TNmg,True,2292096,573024,3245,1622,1623,HfEnetJ7uBSmZWCjBNxdvv9HEC5nsW4wDV7wu6WnhWan,129811,2114805,-1984994,566
2022-01-22 14:27:43-05:00,9163,BYvjENe16Ta77PqGV7JKEWrsqCTfkMGYwTSG5gXneDvd,EvxAXgvhPC6QkNurbK7vWyTApGo8J2R4EgMAknkHVU3d,True,8566,2141,13,6,7,3zqXX6kzhkbW3d4TwD2CNjMRwxTbREXySekvq37kfCNk,536,11025,-10489,625
2022-01-22 14:27:44-05:00,9164,BJV5jbowrbELXfDvfMovaQy4PiRf12pLYHimW9bgzW5X,6WXrWso5FvLx7RMCFBzrbzh5qevKkk2LJAihUfWXxXzB,True,59961,14990,93,46,47,3zqXX6kzhkbW3d4TwD2CNjMRwxTbREXySekvq37kfCNk,3747,93880,-90133,624
2022-01-22 14:27:45-05:00,9165,6Z6y2QLJUZ5s6zdjanJcKprTAotx8tqr9DRNqqycMeS4,JCYwt8MHVaBb14GB2qAvDWwYVMaL7VTxyNEt7Eo5Zy8x,True,590276,147569,923,461,462,HfEnetJ7uBSmZWCjBNxdvv9HEC5nsW4wDV7wu6WnhWan,36947,605903,-568956,625
2022-01-22 14:27:45-05:00,9166,DMgD2KCEhTGFLUZ5GnfNcwfiiwKYbyVpoWiN6knMkCAf,5KU2vgBkPTNVHsSULjgX7ZkZS56U3Dy3xqLTxL5sUZJ3,True,3950733,987683,6152,3076,3076,HfEnetJ7uBSmZWCjBNxdvv9HEC5nsW4wDV7wu6WnhWan,246094,5004378,-4758284,622
2022-01-22 14:27:45-05:00,9167,2ZSfbqxhiCTDrDPeRhoWayTZHNmW7ajVXBCxpFS4eGBF,3ZmWsPdQD7qfSMGKQSNhmBtuH7S6qMFRc8oEmBcHXEiR,True,719394,179848,1088,544,544,3zqXX6kzhkbW3d4TwD2CNjMRwxTbREXySekvq37kfCNk,43537,739989,-696452,605
2022-01-22 14:28:33-05:00,9168,3NhNdphQiKwgHTmTJc4qVhp3aWjqnwMTYbRW1y9CZrZg,BNpP1sKPAr7Dk1ymSrupge9KGMVpk4LfjTjawgi9YaC5,True,4218326,1054581,6576,3288,3288,3zqXX6kzhkbW3d4TwD2CNjMRwxTbREXySekvq37kfCNk,263073,4230944,-3967871,623
2022-01-22 14:28:33-05:00,9169,73PpLzJmAimmqtjGpRcYHua8t6wx3gYiiXFvQxnSDMJV,CRCpLcS8LNKX22co94spJBXEes9Fnh5rYBvbVEte4JXA,True,84549645,21137411,132072,66036,66036,3zqXX6kzhkbW3d4TwD2CNjMRwxTbREXySekvq37kfCNk,5282915,77480722,-72197807,624
2022-01-22 14:28:37-05:00,9170,EBnMKbaJEjNXjt14hxssR8wd3Ua37McPQxUZnKxxbgtd,FAALK2LRFhg98ezHEBFrgrzxTg66eZpmo7ctKDEck8q5,True,1265898,316474,1974,987,987,3zqXX6kzhkbW3d4TwD2CNjMRwxTbREXySekvq37kfCNk,78986,1185901,-1106915,623
2022-01-22 14:28:37-05:00,9171,6sK2PQyTvStxT9qigrFaPmf9GSe4X4wLb4ig7izrzwaB,6iyTuXdnBiLrKPCat7ajRnUq2245L9bbJrHAvsnyFx8e,True,4909,1227,7,3,4,3zqXX6kzhkbW3d4TwD2CNjMRwxTbREXySekvq37kfCNk,306,4944,-4638,623
2022-01-22 14:28:40-05:00,9172,6fqbSyhh3PPdgRcLraHb7Jahj9s1oHHeX3SsjNSsGa6t,GpRUow48TYgttdYfsygbgjYQcmHyYjWETUDjDVphEgwq,True,2298520938,574630234,3596826,1798413,1798413,3zqXX6kzhkbW3d4TwD2CNjMRwxTbREXySekvq37kfCNk,143873067,1171904467,-1028031400,625
2022-01-22 14:28:55-05:00,9173,B4Uc39nKzz9wBRQsCkMR4A7RwTJ8rSuwpR6EQn2AesRb,H49bGZgatRZVpj6QufZRVgYrQtH7LpdbiqKBs23151m,True,71645,17911,112,56,56,3zqXX6kzhkbW3d4TwD2CNjMRwxTbREXySekvq37kfCNk,4483,120366,-115883,625
2022-01-22 14:29:00-05:00,9174,9rgrRAMcGSarfz8xXckw1LjkemMwwjzJLApPjpfY2XZ3,BRtNdDDtCiNDYDERZTBCefUiYvjShucRX1hxEBLyeggT,True,568531,142132,889,444,445,3zqXX6kzhkbW3d4TwD2CNjMRwxTbREXySekvq37kfCNk,35581,584249,-548668,625
2022-01-22 14:29:31-05:00,9175,95urWGJ4HN1bTarbDi8Dpj4K4ms7dovs8gwaYdaSLC6e,2THhqxjhXjp2Zui9ML2MzAbGN4dsfa3dkdqzC8LYhnbQ,True,1054010,263502,1648,824,824,3zqXX6kzhkbW3d4TwD2CNjMRwxTbREXySekvq37kfCNk,65958,1047841,-981883,625
2022-01-22 14:30:37-05:00,9176,7ayTm4uC5VbtMt9w6g9tFban4fYVwbqCzJZpiFMjmBiB,BvidnEZHHtXVhtgv4qFKThEaFZsFmyAuDVqZQwMppjSg,True,2202218088,550554522,3427902,1713951,1713951,3zqXX6kzhkbW3d4TwD2CNjMRwxTbREXySekvq37kfCNk,137116091,1381021133,-1243905042,622
2022-01-22 14:31:11-05:00,9177,3Xbsek5MsEGoWr3G9yhuohREr26B2vSQcjqXdspTFHta,2rPxkUiMo9wGDq8EvAiwY3ngRpKmL223cBWWNTYoBmFp,True,1904564,476141,2976,1488,1488,DddJ7EWCmYEEZETCBNgAUSg81Ls6fZtiAaY5ekJ5sXx1,119072,1156251,-1037179,625
2022-01-22 14:33:18-05:00,9178,Dng7By2saPu5TVxcvXidBe71ggBo8tiHkAXPi4kKL1tk,75ufEJmHbLHffphL7tvAXhGyftKLr1z2PXXoB2GGY5fG,True,17459649,4364911,27316,13658,13658,DddJ7EWCmYEEZETCBNgAUSg81Ls6fZtiAaY5ekJ5sXx1,1092656,6775124,-5682468,625
2022-01-22 14:37:45-05:00,9179,8trkirSQNdMmAcJdeswxs5cPjH8dD6U4eJtWiAdMsrDB,HaSzpQ45x2MipfN17U6jGBxX8tXboomVDhXNSrnEfLDr,False,31435,31435,1265,63,1202,DddJ7EWCmYEEZETCBNgAUSg81Ls6fZtiAaY5ekJ5sXx1,1265,28246,-26981,402
2022-01-22 14:38:55-05:00,9180,399591e8XgY52yCMorCQ2WL6dQZTC485ZooHtmGuirhZ,JCiXAooFmKmEPQ2S7C8iSk6CLcTyrPEe1SsPSLyUGySe,False,18650,18650,687,34,653,HfEnetJ7uBSmZWCjBNxdvv9HEC5nsW4wDV7wu6WnhWan,687,19499,-18812,368
2022-01-22 14:44:03-05:00,9181,7Dm3syN4P2mbBLFKyHTrtnSWY4hadGXiKB9EekTdT68S,HF97QS1dqarPMWgNmtcoaq6z3rpJnzAAAfc1PP4FwRhV,True,1744152,436038,2722,1361,1361,HfEnetJ7uBSmZWCjBNxdvv9HEC5nsW4wDV7wu6WnhWan,108908,646002,-537094,624
2022-01-22 14:46:17-05:00,9182,2rLWe1XADCU93guPU6WgSW6x56gYNfif9bm11V93mJnv,BEGhQRm3fgSHeBtk2DYrXEBPKPRvS3sHyTNopmoBJxMs,True,5429214719,1357303679,8404425,4202212,4202213,HfEnetJ7uBSmZWCjBNxdvv9HEC5nsW4wDV7wu6WnhWan,336177038,2853607398,-2517430360,619
2022-01-22 15:01:21-05:00,9183,7FB6X8YgiDn7YK9bZZmcFyzhuvVLVWPCfBbenwMXhx5,2EaDCpL9MpAKuiC2bvUCGRfvqYvgVXGFHXt35QdNakfG,True,3603405,900851,5568,2784,2784,DddJ7EWCmYEEZETCBNgAUSg81Ls6fZtiAaY5ekJ5sXx1,222724,1066874,-844150,618
2022-01-22 15:01:21-05:00,9184,G3vArDs7nb18se4xMZ68oMHmTAsYP63x8dfY57jAogwp,EY7J8Hw8jWbryw11CYdPVUSdAoDGGNEfacqghVnJn3JK,True,14697622,3674405,22286,11143,11143,DddJ7EWCmYEEZETCBNgAUSg81Ls6fZtiAaY5ekJ5sXx1,891442,6776755,-5885313,606
2022-01-22 15:01:21-05:00,9185,28JujYG1mbpYSjF7LNqXpup17TXb45VJHhhnFMVXtft2,DAqyVExAtmsovPGrkpkFDxm6T7pKWLztfh9iPjTNDqrd,True,6286064,1571516,9520,4760,4760,DddJ7EWCmYEEZETCBNgAUSg81Ls6fZtiAaY5ekJ5sXx1,380821,2901307,-2520486,605
2022-01-22 15:01:23-05:00,9186,33CE2t84MhG7SMsphhZaxvwFVRbK5wcUMUdEw8UBhoq8,DjNko7SbbK9nQT4K5oBWKiSiXiYS9Rv1k5vT3PNiMyaf,True,3592871,898217,5550,2775,2775,3zqXX6kzhkbW3d4TwD2CNjMRwxTbREXySekvq37kfCNk,222022,2250403,-2028381,617
2022-01-22 15:01:30-05:00,9187,98pwBGgiSDuwuas6WYW2hc9qUxfULwvNE34aixaxbxXY,BLrjKxekjThtJ9rKtQxs1Y4rZ225EE2Q16VkP9TkThyV,True,3974189,993547,5999,2999,3000,3zqXX6kzhkbW3d4TwD2CNjMRwxTbREXySekvq37kfCNk,239980,1831567,-1591587,603
2022-01-22 15:01:41-05:00,9188,B5CTBTggmGFvGFSunjbB4C9tLKcYcULehmEiEXRihY2J,FX3ebF8P89rZBWfR74PDWUzxnLuDkUDgGcPYCBD5sMUG,True,15790334,3947583,24661,12330,12331,3zqXX6kzhkbW3d4TwD2CNjMRwxTbREXySekvq37kfCNk,986472,9223460,-8236988,624
2022-01-22 17:35:04-05:00,9189,H1oYXGZTagwv48FdDe6RNkjNaesedqLKyXxTmPc5k4Fp,Am3rx6XrkrZ4MdeZDyZUv1YW2fBujcz4dLjVCnRQHKZa,True,155540472,38885118,243286,121643,121643,HfEnetJ7uBSmZWCjBNxdvv9HEC5nsW4wDV7wu6WnhWan,9731453,47897874,-38166421,625
2022-01-22 17:35:04-05:00,9190,GKCeRcHQYMhcTwEm5wu1SbkXAT19gjGUGji43HS36B5N,EYQKX5sWsmXoge5xbTcMYAjvRbSUTXXpHEzckPY2LV8W,False,204035,204035,10214,510,9704,HfEnetJ7uBSmZWCjBNxdvv9HEC5nsW4wDV7wu6WnhWan,10214,87722,-77508,500
2022-01-22 17:38:26-05:00,9191,J1sBDjpdBZcsSBS5eg95SSRjRqmQUR9cXJCsLJu8yCUt,F5wRpD2senMkGbL8Uquqo8W9x5NQDDa268dHuVFAZCww,True,298932,74733,466,233,233,HfEnetJ7uBSmZWCjBNxdvv9HEC5nsW4wDV7wu6WnhWan,18670,201610,-182940,624
2022-01-22 17:38:26-05:00,9192,EToREv5PrDmMUqRH43RdhooZMpmzXdic79KSoBatakPp,4ZTacQQnxq89V64pELPFkmvwJgkVY7m29g2sXfnn3mPD,True,19465728,4866432,30373,15186,15187,HfEnetJ7uBSmZWCjBNxdvv9HEC5nsW4wDV7wu6WnhWan,1214934,5843006,-4628072,624
2022-01-22 17:38:30-05:00,9193,7aM6r3HXMKzhj1hoDWjjkVCVy2y1rhDx2QV8Sdgr9DoM,4yBtGoYqo6dX4T3NMVbgMN3731hEnugL1dsR1A5vXF8f,True,18891190,4722797,29538,14769,14769,HfEnetJ7uBSmZWCjBNxdvv9HEC5nsW4wDV7wu6WnhWan,1181556,7754666,-6573110,625
2022-01-22 17:38:30-05:00,9194,49hagnoMSB3ozBBMaTgeZ2nwEbKKS3NZWUuPShMBUwp9,6ivAhvY6bUr98jqBp4ye1w8Vz8NesEubqKDSn1jeqxmr,True,34560906,8640226,54054,27027,27027,HfEnetJ7uBSmZWCjBNxdvv9HEC5nsW4wDV7wu6WnhWan,2162182,10570537,-8408355,625
2022-01-22 17:38:40-05:00,9195,3idUQDMPAN9f6F6BipHAYFZyhG5JADey1y7JcFYx5BRh,D6UMk8WsSRahs4nGyi9DLt2HyZQy4wAywDwL31sL8BVj,True,3186529,796632,4984,2492,2492,HfEnetJ7uBSmZWCjBNxdvv9HEC5nsW4wDV7wu6WnhWan,199385,1296840,-1097455,625
2022-01-22 17:40:04-05:00,9196,5gN3624v6n1zQ1BKtZi1e9ZLpbCa4MEfhgHySFB81Qfm,UXT3oB5ud18rBsygsfxwA93kQYdSNbbzTCjt4gtU2jP,True,27468341,6867085,42906,21453,21453,HfEnetJ7uBSmZWCjBNxdvv9HEC5nsW4wDV7wu6WnhWan,1716241,8415272,-6699031,624
2022-01-22 18:43:57-05:00,9197,9E97vZ6evPgg1Ao8KwvjjZhBFW6dXZrrJENk1HvZ3SU,D7U38PB8BXLwUVKbRNv9po7VcFdnn7Y4tWY9xpRiNJsT,True,4300171,1075042,6720,3360,3360,HfEnetJ7uBSmZWCjBNxdvv9HEC5nsW4wDV7wu6WnhWan,268826,1932582,-1663756,625
2022-01-22 19:42:14-05:00,9198,C677yCM22B68au4GspK56Y31pWEpPjt3J9XVMZW7Tiuk,8F3uEiy9fHW1TjPP7GibRuXmLWReJDC3rxdyTLGGdLW7,False,5347,5347,0,0,0,HfEnetJ7uBSmZWCjBNxdvv9HEC5nsW4wDV7wu6WnhWan,0,9581,-13060,0
2022-01-22 19:44:55-05:00,9199,GxFxvEUdWofneMmVvhCSScH9V6Zia5WJ2J9q6CpPnaq3,ATLykiHDii3Lw53MoZXwqu1FbBNPJbVNVGe2SoQMjVmY,False,14897,14897,0,0,0,HfEnetJ7uBSmZWCjBNxdvv9HEC5nsW4wDV7wu6WnhWan,0,17888,-18967,0
2022-01-22 21:47:00-05:00,9200,EYNh72buYHmKWRSqF8omcFHRbqKWV76iXB2vrjHgQMck,Efm7bH2DFg5Y5M39jq3uDcoDHUa95zmey8n7Ld72jG84,True,37462917,9365729,58515,29257,29258,HfEnetJ7uBSmZWCjBNxdvv9HEC5nsW4wDV7wu6WnhWan,2340616,16549796,-14209180,624
2022-01-22 21:48:11-05:00,9201,D7XummfEc3NTK4qMvZegV3FrYuqc8mNgnQu3ujwemZtg,HHiRcecqzW7sGFTio7Ph6TYv3dGt64KWv4DEKgKm84fQ,False,28010,28010,131,6,125,HfEnetJ7uBSmZWCjBNxdvv9HEC5nsW4wDV7wu6WnhWan,131,31337,-31206,46
2022-01-22 21:49:53-05:00,9202,EDCJpkYBNcvKbqWmFwtnbeGYEiE6iACp4aQHgX5FXnNq,AubiccN4FqTZszcX3kJQQWc1JuDgDQG6XEN3TsTm55Zs,True,320611840,80152960,500135,250067,250068,HfEnetJ7uBSmZWCjBNxdvv9HEC5nsW4wDV7wu6WnhWan,20005436,79048352,-59042916,623
2022-01-22 21:57:06-05:00,9203,C33hfnDHzVwKXxr6AwFAXhd1vJYrPKhtqc75Qpjm19Zt,2WYBMSyrHQEYZqxEtxBMe2xn7eioJEGsudqdCmGvssGh,True,4066963,1016740,6340,3170,3170,HfEnetJ7uBSmZWCjBNxdvv9HEC5nsW4wDV7wu6WnhWan,253607,1535919,-1282312,623
2022-01-22 21:58:08-05:00,9204,DkKumyFA6dGw77wcwd16nWzTEC9McvmasAbmGfQXLkB7,9u6QyrruYFjhyLV5AXYUKkrBggzrxXfNH57smUAap5Ro,True,3720752,930188,5816,2908,2908,HfEnetJ7uBSmZWCjBNxdvv9HEC5nsW4wDV7wu6WnhWan,232645,1896617,-1663972,625
2022-01-22 22:00:34-05:00,9205,HmspGdpobjC5Vbmo3FcKdw4RLPN7wJKxv3uKqDjVhLee,3YEX8TzdyJyuHo76Kw76imVCJjzrC9m188YuRKvwwSwD,True,26435111,6608777,41234,20617,20617,3pStmNaV47N2sqUtHJHLAtCKiN9JZ6jzNY9h94ng8G1D,1649382,10400953,-8751571,623
2022-01-22 22:00:35-05:00,9206,8abFwhhZyq3xkvjp4NWDBt7qAPXBbzBxksUk8SAUeVkN,A9u4dhWZbBwthC4WXQg1Dfp3wHYXr67SGs5na1EQ1k3r,True,6379322,1594829,9975,4987,4988,HfEnetJ7uBSmZWCjBNxdvv9HEC5nsW4wDV7wu6WnhWan,399004,2239427,-1840423,625
2022-01-23 02:48:44-05:00,9207,ax5UVRS7cnHMnWCJX3HuLRAA8928UVMNr6MjrkNV23g,Gsuva5PuUju3YWM8XWeSjC71dDVb4aLUxN5EsWGyEjTt,False,8157,8157,0,0,0,HfEnetJ7uBSmZWCjBNxdvv9HEC5nsW4wDV7wu6WnhWan,0,12802,-14869,0
2022-01-23 04:25:11-05:00,9208,9VpoJMRrNqJ5fQiqTrf44G2A1UaHi6ZgYLuGN2hCJQbE,7ar7UP1E8USswbzR4Z3ePjwRY4Wy11MXks3koeq5M8Zf,True,1456400550,364100137,2242238,1121119,1121119,HfEnetJ7uBSmZWCjBNxdvv9HEC5nsW4wDV7wu6WnhWan,89689534,257880085,-168190551,615
2022-01-23 16:53:56-05:00,9209,7feC64HZfQpniey2iXsMMgQXnfcunJus74DiKDeKaEUw,GstsCxAiBBEUrXNkvZZ9Sg4vNK916PsKe2Mx6e4M6dU7,False,18699,18699,0,0,0,HfEnetJ7uBSmZWCjBNxdvv9HEC5nsW4wDV7wu6WnhWan,0,19395,-21399,0
2022-01-23 16:56:42-05:00,9210,9KD2AifD5wFD4QkHYuawXbJgLWHrfj2QPF3fT8jhGVA5,Ga9gAqmkuHbqrr31sUFPqa1xa5WNxLWJWGPUaMxQqLdj,True,17397,4349,24,12,12,HfEnetJ7uBSmZWCjBNxdvv9HEC5nsW4wDV7wu6WnhWan,987,17832,-16845,567
2022-01-23 17:24:40-05:00,9211,9KD2AifD5wFD4QkHYuawXbJgLWHrfj2QPF3fT8jhGVA5,Ga9gAqmkuHbqrr31sUFPqa1xa5WNxLWJWGPUaMxQqLdj,False,12077,12077,0,0,0,HfEnetJ7uBSmZWCjBNxdvv9HEC5nsW4wDV7wu6WnhWan,0,12189,-12200,0
2022-01-23 20:39:39-05:00,9212,AwzEZdWCsm74G3ChJPpYJ3JDhNzbcAoznnBW4veubndv,nvjiDwGDTkBKBVjk3Yhe6n4xDTVssFcqHiBKdUPNhNt,False,11866,11866,0,0,0,HfEnetJ7uBSmZWCjBNxdvv9HEC5nsW4wDV7wu6WnhWan,0,9000,-12402,0
2022-01-23 20:41:25-05:00,9213,BrHRMouGRz3LBNzd9anfdYMhWfg8yUPHL4PqJ8WdEDFS,4uzoLa3mC2VYHAPBoHLX4gTjPTC28rPf2fvEGtJWPYc,True,125020,31255,184,92,92,HfEnetJ7uBSmZWCjBNxdvv9HEC5nsW4wDV7wu6WnhWan,7367,197715,-190348,589
2022-01-23 20:44:34-05:00,9214,4VenmgcXX4E4fSEAo61JXN8a7hycsCziV3RJufjh3jYb,41v2DEZADVcoDoF8hMgjiDc1HeeK8MWZpfQUiVXUmPz5,False,8167,8167,0,0,0,HfEnetJ7uBSmZWCjBNxdvv9HEC5nsW4wDV7wu6WnhWan,0,12836,-16375,0
2022-01-23 22:54:35-05:00,9215,9Ngb4UJjvSm9zbTN4RYRFWBzTPVWQh7C2hFiDvwPsDBd,EamTKaoTYJo9RUMQC7MjS1HJrVPYipR2cv6nYpgBLnPr,True,297677352,74419337,465254,232627,232627,HfEnetJ7uBSmZWCjBNxdvv9HEC5nsW4wDV7wu6WnhWan,18610160,127177645,-108567485,625
2022-01-23 23:40:28-05:00,9216,BrHRMouGRz3LBNzd9anfdYMhWfg8yUPHL4PqJ8WdEDFS,4uzoLa3mC2VYHAPBoHLX4gTjPTC28rPf2fvEGtJWPYc,True,92403,23100,142,71,71,HfEnetJ7uBSmZWCjBNxdvv9HEC5nsW4wDV7wu6WnhWan,5698,141147,-135449,616
