ts,record_id,user_authority,user,partial,base_asset_value,base_asset_value_closed,liquidation_fee,fee_to_liquidator,fee_to_insurance_fund,liquidator,total_collateral,collateral,unrealized_pnl,margin_ratio
2022-01-10 09:18:41-05:00,3073,ymyzGH4Qc7HH5PbKpVphCbsQgLLXyGkPcXamQJuNj5C,8oTLHaV2XzbKXNWRuUjCfHjUn61Pw93LYK14m9q2VDpZ,True,23410650,5852662,36472,18236,18236,3zqXX6kzhkbW3d4TwD2CNjMRwxTbREXySekvq37kfCNk,1458880,8301141,-6842261,623
2022-01-10 09:18:42-05:00,3074,B4Uc39nKzz9wBRQsCkMR4A7RwTJ8rSuwpR6EQn2AesRb,H49bGZgatRZVpj6QufZRVgYrQtH7LpdbiqKBs23151m,True,44051286,11012821,68719,34359,34360,4BnQKPLuE3DMTtxp8MjUBytgnhvxqq3ZTqZHTVZo4JJh,2748773,37540505,-34791732,623
2022-01-10 09:18:42-05:00,3075,3C2MZQKh9x4zNTCMbhhvoafGaFMwUooqfy9MCgPyXs6E,AHjgWKpYPWe6ketjDHDKFBFsKQiRJ41jnkuo39MVYxZo,True,360339692,90084923,559995,279997,279998,3zqXX6kzhkbW3d4TwD2CNjMRwxTbREXySekvq37kfCNk,22399838,194653717,-172253879,621
2022-01-10 09:18:42-05:00,3076,2FEbsetZMkRqLjSC8GBbgecKgX5T1T1fci2sLQux29p8,H722Fcd6DkTFRZxqQWbPDufBfXEgmFfhiEpQZWhxwYv1,True,8223189,2055797,12791,6395,6396,DddJ7EWCmYEEZETCBNgAUSg81Ls6fZtiAaY5ekJ5sXx1,511677,2965438,-2453761,622
2022-01-10 09:18:46-05:00,3077,U3vvMQ4X4aKzVYfhMw1V1p58HRqaLnuXozqmmefYeD9,7JA94MArkNCFRhBq8f5a32DgMF6aPdFsoC5HvXDQ6NuR,True,534556397,133639099,832007,416003,416004,DddJ7EWCmYEEZETCBNgAUSg81Ls6fZtiAaY5ekJ5sXx1,33280280,261804756,-228524476,622
2022-01-10 09:19:04-05:00,3078,FFoYoBmkfEsCWVXQf3BhKeaFMZD3YVKvfhPWkXdnCZS9,8yW6WApAuN43brF1HioTLdyxvQTQJzt875E26QqrWWFk,True,941689,235422,1454,727,727,4BnQKPLuE3DMTtxp8MjUBytgnhvxqq3ZTqZHTVZo4JJh,58175,255551,-197376,617
2022-01-10 09:19:06-05:00,3079,BYvjENe16Ta77PqGV7JKEWrsqCTfkMGYwTSG5gXneDvd,EvxAXgvhPC6QkNurbK7vWyTApGo8J2R4EgMAknkHVU3d,True,5253570,1313392,8050,4025,4025,DddJ7EWCmYEEZETCBNgAUSg81Ls6fZtiAaY5ekJ5sXx1,322000,3076669,-2754669,612
2022-01-10 09:19:06-05:00,3080,6Bq55LtGCEeGqh4JrFLCmmGc2iJfTTBJixivqH78aGSE,DSNrCgWJeNe2P9tAQu5FvCueTzNKDKds7wzuwTQSMRG,True,11673969,2918492,17995,8997,8998,4BnQKPLuE3DMTtxp8MjUBytgnhvxqq3ZTqZHTVZo4JJh,719805,4142007,-3422202,616
2022-01-10 09:19:06-05:00,3081,6rb3fRVWJ5cSzFcmuC1YwdrNxiNctvboDF7HwsfyGoCA,H6JaYfFZkRk6iSJrA4nVeuFpMVQtVwQZHVgK1TyaupTE,True,73753,18438,113,56,57,4BnQKPLuE3DMTtxp8MjUBytgnhvxqq3ZTqZHTVZo4JJh,4538,54725,-50187,615
2022-01-10 09:19:06-05:00,3082,3WcJUt8jQ1ngL3ZCGo6dFrc3GmTMTYtzeDva7mri2Tqx,HeG1Pz2oMjqtkfsRMsbqP3VpatnVEQzcWmKDVoFp4Htr,True,27589941,6897485,42629,21314,21315,DddJ7EWCmYEEZETCBNgAUSg81Ls6fZtiAaY5ekJ5sXx1,1705185,11654275,-9949090,618
2022-01-10 09:19:06-05:00,3083,CwTus4FyoXYqyTKAYDp69NLhA1joYZ3tarzY6FFTr6fn,6ivuvYWU6i25MzJSY8rG9rPDKiq38E6QtrV1jvRubLGr,True,17794,4448,27,13,14,4BnQKPLuE3DMTtxp8MjUBytgnhvxqq3ZTqZHTVZo4JJh,1097,7298,-6201,616
2022-01-10 09:19:12-05:00,3084,2PzBAkdXkrwH9VuoMALumQz86qkW7sSBQtCrHw14JUp3,D5vwWAMHVooobG2sCWv9EwtJrAFZG6cwKH4dfmA98tbt,True,3568654,892163,5566,2783,2783,DddJ7EWCmYEEZETCBNgAUSg81Ls6fZtiAaY5ekJ5sXx1,222653,1458942,-1236289,623
2022-01-10 09:19:12-05:00,3085,FV9CBGGTbppLnBKh79f2LzD1diTiS5g6u89FcpZHZmnK,Fe7mtmCUziFqbbYTvrhAcAq1Ub7YLfTJRtQ1hG7GzJD1,True,9246202,2311550,14241,7120,7121,72FwbpFGoLEazJEdpqNtPNefsadUrimUqma9wSoy4qiS,569650,3340579,-2770929,616
2022-01-10 09:19:12-05:00,3086,X5SF9srgzDgBRBhv8xUWyszYYSQiqFF6cVnVLWzQgp1,7rTqnMkPuUUJFt5px1DxwsUK8U5fQUtnx9N4v6dA4vGb,True,45384,11346,70,35,35,DddJ7EWCmYEEZETCBNgAUSg81Ls6fZtiAaY5ekJ5sXx1,2834,18483,-15649,624
2022-01-10 09:19:12-05:00,3087,Cs2YxkuqBK1kjoYZbUZdUcxapPbv8oC75trwGgWoCPfG,2PgHQM1GhHykE4bQ1ggueAw2Zs1BFUW5hxvMvr8DojKM,True,96586980,24146745,149416,74708,74708,4BnQKPLuE3DMTtxp8MjUBytgnhvxqq3ZTqZHTVZo4JJh,5976669,51759722,-45783053,618
2022-01-10 09:19:12-05:00,3088,DMgD2KCEhTGFLUZ5GnfNcwfiiwKYbyVpoWiN6knMkCAf,5KU2vgBkPTNVHsSULjgX7ZkZS56U3Dy3xqLTxL5sUZJ3,True,2423263240,605815810,3719783,1859891,1859892,DddJ7EWCmYEEZETCBNgAUSg81Ls6fZtiAaY5ekJ5sXx1,148791332,1386922350,-1238131018,614
2022-01-10 09:19:12-05:00,3089,7vKmhLV45Q5etXhJL5ng8rxWhYSiUCDmAbGnwBPr7zcx,cP6xPeuHLnjr858QK1F9qYn7rJpEbPy7wEJHoju6oV7,True,59382371,14845592,92771,46385,46386,4BnQKPLuE3DMTtxp8MjUBytgnhvxqq3ZTqZHTVZo4JJh,3710869,24028966,-20318097,624
2022-01-10 09:19:13-05:00,3090,F1JT1p2VuwK4L7zj7NNnZtYiZiNUCcTGKDkgdoX3BZdZ,3BKe4yzTwnnBnvTWP3britpPJ4oAWL7JZJzNLCxjUufS,True,8915,2228,13,6,7,3zqXX6kzhkbW3d4TwD2CNjMRwxTbREXySekvq37kfCNk,553,2026,-1473,620
2022-01-10 09:19:21-05:00,3091,7D4rFmGMPKNAF75VRPxHAhSn2wTjiW8jmth1UD22Xqq9,GQ7BrT6vsXu8tHCMm75YdxFR2r9QTCrCUbdPEZBSAg9w,True,65762749,16440687,102804,51402,51402,3zqXX6kzhkbW3d4TwD2CNjMRwxTbREXySekvq37kfCNk,4112182,22356166,-18243984,625
2022-01-10 09:19:24-05:00,3092,BhiAaiZu7fF8ndggJrLyiFVCRq526cNBw7VaeascEmNL,4en8MipPi7vq15NGhpPMQfptNdEyhp2j7fpgxBBtjyfz,True,1517758,379439,2353,1176,1177,3zqXX6kzhkbW3d4TwD2CNjMRwxTbREXySekvq37kfCNk,94157,597586,-503429,620
2022-01-10 09:19:28-05:00,3093,DY6k3Dkwe18iLneaT8Xo3VpJWB6V4jWwQQjoDvEzdg2j,3GGV7S9FpRQGbARBXkvGFVqLrmw8JvYAcpnR1aKVUY2f,True,16070535,4017633,24717,12358,12359,4BnQKPLuE3DMTtxp8MjUBytgnhvxqq3ZTqZHTVZo4JJh,988709,9173641,-8184932,615
2022-01-10 09:19:34-05:00,3094,2d1qyEJRyGvB2H83ACSqUjqYLwcLHcURHWAKLXs4w9vp,EFA6rDFpTQcY2vjZMq6Qrjv56nJPN2FhWXNwFzkWtE2M,True,15542873,3885718,24016,12008,12008,3zqXX6kzhkbW3d4TwD2CNjMRwxTbREXySekvq37kfCNk,960665,8196754,-7236089,618
2022-01-10 09:19:34-05:00,3095,5Z3ZFCA65WoWhm3okRuuziEMi7ajGAEHWUFchzBNba5S,FcomdrWidygkxMKzcsY5xELbmwC652uMci648LMTv7AB,True,17046,4261,26,13,13,4BnQKPLuE3DMTtxp8MjUBytgnhvxqq3ZTqZHTVZo4JJh,1061,6752,-5691,622
2022-01-10 09:19:34-05:00,3096,E1wp3bmkcY3eiEYyGYwhTCsr7BZ7RfPa5DJTZFupcFwj,452hVdYkD5SDDrA6hv6DLPFvyS8PvR2P6DPNScGxWTsW,True,1104395,276098,1696,848,848,4BnQKPLuE3DMTtxp8MjUBytgnhvxqq3ZTqZHTVZo4JJh,67861,465013,-397152,614
2022-01-10 09:19:35-05:00,3097,i7TcF4weYcqgrRdH3GpndbEYxCxfcSfr9JWYrAUg1CF,BkDfknUir7PnSEW8auoB87PytycEFwyX5kT2GY4SGJJL,True,7241414,1810353,11097,5548,5549,4BnQKPLuE3DMTtxp8MjUBytgnhvxqq3ZTqZHTVZo4JJh,443907,5715416,-5271509,613
2022-01-10 09:19:35-05:00,3098,DYCYiQFH9QHzCo3eAw1pFoDu7pzwFMo1E2WDZjVFRz5w,CPh4FWsGak1kd1WFEH9qBjNhnun3R2tHtZA57zW8ugn5,True,64958553,16239637,100470,50235,50235,4BnQKPLuE3DMTtxp8MjUBytgnhvxqq3ZTqZHTVZo4JJh,4018819,33263874,-29245055,618
2022-01-10 09:19:35-05:00,3099,DrzTARa7RK8RXoxHZPKCBqYtMC8TAUHRw8SznXRKTa5M,FYANet92VhyXkKZqqBJR4sFxuCftWb68sgQU9VHCdTJk,True,45227,11306,69,34,35,72FwbpFGoLEazJEdpqNtPNefsadUrimUqma9wSoy4qiS,2777,17628,-14851,614
2022-01-10 09:19:37-05:00,3100,EhANPABkSw9x9WnsDEi8pCg67iQTX2UGTTUpyjADTwdN,4FKLi98hyg9ZjM4MY6ctJsv7B6vPUnTYWdhrnNoYsztX,True,13739902,3434975,21054,10527,10527,4BnQKPLuE3DMTtxp8MjUBytgnhvxqq3ZTqZHTVZo4JJh,842167,7009931,-6167764,612
2022-01-10 09:19:37-05:00,3101,Cb4zhnvig11U4GcC4kqKrnDicGgPhUpfDQB1U7hP3nPa,DiRAMrKqaevGXeXg38KnhaYBERj8tNKU7oWFJvhS32kw,True,276242,69060,425,212,213,4BnQKPLuE3DMTtxp8MjUBytgnhvxqq3ZTqZHTVZo4JJh,17016,96734,-79718,615
2022-01-10 09:19:42-05:00,3102,Hy3kzXneDN6FUkiZctU1vWe97BYvj6yZ7QvQzehfWmNr,EhXgQg8BTniANV525RpY76z7Hrh6DuqrMChjqEoXfVJe,True,2203031,550757,3441,1720,1721,4BnQKPLuE3DMTtxp8MjUBytgnhvxqq3ZTqZHTVZo4JJh,137662,1046118,-908456,624
2022-01-10 09:19:42-05:00,3103,CK3ocyWzXQkJJZQmM6bBK4Nv6Rh3UEufjY6DvNU6gJZy,C924o4GY3p2BHLeAbFbe9SEysXqCUyD8sFu2d4NzkAV7,True,8925028,2231257,13699,6849,6850,3zqXX6kzhkbW3d4TwD2CNjMRwxTbREXySekvq37kfCNk,547966,3189784,-2641818,613
2022-01-10 09:19:42-05:00,3104,AKxRtcdpi7gWhAuL8ENj7zhgeQezzEXe9TSANE6bQoRA,2YH4vrU9deP8Cu6E8Hzf8GqKG1yVjv5pdz4FE7r5YKir,True,9379474,2344868,14584,7292,7292,4BnQKPLuE3DMTtxp8MjUBytgnhvxqq3ZTqZHTVZo4JJh,583396,3756977,-3173581,621
2022-01-10 09:19:42-05:00,3105,8E3K7vCHJ2xjdFofPRGLbMxrkm8UYEi926QmXPAFwsqe,4qHUDA1c43Dg4qi1ZPKqmpGYiEMUZ6r4UuzB5ftHCEhW,True,1842473863,460618465,2880205,1440102,1440103,4BnQKPLuE3DMTtxp8MjUBytgnhvxqq3ZTqZHTVZo4JJh,115208200,941771178,-826562978,625
2022-01-10 09:19:42-05:00,3106,2NHv3c4ufYGo3xNr6KXymAZJdpfURrNiCKbXZ7s82Vwo,E4NYpYgHTvSG6LqH2bBV9Q1XJ6pAzCp9FLSKMzJmYRrQ,True,35440021,8860005,54914,27457,27457,4BnQKPLuE3DMTtxp8MjUBytgnhvxqq3ZTqZHTVZo4JJh,2196579,18453867,-16257288,619
2022-01-10 09:19:43-05:00,3107,75ycx5sUFBxDhY1uwuPCW22s2C6BydkJTje7q7zEQFGT,FpEgrVFRubjGK4DRjTqdVbxSECURpn16zfpoC31NbwnN,True,8735757,2183939,13575,6787,6788,4BnQKPLuE3DMTtxp8MjUBytgnhvxqq3ZTqZHTVZo4JJh,543029,4462252,-3919223,621
2022-01-10 09:19:45-05:00,3108,J3ggP7ZxL8HRh3CBp5iYG2WgjLyNSAWYT46uC9VYDLCz,2FqTRiRPiLvdAH2BS5vroVntpsSXvTJEn5UHWmtKHzh9,True,38170428,9542607,59315,29657,29658,4BnQKPLuE3DMTtxp8MjUBytgnhvxqq3ZTqZHTVZo4JJh,2372629,12076317,-9703688,621
2022-01-10 09:19:56-05:00,3109,gMjmD7WioyUdQdwNqE5fobLcxPwoJv5rAvLmJaf8Jjw,5n77euFjVJiwKrnbYq1KpcENW1mzBZj2BuDGyzazrkJ8,True,1580933,395232,2461,1230,1231,72FwbpFGoLEazJEdpqNtPNefsadUrimUqma9wSoy4qiS,98467,650297,-551830,622
2022-01-10 09:19:59-05:00,3110,399591e8XgY52yCMorCQ2WL6dQZTC485ZooHtmGuirhZ,JCiXAooFmKmEPQ2S7C8iSk6CLcTyrPEe1SsPSLyUGySe,True,1389489,347372,2151,1075,1076,72FwbpFGoLEazJEdpqNtPNefsadUrimUqma9wSoy4qiS,86048,798729,-712681,619
2022-01-10 09:20:00-05:00,3111,4uygLJDk9DFCifJ56YwMrEsvd3oQNq8tYSLnMCyWorS6,GimL4uKGvg3FFmFQSWzAcjstv3Vmk5NMgDGMKTuXYVpB,True,673255856,168313964,1041737,520868,520869,4BnQKPLuE3DMTtxp8MjUBytgnhvxqq3ZTqZHTVZo4JJh,41669492,276843720,-235174228,618
2022-01-10 09:20:00-05:00,3112,8kJu5aqVSmW8FSZR9h6F75ftn9V2U9uMLBEKeqRaC855,FhVHByujkvwwtjTVpZ4mqSUqoMoBgeLUc5H7rbz3FgAt,True,114723165,28680791,178871,89435,89436,4BnQKPLuE3DMTtxp8MjUBytgnhvxqq3ZTqZHTVZo4JJh,7154854,65986236,-58831382,623
2022-01-10 09:20:01-05:00,3113,A4tDE948CPFPh1UwHb8sXryfKktbxZ8BCkqXgA5DJHA8,3zXeKMrsEpCe5fQumLNzCgpxcG1kLJFEAtJuqxLsC6ZG,True,112458506,28114626,174152,87076,87076,4BnQKPLuE3DMTtxp8MjUBytgnhvxqq3ZTqZHTVZo4JJh,6966113,49452101,-42485988,619
2022-01-10 09:20:01-05:00,3114,9WJBnVi84E926j7xEd566WzrZJkPJWRgmEnYj9vyjuad,4dLaFS5F7TGyLdwuJLMGkz3bSL53aHzd9ZfpNmhHxXeF,True,19915649,4978912,30087,15043,15044,4BnQKPLuE3DMTtxp8MjUBytgnhvxqq3ZTqZHTVZo4JJh,1203499,10078850,-8875351,604
2022-01-10 09:20:05-05:00,3115,96DzqyUxsB1FKWrhLdTdjDcokuus6rbx83gLsghqPPwt,74CWb7SVoSy3ADysEzFEeMiS2fxHJ9gdUF9pzM3E52Gj,True,26518,6629,41,20,21,4BnQKPLuE3DMTtxp8MjUBytgnhvxqq3ZTqZHTVZo4JJh,1652,10536,-8884,622
2022-01-10 09:20:05-05:00,3116,JCBhqqPQxP1Xc41sSY6e1sQKRstHhe7D1v6rLz4hp3Qp,DWMUq2bMD1jqpxHtyXDFjcAwjA27yyMRe68hGcsK143m,True,9546,2386,14,7,7,3zqXX6kzhkbW3d4TwD2CNjMRwxTbREXySekvq37kfCNk,596,3797,-3201,624
2022-01-10 09:20:05-05:00,3117,D9VKhnfLLCrntDGFYSfoxFaY76VnHmYZ1ZbyFXdKdibz,2hRCRH2pMDyQGYcXHa8Y6BZo6FbcGZf5VJC1v8Bp6tGa,True,119375111,29843777,185454,92727,92727,3zqXX6kzhkbW3d4TwD2CNjMRwxTbREXySekvq37kfCNk,7418184,45118128,-37699944,621
2022-01-10 09:20:05-05:00,3118,9YEzjb49Awvedv9yNc6LG54SkGBug2RYiJwiUV13mGsS,3H8w5WCD187NWWoZMNUCzUDdxTgqrRJLga8gDzUVXBgZ,True,1502461,375615,2350,1175,1175,4BnQKPLuE3DMTtxp8MjUBytgnhvxqq3ZTqZHTVZo4JJh,94012,881322,-787310,625
2022-01-10 09:20:05-05:00,3119,2rCRdyfi65rpxRRmg7knaSb8t55FuPt3h8wF4Fzhy8MM,CLVY5nSG3jTdRo7tRSKgK9DJgW6aswfWKe4tLxzsENmb,True,862632,215658,1337,668,669,3zqXX6kzhkbW3d4TwD2CNjMRwxTbREXySekvq37kfCNk,53519,308595,-255076,620
2022-01-10 09:20:05-05:00,3120,Ar5QB4VBcUyzSCG23z2QNAbrWY55NbHCr1MNN6P2GAmh,BusFGTiDrJmxzwGUxWz9b3SFF3eseqtgh2DRHqyAwyVe,True,633314,158328,979,489,490,DddJ7EWCmYEEZETCBNgAUSg81Ls6fZtiAaY5ekJ5sXx1,39171,268569,-229398,618
2022-01-10 09:20:06-05:00,3121,HutRztBianNUgm9sJDWKUQBmoVyy8y7CfnNk4hHjSkEW,EtVfvPyiy5bizbCZxR19TNUgETf3QcmziBvMtc6o5zjr,True,337545178,84386294,525068,262534,262534,4BnQKPLuE3DMTtxp8MjUBytgnhvxqq3ZTqZHTVZo4JJh,21002737,277748869,-256746132,622
2022-01-10 09:20:06-05:00,3122,GaEpNGa8jnwSRvjzzEMYkZe1pKcr2eiZtePrqFxpABjB,5CFZHuyWbJv14zPdX5dSQDREgHrCb4vsFvB6hLiEe3Ji,True,208560,52140,322,161,161,4BnQKPLuE3DMTtxp8MjUBytgnhvxqq3ZTqZHTVZo4JJh,12912,84672,-71760,619
2022-01-10 09:20:06-05:00,3123,GJ3PbEfPK8jjrPgMmZtvN5fMSSy2dtiiAtZ8wcfgxVuc,FCUDVFb2TjDvehHE8fVBofqSykpb9W6Afc9QeHtj7te7,True,105144196,26286049,162609,81304,81305,3zqXX6kzhkbW3d4TwD2CNjMRwxTbREXySekvq37kfCNk,6504366,56952159,-50447793,618
2022-01-10 09:20:08-05:00,3124,D3mXrJzhHf8qRaoCKLschUxAFoijFCFuT6bmNZH4W7Cj,9E3Xtqw7TncXWnbhAbFJMtuNmP6WS3ooGuptzyzw7UpA,True,79220,19805,123,61,62,4BnQKPLuE3DMTtxp8MjUBytgnhvxqq3ZTqZHTVZo4JJh,4923,43295,-38372,621
2022-01-10 09:20:09-05:00,3125,89CkXnSZnr52Zsoh48efv9MQacrkB6GMtrbEpNJSyA2H,HcvRBS4Z22CpYgDNgm4TVF4AVXFDuYzBUAFcdHAwdpg4,True,4101081,1025270,6270,3135,3135,3zqXX6kzhkbW3d4TwD2CNjMRwxTbREXySekvq37kfCNk,250835,1649454,-1398619,611
2022-01-10 09:20:13-05:00,3126,6XHt7CrURSomkQrtVXV5JuKSZY4tQRpUyQKfCDaSTYaD,GCgcmPSDDBsn2smYbpiX3PJybDkQWtufPu4YRsbEEU8X,True,461883096,115470774,719680,359840,359840,4BnQKPLuE3DMTtxp8MjUBytgnhvxqq3ZTqZHTVZo4JJh,28787223,276720581,-247933358,623
2022-01-10 09:20:13-05:00,3127,9jdfc9GFTecsdRuTjWFGX13niKKmeBxRgtv5j86uhSnU,HLWMShobjSkaLyXrNjgwVaUGVtbtdUSnr1XjqpXn1bLR,True,400946,100236,619,309,310,DddJ7EWCmYEEZETCBNgAUSg81Ls6fZtiAaY5ekJ5sXx1,24781,179894,-155113,618
2022-01-10 09:20:14-05:00,3128,8vva9SmKpMGW8wjpkvydQczxVK6VtN79qzH2i4JQSwg4,F8a3GLicsSapt4aLURoU4qHxJaxCij4LS6JVxoMF3YHT,True,1313550,328387,2016,1008,1008,4BnQKPLuE3DMTtxp8MjUBytgnhvxqq3ZTqZHTVZo4JJh,80671,357593,-276922,614
2022-01-10 09:20:15-05:00,3129,4MmpDGUTyMcYEqJ1RoZ46AN2BhrBUseHaHqF8AmiTPyD,7HW2YZpYM349HMfW7u4h9ESZ1AXkwN8JcVDTNFzp9aTz,True,164328918,41082229,254290,127145,127145,4BnQKPLuE3DMTtxp8MjUBytgnhvxqq3ZTqZHTVZo4JJh,10171622,83537574,-73365952,618
2022-01-10 09:20:19-05:00,3130,KoCscQ9Q8TZHhmya5KaXBrwUEMTdCkEMRtrhvtgEmiZ,6aZ5AFMFoqf1X64RwAt1J4Yrx4WGGe2JMiEjqnQ2gEtk,True,645518,161379,1002,501,501,4BnQKPLuE3DMTtxp8MjUBytgnhvxqq3ZTqZHTVZo4JJh,40083,144566,-104483,620
2022-01-10 09:20:19-05:00,3131,2NdwSLxsGok8PczpCZj9CVX2BymNU5MvHt7hWfGetg2M,8AQbDXeA6mD9QoZBFJcYbnHvZwKNxzA9CCHLAgdSfTA3,True,14583,3645,22,11,11,DddJ7EWCmYEEZETCBNgAUSg81Ls6fZtiAaY5ekJ5sXx1,907,7441,-6534,621
2022-01-10 09:20:21-05:00,3132,BzSJ77zKaqtBk2cEL1XqFL97zTXXMRHmxtkgtXwCc3C,2g4KXTwy2MPSRQ2khNp1o1rn7CradEr9H4ySYKDoSWN9,True,13827451,3456862,21448,10724,10724,3zqXX6kzhkbW3d4TwD2CNjMRwxTbREXySekvq37kfCNk,857951,12886932,-12028981,620
2022-01-10 09:20:21-05:00,3133,6WNPf4rFCX74PuyvdmzRFqbxWhguuxTQqBSdnaTVBd5D,9N7a9aiHGQsxFMgVbmWoCF9w95d12xyT7XFAwpHGkTLA,True,2061540,515385,3223,1611,1612,3zqXX6kzhkbW3d4TwD2CNjMRwxTbREXySekvq37kfCNk,128933,556458,-427525,625
2022-01-10 09:20:23-05:00,3134,EQUZQWk4WLT6LFeWZs3P9AQufFcoZouFETfhyxvuS2JM,Byc2mLXArmkjQPWaxCJksHZD2XpZyCQ2FRtDJyztU81V,True,130100928,32525232,201636,100818,100818,3zqXX6kzhkbW3d4TwD2CNjMRwxTbREXySekvq37kfCNk,8065457,71290503,-63225046,619
2022-01-10 09:20:25-05:00,3135,EV21gv8jEvXtmGDoGRNm5LJEvTBccLMZyVDCLsp54jP3,DGxxoU52aQNoUQcxdvQtv2H5q2PhK6TGkLgNSaFgnZrb,True,6106579,1526644,9458,4729,4729,3zqXX6kzhkbW3d4TwD2CNjMRwxTbREXySekvq37kfCNk,378356,2578967,-2200611,619
2022-01-10 09:20:25-05:00,3136,8BMDSWFtzq9fu1ubVGtSFw8fEaMg1uvJiECuJnN8e1pd,FwkETAXL296CirvQ2AJuSHHtdKsxkZkmXSwZVVHXVDhA,True,178179763,44544940,275776,137888,137888,72FwbpFGoLEazJEdpqNtPNefsadUrimUqma9wSoy4qiS,11031077,70159289,-59128212,619
2022-01-10 09:20:25-05:00,3137,AtKuDfcFXqWUMnRqQpjedUMTb5CQKLc2zoqEAcQpysKQ,9bPFLYp5TDZruLLDXDYYCiPYcD982iF8xt5rfTkqwNsL,True,15236,3809,23,11,12,3zqXX6kzhkbW3d4TwD2CNjMRwxTbREXySekvq37kfCNk,948,5939,-4991,622
2022-01-10 09:20:26-05:00,3138,8aKqLY7GXxNnGRK8Utke7o6EDGZATNDDF8Ph9Q27ppyi,7MQKkebLEzQgjWjByBMzzkn68yqtYivS4VDcraAScZR6,True,1359524,339880,2077,1038,1039,4BnQKPLuE3DMTtxp8MjUBytgnhvxqq3ZTqZHTVZo4JJh,83112,393253,-310141,611
2022-01-10 09:20:27-05:00,3139,EeUACm9TkjHKES5U7Yj1oPhYmcp7R3tvesGBiP8txEzq,3qkmm4aS6EDirEDejmbm5PDw2jpYkC7zKqrMkmgeE5BA,True,316244,79061,490,245,245,3zqXX6kzhkbW3d4TwD2CNjMRwxTbREXySekvq37kfCNk,19629,109319,-89690,620
2022-01-10 09:20:38-05:00,3140,7LRBswSEDBjJzQ4YurfTxLydh7tFS2jVn5V95Z6wL7ci,fD41VYGmk66MW46KKb23vAqQvUSDScgXnVdsHhJBZzu,True,161075,40268,248,124,124,4BnQKPLuE3DMTtxp8MjUBytgnhvxqq3ZTqZHTVZo4JJh,9924,76923,-66999,616
2022-01-10 09:20:38-05:00,3141,s2NgHqXLYtUrRaA6LnDwmxcS5nqfURXw47DmLy7Pn9E,2qn4QbLj5miEB2zZB4v5dhptm3JRbpQRrpTBgPDzokw1,True,2887007,721751,4437,2218,2219,3zqXX6kzhkbW3d4TwD2CNjMRwxTbREXySekvq37kfCNk,177501,2099387,-1921886,614
2022-01-10 09:20:38-05:00,3142,99NHcwD1iaf5FXM3UNb91SjNiiT3HwyQFQMhkGd5ASts,8syAydy52vSQQLzsLXW24BFw4VPeK66Vp3BmAbnHfgod,True,67651892,16912973,104440,52220,52220,DddJ7EWCmYEEZETCBNgAUSg81Ls6fZtiAaY5ekJ5sXx1,4177602,28926564,-24748962,617
2022-01-10 09:20:38-05:00,3143,CAkknoa9UFPMEZ1KWSfqtmnL7ArVNV3HRETLwecuuXP,4cHJYv3dxA6qjcuxUkGRuL7STWobGPKtoHFD4ACUbiWq,True,14314013,3578503,22069,11034,11035,3zqXX6kzhkbW3d4TwD2CNjMRwxTbREXySekvq37kfCNk,882762,5699557,-4816795,616
2022-01-10 09:20:42-05:00,3144,8VT2nxz5ZYDJFd9uL2XZwEXxChd9pjuMJNMAcutZubL1,EhAkiRbouzUAWtqQFsN8HEEfi46UVN8H8tyBP7CbgeLe,True,12542,3135,19,9,10,4BnQKPLuE3DMTtxp8MjUBytgnhvxqq3ZTqZHTVZo4JJh,769,5775,-5006,613
2022-01-10 09:20:42-05:00,3145,243SAnGxchCVB1LQAUF4SsozR86yDwEdg2QQpbWGsMYe,5u8sNkb2oEQjUXJAB3yGStmv3Uwz16gBgExBo5myVK4b,True,13697793,3424448,21273,10636,10637,4BnQKPLuE3DMTtxp8MjUBytgnhvxqq3ZTqZHTVZo4JJh,850945,4956035,-4105090,621
2022-01-10 09:20:42-05:00,3146,FSduW743jAGyyn8HTifEJitgb89Spp5gEeMXDE59aEHF,HjojGNpR3ACtLCP2mP8DKGyXj6SeqWPKjcCAofcyQpsm,True,252584814,63146203,389096,194548,194548,3zqXX6kzhkbW3d4TwD2CNjMRwxTbREXySekvq37kfCNk,15563864,90560497,-74996633,616
2022-01-10 09:20:42-05:00,3147,Mcbzp1LhZwpfmXTv1pqe9D1jCKHw443j9QKp6tUpzgM,8uforSMAKEih5jHfHp3gCqCvaugtCmhzVfVHA63Akz7F,True,2727267,681816,4183,2091,2092,3zqXX6kzhkbW3d4TwD2CNjMRwxTbREXySekvq37kfCNk,167343,1399237,-1231894,613
2022-01-10 09:20:42-05:00,3148,aTkGURJptmKNNP6RSXSWsmVbfcriSAJaMuUiT2eZEfb,5qoGxL83PLhrguyk27X8xE6jGitRg5BaQpXzrcfEvCfJ,True,264884253,66221063,410062,205031,205031,3zqXX6kzhkbW3d4TwD2CNjMRwxTbREXySekvq37kfCNk,16402511,91532879,-75130368,619
2022-01-10 09:20:48-05:00,3149,2RZPBo8Z2BgZmsASo14ySTSwqqgqmfVEjPkiAwQ1VTgf,BRS5cYtEoPRoSvTAiQaT1svWRdLJWVfy8LUb4SCudCjS,True,6695739,1673934,10403,5201,5202,3zqXX6kzhkbW3d4TwD2CNjMRwxTbREXySekvq37kfCNk,416129,2702182,-2286053,621
2022-01-10 09:20:52-05:00,3150,C7a8BtMjuLXkzxZBC4Wk2gjkGBmucLmDjokf9pyA1Mu6,GxwYNWwYTtFMUxuZvNC5qrEYuJzYiEURQVuBxssfCJzr,True,2095638,523909,3251,1625,1626,72FwbpFGoLEazJEdpqNtPNefsadUrimUqma9wSoy4qiS,130051,565666,-435615,620
2022-01-10 09:20:59-05:00,3151,CEbGTNX6WpaoKp4RBGSn9LzYM6yAYyeiMrgVYgJxA4zb,AiXUcGAFFm4tc7vKBscSNjZawV5YJqbv7D1KpxD3Zufg,True,24963030,6240757,38866,19433,19433,4BnQKPLuE3DMTtxp8MjUBytgnhvxqq3ZTqZHTVZo4JJh,1554647,13447728,-11893081,622
2022-01-10 09:21:00-05:00,3152,FnAT8HKGgisYfeAbxKU2gSbCp8KbZHULRpaJX1NVijHy,2u637Crc2QzfSJmCnRNqeib3aZQVn4NGncpgM3Ph6jvm,True,44497370,11124342,69517,34758,34759,4BnQKPLuE3DMTtxp8MjUBytgnhvxqq3ZTqZHTVZo4JJh,2780694,14813246,-12032552,624
2022-01-10 09:21:00-05:00,3153,ZoNjrSjYh4NJLW38LUPcf7jtEBxdaaM7T1zp795qjHE,FZx6v8cU25NwEosbKJ2n141o9uFAWURZB7NeCeX1trEn,True,1922284,480571,2963,1481,1482,4BnQKPLuE3DMTtxp8MjUBytgnhvxqq3ZTqZHTVZo4JJh,118542,516573,-398031,616
2022-01-10 09:21:00-05:00,3154,3axqGcX5yuJ2vGxRjtNguefXUvSQHDQmn2zskhyCuQkf,EYrZo9zZDaHqFdc1fam63W3jvqqmbU67wzp6yFcppwsL,True,36720197,9180049,56447,28223,28224,3zqXX6kzhkbW3d4TwD2CNjMRwxTbREXySekvq37kfCNk,2257904,29531243,-27273339,614
2022-01-10 09:21:00-05:00,3155,5hUZ9uQFcYnjAQVVaGLJWdKyg7y1XMpoo8osQ9DeY7Xd,BdYiKWsjuzJLcHh3814mJ4xQ9JxoQKKcr7AHZ7Vxoavq,True,55380,13845,85,42,43,72FwbpFGoLEazJEdpqNtPNefsadUrimUqma9wSoy4qiS,3408,23105,-19697,615
2022-01-10 09:21:01-05:00,3156,4hrm69kAKNcfBkiP2YgtW94Pbip6FLfQAwnDRAAack69,BjbZRdGMoC7Mfoa4H19UvE2eQafgKD5rqnK7BSGwqS1s,True,46294,11573,71,35,36,4BnQKPLuE3DMTtxp8MjUBytgnhvxqq3ZTqZHTVZo4JJh,2843,18983,-16140,614
2022-01-10 09:21:05-05:00,3157,BJaaH1SK1pF2kZQzmYpLFfDtm52CR9a5rd39RAPtLe8q,HUsT5FVxaisdnCvG1BQxX6zffjfL2Rwx5mMo5y8SDV7e,True,50577261,12644314,78757,39378,39379,4BnQKPLuE3DMTtxp8MjUBytgnhvxqq3ZTqZHTVZo4JJh,3150296,14817935,-11667639,622
2022-01-10 09:21:06-05:00,3158,DiPSJvnnEwg1En7HJfEsKrUbBgtUf4KzGMyMCZDQSYgp,s8UVC6vPBofuXUS6RW1aQmZ8C35PrC5r4A6ugmvzLGB,True,2447926,611981,3820,1910,1910,DddJ7EWCmYEEZETCBNgAUSg81Ls6fZtiAaY5ekJ5sXx1,152812,658015,-505203,624
2022-01-10 09:21:08-05:00,3159,Buioe5v3DyFwD9nquW5XdYeVYbSABCyg79eUHEvtvfaW,7T9gi7prCcZJkYJMSB5Ef6Bu4pAuBw4XLvumSFnqKDSi,True,889594,222398,1362,681,681,4BnQKPLuE3DMTtxp8MjUBytgnhvxqq3ZTqZHTVZo4JJh,54505,481657,-427152,612
2022-01-10 09:21:09-05:00,3160,DiB9SeCFXjioNGPJM3GuZ3FCG9KBZhHK27zCSN5b6gkq,GtK8UtKDQy9jgtTXvam4jja9N7c4EFuDQr4TKHgNyhXT,True,5523741,1380935,8467,4233,4234,HfEnetJ7uBSmZWCjBNxdvv9HEC5nsW4wDV7wu6WnhWan,338694,2466306,-2127612,613
2022-01-10 09:21:09-05:00,3161,3zH1b58jqbNU37y9kDTZZrotSeT8XzS1tuyAHPKWrbah,4trxDWV16x6sVcz7bxHehYHkjjyKebh3S9fyJf8txzK5,True,9519,2379,14,7,7,3zqXX6kzhkbW3d4TwD2CNjMRwxTbREXySekvq37kfCNk,589,3753,-3164,618
2022-01-10 09:21:09-05:00,3162,J1sBDjpdBZcsSBS5eg95SSRjRqmQUR9cXJCsLJu8yCUt,F5wRpD2senMkGbL8Uquqo8W9x5NQDDa268dHuVFAZCww,True,4572679,1143169,7134,3567,3567,3zqXX6kzhkbW3d4TwD2CNjMRwxTbREXySekvq37kfCNk,285368,2130343,-1844975,624
2022-01-10 09:21:11-05:00,3163,93ho4cgnpAJiJsG6uu2udkLVNU7rkz4QjCYfsqvpbPA5,45ouQn9gGwXqnTGfaP5CvU8fCKadBRA5kPwtfvJzykRU,True,79790767,19947691,124535,62267,62268,4BnQKPLuE3DMTtxp8MjUBytgnhvxqq3ZTqZHTVZo4JJh,4981416,27659694,-22678278,624
2022-01-10 09:21:11-05:00,3164,C4dbwF9mioaBkZnyBFvFs6Cqd362VuGPBGPbTY9CAnAk,CcUqBfu1hbWm5VVxbtF2Xm6HUz4CLFzuDsjUi6KtnZQg,True,2236199,559049,3427,1713,1714,4BnQKPLuE3DMTtxp8MjUBytgnhvxqq3ZTqZHTVZo4JJh,137118,600922,-463804,613
2022-01-10 09:21:11-05:00,3165,2ce2v2TCbjNH635NgbwTG3sqiRWYrRRaBpxPxBZJ929q,9cnoebT43FkWDFhidndGCVNiFD4NErv8DuL1Va4Jv9S8,True,7566295,1891573,11749,5874,5875,DddJ7EWCmYEEZETCBNgAUSg81Ls6fZtiAaY5ekJ5sXx1,469975,5701193,-5231218,621
2022-01-10 09:21:11-05:00,3166,FjDp4bWCtqehFD7FunCrjrcdxMezTJj5aqh2VnBvHDQU,HRYeZqcqhP1RPiAGXziR1qCWwk4sF6c5ZYbvSDhX7foN,True,10085218,2521304,15492,7746,7746,3zqXX6kzhkbW3d4TwD2CNjMRwxTbREXySekvq37kfCNk,619719,3881591,-3261872,614
2022-01-10 09:21:13-05:00,3167,9gYrMXAGmGSV4VFjXzYP5WwH2aFpB1TxA6CqpYsosKLv,Dh8aH6RK48wu4fkT9xKw5XL7itxnPDuw3SDwPwvL5sva,True,33301,8325,51,25,26,4BnQKPLuE3DMTtxp8MjUBytgnhvxqq3ZTqZHTVZo4JJh,2077,13374,-11297,623
2022-01-10 09:21:13-05:00,3168,4FazDUgfQ3AKoFcnWHr8E9Ht8jLA3tkxf75yrGZVHdmF,HzRMH6mbgEKydRCnnMvSsKgTEVNQi6nuzoR1xutYFdzg,True,77085,19271,120,60,60,4BnQKPLuE3DMTtxp8MjUBytgnhvxqq3ZTqZHTVZo4JJh,4808,54338,-49530,623
2022-01-10 09:21:13-05:00,3169,3g1debT8Z2efQPuMNSDPUNZzDqarBG2acErsZ4HP7QGA,42wDHagxr5Nno3mUx6kyYGDjwR98aedRbh3ByB468agB,True,23787,5946,37,18,19,4BnQKPLuE3DMTtxp8MjUBytgnhvxqq3ZTqZHTVZo4JJh,1485,9607,-8122,624
2022-01-10 09:21:13-05:00,3170,8mbMH9EKd9kQDyFrYiDJCV9VaWxWCzpZBQZLyYN2yNVx,J9gT39dF1egMeQvweXYWeRAX3kpmBABijYZhfj6M2UqU,True,30671477,7667869,47035,23517,23518,4BnQKPLuE3DMTtxp8MjUBytgnhvxqq3ZTqZHTVZo4JJh,1881403,10360596,-8479193,613
2022-01-10 09:21:16-05:00,3171,5BjBPqumCb9KC82ZNNch3dcRzbpGdRLJneru7o9a1D9R,FuZtBWKktxFu4yoiLVMzxq8fMhQyN8SGzGPz49xs3m6P,True,185274989,46318747,286923,143461,143462,DddJ7EWCmYEEZETCBNgAUSg81Ls6fZtiAaY5ekJ5sXx1,11476954,89336054,-77859100,619
2022-01-10 09:21:16-05:00,3172,EgU9hX6VK7YXeCgCHVaJAMekCcyZa2MVWdKra5pN7Gwv,7y8Ad9XY34bqREvheXHT2tr8Jy11D6X3pu7yLVtjU4QV,True,12455722,3113930,19189,9594,9595,3zqXX6kzhkbW3d4TwD2CNjMRwxTbREXySekvq37kfCNk,767578,6011379,-5243801,616
2022-01-10 09:21:18-05:00,3173,9KD2AifD5wFD4QkHYuawXbJgLWHrfj2QPF3fT8jhGVA5,Ga9gAqmkuHbqrr31sUFPqa1xa5WNxLWJWGPUaMxQqLdj,True,1262920,315730,1976,988,988,4BnQKPLuE3DMTtxp8MjUBytgnhvxqq3ZTqZHTVZo4JJh,79050,737542,-658492,625
2022-01-10 09:21:18-05:00,3174,7MSzV5yy5FmrM4j1BcYSRiTGWfit1AJahheRUaXzz349,aPSTZLxBpVr3sucjbj95emRV2J1GrUWr7wbARYqJkQZ,True,5599377,1399844,8731,4365,4366,3zqXX6kzhkbW3d4TwD2CNjMRwxTbREXySekvq37kfCNk,349262,1878527,-1529265,623
2022-01-10 09:21:19-05:00,3175,H6tDNj9cHac223ckAnNfnC4bAJuNLBnf2pFk2iQdMzMP,28UL9dqgayCqCAexScXjdpobYGVDN44SGBVNAfBByk8C,True,84130748,21032687,131099,65549,65550,3zqXX6kzhkbW3d4TwD2CNjMRwxTbREXySekvq37kfCNk,5243970,46168886,-40924916,623
2022-01-10 09:21:19-05:00,3176,87R8o8xLjHw2GpunYkm7pX7uJ8hjM4B1y4Qm7aQf6Yh4,48aSVPQoFYdncF5NtJ114urbdTzVjTgYLgPzMfpJbZB3,True,80368493,20092123,125374,62687,62687,3zqXX6kzhkbW3d4TwD2CNjMRwxTbREXySekvq37kfCNk,5014969,73145868,-68130899,623
2022-01-10 09:21:22-05:00,3177,EEcTbsFTUEifcdbPyjBLkS943daEx1RpR8F3uZxKRZbT,8V3JzDQ1VWYQLas8fxUsWJZZHe4gEmn74RehtUwLw3k5,True,6730360,1682590,10351,5175,5176,4BnQKPLuE3DMTtxp8MjUBytgnhvxqq3ZTqZHTVZo4JJh,414071,3222898,-2808827,615
2022-01-10 09:21:45-05:00,3178,HwosLQgDY1xtHQRQ4hzroPQHFWssPzTj5vRkP37FcviB,HKTNEYNXrephNkH7apbobK4mcQXcNayQA4W1NgM6sLr8,True,43681836,10920458,67465,33732,33733,3zqXX6kzhkbW3d4TwD2CNjMRwxTbREXySekvq37kfCNk,2698634,14307898,-11609264,617
2022-01-10 09:21:46-05:00,3179,FsMiJiJZibohKoV5QRisWCjzuFd86xSxFb4m73AQmu93,7p3TSKBaG9SV2YNDnhutQKacPKpTTmgsEfzmK51t6sYb,True,270434451,67608612,417773,208886,208887,3zqXX6kzhkbW3d4TwD2CNjMRwxTbREXySekvq37kfCNk,16710956,90397999,-73687043,617
2022-01-10 09:21:47-05:00,3180,AUH6YGBV8tDVX1E1WTo92Mubfx1DGsqfGeyUBqxo4fSr,33QZgMwmW32WuvmxD8XNbmF9ea88bLe3YTtNwHV73Wwu,True,270588742,67647185,417469,208734,208735,4BnQKPLuE3DMTtxp8MjUBytgnhvxqq3ZTqZHTVZo4JJh,16698791,92597960,-75899169,617
2022-01-10 09:21:48-05:00,3181,3VdSA9CED9f5swRwHX2U15U7J6Muaq8VPnCNy9CaGDHe,2YYstfnfdYic5NWmEbcUEHpccNUVd1EhuCkExvMsoMk8,True,6495041,1623760,10105,5052,5053,3zqXX6kzhkbW3d4TwD2CNjMRwxTbREXySekvq37kfCNk,404228,3757704,-3353476,622
2022-01-10 09:21:48-05:00,3182,6d6HN8LWikwW2HYdy3BABWuxKHt1sgv4DcneACR133sE,4eKvzmfFvX96XbujKBhUauAvWP4yQYwZH3pd7gXzbCvJ,True,2096647,524161,3269,1634,1635,3zqXX6kzhkbW3d4TwD2CNjMRwxTbREXySekvq37kfCNk,130787,565393,-434606,623
2022-01-10 09:21:51-05:00,3183,E9FFPvygPSF22u7gqFq4w6yE5kV15zbeGDXFQc349RsG,yi1REPVUwKhr5ss5YJc56crYz8LVfkqNVMpKcdSfwfY,True,2098877,524719,3250,1625,1625,3zqXX6kzhkbW3d4TwD2CNjMRwxTbREXySekvq37kfCNk,130020,562396,-432376,619
2022-01-10 09:21:54-05:00,3184,A36aouot1oFLUtswuBUM4EVcis9chKaSJu53MRoPDjab,33U9gpq1RRFMGWDrWa3ezXXkwgBewdAS6QGgGVPtGvqb,True,348910278,87227569,543971,271985,271986,3zqXX6kzhkbW3d4TwD2CNjMRwxTbREXySekvq37kfCNk,21758865,115881801,-94122936,623
2022-01-10 09:22:00-05:00,3185,ECuu1L4QGdemZ7FjAjVAAxYN6piinweY7Fuk5csVovfT,Amd8WGcpdtB8yoA83R1BUT5uryuqoKbcBexYacbrbGVX,True,3835127,958781,5961,2980,2981,72FwbpFGoLEazJEdpqNtPNefsadUrimUqma9wSoy4qiS,238476,1389987,-1151511,621
2022-01-10 09:22:03-05:00,3186,4mB2DVbQVqVk535v98Cj8SPNg1tTc3DFyY2Q7VBbY645,HXo255k3RgsTGsc4hiP6ZTXUspBTqJ37duQa5eK7tqp3,True,657813404,164453350,1025207,512603,512604,4BnQKPLuE3DMTtxp8MjUBytgnhvxqq3ZTqZHTVZo4JJh,41008313,238840258,-197831945,623
2022-01-10 09:22:06-05:00,3187,5kwvkEtRFFD84j4ntVgxkacadgJaFvQ9JLhJqzLR7Y3G,GpMMkTv9T7y8DTiizuoJUsWvnSk3GSxADjRMGyYpryxm,True,30398633,7599658,46881,23440,23441,3zqXX6kzhkbW3d4TwD2CNjMRwxTbREXySekvq37kfCNk,1875247,9713563,-7838316,616
2022-01-10 09:22:08-05:00,3188,5Rxuqgs4CaSKbfDXqBMFXkLTQ9dxrUjThXzoy3ouYVtK,BgvbKru66ebrGUcFFymGTmsaQv6GgcGMybiWaXqzBtwX,True,200196,50049,310,155,155,4BnQKPLuE3DMTtxp8MjUBytgnhvxqq3ZTqZHTVZo4JJh,12426,122395,-109969,620
2022-01-10 09:22:08-05:00,3189,7W6ih2ZGXaE6tvuQFUPCvc7NvEJHy7UffgoVX3ZPdLXt,6uQCkeMjEXHBQxE2HD33RM1zyTsSko1fYZA1mWUggJ5B,True,32283,8070,50,25,25,4BnQKPLuE3DMTtxp8MjUBytgnhvxqq3ZTqZHTVZo4JJh,2018,13490,-11472,625
2022-01-10 09:22:09-05:00,3190,FLTW9fwjWqGPm5PiE3C9LFzwZxtDh8c2MnEoRq8W7MfQ,GKsfzKBP2QkmoEWvTaUN1h4nqrT3kAcwYRC9WxW9bB3h,True,15478321,3869580,24186,12093,12093,3zqXX6kzhkbW3d4TwD2CNjMRwxTbREXySekvq37kfCNk,967457,5262147,-4294690,625
2022-01-10 09:22:16-05:00,3191,BPRoaqrDs8vhqv2T7d9qV2oPU33pi1K1LUaotM7yuD2i,6qo8uQGAEwBfYQR36v6nRiqA2xGV6SjJAsXsdzy5bqNH,True,1300123604,325030901,2020464,1010232,1010232,3zqXX6kzhkbW3d4TwD2CNjMRwxTbREXySekvq37kfCNk,80818580,580722624,-499904044,621
2022-01-10 09:22:17-05:00,3192,3ogBPSRcKfmwzgumVDHBkXLi1eCsEFG2xzSJgD4LQDNy,7TXyqWgJqfe71MSWFA2n7ufZbUdzf7JJoWej8FNNtMXo,True,20289167,5072291,31562,15781,15781,4BnQKPLuE3DMTtxp8MjUBytgnhvxqq3ZTqZHTVZo4JJh,1262496,7963123,-6700627,622
2022-01-10 09:22:18-05:00,3193,8trkirSQNdMmAcJdeswxs5cPjH8dD6U4eJtWiAdMsrDB,HaSzpQ45x2MipfN17U6jGBxX8tXboomVDhXNSrnEfLDr,True,4293593,1073398,6631,3315,3316,4BnQKPLuE3DMTtxp8MjUBytgnhvxqq3ZTqZHTVZo4JJh,265247,1798924,-1533677,617
2022-01-10 09:22:21-05:00,3194,BxXXWywnC3dSyLPJHt7owfBhgSiBWzkuD3T8hGYLqCH6,4vuwEBXXbXFMPmbJJJRop4FCWGyKR1sXhBc3EWF6MiB8,True,119371707,29842926,183439,91719,91720,DddJ7EWCmYEEZETCBNgAUSg81Ls6fZtiAaY5ekJ5sXx1,7337563,66074651,-58737088,614
2022-01-10 09:22:25-05:00,3195,9LZ3rShLfzErXsGkh4dYfAm58GNPWhK6ohDy5RrLJhc,41tLyuvuJ5M7YctkSASD2R7RGGetD7FmKaZUdkTdgXgt,True,1812636,453159,2734,1367,1367,3zqXX6kzhkbW3d4TwD2CNjMRwxTbREXySekvq37kfCNk,109397,490514,-381117,603
2022-01-10 09:22:27-05:00,3196,4kbcrzH6o2LvLUCNphyL52i8uGzVD8wcUNEqoQ14z3VG,5Q1atmEBs2AqaDZsiZFG5stHzj1fE6ZvypgfkEc9LYqE,True,223290412,55822603,340196,170098,170098,4BnQKPLuE3DMTtxp8MjUBytgnhvxqq3ZTqZHTVZo4JJh,13607843,121994448,-108386605,609
2022-01-10 09:22:27-05:00,3197,2bikYf33ZxxDmvkMNjWDGGqEpbYJPvWv5At3hzyeLEQK,5FtirUBjRAZ3k5arFFVwKz42ixWzhkEBLkaK9PraRZ78,True,183459,45864,277,138,139,3zqXX6kzhkbW3d4TwD2CNjMRwxTbREXySekvq37kfCNk,11103,62579,-51476,605
2022-01-10 09:22:27-05:00,3198,2VyFcgZDH1HTEvD1XaWhwqBCMmZ1k6TmZ3fEpPcBZR9E,G1wFJETTpdoc7CfypGCzkq1jssXPfUkiuLjK2cwVZ9dJ,True,100347,25086,152,76,76,3zqXX6kzhkbW3d4TwD2CNjMRwxTbREXySekvq37kfCNk,6103,50386,-44283,608
2022-01-10 09:22:30-05:00,3199,CCHzYXr5zMXFu8MMZNkfUWGyUcF8xy7Vvhq7tNCtZg2L,AuEXkCJTTJ3HK8iP4qTWpQr4vp6HPRJZyZwfRjF8zjfp,True,183453,45863,278,139,139,3zqXX6kzhkbW3d4TwD2CNjMRwxTbREXySekvq37kfCNk,11133,62615,-51482,606
2022-01-10 09:22:30-05:00,3200,7g4NJBHwDTRm58GqX7Tz1JzqwbAhF6EWJUQH3SoDxSf7,82Ypv7STZeSCBPf3HckWdyatELpvaDaWxFXhD5dNSML4,True,29138,7284,43,21,22,3zqXX6kzhkbW3d4TwD2CNjMRwxTbREXySekvq37kfCNk,1759,11870,-10111,603
2022-01-10 09:22:31-05:00,3201,DJiXXW7sjNsAAxWupDKBUsFhXSgPoerVYaAtJqqNgVbn,2MsqvNuJw1xQhJ3UnXt9i7oNHDuZpR9w7iE1WQcGqt5m,True,183453,45863,278,139,139,3zqXX6kzhkbW3d4TwD2CNjMRwxTbREXySekvq37kfCNk,11125,62606,-51481,606
2022-01-10 09:22:32-05:00,3202,2p2fGXdKrmxjomLSnyaNg84J82cBBBNympZ6qQc8UZgU,HKAM8bazuLMUY6yapZJqYsgaWkTBqKHyMs1hSfpYsZGi,True,1016370845,254092711,1538155,769077,769078,3zqXX6kzhkbW3d4TwD2CNjMRwxTbREXySekvq37kfCNk,61526222,517489581,-455963359,605
2022-01-10 09:22:32-05:00,3203,2jDRvE3pQNjWy1NRFa4tzB3KmU5UkbUCHw8sQRFujo66,C4zNi2szDrEEh4coTF3WRUghfP4ZwAVVSYTLWfkejQRu,True,621763701,155440925,959420,479710,479710,3zqXX6kzhkbW3d4TwD2CNjMRwxTbREXySekvq37kfCNk,38376826,226294975,-187918149,617
2022-01-10 09:22:33-05:00,3204,GH6Q9E1jZPTTp46aDd57UNZPNS2D6PBSwyLL3EHSjGn2,2XvwZXNsrPWx4EfPvhTP933bzCC3SJHDQ8xARfrXdVY9,True,24717992,6179498,38015,19007,19008,3zqXX6kzhkbW3d4TwD2CNjMRwxTbREXySekvq37kfCNk,1520620,20752566,-19231946,615
2022-01-10 09:22:33-05:00,3205,921FBgLS3A1wA77uWitsnTvW737Q2jY7tzvgWtWLXNC7,E4eJ9H7cqP9zNpMH5xRBTAp9yaBCBihuJBNd6pqzteDG,True,183450,45862,278,139,139,3zqXX6kzhkbW3d4TwD2CNjMRwxTbREXySekvq37kfCNk,11127,62613,-51486,606
2022-01-10 09:22:33-05:00,3206,5jin5wXjQQ25nGM2ECrCXcg1a95vquh6kM7rMRru6Ke7,EKM657EQ8HWWgf4cssByoYHoXGjFfTspTKXAGmygAPQG,True,47078934,11769733,73198,36599,36599,4BnQKPLuE3DMTtxp8MjUBytgnhvxqq3ZTqZHTVZo4JJh,2927936,22787658,-19859722,621
2022-01-10 09:22:34-05:00,3207,5BJnMHFSiQjHRGFJDW1jnqCfkHHYWnQzmmccy9eA4jNj,9517JGYsPmvgPUM9pFRD2vipHmdgE578F7jA7Qq6jorm,True,503837910,125959477,786606,393303,393303,4BnQKPLuE3DMTtxp8MjUBytgnhvxqq3ZTqZHTVZo4JJh,31464279,215007240,-183542961,624
2022-01-10 09:22:34-05:00,3208,3VYtHvoT9wi4K1PBjg6JjCf6U9fVPDf6tX9jyRRvLxcg,Ba5fjpVyAxLbiP6hYJmrxzougi7JUEDfDLKBxSbbTL7q,True,563517120,140879279,869284,434642,434642,4BnQKPLuE3DMTtxp8MjUBytgnhvxqq3ZTqZHTVZo4JJh,34771364,108194244,-73422880,617
2022-01-10 09:22:34-05:00,3209,A1j2G5FZRyWSjFt6dK87WHhLkQrPUVqHaM3KhSzhAKDT,2fMiHLYm4pL3YCd8aveTR4mT9uVxztQeMwb5eRZb4wUW,True,673838,168459,1053,526,527,3zqXX6kzhkbW3d4TwD2CNjMRwxTbREXySekvq37kfCNk,42128,317416,-275288,625
2022-01-10 09:22:34-05:00,3210,AGhvB6x3gmvAJSnr9UVtvhKqVg3Qgh1k4roHzrNHhAaa,HhhjXT6WJnz1HQfHcwKdBppuAhc8ncUcq1mkJ4EHqgpe,True,7906,1976,12,6,6,3zqXX6kzhkbW3d4TwD2CNjMRwxTbREXySekvq37kfCNk,485,3338,-2853,613
2022-01-10 09:22:34-05:00,3211,AA9zFZTXqBR8Mw1fwEH59edzBiswoGasRNWsi6aLeysB,4VeitxYqqtRxyfdSVpshdJ3EDcgksRVnaHvAqWxTeujH,True,2128965,532241,3289,1644,1645,3zqXX6kzhkbW3d4TwD2CNjMRwxTbREXySekvq37kfCNk,131575,576050,-444475,618
2022-01-10 09:22:34-05:00,3212,Ayx8dFsVzUBb9b7QKxw7YHJuhptdSitBXFEczXTaxe85,EvU1VLChnowi6ccSPeJRSk65njrqZfYouAN7SHePxsxf,True,29283,7320,45,22,23,3zqXX6kzhkbW3d4TwD2CNjMRwxTbREXySekvq37kfCNk,1831,14585,-12754,625
2022-01-10 09:22:34-05:00,3213,GGGyesjbt7h2XHHp9u8vpiWGugFwEbrtYaKrNQSDhQd7,8tydo1ZjGHmPBSqU33tywB3f9szdsHk1ckGFe4Ay5pgs,True,63185426,15796356,98599,49299,49300,3zqXX6kzhkbW3d4TwD2CNjMRwxTbREXySekvq37kfCNk,3943986,47144657,-43200671,624
2022-01-10 09:22:34-05:00,3214,HdfQweV1KuYSpWdycZbpGrUc8yMcY3ZczLn1agKXMJaf,G1Ae1PZHkANkwFnhUKS1tvdFEv8dAFeojBkezh6rUNMh,True,6949735,1737433,10797,5398,5399,4BnQKPLuE3DMTtxp8MjUBytgnhvxqq3ZTqZHTVZo4JJh,431881,3346881,-2915000,621
2022-01-10 09:22:34-05:00,3215,6dr65yANjSMmfBeKAuSxG3i16S9vMgF1CQ3zDyzh55Pn,EhrE5QpnshD41S4zPEBy2A5q2Gs2mwUrbHGo6WnT9zDP,True,418775,104693,654,327,327,3zqXX6kzhkbW3d4TwD2CNjMRwxTbREXySekvq37kfCNk,26163,208070,-181907,624
2022-01-10 09:22:34-05:00,3216,3Xbsek5MsEGoWr3G9yhuohREr26B2vSQcjqXdspTFHta,2rPxkUiMo9wGDq8EvAiwY3ngRpKmL223cBWWNTYoBmFp,True,297698508,74424627,451512,225756,225756,3zqXX6kzhkbW3d4TwD2CNjMRwxTbREXySekvq37kfCNk,18060484,104697276,-86636792,606
2022-01-10 09:22:35-05:00,3217,HkRKcvAWLM5sCDL6a5DvYsH55bg5BnZnyP9WwX7wLUDF,GXtDJS8BCoZKnvviGaUb2QfKs2LQQZPMa9564tf5Jq8Y,True,1911026602,477756650,2917742,1458871,1458871,4BnQKPLuE3DMTtxp8MjUBytgnhvxqq3ZTqZHTVZo4JJh,116709717,410919315,-294209598,610
2022-01-10 09:22:35-05:00,3218,ES1MDwRUa3hoToPKQiiZkzMYe9PDVnAQwMrEvZrzvnc1,C4wBG3xTDkmDQneB28xYnf1aBNEeq7UB8oR7NuEfLkFg,True,34460872,8615218,53583,26791,26792,3zqXX6kzhkbW3d4TwD2CNjMRwxTbREXySekvq37kfCNk,2143328,11678925,-9535597,621
2022-01-10 09:22:35-05:00,3219,5RvNKzSeJ1fvqsKpcQu25evEZGmKjyEDgwsMZkykoT3P,BRqSGfE4XHXu4HrinwetWumfVTmr82iuF6Y5oSV6eMiK,True,183604,45901,285,142,143,3zqXX6kzhkbW3d4TwD2CNjMRwxTbREXySekvq37kfCNk,11421,62752,-51331,622
2022-01-10 09:22:35-05:00,3220,7CSCMFa9W52tBDVUbXbc3woAy3GByeA1wPJdp3MgznPa,3447ptuVFu6G8B6N63RmS8mRv4n9PfHneypHLvbeaGLn,True,138202687,34550670,213704,106852,106852,3zqXX6kzhkbW3d4TwD2CNjMRwxTbREXySekvq37kfCNk,8548169,63162201,-54614032,618
2022-01-10 09:22:35-05:00,3221,HhwiZPKZBGa16oVi739s4qtMDMTwzWXc7iwNfX63t2UP,5AnbMbAFKy85yHt5y2M5S38nNkA1vT4ejY5NjGbRNUqn,True,1732713,433178,2615,1307,1308,3zqXX6kzhkbW3d4TwD2CNjMRwxTbREXySekvq37kfCNk,104602,1044339,-939737,603
2022-01-10 09:22:39-05:00,3222,7jvKp6onXyWgwsFrFWj4hYTXJsYYD6ot5mn6rPFuJriy,J7N6HiozevJVTiY9hDEUs2ud5BwT5QSE7wnMBS1w5ie2,True,55466438,13866609,85803,42901,42902,DddJ7EWCmYEEZETCBNgAUSg81Ls6fZtiAaY5ekJ5sXx1,3432136,28160019,-24727883,618
2022-01-10 09:22:39-05:00,3223,4D7mDXe7SdmbAx7kaD1mBNuEa7DzMi6TAwXURxtLEazk,5pSnT91PHoLdN6uhPnUtoD7cboLmndn26y1XouPx8vwW,True,1855437,463859,2838,1419,1419,3zqXX6kzhkbW3d4TwD2CNjMRwxTbREXySekvq37kfCNk,113528,630668,-517140,611
2022-01-10 09:22:48-05:00,3224,2QStaRnbSnDhA891Lb1bxjVeMYpJUpNdqaVkw3rqU45V,DakRWPnttPoRcjY5V7WLwiwBx39BapCo9Atog8dL17Ku,True,2831944,707986,4389,2194,2195,3zqXX6kzhkbW3d4TwD2CNjMRwxTbREXySekvq37kfCNk,175564,903194,-727630,619
2022-01-10 09:22:48-05:00,3225,3Lv2XpiD4KBUHq7Zx6u3zNhpXoySodXHH8o8f5yaaPxG,H6TN4rhpBXkEH3mZnymYNcKfmnxRH2uzfwzeLH2q6ahP,True,233565,58391,361,180,181,3zqXX6kzhkbW3d4TwD2CNjMRwxTbREXySekvq37kfCNk,14478,99741,-85263,619
2022-01-10 09:22:50-05:00,3226,6xikA6d7sjCBnSfqkFwrL4nPrtQUNWdRhXB7i1AccnxC,G8t7u2R9qjRfdTdULs74v3nVrTM2WeKvc4dK4FFAvuG1,True,46846542,11711635,72447,36223,36224,4BnQKPLuE3DMTtxp8MjUBytgnhvxqq3ZTqZHTVZo4JJh,2897884,10391342,-7493458,618
2022-01-10 09:22:50-05:00,3227,9E97vZ6evPgg1Ao8KwvjjZhBFW6dXZrrJENk1HvZ3SU,D7U38PB8BXLwUVKbRNv9po7VcFdnn7Y4tWY9xpRiNJsT,True,65657414,16414353,100234,50117,50117,4BnQKPLuE3DMTtxp8MjUBytgnhvxqq3ZTqZHTVZo4JJh,4009368,17780866,-13771498,610
2022-01-10 09:22:50-05:00,3228,6u6bPgAmK8ufACrQV99A1Y5nhGkue3KEUHmQQkcNkxwP,7636yXT5w4DcVpc7LJdN46aiggzSq6U2GXHXL5kyy9F3,True,148342130,37085532,229575,114787,114788,4BnQKPLuE3DMTtxp8MjUBytgnhvxqq3ZTqZHTVZo4JJh,9183020,71713288,-62530268,619
2022-01-10 09:22:53-05:00,3229,Gbxc51WERLLeCtiHv7rDvE52aqF541RoQWG5n5aqErq6,4ngBoHbfXijLMqGKxFMNht9sbmxy2g5eqBmn8QsBmbx1,True,1289425,322356,1975,987,988,3zqXX6kzhkbW3d4TwD2CNjMRwxTbREXySekvq37kfCNk,79022,564535,-485513,612
2022-01-10 09:22:53-05:00,3230,6CeKxTJvFqhyNEyzySiBBKEwYVMe7j3A6nkMes4BW6o2,DzDR9XvwY1z7ygQ8YrCXrwDGHSf67JZF8BzUnuFE2fxQ,True,5473825,1368456,8488,4244,4244,3zqXX6kzhkbW3d4TwD2CNjMRwxTbREXySekvq37kfCNk,339527,1983074,-1643547,620
2022-01-10 09:22:54-05:00,3231,8VnGmfop6qcUezAJ2M15jz2Nn6mPQgehDcJPvypq4XJn,6F6sqXNhgkW9ev8QNMm4ydywUUmemhwgydRQYNeqyUmi,True,13244013,3311003,20656,10328,10328,4BnQKPLuE3DMTtxp8MjUBytgnhvxqq3ZTqZHTVZo4JJh,826256,11312751,-10486495,623
2022-01-10 09:22:54-05:00,3232,3njiRuSRMXRzKmamyiR72Hc38PU8UDDmWdfPhgxmGxEW,5WoF3gkgygyNNbwxWgVfqGWkExcDixuzgJQQjXEZQ6J5,True,319046408,79761602,497280,248640,248640,3zqXX6kzhkbW3d4TwD2CNjMRwxTbREXySekvq37kfCNk,19891218,217567831,-197676613,623
2022-01-10 09:22:54-05:00,3233,8MKNsuGVaoYpdQy6NNyxDvRzh2DAquBUtri4nDsixUxs,D7M1SDmpZAs8vdPCCCa96UbDF15YQDxHmoGWB57tHiir,True,5177067,1294266,8058,4029,4029,4BnQKPLuE3DMTtxp8MjUBytgnhvxqq3ZTqZHTVZo4JJh,322341,2650730,-2328389,622
2022-01-10 09:22:54-05:00,3234,5PbrpM9kjzF4R2eW2UTcRVXnhqWdRQWHZJXKLN43N8WC,6ip4ocbyHusy8CsVvcrpiRCUp2nq9cY8bHpTcUU3Wztq,True,9848489,2462122,14083,7041,7042,4BnQKPLuE3DMTtxp8MjUBytgnhvxqq3ZTqZHTVZo4JJh,563351,4228808,-3665457,572
2022-01-10 09:22:55-05:00,3235,EeztHR1M4PPacJEZ6c5arCRVCuu8aN7eGdpY1u4bev79,9Twdc9Xrzv2oeJ9Fbd8mRvzjbFi7mkGopFS37SMabeAK,True,220866576,55216644,315624,157812,157812,3zqXX6kzhkbW3d4TwD2CNjMRwxTbREXySekvq37kfCNk,12624983,69900807,-57275824,571
2022-01-10 09:22:55-05:00,3236,7iUx7JBwqUvPVPeCqMEXQdLccZJmaFYm1DUQiu3ouHa3,3EVZzhRmJnX9ZiBZZo9tenDtMogAyuA1yf2cKzvUWiuu,True,1458120,364529,2208,1104,1104,3zqXX6kzhkbW3d4TwD2CNjMRwxTbREXySekvq37kfCNk,88342,650991,-562649,605
2022-01-10 09:22:57-05:00,3237,FpqCxvTkSiwDwD5qEt6hXJxzFDLFLAQ8VevK8zwRqYun,A3p6YQisCJKpNkF7vkjZRbEfbnUt7vTZdR2zPBUSdTkk,True,510762744,127690686,737912,368956,368956,3zqXX6kzhkbW3d4TwD2CNjMRwxTbREXySekvq37kfCNk,29516504,186255217,-156738713,577
2022-01-10 09:22:59-05:00,3238,DAku12iueL13vRoTpKLyqdGaLQ2rWF6REe8Dr8soFvNs,H2vVH3LxkhGe6x6Mdwy67BYwTKNQM6XayKx7mhrwyfJM,True,555055,138763,805,402,403,DddJ7EWCmYEEZETCBNgAUSg81Ls6fZtiAaY5ekJ5sXx1,32217,278069,-245852,580
2022-01-10 09:22:59-05:00,3239,9UyQC8vc6zJJaSdnjvTAzgmcsw4fC3xFBBiCC1w9Sbjx,3ppBfboe6FPmt7f6WrivspMUoAznZKWQMeh3rCgw7vjQ,True,11160981,2790245,16904,8452,8452,4BnQKPLuE3DMTtxp8MjUBytgnhvxqq3ZTqZHTVZo4JJh,676196,3752089,-3075893,605
2022-01-10 09:23:00-05:00,3240,J4krKPBBTMVLZRgrSeYJAMyHQs2FkNm5TXk7nQWwDB43,ASmLbfNbhTD2HHeV7qzAqiHjUx5a8Traj8oPDwbkMdFg,True,35417836,8854459,54068,27034,27034,4BnQKPLuE3DMTtxp8MjUBytgnhvxqq3ZTqZHTVZo4JJh,2162738,13142762,-10980024,610
2022-01-10 09:23:01-05:00,3241,51yPLtXTgL9oLKs1cCf5TjL54Ld5vuVxat2NNtwZVsZG,7UjtM7Z1tiXEQMMiorQyncgi9SKu3v46DhVdgXbWqSiF,True,444381810,111095452,687502,343751,343751,4BnQKPLuE3DMTtxp8MjUBytgnhvxqq3ZTqZHTVZo4JJh,27500094,375466300,-347966206,618
2022-01-10 09:23:02-05:00,3242,4cKgCTttVp8pzJnp43PP7uLLUXNcU7YGPJ3cCGHaUFe7,BBQqjwTpVEgpDzMk4wDDH8rCjaSxCRPWVhtFxERSujTD,True,50700347,12675086,79028,39514,39514,DddJ7EWCmYEEZETCBNgAUSg81Ls6fZtiAaY5ekJ5sXx1,3161149,21453833,-18292684,623
2022-01-10 09:23:03-05:00,3243,BAczoNDnbwj5AJX5LwzynzYab7ji7VbhRy9edA9Prax,34sbkUKnMetUNyMs6BhiWut85d5UZtBWnPtwx8jEpJNA,True,1618054,404513,2397,1198,1199,3zqXX6kzhkbW3d4TwD2CNjMRwxTbREXySekvq37kfCNk,95882,727601,-631719,592
2022-01-10 09:23:03-05:00,3244,o2aCmkxsxSiyUX8soTEjwUCbJeXmCZsEaf8CWwxDT5n,3pvS2bTsUuiQyqZp5rdnTpq4cqWGgtv4E5rN9HsBxpRt,True,29945,7486,46,23,23,3zqXX6kzhkbW3d4TwD2CNjMRwxTbREXySekvq37kfCNk,1867,8546,-6679,623
2022-01-10 09:23:03-05:00,3245,6eBSLXDMVoW2nG3n7s42RXDH8byY3C6n1RsUuegBLSrG,37dYrKnTXYer7Bu9xFfpArA4ZNo2B9bycFw9HywDtTRx,True,12346957,3086739,18088,9044,9044,3zqXX6kzhkbW3d4TwD2CNjMRwxTbREXySekvq37kfCNk,723545,5801743,-5078198,586
2022-01-10 09:23:03-05:00,3246,8sneA6wAg6geVDJ1g7YWg4R1PfjuRVzeHp1nUBJinhZa,14i1uWtmcTjrdbg3DSr9vzd5NBnxqsn1A4QdgFBZqeYM,True,150990,37746,234,117,117,4BnQKPLuE3DMTtxp8MjUBytgnhvxqq3ZTqZHTVZo4JJh,9375,66484,-57109,620
2022-01-10 09:23:03-05:00,3247,8NdcaYUC1X5CP7FMDip78uqtqmCt8GcZdCzLRTYTihmb,9Ei1K9bXWXSXcBfeX5exPSXGCAu62WSKzvnnd4wHvyVh,True,163590,40897,241,120,121,3zqXX6kzhkbW3d4TwD2CNjMRwxTbREXySekvq37kfCNk,9676,71302,-61626,591
2022-01-10 09:23:07-05:00,3248,9zpPiboHF5HW7NfCx7hYdmJGwUomVMTiUFc4Um5KrDi3,8q3eBpuwV6dMNkib9N8XQAq2tBUcjSANRe5SXpd4dFhZ,True,10227253,2556813,15460,7730,7730,4BnQKPLuE3DMTtxp8MjUBytgnhvxqq3ZTqZHTVZo4JJh,618411,3440562,-2822151,604
2022-01-10 09:23:07-05:00,3249,CvZssqscu2dm35mwcE3zg9zedavbRjVJjWD59Py5ExUK,7pXaoR6aHKYofCmg1eHipygNYDteEaf8rbbS8BDYGQK6,True,876812,219203,1348,674,674,3zqXX6kzhkbW3d4TwD2CNjMRwxTbREXySekvq37kfCNk,53957,318677,-264720,615
2022-01-10 09:23:07-05:00,3250,F2v1YwVAwXLiUgsJ5uwn4qAAkTXitn1E75fJcPnGuAcy,5rdJ4H5GxPg4Juu77mGc7uya5LwEqLzDSRyG8mQ2mDbK,True,24012378,6003094,35743,17871,17872,3zqXX6kzhkbW3d4TwD2CNjMRwxTbREXySekvq37kfCNk,1429737,11673854,-10244117,595
2022-01-10 09:23:07-05:00,3251,ANQkPUoMjLHyRtypeKzxsKW1DFauQsh9SnB3rRgRXM1Y,7RHAExWpG8Q3PXwKhJs2yXmYK9WogGydvFYpx28p6pgr,True,90411043,22602760,135666,67833,67833,3zqXX6kzhkbW3d4TwD2CNjMRwxTbREXySekvq37kfCNk,5426655,51634024,-46207369,600
2022-01-10 09:23:08-05:00,3252,2FrqGFZjbiNykJyo9BZ5S9FguQJPJiTi681rJJsQ5dta,3QUncYP92NKrfpaTvuF9iQg11PXKgZAgEngwh6BbnCCj,True,1028433,257108,1522,761,761,3zqXX6kzhkbW3d4TwD2CNjMRwxTbREXySekvq37kfCNk,60898,422625,-361727,592
2022-01-10 09:23:08-05:00,3253,Dn916KSmX3HqxT53hrxrbCrV3tdRMCPdaoiRLqetMrth,ATCXRiXgnjRRUbSTPBvtBXMENCqsViexSZbZ6aDaXXWA,True,1630826,407706,2517,1258,1259,3zqXX6kzhkbW3d4TwD2CNjMRwxTbREXySekvq37kfCNk,100693,721097,-620404,617
2022-01-10 09:23:08-05:00,3254,6nJyqvFKprwaVCE1gAa2P4RHKc6Pa6XFSJymx654zZ9K,4e7iJmdwzAPxp1Zi8Azo38YyPQdPKqqY4VLJyQ5rpdYP,True,3122708,780677,4863,2431,2432,3zqXX6kzhkbW3d4TwD2CNjMRwxTbREXySekvq37kfCNk,194537,1582879,-1388342,622
2022-01-10 09:23:08-05:00,3255,CRaKcudjkQiSw5YPVjTLVdXvJskeGiHSYtq5ZcMPJhgQ,AgqTg3b3bAcaBmRidhNC4Uf9ZwNbeH52RQEqumWyuUs7,True,1085285,271321,1690,845,845,3zqXX6kzhkbW3d4TwD2CNjMRwxTbREXySekvq37kfCNk,67620,652615,-584995,623
2022-01-10 09:23:08-05:00,3256,2F45BX9mRmtNCHPejKFknN5aNgGvR4vVLFjMaY1a7dR8,ALdSutsvEFRUEQGGBbi31QywTL1pdXSDWrNJzvNTaoXL,True,31233358,7808339,47578,23789,23789,3zqXX6kzhkbW3d4TwD2CNjMRwxTbREXySekvq37kfCNk,1903142,14609850,-12706708,609
2022-01-10 09:23:08-05:00,3257,AM5fwZR9BUW8AFkhdGWXW4PHd2cy8ora63kDf2z2eknw,E7ru6hg4MchnRG5zcr5YazwX8Snt55r5Xq9zCHCGaYZT,True,1189692,297423,1739,869,870,HfEnetJ7uBSmZWCjBNxdvv9HEC5nsW4wDV7wu6WnhWan,69599,567238,-497639,585
2022-01-10 09:23:15-05:00,3258,67Z7ZGhNu5xxEh9BYKWcXp9m1T4tFiE1o1M16hCzUWQA,CT7YKWixz7BhTbvg5F6M5HCyPGnHoFLNFuDV9GhoLTo3,True,4070733,1017683,6275,3137,3138,72FwbpFGoLEazJEdpqNtPNefsadUrimUqma9wSoy4qiS,251005,2326915,-2075910,616
2022-01-10 09:23:15-05:00,3259,Fd2HrzBAr4JobRPARZwpQHHVoSCEoog32A6tKMWAC1sK,BYappsar5sQf8VLem4wrLuTtrDFH9y8pEx1aMxfuU4Pq,True,37495906,9373976,56011,28005,28006,3zqXX6kzhkbW3d4TwD2CNjMRwxTbREXySekvq37kfCNk,2240451,18227349,-15986898,597
2022-01-10 09:23:15-05:00,3260,pgzvXpnUYiY7hLrfjmwScqLd8oj9vYcXpFvpm4y4JvG,GdqdQgoyBAFuXdbvoZyDhB3jyqJzVo4nkGh7EPFxkBF2,True,2641298,660324,4060,2030,2030,72FwbpFGoLEazJEdpqNtPNefsadUrimUqma9wSoy4qiS,162421,2321356,-2158935,614
2022-01-10 09:23:18-05:00,3261,E8ifvhmyJGBGVQomo3AnZw2UcaLHcpGsTtuoCid8voU3,FMQUWTbTAfSLfrc6GTrz4DM2ZSgoxF3KtqGn8AyjVtsf,True,8865350,2216337,13386,6693,6693,3zqXX6kzhkbW3d4TwD2CNjMRwxTbREXySekvq37kfCNk,535453,3173552,-2638099,603
2022-01-10 09:23:18-05:00,3262,H1LftKtj94Zs6PG2A7gJt9rPurBkXkTy2hbbArQwAehi,8bANmhgdnPYa3PqdPnk5BA2xhvqJmPyaMF77mrBePJ13,True,47723,11930,72,36,36,3zqXX6kzhkbW3d4TwD2CNjMRwxTbREXySekvq37kfCNk,2912,37783,-34871,610
2022-01-10 09:23:18-05:00,3263,DdYgcyV1T2CDYiQVr4VL9Ym8RdKm93a7SKy8HxuyaoMW,GPdAeqeXb1UJ56AttcwwY1CyFhRyfptDC4BAX2Tc8MpE,True,658872,164718,1028,514,514,3zqXX6kzhkbW3d4TwD2CNjMRwxTbREXySekvq37kfCNk,41132,331387,-290255,624
2022-01-10 09:23:18-05:00,3264,HPDN6Ro6gPgYbNgnv7yhFCpyY3uYzT18epFxRFNZ985w,3Jop74A52E7gYLXJRUAoPBzSZ6mmP2gmaCg7eG6eQHu5,True,430901768,107725442,645265,322632,322633,3zqXX6kzhkbW3d4TwD2CNjMRwxTbREXySekvq37kfCNk,25810618,94878850,-69068232,598
2022-01-10 09:23:19-05:00,3265,AHm7zF4rpaxaayBLn5QDHgJSp8KAr647s4cNvQ9wLgd7,FDM33WngED24pukBvSDpPAzinW6afVAeGReum5nyLRiC,True,1031166,257791,1532,766,766,72FwbpFGoLEazJEdpqNtPNefsadUrimUqma9wSoy4qiS,61303,518791,-457488,594
2022-01-10 09:23:19-05:00,3266,6tFQaTqqffino9kwMZTL2xVNBG8k9VREFhXqVi2si3A3,3w3wGxBbS4bmXeqmvd595SAWFeXekVpnH4UdbeEs8Sx5,True,5457623,1364405,8166,4083,4083,4BnQKPLuE3DMTtxp8MjUBytgnhvxqq3ZTqZHTVZo4JJh,326674,1986422,-1659748,598
2022-01-10 09:23:30-05:00,3267,C2Dmfw4G8KKzFq38aRH2pLCRngnGZDvUUN3fHDMjFkoG,7kzJk3BTNvY3hGFNj7nDy9L5CAYus6eNiCAxWH8dSioX,True,462074,115518,675,337,338,3zqXX6kzhkbW3d4TwD2CNjMRwxTbREXySekvq37kfCNk,27021,278237,-251216,584
2022-01-10 09:23:30-05:00,3268,8RmB8o4zux2sD48dEsKpsX475KRxTwdk8QULUDU9xx8R,AKSiZnb4YKVB6B86aPPqvyXquhvN9xqt45bexBCZ7nx,True,78890634,19722658,118411,59205,59206,3zqXX6kzhkbW3d4TwD2CNjMRwxTbREXySekvq37kfCNk,4736447,44459966,-39723519,600
2022-01-10 09:23:31-05:00,3269,EmGW2aAG69ssWqCtbfDocRaM2u3TJsczn2HHP9jdmRvD,aypkDKsp9uqAB4F6mwvm5LofpsrFBuZT2MMWtE2eHdB,True,804045,201011,1206,603,603,4BnQKPLuE3DMTtxp8MjUBytgnhvxqq3ZTqZHTVZo4JJh,48263,370380,-322117,600
2022-01-10 09:23:31-05:00,3270,6yw4GPvkqUbakcEWtqSCfjVLukty11xqjDpGxtEN9Km2,5ppEx7wkpqbG5nApCWMdRja3oRSheFmAAsNHUX7h2w2Y,True,2056549,514137,3082,1541,1541,4BnQKPLuE3DMTtxp8MjUBytgnhvxqq3ZTqZHTVZo4JJh,123316,1799516,-1676200,599
2022-01-10 09:23:39-05:00,3271,DGAQzgZhS2yioeZmG3cbacM3hdz4F1aZn1PWRwgiFukc,48KUtJaNCPNxkLXJBtWAdDxY4b9vZzLgbGxTNdwMqmjz,True,655136205,163784051,1022086,511043,511043,4BnQKPLuE3DMTtxp8MjUBytgnhvxqq3ZTqZHTVZo4JJh,40883474,299478606,-258595132,624
2022-01-10 09:24:28-05:00,3272,BgNgALwBEuiumVgiXRmBZRnyFrr9QTDy2maHzsNwNHGf,ag35Ec2uFtqkarizCxFyhM2SPBuUwfmLRhAdFEWFCNa,True,26816988,6704247,41542,20771,20771,3zqXX6kzhkbW3d4TwD2CNjMRwxTbREXySekvq37kfCNk,1661708,8587220,-6925512,619
2022-01-10 09:25:23-05:00,3273,8xvLGVeDmhVYQhN2ZpWkVG9jCrukRsNQ4926a4TMiZqa,9ciBySSjvADwp47WkETiFWZKVTFL8Hf1XvK7aSxhcgQS,True,23975199,5993799,37274,18637,18637,3zqXX6kzhkbW3d4TwD2CNjMRwxTbREXySekvq37kfCNk,1490988,10286211,-8795223,621
2022-01-10 09:25:51-05:00,3274,C33hfnDHzVwKXxr6AwFAXhd1vJYrPKhtqc75Qpjm19Zt,2WYBMSyrHQEYZqxEtxBMe2xn7eioJEGsudqdCmGvssGh,True,62178902,15544725,97002,48501,48501,4BnQKPLuE3DMTtxp8MjUBytgnhvxqq3ZTqZHTVZo4JJh,3880085,12944085,-9064000,624
2022-01-10 09:25:54-05:00,3275,4k95B2HfiTXT8fDtW4286MoEPj6UdPiQd5BjFadjs8Pv,GmhpDUb5A14X8xRZHRnbrYEr3xJh9zJA7eqoCzwboDTW,True,1180232112,295058028,1834692,917346,917346,3zqXX6kzhkbW3d4TwD2CNjMRwxTbREXySekvq37kfCNk,73387704,275981439,-202593735,621
2022-01-10 09:25:59-05:00,3276,GKCeRcHQYMhcTwEm5wu1SbkXAT19gjGUGji43HS36B5N,EYQKX5sWsmXoge5xbTcMYAjvRbSUTXXpHEzckPY2LV8W,True,2328037,582009,3637,1818,1819,4BnQKPLuE3DMTtxp8MjUBytgnhvxqq3ZTqZHTVZo4JJh,145504,629684,-484180,625
2022-01-10 09:25:59-05:00,3277,HmspGdpobjC5Vbmo3FcKdw4RLPN7wJKxv3uKqDjVhLee,3YEX8TzdyJyuHo76Kw76imVCJjzrC9m188YuRKvwwSwD,True,404081110,101020277,629516,314758,314758,DddJ7EWCmYEEZETCBNgAUSg81Ls6fZtiAaY5ekJ5sXx1,25180640,89714830,-64534190,623
2022-01-10 09:26:13-05:00,3278,G25vsB3sDqRhHoSK4KwR1TywfrJDtpejVbbevEG9sQ9a,5xFC3Hm13magnAA9GD1EnwC9PrPoEfQ7omEa9p9zCrB1,True,2148400,537099,3359,1679,1680,4BnQKPLuE3DMTtxp8MjUBytgnhvxqq3ZTqZHTVZo4JJh,134375,837604,-703229,625
2022-01-10 09:26:20-05:00,3279,36ByQojnxEckWdQTjqHfxKqCx9yjqWQsPsZyqaN72UWR,AZoirtS1fjX61agRM64tqThVinnJTh3BWgiHyNHPTgZP,True,769627,192406,1195,597,598,4BnQKPLuE3DMTtxp8MjUBytgnhvxqq3ZTqZHTVZo4JJh,47822,439950,-392128,621
2022-01-10 09:26:23-05:00,3280,CbhrZUdan1axNDFUrX1ZuEohfNMEGrszKSkk6pppVQuw,DHEAjJNtuEePezYAv77thWabbVxxqQpfuiC6moRSrpG1,True,88935193,22233798,137937,68968,68969,DddJ7EWCmYEEZETCBNgAUSg81Ls6fZtiAaY5ekJ5sXx1,5517518,51570480,-46052962,620
2022-01-10 09:26:41-05:00,3281,D58t4uTjFumsUeYFaKnpV8BRTEQEqKXBreFTdwGrott7,67p6kHDfVqQijfcwugvZK59c3aRRH9x3eHxruqH8WEqF,True,1285977,321493,1981,990,991,4BnQKPLuE3DMTtxp8MjUBytgnhvxqq3ZTqZHTVZo4JJh,79277,562006,-482729,616
2022-01-10 09:27:50-05:00,3282,DdAPWdHnb7ocaYtcwwwYnppsH39sZpmzMyANeoJbCV7s,3BVmC39L8dEypPN1BZhsf9bx9Ge2sXCZR8Y6RH4eBNMJ,True,1317988197,329497049,2050931,1025465,1025466,3zqXX6kzhkbW3d4TwD2CNjMRwxTbREXySekvq37kfCNk,82037243,949597374,-867560131,622
2022-01-10 09:27:50-05:00,3283,9vcKW1GfrDZ3KLPh2pEVFF8ZyKqD1pJW1hiE8H98Av7S,C6Ki27mo4sCHu6u8UnR1p7WSgsTjFQxGGR9Lk9n5Rhjq,True,3480772,870193,5424,2712,2712,4BnQKPLuE3DMTtxp8MjUBytgnhvxqq3ZTqZHTVZo4JJh,216977,1666505,-1449528,623
2022-01-10 09:27:51-05:00,3284,EAUFD16wab8qRMJ4H6updHGt4xFqgRCDeRHVCsLCTSTL,8vkfYSyCyBY9g4TZrp52jUcQj6udy9xAaA4fioRE2RXx,True,2647673773,661918443,4138797,2069398,2069399,4BnQKPLuE3DMTtxp8MjUBytgnhvxqq3ZTqZHTVZo4JJh,165551893,643061445,-477509552,625
2022-01-10 09:27:51-05:00,3285,M69XSefqeum2arinvHEqmA3L2XHWNFN17p4msRhRZXf,2vK15yYUANLSbAoiBfgJ9VLyqsmtEpd2iNytQjms8GaQ,True,339484455,84871113,531042,265521,265521,4BnQKPLuE3DMTtxp8MjUBytgnhvxqq3ZTqZHTVZo4JJh,21241714,214121641,-192879927,625
2022-01-10 09:28:13-05:00,3286,8T4WK27RvWVGqPuNqY6whk1fmU4vd5qaUQPZG1GJ79bh,DvSz7knS8N3K7L6JhQf1s4mJSyxB8uJXNQXtyjJn8QRL,True,87995430,21998857,137627,68813,68814,3zqXX6kzhkbW3d4TwD2CNjMRwxTbREXySekvq37kfCNk,5505100,41873993,-36368893,625
2022-01-10 09:30:09-05:00,3287,Gs3WP18hbzNpbBgiU39e6tfkggfCKRyNqPqJQcthuHFD,4XAY25YUma6gUdG2GdbXeivum3t21g93ZagfWGTZYkWZ,True,12572481,3143120,19591,9795,9796,3zqXX6kzhkbW3d4TwD2CNjMRwxTbREXySekvq37kfCNk,783664,6218360,-5434696,623
2022-01-10 09:30:24-05:00,3288,JDeYjCLpfnzcfxDFgHf4aBcHsajwdR14GUaKAA9euzVf,EJbvKoyMZcoCx4vWa61uMbW2vr6mUhrgEuECdteVBuZZ,True,7473297,1868324,11693,5846,5847,4BnQKPLuE3DMTtxp8MjUBytgnhvxqq3ZTqZHTVZo4JJh,467757,4515796,-4048039,625
2022-01-10 09:30:27-05:00,3289,m7gf1jAYXBZjRZEY9w4MjPfhzLwgDKaXyaCVhRD6C5E,Aa2aTZnpPux1i5K2MT4i1TsVM8vR7qR7rZGijQW4zpwd,True,107676993,26919248,167775,83887,83888,3zqXX6kzhkbW3d4TwD2CNjMRwxTbREXySekvq37kfCNk,6711012,24014019,-17303007,623
2022-01-10 09:30:46-05:00,3290,6oroGB3mvzK3tDfiB9X2NJuL3x476pxhgRnt7VxqhdLo,2SoK8tKkLn2ppKURpTVazKsCEis4uahkHMsac1m85J4r,True,2243899,560974,3508,1754,1754,4BnQKPLuE3DMTtxp8MjUBytgnhvxqq3ZTqZHTVZo4JJh,140351,1900570,-1760219,625
2022-01-10 09:30:48-05:00,3291,Ckqos6cdncPKj13DnCmDVZsZTqp6eS7277CRrT9WhcEr,AtUV8m7VQJvZq7GLCAHMf3jV7iamKEPnWVZHWuuVZQp1,True,1555132,388783,2424,1212,1212,3zqXX6kzhkbW3d4TwD2CNjMRwxTbREXySekvq37kfCNk,96997,936129,-839132,623
2022-01-10 09:30:51-05:00,3292,HVZkXeDR3mc8oB9qFFwCK4RXpPojdcHk9tRGep6xtKGK,Bh3py7awPejWqeTMxtAgF7mPotL2Asxf8YrYJykq9nBt,True,8256843,2064210,12869,6434,6435,4BnQKPLuE3DMTtxp8MjUBytgnhvxqq3ZTqZHTVZo4JJh,514772,3521483,-3006711,623
2022-01-10 09:30:51-05:00,3293,CBL2NbekJrXvBiAcoj4fzQ4PfLDwTntW7Zt4nruHFYEw,59EvfgYTdKkfjUJz5LddLUAqbEdLaihcMzjcrTZsyzyS,True,11715,2928,18,9,9,4BnQKPLuE3DMTtxp8MjUBytgnhvxqq3ZTqZHTVZo4JJh,729,4899,-4170,622
2022-01-10 09:30:59-05:00,3294,5rW9kqXB9feGSKSvSMNJF1FCsBYV3vGmTmc8MvzaZ3pi,7AjnjcfPJevW5521hXw4VtgRCfHSsAqyzyArukKfNcHo,True,13765643,3441410,21435,10717,10718,4BnQKPLuE3DMTtxp8MjUBytgnhvxqq3ZTqZHTVZo4JJh,857416,7023378,-6165962,622
2022-01-10 09:30:59-05:00,3295,zLTuMVfVswjMkhyvjaXnvjcKXv5xNk3iSWSjRGpVqXf,J3D8NHUJCiSjvFYfJ5Es4YDhF1KcPZWRUmCQ5L92t8eB,True,152336581,38084145,236360,118180,118180,4BnQKPLuE3DMTtxp8MjUBytgnhvxqq3ZTqZHTVZo4JJh,9454429,61545846,-52091417,620
2022-01-10 09:30:59-05:00,3296,2jPxG5FL6D6XEJsRszJ9cmQ54AWSpZyPFSbn3DpWBSuM,3toQou4UVNvyWYvMvkuv379RVEF2aN2TzCpKKBUqeQV6,True,241737277,60434319,376550,188275,188275,3zqXX6kzhkbW3d4TwD2CNjMRwxTbREXySekvq37kfCNk,15062015,101369049,-86307034,623
2022-01-10 09:30:59-05:00,3297,CyWBZ1xJ9LahUnPesbXLZ4Rr5UyWAHgVFYwfrnhyrkNL,2Lpk87Xth8ZL5J9BfzmMpEE3x76FDrrrmdKiCNkSVip2,True,176750956,44187737,275092,137546,137546,3zqXX6kzhkbW3d4TwD2CNjMRwxTbREXySekvq37kfCNk,11003683,67820208,-56816525,622
2022-01-10 09:30:59-05:00,3298,CagSUfZLwXuCdypC4KzU6FSNdmCj9dKDroPcNeaRtsyt,yxw5d1ztZuEUY2QjL7eLpr72QJAj5rJd6ERvg91cy1m,True,2025030,506257,3152,1576,1576,3zqXX6kzhkbW3d4TwD2CNjMRwxTbREXySekvq37kfCNk,126103,769408,-643305,622
2022-01-10 09:31:01-05:00,3299,FhAt6pZW3k8StP9VLeWUfidpXfRLoKWdV7Wgxdh9cRy9,Guk93pTo3KcG8konHjJ52oi9rgexmmKhPQAkxZS1BtCG,True,227181985,56795495,354745,177372,177373,4BnQKPLuE3DMTtxp8MjUBytgnhvxqq3ZTqZHTVZo4JJh,14189820,103342111,-89152291,624
2022-01-10 09:31:05-05:00,3300,3qnPsgqW11AcDEmyjmJquPcPLyE3EdJQuVLJ5kinDrd3,86rZadBB7emKio76aFTahpbrFtxd9tqZ4Mxgzaavq2xU,True,197775,49443,308,154,154,3zqXX6kzhkbW3d4TwD2CNjMRwxTbREXySekvq37kfCNk,12357,84892,-72535,624
2022-01-10 09:32:33-05:00,3301,AWvHDdb2ikqV8wc7qQ8azbvNTZdixMNxhQjhQdhayYtR,9EpgEPBb1nog6aQeFdMXfSRiLSnzGQFQ39mbLdCxgYTv,True,44354169,11088542,69356,34678,34678,4BnQKPLuE3DMTtxp8MjUBytgnhvxqq3ZTqZHTVZo4JJh,2774262,14355955,-11581693,625
2022-01-10 09:33:11-05:00,3302,5eMLdQ4gYA5iqvTXSNdGvctHp7s5VpyFuwtJKqx6chBc,Ckxc5K39nkBNXBTmFTM8J48R7wGqNm3vHKZu4G5baumZ,True,314058297,78514574,489748,244874,244874,HfEnetJ7uBSmZWCjBNxdvv9HEC5nsW4wDV7wu6WnhWan,19589935,112929648,-93339713,623
2022-01-10 09:33:40-05:00,3303,BrHRMouGRz3LBNzd9anfdYMhWfg8yUPHL4PqJ8WdEDFS,4uzoLa3mC2VYHAPBoHLX4gTjPTC28rPf2fvEGtJWPYc,True,76129081,19032270,117888,58944,58944,3zqXX6kzhkbW3d4TwD2CNjMRwxTbREXySekvq37kfCNk,4715555,61179471,-56463916,619
2022-01-10 09:33:41-05:00,3304,2FEbsetZMkRqLjSC8GBbgecKgX5T1T1fci2sLQux29p8,H722Fcd6DkTFRZxqQWbPDufBfXEgmFfhiEpQZWhxwYv1,True,6043800,1510950,9382,4691,4691,HfEnetJ7uBSmZWCjBNxdvv9HEC5nsW4wDV7wu6WnhWan,375294,2339208,-1963914,620
2022-01-10 09:33:41-05:00,3305,3C2MZQKh9x4zNTCMbhhvoafGaFMwUooqfy9MCgPyXs6E,AHjgWKpYPWe6ketjDHDKFBFsKQiRJ41jnkuo39MVYxZo,True,264838941,66209735,410600,205300,205300,4BnQKPLuE3DMTtxp8MjUBytgnhvxqq3ZTqZHTVZo4JJh,16424015,151031511,-134607496,620
2022-01-10 09:33:42-05:00,3306,HGJoZvLakWfSDFwuvShNBc4kCf7nP7VqzyM3mELpbFEf,12Qn5jin7QvsBngXqYAv4UstyG3b6nRf1jsLp9Dp8G7k,True,20288379,5072094,31459,15729,15730,3zqXX6kzhkbW3d4TwD2CNjMRwxTbREXySekvq37kfCNk,1258374,9124275,-7865901,620
2022-01-10 09:33:42-05:00,3307,E1CShgy7M9998q9jyzpnHZxHJR6z5hvnshUJt37kVPtG,96f1nYW4S9APCJS3TXTGSb9UcJDdxJuoBR3pLYqcNz2b,True,221103888,55275972,344598,172299,172299,4BnQKPLuE3DMTtxp8MjUBytgnhvxqq3ZTqZHTVZo4JJh,13783942,92649754,-78865812,623
2022-01-10 09:33:43-05:00,3308,U3vvMQ4X4aKzVYfhMw1V1p58HRqaLnuXozqmmefYeD9,7JA94MArkNCFRhBq8f5a32DgMF6aPdFsoC5HvXDQ6NuR,True,392883264,98220816,610355,305177,305178,3zqXX6kzhkbW3d4TwD2CNjMRwxTbREXySekvq37kfCNk,24414239,203844306,-179430067,621
2022-01-10 09:33:43-05:00,3309,GqAS41YJssg9aaEp3hs3sG98APCsXhiQBQszXaSjZ2bN,2wodJ3AhrXdE1T4oVL95KvoBND7PubG5Wd5GWiLCMZJU,True,237608421,59402105,368030,184015,184015,3zqXX6kzhkbW3d4TwD2CNjMRwxTbREXySekvq37kfCNk,14721239,192208285,-177487046,619
2022-01-10 09:33:44-05:00,3310,BYvjENe16Ta77PqGV7JKEWrsqCTfkMGYwTSG5gXneDvd,EvxAXgvhPC6QkNurbK7vWyTApGo8J2R4EgMAknkHVU3d,True,3867745,966936,6037,3018,3019,3zqXX6kzhkbW3d4TwD2CNjMRwxTbREXySekvq37kfCNk,241517,2379953,-2138436,624
2022-01-10 09:33:44-05:00,3311,ymyzGH4Qc7HH5PbKpVphCbsQgLLXyGkPcXamQJuNj5C,8oTLHaV2XzbKXNWRuUjCfHjUn61Pw93LYK14m9q2VDpZ,True,17205661,4301415,26752,13376,13376,4BnQKPLuE3DMTtxp8MjUBytgnhvxqq3ZTqZHTVZo4JJh,1070081,6554109,-5484028,621
2022-01-10 09:33:47-05:00,3312,7PzGZgzieFyyFs1dbajkNQgVxooFUNZrj1bUsQvrSwbp,A2gDREmSmJTBPPw3sbKVY3smC9wbHMDdv87gr4Tr2ES7,True,3557145,889286,5505,2752,2753,3zqXX6kzhkbW3d4TwD2CNjMRwxTbREXySekvq37kfCNk,220229,1529079,-1308850,619
2022-01-10 09:33:47-05:00,3313,B4Uc39nKzz9wBRQsCkMR4A7RwTJ8rSuwpR6EQn2AesRb,H49bGZgatRZVpj6QufZRVgYrQtH7LpdbiqKBs23151m,True,32374369,8093592,50398,25199,25199,4BnQKPLuE3DMTtxp8MjUBytgnhvxqq3ZTqZHTVZo4JJh,2015958,28773877,-26757919,622
2022-01-10 09:33:48-05:00,3314,BPsM1um9ZJf7eNoVMsQCRSwgARMuLCGGSDxf9tZeNeEy,BpzDdXfxVygiSYSmsHV6uPxQMeTFtrURMCCqhswQjd5X,True,1508277,377069,2348,1174,1174,3zqXX6kzhkbW3d4TwD2CNjMRwxTbREXySekvq37kfCNk,93933,587716,-493783,622
2022-01-10 09:34:15-05:00,3315,DMgD2KCEhTGFLUZ5GnfNcwfiiwKYbyVpoWiN6knMkCAf,5KU2vgBkPTNVHsSULjgX7ZkZS56U3Dy3xqLTxL5sUZJ3,True,1782593321,445648330,2755436,1377718,1377718,4BnQKPLuE3DMTtxp8MjUBytgnhvxqq3ZTqZHTVZo4JJh,110217440,1073728043,-963510603,618
2022-01-10 09:34:15-05:00,3316,3WcJUt8jQ1ngL3ZCGo6dFrc3GmTMTYtzeDva7mri2Tqx,HeG1Pz2oMjqtkfsRMsbqP3VpatnVEQzcWmKDVoFp4Htr,True,20290732,5072683,31520,15760,15760,3pStmNaV47N2sqUtHJHLAtCKiN9JZ6jzNY9h94ng8G1D,1260832,9124381,-7863549,621
2022-01-10 09:34:16-05:00,3317,FFoYoBmkfEsCWVXQf3BhKeaFMZD3YVKvfhPWkXdnCZS9,8yW6WApAuN43brF1HioTLdyxvQTQJzt875E26QqrWWFk,True,692530,173132,1074,537,537,DddJ7EWCmYEEZETCBNgAUSg81Ls6fZtiAaY5ekJ5sXx1,42984,204754,-161770,620
2022-01-10 09:34:16-05:00,3318,96StvqZyFUPtyMr4o9s7K4V29RSNyRpVi76vNwxG5rUf,GZKXFSFq4aGiTaqovtxqNCCVGkAFNXPh4Hep1ZMwdZ8g,True,28859927,7214981,44673,22336,22337,3zqXX6kzhkbW3d4TwD2CNjMRwxTbREXySekvq37kfCNk,1786954,24781427,-22994473,619
2022-01-10 09:34:16-05:00,3319,6rb3fRVWJ5cSzFcmuC1YwdrNxiNctvboDF7HwsfyGoCA,H6JaYfFZkRk6iSJrA4nVeuFpMVQtVwQZHVgK1TyaupTE,True,54241,13560,83,41,42,3zqXX6kzhkbW3d4TwD2CNjMRwxTbREXySekvq37kfCNk,3351,42066,-38715,617
2022-01-10 09:34:16-05:00,3320,AA6QgBaH9F8QfPT9xjztv9uELcADPxwUuXofkBV8dYg4,FCMXozSstTNA74FVCJ5hpYvNJamjutnoakHoBVnzwcWj,True,26837,6709,41,20,21,DddJ7EWCmYEEZETCBNgAUSg81Ls6fZtiAaY5ekJ5sXx1,1670,12434,-10764,622
2022-01-10 09:34:16-05:00,3321,CwTus4FyoXYqyTKAYDp69NLhA1joYZ3tarzY6FFTr6fn,6ivuvYWU6i25MzJSY8rG9rPDKiq38E6QtrV1jvRubLGr,True,13087,3271,20,10,10,3zqXX6kzhkbW3d4TwD2CNjMRwxTbREXySekvq37kfCNk,811,5722,-4911,619
2022-01-10 09:34:17-05:00,3322,FV9CBGGTbppLnBKh79f2LzD1diTiS5g6u89FcpZHZmnK,Fe7mtmCUziFqbbYTvrhAcAq1Ub7YLfTJRtQ1hG7GzJD1,True,6800065,1700016,10520,5260,5260,4BnQKPLuE3DMTtxp8MjUBytgnhvxqq3ZTqZHTVZo4JJh,420822,2633607,-2212785,618
2022-01-10 09:34:17-05:00,3323,6Bq55LtGCEeGqh4JrFLCmmGc2iJfTTBJixivqH78aGSE,DSNrCgWJeNe2P9tAQu5FvCueTzNKDKds7wzuwTQSMRG,True,8585484,2146371,13295,6647,6648,4BnQKPLuE3DMTtxp8MjUBytgnhvxqq3ZTqZHTVZo4JJh,531817,3268463,-2736646,619
2022-01-10 09:34:22-05:00,3324,AL8JFS4gjaQx89f9j8wtaNJgV76K8bw1ugvNtgvhgAnb,HJYvG2kGKe8kXgtZSWTWwTmSjxA3XUeCvyT7acoKtS1C,True,5899887840,1474971960,9095404,4547702,4547702,3zqXX6kzhkbW3d4TwD2CNjMRwxTbREXySekvq37kfCNk,363816192,1938642486,-1574826294,616
2022-01-10 09:34:22-05:00,3325,9ebpuMtXee3DSx4qWiEYEtTT1gK5FqCY2H5yQVWWtTts,9b71dTsTYD1bx6KsjFs5h6d3Jj4T9eX3nqmS7RQj3HS5,True,378229248,94557312,586592,293296,293296,3zqXX6kzhkbW3d4TwD2CNjMRwxTbREXySekvq37kfCNk,23463697,158093860,-134630163,620
2022-01-10 09:34:22-05:00,3326,CP2qcTSw1Y5J7jZiEgbtsvJoigRbJ4m9oHGQS8Fiai2x,7Zd1uX1thbuGkp9H4r1t8aLTu9W8MxvUBNjji2FNJa8E,True,50693757,12673439,78738,39369,39369,DddJ7EWCmYEEZETCBNgAUSg81Ls6fZtiAaY5ekJ5sXx1,3149544,21448818,-18299274,621
2022-01-10 09:34:23-05:00,3327,Cs2YxkuqBK1kjoYZbUZdUcxapPbv8oC75trwGgWoCPfG,2PgHQM1GhHykE4bQ1ggueAw2Zs1BFUW5hxvMvr8DojKM,True,71013303,17753325,110008,55004,55004,3zqXX6kzhkbW3d4TwD2CNjMRwxTbREXySekvq37kfCNk,4400321,40164634,-35764313,619
2022-01-10 09:34:23-05:00,3328,F1JT1p2VuwK4L7zj7NNnZtYiZiNUCcTGKDkgdoX3BZdZ,3BKe4yzTwnnBnvTWP3britpPJ4oAWL7JZJzNLCxjUufS,True,6556,1639,10,5,5,4BnQKPLuE3DMTtxp8MjUBytgnhvxqq3ZTqZHTVZo4JJh,409,1646,-1237,623
2022-01-10 09:34:25-05:00,3329,4j19AEcDwhtAZrnoDc4epNPmEL1jPpVUMeg7RmQ72Qkb,84WB42AAGbczVE9txZPwXrx4FD5jP87r8QdDzEABTm5G,True,66199261560,16549815390,103478668,51739334,51739334,72FwbpFGoLEazJEdpqNtPNefsadUrimUqma9wSoy4qiS,4139146742,37929785192,-33790638450,625
2022-01-10 09:34:32-05:00,3330,CK3ocyWzXQkJJZQmM6bBK4Nv6Rh3UEufjY6DvNU6gJZy,C924o4GY3p2BHLeAbFbe9SEysXqCUyD8sFu2d4NzkAV7,True,6566870,1641717,10184,5092,5092,4BnQKPLuE3DMTtxp8MjUBytgnhvxqq3ZTqZHTVZo4JJh,407366,2515632,-2108266,620
2022-01-10 09:34:32-05:00,3331,2PzBAkdXkrwH9VuoMALumQz86qkW7sSBQtCrHw14JUp3,D5vwWAMHVooobG2sCWv9EwtJrAFZG6cwKH4dfmA98tbt,True,2621020,655255,4040,2020,2020,4BnQKPLuE3DMTtxp8MjUBytgnhvxqq3ZTqZHTVZo4JJh,161616,1144305,-982689,616
2022-01-10 09:34:33-05:00,3332,X5SF9srgzDgBRBhv8xUWyszYYSQiqFF6cVnVLWzQgp1,7rTqnMkPuUUJFt5px1DxwsUK8U5fQUtnx9N4v6dA4vGb,True,33333,8333,51,25,26,3zqXX6kzhkbW3d4TwD2CNjMRwxTbREXySekvq37kfCNk,2059,14502,-12443,617
2022-01-10 09:34:34-05:00,3333,7D4rFmGMPKNAF75VRPxHAhSn2wTjiW8jmth1UD22Xqq9,GQ7BrT6vsXu8tHCMm75YdxFR2r9QTCrCUbdPEZBSAg9w,True,48303783,12075945,74777,37388,37389,4BnQKPLuE3DMTtxp8MjUBytgnhvxqq3ZTqZHTVZo4JJh,2991099,17692403,-14701304,619
2022-01-10 09:34:34-05:00,3334,7vKmhLV45Q5etXhJL5ng8rxWhYSiUCDmAbGnwBPr7zcx,cP6xPeuHLnjr858QK1F9qYn7rJpEbPy7wEJHoju6oV7,True,43615681,10903920,67425,33712,33713,DddJ7EWCmYEEZETCBNgAUSg81Ls6fZtiAaY5ekJ5sXx1,2697000,18856703,-16159703,618
2022-01-10 09:34:34-05:00,3335,FX5sizQGZcDCaETDyJ3HbLxFwhu4t9bX6YyQM7cVEo9Z,6EqnCsv1JPjz6JX1yLNcf74rmkuhAUx6Sf35QMYGuuF6,True,220843643,55210910,341263,170631,170632,3zqXX6kzhkbW3d4TwD2CNjMRwxTbREXySekvq37kfCNk,13650549,93376546,-79725997,618
2022-01-10 09:34:34-05:00,3336,EhANPABkSw9x9WnsDEi8pCg67iQTX2UGTTUpyjADTwdN,4FKLi98hyg9ZjM4MY6ctJsv7B6vPUnTYWdhrnNoYsztX,True,10109506,2527376,15642,7821,7821,4BnQKPLuE3DMTtxp8MjUBytgnhvxqq3ZTqZHTVZo4JJh,625692,5446939,-4821247,618
2022-01-10 09:34:34-05:00,3337,Cb4zhnvig11U4GcC4kqKrnDicGgPhUpfDQB1U7hP3nPa,DiRAMrKqaevGXeXg38KnhaYBERj8tNKU7oWFJvhS32kw,True,203253,50813,316,158,158,3zqXX6kzhkbW3d4TwD2CNjMRwxTbREXySekvq37kfCNk,12662,76380,-63718,622
2022-01-10 09:34:34-05:00,3338,8W9NJfM6cqCsvR1FC8Ab8YZPSQF7bz7inxJZxWnF7GsX,3exfPuVcTnPxs8GwCtS3ruKUGveYymwGV7RXQssPiizJ,True,396661270,99165317,617861,308930,308931,3zqXX6kzhkbW3d4TwD2CNjMRwxTbREXySekvq37kfCNk,24714452,319983290,-295268838,623
2022-01-10 09:34:34-05:00,3339,i7TcF4weYcqgrRdH3GpndbEYxCxfcSfr9JWYrAUg1CF,BkDfknUir7PnSEW8auoB87PytycEFwyX5kT2GY4SGJJL,True,5328026,1332006,8244,4122,4122,4BnQKPLuE3DMTtxp8MjUBytgnhvxqq3ZTqZHTVZo4JJh,329775,4386444,-4056669,618
2022-01-10 09:34:34-05:00,3340,2d1qyEJRyGvB2H83ACSqUjqYLwcLHcURHWAKLXs4w9vp,EFA6rDFpTQcY2vjZMq6Qrjv56nJPN2FhWXNwFzkWtE2M,True,11426901,2856725,17659,8829,8830,DddJ7EWCmYEEZETCBNgAUSg81Ls6fZtiAaY5ekJ5sXx1,706395,6363719,-5657324,618
2022-01-10 09:34:34-05:00,3341,GhV3DChNShu8mGwUUy7VLidabCV6Y2aKdp7cqPynd6Ci,8R8QkgruGRCeE1pjXmn3WjdVDiawNbXFid8gU8BfabZA,True,17968,4492,27,13,14,3zqXX6kzhkbW3d4TwD2CNjMRwxTbREXySekvq37kfCNk,1116,7488,-6372,621
2022-01-10 09:34:35-05:00,3342,5Z3ZFCA65WoWhm3okRuuziEMi7ajGAEHWUFchzBNba5S,FcomdrWidygkxMKzcsY5xELbmwC652uMci648LMTv7AB,True,12532,3133,19,9,10,3zqXX6kzhkbW3d4TwD2CNjMRwxTbREXySekvq37kfCNk,782,5304,-4522,624
2022-01-10 09:34:35-05:00,3343,DrzTARa7RK8RXoxHZPKCBqYtMC8TAUHRw8SznXRKTa5M,FYANet92VhyXkKZqqBJR4sFxuCftWb68sgQU9VHCdTJk,True,33278,8319,51,25,26,3zqXX6kzhkbW3d4TwD2CNjMRwxTbREXySekvq37kfCNk,2065,13847,-11782,620
2022-01-10 09:34:44-05:00,3344,E1wp3bmkcY3eiEYyGYwhTCsr7BZ7RfPa5DJTZFupcFwj,452hVdYkD5SDDrA6hv6DLPFvyS8PvR2P6DPNScGxWTsW,True,812583,203145,1261,630,631,4BnQKPLuE3DMTtxp8MjUBytgnhvxqq3ZTqZHTVZo4JJh,50451,364030,-313579,620
2022-01-10 09:34:59-05:00,3345,9RtNbEZ4ZR8T1HFF4cujPVy2kejVBKFo3CPQi8psSa1q,7zwaGb71jKc9y2HKCKy5q2XV2YUphkyU1hkDaab1GBas,True,118870744,29717685,184978,92489,92489,4BnQKPLuE3DMTtxp8MjUBytgnhvxqq3ZTqZHTVZo4JJh,7399156,31959728,-24560572,622
2022-01-10 09:35:02-05:00,3346,Bsr6kx1B6BSEd5UnJ7Z61M49iUb3bFrDVhiEtMVtPDF2,3CFd1pUJAJPA9fobwn4Jj2mRju1CWmoop4Mh4znypNWT,True,27989882,6997470,43174,21587,21587,3zqXX6kzhkbW3d4TwD2CNjMRwxTbREXySekvq37kfCNk,1726984,10957244,-9230260,617
2022-01-10 09:35:02-05:00,3347,GufVttJatW8NLeztT1NRQSLZpQNRk45kaG41p3QcWhx7,GTJUsWoWRyeafYJVhx2aRo8NE94U5UrBjaehmJ4PRUhn,True,26828880,6707220,41909,20954,20955,3zqXX6kzhkbW3d4TwD2CNjMRwxTbREXySekvq37kfCNk,1676372,8589992,-6913620,624
2022-01-10 09:35:03-05:00,3348,6NJFN855M3Q3RLTDNo57gTgAmwPD6G2E3WvMb1m5eNCN,3YpqNnonsvXaRT4nCC3G5FZx1jjVtbDPc36LiR6WK5jR,True,72732030,18183007,112901,56450,56451,3zqXX6kzhkbW3d4TwD2CNjMRwxTbREXySekvq37kfCNk,4516070,43333863,-38817793,620
2022-01-10 09:35:11-05:00,3349,75ycx5sUFBxDhY1uwuPCW22s2C6BydkJTje7q7zEQFGT,FpEgrVFRubjGK4DRjTqdVbxSECURpn16zfpoC31NbwnN,True,6422935,1605733,10014,5007,5007,4BnQKPLuE3DMTtxp8MjUBytgnhvxqq3ZTqZHTVZo4JJh,400571,3468873,-3068302,623
2022-01-10 09:35:12-05:00,3350,AKxRtcdpi7gWhAuL8ENj7zhgeQezzEXe9TSANE6bQoRA,2YH4vrU9deP8Cu6E8Hzf8GqKG1yVjv5pdz4FE7r5YKir,True,6896220,1724055,10760,5380,5380,4BnQKPLuE3DMTtxp8MjUBytgnhvxqq3ZTqZHTVZo4JJh,430426,2948999,-2518573,624
2022-01-10 09:35:12-05:00,3351,2NHv3c4ufYGo3xNr6KXymAZJdpfURrNiCKbXZ7s82Vwo,E4NYpYgHTvSG6LqH2bBV9Q1XJ6pAzCp9FLSKMzJmYRrQ,True,26057142,6514285,40469,20234,20235,3zqXX6kzhkbW3d4TwD2CNjMRwxTbREXySekvq37kfCNk,1618791,14334644,-12715853,621
2022-01-10 09:35:12-05:00,3352,9TL17gjvWFdhSJkpXgfnX7fKF9c2hfw59k3g8WUqm8Cb,7TyxFBKG4z5Xv3js3n1gbEWWj1M9KBF7dEmFxjCPGidC,True,186336114,46584028,290740,145370,145370,4BnQKPLuE3DMTtxp8MjUBytgnhvxqq3ZTqZHTVZo4JJh,11629627,65197513,-53567886,624
2022-01-10 09:35:19-05:00,3353,89CkXnSZnr52Zsoh48efv9MQacrkB6GMtrbEpNJSyA2H,HcvRBS4Z22CpYgDNgm4TVF4AVXFDuYzBUAFcdHAwdpg4,True,3019384,754846,4703,2351,2352,HfEnetJ7uBSmZWCjBNxdvv9HEC5nsW4wDV7wu6WnhWan,188138,1293530,-1105392,623
2022-01-10 09:35:28-05:00,3354,GaEpNGa8jnwSRvjzzEMYkZe1pKcr2eiZtePrqFxpABjB,5CFZHuyWbJv14zPdX5dSQDREgHrCb4vsFvB6hLiEe3Ji,True,153435,38358,240,120,120,DddJ7EWCmYEEZETCBNgAUSg81Ls6fZtiAaY5ekJ5sXx1,9605,66411,-56806,625
2022-01-10 09:35:28-05:00,3355,H1Z83zVoskNuBvYao1FjdLfETfhPpQFQUkniJfGxbaNz,EVqbBRV6Zy1tPLRevxpAykp8Mvv6tDZVTc4RmCKw4Gq1,True,774664076,193666018,1198081,599040,599041,4BnQKPLuE3DMTtxp8MjUBytgnhvxqq3ZTqZHTVZo4JJh,47923271,379382961,-331459690,618
2022-01-10 09:35:29-05:00,3356,BgnsCfJ54ReunUtwPJLzkW4PWnqpBDWGNYxsW5PvDrbK,KpMqEkQ9dKMgCevsEK895wHd3fCLRPSzDmJSv3tKU4u,True,13833459298,3458364824,21131613,10565806,10565807,4BnQKPLuE3DMTtxp8MjUBytgnhvxqq3ZTqZHTVZo4JJh,845264549,5464215275,-4618950726,611
2022-01-10 09:35:29-05:00,3357,DkvR2xUPMyXWGGkUSmDSfhp7RtvMkfbT1ThKCS3TwrXd,F7jYV6TtT1LZ5XCNn1zkbUfNMo4gGcQUczAQy1jLHpaW,True,581295727,145323931,893012,446506,446506,72FwbpFGoLEazJEdpqNtPNefsadUrimUqma9wSoy4qiS,35720492,261581624,-225861132,614
2022-01-10 09:35:29-05:00,3358,D64rDiWT3YG28fCgXCmbNjYa2JakZbpKQ1D2XuLChUfV,8WmMWq8cTsGQym5pUbHm9dPCpJugBeWUMVERYFGLxWHj,True,34044967,8511241,51134,25567,25567,3zqXX6kzhkbW3d4TwD2CNjMRwxTbREXySekvq37kfCNk,2045381,12491090,-10445709,600
2022-01-10 09:35:30-05:00,3359,8xQ3tsWVUe75EG1HmocULJ3kh52utveoFMEPotTGrKno,i3SKW3ywrwYucX9ySEx1C4zaUKGnzLerP3V38437NyV,True,56512376,14128093,87394,43697,43697,4BnQKPLuE3DMTtxp8MjUBytgnhvxqq3ZTqZHTVZo4JJh,3495792,27533030,-24037238,618
2022-01-10 09:35:31-05:00,3360,GJ3PbEfPK8jjrPgMmZtvN5fMSSy2dtiiAtZ8wcfgxVuc,FCUDVFb2TjDvehHE8fVBofqSykpb9W6Afc9QeHtj7te7,True,77323453,19330863,120176,60088,60088,4BnQKPLuE3DMTtxp8MjUBytgnhvxqq3ZTqZHTVZo4JJh,4807063,44177710,-39370647,621
2022-01-10 09:35:32-05:00,3361,Ar5QB4VBcUyzSCG23z2QNAbrWY55NbHCr1MNN6P2GAmh,BusFGTiDrJmxzwGUxWz9b3SFF3eseqtgh2DRHqyAwyVe,True,465738,116434,723,361,362,3zqXX6kzhkbW3d4TwD2CNjMRwxTbREXySekvq37kfCNk,28944,210242,-181298,621
2022-01-10 09:35:33-05:00,3362,8swGZMrPrLAxZd7MxTbkCL13k3DmAJUw41jCp6Xo6awW,3fKnX7yTNXAT4uMmXVdTy47ALJT8h8YSD3WiBb4BGuzH,True,221459418,55364854,340254,170127,170127,3zqXX6kzhkbW3d4TwD2CNjMRwxTbREXySekvq37kfCNk,13610162,102175833,-88565671,614
2022-01-10 09:35:34-05:00,3363,2BH44k4TYoQSqsSs5EASqJhxpH17Fr8Ahxbg2MAkWa72,HwvvVWpqfN7NDsVYdxbCSbqxSrLCThwnJiZQHh2w2zJb,True,18060,4515,28,14,14,3zqXX6kzhkbW3d4TwD2CNjMRwxTbREXySekvq37kfCNk,1124,7606,-6482,622
2022-01-10 09:35:36-05:00,3364,DY6k3Dkwe18iLneaT8Xo3VpJWB6V4jWwQQjoDvEzdg2j,3GGV7S9FpRQGbARBXkvGFVqLrmw8JvYAcpnR1aKVUY2f,True,11819008,2954752,18252,9126,9126,4BnQKPLuE3DMTtxp8MjUBytgnhvxqq3ZTqZHTVZo4JJh,730098,7102706,-6372608,617
2022-01-10 09:35:36-05:00,3365,2rCRdyfi65rpxRRmg7knaSb8t55FuPt3h8wF4Fzhy8MM,CLVY5nSG3jTdRo7tRSKgK9DJgW6aswfWKe4tLxzsENmb,True,634377,158594,989,494,495,3zqXX6kzhkbW3d4TwD2CNjMRwxTbREXySekvq37kfCNk,39585,243490,-203905,623
2022-01-10 09:35:37-05:00,3366,D3mXrJzhHf8qRaoCKLschUxAFoijFCFuT6bmNZH4W7Cj,9E3Xtqw7TncXWnbhAbFJMtuNmP6WS3ooGuptzyzw7UpA,True,58258,14564,91,45,46,72FwbpFGoLEazJEdpqNtPNefsadUrimUqma9wSoy4qiS,3643,33580,-29937,625
2022-01-10 09:35:38-05:00,3367,8vva9SmKpMGW8wjpkvydQczxVK6VtN79qzH2i4JQSwg4,F8a3GLicsSapt4aLURoU4qHxJaxCij4LS6JVxoMF3YHT,True,967006,241751,1512,756,756,4BnQKPLuE3DMTtxp8MjUBytgnhvxqq3ZTqZHTVZo4JJh,60498,286347,-225849,625
2022-01-10 09:35:48-05:00,3368,3JrhHRs4UkkuMoCrQAaAGKZQrWoU72zWArnDGxKFESzH,8yREVE3kMYB7UAwtUDnTDK3egXTuTsN4igtJ5yeHYkCP,True,386348791,96587197,601896,300948,300948,DddJ7EWCmYEEZETCBNgAUSg81Ls6fZtiAaY5ekJ5sXx1,24075870,113059834,-88983964,623
2022-01-10 09:36:12-05:00,3369,DDsY5V3F9wnEGBoQFCEf1hvEYuKUaJdysbc7TxhNqe9G,5oBCGzvy8odB8MCxCUvPDqYCnTyteZ4Yy1JDroroygbi,True,70400610,17600152,109817,54908,54909,3zqXX6kzhkbW3d4TwD2CNjMRwxTbREXySekvq37kfCNk,4392700,18304327,-13911627,623
2022-01-10 09:36:14-05:00,3370,8aKqLY7GXxNnGRK8Utke7o6EDGZATNDDF8Ph9Q27ppyi,7MQKkebLEzQgjWjByBMzzkn68yqtYivS4VDcraAScZR6,True,999848,249960,1553,776,777,4BnQKPLuE3DMTtxp8MjUBytgnhvxqq3ZTqZHTVZo4JJh,62145,313640,-251495,621
2022-01-10 09:36:17-05:00,3371,8Xt3qHjZG3zLxozgM5vPHMVxp8eYFMg89kaVW7vdHKoA,2i8riSsQpfADD9LUVpiBJBfX5qjVAgmZegzfKx6RG9dW,True,53526239,13381559,83492,41746,41746,3zqXX6kzhkbW3d4TwD2CNjMRwxTbREXySekvq37kfCNk,3339697,17748048,-14408351,623
2022-01-10 09:37:03-05:00,3372,56488NdcUy6Hi6X5SLs2GFtW5pG4u5wJpH7vHdxTCx4z,tGgXjJeVr3W2m3T2NXPCqpBEd6HJKE2cRsgCyiDZQy4,True,37123153,9280788,57787,28893,28894,4BnQKPLuE3DMTtxp8MjUBytgnhvxqq3ZTqZHTVZo4JJh,2311485,18582523,-16271038,622
2022-01-10 09:37:37-05:00,3373,2mfcg17QocKKvDcqDH88TwxHRiS8dAQiJAGoAh1brns9,8aQLELBgaA9eXsxSciMjxWv8B1hpbUPfLwqVjEnasZbe,True,156344532,39086133,243709,121854,121855,3zqXX6kzhkbW3d4TwD2CNjMRwxTbREXySekvq37kfCNk,9748367,43231125,-33482758,623
2022-01-10 09:37:38-05:00,3374,BZxJ6CtrVoiU86DMMieMeDFLNWtMpHGTvZfM7nyay6o4,6CRxRR8bisRLHFJBFWjyumYuy7j4C4PkjYH1K8gXhdWD,True,3590094,897522,5604,2802,2802,HfEnetJ7uBSmZWCjBNxdvv9HEC5nsW4wDV7wu6WnhWan,224179,1172557,-948378,624
2022-01-10 09:37:42-05:00,3375,B9WJfmrYEkVH3L1UWz4qqWpaexHydymbzvEfwNVtB9BV,6mQb4yzGq8jE1NbweKCKSbevnnYVhHYxyc6Gz2a5kJLn,True,319944145,79986036,489464,244732,244732,3zqXX6kzhkbW3d4TwD2CNjMRwxTbREXySekvq37kfCNk,19578571,76780290,-57201719,611
2022-01-10 09:37:42-05:00,3376,8trFFwvXKKMwMx952ugCZmqyw29e1HxEKBuQmFn8ZwTf,FsD7gCvHXM3QchQiDcd292ksy5afZMWApneNTat5ndeS,True,285301580,71325395,442009,221004,221005,3zqXX6kzhkbW3d4TwD2CNjMRwxTbREXySekvq37kfCNk,17680375,68126585,-50446210,619
2022-01-10 09:37:46-05:00,3377,aTkGURJptmKNNP6RSXSWsmVbfcriSAJaMuUiT2eZEfb,5qoGxL83PLhrguyk27X8xE6jGitRg5BaQpXzrcfEvCfJ,True,194856829,48714207,304652,152326,152326,4BnQKPLuE3DMTtxp8MjUBytgnhvxqq3ZTqZHTVZo4JJh,12186088,72342285,-60156197,625
2022-01-10 09:38:33-05:00,3378,243SAnGxchCVB1LQAUF4SsozR86yDwEdg2QQpbWGsMYe,5u8sNkb2oEQjUXJAB3yGStmv3Uwz16gBgExBo5myVK4b,True,10072560,2518140,15722,7861,7861,HfEnetJ7uBSmZWCjBNxdvv9HEC5nsW4wDV7wu6WnhWan,628887,3908496,-3279609,624
2022-01-12 07:32:05-05:00,3379,8G3MZPpXc9r39cFuEPoeVhG5jiJchAD6FfUZEu1Ua5q9,Cym1s8kog2DysSqRjccnDDtnnVbyQmGNnmv3Jk85wcGn,True,11330833558,2832708389,17425155,8712577,8712578,HfEnetJ7uBSmZWCjBNxdvv9HEC5nsW4wDV7wu6WnhWan,697006215,2027839774,-1330833559,615
2022-01-12 08:41:51-05:00,3380,2VTYgeeefRGR3R14ywsrn7h3Q9NcCVesVrbK11QKEzSu,FKJUBEkabSEXMmSanm85TDF9zy8Gf2MWEy9Ku2chMqcy,True,69754523,17438630,108061,54030,54031,DddJ7EWCmYEEZETCBNgAUSg81Ls6fZtiAaY5ekJ5sXx1,4322466,12366990,-8044524,619
2022-01-12 16:25:03-05:00,3381,8AhMgKNmKmYtDnc6YCvK6GRmbEM8RmbAkjSSCdJz4Mag,CVBS4BZMTrc7QemUujwAmS9fh7EgNxsUD14w9WNgyKNu,True,7478853953,1869713487,11667137,5833568,5833569,DddJ7EWCmYEEZETCBNgAUSg81Ls6fZtiAaY5ekJ5sXx1,466685486,1318870385,-852184899,624
2022-01-12 16:25:36-05:00,3382,2VTYgeeefRGR3R14ywsrn7h3Q9NcCVesVrbK11QKEzSu,FKJUBEkabSEXMmSanm85TDF9zy8Gf2MWEy9Ku2chMqcy,True,53211445,13302861,83168,41584,41584,3zqXX6kzhkbW3d4TwD2CNjMRwxTbREXySekvq37kfCNk,3326722,10255808,-6929086,625
2022-01-16 13:52:28-05:00,3383,JCBhqqPQxP1Xc41sSY6e1sQKRstHhe7D1v6rLz4hp3Qp,DWMUq2bMD1jqpxHtyXDFjcAwjA27yyMRe68hGcsK143m,False,1970,1970,0,0,0,DddJ7EWCmYEEZETCBNgAUSg81Ls6fZtiAaY5ekJ5sXx1,0,2948,-7592,0
2022-01-17 22:11:25-05:00,3384,3XZLp6JyrQYnufa1obczXqmK6cNR29ZMW1FdCYbWNTCP,8kUTi1Prio14m9LjCj6Mari6pXwJTYkE1mp21LMn235p,True,472623,118154,730,365,365,3zqXX6kzhkbW3d4TwD2CNjMRwxTbREXySekvq37kfCNk,29200,122042,-92842,617
2022-01-18 09:21:45-05:00,3385,EcjCYJWTXn3LfpgJ9EbdVYQyR35QfWdBjsMdX8V9gBn6,8oMpGUjxhnQ8HATVWJCeSzyodTyBHt3u8YSbJsKV4f3J,True,24278053960,6069513490,37696174,18848087,18848087,DddJ7EWCmYEEZETCBNgAUSg81Ls6fZtiAaY5ekJ5sXx1,1507846983,5541008740,-4033161757,621
2022-01-18 09:34:20-05:00,3386,4mB2DVbQVqVk535v98Cj8SPNg1tTc3DFyY2Q7VBbY645,HXo255k3RgsTGsc4hiP6ZTXUspBTqJ37duQa5eK7tqp3,True,513316801,128329199,796591,398295,398296,HfEnetJ7uBSmZWCjBNxdvv9HEC5nsW4wDV7wu6WnhWan,31863644,183772959,-151909315,620
2022-01-18 11:43:10-05:00,3387,3XZLp6JyrQYnufa1obczXqmK6cNR29ZMW1FdCYbWNTCP,8kUTi1Prio14m9LjCj6Mari6pXwJTYkE1mp21LMn235p,True,347191,86797,543,271,272,3zqXX6kzhkbW3d4TwD2CNjMRwxTbREXySekvq37kfCNk,21729,93207,-71478,625
2022-01-19 02:16:51-05:00,3388,EcjCYJWTXn3LfpgJ9EbdVYQyR35QfWdBjsMdX8V9gBn6,8oMpGUjxhnQ8HATVWJCeSzyodTyBHt3u8YSbJsKV4f3J,True,15907418550,3976854637,24884068,12442034,12442034,3zqXX6kzhkbW3d4TwD2CNjMRwxTbREXySekvq37kfCNk,995362756,4174982972,-3179620216,625
2022-01-19 02:44:49-05:00,3389,EYt1Pzqfwnd4iXSmcpw4T3Edmm1y3GnRhCjcQEEK4Atj,EHqporfvvfg7UQPsjv5tsgZE8u9yyRuEU2DdLpQeXy85,True,41004240008,10251060002,64106863,32053431,32053432,3zqXX6kzhkbW3d4TwD2CNjMRwxTbREXySekvq37kfCNk,2564274540,7940285310,-5376010770,625
2022-01-19 03:34:50-05:00,3390,FfpzVu4rcnwxNbx9EoNpZ4LmCYTjhYTkhwrUGCpnSJvh,5rRoUEuDVtaXQBH9xvq4vUvPWJDytFoEByNrcWfiq1E8,True,398327,99580,621,310,311,DddJ7EWCmYEEZETCBNgAUSg81Ls6fZtiAaY5ekJ5sXx1,24870,90219,-65349,624
2022-01-06 23:24:26-05:00,2367,5jin5wXjQQ25nGM2ECrCXcg1a95vquh6kM7rMRru6Ke7,EKM657EQ8HWWgf4cssByoYHoXGjFfTspTKXAGmygAPQG,True,117594432,29398608,183786,91893,91893,4BnQKPLuE3DMTtxp8MjUBytgnhvxqq3ZTqZHTVZo4JJh,7351457,48426062,-41074605,625
2022-01-06 23:24:27-05:00,2368,ES1MDwRUa3hoToPKQiiZkzMYe9PDVnAQwMrEvZrzvnc1,C4wBG3xTDkmDQneB28xYnf1aBNEeq7UB8oR7NuEfLkFg,True,86087140,21521785,134648,67324,67324,3zqXX6kzhkbW3d4TwD2CNjMRwxTbREXySekvq37kfCNk,5385939,23586544,-18200605,625
2022-01-06 23:24:29-05:00,2369,5RvNKzSeJ1fvqsKpcQu25evEZGmKjyEDgwsMZkykoT3P,BRqSGfE4XHXu4HrinwetWumfVTmr82iuF6Y5oSV6eMiK,True,458649,114662,716,358,358,3zqXX6kzhkbW3d4TwD2CNjMRwxTbREXySekvq37kfCNk,28678,126906,-98228,625
2022-01-06 23:24:42-05:00,2370,6dr65yANjSMmfBeKAuSxG3i16S9vMgF1CQ3zDyzh55Pn,EhrE5QpnshD41S4zPEBy2A5q2Gs2mwUrbHGo6WnT9zDP,True,1045661,261415,1630,815,815,3zqXX6kzhkbW3d4TwD2CNjMRwxTbREXySekvq37kfCNk,65226,443398,-378172,623
2022-01-06 23:24:45-05:00,2371,GGGyesjbt7h2XHHp9u8vpiWGugFwEbrtYaKrNQSDhQd7,8tydo1ZjGHmPBSqU33tywB3f9szdsHk1ckGFe4Ay5pgs,True,157757234,39439308,245681,122840,122841,4BnQKPLuE3DMTtxp8MjUBytgnhvxqq3ZTqZHTVZo4JJh,9827267,104243698,-94416431,622
2022-01-06 23:24:48-05:00,2372,6u6bPgAmK8ufACrQV99A1Y5nhGkue3KEUHmQQkcNkxwP,7636yXT5w4DcVpc7LJdN46aiggzSq6U2GXHXL5kyy9F3,True,370688954,92672238,578555,289277,289278,3zqXX6kzhkbW3d4TwD2CNjMRwxTbREXySekvq37kfCNk,23142209,152295286,-129153077,624
2022-01-06 23:24:49-05:00,2373,3Lv2XpiD4KBUHq7Zx6u3zNhpXoySodXHH8o8f5yaaPxG,H6TN4rhpBXkEH3mZnymYNcKfmnxRH2uzfwzeLH2q6ahP,True,583648,145912,911,455,456,GAUsoe8ZTCiGPm2hYxRPGxcPe5ShNzHK9eE3G2zgRjxd,36464,208552,-172088,624
2022-01-06 23:24:58-05:00,2374,2QStaRnbSnDhA891Lb1bxjVeMYpJUpNdqaVkw3rqU45V,DakRWPnttPoRcjY5V7WLwiwBx39BapCo9Atog8dL17Ku,True,7076412,1769103,11049,5524,5525,3zqXX6kzhkbW3d4TwD2CNjMRwxTbREXySekvq37kfCNk,441971,1803062,-1361091,624
2022-01-06 23:25:14-05:00,2375,6CeKxTJvFqhyNEyzySiBBKEwYVMe7j3A6nkMes4BW6o2,DzDR9XvwY1z7ygQ8YrCXrwDGHSf67JZF8BzUnuFE2fxQ,True,13675478,3418869,21372,10686,10686,3zqXX6kzhkbW3d4TwD2CNjMRwxTbREXySekvq37kfCNk,854911,4050228,-3195317,625
2022-01-06 23:25:53-05:00,2376,3njiRuSRMXRzKmamyiR72Hc38PU8UDDmWdfPhgxmGxEW,5WoF3gkgygyNNbwxWgVfqGWkExcDixuzgJQQjXEZQ6J5,True,796642128,199160532,1241056,620528,620528,3zqXX6kzhkbW3d4TwD2CNjMRwxTbREXySekvq37kfCNk,49642265,477805855,-428163590,623
2022-01-06 23:25:54-05:00,2377,8MKNsuGVaoYpdQy6NNyxDvRzh2DAquBUtri4nDsixUxs,D7M1SDmpZAs8vdPCCCa96UbDF15YQDxHmoGWB57tHiir,True,12927402,3231850,20149,10074,10075,3zqXX6kzhkbW3d4TwD2CNjMRwxTbREXySekvq37kfCNk,805985,5669283,-4863298,623
2022-01-06 23:25:54-05:00,2378,5PbrpM9kjzF4R2eW2UTcRVXnhqWdRQWHZJXKLN43N8WC,6ip4ocbyHusy8CsVvcrpiRCUp2nq9cY8bHpTcUU3Wztq,True,24730218,6182554,38599,19299,19300,3zqXX6kzhkbW3d4TwD2CNjMRwxTbREXySekvq37kfCNk,1543998,8846813,-7302815,624
2022-01-06 23:25:56-05:00,2379,8VnGmfop6qcUezAJ2M15jz2Nn6mPQgehDcJPvypq4XJn,6F6sqXNhgkW9ev8QNMm4ydywUUmemhwgydRQYNeqyUmi,True,33070133,8267533,51580,25790,25790,3zqXX6kzhkbW3d4TwD2CNjMRwxTbREXySekvq37kfCNk,2063239,25243159,-23179920,623
2022-01-06 23:25:56-05:00,2380,FpqCxvTkSiwDwD5qEt6hXJxzFDLFLAQ8VevK8zwRqYun,A3p6YQisCJKpNkF7vkjZRbEfbnUt7vTZdR2zPBUSdTkk,True,1281813131,320453282,2000963,1000481,1000482,3zqXX6kzhkbW3d4TwD2CNjMRwxTbREXySekvq37kfCNk,80038522,380411126,-300372604,624
2022-01-06 23:26:08-05:00,2381,DAku12iueL13vRoTpKLyqdGaLQ2rWF6REe8Dr8soFvNs,H2vVH3LxkhGe6x6Mdwy67BYwTKNQM6XayKx7mhrwyfJM,True,1392700,348175,2174,1087,1087,3zqXX6kzhkbW3d4TwD2CNjMRwxTbREXySekvq37kfCNk,86997,592738,-505741,624
2022-01-06 23:30:52-05:00,2382,C2Dmfw4G8KKzFq38aRH2pLCRngnGZDvUUN3fHDMjFkoG,7kzJk3BTNvY3hGFNj7nDy9L5CAYus6eNiCAxWH8dSioX,True,1158759,289689,1812,906,906,3zqXX6kzhkbW3d4TwD2CNjMRwxTbREXySekvq37kfCNk,72483,604477,-531994,625
2022-01-06 23:32:12-05:00,2383,6eBSLXDMVoW2nG3n7s42RXDH8byY3C6n1RsUuegBLSrG,37dYrKnTXYer7Bu9xFfpArA4ZNo2B9bycFw9HywDtTRx,True,30958334,7739583,48437,24218,24219,3zqXX6kzhkbW3d4TwD2CNjMRwxTbREXySekvq37kfCNk,1937495,12283202,-10345707,625
2022-01-06 23:32:34-05:00,2384,6uZobpBuFcQeYgZ4dApFi6iy4DB9GLHP1AAsQcCj6212,SGGFiPjjhscwroiWMqY4jTAHFw8eakpsEv35wNoHUPY,True,420572731,105143181,657014,328507,328507,3zqXX6kzhkbW3d4TwD2CNjMRwxTbREXySekvq37kfCNk,26280566,128719288,-102438722,624
2022-01-06 23:32:48-05:00,2385,8NdcaYUC1X5CP7FMDip78uqtqmCt8GcZdCzLRTYTihmb,9Ei1K9bXWXSXcBfeX5exPSXGCAu62WSKzvnnd4wHvyVh,True,409951,102487,640,320,320,3zqXX6kzhkbW3d4TwD2CNjMRwxTbREXySekvq37kfCNk,25637,149525,-123888,625
2022-01-06 23:32:52-05:00,2386,2FrqGFZjbiNykJyo9BZ5S9FguQJPJiTi681rJJsQ5dta,3QUncYP92NKrfpaTvuF9iQg11PXKgZAgEngwh6BbnCCj,True,2576566,644141,4018,2009,2009,3zqXX6kzhkbW3d4TwD2CNjMRwxTbREXySekvq37kfCNk,160743,879368,-718625,623
2022-01-06 23:32:57-05:00,2387,2VyFcgZDH1HTEvD1XaWhwqBCMmZ1k6TmZ3fEpPcBZR9E,G1wFJETTpdoc7CfypGCzkq1jssXPfUkiuLjK2cwVZ9dJ,True,251064,62765,392,196,196,4BnQKPLuE3DMTtxp8MjUBytgnhvxqq3ZTqZHTVZo4JJh,15697,107447,-91750,625
2022-01-06 23:33:03-05:00,2388,EF6H6aW1p3qcAtiLFU9rbFYfsKfD683meHXDw8hLdaZK,8vfJbpnK7SQcjpEBCzZJRW8JosNbsmTeJ2YXZCbM225c,True,307897420,76974355,479926,239963,239963,4BnQKPLuE3DMTtxp8MjUBytgnhvxqq3ZTqZHTVZo4JJh,19197060,93588736,-74391676,623
2022-01-06 23:33:22-05:00,2389,F2v1YwVAwXLiUgsJ5uwn4qAAkTXitn1E75fJcPnGuAcy,5rdJ4H5GxPg4Juu77mGc7uya5LwEqLzDSRyG8mQ2mDbK,True,60154581,15038645,94063,47031,47032,4BnQKPLuE3DMTtxp8MjUBytgnhvxqq3ZTqZHTVZo4JJh,3762554,24808454,-21045900,625
2022-01-06 23:33:35-05:00,2390,Fd2HrzBAr4JobRPARZwpQHHVoSCEoog32A6tKMWAC1sK,BYappsar5sQf8VLem4wrLuTtrDFH9y8pEx1aMxfuU4Pq,True,93924368,23481092,146934,73467,73467,4BnQKPLuE3DMTtxp8MjUBytgnhvxqq3ZTqZHTVZo4JJh,5877364,38726808,-32849444,625
2022-01-06 23:33:41-05:00,2391,8sneA6wAg6geVDJ1g7YWg4R1PfjuRVzeHp1nUBJinhZa,14i1uWtmcTjrdbg3DSr9vzd5NBnxqsn1A4QdgFBZqeYM,True,378280,94569,591,295,296,HfEnetJ7uBSmZWCjBNxdvv9HEC5nsW4wDV7wu6WnhWan,23650,138625,-114975,625
2022-01-06 23:33:55-05:00,2392,8RmB8o4zux2sD48dEsKpsX475KRxTwdk8QULUDU9xx8R,AKSiZnb4YKVB6B86aPPqvyXquhvN9xqt45bexBCZ7nx,True,197585849,49396462,309202,154601,154601,3zqXX6kzhkbW3d4TwD2CNjMRwxTbREXySekvq37kfCNk,12368115,95940638,-83572523,625
2022-01-06 23:33:58-05:00,2393,EmGW2aAG69ssWqCtbfDocRaM2u3TJsczn2HHP9jdmRvD,aypkDKsp9uqAB4F6mwvm5LofpsrFBuZT2MMWtE2eHdB,True,2013578,503394,3147,1573,1574,3zqXX6kzhkbW3d4TwD2CNjMRwxTbREXySekvq37kfCNk,125890,781726,-655836,625
2022-01-06 23:34:03-05:00,2394,6tFQaTqqffino9kwMZTL2xVNBG8k9VREFhXqVi2si3A3,3w3wGxBbS4bmXeqmvd595SAWFeXekVpnH4UdbeEs8Sx5,True,13667287,3416821,21324,10662,10662,DddJ7EWCmYEEZETCBNgAUSg81Ls6fZtiAaY5ekJ5sXx1,852971,4056479,-3203508,624
2022-01-06 23:34:03-05:00,2395,BJaaH1SK1pF2kZQzmYpLFfDtm52CR9a5rd39RAPtLe8q,HUsT5FVxaisdnCvG1BQxX6zffjfL2Rwx5mMo5y8SDV7e,True,126396948,31599236,196353,98176,98177,3zqXX6kzhkbW3d4TwD2CNjMRwxTbREXySekvq37kfCNk,7854146,29000292,-21146146,621
2022-01-06 23:34:03-05:00,2396,Br1j5Ftafei7ysu5SmqVZSoRe4uS4qCPeKSPHg55pyiE,G8fc7QvXjfkgBFvAVUgJFQS3VaF1biL9rktBExGa87Ks,True,8649926901,2162481724,13519467,6759733,6759734,DddJ7EWCmYEEZETCBNgAUSg81Ls6fZtiAaY5ekJ5sXx1,540778696,3076033572,-2535254876,625
2022-01-06 23:34:03-05:00,2397,6yw4GPvkqUbakcEWtqSCfjVLukty11xqjDpGxtEN9Km2,5ppEx7wkpqbG5nApCWMdRja3oRSheFmAAsNHUX7h2w2Y,True,5149336,1287334,8029,4014,4015,4BnQKPLuE3DMTtxp8MjUBytgnhvxqq3ZTqZHTVZo4JJh,321169,4019824,-3698655,623
2022-01-06 23:34:07-05:00,2398,ANQkPUoMjLHyRtypeKzxsKW1DFauQsh9SnB3rRgRXM1Y,7RHAExWpG8Q3PXwKhJs2yXmYK9WogGydvFYpx28p6pgr,True,226190481,56547620,349519,174759,174760,3zqXX6kzhkbW3d4TwD2CNjMRwxTbREXySekvq37kfCNk,13980768,111625071,-97644303,618
2022-01-06 23:34:08-05:00,2399,46TNhGwBVzedW8xSb9UY94HNeSom9iGiZzAjrKHiRM2G,7JVTiqNYeKHbyzRkKtvSEpqLPKykZso8cGUr3sX1j7QF,True,138566504,34641625,214976,107488,107488,3zqXX6kzhkbW3d4TwD2CNjMRwxTbREXySekvq37kfCNk,8599058,43424813,-34825755,620
2022-01-06 23:34:15-05:00,2400,gMjmD7WioyUdQdwNqE5fobLcxPwoJv5rAvLmJaf8Jjw,5n77euFjVJiwKrnbYq1KpcENW1mzBZj2BuDGyzazrkJ8,True,2892920,723230,4524,2262,2262,3zqXX6kzhkbW3d4TwD2CNjMRwxTbREXySekvq37kfCNk,180983,1079636,-898653,625
2022-01-06 23:34:18-05:00,2401,J2gTwrYpzezkRupgBtgudQn5D33x6WjeBhTHnrA1qgqa,FBzoHRwqGRjnMvPEpiZVjtGZYJmAbneE4dpToXPzy8bv,True,107950565098,26987641274,167458528,83729264,83729264,GAUsoe8ZTCiGPm2hYxRPGxcPe5ShNzHK9eE3G2zgRjxd,6698341146,32925444851,-26227103705,620
2022-01-06 23:34:19-05:00,2402,AHm7zF4rpaxaayBLn5QDHgJSp8KAr647s4cNvQ9wLgd7,FDM33WngED24pukBvSDpPAzinW6afVAeGReum5nyLRiC,True,2575188,643797,3880,1940,1940,3zqXX6kzhkbW3d4TwD2CNjMRwxTbREXySekvq37kfCNk,155233,1108700,-953467,602
2022-01-06 23:34:25-05:00,2403,9zpPiboHF5HW7NfCx7hYdmJGwUomVMTiUFc4Um5KrDi3,8q3eBpuwV6dMNkib9N8XQAq2tBUcjSANRe5SXpd4dFhZ,True,25538321,6384580,38923,19461,19462,3zqXX6kzhkbW3d4TwD2CNjMRwxTbREXySekvq37kfCNk,1556939,6950516,-5393577,609
2022-01-06 23:34:25-05:00,2404,9UyQC8vc6zJJaSdnjvTAzgmcsw4fC3xFBBiCC1w9Sbjx,3ppBfboe6FPmt7f6WrivspMUoAznZKWQMeh3rCgw7vjQ,True,27878138,6969534,42621,21310,21311,4BnQKPLuE3DMTtxp8MjUBytgnhvxqq3ZTqZHTVZo4JJh,1704878,7573380,-5868502,611
2022-01-06 23:34:25-05:00,2405,pgzvXpnUYiY7hLrfjmwScqLd8oj9vYcXpFvpm4y4JvG,GdqdQgoyBAFuXdbvoZyDhB3jyqJzVo4nkGh7EPFxkBF2,True,6595513,1648878,10241,5120,5121,3zqXX6kzhkbW3d4TwD2CNjMRwxTbREXySekvq37kfCNk,409678,5192486,-4782808,621
2022-01-06 23:34:25-05:00,2406,67Z7ZGhNu5xxEh9BYKWcXp9m1T4tFiE1o1M16hCzUWQA,CT7YKWixz7BhTbvg5F6M5HCyPGnHoFLNFuDV9GhoLTo3,True,10164908,2541227,15717,7858,7859,4BnQKPLuE3DMTtxp8MjUBytgnhvxqq3ZTqZHTVZo4JJh,628687,5033591,-4404904,618
2022-01-06 23:34:25-05:00,2407,6nJyqvFKprwaVCE1gAa2P4RHKc6Pa6XFSJymx654zZ9K,4e7iJmdwzAPxp1Zi8Azo38YyPQdPKqqY4VLJyQ5rpdYP,True,7797678,1949419,12177,6088,6089,3zqXX6kzhkbW3d4TwD2CNjMRwxTbREXySekvq37kfCNk,487082,3382254,-2895172,624
2022-01-06 23:34:25-05:00,2408,DdYgcyV1T2CDYiQVr4VL9Ym8RdKm93a7SKy8HxuyaoMW,GPdAeqeXb1UJ56AttcwwY1CyFhRyfptDC4BAX2Tc8MpE,True,1645306,411326,2571,1285,1286,4BnQKPLuE3DMTtxp8MjUBytgnhvxqq3ZTqZHTVZo4JJh,102848,707316,-604468,625
2022-01-06 23:34:25-05:00,2409,E8ifvhmyJGBGVQomo3AnZw2UcaLHcpGsTtuoCid8voU3,FMQUWTbTAfSLfrc6GTrz4DM2ZSgoxF3KtqGn8AyjVtsf,True,22137402,5534350,33722,16861,16861,4BnQKPLuE3DMTtxp8MjUBytgnhvxqq3ZTqZHTVZo4JJh,1348884,6478898,-5130014,609
2022-01-06 23:34:26-05:00,2410,2F45BX9mRmtNCHPejKFknN5aNgGvR4vVLFjMaY1a7dR8,ALdSutsvEFRUEQGGBbi31QywTL1pdXSDWrNJzvNTaoXL,True,77992237,19498059,119467,59733,59734,GAUsoe8ZTCiGPm2hYxRPGxcPe5ShNzHK9eE3G2zgRjxd,4778688,30940515,-26161827,612
2022-01-06 23:34:32-05:00,2411,CvZssqscu2dm35mwcE3zg9zedavbRjVJjWD59Py5ExUK,7pXaoR6aHKYofCmg1eHipygNYDteEaf8rbbS8BDYGQK6,True,2189391,547347,3381,1690,1691,3zqXX6kzhkbW3d4TwD2CNjMRwxTbREXySekvq37kfCNk,135245,651700,-516455,617
2022-01-06 23:34:41-05:00,2412,A2ZUT3A9EjtCkzcZveEvWF3pPwNVqdXkHK3fsNRAg8VX,4137TfTDDzK71KN2ZzJaoRPJDQDKQewSPdmZfKrxdVPD,True,198820042,49705010,309769,154884,154885,3zqXX6kzhkbW3d4TwD2CNjMRwxTbREXySekvq37kfCNk,12390790,55584548,-43193758,623
2022-01-06 23:34:44-05:00,2413,CRaKcudjkQiSw5YPVjTLVdXvJskeGiHSYtq5ZcMPJhgQ,AgqTg3b3bAcaBmRidhNC4Uf9ZwNbeH52RQEqumWyuUs7,True,2708672,677168,4210,2105,2105,HfEnetJ7uBSmZWCjBNxdvv9HEC5nsW4wDV7wu6WnhWan,168421,1418925,-1250504,621
2022-01-06 23:34:53-05:00,2414,864zY9zuCktUurPTtdGeLvUATnDqHZpT1GeWUApsXh2m,CzatBrNJUi7MeyfbNhszRaPMidgt8Xkcmy5ZwFMP9RCs,True,64340227,16085056,99136,49568,49568,3zqXX6kzhkbW3d4TwD2CNjMRwxTbREXySekvq37kfCNk,3965462,25433327,-21467865,616
2022-01-06 23:34:53-05:00,2415,DmrkajG3SrTXnYSYxGRfkzfvhkevD6RdtFk4SdLC2G6Q,5r7vkWH985E2mGSDBtznduhuu5PbZJ7d4zxjzhzEEZG1,True,102261383512,25565345877,158160637,79080318,79080319,4BnQKPLuE3DMTtxp8MjUBytgnhvxqq3ZTqZHTVZo4JJh,6326425487,42652304875,-36325879388,618
2022-01-06 23:34:55-05:00,2416,Ckqos6cdncPKj13DnCmDVZsZTqp6eS7277CRrT9WhcEr,AtUV8m7VQJvZq7GLCAHMf3jV7iamKEPnWVZHWuuVZQp1,True,3881988,970497,6031,3015,3016,3zqXX6kzhkbW3d4TwD2CNjMRwxTbREXySekvq37kfCNk,241259,2034558,-1793299,621
2022-01-06 23:34:56-05:00,2417,DmEVzPyCKnm89v481V2ic57vyikwwMja75uVZ2rjvjfp,38fPZzP4NwTtx7Qu6DLSqx9Sv8e5CQbSrr2BMvVmSy4J,True,73721311,18430327,112206,56103,56103,HfEnetJ7uBSmZWCjBNxdvv9HEC5nsW4wDV7wu6WnhWan,4488268,36335134,-31846866,608
2022-01-06 23:34:56-05:00,2418,9vcKW1GfrDZ3KLPh2pEVFF8ZyKqD1pJW1hiE8H98Av7S,C6Ki27mo4sCHu6u8UnR1p7WSgsTjFQxGGR9Lk9n5Rhjq,True,8685830,2171457,13472,6736,6736,3zqXX6kzhkbW3d4TwD2CNjMRwxTbREXySekvq37kfCNk,538905,3539701,-3000796,620
2022-01-06 23:34:57-05:00,2419,HVZkXeDR3mc8oB9qFFwCK4RXpPojdcHk9tRGep6xtKGK,Bh3py7awPejWqeTMxtAgF7mPotL2Asxf8YrYJykq9nBt,True,20618421,5154605,32152,16076,16076,3zqXX6kzhkbW3d4TwD2CNjMRwxTbREXySekvq37kfCNk,1286108,7366468,-6080360,623
2022-01-06 23:34:57-05:00,2420,BWtXpiXn1bomr28mGfQFTx1Kd58CQipEnKmeweYowDEC,9jws1qkXvWAdEtBvURVEeGcGJzt4zG2gh8AJESvjKKrx,True,334024614,83506153,492757,246378,246379,4BnQKPLuE3DMTtxp8MjUBytgnhvxqq3ZTqZHTVZo4JJh,19710309,160416604,-140706295,590
2022-01-06 23:34:57-05:00,2421,CBL2NbekJrXvBiAcoj4fzQ4PfLDwTntW7Zt4nruHFYEw,59EvfgYTdKkfjUJz5LddLUAqbEdLaihcMzjcrTZsyzyS,True,29253,7313,45,22,23,3zqXX6kzhkbW3d4TwD2CNjMRwxTbREXySekvq37kfCNk,1821,10216,-8395,622
2022-01-06 23:34:57-05:00,2422,zLTuMVfVswjMkhyvjaXnvjcKXv5xNk3iSWSjRGpVqXf,J3D8NHUJCiSjvFYfJ5Es4YDhF1KcPZWRUmCQ5L92t8eB,True,380575983,95143995,594148,297074,297074,4BnQKPLuE3DMTtxp8MjUBytgnhvxqq3ZTqZHTVZo4JJh,23765939,127756377,-103990438,624
2022-01-06 23:34:57-05:00,2423,M69XSefqeum2arinvHEqmA3L2XHWNFN17p4msRhRZXf,2vK15yYUANLSbAoiBfgJ9VLyqsmtEpd2iNytQjms8GaQ,True,847152507,211788126,1316982,658491,658491,3zqXX6kzhkbW3d4TwD2CNjMRwxTbREXySekvq37kfCNk,52679299,467406427,-414727128,621
2022-01-06 23:34:57-05:00,2424,6oroGB3mvzK3tDfiB9X2NJuL3x476pxhgRnt7VxqhdLo,2SoK8tKkLn2ppKURpTVazKsCEis4uahkHMsac1m85J4r,True,5600999,1400249,8716,4358,4358,HfEnetJ7uBSmZWCjBNxdvv9HEC5nsW4wDV7wu6WnhWan,348647,4238881,-3890234,622
2022-01-06 23:34:57-05:00,2425,D7XummfEc3NTK4qMvZegV3FrYuqc8mNgnQu3ujwemZtg,HHiRcecqzW7sGFTio7Ph6TYv3dGt64KWv4DEKgKm84fQ,True,24654804,6163701,36856,18428,18428,3zqXX6kzhkbW3d4TwD2CNjMRwxTbREXySekvq37kfCNk,1474261,10012757,-8538496,597
2022-01-06 23:34:57-05:00,2426,8WHDaiE6LqFFmCVMnPeLEQ99R6ft8b74UfmP9BqzjcE8,CGmoDGsdnjo3zMNrW78n2xxQr1aDPAiBYiXbyciLXYMu,True,629195504,157298874,950995,475497,475498,3zqXX6kzhkbW3d4TwD2CNjMRwxTbREXySekvq37kfCNk,38039820,224151120,-186111300,604
2022-01-06 23:34:57-05:00,2427,DvuRmJkfn6FQczUKgYeaSCqwy2NTMunuAKNrnmxMvnzS,7LpWTX9dgBtW75kfEoB5WuNsDwEdw5s8CYSHh3J4qagM,True,279603725,69900931,426470,213235,213235,3zqXX6kzhkbW3d4TwD2CNjMRwxTbREXySekvq37kfCNk,17058822,114813883,-97755061,610
2022-01-06 23:34:57-05:00,2428,DMgPzJnMQfvpk6LWscs9V9CwnYDj4CEUgKB9S65WsTaY,BZRSLH1Vw1BQwXTZtBcgUYqmFF7TuzYxAaZ8TXUKwLUQ,True,20028,5007,30,15,15,3zqXX6kzhkbW3d4TwD2CNjMRwxTbREXySekvq37kfCNk,1210,9553,-8343,604
2022-01-06 23:34:58-05:00,2429,5SwL5U5hhQXPW1HXFf4GuU4xkmXoAKx58pjY53NPHqWS,7zB7JvYFzEEwawJy7k7NXvBSG3UsbQte7JxgwvBNbS7U,True,611494738,152873684,906453,453226,453227,3zqXX6kzhkbW3d4TwD2CNjMRwxTbREXySekvq37kfCNk,36258153,291629418,-255371265,592
2022-01-06 23:34:58-05:00,2430,cQqH5PtXgtCk1Vs96PgxDxzUZf2Cfx5F63j1Nkz19cs,2VVizb2qVtj8ZEpLSmJXz9hXnAiGD7GdhBxT32PbFjAY,True,74966,18740,115,57,58,3zqXX6kzhkbW3d4TwD2CNjMRwxTbREXySekvq37kfCNk,4610,22461,-17851,614
2022-01-06 23:34:58-05:00,2431,6cnA7PeqQgpZdA7jBg4yMzTusm8JJHRWBMup84ywJfYo,FLqcukY7RehqY6ACrwVJnGH3eRgRDe93K1jLYCQN2F3U,True,250462102,62615525,376893,188446,188447,GAUsoe8ZTCiGPm2hYxRPGxcPe5ShNzHK9eE3G2zgRjxd,15075727,121451341,-106375614,601
2022-01-06 23:34:59-05:00,2432,DC4UVUDFWL3gVtgkX9hPtFgtxaA8DH5p94i4k9U3wyWv,3HCWqVvQQfRgSKitsTjGTduJ82ointZUSNtj13uea4kD,True,5772802264,1443200566,8966424,4483212,4483212,3zqXX6kzhkbW3d4TwD2CNjMRwxTbREXySekvq37kfCNk,358656960,1674029034,-1315372074,621
2022-01-06 23:35:04-05:00,2433,CagSUfZLwXuCdypC4KzU6FSNdmCj9dKDroPcNeaRtsyt,yxw5d1ztZuEUY2QjL7eLpr72QJAj5rJd6ERvg91cy1m,True,5055596,1263899,7853,3926,3927,3zqXX6kzhkbW3d4TwD2CNjMRwxTbREXySekvq37kfCNk,314140,1583478,-1269338,621
2022-01-06 23:35:04-05:00,2434,2jPxG5FL6D6XEJsRszJ9cmQ54AWSpZyPFSbn3DpWBSuM,3toQou4UVNvyWYvMvkuv379RVEF2aN2TzCpKKBUqeQV6,True,603492284,150873071,936944,468472,468472,HfEnetJ7uBSmZWCjBNxdvv9HEC5nsW4wDV7wu6WnhWan,37477770,211562725,-174084955,621
2022-01-06 23:35:05-05:00,2435,2FEbsetZMkRqLjSC8GBbgecKgX5T1T1fci2sLQux29p8,H722Fcd6DkTFRZxqQWbPDufBfXEgmFfhiEpQZWhxwYv1,True,15100454,3775113,23607,11803,11804,3zqXX6kzhkbW3d4TwD2CNjMRwxTbREXySekvq37kfCNk,944306,4825088,-3880782,625
2022-01-06 23:35:08-05:00,2436,5rW9kqXB9feGSKSvSMNJF1FCsBYV3vGmTmc8MvzaZ3pi,7AjnjcfPJevW5521hXw4VtgRCfHSsAqyzyArukKfNcHo,True,34370941,8592735,53427,26713,26714,3zqXX6kzhkbW3d4TwD2CNjMRwxTbREXySekvq37kfCNk,2137095,15011402,-12874307,621
2022-01-06 23:35:08-05:00,2437,U3vvMQ4X4aKzVYfhMw1V1p58HRqaLnuXozqmmefYeD9,7JA94MArkNCFRhBq8f5a32DgMF6aPdFsoC5HvXDQ6NuR,True,981562199,245390549,1534190,767095,767095,3zqXX6kzhkbW3d4TwD2CNjMRwxTbREXySekvq37kfCNk,61367635,436373682,-375006047,625
2022-01-06 23:35:09-05:00,2438,3C2MZQKh9x4zNTCMbhhvoafGaFMwUooqfy9MCgPyXs6E,AHjgWKpYPWe6ketjDHDKFBFsKQiRJ41jnkuo39MVYxZo,True,661653299,165413324,1032989,516494,516495,3zqXX6kzhkbW3d4TwD2CNjMRwxTbREXySekvq37kfCNk,41319573,326489890,-285170317,624
2022-01-06 23:35:09-05:00,2439,BZxJ6CtrVoiU86DMMieMeDFLNWtMpHGTvZfM7nyay6o4,6CRxRR8bisRLHFJBFWjyumYuy7j4C4PkjYH1K8gXhdWD,True,8938144,2234533,13816,6908,6908,4BnQKPLuE3DMTtxp8MjUBytgnhvxqq3ZTqZHTVZo4JJh,552667,2372354,-1819687,618
2022-01-06 23:35:15-05:00,2440,BrHRMouGRz3LBNzd9anfdYMhWfg8yUPHL4PqJ8WdEDFS,4uzoLa3mC2VYHAPBoHLX4gTjPTC28rPf2fvEGtJWPYc,True,190186646,47546661,295969,147984,147985,3zqXX6kzhkbW3d4TwD2CNjMRwxTbREXySekvq37kfCNk,11838763,135945438,-124106675,622
2022-01-06 23:35:15-05:00,2441,HGJoZvLakWfSDFwuvShNBc4kCf7nP7VqzyM3mELpbFEf,12Qn5jin7QvsBngXqYAv4UstyG3b6nRf1jsLp9Dp8G7k,True,50687661,12671915,79070,39535,39535,GAUsoe8ZTCiGPm2hYxRPGxcPe5ShNzHK9eE3G2zgRjxd,3162800,19211139,-16048339,623
2022-01-06 23:35:15-05:00,2442,GqAS41YJssg9aaEp3hs3sG98APCsXhiQBQszXaSjZ2bN,2wodJ3AhrXdE1T4oVL95KvoBND7PubG5Wd5GWiLCMZJU,True,593624455,148406113,925378,462689,462689,4BnQKPLuE3DMTtxp8MjUBytgnhvxqq3ZTqZHTVZo4JJh,37015120,427309111,-390293991,623
2022-01-06 23:35:17-05:00,2443,Hy3kzXneDN6FUkiZctU1vWe97BYvj6yZ7QvQzehfWmNr,EhXgQg8BTniANV525RpY76z7Hrh6DuqrMChjqEoXfVJe,True,4033129,1008282,6251,3125,3126,4BnQKPLuE3DMTtxp8MjUBytgnhvxqq3ZTqZHTVZo4JJh,250042,1748440,-1498398,619
2022-01-06 23:35:17-05:00,2444,7PzGZgzieFyyFs1dbajkNQgVxooFUNZrj1bUsQvrSwbp,A2gDREmSmJTBPPw3sbKVY3smC9wbHMDdv87gr4Tr2ES7,True,8887396,2221849,13850,6925,6925,3zqXX6kzhkbW3d4TwD2CNjMRwxTbREXySekvq37kfCNk,554031,3200839,-2646808,623
2022-01-06 23:35:18-05:00,2445,3qnPsgqW11AcDEmyjmJquPcPLyE3EdJQuVLJ5kinDrd3,86rZadBB7emKio76aFTahpbrFtxd9tqZ4Mxgzaavq2xU,True,493731,123432,767,383,384,3zqXX6kzhkbW3d4TwD2CNjMRwxTbREXySekvq37kfCNk,30698,177693,-146995,621
2022-01-06 23:35:19-05:00,2446,ymyzGH4Qc7HH5PbKpVphCbsQgLLXyGkPcXamQJuNj5C,8oTLHaV2XzbKXNWRuUjCfHjUn61Pw93LYK14m9q2VDpZ,True,42986114,10746528,67209,33604,33605,3zqXX6kzhkbW3d4TwD2CNjMRwxTbREXySekvq37kfCNk,2688377,13485177,-10796800,625
2022-01-06 23:35:28-05:00,2447,B4Uc39nKzz9wBRQsCkMR4A7RwTJ8rSuwpR6EQn2AesRb,H49bGZgatRZVpj6QufZRVgYrQtH7LpdbiqKBs23151m,True,80883090,20220772,126518,63259,63259,GAUsoe8ZTCiGPm2hYxRPGxcPe5ShNzHK9eE3G2zgRjxd,5060748,64342847,-59282099,625
2022-01-06 23:35:41-05:00,2448,Bsr6kx1B6BSEd5UnJ7Z61M49iUb3bFrDVhiEtMVtPDF2,3CFd1pUJAJPA9fobwn4Jj2mRju1CWmoop4Mh4znypNWT,True,95168423,23792105,147121,73560,73561,HfEnetJ7uBSmZWCjBNxdvv9HEC5nsW4wDV7wu6WnhWan,5884844,28349057,-22464213,618
2022-01-06 23:35:58-05:00,2449,BPsM1um9ZJf7eNoVMsQCRSwgARMuLCGGSDxf9tZeNeEy,BpzDdXfxVygiSYSmsHV6uPxQMeTFtrURMCCqhswQjd5X,True,3765278,941319,5855,2927,2928,4BnQKPLuE3DMTtxp8MjUBytgnhvxqq3ZTqZHTVZo4JJh,234238,1214579,-980341,622
2022-01-06 23:35:59-05:00,2450,DMgD2KCEhTGFLUZ5GnfNcwfiiwKYbyVpoWiN6knMkCAf,5KU2vgBkPTNVHsSULjgX7ZkZS56U3Dy3xqLTxL5sUZJ3,True,4452967518,1113241879,6954122,3477061,3477061,3zqXX6kzhkbW3d4TwD2CNjMRwxTbREXySekvq37kfCNk,278164905,2333907743,-2055742838,624
2022-01-06 23:35:59-05:00,2451,BYvjENe16Ta77PqGV7JKEWrsqCTfkMGYwTSG5gXneDvd,EvxAXgvhPC6QkNurbK7vWyTApGo8J2R4EgMAknkHVU3d,True,9654383,2413595,15070,7535,7535,3zqXX6kzhkbW3d4TwD2CNjMRwxTbREXySekvq37kfCNk,602820,5185299,-4582479,624
2022-01-06 23:36:12-05:00,2452,7CSCMFa9W52tBDVUbXbc3woAy3GByeA1wPJdp3MgznPa,3447ptuVFu6G8B6N63RmS8mRv4n9PfHneypHLvbeaGLn,True,345703187,86425796,540922,270461,270461,4BnQKPLuE3DMTtxp8MjUBytgnhvxqq3ZTqZHTVZo4JJh,21636916,132976809,-111339893,625
2022-01-06 23:36:21-05:00,2453,FV9CBGGTbppLnBKh79f2LzD1diTiS5g6u89FcpZHZmnK,Fe7mtmCUziFqbbYTvrhAcAq1Ub7YLfTJRtQ1hG7GzJD1,True,16991071,4247767,26586,13293,13293,3zqXX6kzhkbW3d4TwD2CNjMRwxTbREXySekvq37kfCNk,1063468,5436177,-4372709,625
2022-01-06 23:36:21-05:00,2454,9jeqT7xKb8hr5VRuQEFxnf93Y3zHsvmYDHz64nyE7Wte,9NqYMu528mFG2M7RYL1NuEvR9aiNAW13WwXDKuprQa7h,True,120256210,30064052,188029,94014,94015,4BnQKPLuE3DMTtxp8MjUBytgnhvxqq3ZTqZHTVZo4JJh,7521195,52658406,-45137211,625
2022-01-06 23:36:24-05:00,2455,6NJFN855M3Q3RLTDNo57gTgAmwPD6G2E3WvMb1m5eNCN,3YpqNnonsvXaRT4nCC3G5FZx1jjVtbDPc36LiR6WK5jR,True,246873719,61718429,378160,189080,189080,GAUsoe8ZTCiGPm2hYxRPGxcPe5ShNzHK9eE3G2zgRjxd,15126413,120794449,-105668036,612
2022-01-06 23:36:43-05:00,2456,D64rDiWT3YG28fCgXCmbNjYa2JakZbpKQ1D2XuLChUfV,8WmMWq8cTsGQym5pUbHm9dPCpJugBeWUMVERYFGLxWHj,True,115991361,28997840,180861,90430,90431,DddJ7EWCmYEEZETCBNgAUSg81Ls6fZtiAaY5ekJ5sXx1,7234456,31853578,-24619122,623
2022-01-06 23:36:47-05:00,2457,DR7XL3qweFyTKDatQYS2LacqGLv2368cnGuWpEpk4hSL,Fd3BYCiiQfThDJsxBUNwYTMP8eNCrnXMVzE1wpejJqXa,True,14893,3723,23,11,12,3zqXX6kzhkbW3d4TwD2CNjMRwxTbREXySekvq37kfCNk,928,6619,-5691,623
2022-01-06 23:36:49-05:00,2458,6rb3fRVWJ5cSzFcmuC1YwdrNxiNctvboDF7HwsfyGoCA,H6JaYfFZkRk6iSJrA4nVeuFpMVQtVwQZHVgK1TyaupTE,True,135459,33864,211,105,106,3zqXX6kzhkbW3d4TwD2CNjMRwxTbREXySekvq37kfCNk,8455,93329,-84874,624
2022-01-06 23:36:50-05:00,2459,3WcJUt8jQ1ngL3ZCGo6dFrc3GmTMTYtzeDva7mri2Tqx,HeG1Pz2oMjqtkfsRMsbqP3VpatnVEQzcWmKDVoFp4Htr,True,50673576,12668394,78980,39490,39490,GAUsoe8ZTCiGPm2hYxRPGxcPe5ShNzHK9eE3G2zgRjxd,3159215,19221640,-16062425,623
2022-01-06 23:36:52-05:00,2460,CwTus4FyoXYqyTKAYDp69NLhA1joYZ3tarzY6FFTr6fn,6ivuvYWU6i25MzJSY8rG9rPDKiq38E6QtrV1jvRubLGr,True,32680,8170,51,25,26,4BnQKPLuE3DMTtxp8MjUBytgnhvxqq3ZTqZHTVZo4JJh,2040,12014,-9974,624
2022-01-06 23:36:52-05:00,2461,Cs2YxkuqBK1kjoYZbUZdUcxapPbv8oC75trwGgWoCPfG,2PgHQM1GhHykE4bQ1ggueAw2Zs1BFUW5hxvMvr8DojKM,True,177398794,44349698,276689,138344,138345,3zqXX6kzhkbW3d4TwD2CNjMRwxTbREXySekvq37kfCNk,11067574,86770383,-75702809,623
2022-01-06 23:36:52-05:00,2462,FFoYoBmkfEsCWVXQf3BhKeaFMZD3YVKvfhPWkXdnCZS9,8yW6WApAuN43brF1HioTLdyxvQTQJzt875E26QqrWWFk,True,1729504,432376,2694,1347,1347,GAUsoe8ZTCiGPm2hYxRPGxcPe5ShNzHK9eE3G2zgRjxd,107761,403258,-295497,623
2022-01-06 23:37:12-05:00,2463,8swGZMrPrLAxZd7MxTbkCL13k3DmAJUw41jCp6Xo6awW,3fKnX7yTNXAT4uMmXVdTy47ALJT8h8YSD3WiBb4BGuzH,True,753553475,188388368,1170130,585065,585065,HfEnetJ7uBSmZWCjBNxdvv9HEC5nsW4wDV7wu6WnhWan,46805215,272992782,-226187567,621
2022-01-06 23:37:37-05:00,2464,Cb4zhnvig11U4GcC4kqKrnDicGgPhUpfDQB1U7hP3nPa,DiRAMrKqaevGXeXg38KnhaYBERj8tNKU7oWFJvhS32kw,True,507593,126898,794,397,397,DddJ7EWCmYEEZETCBNgAUSg81Ls6fZtiAaY5ekJ5sXx1,31760,156982,-125222,625
2022-01-06 23:37:37-05:00,2465,DrzTARa7RK8RXoxHZPKCBqYtMC8TAUHRw8SznXRKTa5M,FYANet92VhyXkKZqqBJR4sFxuCftWb68sgQU9VHCdTJk,True,83104,20776,129,64,65,DddJ7EWCmYEEZETCBNgAUSg81Ls6fZtiAaY5ekJ5sXx1,5182,28880,-23698,623
2022-01-06 23:37:37-05:00,2466,2d1qyEJRyGvB2H83ACSqUjqYLwcLHcURHWAKLXs4w9vp,EFA6rDFpTQcY2vjZMq6Qrjv56nJPN2FhWXNwFzkWtE2M,True,28537171,7134292,44360,22180,22180,DddJ7EWCmYEEZETCBNgAUSg81Ls6fZtiAaY5ekJ5sXx1,1774428,13733166,-11958738,621
2022-01-06 23:37:37-05:00,2467,F1JT1p2VuwK4L7zj7NNnZtYiZiNUCcTGKDkgdoX3BZdZ,3BKe4yzTwnnBnvTWP3britpPJ4oAWL7JZJzNLCxjUufS,True,16351,4087,25,12,13,3zqXX6kzhkbW3d4TwD2CNjMRwxTbREXySekvq37kfCNk,1009,3122,-2113,617
2022-01-06 23:37:38-05:00,2468,7vKmhLV45Q5etXhJL5ng8rxWhYSiUCDmAbGnwBPr7zcx,cP6xPeuHLnjr858QK1F9qYn7rJpEbPy7wEJHoju6oV7,True,108922681,27230670,168972,84486,84486,GAUsoe8ZTCiGPm2hYxRPGxcPe5ShNzHK9eE3G2zgRjxd,6758888,39525692,-32766804,620
2022-01-06 23:37:38-05:00,2469,8trkirSQNdMmAcJdeswxs5cPjH8dD6U4eJtWiAdMsrDB,HaSzpQ45x2MipfN17U6jGBxX8tXboomVDhXNSrnEfLDr,True,10736391,2684097,16753,8376,8377,4BnQKPLuE3DMTtxp8MjUBytgnhvxqq3ZTqZHTVZo4JJh,670150,3746529,-3076379,624
2022-01-06 23:37:39-05:00,2470,5Z3ZFCA65WoWhm3okRuuziEMi7ajGAEHWUFchzBNba5S,FcomdrWidygkxMKzcsY5xELbmwC652uMci648LMTv7AB,True,31295,7823,48,24,24,3zqXX6kzhkbW3d4TwD2CNjMRwxTbREXySekvq37kfCNk,1952,11073,-9121,623
2022-01-06 23:37:39-05:00,2471,2PzBAkdXkrwH9VuoMALumQz86qkW7sSBQtCrHw14JUp3,D5vwWAMHVooobG2sCWv9EwtJrAFZG6cwKH4dfmA98tbt,True,6545553,1636388,10141,5070,5071,3zqXX6kzhkbW3d4TwD2CNjMRwxTbREXySekvq37kfCNk,405641,2402204,-1996563,619
2022-01-06 23:37:41-05:00,2472,7D4rFmGMPKNAF75VRPxHAhSn2wTjiW8jmth1UD22Xqq9,GQ7BrT6vsXu8tHCMm75YdxFR2r9QTCrCUbdPEZBSAg9w,True,120636898,30159224,187388,93694,93694,3zqXX6kzhkbW3d4TwD2CNjMRwxTbREXySekvq37kfCNk,7495549,36203679,-28708130,621
2022-01-06 23:37:42-05:00,2473,6VJcr3VAEcEZaHEpt48QL8QxHKABufVp8n2JSEVTLh9U,8naR6kiySKj3vai9dCetdgCnCHgf2oyLjGqKTJ3Lz64Y,True,3770236913,942559228,5871194,2935597,2935597,3zqXX6kzhkbW3d4TwD2CNjMRwxTbREXySekvq37kfCNk,234847786,1395389118,-1160541332,622
2022-01-06 23:37:43-05:00,2474,EhANPABkSw9x9WnsDEi8pCg67iQTX2UGTTUpyjADTwdN,4FKLi98hyg9ZjM4MY6ctJsv7B6vPUnTYWdhrnNoYsztX,True,25247393,6311848,39497,19748,19749,DddJ7EWCmYEEZETCBNgAUSg81Ls6fZtiAaY5ekJ5sXx1,1579907,11723902,-10143995,625
2022-01-06 23:37:45-05:00,2475,i7TcF4weYcqgrRdH3GpndbEYxCxfcSfr9JWYrAUg1CF,BkDfknUir7PnSEW8auoB87PytycEFwyX5kT2GY4SGJJL,True,13306250,3326562,20817,10408,10409,3zqXX6kzhkbW3d4TwD2CNjMRwxTbREXySekvq37kfCNk,832711,9771648,-8938937,625
2022-01-06 23:37:45-05:00,2476,6Bq55LtGCEeGqh4JrFLCmmGc2iJfTTBJixivqH78aGSE,DSNrCgWJeNe2P9tAQu5FvCueTzNKDKds7wzuwTQSMRG,True,21412366,5353091,32953,16476,16477,DddJ7EWCmYEEZETCBNgAUSg81Ls6fZtiAaY5ekJ5sXx1,1318138,6743396,-5425258,615
2022-01-06 23:38:40-05:00,2477,CK3ocyWzXQkJJZQmM6bBK4Nv6Rh3UEufjY6DvNU6gJZy,C924o4GY3p2BHLeAbFbe9SEysXqCUyD8sFu2d4NzkAV7,True,16398271,4099567,25648,12824,12824,3zqXX6kzhkbW3d4TwD2CNjMRwxTbREXySekvq37kfCNk,1025935,5190935,-4165000,625
2022-01-06 23:38:40-05:00,2478,E1wp3bmkcY3eiEYyGYwhTCsr7BZ7RfPa5DJTZFupcFwj,452hVdYkD5SDDrA6hv6DLPFvyS8PvR2P6DPNScGxWTsW,True,2029047,507261,3173,1586,1587,3zqXX6kzhkbW3d4TwD2CNjMRwxTbREXySekvq37kfCNk,126948,767314,-640366,625
2022-01-06 23:39:48-05:00,2479,4ytoBUwuhAL4YYSCa6AgwrpeVF4eeU8H9NfDxMPZKxPo,Pby2szzsxDrXt4gnbmmaMccXxctZALr8miRtKhGKjsD,True,17280698,4320174,27042,13521,13521,GAUsoe8ZTCiGPm2hYxRPGxcPe5ShNzHK9eE3G2zgRjxd,1081689,6998663,-5916974,625
2022-01-07 00:59:26-05:00,2480,DMgPzJnMQfvpk6LWscs9V9CwnYDj4CEUgKB9S65WsTaY,BZRSLH1Vw1BQwXTZtBcgUYqmFF7TuzYxAaZ8TXUKwLUQ,False,14255,14255,413,20,393,GmqQKnMfFxkv6ChqGaZ2wmSFDow7R1x7WeRfU58GVvfw,413,7438,-7025,289
2022-01-07 01:46:11-05:00,2481,75ycx5sUFBxDhY1uwuPCW22s2C6BydkJTje7q7zEQFGT,FpEgrVFRubjGK4DRjTqdVbxSECURpn16zfpoC31NbwnN,True,16042283,4010570,25018,12509,12509,3zqXX6kzhkbW3d4TwD2CNjMRwxTbREXySekvq37kfCNk,1000746,7456195,-6455449,623
2022-01-07 01:46:13-05:00,2482,2NHv3c4ufYGo3xNr6KXymAZJdpfURrNiCKbXZ7s82Vwo,E4NYpYgHTvSG6LqH2bBV9Q1XJ6pAzCp9FLSKMzJmYRrQ,True,65081655,16270413,101326,50663,50663,HfEnetJ7uBSmZWCjBNxdvv9HEC5nsW4wDV7wu6WnhWan,4053059,30877636,-26824577,622
2022-01-07 01:50:00-05:00,2483,9jdfc9GFTecsdRuTjWFGX13niKKmeBxRgtv5j86uhSnU,HLWMShobjSkaLyXrNjgwVaUGVtbtdUSnr1XjqpXn1bLR,True,736816,184204,1152,576,576,3zqXX6kzhkbW3d4TwD2CNjMRwxTbREXySekvq37kfCNk,46104,297834,-251730,625
2022-01-07 01:50:00-05:00,2484,AKxRtcdpi7gWhAuL8ENj7zhgeQezzEXe9TSANE6bQoRA,2YH4vrU9deP8Cu6E8Hzf8GqKG1yVjv5pdz4FE7r5YKir,True,17207528,4301882,26547,13273,13274,3zqXX6kzhkbW3d4TwD2CNjMRwxTbREXySekvq37kfCNk,1061882,6170888,-5109006,617
2022-01-07 01:50:00-05:00,2485,D3mXrJzhHf8qRaoCKLschUxAFoijFCFuT6bmNZH4W7Cj,9E3Xtqw7TncXWnbhAbFJMtuNmP6WS3ooGuptzyzw7UpA,True,145470,36367,226,113,113,3zqXX6kzhkbW3d4TwD2CNjMRwxTbREXySekvq37kfCNk,9070,72649,-63579,623
2022-01-07 01:50:00-05:00,2486,HqtTbC1LFreGvgfpZe7nCqkNnh8GHPQKosfmc19zb1yi,E39UNiHNkwQEd5GXkCtTPqSorQSB1kLx8kjzK4jdFoi3,True,781758013,195439503,1219620,609810,609810,GAUsoe8ZTCiGPm2hYxRPGxcPe5ShNzHK9eE3G2zgRjxd,48784828,327733306,-278948478,624
2022-01-07 01:50:00-05:00,2487,HutRztBianNUgm9sJDWKUQBmoVyy8y7CfnNk4hHjSkEW,EtVfvPyiy5bizbCZxR19TNUgETf3QcmziBvMtc6o5zjr,True,619811437,154952859,966614,483307,483307,DddJ7EWCmYEEZETCBNgAUSg81Ls6fZtiAaY5ekJ5sXx1,38664576,475361177,-436696601,623
2022-01-07 01:50:00-05:00,2488,GJ3PbEfPK8jjrPgMmZtvN5fMSSy2dtiiAtZ8wcfgxVuc,FCUDVFb2TjDvehHE8fVBofqSykpb9W6Afc9QeHtj7te7,True,193070778,48267694,300112,150056,150056,4BnQKPLuE3DMTtxp8MjUBytgnhvxqq3ZTqZHTVZo4JJh,12004503,95540898,-83536395,621
2022-01-07 01:50:02-05:00,2489,8vva9SmKpMGW8wjpkvydQczxVK6VtN79qzH2i4JQSwg4,F8a3GLicsSapt4aLURoU4qHxJaxCij4LS6JVxoMF3YHT,True,2413837,603459,3761,1880,1881,3zqXX6kzhkbW3d4TwD2CNjMRwxTbREXySekvq37kfCNk,150458,564122,-413664,623
2022-01-07 01:50:04-05:00,2490,89CkXnSZnr52Zsoh48efv9MQacrkB6GMtrbEpNJSyA2H,HcvRBS4Z22CpYgDNgm4TVF4AVXFDuYzBUAFcdHAwdpg4,True,7536267,1884066,11681,5840,5841,GAUsoe8ZTCiGPm2hYxRPGxcPe5ShNzHK9eE3G2zgRjxd,467253,2708226,-2240973,620
2022-01-07 01:50:05-05:00,2491,Ar5QB4VBcUyzSCG23z2QNAbrWY55NbHCr1MNN6P2GAmh,BusFGTiDrJmxzwGUxWz9b3SFF3eseqtgh2DRHqyAwyVe,True,1162917,290729,1807,903,904,4BnQKPLuE3DMTtxp8MjUBytgnhvxqq3ZTqZHTVZo4JJh,72298,443088,-370790,621
2022-01-07 01:50:05-05:00,2492,JCBhqqPQxP1Xc41sSY6e1sQKRstHhe7D1v6rLz4hp3Qp,DWMUq2bMD1jqpxHtyXDFjcAwjA27yyMRe68hGcsK143m,True,17526,4381,27,13,14,DddJ7EWCmYEEZETCBNgAUSg81Ls6fZtiAaY5ekJ5sXx1,1094,6227,-5133,624
2022-01-07 01:50:05-05:00,2493,2p2fGXdKrmxjomLSnyaNg84J82cBBBNympZ6qQc8UZgU,HKAM8bazuLMUY6yapZJqYsgaWkTBqKHyMs1hSfpYsZGi,True,1980252705,495063176,3072900,1536450,1536450,DddJ7EWCmYEEZETCBNgAUSg81Ls6fZtiAaY5ekJ5sXx1,122916028,897865149,-774949121,620
2022-01-07 01:50:05-05:00,2494,2rCRdyfi65rpxRRmg7knaSb8t55FuPt3h8wF4Fzhy8MM,CLVY5nSG3jTdRo7tRSKgK9DJgW6aswfWKe4tLxzsENmb,True,1583645,395911,2452,1226,1226,4BnQKPLuE3DMTtxp8MjUBytgnhvxqq3ZTqZHTVZo4JJh,98106,501494,-403388,619
2022-01-07 01:50:05-05:00,2495,96DzqyUxsB1FKWrhLdTdjDcokuus6rbx83gLsghqPPwt,74CWb7SVoSy3ADysEzFEeMiS2fxHJ9gdUF9pzM3E52Gj,True,48675,12168,75,37,38,GAUsoe8ZTCiGPm2hYxRPGxcPe5ShNzHK9eE3G2zgRjxd,3026,17284,-14258,621
2022-01-07 01:50:05-05:00,2496,GaEpNGa8jnwSRvjzzEMYkZe1pKcr2eiZtePrqFxpABjB,5CFZHuyWbJv14zPdX5dSQDREgHrCb4vsFvB6hLiEe3Ji,True,382881,95720,592,296,296,3zqXX6kzhkbW3d4TwD2CNjMRwxTbREXySekvq37kfCNk,23685,139148,-115463,618
2022-01-07 01:50:06-05:00,2497,BzSJ77zKaqtBk2cEL1XqFL97zTXXMRHmxtkgtXwCc3C,2g4KXTwy2MPSRQ2khNp1o1rn7CradEr9H4ySYKDoSWN9,True,25405185,6351296,39727,19863,19864,3zqXX6kzhkbW3d4TwD2CNjMRwxTbREXySekvq37kfCNk,1589118,22150902,-20561784,625
2022-01-07 01:50:06-05:00,2498,9YEzjb49Awvedv9yNc6LG54SkGBug2RYiJwiUV13mGsS,3H8w5WCD187NWWoZMNUCzUDdxTgqrRJLga8gDzUVXBgZ,True,2757967,689491,4299,2149,2150,DddJ7EWCmYEEZETCBNgAUSg81Ls6fZtiAaY5ekJ5sXx1,171995,1484727,-1312732,623
2022-01-07 01:50:07-05:00,2499,4MmpDGUTyMcYEqJ1RoZ46AN2BhrBUseHaHqF8AmiTPyD,7HW2YZpYM349HMfW7u4h9ESZ1AXkwN8JcVDTNFzp9aTz,True,301907509,75476877,471269,235634,235635,3zqXX6kzhkbW3d4TwD2CNjMRwxTbREXySekvq37kfCNk,18850796,139510022,-120659226,624
2022-01-07 01:50:09-05:00,2500,2NdwSLxsGok8PczpCZj9CVX2BymNU5MvHt7hWfGetg2M,8AQbDXeA6mD9QoZBFJcYbnHvZwKNxzA9CCHLAgdSfTA3,True,26792,6698,41,20,21,3zqXX6kzhkbW3d4TwD2CNjMRwxTbREXySekvq37kfCNk,1675,12421,-10746,625
2022-01-07 01:50:09-05:00,2501,EQUZQWk4WLT6LFeWZs3P9AQufFcoZouFETfhyxvuS2JM,Byc2mLXArmkjQPWaxCJksHZD2XpZyCQ2FRtDJyztU81V,True,239031696,59757924,373576,186788,186788,3zqXX6kzhkbW3d4TwD2CNjMRwxTbREXySekvq37kfCNk,14943041,119600728,-104657687,625
2022-01-07 02:05:06-05:00,2502,DkvR2xUPMyXWGGkUSmDSfhp7RtvMkfbT1ThKCS3TwrXd,F7jYV6TtT1LZ5XCNn1zkbUfNMo4gGcQUczAQy1jLHpaW,True,1976614355,494153588,3083722,1541861,1541861,3zqXX6kzhkbW3d4TwD2CNjMRwxTbREXySekvq37kfCNk,123348881,697125526,-573776645,624
2022-01-07 02:05:06-05:00,2503,2jDRvE3pQNjWy1NRFa4tzB3KmU5UkbUCHw8sQRFujo66,C4zNi2szDrEEh4coTF3WRUghfP4ZwAVVSYTLWfkejQRu,True,1554898209,388724551,2414140,1207070,1207070,HfEnetJ7uBSmZWCjBNxdvv9HEC5nsW4wDV7wu6WnhWan,96565630,460789390,-364223760,621
2022-01-07 02:05:07-05:00,2504,DY6k3Dkwe18iLneaT8Xo3VpJWB6V4jWwQQjoDvEzdg2j,3GGV7S9FpRQGbARBXkvGFVqLrmw8JvYAcpnR1aKVUY2f,True,40200178,10050044,62248,31124,31124,4BnQKPLuE3DMTtxp8MjUBytgnhvxqq3ZTqZHTVZo4JJh,2489929,19783943,-17294014,619
2022-01-07 02:05:07-05:00,2505,8BMDSWFtzq9fu1ubVGtSFw8fEaMg1uvJiECuJnN8e1pd,FwkETAXL296CirvQ2AJuSHHtdKsxkZkmXSwZVVHXVDhA,True,327169959,81792489,505945,252972,252973,3zqXX6kzhkbW3d4TwD2CNjMRwxTbREXySekvq37kfCNk,20237815,114946621,-94708806,618
2022-01-07 02:05:08-05:00,2506,HdfQweV1KuYSpWdycZbpGrUc8yMcY3ZczLn1agKXMJaf,G1Ae1PZHkANkwFnhUKS1tvdFEv8dAFeojBkezh6rUNMh,True,17376769,4344192,27043,13521,13522,3zqXX6kzhkbW3d4TwD2CNjMRwxTbREXySekvq37kfCNk,1081735,7088019,-6006284,622
2022-01-07 02:05:08-05:00,2507,6XHt7CrURSomkQrtVXV5JuKSZY4tQRpUyQKfCDaSTYaD,GCgcmPSDDBsn2smYbpiX3PJybDkQWtufPu4YRsbEEU8X,True,848010680,212002670,1315362,657681,657681,DddJ7EWCmYEEZETCBNgAUSg81Ls6fZtiAaY5ekJ5sXx1,52614488,466483627,-413869139,620
2022-01-07 02:05:08-05:00,2508,Mcbzp1LhZwpfmXTv1pqe9D1jCKHw443j9QKp6tUpzgM,8uforSMAKEih5jHfHp3gCqCvaugtCmhzVfVHA63Akz7F,True,5015413,1253853,7840,3920,3920,3zqXX6kzhkbW3d4TwD2CNjMRwxTbREXySekvq37kfCNk,313638,2336730,-2023092,625
2022-01-07 02:05:08-05:00,2509,EeUACm9TkjHKES5U7Yj1oPhYmcp7R3tvesGBiP8txEzq,3qkmm4aS6EDirEDejmbm5PDw2jpYkC7zKqrMkmgeE5BA,True,580677,145169,899,449,450,DddJ7EWCmYEEZETCBNgAUSg81Ls6fZtiAaY5ekJ5sXx1,35965,176945,-140980,619
2022-01-07 02:05:11-05:00,2510,EV21gv8jEvXtmGDoGRNm5LJEvTBccLMZyVDCLsp54jP3,DGxxoU52aQNoUQcxdvQtv2H5q2PhK6TGkLgNSaFgnZrb,True,11212255,2803063,17338,8669,8669,3zqXX6kzhkbW3d4TwD2CNjMRwxTbREXySekvq37kfCNk,693553,4249629,-3556076,618
2022-01-07 02:05:12-05:00,2511,AtKuDfcFXqWUMnRqQpjedUMTb5CQKLc2zoqEAcQpysKQ,9bPFLYp5TDZruLLDXDYYCiPYcD982iF8xt5rfTkqwNsL,True,27974,6993,43,21,22,4BnQKPLuE3DMTtxp8MjUBytgnhvxqq3ZTqZHTVZo4JJh,1737,9719,-7982,620
2022-01-07 02:05:48-05:00,2512,9WJBnVi84E926j7xEd566WzrZJkPJWRgmEnYj9vyjuad,4dLaFS5F7TGyLdwuJLMGkz3bSL53aHzd9ZfpNmhHxXeF,True,49816533,12454133,77023,38511,38512,4BnQKPLuE3DMTtxp8MjUBytgnhvxqq3ZTqZHTVZo4JJh,3080921,21509357,-18428436,618
2022-01-07 02:05:48-05:00,2513,8E3K7vCHJ2xjdFofPRGLbMxrkm8UYEi926QmXPAFwsqe,4qHUDA1c43Dg4qi1ZPKqmpGYiEMUZ6r4UuzB5ftHCEhW,True,4596990507,1149247626,7067197,3533598,3533599,HfEnetJ7uBSmZWCjBNxdvv9HEC5nsW4wDV7wu6WnhWan,282687903,2009247791,-1726559888,614
2022-01-07 02:05:51-05:00,2514,4uygLJDk9DFCifJ56YwMrEsvd3oQNq8tYSLnMCyWorS6,GimL4uKGvg3FFmFQSWzAcjstv3Vmk5NMgDGMKTuXYVpB,True,1682053934,420513483,2609241,1304620,1304621,DddJ7EWCmYEEZETCBNgAUSg81Ls6fZtiAaY5ekJ5sXx1,104369674,575250927,-470881253,620
2022-01-07 02:05:51-05:00,2515,D9VKhnfLLCrntDGFYSfoxFaY76VnHmYZ1ZbyFXdKdibz,2hRCRH2pMDyQGYcXHa8Y6BZo6FbcGZf5VJC1v8Bp6tGa,True,298313074,74578268,464081,232040,232041,4BnQKPLuE3DMTtxp8MjUBytgnhvxqq3ZTqZHTVZo4JJh,18563247,92564552,-74001305,622
2022-01-07 02:05:54-05:00,2516,A4tDE948CPFPh1UwHb8sXryfKktbxZ8BCkqXgA5DJHA8,3zXeKMrsEpCe5fQumLNzCgpxcG1kLJFEAtJuqxLsC6ZG,True,281018646,70254661,436793,218396,218397,3zqXX6kzhkbW3d4TwD2CNjMRwxTbREXySekvq37kfCNk,17471748,103718088,-86246340,621
2022-01-07 02:05:55-05:00,2517,399591e8XgY52yCMorCQ2WL6dQZTC485ZooHtmGuirhZ,JCiXAooFmKmEPQ2S7C8iSk6CLcTyrPEe1SsPSLyUGySe,True,3472002,868000,5391,2695,2696,HfEnetJ7uBSmZWCjBNxdvv9HEC5nsW4wDV7wu6WnhWan,215643,1726550,-1510907,621
2022-01-07 02:05:55-05:00,2518,8kJu5aqVSmW8FSZR9h6F75ftn9V2U9uMLBEKeqRaC855,FhVHByujkvwwtjTVpZ4mqSUqoMoBgeLUc5H7rbz3FgAt,True,286666808,71666702,446362,223181,223181,3zqXX6kzhkbW3d4TwD2CNjMRwxTbREXySekvq37kfCNk,17854480,142563826,-124709346,622
2022-01-07 02:06:06-05:00,2519,CFFpbRxYEP18rqEGxxyG3bzSV13Lv7nfSmZvtUK17kCP,824UwqH2JcFsqYBk9MZ8tTnpka9udTL6WGX35YFtAJQk,True,8898596,2224649,13884,6942,6942,3zqXX6kzhkbW3d4TwD2CNjMRwxTbREXySekvq37kfCNk,555382,3181640,-2626258,624
2022-01-07 02:06:06-05:00,2520,7LRBswSEDBjJzQ4YurfTxLydh7tFS2jVn5V95Z6wL7ci,fD41VYGmk66MW46KKb23vAqQvUSDScgXnVdsHhJBZzu,True,295645,73911,453,226,227,DddJ7EWCmYEEZETCBNgAUSg81Ls6fZtiAaY5ekJ5sXx1,18128,127945,-109817,613
2022-01-07 02:06:06-05:00,2521,FSduW743jAGyyn8HTifEJitgb89Spp5gEeMXDE59aEHF,HjojGNpR3ACtLCP2mP8DKGyXj6SeqWPKjcCAofcyQpsm,True,463602775,115900693,712722,356361,356361,3zqXX6kzhkbW3d4TwD2CNjMRwxTbREXySekvq37kfCNk,28508896,147269069,-118760173,614
2022-01-07 02:06:06-05:00,2522,6WNPf4rFCX74PuyvdmzRFqbxWhguuxTQqBSdnaTVBd5D,9N7a9aiHGQsxFMgVbmWoCF9w95d12xyT7XFAwpHGkTLA,True,3777896,944474,5761,2880,2881,3zqXX6kzhkbW3d4TwD2CNjMRwxTbREXySekvq37kfCNk,230464,877570,-647106,610
2022-01-07 02:06:06-05:00,2523,5hUZ9uQFcYnjAQVVaGLJWdKyg7y1XMpoo8osQ9DeY7Xd,BdYiKWsjuzJLcHh3814mJ4xQ9JxoQKKcr7AHZ7Vxoavq,True,101782,25445,158,79,79,DddJ7EWCmYEEZETCBNgAUSg81Ls6fZtiAaY5ekJ5sXx1,6340,38025,-31685,622
2022-01-07 02:06:08-05:00,2524,CAkknoa9UFPMEZ1KWSfqtmnL7ArVNV3HRETLwecuuXP,4cHJYv3dxA6qjcuxUkGRuL7STWobGPKtoHFD4ACUbiWq,True,26272557,6568139,40412,20206,20206,DddJ7EWCmYEEZETCBNgAUSg81Ls6fZtiAaY5ekJ5sXx1,1616497,9354248,-7737751,615
2022-01-07 02:06:09-05:00,2525,C7a8BtMjuLXkzxZBC4Wk2gjkGBmucLmDjokf9pyA1Mu6,GxwYNWwYTtFMUxuZvNC5qrEYuJzYiEURQVuBxssfCJzr,True,3846444,961611,5938,2969,2969,4BnQKPLuE3DMTtxp8MjUBytgnhvxqq3ZTqZHTVZo4JJh,237527,891085,-653558,617
2022-01-07 02:06:09-05:00,2526,8VT2nxz5ZYDJFd9uL2XZwEXxChd9pjuMJNMAcutZubL1,EhAkiRbouzUAWtqQFsN8HEEfi46UVN8H8tyBP7CbgeLe,True,23020,5755,35,17,18,3zqXX6kzhkbW3d4TwD2CNjMRwxTbREXySekvq37kfCNk,1407,9580,-8173,611
2022-01-07 02:06:19-05:00,2527,FnAT8HKGgisYfeAbxKU2gSbCp8KbZHULRpaJX1NVijHy,2u637Crc2QzfSJmCnRNqeib3aZQVn4NGncpgM3Ph6jvm,True,111188070,27797017,172878,86439,86439,3zqXX6kzhkbW3d4TwD2CNjMRwxTbREXySekvq37kfCNk,6915128,29722339,-22807211,621
2022-01-07 02:06:19-05:00,2528,s2NgHqXLYtUrRaA6LnDwmxcS5nqfURXw47DmLy7Pn9E,2qn4QbLj5miEB2zZB4v5dhptm3JRbpQRrpTBgPDzokw1,True,5298929,1324732,8139,4069,4070,3zqXX6kzhkbW3d4TwD2CNjMRwxTbREXySekvq37kfCNk,325585,3575794,-3250209,614
2022-01-07 02:06:28-05:00,2529,8mbMH9EKd9kQDyFrYiDJCV9VaWxWCzpZBQZLyYN2yNVx,J9gT39dF1egMeQvweXYWeRAX3kpmBABijYZhfj6M2UqU,True,56409999,14102499,88220,44110,44110,3zqXX6kzhkbW3d4TwD2CNjMRwxTbREXySekvq37kfCNk,3528813,16719944,-13191131,625
2022-01-07 02:07:31-05:00,2530,ZoNjrSjYh4NJLW38LUPcf7jtEBxdaaM7T1zp795qjHE,FZx6v8cU25NwEosbKJ2n141o9uFAWURZB7NeCeX1trEn,True,3530327,882581,5488,2744,2744,4BnQKPLuE3DMTtxp8MjUBytgnhvxqq3ZTqZHTVZo4JJh,219533,814207,-594674,621
2022-01-07 02:07:31-05:00,2531,Buioe5v3DyFwD9nquW5XdYeVYbSABCyg79eUHEvtvfaW,7T9gi7prCcZJkYJMSB5Ef6Bu4pAuBw4XLvumSFnqKDSi,True,1635042,408760,2536,1268,1268,DddJ7EWCmYEEZETCBNgAUSg81Ls6fZtiAaY5ekJ5sXx1,101460,807295,-705835,620
2022-01-07 02:07:31-05:00,2532,CEbGTNX6WpaoKp4RBGSn9LzYM6yAYyeiMrgVYgJxA4zb,AiXUcGAFFm4tc7vKBscSNjZawV5YJqbv7D1KpxD3Zufg,True,45809339,11452334,71125,35562,35563,DddJ7EWCmYEEZETCBNgAUSg81Ls6fZtiAaY5ekJ5sXx1,2845006,22557593,-19712587,621
2022-01-07 02:07:32-05:00,2533,FsMiJiJZibohKoV5QRisWCjzuFd86xSxFb4m73AQmu93,7p3TSKBaG9SV2YNDnhutQKacPKpTTmgsEfzmK51t6sYb,True,676624402,169156100,1053529,526764,526765,3zqXX6kzhkbW3d4TwD2CNjMRwxTbREXySekvq37kfCNk,42141193,181154135,-139012942,622
2022-01-07 02:07:32-05:00,2534,C4dbwF9mioaBkZnyBFvFs6Cqd362VuGPBGPbTY9CAnAk,CcUqBfu1hbWm5VVxbtF2Xm6HUz4CLFzuDsjUi6KtnZQg,True,4110058,1027514,6378,3189,3189,DddJ7EWCmYEEZETCBNgAUSg81Ls6fZtiAaY5ekJ5sXx1,255157,945100,-689943,620
2022-01-07 02:07:33-05:00,2535,3zH1b58jqbNU37y9kDTZZrotSeT8XzS1tuyAHPKWrbah,4trxDWV16x6sVcz7bxHehYHkjjyKebh3S9fyJf8txzK5,True,17493,4373,27,13,14,3zqXX6kzhkbW3d4TwD2CNjMRwxTbREXySekvq37kfCNk,1095,6145,-5050,625
2022-01-07 02:07:39-05:00,2536,AUH6YGBV8tDVX1E1WTo92Mubfx1DGsqfGeyUBqxo4fSr,33QZgMwmW32WuvmxD8XNbmF9ea88bLe3YTtNwHV73Wwu,True,676662637,169165659,1045976,522988,522988,4BnQKPLuE3DMTtxp8MjUBytgnhvxqq3ZTqZHTVZo4JJh,41839072,186422630,-144583558,618
2022-01-07 02:07:42-05:00,2537,9KD2AifD5wFD4QkHYuawXbJgLWHrfj2QPF3fT8jhGVA5,Ga9gAqmkuHbqrr31sUFPqa1xa5WNxLWJWGPUaMxQqLdj,True,3153030,788257,4879,2439,2440,DddJ7EWCmYEEZETCBNgAUSg81Ls6fZtiAaY5ekJ5sXx1,195180,1596600,-1401420,619
2022-01-07 02:08:01-05:00,2538,A36aouot1oFLUtswuBUM4EVcis9chKaSJu53MRoPDjab,33U9gpq1RRFMGWDrWa3ezXXkwgBewdAS6QGgGVPtGvqb,True,871884491,217971122,1353123,676561,676562,3zqXX6kzhkbW3d4TwD2CNjMRwxTbREXySekvq37kfCNk,54124939,232296892,-178171953,620
2022-01-07 02:08:02-05:00,2539,3VdSA9CED9f5swRwHX2U15U7J6Muaq8VPnCNy9CaGDHe,2YYstfnfdYic5NWmEbcUEHpccNUVd1EhuCkExvMsoMk8,True,16231974,4057993,25165,12582,12583,DddJ7EWCmYEEZETCBNgAUSg81Ls6fZtiAaY5ekJ5sXx1,1006612,8119224,-7112612,620
2022-01-07 02:08:02-05:00,2540,HwosLQgDY1xtHQRQ4hzroPQHFWssPzTj5vRkP37FcviB,HKTNEYNXrephNkH7apbobK4mcQXcNayQA4W1NgM6sLr8,True,109266636,27316659,170289,85144,85145,3zqXX6kzhkbW3d4TwD2CNjMRwxTbREXySekvq37kfCNk,6811580,28604431,-21792851,623
2022-01-07 02:08:15-05:00,2541,H6tDNj9cHac223ckAnNfnC4bAJuNLBnf2pFk2iQdMzMP,28UL9dqgayCqCAexScXjdpobYGVDN44SGBVNAfBByk8C,True,154545925,38636481,241854,120927,120927,3zqXX6kzhkbW3d4TwD2CNjMRwxTbREXySekvq37kfCNk,9674184,77448918,-67774734,625
2022-01-07 02:08:15-05:00,2542,EEcTbsFTUEifcdbPyjBLkS943daEx1RpR8F3uZxKRZbT,8V3JzDQ1VWYQLas8fxUsWJZZHe4gEmn74RehtUwLw3k5,True,12363548,3090887,19205,9602,9603,3zqXX6kzhkbW3d4TwD2CNjMRwxTbREXySekvq37kfCNk,768231,5363233,-4595002,621
2022-01-07 02:08:15-05:00,2543,FjDp4bWCtqehFD7FunCrjrcdxMezTJj5aqh2VnBvHDQU,HRYeZqcqhP1RPiAGXziR1qCWwk4sF6c5ZYbvSDhX7foN,True,18525540,4631385,28747,14373,14374,HfEnetJ7uBSmZWCjBNxdvv9HEC5nsW4wDV7wu6WnhWan,1149885,6352495,-5202610,620
2022-01-07 02:08:15-05:00,2544,EgU9hX6VK7YXeCgCHVaJAMekCcyZa2MVWdKra5pN7Gwv,7y8Ad9XY34bqREvheXHT2tr8Jy11D6X3pu7yLVtjU4QV,True,22880804,5720201,35574,17787,17787,3zqXX6kzhkbW3d4TwD2CNjMRwxTbREXySekvq37kfCNk,1422991,10007991,-8585000,621
2022-01-07 02:08:15-05:00,2545,3g1debT8Z2efQPuMNSDPUNZzDqarBG2acErsZ4HP7QGA,42wDHagxr5Nno3mUx6kyYGDjwR98aedRbh3ByB468agB,True,43693,10923,68,34,34,3zqXX6kzhkbW3d4TwD2CNjMRwxTbREXySekvq37kfCNk,2734,15764,-13030,625
2022-01-07 02:08:15-05:00,2546,5BjBPqumCb9KC82ZNNch3dcRzbpGdRLJneru7o9a1D9R,FuZtBWKktxFu4yoiLVMzxq8fMhQyN8SGzGPz49xs3m6P,True,340340325,85085081,530646,265323,265323,HfEnetJ7uBSmZWCjBNxdvv9HEC5nsW4wDV7wu6WnhWan,21225843,148677052,-127451209,623
2022-01-07 02:08:15-05:00,2547,DiPSJvnnEwg1En7HJfEsKrUbBgtUf4KzGMyMCZDQSYgp,s8UVC6vPBofuXUS6RW1aQmZ8C35PrC5r4A6ugmvzLGB,True,4493201,1123300,6989,3494,3495,3zqXX6kzhkbW3d4TwD2CNjMRwxTbREXySekvq37kfCNk,279571,1036372,-756801,622
2022-01-07 02:08:16-05:00,2548,2ce2v2TCbjNH635NgbwTG3sqiRWYrRRaBpxPxBZJ929q,9cnoebT43FkWDFhidndGCVNiFD4NErv8DuL1Va4Jv9S8,True,13898435,3474608,21697,10848,10849,3zqXX6kzhkbW3d4TwD2CNjMRwxTbREXySekvq37kfCNk,867915,9720604,-8852689,624
2022-01-07 02:08:16-05:00,2549,4FazDUgfQ3AKoFcnWHr8E9Ht8jLA3tkxf75yrGZVHdmF,HzRMH6mbgEKydRCnnMvSsKgTEVNQi6nuzoR1xutYFdzg,True,141596,35399,221,110,111,3zqXX6kzhkbW3d4TwD2CNjMRwxTbREXySekvq37kfCNk,8861,92354,-83493,625
2022-01-07 02:08:35-05:00,2550,93ho4cgnpAJiJsG6uu2udkLVNU7rkz4QjCYfsqvpbPA5,45ouQn9gGwXqnTGfaP5CvU8fCKadBRA5kPwtfvJzykRU,True,146551977,36637994,229198,114599,114599,3zqXX6kzhkbW3d4TwD2CNjMRwxTbREXySekvq37kfCNk,9167938,44782745,-35614807,625
2022-01-07 02:09:00-05:00,2551,5kwvkEtRFFD84j4ntVgxkacadgJaFvQ9JLhJqzLR7Y3G,GpMMkTv9T7y8DTiizuoJUsWvnSk3GSxADjRMGyYpryxm,True,76061128,19015282,118544,59272,59272,4BnQKPLuE3DMTtxp8MjUBytgnhvxqq3ZTqZHTVZo4JJh,4741784,19315656,-14573872,623
2022-01-07 02:09:12-05:00,2552,7MSzV5yy5FmrM4j1BcYSRiTGWfit1AJahheRUaXzz349,aPSTZLxBpVr3sucjbj95emRV2J1GrUWr7wbARYqJkQZ,True,10270089,2567522,15798,7899,7899,3pStmNaV47N2sqUtHJHLAtCKiN9JZ6jzNY9h94ng8G1D,631956,3035002,-2403046,615
2022-01-07 02:09:16-05:00,2553,Gbxc51WERLLeCtiHv7rDvE52aqF541RoQWG5n5aqErq6,4ngBoHbfXijLMqGKxFMNht9sbmxy2g5eqBmn8QsBmbx1,True,2361643,590410,3632,1816,1816,4BnQKPLuE3DMTtxp8MjUBytgnhvxqq3ZTqZHTVZo4JJh,145303,939099,-793796,615
2022-01-07 02:09:16-05:00,2554,7W6ih2ZGXaE6tvuQFUPCvc7NvEJHy7UffgoVX3ZPdLXt,6uQCkeMjEXHBQxE2HD33RM1zyTsSko1fYZA1mWUggJ5B,True,59269,14817,92,46,46,DddJ7EWCmYEEZETCBNgAUSg81Ls6fZtiAaY5ekJ5sXx1,3685,22198,-18513,621
2022-01-07 02:09:16-05:00,2555,ECuu1L4QGdemZ7FjAjVAAxYN6piinweY7Fuk5csVovfT,Amd8WGcpdtB8yoA83R1BUT5uryuqoKbcBexYacbrbGVX,True,7039714,1759928,10883,5441,5442,DddJ7EWCmYEEZETCBNgAUSg81Ls6fZtiAaY5ekJ5sXx1,435357,2260773,-1825416,618
2022-01-07 02:09:16-05:00,2556,E9FFPvygPSF22u7gqFq4w6yE5kV15zbeGDXFQc349RsG,yi1REPVUwKhr5ss5YJc56crYz8LVfkqNVMpKcdSfwfY,True,3852673,963168,5943,2971,2972,3zqXX6kzhkbW3d4TwD2CNjMRwxTbREXySekvq37kfCNk,237749,885077,-647328,617
2022-01-07 02:09:16-05:00,2557,J5ttoY9YjAuVvggkCeps9sX7ivUWoqps5DzxjfgqddxT,mR1fxSNP4bX9GyzRS1UFLpHg31UAXwB8Du7dydCa7VR,True,4486077,1121519,6940,3470,3470,3zqXX6kzhkbW3d4TwD2CNjMRwxTbREXySekvq37kfCNk,277610,1649305,-1371695,618
2022-01-07 02:09:16-05:00,2558,36ByQojnxEckWdQTjqHfxKqCx9yjqWQsPsZyqaN72UWR,AZoirtS1fjX61agRM64tqThVinnJTh3BWgiHyNHPTgZP,True,1925410,481352,3008,1504,1504,3zqXX6kzhkbW3d4TwD2CNjMRwxTbREXySekvq37kfCNk,120354,948715,-828361,625
2022-01-07 02:09:17-05:00,2559,BxXXWywnC3dSyLPJHt7owfBhgSiBWzkuD3T8hGYLqCH6,4vuwEBXXbXFMPmbJJJRop4FCWGyKR1sXhBc3EWF6MiB8,True,219455128,54863782,342855,171427,171428,3zqXX6kzhkbW3d4TwD2CNjMRwxTbREXySekvq37kfCNk,13714228,110895908,-97181680,624
2022-01-07 02:09:17-05:00,2560,FLTW9fwjWqGPm5PiE3C9LFzwZxtDh8c2MnEoRq8W7MfQ,GKsfzKBP2QkmoEWvTaUN1h4nqrT3kAcwYRC9WxW9bB3h,True,28417623,7104405,44308,22154,22154,4BnQKPLuE3DMTtxp8MjUBytgnhvxqq3ZTqZHTVZo4JJh,1772346,8506723,-6734377,623
2022-01-07 02:09:17-05:00,2561,6d6HN8LWikwW2HYdy3BABWuxKHt1sgv4DcneACR133sE,4eKvzmfFvX96XbujKBhUauAvWP4yQYwZH3pd7gXzbCvJ,True,3848563,962140,5960,2980,2980,DddJ7EWCmYEEZETCBNgAUSg81Ls6fZtiAaY5ekJ5sXx1,238437,889876,-651439,619
2022-01-07 02:09:17-05:00,2562,9gYrMXAGmGSV4VFjXzYP5WwH2aFpB1TxA6CqpYsosKLv,Dh8aH6RK48wu4fkT9xKw5XL7itxnPDuw3SDwPwvL5sva,True,61076,15269,93,46,47,DddJ7EWCmYEEZETCBNgAUSg81Ls6fZtiAaY5ekJ5sXx1,3754,21961,-18207,614
2022-01-07 02:09:18-05:00,2563,7jvKp6onXyWgwsFrFWj4hYTXJsYYD6ot5mn6rPFuJriy,J7N6HiozevJVTiY9hDEUs2ud5BwT5QSE7wnMBS1w5ie2,True,101725301,25431324,158191,79095,79096,4BnQKPLuE3DMTtxp8MjUBytgnhvxqq3ZTqZHTVZo4JJh,6327673,47169902,-40842229,622
2022-01-07 02:09:18-05:00,2564,9LZ3rShLfzErXsGkh4dYfAm58GNPWhK6ohDy5RrLJhc,41tLyuvuJ5M7YctkSASD2R7RGGetD7FmKaZUdkTdgXgt,True,3336130,834032,5197,2598,2599,3zqXX6kzhkbW3d4TwD2CNjMRwxTbREXySekvq37kfCNk,207904,771775,-563871,623
2022-01-07 02:09:57-05:00,2565,7iUx7JBwqUvPVPeCqMEXQdLccZJmaFYm1DUQiu3ouHa3,3EVZzhRmJnX9ZiBZZo9tenDtMogAyuA1yf2cKzvUWiuu,True,2676036,669008,4170,2085,2085,3zqXX6kzhkbW3d4TwD2CNjMRwxTbREXySekvq37kfCNk,166837,1083270,-916433,623
2022-01-07 02:10:29-05:00,2566,GH6Q9E1jZPTTp46aDd57UNZPNS2D6PBSwyLL3EHSjGn2,2XvwZXNsrPWx4EfPvhTP933bzCC3SJHDQ8xARfrXdVY9,True,45445735,11361433,71015,35507,35508,3zqXX6kzhkbW3d4TwD2CNjMRwxTbREXySekvq37kfCNk,2840602,35528031,-32687429,625
2022-01-07 02:10:29-05:00,2567,CCHzYXr5zMXFu8MMZNkfUWGyUcF8xy7Vvhq7tNCtZg2L,AuEXkCJTTJ3HK8iP4qTWpQr4vp6HPRJZyZwfRjF8zjfp,True,337283,84320,522,261,261,3zqXX6kzhkbW3d4TwD2CNjMRwxTbREXySekvq37kfCNk,20917,101292,-80375,620
2022-01-07 02:10:29-05:00,2568,2bikYf33ZxxDmvkMNjWDGGqEpbYJPvWv5At3hzyeLEQK,5FtirUBjRAZ3k5arFFVwKz42ixWzhkEBLkaK9PraRZ78,True,337282,84320,520,260,260,DddJ7EWCmYEEZETCBNgAUSg81Ls6fZtiAaY5ekJ5sXx1,20832,101209,-80377,617
2022-01-07 02:10:29-05:00,2569,AGhvB6x3gmvAJSnr9UVtvhKqVg3Qgh1k4roHzrNHhAaa,HhhjXT6WJnz1HQfHcwKdBppuAhc8ncUcq1mkJ4EHqgpe,True,14537,3634,22,11,11,DddJ7EWCmYEEZETCBNgAUSg81Ls6fZtiAaY5ekJ5sXx1,906,5493,-4587,623
2022-01-07 02:10:29-05:00,2570,FhAt6pZW3k8StP9VLeWUfidpXfRLoKWdV7Wgxdh9cRy9,Guk93pTo3KcG8konHjJ52oi9rgexmmKhPQAkxZS1BtCG,True,567786255,141946562,881711,440855,440856,3zqXX6kzhkbW3d4TwD2CNjMRwxTbREXySekvq37kfCNk,35268457,217305548,-182037091,621
2022-01-07 02:10:29-05:00,2571,4kbcrzH6o2LvLUCNphyL52i8uGzVD8wcUNEqoQ14z3VG,5Q1atmEBs2AqaDZsiZFG5stHzj1fE6ZvypgfkEc9LYqE,True,410503513,102625878,637634,318817,318817,DddJ7EWCmYEEZETCBNgAUSg81Ls6fZtiAaY5ekJ5sXx1,25505385,204646245,-179140860,621
2022-01-07 02:10:33-05:00,2572,HhwiZPKZBGa16oVi739s4qtMDMTwzWXc7iwNfX63t2UP,5AnbMbAFKy85yHt5y2M5S38nNkA1vT4ejY5NjGbRNUqn,True,3186182,796545,4921,2460,2461,3zqXX6kzhkbW3d4TwD2CNjMRwxTbREXySekvq37kfCNk,196879,1761713,-1564834,617
2022-01-07 02:10:35-05:00,2573,921FBgLS3A1wA77uWitsnTvW737Q2jY7tzvgWtWLXNC7,E4eJ9H7cqP9zNpMH5xRBTAp9yaBCBihuJBNd6pqzteDG,True,337279,84319,522,261,261,DddJ7EWCmYEEZETCBNgAUSg81Ls6fZtiAaY5ekJ5sXx1,20911,101291,-80380,619
2022-01-07 02:10:35-05:00,2574,5Rxuqgs4CaSKbfDXqBMFXkLTQ9dxrUjThXzoy3ouYVtK,BgvbKru66ebrGUcFFymGTmsaQv6GgcGMybiWaXqzBtwX,True,500787,125196,782,391,391,3zqXX6kzhkbW3d4TwD2CNjMRwxTbREXySekvq37kfCNk,31312,265725,-234413,625
2022-01-07 02:10:35-05:00,2575,DJiXXW7sjNsAAxWupDKBUsFhXSgPoerVYaAtJqqNgVbn,2MsqvNuJw1xQhJ3UnXt9i7oNHDuZpR9w7iE1WQcGqt5m,True,337280,84320,522,261,261,3zqXX6kzhkbW3d4TwD2CNjMRwxTbREXySekvq37kfCNk,20905,101284,-80379,619
2022-01-07 02:10:48-05:00,2576,3ogBPSRcKfmwzgumVDHBkXLi1eCsEFG2xzSJgD4LQDNy,7TXyqWgJqfe71MSWFA2n7ufZbUdzf7JJoWej8FNNtMXo,True,50729211,12682302,78903,39451,39452,3zqXX6kzhkbW3d4TwD2CNjMRwxTbREXySekvq37kfCNk,3156126,16402375,-13246249,622
2022-01-07 02:10:59-05:00,2577,4D7mDXe7SdmbAx7kaD1mBNuEa7DzMi6TAwXURxtLEazk,5pSnT91PHoLdN6uhPnUtoD7cboLmndn26y1XouPx8vwW,True,3412915,853228,5335,2667,2668,3zqXX6kzhkbW3d4TwD2CNjMRwxTbREXySekvq37kfCNk,213407,1018402,-804995,625
2022-01-07 02:11:59-05:00,2578,G25vsB3sDqRhHoSK4KwR1TywfrJDtpejVbbevEG9sQ9a,5xFC3Hm13magnAA9GD1EnwC9PrPoEfQ7omEa9p9zCrB1,True,3930632,982657,6136,3068,3068,3zqXX6kzhkbW3d4TwD2CNjMRwxTbREXySekvq37kfCNk,245479,1384402,-1138923,624
2022-01-07 02:12:06-05:00,2579,2QStaRnbSnDhA891Lb1bxjVeMYpJUpNdqaVkw3rqU45V,DakRWPnttPoRcjY5V7WLwiwBx39BapCo9Atog8dL17Ku,True,5204471,1301117,8127,4063,4064,3zqXX6kzhkbW3d4TwD2CNjMRwxTbREXySekvq37kfCNk,325096,1448753,-1123657,624
2022-01-07 02:12:06-05:00,2580,AA9zFZTXqBR8Mw1fwEH59edzBiswoGasRNWsi6aLeysB,4VeitxYqqtRxyfdSVpshdJ3EDcgksRVnaHvAqWxTeujH,True,3909202,977300,6038,3019,3019,4BnQKPLuE3DMTtxp8MjUBytgnhvxqq3ZTqZHTVZo4JJh,241524,907323,-665799,617
2022-01-07 02:12:06-05:00,2581,ES1MDwRUa3hoToPKQiiZkzMYe9PDVnAQwMrEvZrzvnc1,C4wBG3xTDkmDQneB28xYnf1aBNEeq7UB8oR7NuEfLkFg,True,63281636,15820409,98280,49140,49140,4BnQKPLuE3DMTtxp8MjUBytgnhvxqq3ZTqZHTVZo4JJh,3931235,18865466,-14934231,621
2022-01-07 02:12:10-05:00,2582,5RvNKzSeJ1fvqsKpcQu25evEZGmKjyEDgwsMZkykoT3P,BRqSGfE4XHXu4HrinwetWumfVTmr82iuF6Y5oSV6eMiK,True,337170,84292,523,261,262,DddJ7EWCmYEEZETCBNgAUSg81Ls6fZtiAaY5ekJ5sXx1,20952,101441,-80489,621
2022-01-07 02:12:10-05:00,2583,GGGyesjbt7h2XHHp9u8vpiWGugFwEbrtYaKrNQSDhQd7,8tydo1ZjGHmPBSqU33tywB3f9szdsHk1ckGFe4Ay5pgs,True,116020440,29005110,180437,90218,90219,4BnQKPLuE3DMTtxp8MjUBytgnhvxqq3ZTqZHTVZo4JJh,7217480,80327546,-73110066,622
2022-01-07 02:12:10-05:00,2584,3Lv2XpiD4KBUHq7Zx6u3zNhpXoySodXHH8o8f5yaaPxG,H6TN4rhpBXkEH3mZnymYNcKfmnxRH2uzfwzeLH2q6ahP,True,429238,107309,670,335,335,DddJ7EWCmYEEZETCBNgAUSg81Ls6fZtiAaY5ekJ5sXx1,26809,164374,-137565,624
2022-01-07 02:12:10-05:00,2585,6u6bPgAmK8ufACrQV99A1Y5nhGkue3KEUHmQQkcNkxwP,7636yXT5w4DcVpc7LJdN46aiggzSq6U2GXHXL5kyy9F3,True,272619412,68154853,425245,212622,212623,3zqXX6kzhkbW3d4TwD2CNjMRwxTbREXySekvq37kfCNk,17009808,119273112,-102263304,623
2022-01-07 02:12:10-05:00,2586,5jin5wXjQQ25nGM2ECrCXcg1a95vquh6kM7rMRru6Ke7,EKM657EQ8HWWgf4cssByoYHoXGjFfTspTKXAGmygAPQG,True,86441469,21610367,134092,67046,67046,3zqXX6kzhkbW3d4TwD2CNjMRwxTbREXySekvq37kfCNk,5363680,37924109,-32560429,620
2022-01-07 02:12:12-05:00,2587,6dr65yANjSMmfBeKAuSxG3i16S9vMgF1CQ3zDyzh55Pn,EhrE5QpnshD41S4zPEBy2A5q2Gs2mwUrbHGo6WnT9zDP,True,768946,192236,1196,598,598,4BnQKPLuE3DMTtxp8MjUBytgnhvxqq3ZTqZHTVZo4JJh,47855,346785,-298930,622
2022-01-07 02:12:38-05:00,2588,6CeKxTJvFqhyNEyzySiBBKEwYVMe7j3A6nkMes4BW6o2,DzDR9XvwY1z7ygQ8YrCXrwDGHSf67JZF8BzUnuFE2fxQ,True,10049987,2512496,15528,7764,7764,3zqXX6kzhkbW3d4TwD2CNjMRwxTbREXySekvq37kfCNk,621141,3224253,-2603112,618
2022-01-07 02:12:39-05:00,2589,5PbrpM9kjzF4R2eW2UTcRVXnhqWdRQWHZJXKLN43N8WC,6ip4ocbyHusy8CsVvcrpiRCUp2nq9cY8bHpTcUU3Wztq,True,18183851,4545962,28278,14139,14139,3zqXX6kzhkbW3d4TwD2CNjMRwxTbREXySekvq37kfCNk,1131135,6972065,-5840930,622
2022-01-07 02:12:39-05:00,2590,AM5fwZR9BUW8AFkhdGWXW4PHd2cy8ora63kDf2z2eknw,E7ru6hg4MchnRG5zcr5YazwX8Snt55r5Xq9zCHCGaYZT,True,2194380,548595,3425,1712,1713,3zqXX6kzhkbW3d4TwD2CNjMRwxTbREXySekvq37kfCNk,137018,942335,-805317,624
2022-01-07 02:12:39-05:00,2591,8VnGmfop6qcUezAJ2M15jz2Nn6mPQgehDcJPvypq4XJn,6F6sqXNhgkW9ev8QNMm4ydywUUmemhwgydRQYNeqyUmi,True,24316100,6079025,37779,18889,18890,3zqXX6kzhkbW3d4TwD2CNjMRwxTbREXySekvq37kfCNk,1511184,19382637,-17871453,621
2022-01-07 02:12:39-05:00,2592,8MKNsuGVaoYpdQy6NNyxDvRzh2DAquBUtri4nDsixUxs,D7M1SDmpZAs8vdPCCCa96UbDF15YQDxHmoGWB57tHiir,True,9505362,2376340,14754,7377,7377,3zqXX6kzhkbW3d4TwD2CNjMRwxTbREXySekvq37kfCNk,590183,4427849,-3837666,620
2022-01-07 02:12:39-05:00,2593,FpqCxvTkSiwDwD5qEt6hXJxzFDLFLAQ8VevK8zwRqYun,A3p6YQisCJKpNkF7vkjZRbEfbnUt7vTZdR2zPBUSdTkk,True,942523392,235630848,1466484,733242,733242,3zqXX6kzhkbW3d4TwD2CNjMRwxTbREXySekvq37kfCNk,58659361,302788316,-244128955,622
2022-01-07 02:12:40-05:00,2594,3njiRuSRMXRzKmamyiR72Hc38PU8UDDmWdfPhgxmGxEW,5WoF3gkgygyNNbwxWgVfqGWkExcDixuzgJQQjXEZQ6J5,True,585751584,146437896,908362,454181,454181,DddJ7EWCmYEEZETCBNgAUSg81Ls6fZtiAaY5ekJ5sXx1,36334519,369193500,-332858981,620
2022-01-07 02:12:40-05:00,2595,DAku12iueL13vRoTpKLyqdGaLQ2rWF6REe8Dr8soFvNs,H2vVH3LxkhGe6x6Mdwy67BYwTKNQM6XayKx7mhrwyfJM,True,1024068,256017,1594,797,797,DddJ7EWCmYEEZETCBNgAUSg81Ls6fZtiAaY5ekJ5sXx1,63778,463541,-399763,622
2022-01-07 02:12:40-05:00,2596,4mB2DVbQVqVk535v98Cj8SPNg1tTc3DFyY2Q7VBbY645,HXo255k3RgsTGsc4hiP6ZTXUspBTqJ37duQa5eK7tqp3,True,906996398,226749099,1416552,708276,708276,3zqXX6kzhkbW3d4TwD2CNjMRwxTbREXySekvq37kfCNk,56662113,307794637,-251132524,624
2022-01-07 02:12:56-05:00,2597,Ftuj53jKP3Z8mvuTE1CEypdw2eZrCn5x8ktMWRdJo2gU,9JNUFRLrPNAh3DgKvMdaNvLCAeUtiS9FGWmDcMvcSe7J,True,247066678,61766669,384606,192303,192303,3zqXX6kzhkbW3d4TwD2CNjMRwxTbREXySekvq37kfCNk,15384265,77502587,-62118322,622
2022-01-07 02:12:56-05:00,2598,C2Dmfw4G8KKzFq38aRH2pLCRngnGZDvUUN3fHDMjFkoG,7kzJk3BTNvY3hGFNj7nDy9L5CAYus6eNiCAxWH8dSioX,True,851437,212859,1313,656,657,3zqXX6kzhkbW3d4TwD2CNjMRwxTbREXySekvq37kfCNk,52549,469179,-416630,617
2022-01-07 02:12:58-05:00,2599,6eBSLXDMVoW2nG3n7s42RXDH8byY3C6n1RsUuegBLSrG,37dYrKnTXYer7Bu9xFfpArA4ZNo2B9bycFw9HywDtTRx,True,22752343,5688085,35239,17619,17620,3zqXX6kzhkbW3d4TwD2CNjMRwxTbREXySekvq37kfCNk,1409560,9635257,-8225697,619
2022-01-07 02:12:59-05:00,2600,2FrqGFZjbiNykJyo9BZ5S9FguQJPJiTi681rJJsQ5dta,3QUncYP92NKrfpaTvuF9iQg11PXKgZAgEngwh6BbnCCj,True,1895060,473765,2956,1478,1478,DddJ7EWCmYEEZETCBNgAUSg81Ls6fZtiAaY5ekJ5sXx1,118270,694604,-576334,624
2022-01-07 02:13:01-05:00,2601,8NdcaYUC1X5CP7FMDip78uqtqmCt8GcZdCzLRTYTihmb,9Ei1K9bXWXSXcBfeX5exPSXGCAu62WSKzvnnd4wHvyVh,True,301441,75360,470,235,235,3zqXX6kzhkbW3d4TwD2CNjMRwxTbREXySekvq37kfCNk,18801,117741,-98940,623
2022-01-07 02:13:17-05:00,2602,aTkGURJptmKNNP6RSXSWsmVbfcriSAJaMuUiT2eZEfb,5qoGxL83PLhrguyk27X8xE6jGitRg5BaQpXzrcfEvCfJ,True,662018353,165504588,1032024,516012,516012,3zqXX6kzhkbW3d4TwD2CNjMRwxTbREXySekvq37kfCNk,41280970,185186837,-143905867,623
2022-01-07 02:13:18-05:00,2603,243SAnGxchCVB1LQAUF4SsozR86yDwEdg2QQpbWGsMYe,5u8sNkb2oEQjUXJAB3yGStmv3Uwz16gBgExBo5myVK4b,True,34236130,8559032,53462,26731,26731,3zqXX6kzhkbW3d4TwD2CNjMRwxTbREXySekvq37kfCNk,2138513,10101704,-7963191,624
2022-01-07 02:14:15-05:00,2604,8RmB8o4zux2sD48dEsKpsX475KRxTwdk8QULUDU9xx8R,AKSiZnb4YKVB6B86aPPqvyXquhvN9xqt45bexBCZ7nx,True,145309424,36327356,227382,113691,113691,HfEnetJ7uBSmZWCjBNxdvv9HEC5nsW4wDV7wu6WnhWan,9095316,74655030,-65559714,625
2022-01-07 02:14:15-05:00,2605,Fd2HrzBAr4JobRPARZwpQHHVoSCEoog32A6tKMWAC1sK,BYappsar5sQf8VLem4wrLuTtrDFH9y8pEx1aMxfuU4Pq,True,69064363,17266090,107794,53897,53897,4BnQKPLuE3DMTtxp8MjUBytgnhvxqq3ZTqZHTVZo4JJh,4311767,30327840,-26016073,624
2022-01-07 02:14:15-05:00,2606,EmGW2aAG69ssWqCtbfDocRaM2u3TJsczn2HHP9jdmRvD,aypkDKsp9uqAB4F6mwvm5LofpsrFBuZT2MMWtE2eHdB,True,1480981,370245,2317,1158,1159,4BnQKPLuE3DMTtxp8MjUBytgnhvxqq3ZTqZHTVZo4JJh,92688,613769,-521081,625
2022-01-07 02:14:16-05:00,2607,ANQkPUoMjLHyRtypeKzxsKW1DFauQsh9SnB3rRgRXM1Y,7RHAExWpG8Q3PXwKhJs2yXmYK9WogGydvFYpx28p6pgr,True,166529974,41632493,260562,130281,130281,4BnQKPLuE3DMTtxp8MjUBytgnhvxqq3ZTqZHTVZo4JJh,10422514,86769101,-76346587,625
2022-01-07 02:14:16-05:00,2608,F2v1YwVAwXLiUgsJ5uwn4qAAkTXitn1E75fJcPnGuAcy,5rdJ4H5GxPg4Juu77mGc7uya5LwEqLzDSRyG8mQ2mDbK,True,44228917,11057229,68900,34450,34450,3zqXX6kzhkbW3d4TwD2CNjMRwxTbREXySekvq37kfCNk,2756016,19427492,-16671476,623
2022-01-07 02:14:16-05:00,2609,AHm7zF4rpaxaayBLn5QDHgJSp8KAr647s4cNvQ9wLgd7,FDM33WngED24pukBvSDpPAzinW6afVAeGReum5nyLRiC,True,1899466,474866,2958,1479,1479,4BnQKPLuE3DMTtxp8MjUBytgnhvxqq3ZTqZHTVZo4JJh,118335,865361,-747026,622
2022-01-07 02:14:16-05:00,2610,6yw4GPvkqUbakcEWtqSCfjVLukty11xqjDpGxtEN9Km2,5ppEx7wkpqbG5nApCWMdRja3oRSheFmAAsNHUX7h2w2Y,True,3787970,946992,5923,2961,2962,4BnQKPLuE3DMTtxp8MjUBytgnhvxqq3ZTqZHTVZo4JJh,236928,3084952,-2848024,625
2022-01-07 02:14:16-05:00,2611,6tFQaTqqffino9kwMZTL2xVNBG8k9VREFhXqVi2si3A3,3w3wGxBbS4bmXeqmvd595SAWFeXekVpnH4UdbeEs8Sx5,True,10053253,2513313,15716,7858,7858,DddJ7EWCmYEEZETCBNgAUSg81Ls6fZtiAaY5ekJ5sXx1,628648,3228494,-2599846,625
2022-01-07 02:15:26-05:00,2612,2VyFcgZDH1HTEvD1XaWhwqBCMmZ1k6TmZ3fEpPcBZR9E,G1wFJETTpdoc7CfypGCzkq1jssXPfUkiuLjK2cwVZ9dJ,True,184630,46157,288,144,144,4BnQKPLuE3DMTtxp8MjUBytgnhvxqq3ZTqZHTVZo4JJh,11538,84021,-72483,624
2022-01-07 10:51:41-05:00,2613,5BJnMHFSiQjHRGFJDW1jnqCfkHHYWnQzmmccy9eA4jNj,9517JGYsPmvgPUM9pFRD2vipHmdgE578F7jA7Qq6jorm,True,1258412881,314603220,1917861,958930,958931,3zqXX6kzhkbW3d4TwD2CNjMRwxTbREXySekvq37kfCNk,76714444,447432532,-370718088,609
2022-01-07 10:51:41-05:00,2614,8xvLGVeDmhVYQhN2ZpWkVG9jCrukRsNQ4926a4TMiZqa,9ciBySSjvADwp47WkETiFWZKVTFL8Hf1XvK7aSxhcgQS,True,59937279,14984319,91940,45970,45970,3zqXX6kzhkbW3d4TwD2CNjMRwxTbREXySekvq37kfCNk,3677635,21417896,-17740261,613
2022-01-07 10:51:43-05:00,2615,BgnsCfJ54ReunUtwPJLzkW4PWnqpBDWGNYxsW5PvDrbK,KpMqEkQ9dKMgCevsEK895wHd3fCLRPSzDmJSv3tKU4u,True,34627654487,8656913621,53315664,26657832,26657832,GAUsoe8ZTCiGPm2hYxRPGxcPe5ShNzHK9eE3G2zgRjxd,2132626569,11084221735,-8951595166,615
2022-01-07 10:51:43-05:00,2616,A1j2G5FZRyWSjFt6dK87WHhLkQrPUVqHaM3KhSzhAKDT,2fMiHLYm4pL3YCd8aveTR4mT9uVxztQeMwb5eRZb4wUW,True,1677994,419498,2468,1234,1234,DddJ7EWCmYEEZETCBNgAUSg81Ls6fZtiAaY5ekJ5sXx1,98729,670509,-571780,588
2022-01-07 10:51:46-05:00,2617,DYCYiQFH9QHzCo3eAw1pFoDu7pzwFMo1E2WDZjVFRz5w,CPh4FWsGak1kd1WFEH9qBjNhnun3R2tHtZA57zW8ugn5,True,119370845,29842711,185876,92938,92938,GAUsoe8ZTCiGPm2hYxRPGxcPe5ShNzHK9eE3G2zgRjxd,7435047,55536800,-48101753,622
2022-01-07 10:51:58-05:00,2618,5eMLdQ4gYA5iqvTXSNdGvctHp7s5VpyFuwtJKqx6chBc,Ckxc5K39nkBNXBTmFTM8J48R7wGqNm3vHKZu4G5baumZ,True,785529799,196382449,1221999,610999,611000,GAUsoe8ZTCiGPm2hYxRPGxcPe5ShNzHK9eE3G2zgRjxd,48879977,228954214,-180074237,622
2022-01-07 10:51:58-05:00,2619,JDeYjCLpfnzcfxDFgHf4aBcHsajwdR14GUaKAA9euzVf,EJbvKoyMZcoCx4vWa61uMbW2vr6mUhrgEuECdteVBuZZ,True,18665021,4666255,28789,14394,14395,GAUsoe8ZTCiGPm2hYxRPGxcPe5ShNzHK9eE3G2zgRjxd,1151598,9796352,-8644754,616
2022-01-07 10:52:33-05:00,2620,D58t4uTjFumsUeYFaKnpV8BRTEQEqKXBreFTdwGrott7,67p6kHDfVqQijfcwugvZK59c3aRRH9x3eHxruqH8WEqF,True,2359646,589911,3688,1844,1844,GAUsoe8ZTCiGPm2hYxRPGxcPe5ShNzHK9eE3G2zgRjxd,147526,932238,-784712,625
2022-01-07 10:53:03-05:00,2621,Bsr6kx1B6BSEd5UnJ7Z61M49iUb3bFrDVhiEtMVtPDF2,3CFd1pUJAJPA9fobwn4Jj2mRju1CWmoop4Mh4znypNWT,True,70058580,17514645,108477,54238,54239,GAUsoe8ZTCiGPm2hYxRPGxcPe5ShNzHK9eE3G2zgRjxd,4339085,22505367,-18166282,619
2022-01-07 10:54:41-05:00,2622,E8ifvhmyJGBGVQomo3AnZw2UcaLHcpGsTtuoCid8voU3,FMQUWTbTAfSLfrc6GTrz4DM2ZSgoxF3KtqGn8AyjVtsf,True,16326807,4081701,25377,12688,12689,DddJ7EWCmYEEZETCBNgAUSg81Ls6fZtiAaY5ekJ5sXx1,1015116,5138876,-4123760,621
2022-01-07 10:54:41-05:00,2623,Dn916KSmX3HqxT53hrxrbCrV3tdRMCPdaoiRLqetMrth,ATCXRiXgnjRRUbSTPBvtBXMENCqsViexSZbZ6aDaXXWA,True,2994256,748563,4667,2333,2334,3zqXX6kzhkbW3d4TwD2CNjMRwxTbREXySekvq37kfCNk,186711,1194632,-1007921,623
2022-01-07 10:54:41-05:00,2624,9UyQC8vc6zJJaSdnjvTAzgmcsw4fC3xFBBiCC1w9Sbjx,3ppBfboe6FPmt7f6WrivspMUoAznZKWQMeh3rCgw7vjQ,True,20560699,5140174,32109,16054,16055,DddJ7EWCmYEEZETCBNgAUSg81Ls6fZtiAaY5ekJ5sXx1,1284379,6033667,-4749288,624
2022-01-07 10:54:45-05:00,2625,9zpPiboHF5HW7NfCx7hYdmJGwUomVMTiUFc4Um5KrDi3,8q3eBpuwV6dMNkib9N8XQAq2tBUcjSANRe5SXpd4dFhZ,True,18835021,4708755,29295,14647,14648,DddJ7EWCmYEEZETCBNgAUSg81Ls6fZtiAaY5ekJ5sXx1,1171839,5535748,-4363909,622
2022-01-07 11:12:40-05:00,2626,2F45BX9mRmtNCHPejKFknN5aNgGvR4vVLFjMaY1a7dR8,ALdSutsvEFRUEQGGBbi31QywTL1pdXSDWrNJzvNTaoXL,True,57502719,14375679,89332,44666,44666,DddJ7EWCmYEEZETCBNgAUSg81Ls6fZtiAaY5ekJ5sXx1,3573307,24186190,-20612883,621
2022-01-07 11:12:49-05:00,2627,67Z7ZGhNu5xxEh9BYKWcXp9m1T4tFiE1o1M16hCzUWQA,CT7YKWixz7BhTbvg5F6M5HCyPGnHoFLNFuDV9GhoLTo3,True,7491748,1872937,11718,5859,5859,4BnQKPLuE3DMTtxp8MjUBytgnhvxqq3ZTqZHTVZo4JJh,468727,3904340,-3435613,625
2022-01-07 11:12:49-05:00,2628,J4krKPBBTMVLZRgrSeYJAMyHQs2FkNm5TXk7nQWwDB43,ASmLbfNbhTD2HHeV7qzAqiHjUx5a8Traj8oPDwbkMdFg,True,65202235,16300558,101690,50845,50845,3zqXX6kzhkbW3d4TwD2CNjMRwxTbREXySekvq37kfCNk,4067623,21350388,-17282765,623
2022-01-07 11:12:51-05:00,2629,CvZssqscu2dm35mwcE3zg9zedavbRjVJjWD59Py5ExUK,7pXaoR6aHKYofCmg1eHipygNYDteEaf8rbbS8BDYGQK6,True,1613684,403421,2521,1260,1261,DddJ7EWCmYEEZETCBNgAUSg81Ls6fZtiAaY5ekJ5sXx1,100853,516555,-415702,624
2022-01-07 11:16:39-05:00,2630,Gs3WP18hbzNpbBgiU39e6tfkggfCKRyNqPqJQcthuHFD,4XAY25YUma6gUdG2GdbXeivum3t21g93ZagfWGTZYkWZ,True,23070398,5767599,36094,18047,18047,DddJ7EWCmYEEZETCBNgAUSg81Ls6fZtiAaY5ekJ5sXx1,1443768,10386114,-8942346,625
2022-01-07 11:18:49-05:00,2631,8xQ3tsWVUe75EG1HmocULJ3kh52utveoFMEPotTGrKno,i3SKW3ywrwYucX9ySEx1C4zaUKGnzLerP3V38437NyV,True,141533772,35383442,220547,110273,110274,4BnQKPLuE3DMTtxp8MjUBytgnhvxqq3ZTqZHTVZo4JJh,8821887,58219481,-49397594,623
2022-01-07 11:18:49-05:00,2632,J2gTwrYpzezkRupgBtgudQn5D33x6WjeBhTHnrA1qgqa,FBzoHRwqGRjnMvPEpiZVjtGZYJmAbneE4dpToXPzy8bv,True,79534553463,19883638365,124285377,62142688,62142689,DddJ7EWCmYEEZETCBNgAUSg81Ls6fZtiAaY5ekJ5sXx1,4971415111,26163484666,-21192069555,625
2022-01-07 11:18:55-05:00,2633,A2ZUT3A9EjtCkzcZveEvWF3pPwNVqdXkHK3fsNRAg8VX,4137TfTDDzK71KN2ZzJaoRPJDQDKQewSPdmZfKrxdVPD,True,146337832,36584458,226573,113286,113287,DddJ7EWCmYEEZETCBNgAUSg81Ls6fZtiAaY5ekJ5sXx1,9062944,44235773,-35172829,619
2022-01-07 11:18:55-05:00,2634,9vcKW1GfrDZ3KLPh2pEVFF8ZyKqD1pJW1hiE8H98Av7S,C6Ki27mo4sCHu6u8UnR1p7WSgsTjFQxGGR9Lk9n5Rhjq,True,6397950,1599487,9961,4980,4981,4BnQKPLuE3DMTtxp8MjUBytgnhvxqq3ZTqZHTVZo4JJh,398479,2765501,-2367022,622
2022-01-07 11:18:55-05:00,2635,6oroGB3mvzK3tDfiB9X2NJuL3x476pxhgRnt7VxqhdLo,2SoK8tKkLn2ppKURpTVazKsCEis4uahkHMsac1m85J4r,True,4125764,1031441,6453,3226,3227,4BnQKPLuE3DMTtxp8MjUBytgnhvxqq3ZTqZHTVZo4JJh,258154,3250817,-2992663,625
2022-01-07 11:18:55-05:00,2636,CRaKcudjkQiSw5YPVjTLVdXvJskeGiHSYtq5ZcMPJhgQ,AgqTg3b3bAcaBmRidhNC4Uf9ZwNbeH52RQEqumWyuUs7,True,1993944,498486,3084,1542,1542,DddJ7EWCmYEEZETCBNgAUSg81Ls6fZtiAaY5ekJ5sXx1,123369,1098808,-975439,618
2022-01-07 11:18:55-05:00,2637,DdYgcyV1T2CDYiQVr4VL9Ym8RdKm93a7SKy8HxuyaoMW,GPdAeqeXb1UJ56AttcwwY1CyFhRyfptDC4BAX2Tc8MpE,True,1210468,302617,1869,934,935,DddJ7EWCmYEEZETCBNgAUSg81Ls6fZtiAaY5ekJ5sXx1,74773,551637,-476864,617
2022-01-07 11:18:55-05:00,2638,Ckqos6cdncPKj13DnCmDVZsZTqp6eS7277CRrT9WhcEr,AtUV8m7VQJvZq7GLCAHMf3jV7iamKEPnWVZHWuuVZQp1,True,2858736,714684,4444,2222,2222,3zqXX6kzhkbW3d4TwD2CNjMRwxTbREXySekvq37kfCNk,177767,1575497,-1397730,621
2022-01-07 11:18:55-05:00,2639,DGAQzgZhS2yioeZmG3cbacM3hdz4F1aZn1PWRwgiFukc,48KUtJaNCPNxkLXJBtWAdDxY4b9vZzLgbGxTNdwMqmjz,True,1203217067,300804266,1851326,925663,925663,3zqXX6kzhkbW3d4TwD2CNjMRwxTbREXySekvq37kfCNk,74053041,495217627,-421164586,615
2022-01-07 11:18:55-05:00,2640,6nJyqvFKprwaVCE1gAa2P4RHKc6Pa6XFSJymx654zZ9K,4e7iJmdwzAPxp1Zi8Azo38YyPQdPKqqY4VLJyQ5rpdYP,True,5735839,1433959,8826,4413,4413,4BnQKPLuE3DMTtxp8MjUBytgnhvxqq3ZTqZHTVZo4JJh,353042,2636842,-2283800,615
2022-01-07 11:18:59-05:00,2641,pgzvXpnUYiY7hLrfjmwScqLd8oj9vYcXpFvpm4y4JvG,GdqdQgoyBAFuXdbvoZyDhB3jyqJzVo4nkGh7EPFxkBF2,True,4851545,1212886,7409,3704,3705,3zqXX6kzhkbW3d4TwD2CNjMRwxTbREXySekvq37kfCNk,296360,3978557,-3682197,610
2022-01-07 11:19:00-05:00,2642,M69XSefqeum2arinvHEqmA3L2XHWNFN17p4msRhRZXf,2vK15yYUANLSbAoiBfgJ9VLyqsmtEpd2iNytQjms8GaQ,True,623873753,155968438,971112,485556,485556,GAUsoe8ZTCiGPm2hYxRPGxcPe5ShNzHK9eE3G2zgRjxd,38844506,361387376,-322542870,622
2022-01-07 11:19:00-05:00,2643,o2aCmkxsxSiyUX8soTEjwUCbJeXmCZsEaf8CWwxDT5n,3pvS2bTsUuiQyqZp5rdnTpq4cqWGgtv4E5rN9HsBxpRt,True,55006,13751,84,42,42,GAUsoe8ZTCiGPm2hYxRPGxcPe5ShNzHK9eE3G2zgRjxd,3387,13488,-10101,615
2022-01-07 11:19:00-05:00,2644,HVZkXeDR3mc8oB9qFFwCK4RXpPojdcHk9tRGep6xtKGK,Bh3py7awPejWqeTMxtAgF7mPotL2Asxf8YrYJykq9nBt,True,15183664,3795916,23720,11860,11860,3zqXX6kzhkbW3d4TwD2CNjMRwxTbREXySekvq37kfCNk,948805,5789231,-4840426,624
2022-01-07 11:19:00-05:00,2645,CBL2NbekJrXvBiAcoj4fzQ4PfLDwTntW7Zt4nruHFYEw,59EvfgYTdKkfjUJz5LddLUAqbEdLaihcMzjcrTZsyzyS,True,21542,5385,33,16,17,3zqXX6kzhkbW3d4TwD2CNjMRwxTbREXySekvq37kfCNk,1343,8038,-6695,623
2022-01-07 11:19:11-05:00,2646,2jPxG5FL6D6XEJsRszJ9cmQ54AWSpZyPFSbn3DpWBSuM,3toQou4UVNvyWYvMvkuv379RVEF2aN2TzCpKKBUqeQV6,True,444644936,111161234,695860,347930,347930,4BnQKPLuE3DMTtxp8MjUBytgnhvxqq3ZTqZHTVZo4JJh,27834430,166375452,-138541022,625
2022-01-07 11:19:25-05:00,2647,6NJFN855M3Q3RLTDNo57gTgAmwPD6G2E3WvMb1m5eNCN,3YpqNnonsvXaRT4nCC3G5FZx1jjVtbDPc36LiR6WK5jR,True,181976875,45494218,283441,141720,141721,3zqXX6kzhkbW3d4TwD2CNjMRwxTbREXySekvq37kfCNk,11337652,93770079,-82432427,623
2022-01-07 11:19:26-05:00,2648,zLTuMVfVswjMkhyvjaXnvjcKXv5xNk3iSWSjRGpVqXf,J3D8NHUJCiSjvFYfJ5Es4YDhF1KcPZWRUmCQ5L92t8eB,True,280250473,70062618,438220,219110,219110,DddJ7EWCmYEEZETCBNgAUSg81Ls6fZtiAaY5ekJ5sXx1,17528836,100704370,-83175534,625
2022-01-07 11:19:47-05:00,2649,CagSUfZLwXuCdypC4KzU6FSNdmCj9dKDroPcNeaRtsyt,yxw5d1ztZuEUY2QjL7eLpr72QJAj5rJd6ERvg91cy1m,True,3724094,931023,5813,2906,2907,3zqXX6kzhkbW3d4TwD2CNjMRwxTbREXySekvq37kfCNk,232552,1252159,-1019607,624
2022-01-07 11:19:47-05:00,2650,5rW9kqXB9feGSKSvSMNJF1FCsBYV3vGmTmc8MvzaZ3pi,7AjnjcfPJevW5521hXw4VtgRCfHSsAqyzyArukKfNcHo,True,25319608,6329902,39584,19792,19792,DddJ7EWCmYEEZETCBNgAUSg81Ls6fZtiAaY5ekJ5sXx1,1583373,11697712,-10114339,625
2022-01-07 11:19:48-05:00,2651,8swGZMrPrLAxZd7MxTbkCL13k3DmAJUw41jCp6Xo6awW,3fKnX7yTNXAT4uMmXVdTy47ALJT8h8YSD3WiBb4BGuzH,True,554798965,138699741,863986,431993,431993,DddJ7EWCmYEEZETCBNgAUSg81Ls6fZtiAaY5ekJ5sXx1,34559474,214591618,-180032144,622
2022-01-07 11:19:50-05:00,2652,D64rDiWT3YG28fCgXCmbNjYa2JakZbpKQ1D2XuLChUfV,8WmMWq8cTsGQym5pUbHm9dPCpJugBeWUMVERYFGLxWHj,True,85294584,21323646,131139,65569,65570,DddJ7EWCmYEEZETCBNgAUSg81Ls6fZtiAaY5ekJ5sXx1,5245589,25409427,-20163838,614
2022-01-07 11:19:50-05:00,2653,3qnPsgqW11AcDEmyjmJquPcPLyE3EdJQuVLJ5kinDrd3,86rZadBB7emKio76aFTahpbrFtxd9tqZ4Mxgzaavq2xU,True,363727,90931,569,284,285,DddJ7EWCmYEEZETCBNgAUSg81Ls6fZtiAaY5ekJ5sXx1,22761,139580,-116819,625
2022-01-07 11:21:00-05:00,2654,BrHRMouGRz3LBNzd9anfdYMhWfg8yUPHL4PqJ8WdEDFS,4uzoLa3mC2VYHAPBoHLX4gTjPTC28rPf2fvEGtJWPYc,True,140097043,35024260,219227,109613,109614,GAUsoe8ZTCiGPm2hYxRPGxcPe5ShNzHK9eE3G2zgRjxd,8769118,104392453,-95623335,625
2022-01-07 11:21:53-05:00,2655,3C2MZQKh9x4zNTCMbhhvoafGaFMwUooqfy9MCgPyXs6E,AHjgWKpYPWe6ketjDHDKFBFsKQiRJ41jnkuo39MVYxZo,True,487230716,121807679,761865,380932,380933,3zqXX6kzhkbW3d4TwD2CNjMRwxTbREXySekvq37kfCNk,30474602,253365642,-222891040,625
2022-01-07 11:21:55-05:00,2656,HGJoZvLakWfSDFwuvShNBc4kCf7nP7VqzyM3mELpbFEf,12Qn5jin7QvsBngXqYAv4UstyG3b6nRf1jsLp9Dp8G7k,True,37325404,9331351,58297,29148,29149,GAUsoe8ZTCiGPm2hYxRPGxcPe5ShNzHK9eE3G2zgRjxd,2331894,15058513,-12726619,624
2022-01-07 11:21:55-05:00,2657,7PzGZgzieFyyFs1dbajkNQgVxooFUNZrj1bUsQvrSwbp,A2gDREmSmJTBPPw3sbKVY3smC9wbHMDdv87gr4Tr2ES7,True,6544569,1636142,10210,5105,5105,72FwbpFGoLEazJEdpqNtPNefsadUrimUqma9wSoy4qiS,408421,2514506,-2106085,624
2022-01-07 11:21:56-05:00,2658,GqAS41YJssg9aaEp3hs3sG98APCsXhiQBQszXaSjZ2bN,2wodJ3AhrXdE1T4oVL95KvoBND7PubG5Wd5GWiLCMZJU,True,437137639,109284409,682221,341110,341111,4BnQKPLuE3DMTtxp8MjUBytgnhvxqq3ZTqZHTVZo4JJh,27288840,328093806,-300804966,624
2022-01-07 11:22:04-05:00,2659,8Xt3qHjZG3zLxozgM5vPHMVxp8eYFMg89kaVW7vdHKoA,2i8riSsQpfADD9LUVpiBJBfX5qjVAgmZegzfKx6RG9dW,True,98030539,24507634,153312,76656,76656,GAUsoe8ZTCiGPm2hYxRPGxcPe5ShNzHK9eE3G2zgRjxd,6132487,28874213,-22741726,625
2022-01-07 11:22:04-05:00,2660,2FEbsetZMkRqLjSC8GBbgecKgX5T1T1fci2sLQux29p8,H722Fcd6DkTFRZxqQWbPDufBfXEgmFfhiEpQZWhxwYv1,True,11118901,2779725,17398,8699,8699,GAUsoe8ZTCiGPm2hYxRPGxcPe5ShNzHK9eE3G2zgRjxd,695941,3812970,-3117029,625
2022-01-07 11:22:04-05:00,2661,DDsY5V3F9wnEGBoQFCEf1hvEYuKUaJdysbc7TxhNqe9G,5oBCGzvy8odB8MCxCUvPDqYCnTyteZ4Yy1JDroroygbi,True,128934147,32233536,201630,100815,100815,3zqXX6kzhkbW3d4TwD2CNjMRwxTbREXySekvq37kfCNk,8065217,29018943,-20953726,625
2022-01-07 11:22:05-05:00,2662,7oxuCEhooUZ5z2nnZRD226rcqdZgAR75SamX9DD7ejUf,CPqBb5ptWUPUJhVjshxNZCHd5RDF3fve29z4vz72JhvM,True,423301,105823,660,330,330,4BnQKPLuE3DMTtxp8MjUBytgnhvxqq3ZTqZHTVZo4JJh,26438,127475,-101037,624
2022-01-07 11:22:46-05:00,2663,U3vvMQ4X4aKzVYfhMw1V1p58HRqaLnuXozqmmefYeD9,7JA94MArkNCFRhBq8f5a32DgMF6aPdFsoC5HvXDQ6NuR,True,722765495,180691373,1130911,565455,565456,DddJ7EWCmYEEZETCBNgAUSg81Ls6fZtiAaY5ekJ5sXx1,45236454,339905736,-294669282,625
2022-01-07 11:35:21-05:00,2664,cQqH5PtXgtCk1Vs96PgxDxzUZf2Cfx5F63j1Nkz19cs,2VVizb2qVtj8ZEpLSmJXz9hXnAiGD7GdhBxT32PbFjAY,True,55028,13756,80,40,40,3zqXX6kzhkbW3d4TwD2CNjMRwxTbREXySekvq37kfCNk,3225,17813,-14588,586
2022-01-07 18:09:15-05:00,2665,BAzH5niE2GX9CHGn3jK6Wv8Dd59PT95dX4dgfZXWoLPT,YNRnuEoNBPFsr7W91gc85TXAdA4ZnXfF2x951zbeRKF,False,69532,69532,3416,170,3246,DddJ7EWCmYEEZETCBNgAUSg81Ls6fZtiAaY5ekJ5sXx1,3416,29007,-25591,491
2022-01-07 18:13:03-05:00,2666,HAk9c831TRUhvpoK4d7PTqfJuJhSjnJUXWpnYsH85bDJ,DVSa3CJrVLTHAeFYjEF89ZjWRm86QwruUk2Y8RvGpjsr,False,74374,74374,3398,169,3229,GAUsoe8ZTCiGPm2hYxRPGxcPe5ShNzHK9eE3G2zgRjxd,3398,30630,-27232,456
2022-01-08 10:05:08-05:00,2667,EanSXRkJu91FKUhPCzYxWkmM3PQUWcovEnoZXcd6vQ9E,Fg4EzAzHStoLRDPmoBUczdWnWrhAb7jKEujqAujLFT8,True,636974719,159243679,995312,497656,497656,DddJ7EWCmYEEZETCBNgAUSg81Ls6fZtiAaY5ekJ5sXx1,39812493,223513002,-183700509,625
2022-01-08 10:05:18-05:00,2668,Dc11Q7yj9HoSfndRUB8Ffaz5BcYNFnvbVWuRn8v7Zs7C,BC35JUb1znJxJhcaivpyUPt8Ydojec2ohC1TrFv7TntJ,True,811494191,202873547,1269787,634893,634894,GAUsoe8ZTCiGPm2hYxRPGxcPe5ShNzHK9eE3G2zgRjxd,50791487,330347600,-279556113,625
2022-01-08 10:05:25-05:00,2669,AvwHizRhHUSahmvSg4jmTUErc7vAFSmkRAEsiKhXfW1m,3UrWYx8y9N5o9GYneSe6zyyHRTZzxwvcipQfHHYh7tEs,True,8498569,2124642,12868,6434,6434,3zqXX6kzhkbW3d4TwD2CNjMRwxTbREXySekvq37kfCNk,514741,2558807,-2044066,605
2022-01-08 10:05:28-05:00,2670,GjQQ2fQ7mrGjWZwjVYFUKp9NM1LmfkhEo675ovU5SPa8,ECgVUMRY5nB4MALs5drDyipF7YohCPuJpj2UegCs7HMn,True,52362254,13090563,81634,40817,40817,4BnQKPLuE3DMTtxp8MjUBytgnhvxqq3ZTqZHTVZo4JJh,3265381,18510477,-15245096,623
2022-01-08 10:06:56-05:00,2671,F9s8a7Cpiw5dw3a2aNFMofqwyDWNXvDLnSdJzoj1gRiV,GpKsQKJD79KBRWdCTkyi4zX7NaoCWsLUjrKxAwJB6o6s,True,69103449,17275862,107267,53633,53634,GAUsoe8ZTCiGPm2hYxRPGxcPe5ShNzHK9eE3G2zgRjxd,4290687,11486029,-7195342,620
2022-01-08 10:07:16-05:00,2672,GxFxvEUdWofneMmVvhCSScH9V6Zia5WJ2J9q6CpPnaq3,ATLykiHDii3Lw53MoZXwqu1FbBNPJbVNVGe2SoQMjVmY,True,10513016,2628254,16387,8193,8194,DddJ7EWCmYEEZETCBNgAUSg81Ls6fZtiAaY5ekJ5sXx1,655519,4377656,-3722137,623
2022-01-08 10:24:45-05:00,2673,864zY9zuCktUurPTtdGeLvUATnDqHZpT1GeWUApsXh2m,CzatBrNJUi7MeyfbNhszRaPMidgt8Xkcmy5ZwFMP9RCs,True,47397592,11849398,71368,35684,35684,3zqXX6kzhkbW3d4TwD2CNjMRwxTbREXySekvq37kfCNk,2854730,19813372,-16958642,602
2022-01-08 10:24:49-05:00,2674,BWtXpiXn1bomr28mGfQFTx1Kd58CQipEnKmeweYowDEC,9jws1qkXvWAdEtBvURVEeGcGJzt4zG2gh8AJESvjKKrx,True,247490226,61872556,384627,192313,192314,3zqXX6kzhkbW3d4TwD2CNjMRwxTbREXySekvq37kfCNk,15385084,123947737,-108562653,621
2022-01-08 10:25:06-05:00,2675,5SwL5U5hhQXPW1HXFf4GuU4xkmXoAKx58pjY53NPHqWS,7zB7JvYFzEEwawJy7k7NXvBSG3UsbQte7JxgwvBNbS7U,True,453102194,113275548,709003,354501,354502,3zqXX6kzhkbW3d4TwD2CNjMRwxTbREXySekvq37kfCNk,28360146,225423156,-197063010,625
2022-01-08 10:25:23-05:00,2676,D7XummfEc3NTK4qMvZegV3FrYuqc8mNgnQu3ujwemZtg,HHiRcecqzW7sGFTio7Ph6TYv3dGt64KWv4DEKgKm84fQ,True,18198439,4549609,27134,13567,13567,4BnQKPLuE3DMTtxp8MjUBytgnhvxqq3ZTqZHTVZo4JJh,1085385,7781946,-6696561,596
2022-01-08 10:25:24-05:00,2677,6cnA7PeqQgpZdA7jBg4yMzTusm8JJHRWBMup84ywJfYo,FLqcukY7RehqY6ACrwVJnGH3eRgRDe93K1jLYCQN2F3U,True,184931998,46232999,279526,139763,139763,DddJ7EWCmYEEZETCBNgAUSg81Ls6fZtiAaY5ekJ5sXx1,11181068,93880006,-82698938,604
2022-01-08 10:25:24-05:00,2678,7ptPfZnqDCvTWotn8wPGyzERTJYLBgk47j7qf8Ciq941,AfAGcFqFFPi6LCQXydgsPWidN35c7NbhBa7RLEaDQQCu,True,10364245,2591059,16091,8045,8046,DddJ7EWCmYEEZETCBNgAUSg81Ls6fZtiAaY5ekJ5sXx1,643665,2964369,-2320704,621
2022-01-08 10:25:26-05:00,2679,DvuRmJkfn6FQczUKgYeaSCqwy2NTMunuAKNrnmxMvnzS,7LpWTX9dgBtW75kfEoB5WuNsDwEdw5s8CYSHh3J4qagM,True,206390940,51597735,316182,158091,158091,4BnQKPLuE3DMTtxp8MjUBytgnhvxqq3ZTqZHTVZo4JJh,12647312,89278587,-76631275,612
2022-01-08 10:25:27-05:00,2680,DmEVzPyCKnm89v481V2ic57vyikwwMja75uVZ2rjvjfp,38fPZzP4NwTtx7Qu6DLSqx9Sv8e5CQbSrr2BMvVmSy4J,True,54416337,13604084,83098,41549,41549,3zqXX6kzhkbW3d4TwD2CNjMRwxTbREXySekvq37kfCNk,3323926,28083954,-24760028,610
2022-01-08 10:33:20-05:00,2681,DC4UVUDFWL3gVtgkX9hPtFgtxaA8DH5p94i4k9U3wyWv,3HCWqVvQQfRgSKitsTjGTduJ82ointZUSNtj13uea4kD,True,4259870217,1064967554,6651151,3325575,3325576,3zqXX6kzhkbW3d4TwD2CNjMRwxTbREXySekvq37kfCNk,266046063,1323518616,-1057472553,624
2022-01-08 10:34:06-05:00,2682,AvwHizRhHUSahmvSg4jmTUErc7vAFSmkRAEsiKhXfW1m,3UrWYx8y9N5o9GYneSe6zyyHRTZzxwvcipQfHHYh7tEs,True,6262376,1565594,9758,4879,4879,GAUsoe8ZTCiGPm2hYxRPGxcPe5ShNzHK9eE3G2zgRjxd,390322,2034925,-1644603,623
2022-01-08 10:34:06-05:00,2683,Dc11Q7yj9HoSfndRUB8Ffaz5BcYNFnvbVWuRn8v7Zs7C,BC35JUb1znJxJhcaivpyUPt8Ydojec2ohC1TrFv7TntJ,True,596093494,149023373,924863,462431,462432,3zqXX6kzhkbW3d4TwD2CNjMRwxTbREXySekvq37kfCNk,36994550,259204248,-222209698,620
2022-01-08 10:34:06-05:00,2684,EanSXRkJu91FKUhPCzYxWkmM3PQUWcovEnoZXcd6vQ9E,Fg4EzAzHStoLRDPmoBUczdWnWrhAb7jKEujqAujLFT8,True,467867106,116966776,723831,361915,361916,4BnQKPLuE3DMTtxp8MjUBytgnhvxqq3ZTqZHTVZo4JJh,28953247,176601693,-147648446,618
2022-01-08 10:34:51-05:00,2685,GjQQ2fQ7mrGjWZwjVYFUKp9NM1LmfkhEo675ovU5SPa8,ECgVUMRY5nB4MALs5drDyipF7YohCPuJpj2UegCs7HMn,True,38471101,9617775,59578,29789,29789,GAUsoe8ZTCiGPm2hYxRPGxcPe5ShNzHK9eE3G2zgRjxd,2383157,14617632,-12234475,619
2022-01-08 10:34:51-05:00,2686,DmrkajG3SrTXnYSYxGRfkzfvhkevD6RdtFk4SdLC2G6Q,5r7vkWH985E2mGSDBtznduhuu5PbZJ7d4zxjzhzEEZG1,True,75346971704,18836742926,117146010,58573005,58573005,3zqXX6kzhkbW3d4TwD2CNjMRwxTbREXySekvq37kfCNk,4685840421,33527367395,-28841526974,621
2022-01-08 10:34:56-05:00,2687,8WHDaiE6LqFFmCVMnPeLEQ99R6ft8b74UfmP9BqzjcE8,CGmoDGsdnjo3zMNrW78n2xxQr1aDPAiBYiXbyciLXYMu,True,463776521,115944129,721807,360903,360904,DddJ7EWCmYEEZETCBNgAUSg81Ls6fZtiAaY5ekJ5sXx1,28872290,176582353,-147710063,622
2022-01-08 10:34:56-05:00,2688,CCP5P6U4xBjea3snWgwBb5rtaounEAsNHpWzTUeNtVf9,GE2Bxc837ybP7sNR487U4bVbx68qyX2HtwPBLfEd4BDj,True,1324808492,331202123,2044349,1022174,1022175,DddJ7EWCmYEEZETCBNgAUSg81Ls6fZtiAaY5ekJ5sXx1,81773969,290995477,-209221508,617
2022-01-08 10:34:56-05:00,2689,EF6H6aW1p3qcAtiLFU9rbFYfsKfD683meHXDw8hLdaZK,8vfJbpnK7SQcjpEBCzZJRW8JosNbsmTeJ2YXZCbM225c,True,226313285,56578321,351898,175949,175949,DddJ7EWCmYEEZETCBNgAUSg81Ls6fZtiAaY5ekJ5sXx1,14075956,74481355,-60405399,621
2022-01-08 10:34:56-05:00,2690,GXfjQr2ihTfLRys1DMetVGocd1sU97KdoCJ6x4HxdW1U,9GHvjJJXjbVz5D3RBfP3njcdRRXnFsXZ68jFa2LiGwsy,True,337901651,84475412,525396,262698,262698,3zqXX6kzhkbW3d4TwD2CNjMRwxTbREXySekvq37kfCNk,21015861,131713535,-110697674,621
2022-01-08 10:34:56-05:00,2691,BHpLpoGQ27T6Q4CT8H4dzqS8KF8Vj5rqmqfcodoBzpgR,Akn3tG2hQBfBVtNYCeXchfzfcsyCuSpkGpFoMLEKwcBF,True,21368999,5342249,33271,16635,16636,3zqXX6kzhkbW3d4TwD2CNjMRwxTbREXySekvq37kfCNk,1330875,8830276,-7499401,622
2022-01-08 10:34:56-05:00,2692,F9s8a7Cpiw5dw3a2aNFMofqwyDWNXvDLnSdJzoj1gRiV,GpKsQKJD79KBRWdCTkyi4zX7NaoCWsLUjrKxAwJB6o6s,True,50666520,12666630,75558,37779,37779,72FwbpFGoLEazJEdpqNtPNefsadUrimUqma9wSoy4qiS,3022353,9580019,-6557666,596
2022-01-08 10:34:56-05:00,2693,GxFxvEUdWofneMmVvhCSScH9V6Zia5WJ2J9q6CpPnaq3,ATLykiHDii3Lw53MoZXwqu1FbBNPJbVNVGe2SoQMjVmY,True,7715829,1928957,11754,5877,5877,3zqXX6kzhkbW3d4TwD2CNjMRwxTbREXySekvq37kfCNk,470199,3430738,-2960539,609
2022-01-08 10:55:21-05:00,2694,GXSysysoV8Z4xBrQsaKUsSrpoWeTTUsbFmgfZDaQu4ZM,6FJyraiLgG3tb9B7pi4YFsJNtRVBNaghnm1ajzneVv7b,True,2128910983,532227745,3324767,1662383,1662384,HfEnetJ7uBSmZWCjBNxdvv9HEC5nsW4wDV7wu6WnhWan,132990681,513729698,-380739017,624
2022-01-08 11:32:06-05:00,2695,56488NdcUy6Hi6X5SLs2GFtW5pG4u5wJpH7vHdxTCx4z,tGgXjJeVr3W2m3T2NXPCqpBEd6HJKE2cRsgCyiDZQy4,True,68458286,17114571,107128,53564,53564,DddJ7EWCmYEEZETCBNgAUSg81Ls6fZtiAaY5ekJ5sXx1,4285149,30749738,-26464589,625
2022-01-08 11:32:52-05:00,2696,864zY9zuCktUurPTtdGeLvUATnDqHZpT1GeWUApsXh2m,CzatBrNJUi7MeyfbNhszRaPMidgt8Xkcmy5ZwFMP9RCs,True,34927456,8731864,53946,26973,26973,DddJ7EWCmYEEZETCBNgAUSg81Ls6fZtiAaY5ekJ5sXx1,2157840,15497614,-13339774,617
2022-01-08 11:32:52-05:00,2697,9RtNbEZ4ZR8T1HFF4cujPVy2kejVBKFo3CPQi8psSa1q,7zwaGb71jKc9y2HKCKy5q2XV2YUphkyU1hkDaab1GBas,True,219225628,54806406,339202,169601,169601,4BnQKPLuE3DMTtxp8MjUBytgnhvxqq3ZTqZHTVZo4JJh,13568086,49329833,-35761747,618
2022-01-08 11:33:17-05:00,2698,9psSuFHBGqCvcgNMc7aTMhKMMFwBDmW7v5Wkn22KtTHj,7zi9LSfuEhXccQXSRukRRwgQUaiQVVgfsGaRYLP2JvwB,True,3768999217,942249804,5896708,2948354,2948354,3zqXX6kzhkbW3d4TwD2CNjMRwxTbREXySekvq37kfCNk,235868347,909359130,-673490783,625
2022-01-08 11:33:31-05:00,2699,5SwL5U5hhQXPW1HXFf4GuU4xkmXoAKx58pjY53NPHqWS,7zB7JvYFzEEwawJy7k7NXvBSG3UsbQte7JxgwvBNbS7U,True,332385955,83096488,504117,252058,252059,DddJ7EWCmYEEZETCBNgAUSg81Ls6fZtiAaY5ekJ5sXx1,20164708,175407840,-155243132,606
2022-01-08 11:33:31-05:00,2700,DmEVzPyCKnm89v481V2ic57vyikwwMja75uVZ2rjvjfp,38fPZzP4NwTtx7Qu6DLSqx9Sv8e5CQbSrr2BMvVmSy4J,True,40059273,10014818,62058,31029,31029,4BnQKPLuE3DMTtxp8MjUBytgnhvxqq3ZTqZHTVZo4JJh,2482335,21805413,-19323078,619
2022-01-08 11:33:31-05:00,2701,BWtXpiXn1bomr28mGfQFTx1Kd58CQipEnKmeweYowDEC,9jws1qkXvWAdEtBvURVEeGcGJzt4zG2gh8AJESvjKKrx,True,181513376,45378344,271779,135889,135890,4BnQKPLuE3DMTtxp8MjUBytgnhvxqq3ZTqZHTVZo4JJh,10871183,96399018,-85527835,598
2022-01-08 11:33:31-05:00,2702,D7XummfEc3NTK4qMvZegV3FrYuqc8mNgnQu3ujwemZtg,HHiRcecqzW7sGFTio7Ph6TYv3dGt64KWv4DEKgKm84fQ,True,13396588,3349147,20104,10052,10052,3zqXX6kzhkbW3d4TwD2CNjMRwxTbREXySekvq37kfCNk,804166,6078838,-5274672,600
2022-01-08 11:33:31-05:00,2703,6cnA7PeqQgpZdA7jBg4yMzTusm8JJHRWBMup84ywJfYo,FLqcukY7RehqY6ACrwVJnGH3eRgRDe93K1jLYCQN2F3U,True,136136834,34034208,208016,104008,104008,4BnQKPLuE3DMTtxp8MjUBytgnhvxqq3ZTqZHTVZo4JJh,8320642,72907883,-64587241,611
2022-01-08 11:33:31-05:00,2704,DvuRmJkfn6FQczUKgYeaSCqwy2NTMunuAKNrnmxMvnzS,7LpWTX9dgBtW75kfEoB5WuNsDwEdw5s8CYSHh3J4qagM,True,151791562,37947890,232714,116357,116357,3zqXX6kzhkbW3d4TwD2CNjMRwxTbREXySekvq37kfCNk,9308577,69784706,-60476129,613
2022-01-08 11:39:48-05:00,2705,4ytoBUwuhAL4YYSCa6AgwrpeVF4eeU8H9NfDxMPZKxPo,Pby2szzsxDrXt4gnbmmaMccXxctZALr8miRtKhGKjsD,True,12669791,3167447,19718,9859,9859,3zqXX6kzhkbW3d4TwD2CNjMRwxTbREXySekvq37kfCNk,788756,5517232,-4728476,622
2022-01-08 11:44:30-05:00,2706,FuoFPNTdYVDkSHaBac6UC1aNJXafSNTvFJuBCdrgQQrH,ApBS1Fx83tcECMzDV6wEzEzEdg4e2hgj3djtjRUoSKK5,True,2883294704,720823675,4464123,2232061,2232062,3zqXX6kzhkbW3d4TwD2CNjMRwxTbREXySekvq37kfCNk,178564923,944871810,-766306887,619
2022-01-08 11:44:37-05:00,2707,DC4UVUDFWL3gVtgkX9hPtFgtxaA8DH5p94i4k9U3wyWv,3HCWqVvQQfRgSKitsTjGTduJ82ointZUSNtj13uea4kD,True,3131971447,782992861,4900787,2450393,2450394,HfEnetJ7uBSmZWCjBNxdvv9HEC5nsW4wDV7wu6WnhWan,196031495,1052466546,-856435051,625
2022-01-08 11:58:50-05:00,2708,EanSXRkJu91FKUhPCzYxWkmM3PQUWcovEnoZXcd6vQ9E,Fg4EzAzHStoLRDPmoBUczdWnWrhAb7jKEujqAujLFT8,True,344257155,86064288,538467,269233,269234,HfEnetJ7uBSmZWCjBNxdvv9HEC5nsW4wDV7wu6WnhWan,21538712,138923304,-117384592,625
2022-01-08 12:02:20-05:00,2709,Dc11Q7yj9HoSfndRUB8Ffaz5BcYNFnvbVWuRn8v7Zs7C,BC35JUb1znJxJhcaivpyUPt8Ydojec2ohC1TrFv7TntJ,True,438491685,109622921,684311,342155,342156,3zqXX6kzhkbW3d4TwD2CNjMRwxTbREXySekvq37kfCNk,27372449,202616767,-175244318,624
2022-01-08 12:02:46-05:00,2710,AvwHizRhHUSahmvSg4jmTUErc7vAFSmkRAEsiKhXfW1m,3UrWYx8y9N5o9GYneSe6zyyHRTZzxwvcipQfHHYh7tEs,True,4605547,1151386,7202,3601,3601,3zqXX6kzhkbW3d4TwD2CNjMRwxTbREXySekvq37kfCNk,288081,1612770,-1324689,625
2022-01-08 12:04:36-05:00,2711,Br1j5Ftafei7ysu5SmqVZSoRe4uS4qCPeKSPHg55pyiE,G8fc7QvXjfkgBFvAVUgJFQS3VaF1biL9rktBExGa87Ks,True,6374992926,1593748230,9939929,4969964,4969965,3zqXX6kzhkbW3d4TwD2CNjMRwxTbREXySekvq37kfCNk,397597168,2411955827,-2014358659,623
2022-01-08 12:04:51-05:00,2712,7oxuCEhooUZ5z2nnZRD226rcqdZgAR75SamX9DD7ejUf,CPqBb5ptWUPUJhVjshxNZCHd5RDF3fve29z4vz72JhvM,True,314248,78560,491,245,246,DddJ7EWCmYEEZETCBNgAUSg81Ls6fZtiAaY5ekJ5sXx1,19663,101191,-81528,625
2022-01-08 12:05:16-05:00,2713,CCP5P6U4xBjea3snWgwBb5rtaounEAsNHpWzTUeNtVf9,GE2Bxc837ybP7sNR487U4bVbx68qyX2HtwPBLfEd4BDj,True,974759525,243689881,1520385,760192,760193,HfEnetJ7uBSmZWCjBNxdvv9HEC5nsW4wDV7wu6WnhWan,60815416,236630464,-175815048,623
2022-01-08 12:07:56-05:00,2714,BHpLpoGQ27T6Q4CT8H4dzqS8KF8Vj5rqmqfcodoBzpgR,Akn3tG2hQBfBVtNYCeXchfzfcsyCuSpkGpFoMLEKwcBF,True,15700147,3925036,24247,12123,12124,4BnQKPLuE3DMTtxp8MjUBytgnhvxqq3ZTqZHTVZo4JJh,969915,6921085,-5951170,617
2022-01-08 12:07:57-05:00,2715,GXfjQr2ihTfLRys1DMetVGocd1sU97KdoCJ6x4HxdW1U,9GHvjJJXjbVz5D3RBfP3njcdRRXnFsXZ68jFa2LiGwsy,True,248261991,62065497,382725,191362,191363,3zqXX6kzhkbW3d4TwD2CNjMRwxTbREXySekvq37kfCNk,15309038,103500426,-88191388,616
2022-01-08 12:11:01-05:00,2716,cQqH5PtXgtCk1Vs96PgxDxzUZf2Cfx5F63j1Nkz19cs,2VVizb2qVtj8ZEpLSmJXz9hXnAiGD7GdhBxT32PbFjAY,False,40212,40212,2005,100,1905,4BnQKPLuE3DMTtxp8MjUBytgnhvxqq3ZTqZHTVZo4JJh,2005,12196,-10191,498
2022-01-08 12:12:08-05:00,2717,46TNhGwBVzedW8xSb9UY94HNeSom9iGiZzAjrKHiRM2G,7JVTiqNYeKHbyzRkKtvSEpqLPKykZso8cGUr3sX1j7QF,True,101965442,25491359,158825,79412,79413,DddJ7EWCmYEEZETCBNgAUSg81Ls6fZtiAaY5ekJ5sXx1,6353010,34431983,-28078973,623
2022-01-08 12:13:47-05:00,2718,8WHDaiE6LqFFmCVMnPeLEQ99R6ft8b74UfmP9BqzjcE8,CGmoDGsdnjo3zMNrW78n2xxQr1aDPAiBYiXbyciLXYMu,True,341078697,85269674,533751,266875,266876,3pStmNaV47N2sqUtHJHLAtCKiN9JZ6jzNY9h94ng8G1D,21350052,138889411,-117539359,625
2022-01-08 12:13:59-05:00,2719,GXSysysoV8Z4xBrQsaKUsSrpoWeTTUsbFmgfZDaQu4ZM,6FJyraiLgG3tb9B7pi4YFsJNtRVBNaghnm1ajzneVv7b,True,1564004939,391001234,2421966,1210983,1210983,HfEnetJ7uBSmZWCjBNxdvv9HEC5nsW4wDV7wu6WnhWan,96878644,415235657,-318357013,619
2022-01-08 12:14:01-05:00,2720,EF6H6aW1p3qcAtiLFU9rbFYfsKfD683meHXDw8hLdaZK,8vfJbpnK7SQcjpEBCzZJRW8JosNbsmTeJ2YXZCbM225c,True,166414255,41603563,259581,129790,129791,HfEnetJ7uBSmZWCjBNxdvv9HEC5nsW4wDV7wu6WnhWan,10383268,59008979,-48625711,623
2022-01-08 12:15:04-05:00,2721,DmrkajG3SrTXnYSYxGRfkzfvhkevD6RdtFk4SdLC2G6Q,5r7vkWH985E2mGSDBtznduhuu5PbZJ7d4zxjzhzEEZG1,True,55403058001,13850764500,86241253,43120626,43120627,DddJ7EWCmYEEZETCBNgAUSg81Ls6fZtiAaY5ekJ5sXx1,3449650154,26275303786,-22825653632,622
2022-01-08 12:15:04-05:00,2722,GjQQ2fQ7mrGjWZwjVYFUKp9NM1LmfkhEo675ovU5SPa8,ECgVUMRY5nB4MALs5drDyipF7YohCPuJpj2UegCs7HMn,True,28249271,7062317,42795,21397,21398,DddJ7EWCmYEEZETCBNgAUSg81Ls6fZtiAaY5ekJ5sXx1,1711835,11491782,-9779947,605
2022-01-08 12:15:08-05:00,2723,F9s8a7Cpiw5dw3a2aNFMofqwyDWNXvDLnSdJzoj1gRiV,GpKsQKJD79KBRWdCTkyi4zX7NaoCWsLUjrKxAwJB6o6s,True,37330250,9332562,56674,28337,28337,3zqXX6kzhkbW3d4TwD2CNjMRwxTbREXySekvq37kfCNk,2266993,7854934,-5587941,607
2022-01-08 12:15:14-05:00,2724,DRVtEzZs9u9ysrcANZLEjrvbuuGqYn77v2h4cDFKuNUx,Fv9qiMZhuSBL2cs9AWUYbDLQjB46W2ZwrhxaNXtPLDpC,True,43088611,10772152,66877,33438,33439,3zqXX6kzhkbW3d4TwD2CNjMRwxTbREXySekvq37kfCNk,2675109,9960498,-7285389,620
2022-01-08 12:15:17-05:00,2725,GxFxvEUdWofneMmVvhCSScH9V6Zia5WJ2J9q6CpPnaq3,ATLykiHDii3Lw53MoZXwqu1FbBNPJbVNVGe2SoQMjVmY,True,5684887,1421221,8872,4436,4436,3zqXX6kzhkbW3d4TwD2CNjMRwxTbREXySekvq37kfCNk,354913,2677305,-2322392,624
2022-01-08 12:33:17-05:00,2726,9psSuFHBGqCvcgNMc7aTMhKMMFwBDmW7v5Wkn22KtTHj,7zi9LSfuEhXccQXSRukRRwgQUaiQVVgfsGaRYLP2JvwB,True,2769550829,692387707,4316263,2158131,2158132,3zqXX6kzhkbW3d4TwD2CNjMRwxTbREXySekvq37kfCNk,172650528,735357697,-562707169,623
2022-01-08 12:33:31-05:00,2727,4ytoBUwuhAL4YYSCa6AgwrpeVF4eeU8H9NfDxMPZKxPo,Pby2szzsxDrXt4gnbmmaMccXxctZALr8miRtKhGKjsD,True,9312578,2328144,14471,7235,7236,DddJ7EWCmYEEZETCBNgAUSg81Ls6fZtiAaY5ekJ5sXx1,578860,4314989,-3736129,621
2022-01-08 12:35:26-05:00,2728,4miF1JWfTjjFHkrpffjGFGVfkkWFME4smk47dEcxpH4y,c4QGrEkmzRKVDbYJe3FuQfrzqBqajt8mnaKJYF2Fy3t,True,470950481,117737620,733641,366820,366821,DddJ7EWCmYEEZETCBNgAUSg81Ls6fZtiAaY5ekJ5sXx1,29345660,111065179,-81719519,623
2022-01-08 12:35:38-05:00,2729,DY6k3Dkwe18iLneaT8Xo3VpJWB6V4jWwQQjoDvEzdg2j,3GGV7S9FpRQGbARBXkvGFVqLrmw8JvYAcpnR1aKVUY2f,True,29659425,7414856,46322,23161,23161,3zqXX6kzhkbW3d4TwD2CNjMRwxTbREXySekvq37kfCNk,1852893,15314193,-13461300,624
2022-01-08 12:35:45-05:00,2730,DkvR2xUPMyXWGGkUSmDSfhp7RtvMkfbT1ThKCS3TwrXd,F7jYV6TtT1LZ5XCNn1zkbUfNMo4gGcQUczAQy1jLHpaW,True,1457359095,364339773,2275715,1137857,1137858,DddJ7EWCmYEEZETCBNgAUSg81Ls6fZtiAaY5ekJ5sXx1,91028630,546635756,-455607126,624
2022-01-08 12:35:46-05:00,2731,8T4WK27RvWVGqPuNqY6whk1fmU4vd5qaUQPZG1GJ79bh,DvSz7knS8N3K7L6JhQf1s4mJSyxB8uJXNQXtyjJn8QRL,True,162132405,40533100,251750,125875,125875,3zqXX6kzhkbW3d4TwD2CNjMRwxTbREXySekvq37kfCNk,10070008,69027901,-58957893,621
2022-01-08 12:36:31-05:00,2732,7CSCMFa9W52tBDVUbXbc3woAy3GByeA1wPJdp3MgznPa,3447ptuVFu6G8B6N63RmS8mRv4n9PfHneypHLvbeaGLn,True,254907988,63726996,397044,198522,198522,3zqXX6kzhkbW3d4TwD2CNjMRwxTbREXySekvq37kfCNk,15881799,103757458,-87875659,623
2022-01-08 12:36:34-05:00,2733,9WJBnVi84E926j7xEd566WzrZJkPJWRgmEnYj9vyjuad,4dLaFS5F7TGyLdwuJLMGkz3bSL53aHzd9ZfpNmhHxXeF,True,36753727,9188431,57268,28634,28634,4BnQKPLuE3DMTtxp8MjUBytgnhvxqq3ZTqZHTVZo4JJh,2290756,16720874,-14430118,623
2022-01-08 12:36:34-05:00,2734,8E3K7vCHJ2xjdFofPRGLbMxrkm8UYEi926QmXPAFwsqe,4qHUDA1c43Dg4qi1ZPKqmpGYiEMUZ6r4UuzB5ftHCEhW,True,3393014031,848253507,5281037,2640518,2640519,DddJ7EWCmYEEZETCBNgAUSg81Ls6fZtiAaY5ekJ5sXx1,211241490,1561889250,-1350647760,622
2022-01-08 12:38:04-05:00,2735,864zY9zuCktUurPTtdGeLvUATnDqHZpT1GeWUApsXh2m,CzatBrNJUi7MeyfbNhszRaPMidgt8Xkcmy5ZwFMP9RCs,True,25699595,6424898,40111,20055,20056,HfEnetJ7uBSmZWCjBNxdvv9HEC5nsW4wDV7wu6WnhWan,1604446,12105304,-10500858,624
2022-01-08 12:38:40-05:00,2736,FuoFPNTdYVDkSHaBac6UC1aNJXafSNTvFJuBCdrgQQrH,ApBS1Fx83tcECMzDV6wEzEzEdg4e2hgj3djtjRUoSKK5,True,2121039613,530259903,3311981,1655990,1655991,3zqXX6kzhkbW3d4TwD2CNjMRwxTbREXySekvq37kfCNk,132479262,748698003,-616218741,624
2022-01-08 12:38:48-05:00,2737,7YkgzZSgiNgRpWbreoG88UHQPCqDDwwo3XvHuj2xC3Q7,5vFivT8iffaeJgVMHaXsh7RNJhWPD9VSeecBxcezVdkq,True,1473429300,368357325,2270191,1135095,1135096,3pStmNaV47N2sqUtHJHLAtCKiN9JZ6jzNY9h94ng8G1D,90807656,350578356,-259770700,616
2022-01-08 12:38:48-05:00,2738,5vzh7WqULESYt69G7cERe6m6CUBFTghs6PsmfwUazeDL,B7wXVicmbid4cYuQJQSx7m8QrVxn7oWMZHHRdCsF15kT,True,4119056225,1029764056,6334764,3167382,3167382,DddJ7EWCmYEEZETCBNgAUSg81Ls6fZtiAaY5ekJ5sXx1,253390570,978844345,-725453775,615
2022-01-08 12:38:48-05:00,2739,9GZvAP3pWvG1R2iX6gGh1Y98uQfWNzx7A4JR8wh2pMB6,EbP9gS23sGYk2TfSy3So3KGtqJQs16zWfbsEoGUkyo5D,True,1249548662,312387165,1931441,965720,965721,4BnQKPLuE3DMTtxp8MjUBytgnhvxqq3ZTqZHTVZo4JJh,77257652,297248990,-219991338,618
2022-01-08 12:38:48-05:00,2740,G9JU2qGFe91CYZcUqdor4VEZJS5Qap8ieaiKebtQmhA6,Ej7hesFJfAJeiGtEPnmRKiETTPptxDRNjSiKaAAbfFh5,True,1287580732,321895183,1967965,983982,983983,3zqXX6kzhkbW3d4TwD2CNjMRwxTbREXySekvq37kfCNk,78718605,306517873,-227799268,611
2022-01-08 12:38:58-05:00,2741,9jeqT7xKb8hr5VRuQEFxnf93Y3zHsvmYDHz64nyE7Wte,9NqYMu528mFG2M7RYL1NuEvR9aiNAW13WwXDKuprQa7h,True,88501921,22125479,138125,69062,69063,3zqXX6kzhkbW3d4TwD2CNjMRwxTbREXySekvq37kfCNk,5525017,41068296,-35543279,624
2022-01-08 12:38:58-05:00,2742,7M96qouCsH6each8J6PbcCaciyWmC7fgSASimc2NdGVD,5FBFPgjq699BCLRb1Ec9ksU5CtxHvtdrwjDh4D3R8pDY,True,1356955557,339238889,2111048,1055524,1055524,3zqXX6kzhkbW3d4TwD2CNjMRwxTbREXySekvq37kfCNk,84441959,322666402,-238224443,622
2022-01-08 12:38:58-05:00,2743,HbgbyziAskLHFgBBKwpjDQLESabiAtcJHqtHi6KXozrJ,6nZzZCdFAo4J5nWPzkid1JtgtTe1xE8xttxQy1hrzEWM,True,1172080689,293020172,1816369,908184,908185,DddJ7EWCmYEEZETCBNgAUSg81Ls6fZtiAaY5ekJ5sXx1,72654778,278954089,-206299311,619
2022-01-08 12:38:58-05:00,2744,Dv1BABsN7amhjmGBpMQsnMkRLx7MuCVwsnuyTQeZ6uum,BCjscxVo1h16teND6KKiAUy1ftNGTMy1vEEEyAW4ttVG,True,15437393,3859348,23979,11989,11990,DddJ7EWCmYEEZETCBNgAUSg81Ls6fZtiAaY5ekJ5sXx1,959181,3671788,-2712607,621
2022-01-08 12:39:07-05:00,2745,661MsJKGwSvjunXGBBckSi1F2dpuJCn3T5FPKcyLzqAv,G2Hyuva8oKaV3PPMp4EPmanfbW8r55bTnQYAs7PXdmti,True,1593873033,398468258,2488868,1244434,1244434,3zqXX6kzhkbW3d4TwD2CNjMRwxTbREXySekvq37kfCNk,99554720,378911687,-279356967,624
2022-01-08 12:39:11-05:00,2746,AVJuLzRoU8fs1DYguypkgjAHw2qozpXZehvhmn24p7MJ,BewpttKJGCFzhe8HaBSgmoH9WrqXuafdb8zW8NTfsYV9,True,1483866444,370966611,2320186,1160093,1160093,3zqXX6kzhkbW3d4TwD2CNjMRwxTbREXySekvq37kfCNk,92807442,352730998,-259923556,625
2022-01-08 12:39:23-05:00,2747,AqEgQKT6MqEvmUTX144W3jfGh4jx8kvsnQojtC7aKg8s,H4UiVvRhub2jVEtgHe5VP43wyqiLGS3ZsSHWSdcmCRr7,True,1493647858,373411964,2336026,1168013,1168013,4BnQKPLuE3DMTtxp8MjUBytgnhvxqq3ZTqZHTVZo4JJh,93441045,355053187,-261612142,625
2022-01-08 12:39:25-05:00,2748,4uygLJDk9DFCifJ56YwMrEsvd3oQNq8tYSLnMCyWorS6,GimL4uKGvg3FFmFQSWzAcjstv3Vmk5NMgDGMKTuXYVpB,True,1239485180,309871295,1904343,952171,952172,DddJ7EWCmYEEZETCBNgAUSg81Ls6fZtiAaY5ekJ5sXx1,76173742,451514435,-375340693,614
2022-01-08 12:39:25-05:00,2749,399591e8XgY52yCMorCQ2WL6dQZTC485ZooHtmGuirhZ,JCiXAooFmKmEPQ2S7C8iSk6CLcTyrPEe1SsPSLyUGySe,True,2558314,639578,3931,1965,1966,DddJ7EWCmYEEZETCBNgAUSg81Ls6fZtiAaY5ekJ5sXx1,157276,1336146,-1178870,614
2022-01-08 12:39:25-05:00,2750,D9VKhnfLLCrntDGFYSfoxFaY76VnHmYZ1ZbyFXdKdibz,2hRCRH2pMDyQGYcXHa8Y6BZo6FbcGZf5VJC1v8Bp6tGa,True,219803656,54950914,338545,169272,169273,DddJ7EWCmYEEZETCBNgAUSg81Ls6fZtiAaY5ekJ5sXx1,13541819,72977767,-59435948,616
2022-01-08 12:39:27-05:00,2751,FhAt6pZW3k8StP9VLeWUfidpXfRLoKWdV7Wgxdh9cRy9,Guk93pTo3KcG8konHjJ52oi9rgexmmKhPQAkxZS1BtCG,True,418835128,104708780,653379,326689,326690,HfEnetJ7uBSmZWCjBNxdvv9HEC5nsW4wDV7wu6WnhWan,26135196,169669614,-143534418,623
2022-01-08 12:39:32-05:00,2752,FnAT8HKGgisYfeAbxKU2gSbCp8KbZHULRpaJX1NVijHy,2u637Crc2QzfSJmCnRNqeib3aZQVn4NGncpgM3Ph6jvm,True,81969703,20492425,127184,63592,63592,4BnQKPLuE3DMTtxp8MjUBytgnhvxqq3ZTqZHTVZo4JJh,5087377,23614648,-18527271,620
2022-01-08 12:39:32-05:00,2753,8kJu5aqVSmW8FSZR9h6F75ftn9V2U9uMLBEKeqRaC855,FhVHByujkvwwtjTVpZ4mqSUqoMoBgeLUc5H7rbz3FgAt,True,211225778,52806444,325800,162900,162900,4BnQKPLuE3DMTtxp8MjUBytgnhvxqq3ZTqZHTVZo4JJh,13032010,110342402,-97310392,616
2022-01-08 12:39:34-05:00,2754,A4tDE948CPFPh1UwHb8sXryfKktbxZ8BCkqXgA5DJHA8,3zXeKMrsEpCe5fQumLNzCgpxcG1kLJFEAtJuqxLsC6ZG,True,207054476,51763619,318388,159194,159194,4BnQKPLuE3DMTtxp8MjUBytgnhvxqq3ZTqZHTVZo4JJh,12735539,81133352,-68397813,615
2022-01-08 12:39:54-05:00,2755,9RtNbEZ4ZR8T1HFF4cujPVy2kejVBKFo3CPQi8psSa1q,7zwaGb71jKc9y2HKCKy5q2XV2YUphkyU1hkDaab1GBas,True,161299558,40324889,252240,126120,126120,DddJ7EWCmYEEZETCBNgAUSg81Ls6fZtiAaY5ekJ5sXx1,10089628,40031302,-29941674,625
2022-01-08 12:40:51-05:00,2756,2mfcg17QocKKvDcqDH88TwxHRiS8dAQiJAGoAh1brns9,8aQLELBgaA9eXsxSciMjxWv8B1hpbUPfLwqVjEnasZbe,True,287473172,71868293,447368,223684,223684,4BnQKPLuE3DMTtxp8MjUBytgnhvxqq3ZTqZHTVZo4JJh,17894728,67889562,-49994834,622
2022-01-08 12:42:14-05:00,2757,FsMiJiJZibohKoV5QRisWCjzuFd86xSxFb4m73AQmu93,7p3TSKBaG9SV2YNDnhutQKacPKpTTmgsEfzmK51t6sYb,True,498971368,124742842,779219,389609,389610,3zqXX6kzhkbW3d4TwD2CNjMRwxTbREXySekvq37kfCNk,31168794,143944416,-112775622,624
2022-01-08 12:42:27-05:00,2758,AUH6YGBV8tDVX1E1WTo92Mubfx1DGsqfGeyUBqxo4fSr,33QZgMwmW32WuvmxD8XNbmF9ea88bLe3YTtNwHV73Wwu,True,499339632,124834908,780317,390158,390159,3zqXX6kzhkbW3d4TwD2CNjMRwxTbREXySekvq37kfCNk,31212699,147826834,-116614135,625
2022-01-08 12:42:29-05:00,2759,9KD2AifD5wFD4QkHYuawXbJgLWHrfj2QPF3fT8jhGVA5,Ga9gAqmkuHbqrr31sUFPqa1xa5WNxLWJWGPUaMxQqLdj,True,2322191,580547,3527,1763,1764,DddJ7EWCmYEEZETCBNgAUSg81Ls6fZtiAaY5ekJ5sXx1,141089,1234737,-1093648,607
2022-01-08 12:42:29-05:00,2760,8sneA6wAg6geVDJ1g7YWg4R1PfjuRVzeHp1nUBJinhZa,14i1uWtmcTjrdbg3DSr9vzd5NBnxqsn1A4QdgFBZqeYM,True,278756,69687,435,217,218,4BnQKPLuE3DMTtxp8MjUBytgnhvxqq3ZTqZHTVZo4JJh,17424,108613,-91189,625
2022-01-08 12:42:30-05:00,2761,3VdSA9CED9f5swRwHX2U15U7J6Muaq8VPnCNy9CaGDHe,2YYstfnfdYic5NWmEbcUEHpccNUVd1EhuCkExvMsoMk8,True,11963542,2990885,18421,9210,9211,DddJ7EWCmYEEZETCBNgAUSg81Ls6fZtiAaY5ekJ5sXx1,736850,6281762,-5544912,615
2022-01-08 12:42:31-05:00,2762,6VJcr3VAEcEZaHEpt48QL8QxHKABufVp8n2JSEVTLh9U,8naR6kiySKj3vai9dCetdgCnCHgf2oyLjGqKTJ3Lz64Y,True,2778495107,694623776,4269812,2134906,2134906,DddJ7EWCmYEEZETCBNgAUSg81Ls6fZtiAaY5ekJ5sXx1,170792500,1090739228,-919946728,614
2022-01-08 12:42:36-05:00,2763,A36aouot1oFLUtswuBUM4EVcis9chKaSJu53MRoPDjab,33U9gpq1RRFMGWDrWa3ezXXkwgBewdAS6QGgGVPtGvqb,True,642487060,160621765,987762,493881,493881,DddJ7EWCmYEEZETCBNgAUSg81Ls6fZtiAaY5ekJ5sXx1,39510502,184597288,-145086786,614
2022-01-08 12:49:09-05:00,2764,CCP5P6U4xBjea3snWgwBb5rtaounEAsNHpWzTUeNtVf9,GE2Bxc837ybP7sNR487U4bVbx68qyX2HtwPBLfEd4BDj,True,715817360,178954340,1101068,550534,550534,HfEnetJ7uBSmZWCjBNxdvv9HEC5nsW4wDV7wu6WnhWan,44042747,191182607,-147139860,615
2022-01-08 12:49:14-05:00,2765,GXfjQr2ihTfLRys1DMetVGocd1sU97KdoCJ6x4HxdW1U,9GHvjJJXjbVz5D3RBfP3njcdRRXnFsXZ68jFa2LiGwsy,True,182262307,45565576,274803,137401,137402,3zqXX6kzhkbW3d4TwD2CNjMRwxTbREXySekvq37kfCNk,10992126,81071814,-70079688,603
2022-01-08 12:49:14-05:00,2766,BHpLpoGQ27T6Q4CT8H4dzqS8KF8Vj5rqmqfcodoBzpgR,Akn3tG2hQBfBVtNYCeXchfzfcsyCuSpkGpFoMLEKwcBF,True,11525997,2881499,17413,8706,8707,3zqXX6kzhkbW3d4TwD2CNjMRwxTbREXySekvq37kfCNk,696554,5409054,-4712500,604
2022-01-08 12:49:15-05:00,2767,E5biUzKn2s5frKseCmfWriWjrYMGVtmLrhR9nYhAkVvR,BDHzqefisuGoMGcpML8t6KAC7rcErvhLcfV8KQC7oHAH,True,45088883,11272220,70478,35239,35239,3zqXX6kzhkbW3d4TwD2CNjMRwxTbREXySekvq37kfCNk,2819132,14644294,-11825162,625
2022-01-08 12:49:44-05:00,2768,5kwvkEtRFFD84j4ntVgxkacadgJaFvQ9JLhJqzLR7Y3G,GpMMkTv9T7y8DTiizuoJUsWvnSk3GSxADjRMGyYpryxm,True,56066786,14016696,87097,43548,43549,DddJ7EWCmYEEZETCBNgAUSg81Ls6fZtiAaY5ekJ5sXx1,3483914,15393616,-11909702,621
2022-01-08 12:50:49-05:00,2769,46TNhGwBVzedW8xSb9UY94HNeSom9iGiZzAjrKHiRM2G,7JVTiqNYeKHbyzRkKtvSEpqLPKykZso8cGUr3sX1j7QF,True,74948591,18737147,116717,58358,58359,3zqXX6kzhkbW3d4TwD2CNjMRwxTbREXySekvq37kfCNk,4668693,27253516,-22584823,622
2022-01-08 12:51:07-05:00,2770,BJaaH1SK1pF2kZQzmYpLFfDtm52CR9a5rd39RAPtLe8q,HUsT5FVxaisdnCvG1BQxX6zffjfL2Rwx5mMo5y8SDV7e,True,93258635,23314658,145509,72754,72755,DddJ7EWCmYEEZETCBNgAUSg81Ls6fZtiAaY5ekJ5sXx1,5820374,23219179,-17398805,624
2022-01-08 12:51:27-05:00,2771,8trkirSQNdMmAcJdeswxs5cPjH8dD6U4eJtWiAdMsrDB,HaSzpQ45x2MipfN17U6jGBxX8tXboomVDhXNSrnEfLDr,True,7918694,1979673,12348,6174,6174,HfEnetJ7uBSmZWCjBNxdvv9HEC5nsW4wDV7wu6WnhWan,493958,2934845,-2440887,623
2022-01-08 12:53:34-05:00,2772,5Rxuqgs4CaSKbfDXqBMFXkLTQ9dxrUjThXzoy3ouYVtK,BgvbKru66ebrGUcFFymGTmsaQv6GgcGMybiWaXqzBtwX,True,368906,92226,569,284,285,4BnQKPLuE3DMTtxp8MjUBytgnhvxqq3ZTqZHTVZo4JJh,22790,205286,-182496,617
2022-01-08 12:53:44-05:00,2773,HdfQweV1KuYSpWdycZbpGrUc8yMcY3ZczLn1agKXMJaf,G1Ae1PZHkANkwFnhUKS1tvdFEv8dAFeojBkezh6rUNMh,True,12816016,3204004,20050,10025,10025,3zqXX6kzhkbW3d4TwD2CNjMRwxTbREXySekvq37kfCNk,802029,5523310,-4721281,625
2022-01-08 12:53:45-05:00,2774,2jDRvE3pQNjWy1NRFa4tzB3KmU5UkbUCHw8sQRFujo66,C4zNi2szDrEEh4coTF3WRUghfP4ZwAVVSYTLWfkejQRu,True,1146500123,286625030,1781163,890581,890582,DddJ7EWCmYEEZETCBNgAUSg81Ls6fZtiAaY5ekJ5sXx1,71246550,364128484,-292881934,621
2022-01-08 12:53:45-05:00,2775,HwosLQgDY1xtHQRQ4hzroPQHFWssPzTj5vRkP37FcviB,HKTNEYNXrephNkH7apbobK4mcQXcNayQA4W1NgM6sLr8,True,80577935,20144483,125850,62925,62925,4BnQKPLuE3DMTtxp8MjUBytgnhvxqq3ZTqZHTVZo4JJh,5034030,22751002,-17716972,624
2022-01-08 12:53:46-05:00,2776,3ogBPSRcKfmwzgumVDHBkXLi1eCsEFG2xzSJgD4LQDNy,7TXyqWgJqfe71MSWFA2n7ufZbUdzf7JJoWej8FNNtMXo,True,37409747,9352436,58324,29162,29162,DddJ7EWCmYEEZETCBNgAUSg81Ls6fZtiAaY5ekJ5sXx1,2332992,12904953,-10571961,623
2022-01-08 12:53:51-05:00,2777,A1j2G5FZRyWSjFt6dK87WHhLkQrPUVqHaM3KhSzhAKDT,2fMiHLYm4pL3YCd8aveTR4mT9uVxztQeMwb5eRZb4wUW,True,1242564,310641,1944,972,972,3zqXX6kzhkbW3d4TwD2CNjMRwxTbREXySekvq37kfCNk,77774,522542,-444768,625
2022-01-08 12:53:51-05:00,2778,5BJnMHFSiQjHRGFJDW1jnqCfkHHYWnQzmmccy9eA4jNj,9517JGYsPmvgPUM9pFRD2vipHmdgE578F7jA7Qq6jorm,True,928892741,232223185,1449225,724612,724613,3zqXX6kzhkbW3d4TwD2CNjMRwxTbREXySekvq37kfCNk,57969011,350995201,-293026190,624
2022-01-08 12:54:20-05:00,2779,GXSysysoV8Z4xBrQsaKUsSrpoWeTTUsbFmgfZDaQu4ZM,6FJyraiLgG3tb9B7pi4YFsJNtRVBNaghnm1ajzneVv7b,True,1148939345,287234836,1759807,879903,879904,4BnQKPLuE3DMTtxp8MjUBytgnhvxqq3ZTqZHTVZo4JJh,70392318,333293730,-262901412,612
2022-01-08 12:54:27-05:00,2780,DRVtEzZs9u9ysrcANZLEjrvbuuGqYn77v2h4cDFKuNUx,Fv9qiMZhuSBL2cs9AWUYbDLQjB46W2ZwrhxaNXtPLDpC,True,31682500,7920625,49356,24678,24678,3zqXX6kzhkbW3d4TwD2CNjMRwxTbREXySekvq37kfCNk,1974273,8072301,-6098028,623
2022-01-08 12:54:28-05:00,2781,8xvLGVeDmhVYQhN2ZpWkVG9jCrukRsNQ4926a4TMiZqa,9ciBySSjvADwp47WkETiFWZKVTFL8Hf1XvK7aSxhcgQS,True,44225723,11056430,69186,34593,34593,4BnQKPLuE3DMTtxp8MjUBytgnhvxqq3ZTqZHTVZo4JJh,2767470,16800064,-14032594,625
2022-01-08 12:55:12-05:00,2782,9psSuFHBGqCvcgNMc7aTMhKMMFwBDmW7v5Wkn22KtTHj,7zi9LSfuEhXccQXSRukRRwgQUaiQVVgfsGaRYLP2JvwB,True,2035415075,508853768,3164655,1582327,1582328,3zqXX6kzhkbW3d4TwD2CNjMRwxTbREXySekvq37kfCNk,126586218,590582108,-463995890,621
2022-01-08 12:55:23-05:00,2783,EF6H6aW1p3qcAtiLFU9rbFYfsKfD683meHXDw8hLdaZK,8vfJbpnK7SQcjpEBCzZJRW8JosNbsmTeJ2YXZCbM225c,True,122310601,30577649,190589,95294,95295,72FwbpFGoLEazJEdpqNtPNefsadUrimUqma9wSoy4qiS,7623596,46593472,-38969876,623
2022-01-08 12:55:23-05:00,2784,4ytoBUwuhAL4YYSCa6AgwrpeVF4eeU8H9NfDxMPZKxPo,Pby2szzsxDrXt4gnbmmaMccXxctZALr8miRtKhGKjsD,True,6844638,1711159,10614,5307,5307,3zqXX6kzhkbW3d4TwD2CNjMRwxTbREXySekvq37kfCNk,424593,3366490,-2941897,620
2022-01-08 12:55:36-05:00,2785,CbhrZUdan1axNDFUrX1ZuEohfNMEGrszKSkk6pppVQuw,DHEAjJNtuEePezYAv77thWabbVxxqQpfuiC6moRSrpG1,True,164069157,41017289,256513,128256,128257,3zqXX6kzhkbW3d4TwD2CNjMRwxTbREXySekvq37kfCNk,10260537,86167140,-75906603,625
2022-01-08 12:55:36-05:00,2786,8WHDaiE6LqFFmCVMnPeLEQ99R6ft8b74UfmP9BqzjcE8,CGmoDGsdnjo3zMNrW78n2xxQr1aDPAiBYiXbyciLXYMu,True,250667460,62666864,391868,195934,195934,3zqXX6kzhkbW3d4TwD2CNjMRwxTbREXySekvq37kfCNk,15674738,108972428,-93297690,625
2022-01-08 12:55:49-05:00,2787,36ByQojnxEckWdQTjqHfxKqCx9yjqWQsPsZyqaN72UWR,AZoirtS1fjX61agRM64tqThVinnJTh3BWgiHyNHPTgZP,True,1419588,354896,2220,1110,1110,3zqXX6kzhkbW3d4TwD2CNjMRwxTbREXySekvq37kfCNk,88832,734575,-645743,625
2022-01-08 12:56:27-05:00,2788,4miF1JWfTjjFHkrpffjGFGVfkkWFME4smk47dEcxpH4y,c4QGrEkmzRKVDbYJe3FuQfrzqBqajt8mnaKJYF2Fy3t,True,346057200,86514300,536408,268204,268204,4BnQKPLuE3DMTtxp8MjUBytgnhvxqq3ZTqZHTVZo4JJh,21456358,89907799,-68451441,620
2022-01-08 12:56:38-05:00,2789,Br1j5Ftafei7ysu5SmqVZSoRe4uS4qCPeKSPHg55pyiE,G8fc7QvXjfkgBFvAVUgJFQS3VaF1biL9rktBExGa87Ks,True,4686792910,1171698227,7330136,3665068,3665068,3zqXX6kzhkbW3d4TwD2CNjMRwxTbREXySekvq37kfCNk,293205453,1898623918,-1605418465,625
2022-01-08 12:57:10-05:00,2790,BWtXpiXn1bomr28mGfQFTx1Kd58CQipEnKmeweYowDEC,9jws1qkXvWAdEtBvURVEeGcGJzt4zG2gh8AJESvjKKrx,True,133891538,33472884,208447,104223,104224,DddJ7EWCmYEEZETCBNgAUSg81Ls6fZtiAaY5ekJ5sXx1,8337889,74728122,-66390233,622
2022-01-08 12:57:15-05:00,2791,D7XummfEc3NTK4qMvZegV3FrYuqc8mNgnQu3ujwemZtg,HHiRcecqzW7sGFTio7Ph6TYv3dGt64KWv4DEKgKm84fQ,True,9881802,2470450,15427,7713,7714,3zqXX6kzhkbW3d4TwD2CNjMRwxTbREXySekvq37kfCNk,617093,4738741,-4121648,624
2022-01-08 12:57:15-05:00,2792,5vzh7WqULESYt69G7cERe6m6CUBFTghs6PsmfwUazeDL,B7wXVicmbid4cYuQJQSx7m8QrVxn7oWMZHHRdCsF15kT,True,3031393072,757848268,4728917,2364458,2364459,3zqXX6kzhkbW3d4TwD2CNjMRwxTbREXySekvq37kfCNk,189156709,791617647,-602460938,623
2022-01-08 12:58:36-05:00,2793,5SwL5U5hhQXPW1HXFf4GuU4xkmXoAKx58pjY53NPHqWS,7zB7JvYFzEEwawJy7k7NXvBSG3UsbQte7JxgwvBNbS7U,True,244910337,61227584,381211,190605,190606,4BnQKPLuE3DMTtxp8MjUBytgnhvxqq3ZTqZHTVZo4JJh,15248460,136062823,-120814363,622
2022-01-08 12:59:14-05:00,2794,8xQ3tsWVUe75EG1HmocULJ3kh52utveoFMEPotTGrKno,i3SKW3ywrwYucX9ySEx1C4zaUKGnzLerP3V38437NyV,True,104280969,26070241,163194,81597,81597,3zqXX6kzhkbW3d4TwD2CNjMRwxTbREXySekvq37kfCNk,6527781,45445678,-38917897,625
2022-01-08 12:59:44-05:00,2795,6cnA7PeqQgpZdA7jBg4yMzTusm8JJHRWBMup84ywJfYo,FLqcukY7RehqY6ACrwVJnGH3eRgRDe93K1jLYCQN2F3U,True,100242443,25060610,155973,77986,77987,72FwbpFGoLEazJEdpqNtPNefsadUrimUqma9wSoy4qiS,6238927,56540028,-50301101,622
2022-01-08 13:00:11-05:00,2796,H1Z83zVoskNuBvYao1FjdLfETfhPpQFQUkniJfGxbaNz,EVqbBRV6Zy1tPLRevxpAykp8Mvv6tDZVTc4RmCKw4Gq1,True,1053625812,263406452,1644457,822228,822229,3zqXX6kzhkbW3d4TwD2CNjMRwxTbREXySekvq37kfCNk,65778310,486946032,-421167722,624
2022-01-08 13:00:12-05:00,2797,BgnsCfJ54ReunUtwPJLzkW4PWnqpBDWGNYxsW5PvDrbK,KpMqEkQ9dKMgCevsEK895wHd3fCLRPSzDmJSv3tKU4u,True,25539554205,6384888551,39783628,19891814,19891814,DddJ7EWCmYEEZETCBNgAUSg81Ls6fZtiAaY5ekJ5sXx1,1591345127,8788354070,-7197008943,623
2022-01-08 13:00:13-05:00,2798,BMn3FQ6axnUt5K3esCEgoVi8GZAcPCg3YrjcwAFVvTah,HEvRK6CPti7aoTaYExEQAyr9ZyTQ6u4jg5Y2btc7ovdd,False,126557,126557,6070,303,5767,3zqXX6kzhkbW3d4TwD2CNjMRwxTbREXySekvq37kfCNk,6070,34156,-28086,479
2022-01-08 13:00:14-05:00,2799,JDeYjCLpfnzcfxDFgHf4aBcHsajwdR14GUaKAA9euzVf,EJbvKoyMZcoCx4vWa61uMbW2vr6mUhrgEuECdteVBuZZ,True,13734193,3433548,20694,10347,10347,4BnQKPLuE3DMTtxp8MjUBytgnhvxqq3ZTqZHTVZo4JJh,827775,7575932,-6748157,602
2022-01-08 13:00:20-05:00,2800,5eMLdQ4gYA5iqvTXSNdGvctHp7s5VpyFuwtJKqx6chBc,Ckxc5K39nkBNXBTmFTM8J48R7wGqNm3vHKZu4G5baumZ,True,578011599,144502899,881002,440501,440501,DddJ7EWCmYEEZETCBNgAUSg81Ls6fZtiAaY5ekJ5sXx1,35240114,181457745,-146217631,609
2022-01-08 13:00:21-05:00,2801,Bsr6kx1B6BSEd5UnJ7Z61M49iUb3bFrDVhiEtMVtPDF2,3CFd1pUJAJPA9fobwn4Jj2mRju1CWmoop4Mh4znypNWT,True,51648451,12912112,80514,40257,40257,DddJ7EWCmYEEZETCBNgAUSg81Ls6fZtiAaY5ekJ5sXx1,3220566,17740976,-14520410,623
2022-01-08 13:00:24-05:00,2802,DmEVzPyCKnm89v481V2ic57vyikwwMja75uVZ2rjvjfp,38fPZzP4NwTtx7Qu6DLSqx9Sv8e5CQbSrr2BMvVmSy4J,True,29478105,7369526,46099,23049,23050,DddJ7EWCmYEEZETCBNgAUSg81Ls6fZtiAaY5ekJ5sXx1,1843975,16902677,-15058702,625
2022-01-08 13:00:24-05:00,2803,H3x9b27yHVdCxvtDf7mmJxkNeubcmQMwfAkLTYADPWNv,HGVCCz23rWx78vrTB2wvm2aesbLZuYFhhNuznGiSSAyA,True,5871023407,1467755851,9132565,4566282,4566283,72FwbpFGoLEazJEdpqNtPNefsadUrimUqma9wSoy4qiS,365302630,1161952398,-796649768,622
2022-01-08 13:00:24-05:00,2804,56488NdcUy6Hi6X5SLs2GFtW5pG4u5wJpH7vHdxTCx4z,tGgXjJeVr3W2m3T2NXPCqpBEd6HJKE2cRsgCyiDZQy4,True,50297911,12574477,77729,38864,38865,3zqXX6kzhkbW3d4TwD2CNjMRwxTbREXySekvq37kfCNk,3109160,24003461,-20894301,618
2022-01-08 13:00:27-05:00,2805,8aKqLY7GXxNnGRK8Utke7o6EDGZATNDDF8Ph9Q27ppyi,7MQKkebLEzQgjWjByBMzzkn68yqtYivS4VDcraAScZR6,True,2508718,627178,3853,1926,1927,3zqXX6kzhkbW3d4TwD2CNjMRwxTbREXySekvq37kfCNk,154157,614775,-460618,614
2022-01-08 13:00:33-05:00,2806,2MbNCikBC3fdwqJKfMK1FjPg7wT3xWMXmN88XuikJ8r9,5eG6U5x63YYMpE7iwwu1TPcZapvQMyKczvtnFfST1BH3,False,90484,90484,4482,224,4258,DddJ7EWCmYEEZETCBNgAUSg81Ls6fZtiAaY5ekJ5sXx1,4482,31438,-26956,495
2022-01-08 13:04:35-05:00,2807,DvuRmJkfn6FQczUKgYeaSCqwy2NTMunuAKNrnmxMvnzS,7LpWTX9dgBtW75kfEoB5WuNsDwEdw5s8CYSHh3J4qagM,True,111769861,27942465,174107,87053,87054,HfEnetJ7uBSmZWCjBNxdvv9HEC5nsW4wDV7wu6WnhWan,6964303,54395785,-47431482,623
2022-01-08 13:04:41-05:00,2808,Dv1BABsN7amhjmGBpMQsnMkRLx7MuCVwsnuyTQeZ6uum,BCjscxVo1h16teND6KKiAUy1ftNGTMy1vEEEyAW4ttVG,True,11347532,2836883,17586,8793,8793,3zqXX6kzhkbW3d4TwD2CNjMRwxTbREXySekvq37kfCNk,703462,2968437,-2264975,619
2022-01-08 13:04:51-05:00,2809,7ptPfZnqDCvTWotn8wPGyzERTJYLBgk47j7qf8Ciq941,AfAGcFqFFPi6LCQXydgsPWidN35c7NbhBa7RLEaDQQCu,True,7492931,1873230,11667,5833,5834,3zqXX6kzhkbW3d4TwD2CNjMRwxTbREXySekvq37kfCNk,466699,2365699,-1899000,622
2022-01-08 13:05:41-05:00,2810,CCP5P6U4xBjea3snWgwBb5rtaounEAsNHpWzTUeNtVf9,GE2Bxc837ybP7sNR487U4bVbx68qyX2HtwPBLfEd4BDj,True,526945888,131736472,824183,412091,412092,3zqXX6kzhkbW3d4TwD2CNjMRwxTbREXySekvq37kfCNk,32967347,153254008,-120286661,625
2022-01-08 13:05:42-05:00,2811,GXfjQr2ihTfLRys1DMetVGocd1sU97KdoCJ6x4HxdW1U,9GHvjJJXjbVz5D3RBfP3njcdRRXnFsXZ68jFa2LiGwsy,True,134362638,33590659,209216,104608,104608,3zqXX6kzhkbW3d4TwD2CNjMRwxTbREXySekvq37kfCNk,8368643,63263593,-54894950,622
2022-01-08 13:05:42-05:00,2812,6NJFN855M3Q3RLTDNo57gTgAmwPD6G2E3WvMb1m5eNCN,3YpqNnonsvXaRT4nCC3G5FZx1jjVtbDPc36LiR6WK5jR,True,134056681,33514170,208674,104337,104337,3zqXX6kzhkbW3d4TwD2CNjMRwxTbREXySekvq37kfCNk,8346982,72598943,-64251961,622
2022-01-08 13:05:50-05:00,2813,BHpLpoGQ27T6Q4CT8H4dzqS8KF8Vj5rqmqfcodoBzpgR,Akn3tG2hQBfBVtNYCeXchfzfcsyCuSpkGpFoMLEKwcBF,True,8496602,2124150,13258,6629,6629,3zqXX6kzhkbW3d4TwD2CNjMRwxTbREXySekvq37kfCNk,530323,4212599,-3682276,624
2022-01-08 13:06:03-05:00,2814,D64rDiWT3YG28fCgXCmbNjYa2JakZbpKQ1D2XuLChUfV,8WmMWq8cTsGQym5pUbHm9dPCpJugBeWUMVERYFGLxWHj,True,62902701,15725675,97852,48926,48926,3zqXX6kzhkbW3d4TwD2CNjMRwxTbREXySekvq37kfCNk,3914095,20105523,-16191428,622
2022-01-08 13:06:25-05:00,2815,9jeqT7xKb8hr5VRuQEFxnf93Y3zHsvmYDHz64nyE7Wte,9NqYMu528mFG2M7RYL1NuEvR9aiNAW13WwXDKuprQa7h,True,65068998,16267249,101751,50875,50876,3zqXX6kzhkbW3d4TwD2CNjMRwxTbREXySekvq37kfCNk,4070042,32035010,-27964968,625
2022-01-08 13:06:25-05:00,2816,ymyzGH4Qc7HH5PbKpVphCbsQgLLXyGkPcXamQJuNj5C,8oTLHaV2XzbKXNWRuUjCfHjUn61Pw93LYK14m9q2VDpZ,True,31712139,7928034,49555,24777,24778,3zqXX6kzhkbW3d4TwD2CNjMRwxTbREXySekvq37kfCNk,1982238,10607301,-8625063,625
2022-01-08 13:06:30-05:00,2817,B4Uc39nKzz9wBRQsCkMR4A7RwTJ8rSuwpR6EQn2AesRb,H49bGZgatRZVpj6QufZRVgYrQtH7LpdbiqKBs23151m,True,59669903,14917475,93300,46650,46650,3zqXX6kzhkbW3d4TwD2CNjMRwxTbREXySekvq37kfCNk,3732039,49186103,-45454064,625
2022-01-08 13:06:31-05:00,2818,8swGZMrPrLAxZd7MxTbkCL13k3DmAJUw41jCp6Xo6awW,3fKnX7yTNXAT4uMmXVdTy47ALJT8h8YSD3WiBb4BGuzH,True,408765436,102191359,637557,318778,318779,3zqXX6kzhkbW3d4TwD2CNjMRwxTbREXySekvq37kfCNk,25502288,167874300,-142372012,623
2022-01-08 13:07:10-05:00,2819,FV9CBGGTbppLnBKh79f2LzD1diTiS5g6u89FcpZHZmnK,Fe7mtmCUziFqbbYTvrhAcAq1Ub7YLfTJRtQ1hG7GzJD1,True,12532952,3133238,19560,9780,9780,HfEnetJ7uBSmZWCjBNxdvv9HEC5nsW4wDV7wu6WnhWan,782423,4272310,-3489887,624
2022-01-08 13:07:11-05:00,2820,243SAnGxchCVB1LQAUF4SsozR86yDwEdg2QQpbWGsMYe,5u8sNkb2oEQjUXJAB3yGStmv3Uwz16gBgExBo5myVK4b,True,25247733,6311933,39303,19651,19652,DddJ7EWCmYEEZETCBNgAUSg81Ls6fZtiAaY5ekJ5sXx1,1572153,7973944,-6401791,622
2022-01-08 13:07:11-05:00,2821,DMgD2KCEhTGFLUZ5GnfNcwfiiwKYbyVpoWiN6knMkCAf,5KU2vgBkPTNVHsSULjgX7ZkZS56U3Dy3xqLTxL5sUZJ3,True,3284477821,821119455,5110064,2555032,2555032,4BnQKPLuE3DMTtxp8MjUBytgnhvxqq3ZTqZHTVZo4JJh,204402575,1801644606,-1597242031,622
2022-01-08 13:07:12-05:00,2822,3WcJUt8jQ1ngL3ZCGo6dFrc3GmTMTYtzeDva7mri2Tqx,HeG1Pz2oMjqtkfsRMsbqP3VpatnVEQzcWmKDVoFp4Htr,True,37394906,9348726,58458,29229,29229,3zqXX6kzhkbW3d4TwD2CNjMRwxTbREXySekvq37kfCNk,2338348,14995465,-12657117,625
2022-01-08 13:07:12-05:00,2823,BPsM1um9ZJf7eNoVMsQCRSwgARMuLCGGSDxf9tZeNeEy,BpzDdXfxVygiSYSmsHV6uPxQMeTFtrURMCCqhswQjd5X,True,2776868,694217,4287,2143,2144,3zqXX6kzhkbW3d4TwD2CNjMRwxTbREXySekvq37kfCNk,171519,953867,-782348,617
2022-01-08 13:07:13-05:00,2824,DR7XL3qweFyTKDatQYS2LacqGLv2368cnGuWpEpk4hSL,Fd3BYCiiQfThDJsxBUNwYTMP8eNCrnXMVzE1wpejJqXa,True,10990,2747,17,8,9,DddJ7EWCmYEEZETCBNgAUSg81Ls6fZtiAaY5ekJ5sXx1,687,5136,-4449,625
2022-01-08 13:07:14-05:00,2825,BYvjENe16Ta77PqGV7JKEWrsqCTfkMGYwTSG5gXneDvd,EvxAXgvhPC6QkNurbK7vWyTApGo8J2R4EgMAknkHVU3d,True,7120590,1780147,11062,5531,5531,3zqXX6kzhkbW3d4TwD2CNjMRwxTbREXySekvq37kfCNk,442492,3999551,-3557059,621
2022-01-08 13:07:20-05:00,2826,Cs2YxkuqBK1kjoYZbUZdUcxapPbv8oC75trwGgWoCPfG,2PgHQM1GhHykE4bQ1ggueAw2Zs1BFUW5hxvMvr8DojKM,True,130912929,32728232,204849,102424,102425,4BnQKPLuE3DMTtxp8MjUBytgnhvxqq3ZTqZHTVZo4JJh,8193967,67107532,-58913565,625
2022-01-08 13:07:20-05:00,2827,aTkGURJptmKNNP6RSXSWsmVbfcriSAJaMuUiT2eZEfb,5qoGxL83PLhrguyk27X8xE6jGitRg5BaQpXzrcfEvCfJ,True,488209693,122052423,758238,379119,379119,4BnQKPLuE3DMTtxp8MjUBytgnhvxqq3ZTqZHTVZo4JJh,30329521,146574872,-116245351,621
2022-01-08 13:07:22-05:00,2828,FFoYoBmkfEsCWVXQf3BhKeaFMZD3YVKvfhPWkXdnCZS9,8yW6WApAuN43brF1HioTLdyxvQTQJzt875E26QqrWWFk,True,1276299,319074,1993,996,997,3zqXX6kzhkbW3d4TwD2CNjMRwxTbREXySekvq37kfCNk,79747,322199,-242452,624
2022-01-08 13:07:30-05:00,2829,6rb3fRVWJ5cSzFcmuC1YwdrNxiNctvboDF7HwsfyGoCA,H6JaYfFZkRk6iSJrA4nVeuFpMVQtVwQZHVgK1TyaupTE,True,99820,24955,152,76,76,3zqXX6kzhkbW3d4TwD2CNjMRwxTbREXySekvq37kfCNk,6118,71550,-65432,612
2022-01-08 13:07:30-05:00,2830,CwTus4FyoXYqyTKAYDp69NLhA1joYZ3tarzY6FFTr6fn,6ivuvYWU6i25MzJSY8rG9rPDKiq38E6QtrV1jvRubLGr,True,24082,6020,36,18,18,3zqXX6kzhkbW3d4TwD2CNjMRwxTbREXySekvq37kfCNk,1477,9386,-7909,613
2022-01-08 13:07:30-05:00,2831,6Bq55LtGCEeGqh4JrFLCmmGc2iJfTTBJixivqH78aGSE,DSNrCgWJeNe2P9tAQu5FvCueTzNKDKds7wzuwTQSMRG,True,15799982,3949995,24255,12127,12128,3zqXX6kzhkbW3d4TwD2CNjMRwxTbREXySekvq37kfCNk,970204,5298445,-4328241,614
2022-01-08 13:07:33-05:00,2832,BZxJ6CtrVoiU86DMMieMeDFLNWtMpHGTvZfM7nyay6o4,6CRxRR8bisRLHFJBFWjyumYuy7j4C4PkjYH1K8gXhdWD,True,6608855,1652212,10293,5146,5147,3zqXX6kzhkbW3d4TwD2CNjMRwxTbREXySekvq37kfCNk,411735,1871260,-1459525,623
2022-01-08 13:07:35-05:00,2833,DrzTARa7RK8RXoxHZPKCBqYtMC8TAUHRw8SznXRKTa5M,FYANet92VhyXkKZqqBJR4sFxuCftWb68sgQU9VHCdTJk,True,61322,15330,95,47,48,DddJ7EWCmYEEZETCBNgAUSg81Ls6fZtiAaY5ekJ5sXx1,3831,22611,-18780,624
2022-01-08 13:07:35-05:00,2834,7vKmhLV45Q5etXhJL5ng8rxWhYSiUCDmAbGnwBPr7zcx,cP6xPeuHLnjr858QK1F9qYn7rJpEbPy7wEJHoju6oV7,True,80374374,20093593,124724,62362,62362,3zqXX6kzhkbW3d4TwD2CNjMRwxTbREXySekvq37kfCNk,4988994,30881835,-25892841,620
2022-01-08 13:07:36-05:00,2835,X5SF9srgzDgBRBhv8xUWyszYYSQiqFF6cVnVLWzQgp1,7rTqnMkPuUUJFt5px1DxwsUK8U5fQUtnx9N4v6dA4vGb,True,61425,15356,95,47,48,3zqXX6kzhkbW3d4TwD2CNjMRwxTbREXySekvq37kfCNk,3808,23759,-19951,619
2022-01-08 13:07:36-05:00,2836,7D4rFmGMPKNAF75VRPxHAhSn2wTjiW8jmth1UD22Xqq9,GQ7BrT6vsXu8tHCMm75YdxFR2r9QTCrCUbdPEZBSAg9w,True,89013321,22253330,138251,69125,69126,3zqXX6kzhkbW3d4TwD2CNjMRwxTbREXySekvq37kfCNk,5530074,28525642,-22995568,621
2022-01-08 13:07:36-05:00,2837,DY6k3Dkwe18iLneaT8Xo3VpJWB6V4jWwQQjoDvEzdg2j,3GGV7S9FpRQGbARBXkvGFVqLrmw8JvYAcpnR1aKVUY2f,True,21800084,5450021,33971,16985,16986,4BnQKPLuE3DMTtxp8MjUBytgnhvxqq3ZTqZHTVZo4JJh,1358845,11899350,-10540505,623
2022-01-08 13:07:37-05:00,2838,5Z3ZFCA65WoWhm3okRuuziEMi7ajGAEHWUFchzBNba5S,FcomdrWidygkxMKzcsY5xELbmwC652uMci648LMTv7AB,True,23093,5773,36,18,18,DddJ7EWCmYEEZETCBNgAUSg81Ls6fZtiAaY5ekJ5sXx1,1444,8665,-7221,625
2022-01-08 13:07:39-05:00,2839,2d1qyEJRyGvB2H83ACSqUjqYLwcLHcURHWAKLXs4w9vp,EFA6rDFpTQcY2vjZMq6Qrjv56nJPN2FhWXNwFzkWtE2M,True,21057563,5264390,32763,16381,16382,DddJ7EWCmYEEZETCBNgAUSg81Ls6fZtiAaY5ekJ5sXx1,1310534,10624912,-9314378,622
2022-01-08 13:07:39-05:00,2840,2PzBAkdXkrwH9VuoMALumQz86qkW7sSBQtCrHw14JUp3,D5vwWAMHVooobG2sCWv9EwtJrAFZG6cwKH4dfmA98tbt,True,4829969,1207492,7482,3741,3741,72FwbpFGoLEazJEdpqNtPNefsadUrimUqma9wSoy4qiS,299281,1875901,-1576620,619
2022-01-08 13:07:39-05:00,2841,F1JT1p2VuwK4L7zj7NNnZtYiZiNUCcTGKDkgdoX3BZdZ,3BKe4yzTwnnBnvTWP3britpPJ4oAWL7JZJzNLCxjUufS,True,12066,3016,18,9,9,72FwbpFGoLEazJEdpqNtPNefsadUrimUqma9wSoy4qiS,744,2527,-1783,616
2022-01-08 13:08:04-05:00,2842,BhiAaiZu7fF8ndggJrLyiFVCRq526cNBw7VaeascEmNL,4en8MipPi7vq15NGhpPMQfptNdEyhp2j7fpgxBBtjyfz,True,2051651,512912,3167,1583,1584,4BnQKPLuE3DMTtxp8MjUBytgnhvxqq3ZTqZHTVZo4JJh,126712,769973,-643261,617
2022-01-08 13:08:07-05:00,2843,7oxuCEhooUZ5z2nnZRD226rcqdZgAR75SamX9DD7ejUf,CPqBb5ptWUPUJhVjshxNZCHd5RDF3fve29z4vz72JhvM,True,228902,57224,356,178,178,4BnQKPLuE3DMTtxp8MjUBytgnhvxqq3ZTqZHTVZo4JJh,14277,80292,-66015,623
2022-01-08 13:08:48-05:00,2844,gMjmD7WioyUdQdwNqE5fobLcxPwoJv5rAvLmJaf8Jjw,5n77euFjVJiwKrnbYq1KpcENW1mzBZj2BuDGyzazrkJ8,True,2135964,533990,3283,1641,1642,4BnQKPLuE3DMTtxp8MjUBytgnhvxqq3ZTqZHTVZo4JJh,131341,839058,-707717,614
2022-01-08 13:08:48-05:00,2845,J1sBDjpdBZcsSBS5eg95SSRjRqmQUR9cXJCsLJu8yCUt,F5wRpD2senMkGbL8Uquqo8W9x5NQDDa268dHuVFAZCww,True,6175171,1543792,9500,4750,4750,DddJ7EWCmYEEZETCBNgAUSg81Ls6fZtiAaY5ekJ5sXx1,380011,2761709,-2381698,615
2022-01-08 13:08:50-05:00,2846,Hy3kzXneDN6FUkiZctU1vWe97BYvj6yZ7QvQzehfWmNr,EhXgQg8BTniANV525RpY76z7Hrh6DuqrMChjqEoXfVJe,True,2981058,745264,4652,2326,2326,3zqXX6kzhkbW3d4TwD2CNjMRwxTbREXySekvq37kfCNk,186094,1353683,-1167589,624
2022-01-08 13:08:51-05:00,2847,9E97vZ6evPgg1Ao8KwvjjZhBFW6dXZrrJENk1HvZ3SU,D7U38PB8BXLwUVKbRNv9po7VcFdnn7Y4tWY9xpRiNJsT,True,88911695,22227923,138873,69436,69437,3zqXX6kzhkbW3d4TwD2CNjMRwxTbREXySekvq37kfCNk,5554927,22548293,-16993366,624
2022-01-08 13:09:18-05:00,2848,8kJu5aqVSmW8FSZR9h6F75ftn9V2U9uMLBEKeqRaC855,FhVHByujkvwwtjTVpZ4mqSUqoMoBgeLUc5H7rbz3FgAt,True,155244359,38811089,237700,118850,118850,3zqXX6kzhkbW3d4TwD2CNjMRwxTbREXySekvq37kfCNk,9508032,85668058,-76160026,612
2022-01-08 13:09:18-05:00,2849,D9VKhnfLLCrntDGFYSfoxFaY76VnHmYZ1ZbyFXdKdibz,2hRCRH2pMDyQGYcXHa8Y6BZo6FbcGZf5VJC1v8Bp6tGa,True,161540728,40385182,246677,123338,123339,3zqXX6kzhkbW3d4TwD2CNjMRwxTbREXySekvq37kfCNk,9867116,57758216,-47891100,610
2022-01-08 13:09:18-05:00,2850,FsMiJiJZibohKoV5QRisWCjzuFd86xSxFb4m73AQmu93,7p3TSKBaG9SV2YNDnhutQKacPKpTTmgsEfzmK51t6sYb,True,366803595,91700898,572745,286372,286373,3zqXX6kzhkbW3d4TwD2CNjMRwxTbREXySekvq37kfCNk,22909817,114927032,-92017215,624
2022-01-08 13:09:18-05:00,2851,AUH6YGBV8tDVX1E1WTo92Mubfx1DGsqfGeyUBqxo4fSr,33QZgMwmW32WuvmxD8XNbmF9ea88bLe3YTtNwHV73Wwu,True,367078678,91769669,573786,286893,286893,3zqXX6kzhkbW3d4TwD2CNjMRwxTbREXySekvq37kfCNk,22951466,117848761,-94897295,625
2022-01-08 13:09:19-05:00,2852,399591e8XgY52yCMorCQ2WL6dQZTC485ZooHtmGuirhZ,JCiXAooFmKmEPQ2S7C8iSk6CLcTyrPEe1SsPSLyUGySe,True,1879991,469997,2857,1428,1429,3zqXX6kzhkbW3d4TwD2CNjMRwxTbREXySekvq37kfCNk,114319,1037218,-922899,608
2022-01-08 13:09:19-05:00,2853,9KD2AifD5wFD4QkHYuawXbJgLWHrfj2QPF3fT8jhGVA5,Ga9gAqmkuHbqrr31sUFPqa1xa5WNxLWJWGPUaMxQqLdj,True,1710330,427582,2649,1324,1325,3zqXX6kzhkbW3d4TwD2CNjMRwxTbREXySekvq37kfCNk,105993,957544,-851551,619
2022-01-08 13:09:19-05:00,2854,FnAT8HKGgisYfeAbxKU2gSbCp8KbZHULRpaJX1NVijHy,2u637Crc2QzfSJmCnRNqeib3aZQVn4NGncpgM3Ph6jvm,True,60238068,15059517,92799,46399,46400,3zqXX6kzhkbW3d4TwD2CNjMRwxTbREXySekvq37kfCNk,3711979,18846928,-15134949,616
2022-01-08 13:09:19-05:00,2855,8E3K7vCHJ2xjdFofPRGLbMxrkm8UYEi926QmXPAFwsqe,4qHUDA1c43Dg4qi1ZPKqmpGYiEMUZ6r4UuzB5ftHCEhW,True,2488576095,622144023,3735096,1867548,1867548,3zqXX6kzhkbW3d4TwD2CNjMRwxTbREXySekvq37kfCNk,149403872,1219130671,-1069726799,600
2022-01-08 13:09:19-05:00,2856,DYCYiQFH9QHzCo3eAw1pFoDu7pzwFMo1E2WDZjVFRz5w,CPh4FWsGak1kd1WFEH9qBjNhnun3R2tHtZA57zW8ugn5,True,87831005,21957750,133337,66668,66669,3zqXX6kzhkbW3d4TwD2CNjMRwxTbREXySekvq37kfCNk,5333510,43107160,-37773650,607
2022-01-08 13:09:19-05:00,2857,J3ggP7ZxL8HRh3CBp5iYG2WgjLyNSAWYT46uC9VYDLCz,2FqTRiRPiLvdAH2BS5vroVntpsSXvTJEn5UHWmtKHzh9,True,51564252,12891063,77181,38590,38591,3zqXX6kzhkbW3d4TwD2CNjMRwxTbREXySekvq37kfCNk,3087257,15355005,-12267748,598
2022-01-08 13:09:20-05:00,2858,A4tDE948CPFPh1UwHb8sXryfKktbxZ8BCkqXgA5DJHA8,3zXeKMrsEpCe5fQumLNzCgpxcG1kLJFEAtJuqxLsC6ZG,True,152128984,38032246,230813,115406,115407,3zqXX6kzhkbW3d4TwD2CNjMRwxTbREXySekvq37kfCNk,9232533,63694741,-54462208,606
2022-01-08 13:09:20-05:00,2859,4uygLJDk9DFCifJ56YwMrEsvd3oQNq8tYSLnMCyWorS6,GimL4uKGvg3FFmFQSWzAcjstv3Vmk5NMgDGMKTuXYVpB,True,910605857,227651464,1378130,689065,689065,3zqXX6kzhkbW3d4TwD2CNjMRwxTbREXySekvq37kfCNk,55125201,355708026,-300582825,605
2022-01-08 13:09:20-05:00,2860,DkvR2xUPMyXWGGkUSmDSfhp7RtvMkfbT1ThKCS3TwrXd,F7jYV6TtT1LZ5XCNn1zkbUfNMo4gGcQUczAQy1jLHpaW,True,1066096061,266524015,1541755,770877,770878,3zqXX6kzhkbW3d4TwD2CNjMRwxTbREXySekvq37kfCNk,61670214,430395111,-368724897,578
2022-01-08 13:09:20-05:00,2861,9WJBnVi84E926j7xEd566WzrZJkPJWRgmEnYj9vyjuad,4dLaFS5F7TGyLdwuJLMGkz3bSL53aHzd9ZfpNmhHxXeF,True,26936279,6734069,40011,20005,20006,3zqXX6kzhkbW3d4TwD2CNjMRwxTbREXySekvq37kfCNk,1600443,13052114,-11451671,594
2022-01-08 13:09:27-05:00,2862,8T4WK27RvWVGqPuNqY6whk1fmU4vd5qaUQPZG1GJ79bh,DvSz7knS8N3K7L6JhQf1s4mJSyxB8uJXNQXtyjJn8QRL,True,118838965,29709740,175994,87997,87997,72FwbpFGoLEazJEdpqNtPNefsadUrimUqma9wSoy4qiS,7039786,54019333,-46979547,592
2022-01-08 13:09:32-05:00,2863,7CSCMFa9W52tBDVUbXbc3woAy3GByeA1wPJdp3MgznPa,3447ptuVFu6G8B6N63RmS8mRv4n9PfHneypHLvbeaGLn,True,187408527,46852130,292029,146014,146015,HfEnetJ7uBSmZWCjBNxdvv9HEC5nsW4wDV7wu6WnhWan,11681178,81361087,-69679909,623
2022-01-08 13:11:01-05:00,2864,Cb4zhnvig11U4GcC4kqKrnDicGgPhUpfDQB1U7hP3nPa,DiRAMrKqaevGXeXg38KnhaYBERj8tNKU7oWFJvhS32kw,True,374378,93594,583,291,292,4BnQKPLuE3DMTtxp8MjUBytgnhvxqq3ZTqZHTVZo4JJh,23329,123563,-100234,623
2022-01-08 13:11:04-05:00,2865,DC4UVUDFWL3gVtgkX9hPtFgtxaA8DH5p94i4k9U3wyWv,3HCWqVvQQfRgSKitsTjGTduJ82ointZUSNtj13uea4kD,True,2302372628,575593157,3593610,1796805,1796805,3pStmNaV47N2sqUtHJHLAtCKiN9JZ6jzNY9h94ng8G1D,143744433,832899169,-689154736,624
2022-01-08 13:11:06-05:00,2866,CK3ocyWzXQkJJZQmM6bBK4Nv6Rh3UEufjY6DvNU6gJZy,C924o4GY3p2BHLeAbFbe9SEysXqCUyD8sFu2d4NzkAV7,True,12083871,3020967,18570,9285,9285,3zqXX6kzhkbW3d4TwD2CNjMRwxTbREXySekvq37kfCNk,742803,4081389,-3338586,614
2022-01-08 13:11:06-05:00,2867,i7TcF4weYcqgrRdH3GpndbEYxCxfcSfr9JWYrAUg1CF,BkDfknUir7PnSEW8auoB87PytycEFwyX5kT2GY4SGJJL,True,9804365,2451091,15049,7524,7525,3zqXX6kzhkbW3d4TwD2CNjMRwxTbREXySekvq37kfCNk,601965,7481494,-6879529,613
2022-01-08 13:11:06-05:00,2868,E1wp3bmkcY3eiEYyGYwhTCsr7BZ7RfPa5DJTZFupcFwj,452hVdYkD5SDDrA6hv6DLPFvyS8PvR2P6DPNScGxWTsW,True,1495204,373801,2297,1148,1149,3zqXX6kzhkbW3d4TwD2CNjMRwxTbREXySekvq37kfCNk,91916,598774,-506858,614
2022-01-08 13:11:06-05:00,2869,EhANPABkSw9x9WnsDEi8pCg67iQTX2UGTTUpyjADTwdN,4FKLi98hyg9ZjM4MY6ctJsv7B6vPUnTYWdhrnNoYsztX,True,18602863,4650715,28551,14275,14276,3zqXX6kzhkbW3d4TwD2CNjMRwxTbREXySekvq37kfCNk,1142067,9082752,-7940685,613
2022-01-08 13:11:07-05:00,2870,AKxRtcdpi7gWhAuL8ENj7zhgeQezzEXe9TSANE6bQoRA,2YH4vrU9deP8Cu6E8Hzf8GqKG1yVjv5pdz4FE7r5YKir,True,12699153,3174788,19708,9854,9854,3zqXX6kzhkbW3d4TwD2CNjMRwxTbREXySekvq37kfCNk,788341,4826592,-4038251,620
2022-01-08 13:11:07-05:00,2871,GaEpNGa8jnwSRvjzzEMYkZe1pKcr2eiZtePrqFxpABjB,5CFZHuyWbJv14zPdX5dSQDREgHrCb4vsFvB6hLiEe3Ji,True,282638,70659,441,220,221,DddJ7EWCmYEEZETCBNgAUSg81Ls6fZtiAaY5ekJ5sXx1,17669,108790,-91121,625
2022-01-08 13:11:07-05:00,2872,89CkXnSZnr52Zsoh48efv9MQacrkB6GMtrbEpNJSyA2H,HcvRBS4Z22CpYgDNgm4TVF4AVXFDuYzBUAFcdHAwdpg4,True,5561917,1390479,8688,4344,4344,3zqXX6kzhkbW3d4TwD2CNjMRwxTbREXySekvq37kfCNk,347550,2118565,-1771015,624
2022-01-08 13:11:07-05:00,2873,75ycx5sUFBxDhY1uwuPCW22s2C6BydkJTje7q7zEQFGT,FpEgrVFRubjGK4DRjTqdVbxSECURpn16zfpoC31NbwnN,True,11827610,2956902,18347,9173,9174,DddJ7EWCmYEEZETCBNgAUSg81Ls6fZtiAaY5ekJ5sXx1,733904,5779597,-5045693,620
2022-01-08 13:11:07-05:00,2874,2NHv3c4ufYGo3xNr6KXymAZJdpfURrNiCKbXZ7s82Vwo,E4NYpYgHTvSG6LqH2bBV9Q1XJ6pAzCp9FLSKMzJmYRrQ,True,47983264,11995816,74268,37134,37134,3zqXX6kzhkbW3d4TwD2CNjMRwxTbREXySekvq37kfCNk,2970723,23917174,-20946451,619
2022-01-08 13:11:25-05:00,2875,2p2fGXdKrmxjomLSnyaNg84J82cBBBNympZ6qQc8UZgU,HKAM8bazuLMUY6yapZJqYsgaWkTBqKHyMs1hSfpYsZGi,True,1461459218,365364804,2286284,1143142,1143142,3zqXX6kzhkbW3d4TwD2CNjMRwxTbREXySekvq37kfCNk,91451387,696428820,-604977433,625
2022-01-08 13:11:25-05:00,2876,2rCRdyfi65rpxRRmg7knaSb8t55FuPt3h8wF4Fzhy8MM,CLVY5nSG3jTdRo7tRSKgK9DJgW6aswfWKe4tLxzsENmb,True,1168948,292237,1828,914,914,3zqXX6kzhkbW3d4TwD2CNjMRwxTbREXySekvq37kfCNk,73140,394468,-321328,625
2022-01-08 13:11:41-05:00,2877,6VJcr3VAEcEZaHEpt48QL8QxHKABufVp8n2JSEVTLh9U,8naR6kiySKj3vai9dCetdgCnCHgf2oyLjGqKTJ3Lz64Y,True,2045670043,511417510,3200157,1600078,1600079,4BnQKPLuE3DMTtxp8MjUBytgnhvxqq3ZTqZHTVZo4JJh,128006302,856366436,-728360134,625
2022-01-08 13:11:44-05:00,2878,9YEzjb49Awvedv9yNc6LG54SkGBug2RYiJwiUV13mGsS,3H8w5WCD187NWWoZMNUCzUDdxTgqrRJLga8gDzUVXBgZ,True,2033822,508455,3163,1581,1582,3zqXX6kzhkbW3d4TwD2CNjMRwxTbREXySekvq37kfCNk,126549,1145753,-1019204,622
2022-01-08 13:11:44-05:00,2879,2NdwSLxsGok8PczpCZj9CVX2BymNU5MvHt7hWfGetg2M,8AQbDXeA6mD9QoZBFJcYbnHvZwKNxzA9CCHLAgdSfTA3,True,19757,4939,30,15,15,72FwbpFGoLEazJEdpqNtPNefsadUrimUqma9wSoy4qiS,1234,9631,-8397,624
2022-01-08 13:11:44-05:00,2880,4MmpDGUTyMcYEqJ1RoZ46AN2BhrBUseHaHqF8AmiTPyD,7HW2YZpYM349HMfW7u4h9ESZ1AXkwN8JcVDTNFzp9aTz,True,222638331,55659582,346911,173455,173456,72FwbpFGoLEazJEdpqNtPNefsadUrimUqma9wSoy4qiS,13876441,108163987,-94287546,623
2022-01-08 13:11:44-05:00,2881,BzSJ77zKaqtBk2cEL1XqFL97zTXXMRHmxtkgtXwCc3C,2g4KXTwy2MPSRQ2khNp1o1rn7CradEr9H4ySYKDoSWN9,True,18734599,4683649,29257,14628,14629,3zqXX6kzhkbW3d4TwD2CNjMRwxTbREXySekvq37kfCNk,1170290,16910926,-15740636,624
2022-01-08 13:11:44-05:00,2882,JCBhqqPQxP1Xc41sSY6e1sQKRstHhe7D1v6rLz4hp3Qp,DWMUq2bMD1jqpxHtyXDFjcAwjA27yyMRe68hGcsK143m,True,12921,3230,20,10,10,72FwbpFGoLEazJEdpqNtPNefsadUrimUqma9wSoy4qiS,802,4876,-4074,620
2022-01-08 13:11:44-05:00,2883,EeUACm9TkjHKES5U7Yj1oPhYmcp7R3tvesGBiP8txEzq,3qkmm4aS6EDirEDejmbm5PDw2jpYkC7zKqrMkmgeE5BA,True,428492,107123,669,334,335,3zqXX6kzhkbW3d4TwD2CNjMRwxTbREXySekvq37kfCNk,26785,139537,-112752,625
2022-01-08 13:11:49-05:00,2884,HqtTbC1LFreGvgfpZe7nCqkNnh8GHPQKosfmc19zb1yi,E39UNiHNkwQEd5GXkCtTPqSorQSB1kLx8kjzK4jdFoi3,True,576355550,144088887,894054,447027,447027,3zqXX6kzhkbW3d4TwD2CNjMRwxTbREXySekvq37kfCNk,35762170,254941851,-219179681,620
2022-01-08 13:11:49-05:00,2885,EV21gv8jEvXtmGDoGRNm5LJEvTBccLMZyVDCLsp54jP3,DGxxoU52aQNoUQcxdvQtv2H5q2PhK6TGkLgNSaFgnZrb,True,8273646,2068411,12905,6452,6453,3zqXX6kzhkbW3d4TwD2CNjMRwxTbREXySekvq37kfCNk,516230,3318835,-2802605,623
2022-01-08 13:11:51-05:00,2886,GJ3PbEfPK8jjrPgMmZtvN5fMSSy2dtiiAtZ8wcfgxVuc,FCUDVFb2TjDvehHE8fVBofqSykpb9W6Afc9QeHtj7te7,True,142343061,35585765,219748,109874,109874,3zqXX6kzhkbW3d4TwD2CNjMRwxTbREXySekvq37kfCNk,8789925,73902591,-65112666,617
2022-01-08 13:11:51-05:00,2887,EQUZQWk4WLT6LFeWZs3P9AQufFcoZouFETfhyxvuS2JM,Byc2mLXArmkjQPWaxCJksHZD2XpZyCQ2FRtDJyztU81V,True,176269017,44067254,275048,137524,137524,3zqXX6kzhkbW3d4TwD2CNjMRwxTbREXySekvq37kfCNk,11001953,92500505,-81498552,624
2022-01-08 13:11:51-05:00,2888,9jdfc9GFTecsdRuTjWFGX13niKKmeBxRgtv5j86uhSnU,HLWMShobjSkaLyXrNjgwVaUGVtbtdUSnr1XjqpXn1bLR,True,543206,135801,845,422,423,3zqXX6kzhkbW3d4TwD2CNjMRwxTbREXySekvq37kfCNk,33812,232016,-198204,622
2022-01-08 13:11:52-05:00,2889,3VdSA9CED9f5swRwHX2U15U7J6Muaq8VPnCNy9CaGDHe,2YYstfnfdYic5NWmEbcUEHpccNUVd1EhuCkExvMsoMk8,True,8806011,2201502,13761,6880,6881,3zqXX6kzhkbW3d4TwD2CNjMRwxTbREXySekvq37kfCNk,550466,4875804,-4325338,625
2022-01-08 13:11:55-05:00,2890,8BMDSWFtzq9fu1ubVGtSFw8fEaMg1uvJiECuJnN8e1pd,FwkETAXL296CirvQ2AJuSHHtdKsxkZkmXSwZVVHXVDhA,True,241417304,60354326,376464,188232,188232,3zqXX6kzhkbW3d4TwD2CNjMRwxTbREXySekvq37kfCNk,15058573,90051237,-74992664,623
2022-01-08 13:11:55-05:00,2891,Ar5QB4VBcUyzSCG23z2QNAbrWY55NbHCr1MNN6P2GAmh,BusFGTiDrJmxzwGUxWz9b3SFF3eseqtgh2DRHqyAwyVe,True,857362,214340,1323,661,662,3zqXX6kzhkbW3d4TwD2CNjMRwxTbREXySekvq37kfCNk,52928,345847,-292919,617
2022-01-08 13:11:55-05:00,2892,96DzqyUxsB1FKWrhLdTdjDcokuus6rbx83gLsghqPPwt,74CWb7SVoSy3ADysEzFEeMiS2fxHJ9gdUF9pzM3E52Gj,True,35895,8973,55,27,28,3zqXX6kzhkbW3d4TwD2CNjMRwxTbREXySekvq37kfCNk,2225,13531,-11306,619
2022-01-08 13:11:55-05:00,2893,D3mXrJzhHf8qRaoCKLschUxAFoijFCFuT6bmNZH4W7Cj,9E3Xtqw7TncXWnbhAbFJMtuNmP6WS3ooGuptzyzw7UpA,True,107245,26811,166,83,83,DddJ7EWCmYEEZETCBNgAUSg81Ls6fZtiAaY5ekJ5sXx1,6644,56187,-49543,619
2022-01-08 13:11:56-05:00,2894,HutRztBianNUgm9sJDWKUQBmoVyy8y7CfnNk4hHjSkEW,EtVfvPyiy5bizbCZxR19TNUgETf3QcmziBvMtc6o5zjr,True,456955272,114238818,708393,354196,354197,3zqXX6kzhkbW3d4TwD2CNjMRwxTbREXySekvq37kfCNk,28335753,363765745,-335429992,620
2022-01-08 13:11:57-05:00,2895,A36aouot1oFLUtswuBUM4EVcis9chKaSJu53MRoPDjab,33U9gpq1RRFMGWDrWa3ezXXkwgBewdAS6QGgGVPtGvqb,True,472945368,118236342,738301,369150,369151,72FwbpFGoLEazJEdpqNtPNefsadUrimUqma9wSoy4qiS,29532058,147284611,-117752553,624
2022-01-08 13:11:59-05:00,2896,8vva9SmKpMGW8wjpkvydQczxVK6VtN79qzH2i4JQSwg4,F8a3GLicsSapt4aLURoU4qHxJaxCij4LS6JVxoMF3YHT,True,1779590,444897,2755,1377,1378,3zqXX6kzhkbW3d4TwD2CNjMRwxTbREXySekvq37kfCNk,110228,451265,-341037,619
2022-01-08 13:12:08-05:00,2897,6XHt7CrURSomkQrtVXV5JuKSZY4tQRpUyQKfCDaSTYaD,GCgcmPSDDBsn2smYbpiX3PJybDkQWtufPu4YRsbEEU8X,True,625723329,156430832,979149,489574,489575,72FwbpFGoLEazJEdpqNtPNefsadUrimUqma9wSoy4qiS,39165987,359859446,-320693459,625
2022-01-08 13:12:20-05:00,2898,Mcbzp1LhZwpfmXTv1pqe9D1jCKHw443j9QKp6tUpzgM,8uforSMAKEih5jHfHp3gCqCvaugtCmhzVfVHA63Akz7F,True,3697209,924302,5762,2881,2881,3zqXX6kzhkbW3d4TwD2CNjMRwxTbREXySekvq37kfCNk,230515,1812186,-1581671,623
2022-01-08 13:12:20-05:00,2899,KoCscQ9Q8TZHhmya5KaXBrwUEMTdCkEMRtrhvtgEmiZ,6aZ5AFMFoqf1X64RwAt1J4Yrx4WGGe2JMiEjqnQ2gEtk,True,873684,218421,1348,674,674,3zqXX6kzhkbW3d4TwD2CNjMRwxTbREXySekvq37kfCNk,53957,180273,-126316,617
2022-01-08 13:12:22-05:00,2900,7LRBswSEDBjJzQ4YurfTxLydh7tFS2jVn5V95Z6wL7ci,fD41VYGmk66MW46KKb23vAqQvUSDScgXnVdsHhJBZzu,True,218358,54589,341,170,171,3zqXX6kzhkbW3d4TwD2CNjMRwxTbREXySekvq37kfCNk,13654,99393,-85739,625
2022-01-08 13:12:22-05:00,2901,8VT2nxz5ZYDJFd9uL2XZwEXxChd9pjuMJNMAcutZubL1,EhAkiRbouzUAWtqQFsN8HEEfi46UVN8H8tyBP7CbgeLe,True,17002,4250,26,13,13,DddJ7EWCmYEEZETCBNgAUSg81Ls6fZtiAaY5ekJ5sXx1,1059,7452,-6393,622
2022-01-08 13:12:27-05:00,2902,AtKuDfcFXqWUMnRqQpjedUMTb5CQKLc2zoqEAcQpysKQ,9bPFLYp5TDZruLLDXDYYCiPYcD982iF8xt5rfTkqwNsL,True,20623,5155,31,15,16,3zqXX6kzhkbW3d4TwD2CNjMRwxTbREXySekvq37kfCNk,1276,7621,-6345,618
2022-01-08 13:12:29-05:00,2903,6WNPf4rFCX74PuyvdmzRFqbxWhguuxTQqBSdnaTVBd5D,9N7a9aiHGQsxFMgVbmWoCF9w95d12xyT7XFAwpHGkTLA,True,2790313,697578,4333,2166,2167,DddJ7EWCmYEEZETCBNgAUSg81Ls6fZtiAaY5ekJ5sXx1,173344,701783,-528439,621
2022-01-08 13:13:02-05:00,2904,FSduW743jAGyyn8HTifEJitgb89Spp5gEeMXDE59aEHF,HjojGNpR3ACtLCP2mP8DKGyXj6SeqWPKjcCAofcyQpsm,True,342064876,85516219,528662,264331,264331,3zqXX6kzhkbW3d4TwD2CNjMRwxTbREXySekvq37kfCNk,21146490,115855575,-94709085,618
2022-01-08 13:13:02-05:00,2905,CAkknoa9UFPMEZ1KWSfqtmnL7ArVNV3HRETLwecuuXP,4cHJYv3dxA6qjcuxUkGRuL7STWobGPKtoHFD4ACUbiWq,True,19384849,4846212,29978,14989,14989,3zqXX6kzhkbW3d4TwD2CNjMRwxTbREXySekvq37kfCNk,1199140,7322029,-6122889,618
2022-01-08 13:13:03-05:00,2906,8sneA6wAg6geVDJ1g7YWg4R1PfjuRVzeHp1nUBJinhZa,14i1uWtmcTjrdbg3DSr9vzd5NBnxqsn1A4QdgFBZqeYM,True,204838,51209,318,159,159,DddJ7EWCmYEEZETCBNgAUSg81Ls6fZtiAaY5ekJ5sXx1,12725,85350,-72625,621
2022-01-08 13:13:03-05:00,2907,C7a8BtMjuLXkzxZBC4Wk2gjkGBmucLmDjokf9pyA1Mu6,GxwYNWwYTtFMUxuZvNC5qrEYuJzYiEURQVuBxssfCJzr,True,2838046,709511,4410,2205,2205,3zqXX6kzhkbW3d4TwD2CNjMRwxTbREXySekvq37kfCNk,176402,713358,-536956,621
2022-01-08 13:13:04-05:00,2908,99NHcwD1iaf5FXM3UNb91SjNiiT3HwyQFQMhkGd5ASts,8syAydy52vSQQLzsLXW24BFw4VPeK66Vp3BmAbnHfgod,True,91614582,22903645,141759,70879,70880,3zqXX6kzhkbW3d4TwD2CNjMRwxTbREXySekvq37kfCNk,5670380,37256837,-31586457,618
2022-01-08 13:13:04-05:00,2909,4hrm69kAKNcfBkiP2YgtW94Pbip6FLfQAwnDRAAack69,BjbZRdGMoC7Mfoa4H19UvE2eQafgKD5rqnK7BSGwqS1s,True,62776,15694,98,49,49,DddJ7EWCmYEEZETCBNgAUSg81Ls6fZtiAaY5ekJ5sXx1,3929,24397,-20468,625
2022-01-08 13:13:07-05:00,2910,s2NgHqXLYtUrRaA6LnDwmxcS5nqfURXw47DmLy7Pn9E,2qn4QbLj5miEB2zZB4v5dhptm3JRbpQRrpTBgPDzokw1,True,3909191,977297,6021,3010,3011,DddJ7EWCmYEEZETCBNgAUSg81Ls6fZtiAaY5ekJ5sXx1,240868,2743532,-2502664,616
2022-01-08 13:13:08-05:00,2911,EanSXRkJu91FKUhPCzYxWkmM3PQUWcovEnoZXcd6vQ9E,Fg4EzAzHStoLRDPmoBUczdWnWrhAb7jKEujqAujLFT8,True,253077757,63269439,394983,197491,197492,3zqXX6kzhkbW3d4TwD2CNjMRwxTbREXySekvq37kfCNk,15799329,108955716,-93156387,624
2022-01-08 13:13:14-05:00,2912,Dc11Q7yj9HoSfndRUB8Ffaz5BcYNFnvbVWuRn8v7Zs7C,BC35JUb1znJxJhcaivpyUPt8Ydojec2ohC1TrFv7TntJ,True,322366313,80591578,503001,251500,251501,3zqXX6kzhkbW3d4TwD2CNjMRwxTbREXySekvq37kfCNk,20120051,158060537,-137940486,624
2022-01-08 13:13:14-05:00,2913,5kwvkEtRFFD84j4ntVgxkacadgJaFvQ9JLhJqzLR7Y3G,GpMMkTv9T7y8DTiizuoJUsWvnSk3GSxADjRMGyYpryxm,True,41233502,10308375,64351,32175,32176,3zqXX6kzhkbW3d4TwD2CNjMRwxTbREXySekvq37kfCNk,2574050,12323047,-9748997,624
2022-01-08 13:13:31-05:00,2914,FuoFPNTdYVDkSHaBac6UC1aNJXafSNTvFJuBCdrgQQrH,ApBS1Fx83tcECMzDV6wEzEzEdg4e2hgj3djtjRUoSKK5,True,1556451438,389112858,2364783,1182391,1182392,3zqXX6kzhkbW3d4TwD2CNjMRwxTbREXySekvq37kfCNk,94591321,591115511,-496524190,607
2022-01-08 13:13:32-05:00,2915,E5biUzKn2s5frKseCmfWriWjrYMGVtmLrhR9nYhAkVvR,BDHzqefisuGoMGcpML8t6KAC7rcErvhLcfV8KQC7oHAH,True,33070542,8267635,49973,24986,24987,3zqXX6kzhkbW3d4TwD2CNjMRwxTbREXySekvq37kfCNk,1998925,11613979,-9615054,604
2022-01-08 13:13:32-05:00,2916,DmrkajG3SrTXnYSYxGRfkzfvhkevD6RdtFk4SdLC2G6Q,5r7vkWH985E2mGSDBtznduhuu5PbZJ7d4zxjzhzEEZG1,True,40676251396,10169062848,62003890,31001945,31001945,DddJ7EWCmYEEZETCBNgAUSg81Ls6fZtiAaY5ekJ5sXx1,2480155604,20523355914,-18043200310,609
2022-01-08 13:13:37-05:00,2917,HGAFdundf5voDqeh9g7d6Q9mgMf8eEg898QMRBqwPZ6C,deanBuZXWBHEe2TGfP37S9aMBEnEgmZoyRJjAvruzfA,True,60176624,15044155,90736,45368,45368,3zqXX6kzhkbW3d4TwD2CNjMRwxTbREXySekvq37kfCNk,3629469,34216171,-30586702,603
2022-01-08 13:13:41-05:00,2918,AvwHizRhHUSahmvSg4jmTUErc7vAFSmkRAEsiKhXfW1m,3UrWYx8y9N5o9GYneSe6zyyHRTZzxwvcipQfHHYh7tEs,True,3381321,845330,5183,2591,2592,3zqXX6kzhkbW3d4TwD2CNjMRwxTbREXySekvq37kfCNk,207350,1273708,-1066358,613
2022-01-08 13:13:42-05:00,2919,5hUZ9uQFcYnjAQVVaGLJWdKyg7y1XMpoo8osQ9DeY7Xd,BdYiKWsjuzJLcHh3814mJ4xQ9JxoQKKcr7AHZ7Vxoavq,True,75040,18760,116,58,58,3zqXX6kzhkbW3d4TwD2CNjMRwxTbREXySekvq37kfCNk,4663,29725,-25062,621
2022-01-08 13:13:47-05:00,2920,8mbMH9EKd9kQDyFrYiDJCV9VaWxWCzpZBQZLyYN2yNVx,J9gT39dF1egMeQvweXYWeRAX3kpmBABijYZhfj6M2UqU,True,41590784,10397696,65016,32508,32508,3zqXX6kzhkbW3d4TwD2CNjMRwxTbREXySekvq37kfCNk,2600677,13210767,-10610090,625
2022-01-08 13:13:47-05:00,2921,Buioe5v3DyFwD9nquW5XdYeVYbSABCyg79eUHEvtvfaW,7T9gi7prCcZJkYJMSB5Ef6Bu4pAuBw4XLvumSFnqKDSi,True,1206294,301573,1884,942,942,4BnQKPLuE3DMTtxp8MjUBytgnhvxqq3ZTqZHTVZo4JJh,75363,624728,-549365,624
2022-01-08 13:13:52-05:00,2922,CFFpbRxYEP18rqEGxxyG3bzSV13Lv7nfSmZvtUK17kCP,824UwqH2JcFsqYBk9MZ8tTnpka9udTL6WGX35YFtAJQk,True,6560506,1640126,10215,5107,5108,3zqXX6kzhkbW3d4TwD2CNjMRwxTbREXySekvq37kfCNk,408624,2491760,-2083136,622
2022-01-08 13:13:54-05:00,2923,C4dbwF9mioaBkZnyBFvFs6Cqd362VuGPBGPbTY9CAnAk,CcUqBfu1hbWm5VVxbtF2Xm6HUz4CLFzuDsjUi6KtnZQg,True,3032302,758075,4738,2369,2369,3zqXX6kzhkbW3d4TwD2CNjMRwxTbREXySekvq37kfCNk,189555,757255,-567700,625
2022-01-08 13:13:55-05:00,2924,CEbGTNX6WpaoKp4RBGSn9LzYM6yAYyeiMrgVYgJxA4zb,AiXUcGAFFm4tc7vKBscSNjZawV5YJqbv7D1KpxD3Zufg,True,33735832,8433958,51314,25657,25657,HfEnetJ7uBSmZWCjBNxdvv9HEC5nsW4wDV7wu6WnhWan,2052595,17458229,-15405634,608
2022-01-08 13:14:00-05:00,2925,3zH1b58jqbNU37y9kDTZZrotSeT8XzS1tuyAHPKWrbah,4trxDWV16x6sVcz7bxHehYHkjjyKebh3S9fyJf8txzK5,True,12883,3220,19,9,10,HfEnetJ7uBSmZWCjBNxdvv9HEC5nsW4wDV7wu6WnhWan,793,4818,-4025,615
2022-01-08 13:14:01-05:00,2926,DiPSJvnnEwg1En7HJfEsKrUbBgtUf4KzGMyMCZDQSYgp,s8UVC6vPBofuXUS6RW1aQmZ8C35PrC5r4A6ugmvzLGB,True,3310799,827699,5091,2545,2546,3zqXX6kzhkbW3d4TwD2CNjMRwxTbREXySekvq37kfCNk,203655,830359,-626704,615
2022-01-08 13:14:03-05:00,2927,ECuu1L4QGdemZ7FjAjVAAxYN6piinweY7Fuk5csVovfT,Amd8WGcpdtB8yoA83R1BUT5uryuqoKbcBexYacbrbGVX,True,5195150,1298787,8110,4055,4055,DddJ7EWCmYEEZETCBNgAUSg81Ls6fZtiAaY5ekJ5sXx1,324421,1778120,-1453699,624
2022-01-08 13:14:03-05:00,2928,FhAt6pZW3k8StP9VLeWUfidpXfRLoKWdV7Wgxdh9cRy9,Guk93pTo3KcG8konHjJ52oi9rgexmmKhPQAkxZS1BtCG,True,307833013,76958251,478329,239164,239165,3zqXX6kzhkbW3d4TwD2CNjMRwxTbREXySekvq37kfCNk,19133194,133078414,-113945220,621
2022-01-08 13:14:04-05:00,2929,87R8o8xLjHw2GpunYkm7pX7uJ8hjM4B1y4Qm7aQf6Yh4,48aSVPQoFYdncF5NtJ114urbdTzVjTgYLgPzMfpJbZB3,True,108783354,27195838,168758,84379,84379,4BnQKPLuE3DMTtxp8MjUBytgnhvxqq3ZTqZHTVZo4JJh,6750342,95965988,-89215646,620
2022-01-08 13:14:04-05:00,2930,5BjBPqumCb9KC82ZNNch3dcRzbpGdRLJneru7o9a1D9R,FuZtBWKktxFu4yoiLVMzxq8fMhQyN8SGzGPz49xs3m6P,True,250777569,62694392,386832,193416,193416,3zqXX6kzhkbW3d4TwD2CNjMRwxTbREXySekvq37kfCNk,15473284,115540398,-100067114,617
2022-01-08 13:14:04-05:00,2931,EgU9hX6VK7YXeCgCHVaJAMekCcyZa2MVWdKra5pN7Gwv,7y8Ad9XY34bqREvheXHT2tr8Jy11D6X3pu7yLVtjU4QV,True,16859399,4214849,25904,12952,12952,DddJ7EWCmYEEZETCBNgAUSg81Ls6fZtiAaY5ekJ5sXx1,1036180,7776139,-6739959,614
2022-01-08 13:14:04-05:00,2932,4FazDUgfQ3AKoFcnWHr8E9Ht8jLA3tkxf75yrGZVHdmF,HzRMH6mbgEKydRCnnMvSsKgTEVNQi6nuzoR1xutYFdzg,True,104334,26083,161,80,81,3zqXX6kzhkbW3d4TwD2CNjMRwxTbREXySekvq37kfCNk,6468,70952,-64484,619
2022-01-08 13:14:04-05:00,2933,9gYrMXAGmGSV4VFjXzYP5WwH2aFpB1TxA6CqpYsosKLv,Dh8aH6RK48wu4fkT9xKw5XL7itxnPDuw3SDwPwvL5sva,True,45072,11268,69,34,35,3zqXX6kzhkbW3d4TwD2CNjMRwxTbREXySekvq37kfCNk,2793,17184,-14391,619
2022-01-08 13:14:04-05:00,2934,7MSzV5yy5FmrM4j1BcYSRiTGWfit1AJahheRUaXzz349,aPSTZLxBpVr3sucjbj95emRV2J1GrUWr7wbARYqJkQZ,True,7579027,1894756,11753,5876,5877,3zqXX6kzhkbW3d4TwD2CNjMRwxTbREXySekvq37kfCNk,470126,2395952,-1925826,620
2022-01-08 13:14:04-05:00,2935,3g1debT8Z2efQPuMNSDPUNZzDqarBG2acErsZ4HP7QGA,42wDHagxr5Nno3mUx6kyYGDjwR98aedRbh3ByB468agB,True,32195,8048,49,24,25,DddJ7EWCmYEEZETCBNgAUSg81Ls6fZtiAaY5ekJ5sXx1,1996,12344,-10348,619
2022-01-08 13:14:04-05:00,2936,93ho4cgnpAJiJsG6uu2udkLVNU7rkz4QjCYfsqvpbPA5,45ouQn9gGwXqnTGfaP5CvU8fCKadBRA5kPwtfvJzykRU,True,107995903,26998975,167503,83751,83752,3zqXX6kzhkbW3d4TwD2CNjMRwxTbREXySekvq37kfCNk,6700159,35329518,-28629359,620
2022-01-08 13:14:04-05:00,2937,E9FFPvygPSF22u7gqFq4w6yE5kV15zbeGDXFQc349RsG,yi1REPVUwKhr5ss5YJc56crYz8LVfkqNVMpKcdSfwfY,True,2843155,710788,4425,2212,2213,3zqXX6kzhkbW3d4TwD2CNjMRwxTbREXySekvq37kfCNk,177019,708866,-531847,622
2022-01-08 13:14:04-05:00,2938,FjDp4bWCtqehFD7FunCrjrcdxMezTJj5aqh2VnBvHDQU,HRYeZqcqhP1RPiAGXziR1qCWwk4sF6c5ZYbvSDhX7foN,True,13650246,3412561,20917,10458,10459,3zqXX6kzhkbW3d4TwD2CNjMRwxTbREXySekvq37kfCNk,836719,4982589,-4145870,612
2022-01-08 13:14:05-05:00,2939,ZoNjrSjYh4NJLW38LUPcf7jtEBxdaaM7T1zp795qjHE,FZx6v8cU25NwEosbKJ2n141o9uFAWURZB7NeCeX1trEn,True,2599752,649938,3958,1979,1979,DddJ7EWCmYEEZETCBNgAUSg81Ls6fZtiAaY5ekJ5sXx1,158336,652336,-494000,609
2022-01-08 13:14:05-05:00,2940,EEcTbsFTUEifcdbPyjBLkS943daEx1RpR8F3uZxKRZbT,8V3JzDQ1VWYQLas8fxUsWJZZHe4gEmn74RehtUwLw3k5,True,9109876,2277469,13980,6990,6990,3zqXX6kzhkbW3d4TwD2CNjMRwxTbREXySekvq37kfCNk,559206,4168244,-3609038,613
2022-01-08 13:14:05-05:00,2941,2ce2v2TCbjNH635NgbwTG3sqiRWYrRRaBpxPxBZJ929q,9cnoebT43FkWDFhidndGCVNiFD4NErv8DuL1Va4Jv9S8,True,10240902,2560225,15822,7911,7911,4BnQKPLuE3DMTtxp8MjUBytgnhvxqq3ZTqZHTVZo4JJh,632901,7455346,-6822445,618
2022-01-08 13:14:06-05:00,2942,6d6HN8LWikwW2HYdy3BABWuxKHt1sgv4DcneACR133sE,4eKvzmfFvX96XbujKBhUauAvWP4yQYwZH3pd7gXzbCvJ,True,2840134,710033,4444,2222,2222,4BnQKPLuE3DMTtxp8MjUBytgnhvxqq3ZTqZHTVZo4JJh,177760,712629,-534869,625
2022-01-08 13:14:06-05:00,2943,H6tDNj9cHac223ckAnNfnC4bAJuNLBnf2pFk2iQdMzMP,28UL9dqgayCqCAexScXjdpobYGVDN44SGBVNAfBByk8C,True,113874543,28468635,176487,88243,88244,3zqXX6kzhkbW3d4TwD2CNjMRwxTbREXySekvq37kfCNk,7059481,59925656,-52866175,619
2022-01-08 13:14:08-05:00,2944,DiB9SeCFXjioNGPJM3GuZ3FCG9KBZhHK27zCSN5b6gkq,GtK8UtKDQy9jgtTXvam4jja9N7c4EFuDQr4TKHgNyhXT,True,7476298,1869074,11437,5718,5719,3zqXX6kzhkbW3d4TwD2CNjMRwxTbREXySekvq37kfCNk,457503,3183006,-2725503,611
2022-01-08 13:14:28-05:00,2945,F9s8a7Cpiw5dw3a2aNFMofqwyDWNXvDLnSdJzoj1gRiV,GpKsQKJD79KBRWdCTkyi4zX7NaoCWsLUjrKxAwJB6o6s,True,27509129,6877282,42903,21451,21452,4BnQKPLuE3DMTtxp8MjUBytgnhvxqq3ZTqZHTVZo4JJh,1716146,6395690,-4679544,623
2022-01-08 13:14:29-05:00,2946,GjQQ2fQ7mrGjWZwjVYFUKp9NM1LmfkhEo675ovU5SPa8,ECgVUMRY5nB4MALs5drDyipF7YohCPuJpj2UegCs7HMn,True,20815194,5203798,32325,16162,16163,4BnQKPLuE3DMTtxp8MjUBytgnhvxqq3ZTqZHTVZo4JJh,1293032,8999772,-7706740,621
2022-01-08 13:14:39-05:00,2947,46TNhGwBVzedW8xSb9UY94HNeSom9iGiZzAjrKHiRM2G,7JVTiqNYeKHbyzRkKtvSEpqLPKykZso8cGUr3sX1j7QF,True,55099649,13774911,85813,42906,42907,3zqXX6kzhkbW3d4TwD2CNjMRwxTbREXySekvq37kfCNk,3432526,21482995,-18050469,622
2022-01-08 13:55:59-05:00,2948,BJaaH1SK1pF2kZQzmYpLFfDtm52CR9a5rd39RAPtLe8q,HUsT5FVxaisdnCvG1BQxX6zffjfL2Rwx5mMo5y8SDV7e,True,68566441,17141609,107122,53561,53561,3zqXX6kzhkbW3d4TwD2CNjMRwxTbREXySekvq37kfCNk,4284882,18711588,-14426706,624
2022-01-08 13:56:15-05:00,2949,8aKqLY7GXxNnGRK8Utke7o6EDGZATNDDF8Ph9Q27ppyi,7MQKkebLEzQgjWjByBMzzkn68yqtYivS4VDcraAScZR6,True,1845998,461497,2885,1442,1443,DddJ7EWCmYEEZETCBNgAUSg81Ls6fZtiAaY5ekJ5sXx1,115437,495762,-380325,625
2022-01-08 13:59:24-05:00,2950,243SAnGxchCVB1LQAUF4SsozR86yDwEdg2QQpbWGsMYe,5u8sNkb2oEQjUXJAB3yGStmv3Uwz16gBgExBo5myVK4b,True,18536818,4634204,28346,14173,14173,HfEnetJ7uBSmZWCjBNxdvv9HEC5nsW4wDV7wu6WnhWan,1133868,6334212,-5200344,611
2022-01-08 13:59:24-05:00,2951,aTkGURJptmKNNP6RSXSWsmVbfcriSAJaMuUiT2eZEfb,5qoGxL83PLhrguyk27X8xE6jGitRg5BaQpXzrcfEvCfJ,True,358452480,89613120,546662,273331,273331,DddJ7EWCmYEEZETCBNgAUSg81Ls6fZtiAaY5ekJ5sXx1,21866493,116761923,-94895430,610
2022-01-08 14:00:57-05:00,2952,GXSysysoV8Z4xBrQsaKUsSrpoWeTTUsbFmgfZDaQu4ZM,6FJyraiLgG3tb9B7pi4YFsJNtRVBNaghnm1ajzneVv7b,True,845149615,211287403,1296868,648434,648434,72FwbpFGoLEazJEdpqNtPNefsadUrimUqma9wSoy4qiS,51874722,265644254,-213769532,613
2022-01-08 14:02:40-05:00,2953,HwosLQgDY1xtHQRQ4hzroPQHFWssPzTj5vRkP37FcviB,HKTNEYNXrephNkH7apbobK4mcQXcNayQA4W1NgM6sLr8,True,59209462,14802365,91547,45773,45774,GAUsoe8ZTCiGPm2hYxRPGxcPe5ShNzHK9eE3G2zgRjxd,3661891,18173773,-14511882,618
2022-01-08 14:21:50-05:00,2954,5Rxuqgs4CaSKbfDXqBMFXkLTQ9dxrUjThXzoy3ouYVtK,BgvbKru66ebrGUcFFymGTmsaQv6GgcGMybiWaXqzBtwX,True,271500,67875,423,211,212,HfEnetJ7uBSmZWCjBNxdvv9HEC5nsW4wDV7wu6WnhWan,16952,159005,-142053,624
2022-01-08 14:22:25-05:00,2955,3ogBPSRcKfmwzgumVDHBkXLi1eCsEFG2xzSJgD4LQDNy,7TXyqWgJqfe71MSWFA2n7ufZbUdzf7JJoWej8FNNtMXo,True,27505168,6876292,42836,21418,21418,HfEnetJ7uBSmZWCjBNxdvv9HEC5nsW4wDV7wu6WnhWan,1713463,10194640,-8481177,622
2022-01-08 14:22:27-05:00,2956,5BJnMHFSiQjHRGFJDW1jnqCfkHHYWnQzmmccy9eA4jNj,9517JGYsPmvgPUM9pFRD2vipHmdgE578F7jA7Qq6jorm,True,683072666,170768166,1067444,533722,533722,3zqXX6kzhkbW3d4TwD2CNjMRwxTbREXySekvq37kfCNk,42697798,276103711,-233405913,625
2022-01-08 14:42:33-05:00,2957,GxFxvEUdWofneMmVvhCSScH9V6Zia5WJ2J9q6CpPnaq3,ATLykiHDii3Lw53MoZXwqu1FbBNPJbVNVGe2SoQMjVmY,True,4174911,1043727,6388,3194,3194,3zqXX6kzhkbW3d4TwD2CNjMRwxTbREXySekvq37kfCNk,255527,2086078,-1830551,612
2022-01-08 14:47:10-05:00,2958,7W6ih2ZGXaE6tvuQFUPCvc7NvEJHy7UffgoVX3ZPdLXt,6uQCkeMjEXHBQxE2HD33RM1zyTsSko1fYZA1mWUggJ5B,True,43734,10933,68,34,34,GAUsoe8ZTCiGPm2hYxRPGxcPe5ShNzHK9eE3G2zgRjxd,2736,17340,-14604,625
2022-01-08 14:47:44-05:00,2959,BPRoaqrDs8vhqv2T7d9qV2oPU33pi1K1LUaotM7yuD2i,6qo8uQGAEwBfYQR36v6nRiqA2xGV6SjJAsXsdzy5bqNH,True,1761878855,440469713,2755012,1377506,1377506,GAUsoe8ZTCiGPm2hYxRPGxcPe5ShNzHK9eE3G2zgRjxd,110200497,748321642,-638121145,625
2022-01-08 14:47:51-05:00,2960,9LZ3rShLfzErXsGkh4dYfAm58GNPWhK6ohDy5RrLJhc,41tLyuvuJ5M7YctkSASD2R7RGGetD7FmKaZUdkTdgXgt,True,2461242,615310,3850,1925,1925,GAUsoe8ZTCiGPm2hYxRPGxcPe5ShNzHK9eE3G2zgRjxd,154004,617764,-463760,625
2022-01-08 14:47:51-05:00,2961,7g4NJBHwDTRm58GqX7Tz1JzqwbAhF6EWJUQH3SoDxSf7,82Ypv7STZeSCBPf3HckWdyatELpvaDaWxFXhD5dNSML4,True,39566,9891,61,30,31,GAUsoe8ZTCiGPm2hYxRPGxcPe5ShNzHK9eE3G2zgRjxd,2476,15240,-12764,625
2022-01-08 15:18:48-05:00,2962,A1j2G5FZRyWSjFt6dK87WHhLkQrPUVqHaM3KhSzhAKDT,2fMiHLYm4pL3YCd8aveTR4mT9uVxztQeMwb5eRZb4wUW,True,913702,228425,1428,714,714,4BnQKPLuE3DMTtxp8MjUBytgnhvxqq3ZTqZHTVZo4JJh,57141,408939,-351798,625
2022-01-08 15:19:07-05:00,2963,8xvLGVeDmhVYQhN2ZpWkVG9jCrukRsNQ4926a4TMiZqa,9ciBySSjvADwp47WkETiFWZKVTFL8Hf1XvK7aSxhcgQS,True,32523304,8130826,50889,25444,25445,DddJ7EWCmYEEZETCBNgAUSg81Ls6fZtiAaY5ekJ5sXx1,2035599,13206124,-11170525,625
2022-01-10 08:17:38-05:00,2964,4k95B2HfiTXT8fDtW4286MoEPj6UdPiQd5BjFadjs8Pv,GmhpDUb5A14X8xRZHRnbrYEr3xJh9zJA7eqoCzwboDTW,True,1605311931,401327982,2497874,1248937,1248937,HfEnetJ7uBSmZWCjBNxdvv9HEC5nsW4wDV7wu6WnhWan,99914963,338323032,-238408069,622
2022-01-10 08:17:39-05:00,2965,C33hfnDHzVwKXxr6AwFAXhd1vJYrPKhtqc75Qpjm19Zt,2WYBMSyrHQEYZqxEtxBMe2xn7eioJEGsudqdCmGvssGh,True,84551056,21137764,131515,65757,65758,DddJ7EWCmYEEZETCBNgAUSg81Ls6fZtiAaY5ekJ5sXx1,5260607,15699956,-10439349,622
2022-01-10 08:17:39-05:00,2966,GKCeRcHQYMhcTwEm5wu1SbkXAT19gjGUGji43HS36B5N,EYQKX5sWsmXoge5xbTcMYAjvRbSUTXXpHEzckPY2LV8W,True,3166633,791658,4948,2474,2474,DddJ7EWCmYEEZETCBNgAUSg81Ls6fZtiAaY5ekJ5sXx1,197937,780925,-582988,625
2022-01-10 08:25:44-05:00,2967,Gbxc51WERLLeCtiHv7rDvE52aqF541RoQWG5n5aqErq6,4ngBoHbfXijLMqGKxFMNht9sbmxy2g5eqBmn8QsBmbx1,True,1755993,438998,2739,1369,1370,DddJ7EWCmYEEZETCBNgAUSg81Ls6fZtiAaY5ekJ5sXx1,109587,720176,-610589,624
2022-01-10 08:26:44-05:00,2968,CbhrZUdan1axNDFUrX1ZuEohfNMEGrszKSkk6pppVQuw,DHEAjJNtuEePezYAv77thWabbVxxqQpfuiC6moRSrpG1,True,121025867,30256466,188736,94368,94368,DddJ7EWCmYEEZETCBNgAUSg81Ls6fZtiAaY5ekJ5sXx1,7549458,66506779,-58957321,623
2022-01-10 08:35:38-05:00,2969,G25vsB3sDqRhHoSK4KwR1TywfrJDtpejVbbevEG9sQ9a,5xFC3Hm13magnAA9GD1EnwC9PrPoEfQ7omEa9p9zCrB1,True,2920090,730022,4526,2263,2263,3zqXX6kzhkbW3d4TwD2CNjMRwxTbREXySekvq37kfCNk,181045,1063124,-882079,619
2022-01-10 08:36:01-05:00,2970,7iUx7JBwqUvPVPeCqMEXQdLccZJmaFYm1DUQiu3ouHa3,3EVZzhRmJnX9ZiBZZo9tenDtMogAyuA1yf2cKzvUWiuu,True,1987311,496827,3102,1551,1551,HfEnetJ7uBSmZWCjBNxdvv9HEC5nsW4wDV7wu6WnhWan,124093,831137,-707044,624
2022-01-10 08:45:46-05:00,2971,Dn916KSmX3HqxT53hrxrbCrV3tdRMCPdaoiRLqetMrth,ATCXRiXgnjRRUbSTPBvtBXMENCqsViexSZbZ6aDaXXWA,True,2219556,554888,3456,1728,1728,DddJ7EWCmYEEZETCBNgAUSg81Ls6fZtiAaY5ekJ5sXx1,138279,920359,-782080,623
2022-01-10 08:46:33-05:00,2972,D58t4uTjFumsUeYFaKnpV8BRTEQEqKXBreFTdwGrott7,67p6kHDfVqQijfcwugvZK59c3aRRH9x3eHxruqH8WEqF,True,1750324,437580,2725,1362,1363,3zqXX6kzhkbW3d4TwD2CNjMRwxTbREXySekvq37kfCNk,109031,716978,-607947,622
2022-01-10 08:46:34-05:00,2973,7jvKp6onXyWgwsFrFWj4hYTXJsYYD6ot5mn6rPFuJriy,J7N6HiozevJVTiY9hDEUs2ud5BwT5QSE7wnMBS1w5ie2,True,75504463,18876115,118043,59021,59022,4BnQKPLuE3DMTtxp8MjUBytgnhvxqq3ZTqZHTVZo4JJh,4721736,36142985,-31421249,625
2022-01-10 08:46:44-05:00,2974,DDsY5V3F9wnEGBoQFCEf1hvEYuKUaJdysbc7TxhNqe9G,5oBCGzvy8odB8MCxCUvPDqYCnTyteZ4Yy1JDroroygbi,True,95685771,23921442,148027,74013,74014,HfEnetJ7uBSmZWCjBNxdvv9HEC5nsW4wDV7wu6WnhWan,5921103,22651472,-16730369,618
2022-01-10 08:46:44-05:00,2975,8Xt3qHjZG3zLxozgM5vPHMVxp8eYFMg89kaVW7vdHKoA,2i8riSsQpfADD9LUVpiBJBfX5qjVAgmZegzfKx6RG9dW,True,72750779,18187694,112543,56271,56272,3zqXX6kzhkbW3d4TwD2CNjMRwxTbREXySekvq37kfCNk,4501751,22330316,-17828565,618
2022-01-10 08:54:40-05:00,2976,2mfcg17QocKKvDcqDH88TwxHRiS8dAQiJAGoAh1brns9,8aQLELBgaA9eXsxSciMjxWv8B1hpbUPfLwqVjEnasZbe,True,212704667,53176166,332550,166275,166275,4BnQKPLuE3DMTtxp8MjUBytgnhvxqq3ZTqZHTVZo4JJh,13302007,53699518,-40397511,625
2022-01-10 08:54:42-05:00,2977,8trFFwvXKKMwMx952ugCZmqyw29e1HxEKBuQmFn8ZwTf,FsD7gCvHXM3QchQiDcd292ksy5afZMWApneNTat5ndeS,True,388150188,97037547,604081,302040,302041,DddJ7EWCmYEEZETCBNgAUSg81Ls6fZtiAaY5ekJ5sXx1,24163259,83673971,-59510712,622
2022-01-10 08:54:42-05:00,2978,B9WJfmrYEkVH3L1UWz4qqWpaexHydymbzvEfwNVtB9BV,6mQb4yzGq8jE1NbweKCKSbevnnYVhHYxyc6Gz2a5kJLn,True,435270357,108817589,670850,335425,335425,DddJ7EWCmYEEZETCBNgAUSg81Ls6fZtiAaY5ekJ5sXx1,26834011,94421254,-67587243,616
2022-01-10 08:54:57-05:00,2979,Gs3WP18hbzNpbBgiU39e6tfkggfCKRyNqPqJQcthuHFD,4XAY25YUma6gUdG2GdbXeivum3t21g93ZagfWGTZYkWZ,True,17103445,4275861,26697,13348,13349,DddJ7EWCmYEEZETCBNgAUSg81Ls6fZtiAaY5ekJ5sXx1,1067887,7974006,-6906119,624
2022-01-10 09:05:00-05:00,2980,8trkirSQNdMmAcJdeswxs5cPjH8dD6U4eJtWiAdMsrDB,HaSzpQ45x2MipfN17U6jGBxX8tXboomVDhXNSrnEfLDr,True,5845439,1461359,9121,4560,4561,DddJ7EWCmYEEZETCBNgAUSg81Ls6fZtiAaY5ekJ5sXx1,364855,2289105,-1924250,624
2022-01-10 09:07:48-05:00,2981,H3x9b27yHVdCxvtDf7mmJxkNeubcmQMwfAkLTYADPWNv,HGVCCz23rWx78vrTB2wvm2aesbLZuYFhhNuznGiSSAyA,True,4343950754,1085987688,6795510,3397755,3397755,DddJ7EWCmYEEZETCBNgAUSg81Ls6fZtiAaY5ekJ5sXx1,271820407,929098182,-657277775,625
2022-01-10 09:07:48-05:00,2982,2jDRvE3pQNjWy1NRFa4tzB3KmU5UkbUCHw8sQRFujo66,C4zNi2szDrEEh4coTF3WRUghfP4ZwAVVSYTLWfkejQRu,True,846731830,211682957,1324666,662333,662333,3zqXX6kzhkbW3d4TwD2CNjMRwxTbREXySekvq37kfCNk,52986664,285813889,-232827225,625
2022-01-10 09:08:16-05:00,2983,HdfQweV1KuYSpWdycZbpGrUc8yMcY3ZczLn1agKXMJaf,G1Ae1PZHkANkwFnhUKS1tvdFEv8dAFeojBkezh6rUNMh,True,9457146,2364286,14743,7371,7372,DddJ7EWCmYEEZETCBNgAUSg81Ls6fZtiAaY5ekJ5sXx1,589749,4285579,-3695830,623
2022-01-10 09:08:21-05:00,2984,2VyFcgZDH1HTEvD1XaWhwqBCMmZ1k6TmZ3fEpPcBZR9E,G1wFJETTpdoc7CfypGCzkq1jssXPfUkiuLjK2cwVZ9dJ,True,136626,34156,210,105,105,4BnQKPLuE3DMTtxp8MjUBytgnhvxqq3ZTqZHTVZo4JJh,8436,64646,-56210,617
2022-01-10 09:08:21-05:00,2985,BxXXWywnC3dSyLPJHt7owfBhgSiBWzkuD3T8hGYLqCH6,4vuwEBXXbXFMPmbJJJRop4FCWGyKR1sXhBc3EWF6MiB8,True,162429660,40607415,250976,125488,125488,4BnQKPLuE3DMTtxp8MjUBytgnhvxqq3ZTqZHTVZo4JJh,10039077,85087474,-75048397,618
2022-01-10 09:08:21-05:00,2986,2bikYf33ZxxDmvkMNjWDGGqEpbYJPvWv5At3hzyeLEQK,5FtirUBjRAZ3k5arFFVwKz42ixWzhkEBLkaK9PraRZ78,True,249924,62481,386,193,193,DddJ7EWCmYEEZETCBNgAUSg81Ls6fZtiAaY5ekJ5sXx1,15473,78795,-63322,619
2022-01-10 09:08:21-05:00,2987,HhwiZPKZBGa16oVi739s4qtMDMTwzWXc7iwNfX63t2UP,5AnbMbAFKy85yHt5y2M5S38nNkA1vT4ejY5NjGbRNUqn,True,2360958,590239,3656,1828,1828,DddJ7EWCmYEEZETCBNgAUSg81Ls6fZtiAaY5ekJ5sXx1,146264,1348570,-1202306,619
2022-01-10 09:08:21-05:00,2988,FLTW9fwjWqGPm5PiE3C9LFzwZxtDh8c2MnEoRq8W7MfQ,GKsfzKBP2QkmoEWvTaUN1h4nqrT3kAcwYRC9WxW9bB3h,True,21033247,5258311,32412,16206,16206,4BnQKPLuE3DMTtxp8MjUBytgnhvxqq3ZTqZHTVZo4JJh,1296484,6627245,-5330761,616
2022-01-10 09:08:24-05:00,2989,4kbcrzH6o2LvLUCNphyL52i8uGzVD8wcUNEqoQ14z3VG,5Q1atmEBs2AqaDZsiZFG5stHzj1fE6ZvypgfkEc9LYqE,True,303953276,75988319,468779,234389,234390,4BnQKPLuE3DMTtxp8MjUBytgnhvxqq3ZTqZHTVZo4JJh,18751167,157032742,-138281575,616
2022-01-10 09:08:24-05:00,2990,CCHzYXr5zMXFu8MMZNkfUWGyUcF8xy7Vvhq7tNCtZg2L,AuEXkCJTTJ3HK8iP4qTWpQr4vp6HPRJZyZwfRjF8zjfp,True,249734,62433,384,192,192,3zqXX6kzhkbW3d4TwD2CNjMRwxTbREXySekvq37kfCNk,15365,78876,-63511,615
2022-01-10 09:08:26-05:00,2991,921FBgLS3A1wA77uWitsnTvW737Q2jY7tzvgWtWLXNC7,E4eJ9H7cqP9zNpMH5xRBTAp9yaBCBihuJBNd6pqzteDG,True,249735,62433,384,192,192,DddJ7EWCmYEEZETCBNgAUSg81Ls6fZtiAaY5ekJ5sXx1,15363,78874,-63511,615
2022-01-10 09:08:26-05:00,2992,AGhvB6x3gmvAJSnr9UVtvhKqVg3Qgh1k4roHzrNHhAaa,HhhjXT6WJnz1HQfHcwKdBppuAhc8ncUcq1mkJ4EHqgpe,True,10764,2691,16,8,8,4BnQKPLuE3DMTtxp8MjUBytgnhvxqq3ZTqZHTVZo4JJh,668,4248,-3580,620
2022-01-10 09:08:26-05:00,2993,GH6Q9E1jZPTTp46aDd57UNZPNS2D6PBSwyLL3EHSjGn2,2XvwZXNsrPWx4EfPvhTP933bzCC3SJHDQ8xARfrXdVY9,True,33649323,8412330,52297,26148,26149,4BnQKPLuE3DMTtxp8MjUBytgnhvxqq3ZTqZHTVZo4JJh,2091918,27042493,-24950575,621
2022-01-10 09:08:26-05:00,2994,3Xbsek5MsEGoWr3G9yhuohREr26B2vSQcjqXdspTFHta,2rPxkUiMo9wGDq8EvAiwY3ngRpKmL223cBWWNTYoBmFp,True,405281648,101320412,623672,311836,311836,DddJ7EWCmYEEZETCBNgAUSg81Ls6fZtiAaY5ekJ5sXx1,24946884,132110494,-107163610,615
2022-01-10 09:08:27-05:00,2995,DJiXXW7sjNsAAxWupDKBUsFhXSgPoerVYaAtJqqNgVbn,2MsqvNuJw1xQhJ3UnXt9i7oNHDuZpR9w7iE1WQcGqt5m,True,249732,62433,383,191,192,DddJ7EWCmYEEZETCBNgAUSg81Ls6fZtiAaY5ekJ5sXx1,15354,78867,-63513,614
2022-01-10 09:08:30-05:00,2996,4D7mDXe7SdmbAx7kaD1mBNuEa7DzMi6TAwXURxtLEazk,5pSnT91PHoLdN6uhPnUtoD7cboLmndn26y1XouPx8vwW,True,2527507,631876,3941,1970,1971,3zqXX6kzhkbW3d4TwD2CNjMRwxTbREXySekvq37kfCNk,157663,793590,-635927,623
2022-01-10 09:08:31-05:00,2997,AA9zFZTXqBR8Mw1fwEH59edzBiswoGasRNWsi6aLeysB,4VeitxYqqtRxyfdSVpshdJ3EDcgksRVnaHvAqWxTeujH,True,2897760,724440,4511,2255,2256,DddJ7EWCmYEEZETCBNgAUSg81Ls6fZtiAaY5ekJ5sXx1,180441,713933,-533492,622
2022-01-10 09:08:36-05:00,2998,36ByQojnxEckWdQTjqHfxKqCx9yjqWQsPsZyqaN72UWR,AZoirtS1fjX61agRM64tqThVinnJTh3BWgiHyNHPTgZP,True,1047440,261859,1635,817,818,4BnQKPLuE3DMTtxp8MjUBytgnhvxqq3ZTqZHTVZo4JJh,65411,566973,-501562,624
2022-01-10 09:08:37-05:00,2999,5RvNKzSeJ1fvqsKpcQu25evEZGmKjyEDgwsMZkykoT3P,BRqSGfE4XHXu4HrinwetWumfVTmr82iuF6Y5oSV6eMiK,True,249828,62457,389,194,195,DddJ7EWCmYEEZETCBNgAUSg81Ls6fZtiAaY5ekJ5sXx1,15577,78995,-63418,623
2022-01-10 09:08:39-05:00,3000,6dr65yANjSMmfBeKAuSxG3i16S9vMgF1CQ3zDyzh55Pn,EhrE5QpnshD41S4zPEBy2A5q2Gs2mwUrbHGo6WnT9zDP,True,569758,142439,889,444,445,DddJ7EWCmYEEZETCBNgAUSg81Ls6fZtiAaY5ekJ5sXx1,35596,266746,-231150,624
2022-01-10 09:08:40-05:00,3001,Ayx8dFsVzUBb9b7QKxw7YHJuhptdSitBXFEczXTaxe85,EvU1VLChnowi6ccSPeJRSk65njrqZfYouAN7SHePxsxf,True,39839,9959,62,31,31,DddJ7EWCmYEEZETCBNgAUSg81Ls6fZtiAaY5ekJ5sXx1,2490,18698,-16208,625
2022-01-10 09:08:40-05:00,3002,5jin5wXjQQ25nGM2ECrCXcg1a95vquh6kM7rMRru6Ke7,EKM657EQ8HWWgf4cssByoYHoXGjFfTspTKXAGmygAPQG,True,64049605,16012401,99646,49823,49823,3zqXX6kzhkbW3d4TwD2CNjMRwxTbREXySekvq37kfCNk,3985852,29187738,-25201886,622
2022-01-10 09:08:43-05:00,3003,ES1MDwRUa3hoToPKQiiZkzMYe9PDVnAQwMrEvZrzvnc1,C4wBG3xTDkmDQneB28xYnf1aBNEeq7UB8oR7NuEfLkFg,True,46888674,11722168,73050,36525,36525,4BnQKPLuE3DMTtxp8MjUBytgnhvxqq3ZTqZHTVZo4JJh,2922012,14695271,-11773259,623
2022-01-10 09:08:43-05:00,3004,GGGyesjbt7h2XHHp9u8vpiWGugFwEbrtYaKrNQSDhQd7,8tydo1ZjGHmPBSqU33tywB3f9szdsHk1ckGFe4Ay5pgs,True,85965716,21491429,134175,67087,67088,4BnQKPLuE3DMTtxp8MjUBytgnhvxqq3ZTqZHTVZo4JJh,5367022,61249329,-55882307,624
2022-01-10 09:08:52-05:00,3005,6u6bPgAmK8ufACrQV99A1Y5nhGkue3KEUHmQQkcNkxwP,7636yXT5w4DcVpc7LJdN46aiggzSq6U2GXHXL5kyy9F3,True,201978918,50494729,316027,158013,158014,4BnQKPLuE3DMTtxp8MjUBytgnhvxqq3ZTqZHTVZo4JJh,12641106,91824889,-79183783,625
2022-01-10 09:09:09-05:00,3006,3Lv2XpiD4KBUHq7Zx6u3zNhpXoySodXHH8o8f5yaaPxG,H6TN4rhpBXkEH3mZnymYNcKfmnxRH2uzfwzeLH2q6ahP,True,317980,79495,497,248,249,DddJ7EWCmYEEZETCBNgAUSg81Ls6fZtiAaY5ekJ5sXx1,19895,127018,-107123,625
2022-01-10 09:09:10-05:00,3007,2QStaRnbSnDhA891Lb1bxjVeMYpJUpNdqaVkw3rqU45V,DakRWPnttPoRcjY5V7WLwiwBx39BapCo9Atog8dL17Ku,True,3855464,963866,6031,3015,3016,4BnQKPLuE3DMTtxp8MjUBytgnhvxqq3ZTqZHTVZo4JJh,241249,1131883,-890634,625
2022-01-10 09:09:11-05:00,3008,6CeKxTJvFqhyNEyzySiBBKEwYVMe7j3A6nkMes4BW6o2,DzDR9XvwY1z7ygQ8YrCXrwDGHSf67JZF8BzUnuFE2fxQ,True,7452133,1863033,11661,5830,5831,DddJ7EWCmYEEZETCBNgAUSg81Ls6fZtiAaY5ekJ5sXx1,466463,2504157,-2037694,625
2022-01-10 09:09:38-05:00,3009,3njiRuSRMXRzKmamyiR72Hc38PU8UDDmWdfPhgxmGxEW,5WoF3gkgygyNNbwxWgVfqGWkExcDixuzgJQQjXEZQ6J5,True,434187214,108546803,679108,339554,339554,3zqXX6kzhkbW3d4TwD2CNjMRwxTbREXySekvq37kfCNk,27164329,281938535,-254774206,625
2022-01-10 09:09:41-05:00,3010,8MKNsuGVaoYpdQy6NNyxDvRzh2DAquBUtri4nDsixUxs,D7M1SDmpZAs8vdPCCCa96UbDF15YQDxHmoGWB57tHiir,True,7042808,1760702,10958,5479,5479,DddJ7EWCmYEEZETCBNgAUSg81Ls6fZtiAaY5ekJ5sXx1,438338,3402803,-2964465,622
2022-01-10 09:09:41-05:00,3011,8VnGmfop6qcUezAJ2M15jz2Nn6mPQgehDcJPvypq4XJn,6F6sqXNhgkW9ev8QNMm4ydywUUmemhwgydRQYNeqyUmi,True,18016524,4504131,28067,14033,14034,4BnQKPLuE3DMTtxp8MjUBytgnhvxqq3ZTqZHTVZo4JJh,1122703,14746851,-13624148,623
2022-01-10 09:09:45-05:00,3012,5PbrpM9kjzF4R2eW2UTcRVXnhqWdRQWHZJXKLN43N8WC,6ip4ocbyHusy8CsVvcrpiRCUp2nq9cY8bHpTcUU3Wztq,True,13472947,3368236,21014,10507,10507,4BnQKPLuE3DMTtxp8MjUBytgnhvxqq3ZTqZHTVZo4JJh,840587,5386230,-4545643,623
2022-01-10 09:09:45-05:00,3013,DAku12iueL13vRoTpKLyqdGaLQ2rWF6REe8Dr8soFvNs,H2vVH3LxkhGe6x6Mdwy67BYwTKNQM6XayKx7mhrwyfJM,True,758782,189695,1185,592,593,4BnQKPLuE3DMTtxp8MjUBytgnhvxqq3ZTqZHTVZo4JJh,47434,356526,-309092,625
2022-01-10 09:09:45-05:00,3014,FpqCxvTkSiwDwD5qEt6hXJxzFDLFLAQ8VevK8zwRqYun,A3p6YQisCJKpNkF7vkjZRbEfbnUt7vTZdR2zPBUSdTkk,True,698354896,174588724,1090254,545127,545127,4BnQKPLuE3DMTtxp8MjUBytgnhvxqq3ZTqZHTVZo4JJh,43610186,235251816,-191641630,624
2022-01-10 09:10:08-05:00,3015,C2Dmfw4G8KKzFq38aRH2pLCRngnGZDvUUN3fHDMjFkoG,7kzJk3BTNvY3hGFNj7nDy9L5CAYus6eNiCAxWH8dSioX,True,631347,157836,986,493,493,4BnQKPLuE3DMTtxp8MjUBytgnhvxqq3ZTqZHTVZo4JJh,39444,359148,-319704,624
2022-01-10 09:10:09-05:00,3016,AM5fwZR9BUW8AFkhdGWXW4PHd2cy8ora63kDf2z2eknw,E7ru6hg4MchnRG5zcr5YazwX8Snt55r5Xq9zCHCGaYZT,True,1625539,406384,2540,1270,1270,HfEnetJ7uBSmZWCjBNxdvv9HEC5nsW4wDV7wu6WnhWan,101602,725836,-624234,625
2022-01-10 09:10:31-05:00,3017,6eBSLXDMVoW2nG3n7s42RXDH8byY3C6n1RsUuegBLSrG,37dYrKnTXYer7Bu9xFfpArA4ZNo2B9bycFw9HywDtTRx,True,16858357,4214589,26162,13081,13081,HfEnetJ7uBSmZWCjBNxdvv9HEC5nsW4wDV7wu6WnhWan,1046518,7421697,-6375179,620
2022-01-10 09:11:03-05:00,3018,6yw4GPvkqUbakcEWtqSCfjVLukty11xqjDpGxtEN9Km2,5ppEx7wkpqbG5nApCWMdRja3oRSheFmAAsNHUX7h2w2Y,True,2805716,701429,4386,2193,2193,HfEnetJ7uBSmZWCjBNxdvv9HEC5nsW4wDV7wu6WnhWan,175440,2346721,-2171281,625
2022-01-10 09:11:03-05:00,3019,Fd2HrzBAr4JobRPARZwpQHHVoSCEoog32A6tKMWAC1sK,BYappsar5sQf8VLem4wrLuTtrDFH9y8pEx1aMxfuU4Pq,True,51155164,12788791,79767,39883,39884,4BnQKPLuE3DMTtxp8MjUBytgnhvxqq3ZTqZHTVZo4JJh,3190685,23345893,-20155208,623
2022-01-10 09:11:03-05:00,3020,2FrqGFZjbiNykJyo9BZ5S9FguQJPJiTi681rJJsQ5dta,3QUncYP92NKrfpaTvuF9iQg11PXKgZAgEngwh6BbnCCj,True,1403088,350772,2173,1086,1087,DddJ7EWCmYEEZETCBNgAUSg81Ls6fZtiAaY5ekJ5sXx1,86954,537412,-450458,619
2022-01-10 09:11:03-05:00,3021,8RmB8o4zux2sD48dEsKpsX475KRxTwdk8QULUDU9xx8R,AKSiZnb4YKVB6B86aPPqvyXquhvN9xqt45bexBCZ7nx,True,107628759,26907189,168394,84197,84197,4BnQKPLuE3DMTtxp8MjUBytgnhvxqq3ZTqZHTVZo4JJh,6735777,57259071,-50523294,625
2022-01-10 09:11:03-05:00,3022,BAczoNDnbwj5AJX5LwzynzYab7ji7VbhRy9edA9Prax,34sbkUKnMetUNyMs6BhiWut85d5UZtBWnPtwx8jEpJNA,True,2207600,551900,3423,1711,1712,4BnQKPLuE3DMTtxp8MjUBytgnhvxqq3ZTqZHTVZo4JJh,136951,929048,-792097,620
2022-01-10 09:11:07-05:00,3023,AHm7zF4rpaxaayBLn5QDHgJSp8KAr647s4cNvQ9wLgd7,FDM33WngED24pukBvSDpPAzinW6afVAeGReum5nyLRiC,True,1406914,351728,2187,1093,1094,DddJ7EWCmYEEZETCBNgAUSg81Ls6fZtiAaY5ekJ5sXx1,87510,665466,-577956,621
2022-01-10 09:11:07-05:00,3024,8NdcaYUC1X5CP7FMDip78uqtqmCt8GcZdCzLRTYTihmb,9Ei1K9bXWXSXcBfeX5exPSXGCAu62WSKzvnnd4wHvyVh,True,223184,55796,345,172,173,4BnQKPLuE3DMTtxp8MjUBytgnhvxqq3ZTqZHTVZo4JJh,13819,90922,-77103,619
2022-01-10 09:11:07-05:00,3025,ANQkPUoMjLHyRtypeKzxsKW1DFauQsh9SnB3rRgRXM1Y,7RHAExWpG8Q3PXwKhJs2yXmYK9WogGydvFYpx28p6pgr,True,123346807,30836701,192967,96483,96484,HfEnetJ7uBSmZWCjBNxdvv9HEC5nsW4wDV7wu6WnhWan,7718685,66529563,-58810878,625
2022-01-10 09:11:08-05:00,3026,EmGW2aAG69ssWqCtbfDocRaM2u3TJsczn2HHP9jdmRvD,aypkDKsp9uqAB4F6mwvm5LofpsrFBuZT2MMWtE2eHdB,True,1096940,274235,1715,857,858,3zqXX6kzhkbW3d4TwD2CNjMRwxTbREXySekvq37kfCNk,68638,473246,-404608,625
2022-01-10 09:11:09-05:00,3027,F2v1YwVAwXLiUgsJ5uwn4qAAkTXitn1E75fJcPnGuAcy,5rdJ4H5GxPg4Juu77mGc7uya5LwEqLzDSRyG8mQ2mDbK,True,32759796,8189949,50954,25477,25477,DddJ7EWCmYEEZETCBNgAUSg81Ls6fZtiAaY5ekJ5sXx1,2038160,14953677,-12915517,622
2022-01-10 09:11:14-05:00,3028,6tFQaTqqffino9kwMZTL2xVNBG8k9VREFhXqVi2si3A3,3w3wGxBbS4bmXeqmvd595SAWFeXekVpnH4UdbeEs8Sx5,True,7446314,1861578,11635,5817,5818,72FwbpFGoLEazJEdpqNtPNefsadUrimUqma9wSoy4qiS,465422,2508934,-2043512,625
2022-01-10 09:11:39-05:00,3029,JDeYjCLpfnzcfxDFgHf4aBcHsajwdR14GUaKAA9euzVf,EJbvKoyMZcoCx4vWa61uMbW2vr6mUhrgEuECdteVBuZZ,True,10157025,2539256,15698,7849,7849,DddJ7EWCmYEEZETCBNgAUSg81Ls6fZtiAaY5ekJ5sXx1,627927,5832675,-5204748,618
2022-01-10 09:11:59-05:00,3030,AWvHDdb2ikqV8wc7qQ8azbvNTZdixMNxhQjhQdhayYtR,9EpgEPBb1nog6aQeFdMXfSRiLSnzGQFQ39mbLdCxgYTv,True,60349126,15087281,94408,47204,47204,DddJ7EWCmYEEZETCBNgAUSg81Ls6fZtiAaY5ekJ5sXx1,3776346,18008157,-14231811,625
2022-01-10 09:13:04-05:00,3031,9zpPiboHF5HW7NfCx7hYdmJGwUomVMTiUFc4Um5KrDi3,8q3eBpuwV6dMNkib9N8XQAq2tBUcjSANRe5SXpd4dFhZ,True,13940363,3485090,21703,10851,10852,3zqXX6kzhkbW3d4TwD2CNjMRwxTbREXySekvq37kfCNk,868134,4326972,-3458838,622
2022-01-10 09:13:04-05:00,3032,E8ifvhmyJGBGVQomo3AnZw2UcaLHcpGsTtuoCid8voU3,FMQUWTbTAfSLfrc6GTrz4DM2ZSgoxF3KtqGn8AyjVtsf,True,12083949,3020987,18796,9398,9398,3zqXX6kzhkbW3d4TwD2CNjMRwxTbREXySekvq37kfCNk,751861,4005841,-3253980,622
2022-01-10 09:16:05-05:00,3033,5eMLdQ4gYA5iqvTXSNdGvctHp7s5VpyFuwtJKqx6chBc,Ckxc5K39nkBNXBTmFTM8J48R7wGqNm3vHKZu4G5baumZ,True,427381304,106845326,668400,334200,334200,HfEnetJ7uBSmZWCjBNxdvv9HEC5nsW4wDV7wu6WnhWan,26736016,142541207,-115805191,625
2022-01-10 09:16:38-05:00,3034,Bsr6kx1B6BSEd5UnJ7Z61M49iUb3bFrDVhiEtMVtPDF2,3CFd1pUJAJPA9fobwn4Jj2mRju1CWmoop4Mh4znypNWT,True,38105688,9526422,59394,29697,29697,4BnQKPLuE3DMTtxp8MjUBytgnhvxqq3ZTqZHTVZo4JJh,2375762,13896840,-11521078,623
2022-01-10 09:16:39-05:00,3035,BgnsCfJ54ReunUtwPJLzkW4PWnqpBDWGNYxsW5PvDrbK,KpMqEkQ9dKMgCevsEK895wHd3fCLRPSzDmJSv3tKU4u,True,18842171577,4710542894,29318818,14659409,14659409,DddJ7EWCmYEEZETCBNgAUSg81Ls6fZtiAaY5ekJ5sXx1,1172752752,6912103347,-5739350595,622
2022-01-10 09:16:45-05:00,3036,6NJFN855M3Q3RLTDNo57gTgAmwPD6G2E3WvMb1m5eNCN,3YpqNnonsvXaRT4nCC3G5FZx1jjVtbDPc36LiR6WK5jR,True,98741141,24685285,149740,74870,74870,4BnQKPLuE3DMTtxp8MjUBytgnhvxqq3ZTqZHTVZo4JJh,5989636,55980903,-49991267,606
2022-01-10 09:16:48-05:00,3037,D64rDiWT3YG28fCgXCmbNjYa2JakZbpKQ1D2XuLChUfV,8WmMWq8cTsGQym5pUbHm9dPCpJugBeWUMVERYFGLxWHj,True,46383296,11595824,71484,35742,35742,4BnQKPLuE3DMTtxp8MjUBytgnhvxqq3ZTqZHTVZo4JJh,2859370,15796845,-12937475,616
2022-01-10 09:16:56-05:00,3038,DkvR2xUPMyXWGGkUSmDSfhp7RtvMkfbT1ThKCS3TwrXd,F7jYV6TtT1LZ5XCNn1zkbUfNMo4gGcQUczAQy1jLHpaW,True,791547706,197886926,1232962,616481,616481,DddJ7EWCmYEEZETCBNgAUSg81Ls6fZtiAaY5ekJ5sXx1,49318507,333940019,-284621512,623
2022-01-10 09:17:00-05:00,3039,8swGZMrPrLAxZd7MxTbkCL13k3DmAJUw41jCp6Xo6awW,3fKnX7yTNXAT4uMmXVdTy47ALJT8h8YSD3WiBb4BGuzH,True,301564766,75391191,469854,234927,234927,DddJ7EWCmYEEZETCBNgAUSg81Ls6fZtiAaY5ekJ5sXx1,18794173,130590348,-111796175,623
2022-01-10 09:17:10-05:00,3040,3XZLp6JyrQYnufa1obczXqmK6cNR29ZMW1FdCYbWNTCP,8kUTi1Prio14m9LjCj6Mari6pXwJTYkE1mp21LMn235p,True,571675,142916,891,445,446,DddJ7EWCmYEEZETCBNgAUSg81Ls6fZtiAaY5ekJ5sXx1,35645,155548,-119903,623
2022-01-10 09:17:10-05:00,3041,2F45BX9mRmtNCHPejKFknN5aNgGvR4vVLFjMaY1a7dR8,ALdSutsvEFRUEQGGBbi31QywTL1pdXSDWrNJzvNTaoXL,True,42566936,10641734,66538,33269,33269,4BnQKPLuE3DMTtxp8MjUBytgnhvxqq3ZTqZHTVZo4JJh,2661524,18681320,-16019796,625
2022-01-10 09:17:14-05:00,3042,9UyQC8vc6zJJaSdnjvTAzgmcsw4fC3xFBBiCC1w9Sbjx,3ppBfboe6FPmt7f6WrivspMUoAznZKWQMeh3rCgw7vjQ,True,15215397,3803849,23763,11881,11882,DddJ7EWCmYEEZETCBNgAUSg81Ls6fZtiAaY5ekJ5sXx1,950526,4717624,-3767098,624
2022-01-10 09:17:19-05:00,3043,H1LftKtj94Zs6PG2A7gJt9rPurBkXkTy2hbbArQwAehi,8bANmhgdnPYa3PqdPnk5BA2xhvqJmPyaMF77mrBePJ13,True,65041,16260,101,50,51,HfEnetJ7uBSmZWCjBNxdvv9HEC5nsW4wDV7wu6WnhWan,4071,49153,-45082,625
2022-01-10 09:17:21-05:00,3044,pgzvXpnUYiY7hLrfjmwScqLd8oj9vYcXpFvpm4y4JvG,GdqdQgoyBAFuXdbvoZyDhB3jyqJzVo4nkGh7EPFxkBF2,True,3594306,898576,5560,2780,2780,DddJ7EWCmYEEZETCBNgAUSg81Ls6fZtiAaY5ekJ5sXx1,222413,3028415,-2806002,618
2022-01-10 09:17:27-05:00,3045,6nJyqvFKprwaVCE1gAa2P4RHKc6Pa6XFSJymx654zZ9K,4e7iJmdwzAPxp1Zi8Azo38YyPQdPKqqY4VLJyQ5rpdYP,True,4249442,1062360,6638,3319,3319,DddJ7EWCmYEEZETCBNgAUSg81Ls6fZtiAaY5ekJ5sXx1,265549,2030838,-1765289,624
2022-01-10 09:17:27-05:00,3046,DGAQzgZhS2yioeZmG3cbacM3hdz4F1aZn1PWRwgiFukc,48KUtJaNCPNxkLXJBtWAdDxY4b9vZzLgbGxTNdwMqmjz,True,891412809,222853202,1392484,696242,696242,DddJ7EWCmYEEZETCBNgAUSg81Ls6fZtiAaY5ekJ5sXx1,55699360,382585515,-326886155,624
2022-01-10 09:17:27-05:00,3047,o2aCmkxsxSiyUX8soTEjwUCbJeXmCZsEaf8CWwxDT5n,3pvS2bTsUuiQyqZp5rdnTpq4cqWGgtv4E5rN9HsBxpRt,True,40752,10188,63,31,32,4BnQKPLuE3DMTtxp8MjUBytgnhvxqq3ZTqZHTVZo4JJh,2549,10628,-8079,625
2022-01-10 09:17:27-05:00,3048,67Z7ZGhNu5xxEh9BYKWcXp9m1T4tFiE1o1M16hCzUWQA,CT7YKWixz7BhTbvg5F6M5HCyPGnHoFLNFuDV9GhoLTo3,True,5539405,1384851,8585,4292,4293,DddJ7EWCmYEEZETCBNgAUSg81Ls6fZtiAaY5ekJ5sXx1,343411,2999528,-2656117,619
2022-01-10 09:17:27-05:00,3049,J4krKPBBTMVLZRgrSeYJAMyHQs2FkNm5TXk7nQWwDB43,ASmLbfNbhTD2HHeV7qzAqiHjUx5a8Traj8oPDwbkMdFg,True,48210640,12052660,74432,37216,37216,4BnQKPLuE3DMTtxp8MjUBytgnhvxqq3ZTqZHTVZo4JJh,2977314,16630460,-13653146,617
2022-01-10 09:17:28-05:00,3050,51yPLtXTgL9oLKs1cCf5TjL54Ld5vuVxat2NNtwZVsZG,7UjtM7Z1tiXEQMMiorQyncgi9SKu3v46DhVdgXbWqSiF,True,604761397,151190349,940752,470376,470376,DddJ7EWCmYEEZETCBNgAUSg81Ls6fZtiAaY5ekJ5sXx1,37630084,489327128,-451697044,622
2022-01-10 09:17:29-05:00,3051,CvZssqscu2dm35mwcE3zg9zedavbRjVJjWD59Py5ExUK,7pXaoR6aHKYofCmg1eHipygNYDteEaf8rbbS8BDYGQK6,True,1193147,298286,1846,923,923,DddJ7EWCmYEEZETCBNgAUSg81Ls6fZtiAaY5ekJ5sXx1,73852,402745,-328893,618
2022-01-10 09:17:33-05:00,3052,DdYgcyV1T2CDYiQVr4VL9Ym8RdKm93a7SKy8HxuyaoMW,GPdAeqeXb1UJ56AttcwwY1CyFhRyfptDC4BAX2Tc8MpE,True,896575,224143,1402,701,701,DddJ7EWCmYEEZETCBNgAUSg81Ls6fZtiAaY5ekJ5sXx1,56094,425019,-368925,625
2022-01-10 09:17:55-05:00,3053,CRaKcudjkQiSw5YPVjTLVdXvJskeGiHSYtq5ZcMPJhgQ,AgqTg3b3bAcaBmRidhNC4Uf9ZwNbeH52RQEqumWyuUs7,True,1475625,368906,2283,1141,1142,4BnQKPLuE3DMTtxp8MjUBytgnhvxqq3ZTqZHTVZo4JJh,91337,842750,-751413,618
2022-01-10 09:17:55-05:00,3054,EAUFD16wab8qRMJ4H6updHGt4xFqgRCDeRHVCsLCTSTL,8vkfYSyCyBY9g4TZrp52jUcQj6udy9xAaA4fioRE2RXx,True,3601374462,900343615,5613050,2806525,2806525,3zqXX6kzhkbW3d4TwD2CNjMRwxTbREXySekvq37kfCNk,224522017,789927554,-565405537,623
2022-01-10 09:17:55-05:00,3055,Ckqos6cdncPKj13DnCmDVZsZTqp6eS7277CRrT9WhcEr,AtUV8m7VQJvZq7GLCAHMf3jV7iamKEPnWVZHWuuVZQp1,True,2115870,528967,3301,1650,1651,DddJ7EWCmYEEZETCBNgAUSg81Ls6fZtiAaY5ekJ5sXx1,132069,1208549,-1076480,624
2022-01-10 09:18:01-05:00,3056,BrHRMouGRz3LBNzd9anfdYMhWfg8yUPHL4PqJ8WdEDFS,4uzoLa3mC2VYHAPBoHLX4gTjPTC28rPf2fvEGtJWPYc,True,103649470,25912367,162143,81071,81072,DddJ7EWCmYEEZETCBNgAUSg81Ls6fZtiAaY5ekJ5sXx1,6485720,79626750,-73141030,625
2022-01-10 09:18:03-05:00,3057,M69XSefqeum2arinvHEqmA3L2XHWNFN17p4msRhRZXf,2vK15yYUANLSbAoiBfgJ9VLyqsmtEpd2iNytQjms8GaQ,True,461422424,115355606,713437,356718,356719,3zqXX6kzhkbW3d4TwD2CNjMRwxTbREXySekvq37kfCNk,28537514,276931402,-248393888,618
2022-01-10 09:18:03-05:00,3058,HVZkXeDR3mc8oB9qFFwCK4RXpPojdcHk9tRGep6xtKGK,Bh3py7awPejWqeTMxtAgF7mPotL2Asxf8YrYJykq9nBt,True,11229880,2807470,17444,8722,8722,4BnQKPLuE3DMTtxp8MjUBytgnhvxqq3ZTqZHTVZo4JJh,697783,4485973,-3788190,621
2022-01-10 09:18:03-05:00,3059,9vcKW1GfrDZ3KLPh2pEVFF8ZyKqD1pJW1hiE8H98Av7S,C6Ki27mo4sCHu6u8UnR1p7WSgsTjFQxGGR9Lk9n5Rhjq,True,4730759,1182689,7289,3644,3645,4BnQKPLuE3DMTtxp8MjUBytgnhvxqq3ZTqZHTVZo4JJh,291564,2134536,-1842972,616
2022-01-10 09:18:04-05:00,3060,3qnPsgqW11AcDEmyjmJquPcPLyE3EdJQuVLJ5kinDrd3,86rZadBB7emKio76aFTahpbrFtxd9tqZ4Mxgzaavq2xU,True,269078,67269,420,210,210,DddJ7EWCmYEEZETCBNgAUSg81Ls6fZtiAaY5ekJ5sXx1,16811,108144,-91333,624
2022-01-10 09:18:04-05:00,3061,5rW9kqXB9feGSKSvSMNJF1FCsBYV3vGmTmc8MvzaZ3pi,7AjnjcfPJevW5521hXw4VtgRCfHSsAqyzyArukKfNcHo,True,18730935,4682733,29230,14615,14615,DddJ7EWCmYEEZETCBNgAUSg81Ls6fZtiAaY5ekJ5sXx1,1169205,9013737,-7844532,624
2022-01-10 09:18:05-05:00,3062,6oroGB3mvzK3tDfiB9X2NJuL3x476pxhgRnt7VxqhdLo,2SoK8tKkLn2ppKURpTVazKsCEis4uahkHMsac1m85J4r,True,3050663,762665,4729,2364,2365,3zqXX6kzhkbW3d4TwD2CNjMRwxTbREXySekvq37kfCNk,189179,2477337,-2288158,620
2022-01-10 09:18:06-05:00,3063,CagSUfZLwXuCdypC4KzU6FSNdmCj9dKDroPcNeaRtsyt,yxw5d1ztZuEUY2QjL7eLpr72QJAj5rJd6ERvg91cy1m,True,2754911,688727,4288,2144,2144,DddJ7EWCmYEEZETCBNgAUSg81Ls6fZtiAaY5ekJ5sXx1,171545,974411,-802866,622
2022-01-10 09:18:10-05:00,3064,zLTuMVfVswjMkhyvjaXnvjcKXv5xNk3iSWSjRGpVqXf,J3D8NHUJCiSjvFYfJ5Es4YDhF1KcPZWRUmCQ5L92t8eB,True,207276701,51819175,322445,161222,161223,3zqXX6kzhkbW3d4TwD2CNjMRwxTbREXySekvq37kfCNk,12897819,78191287,-65293468,622
2022-01-10 09:18:10-05:00,3065,CBL2NbekJrXvBiAcoj4fzQ4PfLDwTntW7Zt4nruHFYEw,59EvfgYTdKkfjUJz5LddLUAqbEdLaihcMzjcrTZsyzyS,True,15932,3983,24,12,12,DddJ7EWCmYEEZETCBNgAUSg81Ls6fZtiAaY5ekJ5sXx1,987,6234,-5247,619
2022-01-10 09:18:11-05:00,3066,8xQ3tsWVUe75EG1HmocULJ3kh52utveoFMEPotTGrKno,i3SKW3ywrwYucX9ySEx1C4zaUKGnzLerP3V38437NyV,True,76929516,19232377,120014,60007,60007,3zqXX6kzhkbW3d4TwD2CNjMRwxTbREXySekvq37kfCNk,4800569,35270393,-30469824,624
2022-01-10 09:18:11-05:00,3067,2jPxG5FL6D6XEJsRszJ9cmQ54AWSpZyPFSbn3DpWBSuM,3toQou4UVNvyWYvMvkuv379RVEF2aN2TzCpKKBUqeQV6,True,328861573,82215393,512074,256037,256037,72FwbpFGoLEazJEdpqNtPNefsadUrimUqma9wSoy4qiS,20482992,129012576,-108529584,622
2022-01-10 09:18:11-05:00,3068,7PzGZgzieFyyFs1dbajkNQgVxooFUNZrj1bUsQvrSwbp,A2gDREmSmJTBPPw3sbKVY3smC9wbHMDdv87gr4Tr2ES7,True,4843301,1210825,7578,3789,3789,4BnQKPLuE3DMTtxp8MjUBytgnhvxqq3ZTqZHTVZo4JJh,303138,1947829,-1644691,625
2022-01-10 09:18:20-05:00,3069,BZxJ6CtrVoiU86DMMieMeDFLNWtMpHGTvZfM7nyay6o4,6CRxRR8bisRLHFJBFWjyumYuy7j4C4PkjYH1K8gXhdWD,True,4885278,1221318,7642,3821,3821,DddJ7EWCmYEEZETCBNgAUSg81Ls6fZtiAaY5ekJ5sXx1,305687,1471699,-1166012,625
2022-01-10 09:18:22-05:00,3070,GqAS41YJssg9aaEp3hs3sG98APCsXhiQBQszXaSjZ2bN,2wodJ3AhrXdE1T4oVL95KvoBND7PubG5Wd5GWiLCMZJU,True,323460437,80865109,505337,252668,252669,4BnQKPLuE3DMTtxp8MjUBytgnhvxqq3ZTqZHTVZo4JJh,20213483,250212102,-229998619,624
2022-01-10 09:18:28-05:00,3071,HGJoZvLakWfSDFwuvShNBc4kCf7nP7VqzyM3mELpbFEf,12Qn5jin7QvsBngXqYAv4UstyG3b6nRf1jsLp9Dp8G7k,True,27617633,6904408,43159,21579,21580,4BnQKPLuE3DMTtxp8MjUBytgnhvxqq3ZTqZHTVZo4JJh,1726379,11647776,-9921397,625
2022-01-10 09:18:41-05:00,3072,BPsM1um9ZJf7eNoVMsQCRSwgARMuLCGGSDxf9tZeNeEy,BpzDdXfxVygiSYSmsHV6uPxQMeTFtrURMCCqhswQjd5X,True,2052292,513073,3201,1600,1601,DddJ7EWCmYEEZETCBNgAUSg81Ls6fZtiAaY5ekJ5sXx1,128076,745197,-617121,624
