ts,record_id,user_authority,user,partial,base_asset_value,base_asset_value_closed,liquidation_fee,fee_to_liquidator,fee_to_insurance_fund,liquidator,total_collateral,collateral,unrealized_pnl,margin_ratio
2022-01-22 09:15:25-05:00,8193,GjQQ2fQ7mrGjWZwjVYFUKp9NM1LmfkhEo675ovU5SPa8,ECgVUMRY5nB4MALs5drDyipF7YohCPuJpj2UegCs7HMn,True,156307,39076,243,121,122,3zqXX6kzhkbW3d4TwD2CNjMRwxTbREXySekvq37kfCNk,9734,139296,-129562,622
2022-01-22 09:32:04-05:00,8194,5NVD6QvomTAD35yNxSFZw4DhF2hCtV8drkbnGhBVtK5y,3JzkyPnREvoFZLL9JZuuDEnee3nuKcrqY3xLuXsmHwRo,True,413019,103254,645,322,323,3zqXX6kzhkbW3d4TwD2CNjMRwxTbREXySekvq37kfCNk,25823,404562,-378739,625
2022-01-22 09:32:08-05:00,8195,F9s8a7Cpiw5dw3a2aNFMofqwyDWNXvDLnSdJzoj1gRiV,GpKsQKJD79KBRWdCTkyi4zX7NaoCWsLUjrKxAwJB6o6s,True,206364,51591,321,160,161,HfEnetJ7uBSmZWCjBNxdvv9HEC5nsW4wDV7wu6WnhWan,12850,129107,-116257,622
2022-01-22 09:32:32-05:00,8196,EDSf2w1UyGvbgMuxyoXL58ifR1dviZinnLBYnFmgjcNG,DFenkzbL9SUjs9cSCaHJ1eXK75mHfk3GSPRFs8TSzrFV,True,107448452,26862113,167683,83841,83842,HfEnetJ7uBSmZWCjBNxdvv9HEC5nsW4wDV7wu6WnhWan,6707354,48573682,-41866328,624
2022-01-22 09:32:51-05:00,8197,3FF2rhr1RuT7UR7MmmGtrhfYbh6kbc5UXq51KmqFLZnq,AEmSYLt1dQ8suLugC4Lcw4kF3dG9GYcEfX54hEAKfmv5,True,1905630,476407,2970,1485,1485,3zqXX6kzhkbW3d4TwD2CNjMRwxTbREXySekvq37kfCNk,118814,1028305,-909491,623
2022-01-22 09:32:51-05:00,8198,2pKygdXJnjZBFfrZgDasmHQQgw8LgycmBBRuaoCU72cz,DXsomQ5yWw2ceZMbaCVsSaE4hKm9W6Gy785JG75Aaz18,True,1715696,428924,2684,1342,1342,HfEnetJ7uBSmZWCjBNxdvv9HEC5nsW4wDV7wu6WnhWan,107369,925225,-817856,625
2022-01-22 09:32:51-05:00,8199,GxFxvEUdWofneMmVvhCSScH9V6Zia5WJ2J9q6CpPnaq3,ATLykiHDii3Lw53MoZXwqu1FbBNPJbVNVGe2SoQMjVmY,True,31378,7844,49,24,25,HfEnetJ7uBSmZWCjBNxdvv9HEC5nsW4wDV7wu6WnhWan,1960,30779,-28819,624
2022-01-22 09:32:58-05:00,8200,8JtUn4uue4WzrySwnDQ74qzzWaKsoo11MbMvRh1ePDJN,8iahKConWg6fyZrkoze5eeujyNHA26AybYBpHwUr76Cu,True,21529884,5382471,33556,16778,16778,3zqXX6kzhkbW3d4TwD2CNjMRwxTbREXySekvq37kfCNk,1342275,13915104,-12572829,623
2022-01-22 09:33:03-05:00,8201,72woixtGAuGazCMfsYfYBYLP7FuRj8Fwz9fynFo4MCE4,5237BmWkKf58PBeTUEiu3Ld5uKXEe8wcrJRmCnUoWWku,True,6846076,1711519,10713,5356,5357,3zqXX6kzhkbW3d4TwD2CNjMRwxTbREXySekvq37kfCNk,428521,4197096,-3768575,625
2022-01-22 09:44:48-05:00,8202,BZn1DDE568UHeL2Qniv9EDT1yAAWvPJcTtSw4K4GQx44,CCaroU4YwKvYgibMsRPdEBxeDbzcNC4s5ZthxrhywSm5,True,6553315,1638328,10114,5057,5057,HfEnetJ7uBSmZWCjBNxdvv9HEC5nsW4wDV7wu6WnhWan,404561,5359716,-4955155,617
2022-01-22 09:44:48-05:00,8203,52hhBAuVyifMNFKGQmSitc8smiEgscXQMzVuZj55j7E5,6B5DBJx9NLytR3fkrYqe5W5ek4rUWsR4nPsRTvRfRwzC,True,108341284,27085321,167469,83734,83735,3zqXX6kzhkbW3d4TwD2CNjMRwxTbREXySekvq37kfCNk,6698772,92443234,-85744462,618
2022-01-22 09:44:48-05:00,8204,3EgUBHBeKWegibDcCsTGaGehnwHYvpMbcPaT1UTbwQ49,Hxd4dsnLD8uHnG7KR7GVmKXBcpN1egMUvoTccPvBcaYA,True,107640349,26910087,166823,83411,83412,HfEnetJ7uBSmZWCjBNxdvv9HEC5nsW4wDV7wu6WnhWan,6672946,91778475,-85105529,619
2022-01-22 09:44:48-05:00,8205,57Vsw8jXaaoLriYEkvPAVyq66r4a4zMfLWbDaTBMjFzC,7AVDWUTHa6729UkXgCXASphSmrLvXYGAA9ygTMSqvwvY,True,3215436,803859,4955,2477,2478,4BnQKPLuE3DMTtxp8MjUBytgnhvxqq3ZTqZHTVZo4JJh,198221,2751934,-2553713,616
2022-01-22 09:44:48-05:00,8206,Fs8MQLaMyr1Q96HsZivKLY7Kjdeu2ZoB2n3VTZ15KbSn,DREfCs5CTVNUUF8H3hD8CWvtxztiYxoLYh8HUWDecMyZ,True,101717292,25429323,157344,78672,78672,3zqXX6kzhkbW3d4TwD2CNjMRwxTbREXySekvq37kfCNk,6293784,86830066,-80536282,618
2022-01-22 09:44:54-05:00,8207,75NA5QiXEHG4caSB9BpafGZPA9eT9S6MhKTFM6eHjz8H,FmoxAVw2zdG6qbyaXKy6gsvi1XY8ZVbSgUNbjsp9EpVd,True,6704168,1676042,10384,5192,5192,3zqXX6kzhkbW3d4TwD2CNjMRwxTbREXySekvq37kfCNk,415383,5261924,-4846541,619
2022-01-22 09:44:54-05:00,8208,JCagxpXPs6wVRUWbNBPCZ4uLCkZsachnofN7SZEEwGwB,5uGj1TBCkc7FV4ffdBJg31yLcCxkQLxRExjcinnJUow9,True,1465398058,366349513,2289392,1144696,1144696,3zqXX6kzhkbW3d4TwD2CNjMRwxTbREXySekvq37kfCNk,91575718,1171830125,-1080254407,624
2022-01-22 09:44:55-05:00,8209,JDg1bbHkYeznDUtSBLhagRJ45aSzeSF5V8iDRJCay9wL,8n7ic28zq5PjJtRcM7Fcy5vLW2YVXw4EWMK6UAt2zh3V,True,73261302,18315325,113506,56753,56753,4BnQKPLuE3DMTtxp8MjUBytgnhvxqq3ZTqZHTVZo4JJh,4540260,60266061,-55725801,619
2022-01-22 09:44:57-05:00,8210,7A1v7bFDJwxM7XomePFyRh58SMHxrNSkM3fJygd8pQUN,DL9jCFHaM8BXJ5KE1YJHXNCbXgSdRgt18MHhAgC6TNmg,True,7848306,1962076,12206,6103,6103,HfEnetJ7uBSmZWCjBNxdvv9HEC5nsW4wDV7wu6WnhWan,488257,6157656,-5669399,622
2022-01-22 09:45:06-05:00,8211,7EtGovzHsbD8cKGqq4R5rvKBbncR4Kc7CDkTjof2QBMf,8ShjeNWM2vcvUF9yYztYCHUQfcGsyg2A1LyWiPbQDDvq,True,627216,156804,972,486,486,3zqXX6kzhkbW3d4TwD2CNjMRwxTbREXySekvq37kfCNk,38908,536581,-497673,620
2022-01-22 09:45:09-05:00,8212,HfwGSiwGiyDFaTS2usYRp82zSmPPQqZukbw2d1BuFs5w,ArtgZbmA33k8Y3EfR6oMJiqT72MUrVBQqifPBdcnrzea,True,1941168,485292,2993,1496,1497,HfEnetJ7uBSmZWCjBNxdvv9HEC5nsW4wDV7wu6WnhWan,119746,932978,-813232,616
2022-01-22 09:45:11-05:00,8213,3PPCwAjj8GNphb3cRs7kP1QVghEUX6gWUH3M4JarQsTD,28UR4WKAziiJmPwas5E5JrY3WaUrR2NkYYXCKuxPHTMR,True,867514781,216878695,1350017,675008,675009,3zqXX6kzhkbW3d4TwD2CNjMRwxTbREXySekvq37kfCNk,54000683,686352328,-632351645,622
2022-01-22 09:45:13-05:00,8214,FwTGq3BeMLyRFRa5r4E6nySLgoLNcNdqJsCQxA2i6uh6,88w6ti3WSriyu2FvNjVfrLpGyU5PUvaiJyqrAGPM8TKp,True,3115210,778802,4851,2425,2426,3zqXX6kzhkbW3d4TwD2CNjMRwxTbREXySekvq37kfCNk,194042,2665362,-2471320,622
2022-01-22 01:27:31-05:00,7191,DMgD2KCEhTGFLUZ5GnfNcwfiiwKYbyVpoWiN6knMkCAf,5KU2vgBkPTNVHsSULjgX7ZkZS56U3Dy3xqLTxL5sUZJ3,True,45216146,11304036,66620,33310,33310,3zqXX6kzhkbW3d4TwD2CNjMRwxTbREXySekvq37kfCNk,2664838,44440450,-41775612,589
2022-01-22 01:27:31-05:00,7192,HqYn1PU7foJ9daTJMbd19LjTqWR2vQ1XqMEmffM2kCFA,8o6U7rDTtzSvywjzENEZSDYxCf7XK85rueCYVM4vZjY1,False,17217505,17217505,850242,42512,807730,72FwbpFGoLEazJEdpqNtPNefsadUrimUqma9wSoy4qiS,850242,15872120,-15021878,493
2022-01-22 01:27:31-05:00,7193,6xbPoFjPYUcSejbTk5iiTZRWyZkicfkSzM1Fhbj3w9L5,7xTAbaXwhxxVY3TM88TLakPPwPyL4zT4TsVvtUvniVec,False,122254773,122254773,5481670,274083,5207587,HfEnetJ7uBSmZWCjBNxdvv9HEC5nsW4wDV7wu6WnhWan,5481670,42206980,-36725310,448
2022-01-22 01:27:31-05:00,7194,3g1debT8Z2efQPuMNSDPUNZzDqarBG2acErsZ4HP7QGA,42wDHagxr5Nno3mUx6kyYGDjwR98aedRbh3ByB468agB,False,795,795,26,1,25,72FwbpFGoLEazJEdpqNtPNefsadUrimUqma9wSoy4qiS,26,582,-556,327
2022-01-22 01:27:31-05:00,7195,BJaaH1SK1pF2kZQzmYpLFfDtm52CR9a5rd39RAPtLe8q,HUsT5FVxaisdnCvG1BQxX6zffjfL2Rwx5mMo5y8SDV7e,True,4339473,1084867,5999,2999,3000,72FwbpFGoLEazJEdpqNtPNefsadUrimUqma9wSoy4qiS,239961,2132026,-1892065,552
2022-01-22 01:27:31-05:00,7196,Go3ne58krEsFsZ5yu9EBT7od15VCYmtbs1KhumRMTiXS,HCvwQ7HjmmeDXrguZQPrAbJjcCJzHqVZK2JMSFkFDWfe,True,2835725,708931,4412,2206,2206,HfEnetJ7uBSmZWCjBNxdvv9HEC5nsW4wDV7wu6WnhWan,176482,2283920,-2107438,622
2022-01-22 01:27:32-05:00,7197,5yPGvUz6JWKjkViGwTCpygJii1rP2xv5yx146ULtBiYq,FMnHUCQWTf1UHu5qVFqUAsWh8aba9EQYTEoiXy55totD,True,153937363,38484340,224465,112232,112233,3zqXX6kzhkbW3d4TwD2CNjMRwxTbREXySekvq37kfCNk,8978630,61210358,-52231728,583
2022-01-22 01:27:32-05:00,7198,DAku12iueL13vRoTpKLyqdGaLQ2rWF6REe8Dr8soFvNs,H2vVH3LxkhGe6x6Mdwy67BYwTKNQM6XayKx7mhrwyfJM,False,14039,14039,689,34,655,3zqXX6kzhkbW3d4TwD2CNjMRwxTbREXySekvq37kfCNk,689,12025,-11336,490
2022-01-22 01:27:33-05:00,7199,6nJyqvFKprwaVCE1gAa2P4RHKc6Pa6XFSJymx654zZ9K,4e7iJmdwzAPxp1Zi8Azo38YyPQdPKqqY4VLJyQ5rpdYP,True,78952,19738,109,54,55,3zqXX6kzhkbW3d4TwD2CNjMRwxTbREXySekvq37kfCNk,4374,68321,-63947,554
2022-01-22 01:27:33-05:00,7200,FF8rqfM9PTEjYiVFy8jS81weDRwdaYooux2uSa2LexrJ,JBk1JghH1gged1YpDbkczFXP9ka5ivYSkaYoVbbXD4kg,True,5947185,1486796,8708,4354,4354,HfEnetJ7uBSmZWCjBNxdvv9HEC5nsW4wDV7wu6WnhWan,348326,4958924,-4610598,585
2022-01-22 01:27:33-05:00,7201,2WG1vzMHrYu1UdNjWccbzigwXaC3BcPqSmDTgHnEgSjz,26MRaqCvaK37n8YKepmVS76zSsqKj9CefJQSQFts5yno,True,325963747,81490936,439743,219871,219872,3zqXX6kzhkbW3d4TwD2CNjMRwxTbREXySekvq37kfCNk,17589746,277160527,-259570781,539
2022-01-22 01:27:33-05:00,7202,6xikA6d7sjCBnSfqkFwrL4nPrtQUNWdRhXB7i1AccnxC,G8t7u2R9qjRfdTdULs74v3nVrTM2WeKvc4dK4FFAvuG1,False,1178960,1178960,57587,2879,54708,3zqXX6kzhkbW3d4TwD2CNjMRwxTbREXySekvq37kfCNk,57587,599926,-542339,488
2022-01-22 01:27:33-05:00,7203,BPsM1um9ZJf7eNoVMsQCRSwgARMuLCGGSDxf9tZeNeEy,BpzDdXfxVygiSYSmsHV6uPxQMeTFtrURMCCqhswQjd5X,True,38222,9555,55,27,28,3zqXX6kzhkbW3d4TwD2CNjMRwxTbREXySekvq37kfCNk,2202,27403,-25201,576
2022-01-22 01:27:33-05:00,7204,7g4NJBHwDTRm58GqX7Tz1JzqwbAhF6EWJUQH3SoDxSf7,82Ypv7STZeSCBPf3HckWdyatELpvaDaWxFXhD5dNSML4,False,733,733,36,1,35,4BnQKPLuE3DMTtxp8MjUBytgnhvxqq3ZTqZHTVZo4JJh,36,550,-514,491
2022-01-22 01:27:36-05:00,7205,69byqtDPmgEY1NqKBCR95CEPVHRUxgbNW9Y4P4HjQ7ND,E47T4q4zMGzNL6vDxgWdLn3EQbW3WfVryr8Jsymy1hAL,True,13657338,3414334,21344,10672,10672,72FwbpFGoLEazJEdpqNtPNefsadUrimUqma9wSoy4qiS,853781,9441573,-8587792,625
2022-01-22 01:27:36-05:00,7206,BTouoY9doTYwX8wAa6QcZHzJjfZfEAtiLYR2JHKd5V8Z,H4ByqCdZy7AMx7VJZEwQwQmZLVA8vHg55C7ypwZwv67u,False,666978774,666978774,33069200,1653460,31415740,3zqXX6kzhkbW3d4TwD2CNjMRwxTbREXySekvq37kfCNk,33069200,326381275,-293312075,495
2022-01-22 01:27:38-05:00,7207,6dr65yANjSMmfBeKAuSxG3i16S9vMgF1CQ3zDyzh55Pn,EhrE5QpnshD41S4zPEBy2A5q2Gs2mwUrbHGo6WnT9zDP,False,10531,10531,521,26,495,3zqXX6kzhkbW3d4TwD2CNjMRwxTbREXySekvq37kfCNk,521,9022,-8501,494
2022-01-22 01:27:38-05:00,7208,Ck946unSEhqFVgSURskkU3J1yd2TqWbk3nYuZRTzohLb,6mbR3HfdmSK9deU7L64vDti4p9bVZkZgQsBCtPrD9BV,False,495168227,495168227,24700296,1235014,23465282,HfEnetJ7uBSmZWCjBNxdvv9HEC5nsW4wDV7wu6WnhWan,24700296,122261004,-97560708,498
2022-01-22 01:27:41-05:00,7209,woTXSsDkL9TQNxc3zwxSPagVijX7PE24bgKjvxexRwQ,A5M5EEPfDgvAxGLhpNgfn8AzPmyXxmPVgkEKnyoVzsz6,True,449988,112496,596,298,298,3zqXX6kzhkbW3d4TwD2CNjMRwxTbREXySekvq37kfCNk,23867,426073,-402206,530
2022-01-22 01:27:43-05:00,7210,E1CShgy7M9998q9jyzpnHZxHJR6z5hvnshUJt37kVPtG,96f1nYW4S9APCJS3TXTGSb9UcJDdxJuoBR3pLYqcNz2b,True,5601856,1400464,8134,4067,4067,3zqXX6kzhkbW3d4TwD2CNjMRwxTbREXySekvq37kfCNk,325396,4225561,-3900165,580
2022-01-22 01:27:44-05:00,7211,7E3Zc3g1eJ7ueosPPoHDSkhuHvBVfN41eXcJXWeffozU,CGA8dcsZjfLqSYijYmssZwd9TXAsvSafNVT6JvUajGdu,True,100839270,25209817,136881,68440,68441,72FwbpFGoLEazJEdpqNtPNefsadUrimUqma9wSoy4qiS,5475262,90872769,-85397507,542
2022-01-22 01:27:44-05:00,7212,EFHg5FatMRRSZnKJPJF9e1iw2cjPJRmwTTZYtkHno9DP,84LnLKhZDJgWFnbBYnYjqWkjymemXfidecPFwnUAvuFj,False,67829932,67829932,3371773,168588,3203185,HfEnetJ7uBSmZWCjBNxdvv9HEC5nsW4wDV7wu6WnhWan,3371773,44488003,-41116230,497
2022-01-22 01:27:44-05:00,7213,DdAPWdHnb7ocaYtcwwwYnppsH39sZpmzMyANeoJbCV7s,3BVmC39L8dEypPN1BZhsf9bx9Ge2sXCZR8Y6RH4eBNMJ,True,33338995,8334748,45011,22505,22506,4BnQKPLuE3DMTtxp8MjUBytgnhvxqq3ZTqZHTVZo4JJh,1800443,37694704,-35894261,540
2022-01-22 01:27:44-05:00,7214,B4Uc39nKzz9wBRQsCkMR4A7RwTJ8rSuwpR6EQn2AesRb,H49bGZgatRZVpj6QufZRVgYrQtH7LpdbiqKBs23151m,True,820258,205064,1201,600,601,3zqXX6kzhkbW3d4TwD2CNjMRwxTbREXySekvq37kfCNk,48045,1100891,-1052846,585
2022-01-22 01:27:45-05:00,7215,EAUFD16wab8qRMJ4H6updHGt4xFqgRCDeRHVCsLCTSTL,8vkfYSyCyBY9g4TZrp52jUcQj6udy9xAaA4fioRE2RXx,True,4954649385,1238662346,7653060,3826530,3826530,4BnQKPLuE3DMTtxp8MjUBytgnhvxqq3ZTqZHTVZo4JJh,306122401,1902405272,-1596282871,617
2022-01-22 01:27:46-05:00,7216,3EmGvYu72cR4Ta3wLA5HKZBEqgfChCyiRanwj5hGLJXc,6NEWPFaKi5uLsrj4n6RM1DBhQTcGFE9TwYeJ12pC7yyp,True,1257,314,1,0,1,HfEnetJ7uBSmZWCjBNxdvv9HEC5nsW4wDV7wu6WnhWan,72,940,-868,572
2022-01-22 01:27:46-05:00,7217,D6qMab7uevXTa89ssv4BRyHwrw3FYpNimAmX2VH2uf4B,8ZauZ5dAp7kyawkPdxi4mqfempFHubJebfBenQdDektD,True,4526350,1131587,7049,3524,3525,4BnQKPLuE3DMTtxp8MjUBytgnhvxqq3ZTqZHTVZo4JJh,281962,3645143,-3363181,622
2022-01-22 01:27:46-05:00,7218,HoJ3Re4BmCYKMJx2RUYtoHfg8ncEy3iFqvWJDGKqfMBV,2qg4FMcurNDVRzXYKwpzEYapxFECnAyU2oGmxQCSf3hf,True,6814433,1703608,10587,5293,5294,4BnQKPLuE3DMTtxp8MjUBytgnhvxqq3ZTqZHTVZo4JJh,423485,5492114,-5068629,621
2022-01-22 01:27:46-05:00,7219,84SgzR8J6DeqPJ1uXphP1BHMotYGKh3kS4owMMj9x58x,CL7Jkwe3NK4qaAVK2QjuftXnQ5YLqDT9qYeeEi7kJXrV,True,11948142765,2987035691,15323328,7661664,7661664,3zqXX6kzhkbW3d4TwD2CNjMRwxTbREXySekvq37kfCNk,612933136,10392178591,-9779245455,512
2022-01-22 01:27:46-05:00,7220,HVZkXeDR3mc8oB9qFFwCK4RXpPojdcHk9tRGep6xtKGK,Bh3py7awPejWqeTMxtAgF7mPotL2Asxf8YrYJykq9nBt,True,208891,52222,292,146,146,72FwbpFGoLEazJEdpqNtPNefsadUrimUqma9wSoy4qiS,11703,159605,-147902,560
2022-01-22 01:27:46-05:00,7221,6gFbxvPafnpqZjWW94MMmL8mGp2FHZGqoJC5fWqgwNxS,C6WcDycp3Ff3xYmb81i8JbD39Xv1o5G2AdtPs1FdXtr4,False,72438914,72438914,3357515,167875,3189640,3zqXX6kzhkbW3d4TwD2CNjMRwxTbREXySekvq37kfCNk,3357515,32276249,-28918734,463
2022-01-22 01:27:46-05:00,7222,51yPLtXTgL9oLKs1cCf5TjL54Ld5vuVxat2NNtwZVsZG,7UjtM7Z1tiXEQMMiorQyncgi9SKu3v46DhVdgXbWqSiF,True,11230706,2807676,15078,7539,7539,HfEnetJ7uBSmZWCjBNxdvv9HEC5nsW4wDV7wu6WnhWan,603146,14471515,-13868369,537
2022-01-22 01:27:47-05:00,7223,BXMMFy2k9b2hVBEG6RyXAq3qqXxJ7EY2xhyPZqtLvBiU,KpoZwr4ZFTHJgebbf4tcjT9iKvpC1EF8Aw4uaVPxXNd,True,2052696,513174,2803,1401,1402,72FwbpFGoLEazJEdpqNtPNefsadUrimUqma9wSoy4qiS,112135,727342,-615207,546
2022-01-22 01:27:47-05:00,7224,3HUAjpBLM9XnT5W8p7asjjh1s8GDBzHL55AbsvBPsZ2e,6g6azPhma25H5q8HEATFAcXKg7UokmzPXzXDBr7QKbTL,True,4575600,1143900,5884,2942,2942,72FwbpFGoLEazJEdpqNtPNefsadUrimUqma9wSoy4qiS,235373,3731441,-3496068,514
2022-01-22 01:27:47-05:00,7225,921FBgLS3A1wA77uWitsnTvW737Q2jY7tzvgWtWLXNC7,E4eJ9H7cqP9zNpMH5xRBTAp9yaBCBihuJBNd6pqzteDG,False,4611,4611,215,10,205,HfEnetJ7uBSmZWCjBNxdvv9HEC5nsW4wDV7wu6WnhWan,215,3050,-2835,466
2022-01-22 01:27:48-05:00,7226,9k5YHTFCHczFg6KAZXf2ostkFLH7WdVAxiA9zCGRprg3,2b52r1TA8dkJsnuMuM9cNfGxKEynd42WjQUuzcQTRcD9,False,2006,2006,95,4,91,72FwbpFGoLEazJEdpqNtPNefsadUrimUqma9wSoy4qiS,95,1501,-1406,473
2022-01-22 01:27:48-05:00,7227,5PVUmELKMD7mf2vbXbiXXsiZW2myGmZuMe757raBAj8Y,5eikdsebvyBh27aPz9t9KPswYWd8X4Cbk2TSiif6vn36,False,296680670,296680670,14841320,742066,14099254,4BnQKPLuE3DMTtxp8MjUBytgnhvxqq3ZTqZHTVZo4JJh,14841320,264869775,-250028455,500
2022-01-22 01:27:58-05:00,7228,GM22yjVoBCzgBcVTT5EcgRhVWiXVV82kSj1dPCbegKWj,CDDy8JmJMwJyx1YAvEPpj8AYxCpngRovf3wWfVzao5Rc,True,4888805,1222201,7637,3818,3819,72FwbpFGoLEazJEdpqNtPNefsadUrimUqma9wSoy4qiS,305498,1740603,-1435105,624
2022-01-22 01:27:58-05:00,7229,7dmoK7QPki7R66SPQST4veUgVfnJbVToxxBPZveECiwK,4vh4REBDm5zBDmcjRCD9zNsny1HGneu7B2co4dSJNLL6,True,26136448,6534111,40854,20427,20427,72FwbpFGoLEazJEdpqNtPNefsadUrimUqma9wSoy4qiS,1634188,19302841,-17668653,625
2022-01-22 01:27:59-05:00,7230,DiPSJvnnEwg1En7HJfEsKrUbBgtUf4KzGMyMCZDQSYgp,s8UVC6vPBofuXUS6RW1aQmZ8C35PrC5r4A6ugmvzLGB,True,45939,11484,71,35,36,72FwbpFGoLEazJEdpqNtPNefsadUrimUqma9wSoy4qiS,2857,27082,-24225,621
2022-01-22 01:28:13-05:00,7231,3oCun4gm3k8sXxVxiYM8okGi8iCXH9LvDkHf9PBQWYXR,E1np1dZ7jUm811ddvy1jQerBwGSYb5BbZWnUHeotvrfH,True,25525850,6381462,39868,19934,19934,4BnQKPLuE3DMTtxp8MjUBytgnhvxqq3ZTqZHTVZo4JJh,1594743,6353904,-4759161,624
2022-01-22 01:30:26-05:00,7232,EDSf2w1UyGvbgMuxyoXL58ifR1dviZinnLBYnFmgjcNG,DFenkzbL9SUjs9cSCaHJ1eXK75mHfk3GSPRFs8TSzrFV,True,366917226,91729306,565014,282507,282507,4BnQKPLuE3DMTtxp8MjUBytgnhvxqq3ZTqZHTVZo4JJh,22600597,127582236,-104981639,615
2022-01-22 01:30:57-05:00,7233,4ne6vC7qdxQYHJCsaeFAKZrKdFt2SwXGHQ3jrMHqt4DL,Cf1dLHY2WXH9rXbRKq5TT8THbdo9SdNUZq4rYhRCF9z,True,5946743,1486685,9211,4605,4606,4BnQKPLuE3DMTtxp8MjUBytgnhvxqq3ZTqZHTVZo4JJh,368467,2679595,-2311128,619
2022-01-22 01:40:58-05:00,7234,F9s8a7Cpiw5dw3a2aNFMofqwyDWNXvDLnSdJzoj1gRiV,GpKsQKJD79KBRWdCTkyi4zX7NaoCWsLUjrKxAwJB6o6s,True,951374,237843,1473,736,737,3zqXX6kzhkbW3d4TwD2CNjMRwxTbREXySekvq37kfCNk,58947,467073,-408126,619
2022-01-22 01:40:59-05:00,7235,5NVD6QvomTAD35yNxSFZw4DhF2hCtV8drkbnGhBVtK5y,3JzkyPnREvoFZLL9JZuuDEnee3nuKcrqY3xLuXsmHwRo,True,1903164,475791,2945,1472,1473,HfEnetJ7uBSmZWCjBNxdvv9HEC5nsW4wDV7wu6WnhWan,117825,1551099,-1433274,619
2022-01-22 01:41:00-05:00,7236,GjQQ2fQ7mrGjWZwjVYFUKp9NM1LmfkhEo675ovU5SPa8,ECgVUMRY5nB4MALs5drDyipF7YohCPuJpj2UegCs7HMn,True,719873,179968,1109,554,555,3uL2NSR2ZdDqCiKfzA5SwwpddAnit22DBJo6uvvz1rRs,44382,529144,-484762,616
2022-01-22 01:41:01-05:00,7237,3FF2rhr1RuT7UR7MmmGtrhfYbh6kbc5UXq51KmqFLZnq,AEmSYLt1dQ8suLugC4Lcw4kF3dG9GYcEfX54hEAKfmv5,True,8799438,2199859,13757,6878,6879,4BnQKPLuE3DMTtxp8MjUBytgnhvxqq3ZTqZHTVZo4JJh,550301,3613741,-3063440,625
2022-01-22 01:42:08-05:00,7238,2pKygdXJnjZBFfrZgDasmHQQgw8LgycmBBRuaoCU72cz,DXsomQ5yWw2ceZMbaCVsSaE4hKm9W6Gy785JG75Aaz18,True,7919059,1979764,12333,6166,6167,3zqXX6kzhkbW3d4TwD2CNjMRwxTbREXySekvq37kfCNk,493349,3250642,-2757293,622
2022-01-22 01:42:12-05:00,7239,GxFxvEUdWofneMmVvhCSScH9V6Zia5WJ2J9q6CpPnaq3,ATLykiHDii3Lw53MoZXwqu1FbBNPJbVNVGe2SoQMjVmY,True,144821,36205,225,112,113,3zqXX6kzhkbW3d4TwD2CNjMRwxTbREXySekvq37kfCNk,9015,117840,-108825,622
2022-01-22 01:43:53-05:00,7240,442usWu6XpJZvU25bqXeynRrQ15jAzWwU9DWMgHpTn3Q,CtvADKp39bjJf3cPKWNL3wxnhq273fVM4fC5DmEcg5cC,True,2463122047,615780511,3767625,1883812,1883813,HfEnetJ7uBSmZWCjBNxdvv9HEC5nsW4wDV7wu6WnhWan,150705026,919001146,-768296120,611
2022-01-22 01:44:37-05:00,7241,CmvNNpdGVDGujBadaMmgKc8xgFfyV6G9PNEjD8zEND6L,EzmfinKBZ8TXoSugyTqdEdHWrHdTdpHQtc1TApfaNfDR,True,3956965413,989241353,6171611,3085805,3085806,3zqXX6kzhkbW3d4TwD2CNjMRwxTbREXySekvq37kfCNk,246864479,2621422361,-2374557882,623
2022-01-22 01:44:39-05:00,7242,2r64Rnbu3ZjmJTHHUxxV9TWWGzwpAepA4ySbtKivBXCj,6RRzx6KLkMiFK9JSuznrSJGiPgkHwatBSskudHqbfKJ5,True,645451865,161362965,1007005,503502,503503,HfEnetJ7uBSmZWCjBNxdvv9HEC5nsW4wDV7wu6WnhWan,40280202,345110784,-304830582,624
2022-01-22 01:44:43-05:00,7243,8JtUn4uue4WzrySwnDQ74qzzWaKsoo11MbMvRh1ePDJN,8iahKConWg6fyZrkoze5eeujyNHA26AybYBpHwUr76Cu,True,99061606,24765401,150413,75206,75207,3zqXX6kzhkbW3d4TwD2CNjMRwxTbREXySekvq37kfCNk,6016526,50662800,-44646274,607
2022-01-22 01:50:51-05:00,7244,6qDAr9rGtFMeiTx9KfAeu3WBqiZzRzEtMfipFaZ2gQiJ,MGfCsHXhA5C6S28qKoQjeZmn28dehGUJ4MLSaic7CfB,False,2298548115,2298548115,106317966,5315898,101002068,HfEnetJ7uBSmZWCjBNxdvv9HEC5nsW4wDV7wu6WnhWan,106317966,620404996,-514087030,462
2022-01-22 01:50:51-05:00,7245,Gbxc51WERLLeCtiHv7rDvE52aqF541RoQWG5n5aqErq6,4ngBoHbfXijLMqGKxFMNht9sbmxy2g5eqBmn8QsBmbx1,True,44171001,11042749,65125,32562,32563,HfEnetJ7uBSmZWCjBNxdvv9HEC5nsW4wDV7wu6WnhWan,2605000,14790778,-12185778,589
2022-01-22 01:50:52-05:00,7246,8ZBphuKHLmv5jNURAunz6pFb3zyyCePKoToEXefPhDYC,GiQaHVaAxgf6jrUquKHjext6AXk3Vo5KKejhb3iGoc8H,False,173289969,173289969,8581181,429059,8152122,3zqXX6kzhkbW3d4TwD2CNjMRwxTbREXySekvq37kfCNk,8581181,60293758,-51712577,495
2022-01-22 01:50:52-05:00,7247,6pXjgzpAPSjchUHoPqsZduviYV95SBHNk5CRCNjGAJZw,26Zjv9SkvUmwQAQT9Ls6k1wdKECrkhBrDUDrntpHfPEu,True,434609586,108652396,567333,283666,283667,3zqXX6kzhkbW3d4TwD2CNjMRwxTbREXySekvq37kfCNk,22693346,98023760,-75330414,522
2022-01-22 01:55:21-05:00,7248,AvwHizRhHUSahmvSg4jmTUErc7vAFSmkRAEsiKhXfW1m,3UrWYx8y9N5o9GYneSe6zyyHRTZzxwvcipQfHHYh7tEs,True,86087,21521,130,65,65,3zqXX6kzhkbW3d4TwD2CNjMRwxTbREXySekvq37kfCNk,5201,60005,-54804,604
2022-01-22 01:55:21-05:00,7249,3c4tj9J8QwB3exFchWei43nBh5xsYRZxEUfayi3JvYgm,Fyw1TEEDKhLFo16qxDsttsAwSkrfzpDe8Dmm3atEeXyN,True,13448184,3362046,20004,10002,10002,3zqXX6kzhkbW3d4TwD2CNjMRwxTbREXySekvq37kfCNk,800195,9497330,-8697135,595
2022-01-22 01:55:21-05:00,7250,2sPD4f4d3CCeFSwSC5vAGS3YoTsTGypYKfDeoJczebop,HWCRpcq2sXqJL7Vi8MtipQDwGSViE73bUxS36ETmvnP2,True,5995062,1498765,8953,4476,4477,4BnQKPLuE3DMTtxp8MjUBytgnhvxqq3ZTqZHTVZo4JJh,358153,2562527,-2204374,597
2022-01-22 01:55:21-05:00,7251,4xn9vTtLZyNtCbBLLpcXUMWU8AnnZCov9rJaY6rew16T,5UNWdFw2CP44qS8oc4uPt8zxw6zFg8oXz8SUCedZLLEC,True,1060695,265173,1467,733,734,3zqXX6kzhkbW3d4TwD2CNjMRwxTbREXySekvq37kfCNk,58697,497709,-439012,553
2022-01-22 01:55:21-05:00,7252,4hZG7dM716SxDagiFGwt1gSC99B2QK1emGLV9TJmmuR8,7vjfUWySkyx4Z5qAaRr2VWnVvxHHNsvPj1PirGNSjM6,True,8402100298,2100525074,11224770,5612385,5612385,3zqXX6kzhkbW3d4TwD2CNjMRwxTbREXySekvq37kfCNk,448990832,3932633508,-3483642676,534
2022-01-22 01:55:21-05:00,7253,GBpe8E33cNkFmMUuP3WjhDBBuQz7MHaDkpCJjGFaFkvu,3QYFKkgzZ1PKKAxCh4hMhgqrupoCcfRVkjuJZRWVZo3H,True,24984984,6246245,36544,18272,18272,HfEnetJ7uBSmZWCjBNxdvv9HEC5nsW4wDV7wu6WnhWan,1461767,11238474,-9776707,585
2022-01-22 01:55:22-05:00,7254,D7XummfEc3NTK4qMvZegV3FrYuqc8mNgnQu3ujwemZtg,HHiRcecqzW7sGFTio7Ph6TYv3dGt64KWv4DEKgKm84fQ,True,249441,62360,331,165,166,3zqXX6kzhkbW3d4TwD2CNjMRwxTbREXySekvq37kfCNk,13268,207410,-194142,531
2022-01-22 01:55:22-05:00,7255,HELPNUwAqTX7gfHS4cnJnqXFM6Rb156tYcpsitKR9iDu,3RdfgDvLvsdZG5Cf6hKiKMQMqfidyxHzjYvUx1FZpeHQ,True,14726190,3681547,22015,11007,11008,4BnQKPLuE3DMTtxp8MjUBytgnhvxqq3ZTqZHTVZo4JJh,880602,14306361,-13425759,597
2022-01-22 01:55:22-05:00,7256,4SQQdHTJUDv8taPXQRvEVJpUu91iCWQsv9su8tfehaQG,33CJXj1pmmatAofRvgt5in9E6SLEuy7tq4jqSwnUWP2A,True,943109108,235777277,1456623,728311,728312,3zqXX6kzhkbW3d4TwD2CNjMRwxTbREXySekvq37kfCNk,58264945,850092121,-791827176,617
2022-01-22 01:55:23-05:00,7257,C1rjefgArnN3nBn5Wu3yXij2wAyGWFtWdjGNLR9vpjmj,GsLCESLzYGZ1brEh8RJrZttE7hxcpSq7iUqdhwJhnDVB,True,5544057,1386014,7972,3986,3986,3zqXX6kzhkbW3d4TwD2CNjMRwxTbREXySekvq37kfCNk,318917,3760012,-3441095,575
2022-01-22 01:55:24-05:00,7258,72woixtGAuGazCMfsYfYBYLP7FuRj8Fwz9fynFo4MCE4,5237BmWkKf58PBeTUEiu3Ld5uKXEe8wcrJRmCnUoWWku,True,31068265,7767066,39637,19818,19819,4BnQKPLuE3DMTtxp8MjUBytgnhvxqq3ZTqZHTVZo4JJh,1585481,15247191,-13661710,510
2022-01-22 01:55:26-05:00,7259,DC4UVUDFWL3gVtgkX9hPtFgtxaA8DH5p94i4k9U3wyWv,3HCWqVvQQfRgSKitsTjGTduJ82ointZUSNtj13uea4kD,True,58484621,14621155,86603,43301,43302,3zqXX6kzhkbW3d4TwD2CNjMRwxTbREXySekvq37kfCNk,3464158,39753849,-36289691,592
2022-01-22 01:55:26-05:00,7260,FV3G5EsSmyiLAAoREhgDXwvzbxoyDeq4Mwfj4jK5fJ7U,5nhzbJmm5JAwGDpTZoenkM1u3XtMY4uN7Qsm3vFGtRJE,True,2752831,688207,3923,1961,1962,3zqXX6kzhkbW3d4TwD2CNjMRwxTbREXySekvq37kfCNk,156942,1210919,-1053977,570
2022-01-22 01:55:32-05:00,7261,DvuRmJkfn6FQczUKgYeaSCqwy2NTMunuAKNrnmxMvnzS,7LpWTX9dgBtW75kfEoB5WuNsDwEdw5s8CYSHh3J4qagM,True,2828952,707238,4025,2012,2013,3zqXX6kzhkbW3d4TwD2CNjMRwxTbREXySekvq37kfCNk,161033,2375038,-2214005,569
2022-01-22 01:56:46-05:00,7262,FuoFPNTdYVDkSHaBac6UC1aNJXafSNTvFJuBCdrgQQrH,ApBS1Fx83tcECMzDV6wEzEzEdg4e2hgj3djtjRUoSKK5,True,134246534,33561632,208214,104107,104107,3zqXX6kzhkbW3d4TwD2CNjMRwxTbREXySekvq37kfCNk,8328574,79617747,-71289173,620
2022-01-22 01:57:30-05:00,7263,2pKygdXJnjZBFfrZgDasmHQQgw8LgycmBBRuaoCU72cz,DXsomQ5yWw2ceZMbaCVsSaE4hKm9W6Gy785JG75Aaz18,True,5822158,1455539,9096,4548,4548,3zqXX6kzhkbW3d4TwD2CNjMRwxTbREXySekvq37kfCNk,363879,2548988,-2185109,624
2022-01-22 01:57:30-05:00,7264,GjQQ2fQ7mrGjWZwjVYFUKp9NM1LmfkhEo675ovU5SPa8,ECgVUMRY5nB4MALs5drDyipF7YohCPuJpj2UegCs7HMn,True,529033,132258,810,405,405,3zqXX6kzhkbW3d4TwD2CNjMRwxTbREXySekvq37kfCNk,32401,406845,-374444,612
2022-01-22 01:57:31-05:00,7265,3FF2rhr1RuT7UR7MmmGtrhfYbh6kbc5UXq51KmqFLZnq,AEmSYLt1dQ8suLugC4Lcw4kF3dG9GYcEfX54hEAKfmv5,True,6466691,1616672,10091,5045,5046,3zqXX6kzhkbW3d4TwD2CNjMRwxTbREXySekvq37kfCNk,403656,2834126,-2430470,624
2022-01-22 01:57:33-05:00,7266,5NVD6QvomTAD35yNxSFZw4DhF2hCtV8drkbnGhBVtK5y,3JzkyPnREvoFZLL9JZuuDEnee3nuKcrqY3xLuXsmHwRo,True,1398631,349657,2153,1076,1077,3zqXX6kzhkbW3d4TwD2CNjMRwxTbREXySekvq37kfCNk,86138,1189836,-1103698,615
2022-01-22 01:57:33-05:00,7267,GxFxvEUdWofneMmVvhCSScH9V6Zia5WJ2J9q6CpPnaq3,ATLykiHDii3Lw53MoZXwqu1FbBNPJbVNVGe2SoQMjVmY,True,106474,26618,166,83,83,3zqXX6kzhkbW3d4TwD2CNjMRwxTbREXySekvq37kfCNk,6648,90410,-83762,624
2022-01-22 01:57:33-05:00,7268,F9s8a7Cpiw5dw3a2aNFMofqwyDWNXvDLnSdJzoj1gRiV,GpKsQKJD79KBRWdCTkyi4zX7NaoCWsLUjrKxAwJB6o6s,True,699163,174790,1077,538,539,3zqXX6kzhkbW3d4TwD2CNjMRwxTbREXySekvq37kfCNk,43106,363569,-320463,616
2022-01-22 01:57:34-05:00,7269,8WHDaiE6LqFFmCVMnPeLEQ99R6ft8b74UfmP9BqzjcE8,CGmoDGsdnjo3zMNrW78n2xxQr1aDPAiBYiXbyciLXYMu,True,53819950,13454986,84088,42044,42044,3zqXX6kzhkbW3d4TwD2CNjMRwxTbREXySekvq37kfCNk,3363533,31168805,-27805272,624
2022-01-22 01:58:33-05:00,7270,BCGTaPQxGEMjD7xUxwfwmVVYJ9CEGH33yJRi3QjwyiLE,JBct1cZ9a959UKwABBEefwxZnGTAAGLzyUdXrXqGGCZd,True,215810526,53952631,289430,144715,144715,3zqXX6kzhkbW3d4TwD2CNjMRwxTbREXySekvq37kfCNk,11577231,120805133,-109227902,536
2022-01-22 01:58:37-05:00,7271,9aQrdyfAvcBbBj7iKQB17eAS4zBqymdd3kzkTkuRhdLU,BDHhukMF5rALuSwCxaw8g73m2MN4oX1D4e7uNmx3SiVt,True,117000139,29250034,178297,89148,89149,4BnQKPLuE3DMTtxp8MjUBytgnhvxqq3ZTqZHTVZo4JJh,7131919,37681405,-30549486,609
2022-01-22 01:58:37-05:00,7272,Br1j5Ftafei7ysu5SmqVZSoRe4uS4qCPeKSPHg55pyiE,G8fc7QvXjfkgBFvAVUgJFQS3VaF1biL9rktBExGa87Ks,True,310362646,77590660,474983,237491,237492,HfEnetJ7uBSmZWCjBNxdvv9HEC5nsW4wDV7wu6WnhWan,18999347,194578944,-175579597,612
2022-01-22 01:58:37-05:00,7273,EF6H6aW1p3qcAtiLFU9rbFYfsKfD683meHXDw8hLdaZK,8vfJbpnK7SQcjpEBCzZJRW8JosNbsmTeJ2YXZCbM225c,True,26203579,6550894,39887,19943,19944,4BnQKPLuE3DMTtxp8MjUBytgnhvxqq3ZTqZHTVZo4JJh,1595509,13664775,-12069266,608
2022-01-22 02:00:16-05:00,7274,9psSuFHBGqCvcgNMc7aTMhKMMFwBDmW7v5Wkn22KtTHj,7zi9LSfuEhXccQXSRukRRwgQUaiQVVgfsGaRYLP2JvwB,True,1468803602,367200900,2160837,1080418,1080419,3zqXX6kzhkbW3d4TwD2CNjMRwxTbREXySekvq37kfCNk,86433501,492309232,-405875731,588
2022-01-22 02:00:16-05:00,7275,4ytoBUwuhAL4YYSCa6AgwrpeVF4eeU8H9NfDxMPZKxPo,Pby2szzsxDrXt4gnbmmaMccXxctZALr8miRtKhGKjsD,True,4941018,1235254,7284,3642,3642,HfEnetJ7uBSmZWCjBNxdvv9HEC5nsW4wDV7wu6WnhWan,291382,2690268,-2398886,589
2022-01-22 02:01:08-05:00,7276,442usWu6XpJZvU25bqXeynRrQ15jAzWwU9DWMgHpTn3Q,CtvADKp39bjJf3cPKWNL3wxnhq273fVM4fC5DmEcg5cC,True,1807756521,451939130,2679640,1339820,1339820,3zqXX6kzhkbW3d4TwD2CNjMRwxTbREXySekvq37kfCNk,107185624,723111033,-615925409,592
2022-01-22 02:01:08-05:00,7277,Dv1BABsN7amhjmGBpMQsnMkRLx7MuCVwsnuyTQeZ6uum,BCjscxVo1h16teND6KKiAUy1ftNGTMy1vEEEyAW4ttVG,True,8200445,2050111,12325,6162,6163,4BnQKPLuE3DMTtxp8MjUBytgnhvxqq3ZTqZHTVZo4JJh,493018,2501958,-2008940,601
2022-01-22 02:01:15-05:00,7278,CCP5P6U4xBjea3snWgwBb5rtaounEAsNHpWzTUeNtVf9,GE2Bxc837ybP7sNR487U4bVbx68qyX2HtwPBLfEd4BDj,True,380510157,95127539,572773,286386,286387,4BnQKPLuE3DMTtxp8MjUBytgnhvxqq3ZTqZHTVZo4JJh,22910951,127833361,-104922410,602
2022-01-22 02:01:15-05:00,7279,E5biUzKn2s5frKseCmfWriWjrYMGVtmLrhR9nYhAkVvR,BDHzqefisuGoMGcpML8t6KAC7rcErvhLcfV8KQC7oHAH,True,24006217,6001554,37429,18714,18715,3zqXX6kzhkbW3d4TwD2CNjMRwxTbREXySekvq37kfCNk,1497170,9505185,-8008015,623
2022-01-22 02:01:15-05:00,7280,GXfjQr2ihTfLRys1DMetVGocd1sU97KdoCJ6x4HxdW1U,9GHvjJJXjbVz5D3RBfP3njcdRRXnFsXZ68jFa2LiGwsy,True,97040636,24260159,145558,72779,72779,HfEnetJ7uBSmZWCjBNxdvv9HEC5nsW4wDV7wu6WnhWan,5822323,50725487,-44903164,599
2022-01-22 02:01:17-05:00,7281,BCGTaPQxGEMjD7xUxwfwmVVYJ9CEGH33yJRi3QjwyiLE,JBct1cZ9a959UKwABBEefwxZnGTAAGLzyUdXrXqGGCZd,True,160324760,40081189,242863,121431,121432,3zqXX6kzhkbW3d4TwD2CNjMRwxTbREXySekvq37kfCNk,9714535,93169236,-83454701,605
2022-01-22 02:01:17-05:00,7282,BH36ueAULprzjj6WabTgvivEcrx3VdDn8DTxSoro8Zym,6yydJKEmtZjUwURrs9gQ7EGkB86nK28ZDJQqNMgbPosA,True,396800930,99200232,617013,308506,308507,HfEnetJ7uBSmZWCjBNxdvv9HEC5nsW4wDV7wu6WnhWan,24680540,172038615,-147358075,621
2022-01-22 02:01:17-05:00,7283,BHpLpoGQ27T6Q4CT8H4dzqS8KF8Vj5rqmqfcodoBzpgR,Akn3tG2hQBfBVtNYCeXchfzfcsyCuSpkGpFoMLEKwcBF,True,6136531,1534132,9232,4616,4616,3zqXX6kzhkbW3d4TwD2CNjMRwxTbREXySekvq37kfCNk,369311,3366942,-2997631,601
2022-01-22 02:01:22-05:00,7284,46TNhGwBVzedW8xSb9UY94HNeSom9iGiZzAjrKHiRM2G,7JVTiqNYeKHbyzRkKtvSEpqLPKykZso8cGUr3sX1j7QF,True,6433192,1608298,9824,4912,4912,4BnQKPLuE3DMTtxp8MjUBytgnhvxqq3ZTqZHTVZo4JJh,392969,3724162,-3331193,610
2022-01-22 02:07:15-05:00,7285,3662SX3YSARYupcxpgtTvUAPUsU7aJKsGxvpkNC1AV1A,HkAb86jdGHbz6VxrtbA81jPvjhiNHhbe82NBPFxnwzE5,True,41967566,10491891,64899,32449,32450,HfEnetJ7uBSmZWCjBNxdvv9HEC5nsW4wDV7wu6WnhWan,2595988,9028422,-6432434,618
2022-01-22 02:07:17-05:00,7286,Dn916KSmX3HqxT53hrxrbCrV3tdRMCPdaoiRLqetMrth,ATCXRiXgnjRRUbSTPBvtBXMENCqsViexSZbZ6aDaXXWA,True,50015078,12503768,75956,37978,37978,3zqXX6kzhkbW3d4TwD2CNjMRwxTbREXySekvq37kfCNk,3038268,14871315,-11833047,607
2022-01-22 02:07:19-05:00,7287,BjCNaM7YbE9SjFi7tzi4677zg1fKXGJwtecz2GWwWuhd,6rNsSrKZezQrLb2whToNjnizpnurDXrobHqfEK3QqU1M,True,3028701578,757175394,4698678,2349339,2349339,3zqXX6kzhkbW3d4TwD2CNjMRwxTbREXySekvq37kfCNk,187947144,1132532704,-944585560,620
2022-01-22 02:07:22-05:00,7288,DRVtEzZs9u9ysrcANZLEjrvbuuGqYn77v2h4cDFKuNUx,Fv9qiMZhuSBL2cs9AWUYbDLQjB46W2ZwrhxaNXtPLDpC,True,5416346,1354086,8435,4217,4218,3zqXX6kzhkbW3d4TwD2CNjMRwxTbREXySekvq37kfCNk,337412,1744126,-1406714,622
2022-01-22 02:07:22-05:00,7289,EXP61AETWHw3kHSjrJH1jQBt6cXR9Zebz34Cueb3KAzg,2JT9GrgdUKjuQQtXvZqevbjFquUQBMYDoADmBjDKWXj3,True,147385999,36846499,230606,115303,115303,3zqXX6kzhkbW3d4TwD2CNjMRwxTbREXySekvq37kfCNk,9224277,64278816,-55054539,625
2022-01-22 02:07:30-05:00,7290,6pXjgzpAPSjchUHoPqsZduviYV95SBHNk5CRCNjGAJZw,26Zjv9SkvUmwQAQT9Ls6k1wdKECrkhBrDUDrntpHfPEu,True,324479566,81119891,506766,253383,253383,4BnQKPLuE3DMTtxp8MjUBytgnhvxqq3ZTqZHTVZo4JJh,20270654,78249503,-57978849,624
2022-01-22 02:08:17-05:00,7291,7tDiadLeMrob7yD6R5SDskYn41tnQZVPjEc6W2vv6irK,AHZidccE9ERBcipuRQ2iGM9kHRpTnty7UNuYTFurvXB7,True,150457398,37614349,229439,114719,114720,HfEnetJ7uBSmZWCjBNxdvv9HEC5nsW4wDV7wu6WnhWan,9177589,48607292,-39429703,609
2022-01-22 02:08:17-05:00,7292,GHn96Ev7UmKJWqch3H3wzXpRT7qLg5FBuSBJAATVED1f,BXBSUddfz9MThXqk4517M7YVRDGdTm4pC6G4ipT69TMV,True,25655561,6413890,38859,19429,19430,3zqXX6kzhkbW3d4TwD2CNjMRwxTbREXySekvq37kfCNk,1554368,7730807,-6176439,605
2022-01-22 02:08:19-05:00,7293,98pwBGgiSDuwuas6WYW2hc9qUxfULwvNE34aixaxbxXY,BLrjKxekjThtJ9rKtQxs1Y4rZ225EE2Q16VkP9TkThyV,True,25100251,6275062,39116,19558,19558,3zqXX6kzhkbW3d4TwD2CNjMRwxTbREXySekvq37kfCNk,1564655,7736504,-6171849,623
2022-01-22 02:11:15-05:00,7294,woTXSsDkL9TQNxc3zwxSPagVijX7PE24bgKjvxexRwQ,A5M5EEPfDgvAxGLhpNgfn8AzPmyXxmPVgkEKnyoVzsz6,True,335330,83832,522,261,261,4BnQKPLuE3DMTtxp8MjUBytgnhvxqq3ZTqZHTVZo4JJh,20899,324718,-303819,623
2022-01-22 02:11:29-05:00,7295,GXSysysoV8Z4xBrQsaKUsSrpoWeTTUsbFmgfZDaQu4ZM,6FJyraiLgG3tb9B7pi4YFsJNtRVBNaghnm1ajzneVv7b,True,610373587,152593396,900417,450208,450209,3zqXX6kzhkbW3d4TwD2CNjMRwxTbREXySekvq37kfCNk,36016688,219853955,-183837267,590
2022-01-22 02:11:34-05:00,7296,ARB1q7bNcQ7grwFEZC6nk9Pfrrg7yZ2WK8zVqq5CEE8F,53e8mUYrWzQnCm9XQyp18CL9owyPqJcYyxZANYhRypPx,True,63633798,15908449,94674,47337,47337,HfEnetJ7uBSmZWCjBNxdvv9HEC5nsW4wDV7wu6WnhWan,3786988,29331190,-25544202,595
2022-01-22 02:11:34-05:00,7297,9aQrdyfAvcBbBj7iKQB17eAS4zBqymdd3kzkTkuRhdLU,BDHhukMF5rALuSwCxaw8g73m2MN4oX1D4e7uNmx3SiVt,True,85944025,21486006,128487,64243,64244,3zqXX6kzhkbW3d4TwD2CNjMRwxTbREXySekvq37kfCNk,5139515,29857969,-24718454,598
2022-01-22 02:11:34-05:00,7298,9psSuFHBGqCvcgNMc7aTMhKMMFwBDmW7v5Wkn22KtTHj,7zi9LSfuEhXccQXSRukRRwgQUaiQVVgfsGaRYLP2JvwB,True,1083447240,270861810,1652930,826465,826465,3zqXX6kzhkbW3d4TwD2CNjMRwxTbREXySekvq37kfCNk,66117202,388720753,-322603551,610
2022-01-22 02:11:35-05:00,7299,4ytoBUwuhAL4YYSCa6AgwrpeVF4eeU8H9NfDxMPZKxPo,Pby2szzsxDrXt4gnbmmaMccXxctZALr8miRtKhGKjsD,True,3644529,911132,5571,2785,2786,4BnQKPLuE3DMTtxp8MjUBytgnhvxqq3ZTqZHTVZo4JJh,222863,2083264,-1860401,611
2022-01-22 02:11:59-05:00,7300,Dv1BABsN7amhjmGBpMQsnMkRLx7MuCVwsnuyTQeZ6uum,BCjscxVo1h16teND6KKiAUy1ftNGTMy1vEEEyAW4ttVG,True,6048197,1512049,9463,4731,4732,HfEnetJ7uBSmZWCjBNxdvv9HEC5nsW4wDV7wu6WnhWan,378556,1987400,-1608844,625
2022-01-22 02:12:03-05:00,7301,442usWu6XpJZvU25bqXeynRrQ15jAzWwU9DWMgHpTn3Q,CtvADKp39bjJf3cPKWNL3wxnhq273fVM4fC5DmEcg5cC,True,1333302232,333325558,2049770,1024885,1024885,3uL2NSR2ZdDqCiKfzA5SwwpddAnit22DBJo6uvvz1rRs,81990825,566515876,-484525051,614
2022-01-22 02:15:47-05:00,7302,Bbd196A866Y9rQWQFt4YGg2R6Jqj7WQGXWPDmrNtPcKf,5gmWk1KwLoRHnhkjxps4Ad6aVk4ZpcfC3McZCWDVCUbu,True,7926973,1981743,12354,6177,6177,72FwbpFGoLEazJEdpqNtPNefsadUrimUqma9wSoy4qiS,494190,6379014,-5884824,623
2022-01-22 02:15:50-05:00,7303,H6fVnghBUSJRKp2mxSG7Fq2Lr4dE3YMS7yM1XTrxoe3Z,JjgtLi79grUZXofhWukB1yNXZkXFMUX5jm9HcXNDsB6,True,715299,178824,1116,558,558,3zqXX6kzhkbW3d4TwD2CNjMRwxTbREXySekvq37kfCNk,44654,455516,-410862,624
2022-01-22 02:15:51-05:00,7304,6b7Ro2myM4HcUDqyyW9NEqTWPz8BWpH4eNFSQQci37So,7r7j7rSsa6YZcTuRPfs3KP44MVqUA4Q5NeJGmx84wbHq,True,3478539,869634,5421,2710,2711,3zqXX6kzhkbW3d4TwD2CNjMRwxTbREXySekvq37kfCNk,216860,2788777,-2571917,623
2022-01-22 02:16:36-05:00,7305,3Xbsek5MsEGoWr3G9yhuohREr26B2vSQcjqXdspTFHta,2rPxkUiMo9wGDq8EvAiwY3ngRpKmL223cBWWNTYoBmFp,True,11948182,2987045,17861,8930,8931,3zqXX6kzhkbW3d4TwD2CNjMRwxTbREXySekvq37kfCNk,714457,5294884,-4580427,597
2022-01-22 02:16:36-05:00,7306,5hJereyPSCNUrGW7TdYXHKjhXMWTbGZzc2GF9MWksLJE,AUE3NpqaeamHGBKUVuKnUhnBb4Lzt7xWU1FHMu1Hq5dC,True,101451348,25362837,149660,74830,74830,3zqXX6kzhkbW3d4TwD2CNjMRwxTbREXySekvq37kfCNk,5986400,46656091,-40669691,590
2022-01-22 02:17:42-05:00,7307,7CSCMFa9W52tBDVUbXbc3woAy3GByeA1wPJdp3MgznPa,3447ptuVFu6G8B6N63RmS8mRv4n9PfHneypHLvbeaGLn,True,4765939,1191483,7238,3619,3619,HfEnetJ7uBSmZWCjBNxdvv9HEC5nsW4wDV7wu6WnhWan,289557,3667317,-3377760,607
2022-01-22 02:17:42-05:00,7308,Ayx8dFsVzUBb9b7QKxw7YHJuhptdSitBXFEczXTaxe85,EvU1VLChnowi6ccSPeJRSk65njrqZfYouAN7SHePxsxf,False,720,720,21,1,20,4BnQKPLuE3DMTtxp8MjUBytgnhvxqq3ZTqZHTVZo4JJh,21,638,-617,291
2022-01-22 02:17:42-05:00,7309,7W6ih2ZGXaE6tvuQFUPCvc7NvEJHy7UffgoVX3ZPdLXt,6uQCkeMjEXHBQxE2HD33RM1zyTsSko1fYZA1mWUggJ5B,False,791,791,21,1,20,HfEnetJ7uBSmZWCjBNxdvv9HEC5nsW4wDV7wu6WnhWan,21,622,-601,265
2022-01-22 02:17:44-05:00,7310,AHm7zF4rpaxaayBLn5QDHgJSp8KAr647s4cNvQ9wLgd7,FDM33WngED24pukBvSDpPAzinW6afVAeGReum5nyLRiC,False,19077,19077,767,38,729,4BnQKPLuE3DMTtxp8MjUBytgnhvxqq3ZTqZHTVZo4JJh,767,17061,-16294,402
2022-01-22 02:17:44-05:00,7311,EsRMkRaxhpF8roFS5CwMvTsbxLzJgpFsmQ1oHrn6jzmY,2Mxw76BgfopX5eGwFwzBZ2xGUSsTTCeJkGr36v6V8Fck,False,7329968,7329968,300301,15015,285286,HfEnetJ7uBSmZWCjBNxdvv9HEC5nsW4wDV7wu6WnhWan,300301,6023590,-5723289,409
2022-01-22 02:17:45-05:00,7312,62PLFKZ9cmzY2ZSA7G3co7zUygnbGSFWBtUpqBUirmqF,4jRR2v8kpf5HzN1voCqw655QC9nBAyh7kLGkux2vHRZT,False,5574522,5574522,257327,12866,244461,4BnQKPLuE3DMTtxp8MjUBytgnhvxqq3ZTqZHTVZo4JJh,257327,4553182,-4295855,461
2022-01-22 02:17:45-05:00,7313,BdHvHM3DBBmhaxVgUG76s7ksZamWJgwRHVvQkcUdncUM,EPV6oEXcEaumegnLYUm8KZxa7MhAzV4yURyJfBTK8ZjC,False,6268310,6268310,302945,15147,287798,HfEnetJ7uBSmZWCjBNxdvv9HEC5nsW4wDV7wu6WnhWan,302945,8098455,-7795510,483
2022-01-22 02:17:45-05:00,7314,5JFrEg61m6doRepvNFG1CH482oCfKtBPoq4mCvHYZH5T,CU6PGkQPezqAssYsApxCsitKuGjdwskbuVrRuhqmVqU6,False,5953285,5953285,270396,13519,256877,HfEnetJ7uBSmZWCjBNxdvv9HEC5nsW4wDV7wu6WnhWan,270396,4859802,-4589406,454
2022-01-22 02:17:45-05:00,7315,E5DXwW9rZdBRQPC6qu2zoh48xxnrLRXsZS2fZQ6Z3rC2,6X8YPwJinjCanbNpg3hQrd3hXYzCQR1cuLZFgAWiWvUM,False,4772708,4772708,210386,10519,199867,HfEnetJ7uBSmZWCjBNxdvv9HEC5nsW4wDV7wu6WnhWan,210386,3900887,-3690501,440
2022-01-22 02:17:45-05:00,7316,3PNJKoeTLt4KTHtkjK3JZooKfQMFjca5wFkfR6R9bmaq,HufTdMLqaenWqQE8SCnii5RAuWKigNLAdedAPP3zftMh,False,14214,14214,696,34,662,HfEnetJ7uBSmZWCjBNxdvv9HEC5nsW4wDV7wu6WnhWan,696,11125,-10429,489
2022-01-22 02:17:45-05:00,7317,o2aCmkxsxSiyUX8soTEjwUCbJeXmCZsEaf8CWwxDT5n,3pvS2bTsUuiQyqZp5rdnTpq4cqWGgtv4E5rN9HsBxpRt,False,740,740,26,1,25,3zqXX6kzhkbW3d4TwD2CNjMRwxTbREXySekvq37kfCNk,26,450,-424,351
2022-01-22 02:17:45-05:00,7318,ymyzGH4Qc7HH5PbKpVphCbsQgLLXyGkPcXamQJuNj5C,8oTLHaV2XzbKXNWRuUjCfHjUn61Pw93LYK14m9q2VDpZ,True,319001,79750,405,202,203,HfEnetJ7uBSmZWCjBNxdvv9HEC5nsW4wDV7wu6WnhWan,16225,236274,-220049,508
2022-01-22 02:17:45-05:00,7319,M69XSefqeum2arinvHEqmA3L2XHWNFN17p4msRhRZXf,2vK15yYUANLSbAoiBfgJ9VLyqsmtEpd2iNytQjms8GaQ,False,6283232,6283232,307011,15350,291661,HfEnetJ7uBSmZWCjBNxdvv9HEC5nsW4wDV7wu6WnhWan,307011,6671450,-6364439,488
2022-01-22 02:17:45-05:00,7320,9kYkFDNE3qD6s73fn8kJowgqbDZoDSw22XaUJ7rTD43D,E8zJz8pT2c9aZsxe4kLMNs4bY7skt38SU5wK5JTqbGr6,True,92502001,23125500,119657,59828,59829,HfEnetJ7uBSmZWCjBNxdvv9HEC5nsW4wDV7wu6WnhWan,4786312,75071704,-70285392,517
2022-01-22 02:17:45-05:00,7321,6Y1UoGwrKyKsScZQm9ng1rNrXXykKT82V7kUopc43kAy,8YtWQTTKymCESbPMWCP9TMehbMU25zJMtxt9grqrpbD4,False,879038,879038,36689,1834,34855,HfEnetJ7uBSmZWCjBNxdvv9HEC5nsW4wDV7wu6WnhWan,36689,1184740,-1148051,417
2022-01-22 02:17:45-05:00,7322,HGAFdundf5voDqeh9g7d6Q9mgMf8eEg898QMRBqwPZ6C,deanBuZXWBHEe2TGfP37S9aMBEnEgmZoyRJjAvruzfA,True,3791129,947781,5081,2540,2541,HfEnetJ7uBSmZWCjBNxdvv9HEC5nsW4wDV7wu6WnhWan,203260,3227086,-3023826,536
2022-01-22 02:17:45-05:00,7323,EmXaq1sxmAZUiwYW6LXpKtKFZXu5MzQ3sK4MEAojDK1h,HuAsa5G2wJi8Ah9stxEmggwcB5zW1QjBsP3Ndgke7r8X,True,8079016,2019754,11092,5546,5546,HfEnetJ7uBSmZWCjBNxdvv9HEC5nsW4wDV7wu6WnhWan,443719,6533945,-6090226,549
2022-01-22 02:17:45-05:00,7324,EwGnQsfyNv3bQSj8gqF2ZAa4YE2MfJybKqb3xEodFUkW,3LurEajwp3CzBPbaJSJSHAgD8CgecwvWJ95fdUKMkGiU,False,5664116,5664116,227940,11397,216543,HfEnetJ7uBSmZWCjBNxdvv9HEC5nsW4wDV7wu6WnhWan,227940,4657160,-4429220,402
2022-01-22 02:17:45-05:00,7325,2tYCtJ377Jt8noUwmnjK3YwDsfsP7K7UcjQ1cMXqgNR9,2CJjxgqjzZjtoKG1zTTEkqcmf2x6EZCJBWe2ypj7niw5,False,5436377,5436377,267004,13350,253654,HfEnetJ7uBSmZWCjBNxdvv9HEC5nsW4wDV7wu6WnhWan,267004,4414493,-4147489,491
2022-01-22 02:17:45-05:00,7326,3R2wxFQwjCqUwwxJmp9tNrT6osYFpB5gczq2QYik6QYm,7At5Ej3ZsynfWr56FYrd4P4Y6UtD8FHA4gCFB8TaAyaG,True,6053236,1513309,8450,4225,4225,HfEnetJ7uBSmZWCjBNxdvv9HEC5nsW4wDV7wu6WnhWan,338004,4894966,-4556962,558
2022-01-22 02:17:46-05:00,7327,5ek257JwzV27kFiv9zdpVVyTz7HyuZicsJyUMFSeXnX,8rpHQHBTkq5a8Qts1nyfbnFwjQjkLcmjgTKKbC8KjrBf,False,14219,14219,700,35,665,4BnQKPLuE3DMTtxp8MjUBytgnhvxqq3ZTqZHTVZo4JJh,700,11124,-10424,492
2022-01-22 02:17:46-05:00,7328,7QDEq3mN94qSZ45XXdyBhvWnRDi6HypHaG3YTDLwtuB3,HgS8Nd3xmmJ5UiqybdGXxHLQxRkkvR1S9QwZn8gRg2fu,False,5598519,5598519,232925,11646,221279,4BnQKPLuE3DMTtxp8MjUBytgnhvxqq3ZTqZHTVZo4JJh,232925,4599944,-4367019,416
2022-01-22 02:17:46-05:00,7329,CyWBZ1xJ9LahUnPesbXLZ4Rr5UyWAHgVFYwfrnhyrkNL,2Lpk87Xth8ZL5J9BfzmMpEE3x76FDrrrmdKiCNkSVip2,True,8224012,2056001,11736,5868,5868,4BnQKPLuE3DMTtxp8MjUBytgnhvxqq3ZTqZHTVZo4JJh,469470,5398535,-4929065,570
2022-01-22 02:17:46-05:00,7330,DiPSJvnnEwg1En7HJfEsKrUbBgtUf4KzGMyMCZDQSYgp,s8UVC6vPBofuXUS6RW1aQmZ8C35PrC5r4A6ugmvzLGB,True,33631,8407,48,24,24,DddJ7EWCmYEEZETCBNgAUSg81Ls6fZtiAaY5ekJ5sXx1,1931,20925,-18994,574
2022-01-22 02:17:47-05:00,7331,4yhW5mBsFVNgQ5QQc2Yg65guctPsTSXcERbzmYM6rdnL,5uJnMZ6DWA9bMSvHvS5zomwtt1sv7YCWq3GDJh77YC3q,True,5935631,1483907,7848,3924,3924,4BnQKPLuE3DMTtxp8MjUBytgnhvxqq3ZTqZHTVZo4JJh,313932,4817302,-4503370,528
2022-01-22 02:17:47-05:00,7332,HdRgh9niYSd3YKCxzGdusYFquiVoFTP2mEGEzJJL5Nii,78C68Gbb1jYFQmYNCHHjL52keEKMXtGukmBwT7ahon4B,True,664646022,166161505,860550,430275,430275,3uL2NSR2ZdDqCiKfzA5SwwpddAnit22DBJo6uvvz1rRs,34422030,446285616,-411863586,517
2022-01-22 02:17:47-05:00,7333,U3vvMQ4X4aKzVYfhMw1V1p58HRqaLnuXozqmmefYeD9,7JA94MArkNCFRhBq8f5a32DgMF6aPdFsoC5HvXDQ6NuR,True,7284225,1821056,9379,4689,4690,3uL2NSR2ZdDqCiKfzA5SwwpddAnit22DBJo6uvvz1rRs,375182,6687740,-6312558,515
2022-01-22 02:17:47-05:00,7334,51yPLtXTgL9oLKs1cCf5TjL54Ld5vuVxat2NNtwZVsZG,7UjtM7Z1tiXEQMMiorQyncgi9SKu3v46DhVdgXbWqSiF,False,8221228,8221228,378575,18928,359647,4BnQKPLuE3DMTtxp8MjUBytgnhvxqq3ZTqZHTVZo4JJh,378575,10981657,-10603082,460
2022-01-22 02:17:47-05:00,7335,HGJoZvLakWfSDFwuvShNBc4kCf7nP7VqzyM3mELpbFEf,12Qn5jin7QvsBngXqYAv4UstyG3b6nRf1jsLp9Dp8G7k,True,376145,94036,487,243,244,4BnQKPLuE3DMTtxp8MjUBytgnhvxqq3ZTqZHTVZo4JJh,19487,312217,-292730,518
2022-01-22 02:17:47-05:00,7336,Ecpu1wBKxKGUMxb7kP483xkoZ9HZZ4PM3kT9uj6nUAKg,CCVmomGHRFbCwbFUwv5q9Gfa3pV2CFypg9JAF86TiBcZ,False,5592201,5592201,265950,13297,252653,4BnQKPLuE3DMTtxp8MjUBytgnhvxqq3ZTqZHTVZo4JJh,265950,4564618,-4298668,475
2022-01-22 02:17:52-05:00,7337,4iPTUqUGM6D2smveHEgEbJF6SSsaUyFtvzv7MarNhTGV,8DgAH2dgCZGjV2gm2MzqvkgLwDhSLnq98Nwm5B5JRYJ2,False,6370058,6370058,291078,14553,276525,4BnQKPLuE3DMTtxp8MjUBytgnhvxqq3ZTqZHTVZo4JJh,291078,5198263,-4907185,456
2022-01-22 02:17:52-05:00,7338,ANXYsUNpZ34dBt7cp6HEE7oi2pTKsbj7B5TeFHKPbHBU,2pqeP4fuMREosHcfWUecEBssp1GM4isihNjn7ALUD51d,True,7365145,1841286,10483,5241,5242,HfEnetJ7uBSmZWCjBNxdvv9HEC5nsW4wDV7wu6WnhWan,419334,5944813,-5525479,569
2022-01-22 02:17:52-05:00,7339,57Vsw8jXaaoLriYEkvPAVyq66r4a4zMfLWbDaTBMjFzC,7AVDWUTHa6729UkXgCXASphSmrLvXYGAA9ygTMSqvwvY,True,5889523,1472380,9060,4530,4530,72FwbpFGoLEazJEdpqNtPNefsadUrimUqma9wSoy4qiS,362412,4729149,-4366737,615
2022-01-22 02:17:52-05:00,7340,84SgzR8J6DeqPJ1uXphP1BHMotYGKh3kS4owMMj9x58x,CL7Jkwe3NK4qaAVK2QjuftXnQ5YLqDT9qYeeEi7kJXrV,False,8746382332,8746382332,374699019,18734950,355964069,4BnQKPLuE3DMTtxp8MjUBytgnhvxqq3ZTqZHTVZo4JJh,374699019,7925794377,-7551095358,428
2022-01-22 02:17:52-05:00,7341,8CQ8wTkDHxhDjxtARpqi1NvwhgvifEgmmsaZi53L6rDM,6BgagW5MLhH3tXKPVyN6ZDotT1TkcZ2bb3kNBKLY3cKm,False,3534937,3534937,170083,8504,161579,4BnQKPLuE3DMTtxp8MjUBytgnhvxqq3ZTqZHTVZo4JJh,170083,2997429,-2827346,481
2022-01-22 02:17:52-05:00,7342,FS5xx53Bo65G21gJLta7LEEiS132VJM1kGpUzuqyfzoy,2kbTLjdBBA9K1coxKmwmYbjq2heSnuNg4Nh2EfVNYgwj,True,18253126,4563281,27252,13626,13626,HfEnetJ7uBSmZWCjBNxdvv9HEC5nsW4wDV7wu6WnhWan,1090089,7828276,-6738187,597
2022-01-22 02:17:52-05:00,7343,EmGW2aAG69ssWqCtbfDocRaM2u3TJsczn2HHP9jdmRvD,aypkDKsp9uqAB4F6mwvm5LofpsrFBuZT2MMWtE2eHdB,False,14864,14864,620,31,589,3zqXX6kzhkbW3d4TwD2CNjMRwxTbREXySekvq37kfCNk,620,12517,-11897,417
2022-01-22 02:17:52-05:00,7344,9Hz4p7gcfDbXBJp8KzhaBBPh9i7xe9kun7zLfDtqPe6c,2bJ43Lep6kp6WY7Ct56oiscKnAbdtC265G5yRvRPFThU,True,22014684,5503671,27878,13939,13939,4BnQKPLuE3DMTtxp8MjUBytgnhvxqq3ZTqZHTVZo4JJh,1115153,10951528,-9836375,506
2022-01-22 02:17:52-05:00,7345,9BMHbUs4d3qX49fnroHv2FTPDs4yoDFrvDMqf8p9U4pE,2yL7zwMr7qVG5Sdwkf7z6ppnNqt1ASppBbmxwYjfFY6Z,True,93613776,23403444,119800,59900,59900,72FwbpFGoLEazJEdpqNtPNefsadUrimUqma9wSoy4qiS,4792032,76016626,-71224594,511
2022-01-22 02:17:52-05:00,7346,2fyVBNx9V7YT3HXP5BWgteS3X94Hc9Qw8mEXdv9F5P4T,EHmTcchLaxfd77oJqDMh5ebw8DXG9b5my7rnyoBwPGcp,False,90017686,90017686,4450702,222535,4228167,DddJ7EWCmYEEZETCBNgAUSg81Ls6fZtiAaY5ekJ5sXx1,4450702,73802080,-69351378,494
2022-01-22 02:17:52-05:00,7347,B9ip43CcQ8cARn5NKT7ARev1LtTwBsMyFzQcRNxKZppH,HkL4QXHHX3PTYiWHw3wKDFujnD5K7DBi58MFRrEGkHyo,False,5587418,5587418,253402,12670,240732,72FwbpFGoLEazJEdpqNtPNefsadUrimUqma9wSoy4qiS,253402,4565488,-4312086,453
2022-01-22 02:17:52-05:00,7348,CEtpqFD4BbeiNfaXyLLYEapY2mWgE26H5q6H34tWwRuD,BVqRyqwGFPzSkk1H2finiyfaL3LScbEiQGk3mihirxqs,True,4441498,1110374,5782,2891,2891,4BnQKPLuE3DMTtxp8MjUBytgnhvxqq3ZTqZHTVZo4JJh,231300,3529574,-3298274,520
2022-01-22 02:17:52-05:00,7349,GRTpRhhDdiecBjFaeKKr4rpP4gZWTrcd2jtdxAiuYDhF,EVyXAd6kJVQmQZRwpmNkbLv7fn4kaYyqLb2EzarGWRS,False,7899561,7899561,363086,18154,344932,3zqXX6kzhkbW3d4TwD2CNjMRwxTbREXySekvq37kfCNk,363086,6438690,-6075604,459
2022-01-22 02:17:52-05:00,7350,9vcKW1GfrDZ3KLPh2pEVFF8ZyKqD1pJW1hiE8H98Av7S,C6Ki27mo4sCHu6u8UnR1p7WSgsTjFQxGGR9Lk9n5Rhjq,False,64373,64373,3046,152,2894,3uL2NSR2ZdDqCiKfzA5SwwpddAnit22DBJo6uvvz1rRs,3046,55810,-52764,473
2022-01-22 02:17:52-05:00,7351,FL1C5wMXApaNzez9LFMAiFYVFiLSRQxgZ3GfPrscdvRB,2FkYGYyTzbTFjJBiggre23H7TvqHjzBTdyrzQ5VNGqht,False,917817,917817,42412,2120,40292,72FwbpFGoLEazJEdpqNtPNefsadUrimUqma9wSoy4qiS,42412,249842,-207430,462
2022-01-22 02:17:52-05:00,7352,D58t4uTjFumsUeYFaKnpV8BRTEQEqKXBreFTdwGrott7,67p6kHDfVqQijfcwugvZK59c3aRRH9x3eHxruqH8WEqF,True,17334083,4333520,26503,13251,13252,3uL2NSR2ZdDqCiKfzA5SwwpddAnit22DBJo6uvvz1rRs,1060143,7115736,-6055593,611
2022-01-22 02:17:52-05:00,7353,HPDN6Ro6gPgYbNgnv7yhFCpyY3uYzT18epFxRFNZ985w,3Jop74A52E7gYLXJRUAoPBzSZ6mmP2gmaCg7eG6eQHu5,False,25580616,25580616,1244150,62207,1181943,3zqXX6kzhkbW3d4TwD2CNjMRwxTbREXySekvq37kfCNk,1244150,13676674,-12432524,486
2022-01-22 02:17:52-05:00,7354,CagSUfZLwXuCdypC4KzU6FSNdmCj9dKDroPcNeaRtsyt,yxw5d1ztZuEUY2QjL7eLpr72QJAj5rJd6ERvg91cy1m,False,37488,37488,1874,93,1781,4BnQKPLuE3DMTtxp8MjUBytgnhvxqq3ZTqZHTVZo4JJh,1874,27783,-25909,499
2022-01-22 02:17:52-05:00,7355,ES1MDwRUa3hoToPKQiiZkzMYe9PDVnAQwMrEvZrzvnc1,C4wBG3xTDkmDQneB28xYnf1aBNEeq7UB8oR7NuEfLkFg,False,633583,633583,25264,1263,24001,4BnQKPLuE3DMTtxp8MjUBytgnhvxqq3ZTqZHTVZo4JJh,25264,436923,-411659,398
2022-01-22 02:17:52-05:00,7356,DdYgcyV1T2CDYiQVr4VL9Ym8RdKm93a7SKy8HxuyaoMW,GPdAeqeXb1UJ56AttcwwY1CyFhRyfptDC4BAX2Tc8MpE,False,12181,12181,581,29,552,72FwbpFGoLEazJEdpqNtPNefsadUrimUqma9wSoy4qiS,581,10955,-10374,476
2022-01-22 02:17:52-05:00,7357,woTXSsDkL9TQNxc3zwxSPagVijX7PE24bgKjvxexRwQ,A5M5EEPfDgvAxGLhpNgfn8AzPmyXxmPVgkEKnyoVzsz6,True,246100,61525,374,187,187,72FwbpFGoLEazJEdpqNtPNefsadUrimUqma9wSoy4qiS,14979,248243,-233264,608
2022-01-22 02:17:52-05:00,7358,CYv2hNAzvRak1LBSayFxMJEXoAQdMEZHnNpQLZ5G5RVo,HkvTQbtKxWv2E5z6MsViv1LS4jm8T286fiY1C7n6ZZ9C,False,195620376,195620376,7755922,387796,7368126,4BnQKPLuE3DMTtxp8MjUBytgnhvxqq3ZTqZHTVZo4JJh,7755922,182303218,-174547296,396
2022-01-22 02:17:52-05:00,7359,8nXbrdjjaHB73CRPRenGEQj73wbtEFGDwXsehRGMhsap,43pvdcJ6f27wz94D6ZboKwRJYbyvYCrjsJhYsvk7LJCM,True,1494604,373651,1971,985,986,3zqXX6kzhkbW3d4TwD2CNjMRwxTbREXySekvq37kfCNk,78876,726052,-647176,527
2022-01-22 02:17:52-05:00,7360,2DHhfXSzcuSwsKfAYLMuWuD17w84mCwNer9fcBNLTpSc,89BVfDycKjdSkQzFVqCXd5c16DntdND7WsqoZtCafYFH,True,289322313,72330578,390065,195032,195033,HfEnetJ7uBSmZWCjBNxdvv9HEC5nsW4wDV7wu6WnhWan,15602606,226229793,-210627187,539
2022-01-22 02:17:52-05:00,7361,D2L7ST8iGsRfZ4zj2pdfKTptbojQ4cDtHKQ8ngcFVQwA,7cNrHGWJ6FGGazfGaCePs8XyaK6bwVLrYFCUJQi9w2Wc,False,1558,1558,65,3,62,72FwbpFGoLEazJEdpqNtPNefsadUrimUqma9wSoy4qiS,65,1214,-1149,417
2022-01-22 02:17:52-05:00,7362,7aBHHP6sEWg6s7H3BADdx8YiwHTRV4jNTWLNMy1xfv7,484eWXa2zXsNeuaGRE2w9do4SL3fG1PjNs8Ra9bGciK3,False,5414591,5414591,228355,11417,216938,3zqXX6kzhkbW3d4TwD2CNjMRwxTbREXySekvq37kfCNk,228355,4443757,-4215402,421
2022-01-22 02:17:52-05:00,7363,9zpPiboHF5HW7NfCx7hYdmJGwUomVMTiUFc4Um5KrDi3,8q3eBpuwV6dMNkib9N8XQAq2tBUcjSANRe5SXpd4dFhZ,False,189046,189046,7692,384,7308,72FwbpFGoLEazJEdpqNtPNefsadUrimUqma9wSoy4qiS,7692,128669,-120977,406
2022-01-22 02:17:52-05:00,7364,CvZssqscu2dm35mwcE3zg9zedavbRjVJjWD59Py5ExUK,7pXaoR6aHKYofCmg1eHipygNYDteEaf8rbbS8BDYGQK6,False,16208,16208,728,36,692,72FwbpFGoLEazJEdpqNtPNefsadUrimUqma9wSoy4qiS,728,11643,-10915,449
2022-01-22 02:17:52-05:00,7365,Gs3WP18hbzNpbBgiU39e6tfkggfCKRyNqPqJQcthuHFD,4XAY25YUma6gUdG2GdbXeivum3t21g93ZagfWGTZYkWZ,True,805603,201400,1140,570,570,DddJ7EWCmYEEZETCBNgAUSg81Ls6fZtiAaY5ekJ5sXx1,45631,592102,-546471,566
2022-01-22 02:17:52-05:00,7366,AvpYg74EBhwAXE8rcdGkpwmbBMRyVidF6zMRSFtWAVC6,4WgpqTp4r9wMpMptYMNbvCaP2faBnVr6FdShCAobetpL,True,5972100,1493025,7582,3791,3791,4BnQKPLuE3DMTtxp8MjUBytgnhvxqq3ZTqZHTVZo4JJh,303296,4853431,-4550135,507
2022-01-22 02:17:52-05:00,7367,AiLCB8xw3k5FXdJE1T42PLFhHrz1bLTKpNekR61a915N,HB7CNWxLipWAc6MPGq9wV4TT7AYjiELA5T3onYeVqBbU,True,121594137,30398534,169855,84927,84928,4BnQKPLuE3DMTtxp8MjUBytgnhvxqq3ZTqZHTVZo4JJh,6794225,99178474,-92384249,558
2022-01-22 02:17:52-05:00,7368,33fBsmAi7CdYxccnzMoGsdyCoAWmatJbrEEdUXZzUWft,EyEcNqLYXC2Aaecbun5VEeAGKSPok97PeD4sf6rBVkuj,False,6215184,6215184,269458,13472,255986,4BnQKPLuE3DMTtxp8MjUBytgnhvxqq3ZTqZHTVZo4JJh,269458,5083731,-4814273,433
2022-01-22 02:17:52-05:00,7369,FLQcLhAsRBKnLcSYkK94Za6NhGudrCGhGGxFTdDhVC6L,7vr92sRGp6DopaDv3wJr7gw4BFmxY74K8kFheKyxZdLX,False,12045,12045,584,29,555,3zqXX6kzhkbW3d4TwD2CNjMRwxTbREXySekvq37kfCNk,584,7430,-6846,484
2022-01-22 02:17:52-05:00,7370,2vRdBUakRbsdKAUbcDzE5YqNWx3DCc8XuLewhwM39UqK,2hcQX5ZsQBPzb9HPEp94H8k9rjj7cew6VEU8RbVKXLX9,False,7463590,7463590,340914,17045,323869,72FwbpFGoLEazJEdpqNtPNefsadUrimUqma9wSoy4qiS,340914,6087601,-5746687,456
2022-01-22 02:17:52-05:00,7371,6tFQaTqqffino9kwMZTL2xVNBG8k9VREFhXqVi2si3A3,3w3wGxBbS4bmXeqmvd595SAWFeXekVpnH4UdbeEs8Sx5,False,100889,100889,3996,199,3797,4BnQKPLuE3DMTtxp8MjUBytgnhvxqq3ZTqZHTVZo4JJh,3996,72201,-68205,396
2022-01-22 02:17:52-05:00,7372,BrHRMouGRz3LBNzd9anfdYMhWfg8yUPHL4PqJ8WdEDFS,4uzoLa3mC2VYHAPBoHLX4gTjPTC28rPf2fvEGtJWPYc,True,1410299,352574,1786,893,893,3zqXX6kzhkbW3d4TwD2CNjMRwxTbREXySekvq37kfCNk,71472,1811234,-1739762,506
2022-01-22 02:17:52-05:00,7373,DLx1pUQCp78RRLAaKfuLUdQaf3ovhD7dpDTWpNRWFw9W,3dT1vccCWmkcqAfyQ6YPrXXz5SW8RnEPvUeH5QewZnXJ,False,4560750,4560750,199069,9953,189116,4BnQKPLuE3DMTtxp8MjUBytgnhvxqq3ZTqZHTVZo4JJh,199069,3735279,-3536210,436
2022-01-22 02:17:53-05:00,7374,D6qMab7uevXTa89ssv4BRyHwrw3FYpNimAmX2VH2uf4B,8ZauZ5dAp7kyawkPdxi4mqfempFHubJebfBenQdDektD,True,3310152,827538,4680,2340,2340,3zqXX6kzhkbW3d4TwD2CNjMRwxTbREXySekvq37kfCNk,187203,2794201,-2606998,565
2022-01-22 02:17:53-05:00,7375,2ZSfbqxhiCTDrDPeRhoWayTZHNmW7ajVXBCxpFS4eGBF,3ZmWsPdQD7qfSMGKQSNhmBtuH7S6qMFRc8oEmBcHXEiR,True,6019460,1504865,7605,3802,3803,HfEnetJ7uBSmZWCjBNxdvv9HEC5nsW4wDV7wu6WnhWan,304237,4891604,-4587367,505
2022-01-22 02:17:53-05:00,7376,pgzvXpnUYiY7hLrfjmwScqLd8oj9vYcXpFvpm4y4JvG,GdqdQgoyBAFuXdbvoZyDhB3jyqJzVo4nkGh7EPFxkBF2,False,48824,48824,2181,109,2072,3zqXX6kzhkbW3d4TwD2CNjMRwxTbREXySekvq37kfCNk,2181,67404,-65223,446
2022-01-22 02:17:53-05:00,7377,CgQB5KmWNz21q9mPfFBve8Ksbqdsdr8jNfwkrxmNZPLN,2dtPpz7Ck4hhBQq8DUywp4Bq21Jk1enHLe8AgXa8ARZu,False,26699204,26699204,1285329,64266,1221063,HfEnetJ7uBSmZWCjBNxdvv9HEC5nsW4wDV7wu6WnhWan,1285329,20281643,-18996314,481
2022-01-22 02:17:53-05:00,7378,9VSpd4vToJrnQhmJ595Ua7GhmhutYRgd6rCk3pL4yNxr,7axwFe8aQVPYLNgM9rdUwnFf6vW69Jsw2XpKNjYRDn6N,False,7814971,7814971,372351,18617,353734,4BnQKPLuE3DMTtxp8MjUBytgnhvxqq3ZTqZHTVZo4JJh,372351,5606783,-5234432,476
2022-01-22 02:17:53-05:00,7379,4uDqrACGzns1HRKSezhDgFShygnc21GjzmDRvGaQWrD3,GMa3SrgxvtGZzcDXbwLhaiNSsCYNsz82Sm99YgWxx3PX,False,5700400,5700400,264898,13244,251654,72FwbpFGoLEazJEdpqNtPNefsadUrimUqma9wSoy4qiS,264898,4653662,-4388764,464
2022-01-22 02:17:53-05:00,7380,9hB3EPuj4SrSrpAzHvExDb6mzh2vNGGVbj7qqfRjeao4,9725jRXGPRUuo1dijvv8mwzvSu1ed4y5hi9FAQNwb8dG,True,102813063,25703265,145383,72691,72692,HfEnetJ7uBSmZWCjBNxdvv9HEC5nsW4wDV7wu6WnhWan,5815357,82984114,-77168757,565
2022-01-22 02:17:53-05:00,7381,FdYFnEYtFQKcZPmzUqnvNLzozxdR1emtkmvnYcMgYykS,7arWNJQf2cWxerjhLgQh9CJxwTat1efnr5KmhuD7Qnv4,True,4684839,1171209,5901,2950,2951,DddJ7EWCmYEEZETCBNgAUSg81Ls6fZtiAaY5ekJ5sXx1,236077,3809128,-3573051,503
2022-01-22 02:17:53-05:00,7382,8NdcaYUC1X5CP7FMDip78uqtqmCt8GcZdCzLRTYTihmb,9Ei1K9bXWXSXcBfeX5exPSXGCAu62WSKzvnnd4wHvyVh,False,3026,3026,122,6,116,3zqXX6kzhkbW3d4TwD2CNjMRwxTbREXySekvq37kfCNk,122,2453,-2331,403
2022-01-22 02:17:53-05:00,7383,J4krKPBBTMVLZRgrSeYJAMyHQs2FkNm5TXk7nQWwDB43,ASmLbfNbhTD2HHeV7qzAqiHjUx5a8Traj8oPDwbkMdFg,False,654868,654868,29630,1481,28149,4BnQKPLuE3DMTtxp8MjUBytgnhvxqq3ZTqZHTVZo4JJh,29630,477056,-447426,452
2022-01-22 02:17:53-05:00,7384,HtHNRFaoM14udMSVez69Hhn5g7JGiuAcv5kXZJfxjcXr,6P9mmacCVwJ5EDaAAFqxeSXz1aYBepUaVsLRVTcW7iMq,False,4921512,4921512,237715,11885,225830,DddJ7EWCmYEEZETCBNgAUSg81Ls6fZtiAaY5ekJ5sXx1,237715,3999888,-3762173,483
2022-01-22 02:17:53-05:00,7385,HxhVxMpFpKzeuC6Z6CpsuUhPHdHUzvpMNYJ8LpQ3NYCp,8KyiipC39iU15zVErVvj6hdhbv89STsexrB8dVw3RcLs,True,6334499,1583624,8562,4281,4281,HfEnetJ7uBSmZWCjBNxdvv9HEC5nsW4wDV7wu6WnhWan,342505,5127798,-4785293,540
2022-01-22 02:17:53-05:00,7386,6nJyqvFKprwaVCE1gAa2P4RHKc6Pa6XFSJymx654zZ9K,4e7iJmdwzAPxp1Zi8Azo38YyPQdPKqqY4VLJyQ5rpdYP,False,57722,57722,2719,135,2584,3zqXX6kzhkbW3d4TwD2CNjMRwxTbREXySekvq37kfCNk,2719,52172,-49453,471
2022-01-22 02:17:53-05:00,7387,Ht2oWgWWVsA4u5fwp8o8dwgUjoGSRDF2gAwQPDXCwKfZ,8pYWhoNFpmDYuawZub9rd5qkSsAJuPGeJwoa23YyVVym,False,1246883,1246883,52087,2604,49483,3zqXX6kzhkbW3d4TwD2CNjMRwxTbREXySekvq37kfCNk,52087,1216354,-1164267,417
2022-01-22 02:17:53-05:00,7388,DD1a8rMoUCwmEiLKRN43VpdqL8Qgfr5yi92ejQxDVRMo,3vMJVNAuyRhM9jkaEZARhwbR6MerR5UmcgoZ9c5bs1VS,True,110325774,27581443,145788,72894,72894,HfEnetJ7uBSmZWCjBNxdvv9HEC5nsW4wDV7wu6WnhWan,5831556,89432032,-83600476,528
2022-01-22 02:17:53-05:00,7389,7sehUeigZkhQjrNdRDaja2VdFWu7x9vWc1dYQSXz7qR8,DvRnmtGNS2Z7QoM4N5AqUdB7Xd6stwPhJUL3kk4kH2Ex,False,6647073,6647073,288533,14426,274107,3zqXX6kzhkbW3d4TwD2CNjMRwxTbREXySekvq37kfCNk,288533,5438791,-5150258,434
2022-01-22 02:17:53-05:00,7390,Ckqos6cdncPKj13DnCmDVZsZTqp6eS7277CRrT9WhcEr,AtUV8m7VQJvZq7GLCAHMf3jV7iamKEPnWVZHWuuVZQp1,False,28769,28769,1368,68,1300,3zqXX6kzhkbW3d4TwD2CNjMRwxTbREXySekvq37kfCNk,1368,29485,-28117,475
2022-01-22 02:17:53-05:00,7391,3qnPsgqW11AcDEmyjmJquPcPLyE3EdJQuVLJ5kinDrd3,86rZadBB7emKio76aFTahpbrFtxd9tqZ4Mxgzaavq2xU,True,3662,915,4,2,2,3zqXX6kzhkbW3d4TwD2CNjMRwxTbREXySekvq37kfCNk,189,2954,-2765,516
2022-01-22 02:17:53-05:00,7392,5XrU9QLKHL8m66mpfcsqvndBBeQ9t8vA7zhNdB1yAi9s,3FDocKqsT3aUigiW2P7MESU8anAYqg1D9domHCDsxCB1,False,154040977,154040977,6168406,308420,5859986,HfEnetJ7uBSmZWCjBNxdvv9HEC5nsW4wDV7wu6WnhWan,6168406,44972397,-38803991,400
2022-01-22 02:17:53-05:00,7393,B2sFHhYMf3wE6BZAYQbst77ZPoY3Muf9ubPPcWHxSont,5BPmqYokg5b2fyqp2tnFHqXtLocrErvix3YCuwAqUvno,False,5761666,5761666,268032,13401,254631,3zqXX6kzhkbW3d4TwD2CNjMRwxTbREXySekvq37kfCNk,268032,4694589,-4426557,465
2022-01-22 02:17:53-05:00,7394,BYvjENe16Ta77PqGV7JKEWrsqCTfkMGYwTSG5gXneDvd,EvxAXgvhPC6QkNurbK7vWyTApGo8J2R4EgMAknkHVU3d,True,71654,17913,91,45,46,3uL2NSR2ZdDqCiKfzA5SwwpddAnit22DBJo6uvvz1rRs,3670,74711,-71041,512
2022-01-22 02:17:53-05:00,7395,9dvxqJqDhhFW6tMHquhdWCvYcEkSj5XPXd818mnDRKRA,F7yFNuLDaS73XGVyAKMhMYCYbZehKmC8uEG68rZqdFL3,False,4867327,4867327,211899,10594,201305,3zqXX6kzhkbW3d4TwD2CNjMRwxTbREXySekvq37kfCNk,211899,3984327,-3772428,435
2022-01-22 02:17:53-05:00,7396,B4Uc39nKzz9wBRQsCkMR4A7RwTJ8rSuwpR6EQn2AesRb,H49bGZgatRZVpj6QufZRVgYrQtH7LpdbiqKBs23151m,True,599789,149947,771,385,386,3zqXX6kzhkbW3d4TwD2CNjMRwxTbREXySekvq37kfCNk,30878,835919,-805041,514
2022-01-22 02:17:53-05:00,7397,JCagxpXPs6wVRUWbNBPCZ4uLCkZsachnofN7SZEEwGwB,5uGj1TBCkc7FV4ffdBJg31yLcCxkQLxRExjcinnJUow9,True,2667748237,666937058,3763153,1881576,1881577,72FwbpFGoLEazJEdpqNtPNefsadUrimUqma9wSoy4qiS,150526128,2008251360,-1857725232,564
2022-01-22 02:17:53-05:00,7398,H2ZziGps3c5QuRdyeianD1UHYj5eujj8cnYNYQhCiV3E,2HmbZcWsei6SPZ9J85ngNHBJUP5RRaJTqhZRp2TvmjAM,False,6000851,6000851,287992,14399,273593,3zqXX6kzhkbW3d4TwD2CNjMRwxTbREXySekvq37kfCNk,287992,4891692,-4603700,479
2022-01-22 02:17:53-05:00,7399,Fs8MQLaMyr1Q96HsZivKLY7Kjdeu2ZoB2n3VTZ15KbSn,DREfCs5CTVNUUF8H3hD8CWvtxztiYxoLYh8HUWDecMyZ,True,186161271,46540317,284374,142187,142187,4BnQKPLuE3DMTtxp8MjUBytgnhvxqq3ZTqZHTVZo4JJh,11374989,149219006,-137844017,611
2022-01-22 02:17:53-05:00,7400,FYdUiU3rPpbYKWnEpekQQsocSJKjXmscohi4v6DYqix7,daPyq9YdunQJhhLoW5ifhJ7UFPTtRZhGs4JwE1nqZhN,True,6058090,1514522,7677,3838,3839,HfEnetJ7uBSmZWCjBNxdvv9HEC5nsW4wDV7wu6WnhWan,307081,4923851,-4616770,506
2022-01-22 02:17:53-05:00,7401,C9beggursF9WdLyzunVSoz2Bw6kAxoQpUifPHbo4ybvw,3R7KdKBK7FoudsNXUeRuC2AGVFusMhmTYXSGdnA88pJT,False,851518189,851518189,40679526,2033976,38645550,4BnQKPLuE3DMTtxp8MjUBytgnhvxqq3ZTqZHTVZo4JJh,40679526,420922736,-380243210,477
2022-01-22 02:17:53-05:00,7402,2AAWghW6BUAFBtF3R6hB9uoqMc5oUDkU8FTd2JrXKema,798cfEUZ2YhXwNTNjXMS4Z2J8gAHaK4zZwpMkq2HzWWM,True,32389329472,8097332368,41758438,20879219,20879219,4BnQKPLuE3DMTtxp8MjUBytgnhvxqq3ZTqZHTVZo4JJh,1670337536,16274057949,-14603720413,515
2022-01-22 02:17:53-05:00,7403,6SqJHnwgDCdUdUercq1UushY4tKpbJPKTapGM3ub7Sgm,8MQCsx2SzMUCBWkbriEgkP2ooWC6MDRJvT23xLYEYHTe,False,2788709,2788709,124719,6235,118484,72FwbpFGoLEazJEdpqNtPNefsadUrimUqma9wSoy4qiS,124719,2398004,-2273285,447
2022-01-22 02:17:53-05:00,7404,B35LX2SGUTp8KzzNgqA6PHEfF3gTpvb67TTmK23aVLgm,HBSe4EdWZyBp88VDbesyGTdkL5HqNGXeo5eD7wLVpTFm,False,3035243,3035243,118663,5933,112730,HfEnetJ7uBSmZWCjBNxdvv9HEC5nsW4wDV7wu6WnhWan,118663,2499335,-2380672,390
2022-01-22 02:17:53-05:00,7405,3C2MZQKh9x4zNTCMbhhvoafGaFMwUooqfy9MCgPyXs6E,AHjgWKpYPWe6ketjDHDKFBFsKQiRJ41jnkuo39MVYxZo,False,4902698,4902698,240221,12011,228210,4BnQKPLuE3DMTtxp8MjUBytgnhvxqq3ZTqZHTVZo4JJh,240221,4827368,-4587147,489
2022-01-22 02:17:53-05:00,7406,BvoctLT1kkt7sM4C2H26hSKXcjAgreYRTj7rkGt5SPJ2,EFKKd4Upox5TzBSAT96oxfeKBVEfDeE8yxnG3qoMJVGY,False,4424282,4424282,210143,10507,199636,4BnQKPLuE3DMTtxp8MjUBytgnhvxqq3ZTqZHTVZo4JJh,210143,3754201,-3544058,474
2022-01-22 02:17:53-05:00,7407,BEpTAoTBPSNi7axppx2AC8frxWHptPBxtNPentBa9dHA,8uBZccwMQQcibm59CkwrQyhfrw3aLm6VX2bKjpEoEMrm,False,5395515,5395515,242335,12116,230219,4BnQKPLuE3DMTtxp8MjUBytgnhvxqq3ZTqZHTVZo4JJh,242335,4404335,-4162000,449
2022-01-22 02:17:53-05:00,7408,GcjcaWoMUcGkLaJBx3svxtzwGNn5SLcFrwaLqnpadUZY,Ep9sDjTMMasVjKdshsE88uk3mWYkKuMTVRooVJWvCq9F,True,91606671,22901667,119815,59907,59908,4BnQKPLuE3DMTtxp8MjUBytgnhvxqq3ZTqZHTVZo4JJh,4792624,74297973,-69505349,523
2022-01-22 02:17:53-05:00,7409,5RvNKzSeJ1fvqsKpcQu25evEZGmKjyEDgwsMZkykoT3P,BRqSGfE4XHXu4HrinwetWumfVTmr82iuF6Y5oSV6eMiK,False,3374,3374,136,6,130,4BnQKPLuE3DMTtxp8MjUBytgnhvxqq3ZTqZHTVZo4JJh,136,2348,-2212,403
2022-01-22 02:17:53-05:00,7410,BAczoNDnbwj5AJX5LwzynzYab7ji7VbhRy9edA9Prax,34sbkUKnMetUNyMs6BhiWut85d5UZtBWnPtwx8jEpJNA,False,29888,29888,1174,58,1116,72FwbpFGoLEazJEdpqNtPNefsadUrimUqma9wSoy4qiS,1174,24739,-23565,392
2022-01-22 02:17:53-05:00,7411,69byqtDPmgEY1NqKBCR95CEPVHRUxgbNW9Y4P4HjQ7ND,E47T4q4zMGzNL6vDxgWdLn3EQbW3WfVryr8Jsymy1hAL,True,9977324,2494331,13935,6967,6968,3zqXX6kzhkbW3d4TwD2CNjMRwxTbREXySekvq37kfCNk,557408,7263935,-6706527,558
2022-01-22 02:17:53-05:00,7412,3MEiFqy4F9nBW8gHxvGjv7norSBHwxhbzzNKngPk1RHq,2tcsJ4NUJegcEfHNwWPh979yKjKmq568CpNm5iWGbuoR,True,2029385,507345,3107,1553,1554,3zqXX6kzhkbW3d4TwD2CNjMRwxTbREXySekvq37kfCNk,124286,1198415,-1074129,612
2022-01-22 02:17:53-05:00,7413,Go3ne58krEsFsZ5yu9EBT7od15VCYmtbs1KhumRMTiXS,HCvwQ7HjmmeDXrguZQPrAbJjcCJzHqVZK2JMSFkFDWfe,True,2071609,517902,2873,1436,1437,3zqXX6kzhkbW3d4TwD2CNjMRwxTbREXySekvq37kfCNk,114944,1750708,-1635764,554
2022-01-22 02:17:53-05:00,7414,DdAPWdHnb7ocaYtcwwwYnppsH39sZpmzMyANeoJbCV7s,3BVmC39L8dEypPN1BZhsf9bx9Ge2sXCZR8Y6RH4eBNMJ,False,24359769,24359769,1088129,54406,1033723,3uL2NSR2ZdDqCiKfzA5SwwpddAnit22DBJo6uvvz1rRs,1088129,28653321,-27565192,446
2022-01-22 02:17:53-05:00,7415,BLJgLzizx2yLgd12pVBAHTMqn9J5JA3JHCF8PnLnPyUk,HhDmwMysBFWhXnd3mrV31w75WBRKBS8wJSiEMZgqdUSp,True,23669965,5917491,29741,14870,14871,HfEnetJ7uBSmZWCjBNxdvv9HEC5nsW4wDV7wu6WnhWan,1189659,19752342,-18562683,502
2022-01-22 02:17:53-05:00,7416,6BQVtmNsxihi4PcA7MurtguTwa6SmbmKyP14RHyjVZkf,7ZFv5ms4HzVKiw7KgE8RUoKxW9rB6JUD7ujZxMx4DwnM,False,76769,76769,3822,191,3631,3zqXX6kzhkbW3d4TwD2CNjMRwxTbREXySekvq37kfCNk,3822,53750,-49928,497
2022-01-22 02:17:53-05:00,7417,FtF3PVw8YNJseWPMcA2GEuQZ6nni1mq5kYPa2LrSzfkW,4yr1TM2dXrBvLNMpSaoryuGU2P8D3WG1ZCkvVzWFiQRH,True,8672729368,2168182340,12417375,6208687,6208688,3zqXX6kzhkbW3d4TwD2CNjMRwxTbREXySekvq37kfCNk,496695030,3228009382,-2731314352,572
2022-01-22 02:17:53-05:00,7418,Hqzz5RdbkkmMPCVdxF3Q3sLuh7XVJHEwAP6zpz7pCwTj,TNwXSETgrJGM9S5zbBY3mMWKbPFskbKjPAhBrWFNfuK,True,5385428,1346357,7198,3599,3599,HfEnetJ7uBSmZWCjBNxdvv9HEC5nsW4wDV7wu6WnhWan,287950,4358387,-4070437,534
2022-01-22 02:17:53-05:00,7419,67Z7ZGhNu5xxEh9BYKWcXp9m1T4tFiE1o1M16hCzUWQA,CT7YKWixz7BhTbvg5F6M5HCyPGnHoFLNFuDV9GhoLTo3,False,75183,75183,3492,174,3318,3zqXX6kzhkbW3d4TwD2CNjMRwxTbREXySekvq37kfCNk,3492,74342,-70850,464
2022-01-22 02:17:53-05:00,7420,A3E9T7xYkPeNiWKdvhNTYiD5j7k2Xecpe318eFqVro4m,2QJk8iVJEy2QZmbFHnR7RBJsi7NpXWFFkEmweWtKKHfE,False,44986066,44986066,1848421,92421,1756000,3zqXX6kzhkbW3d4TwD2CNjMRwxTbREXySekvq37kfCNk,1848421,41023208,-39174787,410
2022-01-22 02:17:53-05:00,7421,5sN3cfz4hZjwy2HkAStKWeL8wHhdbkW8F7USzwCzmggh,Fme7U7QY92biAsV3RR2Fj7rJPnpdcov13mmFhVDFuyYG,False,16562647,16562647,816185,40809,775376,HfEnetJ7uBSmZWCjBNxdvv9HEC5nsW4wDV7wu6WnhWan,816185,12631573,-11815388,492
2022-01-22 02:17:53-05:00,7422,BXMMFy2k9b2hVBEG6RyXAq3qqXxJ7EY2xhyPZqtLvBiU,KpoZwr4ZFTHJgebbf4tcjT9iKvpC1EF8Aw4uaVPxXNd,False,1500265,1500265,68670,3433,65237,3zqXX6kzhkbW3d4TwD2CNjMRwxTbREXySekvq37kfCNk,68670,569333,-500663,457
2022-01-22 02:17:53-05:00,7423,3EgUBHBeKWegibDcCsTGaGehnwHYvpMbcPaT1UTbwQ49,Hxd4dsnLD8uHnG7KR7GVmKXBcpN1egMUvoTccPvBcaYA,True,196845609,49211402,299718,149859,149859,3zqXX6kzhkbW3d4TwD2CNjMRwxTbREXySekvq37kfCNk,11988730,157801269,-145812539,609
2022-01-22 02:17:53-05:00,7424,CRaKcudjkQiSw5YPVjTLVdXvJskeGiHSYtq5ZcMPJhgQ,AgqTg3b3bAcaBmRidhNC4Uf9ZwNbeH52RQEqumWyuUs7,False,20045,20045,933,46,887,3zqXX6kzhkbW3d4TwD2CNjMRwxTbREXySekvq37kfCNk,933,20575,-19642,465
2022-01-22 02:17:53-05:00,7425,2FrqGFZjbiNykJyo9BZ5S9FguQJPJiTi681rJJsQ5dta,3QUncYP92NKrfpaTvuF9iQg11PXKgZAgEngwh6BbnCCj,False,18995,18995,743,37,706,3zqXX6kzhkbW3d4TwD2CNjMRwxTbREXySekvq37kfCNk,743,14780,-14037,391
2022-01-22 02:17:53-05:00,7426,9UyQC8vc6zJJaSdnjvTAzgmcsw4fC3xFBBiCC1w9Sbjx,3ppBfboe6FPmt7f6WrivspMUoAznZKWQMeh3rCgw7vjQ,False,206193,206193,8596,429,8167,3zqXX6kzhkbW3d4TwD2CNjMRwxTbREXySekvq37kfCNk,8596,140638,-132042,416
2022-01-22 02:17:53-05:00,7427,DGAQzgZhS2yioeZmG3cbacM3hdz4F1aZn1PWRwgiFukc,48KUtJaNCPNxkLXJBtWAdDxY4b9vZzLgbGxTNdwMqmjz,False,12098861,12098861,548849,27442,521407,3uL2NSR2ZdDqCiKfzA5SwwpddAnit22DBJo6uvvz1rRs,548849,10158229,-9609380,453
2022-01-22 02:17:53-05:00,7428,BJV5jbowrbELXfDvfMovaQy4PiRf12pLYHimW9bgzW5X,6WXrWso5FvLx7RMCFBzrbzh5qevKkk2LJAihUfWXxXzB,True,501284,125321,638,319,319,3zqXX6kzhkbW3d4TwD2CNjMRwxTbREXySekvq37kfCNk,25548,648654,-623106,509
2022-01-22 02:17:53-05:00,7429,6oroGB3mvzK3tDfiB9X2NJuL3x476pxhgRnt7VxqhdLo,2SoK8tKkLn2ppKURpTVazKsCEis4uahkHMsac1m85J4r,False,41475,41475,1944,97,1847,3zqXX6kzhkbW3d4TwD2CNjMRwxTbREXySekvq37kfCNk,1944,55602,-53658,468
2022-01-22 02:17:55-05:00,7430,4FgDZBsdPTL7Q9Nrw8fgxFuRk1YBv3ETbRS5Hx5ZJTVT,8jDJz1EcGDts6c6eFowYRBWrVjLJabhLRaai6p5KqP2D,False,5006735,5006735,213715,10685,203030,3zqXX6kzhkbW3d4TwD2CNjMRwxTbREXySekvq37kfCNk,213715,4109979,-3896264,426
2022-01-22 02:17:55-05:00,7431,6Bq55LtGCEeGqh4JrFLCmmGc2iJfTTBJixivqH78aGSE,DSNrCgWJeNe2P9tAQu5FvCueTzNKDKds7wzuwTQSMRG,True,159093,39773,206,103,103,3zqXX6kzhkbW3d4TwD2CNjMRwxTbREXySekvq37kfCNk,8245,118140,-109895,518
2022-01-22 02:17:55-05:00,7432,H6fVnghBUSJRKp2mxSG7Fq2Lr4dE3YMS7yM1XTrxoe3Z,JjgtLi79grUZXofhWukB1yNXZkXFMUX5jm9HcXNDsB6,True,523018,130754,752,376,376,3zqXX6kzhkbW3d4TwD2CNjMRwxTbREXySekvq37kfCNk,30081,351685,-321604,575
2022-01-22 02:17:55-05:00,7433,ApAgbKGyEYXRonGM33w56ZxHQNAGSd9ji4K3zAGN2yA8,FZAhAUDtEaNsFmh4fP8uXNjoHneNkpZ2wQCfEeU4RYRM,False,2338116,2338116,106906,5345,101561,3zqXX6kzhkbW3d4TwD2CNjMRwxTbREXySekvq37kfCNk,106906,1696275,-1589369,457
2022-01-22 02:17:55-05:00,7434,5FeoHTpVt8u6m52SUq8P8Pe8LqHJLweZWA5eY8H8dswU,HUPUcjwBMVa6SZXjPqSTXtgnTEbmy9pX7nY4zVzzPYDA,False,7559614,7559614,341040,17052,323988,72FwbpFGoLEazJEdpqNtPNefsadUrimUqma9wSoy4qiS,341040,6187326,-5846286,451
2022-01-22 02:17:55-05:00,7435,9U25LWBU67c9S6L9F4qmjpTkaHqjFgxyuTCqQ7Zqj62g,ESyDCGZWamnabH3NNvus52X6Z9YAmt3y8oB8zYLmhfX3,False,238815818,238815818,10741708,537085,10204623,3zqXX6kzhkbW3d4TwD2CNjMRwxTbREXySekvq37kfCNk,10741708,96443887,-85702179,449
2022-01-22 02:17:55-05:00,7436,8Ttfg27wadhtnXPGoYFcawMaRJ2EXAqmmcQhbyjYrwQL,DXmDDubD8DoX7ZaRtQLFoZtvVmYKB61ht3w9QZPW3nKD,False,11017327,11017327,502307,25115,477192,72FwbpFGoLEazJEdpqNtPNefsadUrimUqma9wSoy4qiS,502307,9002635,-8500328,455
2022-01-22 02:17:55-05:00,7437,4mB2DVbQVqVk535v98Cj8SPNg1tTc3DFyY2Q7VBbY645,HXo255k3RgsTGsc4hiP6ZTXUspBTqJ37duQa5eK7tqp3,True,29502127,7375531,38537,19268,19269,3zqXX6kzhkbW3d4TwD2CNjMRwxTbREXySekvq37kfCNk,1541480,19291809,-17750329,522
2022-01-22 02:17:55-05:00,7438,4SX2pj4eHRwFMtyDCrMZ8ZT6ASAMi7yfZWZnccw5dGn8,Ads49ZqvTmPHxfzNYm4oJb4HBYhwS6vXQbarqmpUi5VZ,True,4903980,1225995,6196,3098,3098,3zqXX6kzhkbW3d4TwD2CNjMRwxTbREXySekvq37kfCNk,247840,3986483,-3738643,505
2022-01-22 02:17:55-05:00,7439,9PREuyML3TWUx7PnbAvMYhbQnDnorb9ng2vBSerAZCsr,G8Lzjw7xpKFTmbsWtRXR79sDvekwK1gqvQthZ5DxNEQJ,False,5155120,5155120,226160,11308,214852,3zqXX6kzhkbW3d4TwD2CNjMRwxTbREXySekvq37kfCNk,226160,4215068,-3988908,438
2022-01-22 02:17:55-05:00,7440,J1wNRFhQYLnTcbU8tnCFNYNo7sWaxAXhybEyR1YxsUba,G7m6N7Ew4dqTTVbYpLgQbzZdjzNNzsy3KwFhGJPYMBCn,False,6147819,6147819,243999,12199,231800,72FwbpFGoLEazJEdpqNtPNefsadUrimUqma9wSoy4qiS,243999,5046544,-4802545,396
2022-01-22 02:17:55-05:00,7441,brCL9pzP6q4b6rKgAH1AJbMoqffBWyXLX8oAnZDoi77,Dx4G5UP9jTb47JQypWJnv48mPTzhJvqPD1BtBtDT7TJF,False,186976,186976,8639,431,8208,72FwbpFGoLEazJEdpqNtPNefsadUrimUqma9wSoy4qiS,8639,84463,-75824,462
2022-01-22 02:17:55-05:00,7442,Cu5b14TQN3N2HoboxGMDxXf3tMCsz4QZDi6JEMAExE2o,BCgKRk4XKtFv35ss9ThFqYXpzdQMHwNwQNa4EzLcwoGj,False,7412523,7412523,328448,16422,312026,3zqXX6kzhkbW3d4TwD2CNjMRwxTbREXySekvq37kfCNk,328448,6053032,-5724584,443
2022-01-22 02:17:55-05:00,7443,HZJyrD4eqM4nKnyRh2JAs1sC2TaJxFhNPixBdK7PLMuS,Hycz71z4tEsKUogJnefT2GN3MPCLdTJdv9B6T82Ngw2u,True,26002331,6500582,35382,17691,17691,3zqXX6kzhkbW3d4TwD2CNjMRwxTbREXySekvq37kfCNk,1415307,21239571,-19824264,544
2022-01-22 02:17:55-05:00,7444,96StvqZyFUPtyMr4o9s7K4V29RSNyRpVi76vNwxG5rUf,GZKXFSFq4aGiTaqovtxqNCCVGkAFNXPh4Hep1ZMwdZ8g,True,534771,133692,686,343,343,4BnQKPLuE3DMTtxp8MjUBytgnhvxqq3ZTqZHTVZo4JJh,27456,724612,-697156,513
2022-01-22 02:17:55-05:00,7445,52hhBAuVyifMNFKGQmSitc8smiEgscXQMzVuZj55j7E5,6B5DBJx9NLytR3fkrYqe5W5ek4rUWsR4nPsRTvRfRwzC,True,198121245,49530311,299629,149814,149815,3zqXX6kzhkbW3d4TwD2CNjMRwxTbREXySekvq37kfCNk,11985177,158904051,-146918874,604
2022-01-22 02:17:55-05:00,7446,HoJ3Re4BmCYKMJx2RUYtoHfg8ncEy3iFqvWJDGKqfMBV,2qg4FMcurNDVRzXYKwpzEYapxFECnAyU2oGmxQCSf3hf,True,4979122,1244780,6913,3456,3457,3zqXX6kzhkbW3d4TwD2CNjMRwxTbREXySekvq37kfCNk,276529,4209705,-3933176,555
2022-01-22 02:17:55-05:00,7447,2ijaXzGryTmRqqjnHpPrdJfR3gokGhTfeYfHQVMydrtq,569ktfvZ3BSQ9yTRmgNDhRcPBPfWmKoW8FMpLkwiBnVB,False,6975717,6975717,333245,16662,316583,3zqXX6kzhkbW3d4TwD2CNjMRwxTbREXySekvq37kfCNk,333245,5687134,-5353889,477
2022-01-22 02:17:55-05:00,7448,E1CShgy7M9998q9jyzpnHZxHJR6z5hvnshUJt37kVPtG,96f1nYW4S9APCJS3TXTGSb9UcJDdxJuoBR3pLYqcNz2b,False,4092685,4092685,204720,10236,194484,3zqXX6kzhkbW3d4TwD2CNjMRwxTbREXySekvq37kfCNk,204720,3238552,-3033832,500
2022-01-22 02:17:55-05:00,7449,FV9CBGGTbppLnBKh79f2LzD1diTiS5g6u89FcpZHZmnK,Fe7mtmCUziFqbbYTvrhAcAq1Ub7YLfTJRtQ1hG7GzJD1,True,126005,31501,158,79,79,3zqXX6kzhkbW3d4TwD2CNjMRwxTbREXySekvq37kfCNk,6339,94460,-88121,503
2022-01-22 02:17:55-05:00,7450,2WG1vzMHrYu1UdNjWccbzigwXaC3BcPqSmDTgHnEgSjz,26MRaqCvaK37n8YKepmVS76zSsqKj9CefJQSQFts5yno,False,238109148,238109148,10563203,528160,10035043,4BnQKPLuE3DMTtxp8MjUBytgnhvxqq3ZTqZHTVZo4JJh,10563203,211606377,-201043174,443
2022-01-22 02:17:55-05:00,7451,3Lv2XpiD4KBUHq7Zx6u3zNhpXoySodXHH8o8f5yaaPxG,H6TN4rhpBXkEH3mZnymYNcKfmnxRH2uzfwzeLH2q6ahP,False,4295,4295,166,8,158,3zqXX6kzhkbW3d4TwD2CNjMRwxTbREXySekvq37kfCNk,166,3449,-3283,386
2022-01-22 02:17:55-05:00,7452,3YnVYS7agSrGNeJXh9GXLHQJRSHYWKGe9gWwKese1X4B,CnV77x6ehrba1eUeqiAMc5yKug8opZxbd4tnDu2jw1Ae,False,5948258,5948258,265735,13286,252449,3zqXX6kzhkbW3d4TwD2CNjMRwxTbREXySekvq37kfCNk,265735,4860186,-4594451,446
2022-01-22 02:17:55-05:00,7453,HXnDgvqsDggo4JYq7JW7iPcXvfs9q6qt9aPV9qArNdZZ,Ho33vrWReuJYuyST6GooRYG3tdRxBe9NrKoknajUbEcR,False,8054610,8054610,369842,18492,351350,3zqXX6kzhkbW3d4TwD2CNjMRwxTbREXySekvq37kfCNk,369842,6566770,-6196928,459
2022-01-22 02:17:55-05:00,7454,8aeFnGu1MWr1zicKmmYHhpnyt1TqdeYBtNrqUpMNHwWQ,4Zki9YB787eExNToiBkNRhne5QqJUvPHWmvG33g2xXf2,False,3849374,3849374,177449,8872,168577,72FwbpFGoLEazJEdpqNtPNefsadUrimUqma9wSoy4qiS,177449,3146801,-2969352,460
2022-01-22 02:17:55-05:00,7455,BjyZWwz1ARSfmPkHXHBzehq5NsH4DRJiu4zFMkqsKu6A,7WUCSZ9SnKDsbomDRZ7CKsHfHJFwboKJwFFdaGkBURBS,False,112321845,112321845,4430184,221509,4208675,3zqXX6kzhkbW3d4TwD2CNjMRwxTbREXySekvq37kfCNk,4430184,81954962,-77524778,394
2022-01-22 02:17:55-05:00,7456,43wwd6zLB8yKfXEu7rtbeDFhKBuxFR66MnyhTKW3zqa3,A9t6AMvVNenwWymz3QMtdUuuGYjjTPLaA9bhRjTzNY9h,True,93872785,23468196,122047,61023,61024,3zqXX6kzhkbW3d4TwD2CNjMRwxTbREXySekvq37kfCNk,4881899,76163509,-71281610,520
2022-01-22 02:17:56-05:00,7457,DZ39kEQZn3qA98LxtGmKU6yhWDuiH6Qjqi52VNrvWzRw,D3XS2JoLKi8KiKrWpq9YegcH7uLQ5n8xdpymMMf8jUrR,False,3731748,3731748,161256,8062,153194,3zqXX6kzhkbW3d4TwD2CNjMRwxTbREXySekvq37kfCNk,161256,3176966,-3015710,432
2022-01-22 02:17:56-05:00,7458,Bbd196A866Y9rQWQFt4YGg2R6Jqj7WQGXWPDmrNtPcKf,5gmWk1KwLoRHnhkjxps4Ad6aVk4ZpcfC3McZCWDVCUbu,True,5795754,1448938,8309,4154,4155,3zqXX6kzhkbW3d4TwD2CNjMRwxTbREXySekvq37kfCNk,332360,4895456,-4563096,573
2022-01-22 02:17:56-05:00,7459,GM22yjVoBCzgBcVTT5EcgRhVWiXVV82kSj1dPCbegKWj,CDDy8JmJMwJyx1YAvEPpj8AYxCpngRovf3wWfVzao5Rc,True,3572978,893244,5022,2511,2511,4BnQKPLuE3DMTtxp8MjUBytgnhvxqq3ZTqZHTVZo4JJh,200887,1370843,-1169956,562
2022-01-22 02:17:56-05:00,7460,BFs34P4fwk5wYXr8dQGiVNLACM64sebEfJAaFXd86aMV,H6MpEFEHgdsBZuGSpfKznAaUaCPuEwsgLjcNCPm3kzmQ,False,3230942,3230942,157614,7880,149734,3zqXX6kzhkbW3d4TwD2CNjMRwxTbREXySekvq37kfCNk,157614,2740984,-2583370,487
2022-01-22 02:17:56-05:00,7461,AATMHH4e4B6SL9bThnXGktzWuqWkPdx3JbRXk8HwkbPW,6F3u2yLx7P9gtpAAXASx7uF8xNyVBgJiKosMKUrgpicA,False,5757691,5757691,232723,11636,221087,3zqXX6kzhkbW3d4TwD2CNjMRwxTbREXySekvq37kfCNk,232723,4521784,-4289061,404
2022-01-22 02:17:56-05:00,7462,GqAS41YJssg9aaEp3hs3sG98APCsXhiQBQszXaSjZ2bN,2wodJ3AhrXdE1T4oVL95KvoBND7PubG5Wd5GWiLCMZJU,False,4398094,4398094,218446,10922,207524,3zqXX6kzhkbW3d4TwD2CNjMRwxTbREXySekvq37kfCNk,218446,5681969,-5463523,496
2022-01-22 02:17:56-05:00,7463,5rW9kqXB9feGSKSvSMNJF1FCsBYV3vGmTmc8MvzaZ3pi,7AjnjcfPJevW5521hXw4VtgRCfHSsAqyzyArukKfNcHo,False,254633,254633,12419,620,11799,3zqXX6kzhkbW3d4TwD2CNjMRwxTbREXySekvq37kfCNk,12419,231311,-218892,487
2022-01-22 02:17:56-05:00,7464,8VQ21PFXdHBNmiZiF18LyGvsRSpr13vkyktfembNCe3m,5exbVC7vaGFeHEGAx7epYfMaU932QafqzfhFm5FKAq2H,True,5465548,1366387,7520,3760,3760,3zqXX6kzhkbW3d4TwD2CNjMRwxTbREXySekvq37kfCNk,300823,4418445,-4117622,550
2022-01-22 02:17:56-05:00,7465,BJaaH1SK1pF2kZQzmYpLFfDtm52CR9a5rd39RAPtLe8q,HUsT5FVxaisdnCvG1BQxX6zffjfL2Rwx5mMo5y8SDV7e,True,3214005,803501,4724,2362,2362,3zqXX6kzhkbW3d4TwD2CNjMRwxTbREXySekvq37kfCNk,188975,1648627,-1459652,587
2022-01-22 02:17:58-05:00,7466,6Z6y2QLJUZ5s6zdjanJcKprTAotx8tqr9DRNqqycMeS4,JCYwt8MHVaBb14GB2qAvDWwYVMaL7VTxyNEt7Eo5Zy8x,True,4934625,1233656,6250,3125,3125,4BnQKPLuE3DMTtxp8MjUBytgnhvxqq3ZTqZHTVZo4JJh,250002,3999766,-3749764,506
2022-01-22 02:18:00-05:00,7467,9WRDBHzD4aNHw5qvrhc6nqXCBLA5D7YYP8TvSrLksXd6,GwxWNmv9XDkqQsx7DfCMccFjVik8asPnFU9gtnb4UVx,True,4674574,1168643,6295,3147,3148,HfEnetJ7uBSmZWCjBNxdvv9HEC5nsW4wDV7wu6WnhWan,251806,3784469,-3532663,538
2022-01-22 02:18:00-05:00,7468,FF8rqfM9PTEjYiVFy8jS81weDRwdaYooux2uSa2LexrJ,JBk1JghH1gged1YpDbkczFXP9ka5ivYSkaYoVbbXD4kg,True,4344110,1086027,5481,2740,2741,72FwbpFGoLEazJEdpqNtPNefsadUrimUqma9wSoy4qiS,219268,3793497,-3574229,504
2022-01-22 02:18:00-05:00,7469,8GdYhwX26GRmVfGFCbJ3MJrH1UdneN2FNRUexhLsqprN,DpUTHSVucDPyCWoLCdpm8EFRZFiKL88tmnSiWG2TRpS8,True,5403463,1350865,6948,3474,3474,DddJ7EWCmYEEZETCBNgAUSg81Ls6fZtiAaY5ekJ5sXx1,277926,4354784,-4076858,514
2022-01-22 02:18:00-05:00,7470,9rgrRAMcGSarfz8xXckw1LjkemMwwjzJLApPjpfY2XZ3,BRtNdDDtCiNDYDERZTBCefUiYvjShucRX1hxEBLyeggT,True,4755421,1188855,6126,3063,3063,72FwbpFGoLEazJEdpqNtPNefsadUrimUqma9wSoy4qiS,245063,3859140,-3614077,515
2022-01-22 02:18:00-05:00,7471,AzLdwyd8Q4V3iMaSwWgvWwQ9nCs7X7YV2YKpd6CH33nP,BYjeXF5YkcJy3mNMbvfHzXTtyjkc4U53hM5tvfERUH8y,True,6005218,1501304,8237,4118,4119,3zqXX6kzhkbW3d4TwD2CNjMRwxTbREXySekvq37kfCNk,329498,4855750,-4526252,548
2022-01-22 02:18:01-05:00,7472,CS2Wbk1Sd1aix7kSiQhHW2Q4q63DcZFvqsio5NTUeDiH,7dFYg3VuTG9Scg1J42ouZ4wnSnXqVB8LDfwamYnH1XWK,False,30687480,30687480,1405541,70277,1335264,3zqXX6kzhkbW3d4TwD2CNjMRwxTbREXySekvq37kfCNk,1405541,28013535,-26607994,458
2022-01-22 02:18:01-05:00,7473,E8ifvhmyJGBGVQomo3AnZw2UcaLHcpGsTtuoCid8voU3,FMQUWTbTAfSLfrc6GTrz4DM2ZSgoxF3KtqGn8AyjVtsf,False,163722,163722,6597,329,6268,3zqXX6kzhkbW3d4TwD2CNjMRwxTbREXySekvq37kfCNk,6597,116170,-109573,402
2022-01-22 02:18:01-05:00,7474,68F35fonSGS1P6LMYmAmeoM8kC6Z78NabMqYLeCZr9GJ,8apmWSZdS8s1ScoNVj4AvSJsbQCj1drU3HL74khuANT2,True,6424673,1606168,8780,4390,4390,3zqXX6kzhkbW3d4TwD2CNjMRwxTbREXySekvq37kfCNk,351222,5198814,-4847592,546
2022-01-22 02:18:01-05:00,7475,DMgD2KCEhTGFLUZ5GnfNcwfiiwKYbyVpoWiN6knMkCAf,5KU2vgBkPTNVHsSULjgX7ZkZS56U3Dy3xqLTxL5sUZJ3,True,33027474,8256868,42065,21032,21033,3zqXX6kzhkbW3d4TwD2CNjMRwxTbREXySekvq37kfCNk,1682631,33899007,-32216376,509
2022-01-22 02:18:01-05:00,7476,2F45BX9mRmtNCHPejKFknN5aNgGvR4vVLFjMaY1a7dR8,ALdSutsvEFRUEQGGBbi31QywTL1pdXSDWrNJzvNTaoXL,False,576808,576808,23035,1151,21884,HfEnetJ7uBSmZWCjBNxdvv9HEC5nsW4wDV7wu6WnhWan,23035,490129,-467094,399
2022-01-22 02:18:01-05:00,7477,7EvJoetxJVTgpJXqE1VC3fZN1CQ5xdWdv29yCiDuH9gU,6RTEusjGEHNDdMj75qkpzYHjHZ3R2XN5xvptCwkRJz5j,True,6744134,1686033,8525,4262,4263,3zqXX6kzhkbW3d4TwD2CNjMRwxTbREXySekvq37kfCNk,341021,5483189,-5142168,505
2022-01-22 02:18:01-05:00,7478,2jPxG5FL6D6XEJsRszJ9cmQ54AWSpZyPFSbn3DpWBSuM,3toQou4UVNvyWYvMvkuv379RVEF2aN2TzCpKKBUqeQV6,False,4470863,4470863,222712,11135,211577,3uL2NSR2ZdDqCiKfzA5SwwpddAnit22DBJo6uvvz1rRs,222712,3545352,-3322640,498
2022-01-22 02:18:01-05:00,7479,5q7BsF2SxXYB6VcZcuwQr2WKqcTRWZupUsZqDB3pvZbS,D83ENcsAJmiGyzCTL8dr5y8DEC9kE7T6SKPCnNLxBaMd,False,2574489,2574489,111108,5555,105553,3zqXX6kzhkbW3d4TwD2CNjMRwxTbREXySekvq37kfCNk,111108,1624219,-1513111,431
2022-01-22 02:18:01-05:00,7480,6fqbSyhh3PPdgRcLraHb7Jahj9s1oHHeX3SsjNSsGa6t,GpRUow48TYgttdYfsygbgjYQcmHyYjWETUDjDVphEgwq,True,10416663696,2604165923,13687656,6843828,6843828,3zqXX6kzhkbW3d4TwD2CNjMRwxTbREXySekvq37kfCNk,547506266,4146067790,-3598561524,525
2022-01-22 02:18:01-05:00,7481,FKQVm9RsteDe7dQmwx4NGYhz3Wrvwh7TCp9rFbTgAomx,Dbwox8eRCdmH5KXyi5sBaqWzhxtaVPo1teWXJ2kRFT1f,False,15975043,15975043,787709,39385,748324,3uL2NSR2ZdDqCiKfzA5SwwpddAnit22DBJo6uvvz1rRs,787709,20039253,-19251544,493
2022-01-22 02:18:01-05:00,7482,CCi9urfx5bFFMazAAVz1WtJzJotHA8E1i8RrtgMP97Fp,2DFvm5fZj29qvqoLmbReUaisd9qBTNUfuE7HgmmHUc7w,False,1825724,1825724,75586,3779,71807,3zqXX6kzhkbW3d4TwD2CNjMRwxTbREXySekvq37kfCNk,75586,1784550,-1708964,414
2022-01-22 02:18:01-05:00,7483,4cKgCTttVp8pzJnp43PP7uLLUXNcU7YGPJ3cCGHaUFe7,BBQqjwTpVEgpDzMk4wDDH8rCjaSxCRPWVhtFxERSujTD,False,936300,936300,43974,2198,41776,3uL2NSR2ZdDqCiKfzA5SwwpddAnit22DBJo6uvvz1rRs,43974,746768,-702794,469
2022-01-22 02:18:01-05:00,7484,FwTGq3BeMLyRFRa5r4E6nySLgoLNcNdqJsCQxA2i6uh6,88w6ti3WSriyu2FvNjVfrLpGyU5PUvaiJyqrAGPM8TKp,True,5709461,1427365,8905,4452,4453,4BnQKPLuE3DMTtxp8MjUBytgnhvxqq3ZTqZHTVZo4JJh,356218,4578362,-4222144,623
2022-01-22 02:18:02-05:00,7485,3HUAjpBLM9XnT5W8p7asjjh1s8GDBzHL55AbsvBPsZ2e,6g6azPhma25H5q8HEATFAcXKg7UokmzPXzXDBr7QKbTL,False,3343559,3343559,138215,6910,131305,HfEnetJ7uBSmZWCjBNxdvv9HEC5nsW4wDV7wu6WnhWan,138215,2848408,-2710193,413
2022-01-22 02:18:02-05:00,7486,HVZkXeDR3mc8oB9qFFwCK4RXpPojdcHk9tRGep6xtKGK,Bh3py7awPejWqeTMxtAgF7mPotL2Asxf8YrYJykq9nBt,False,152644,152644,7243,362,6881,3zqXX6kzhkbW3d4TwD2CNjMRwxTbREXySekvq37kfCNk,7243,122196,-114953,474
2022-01-22 02:18:02-05:00,7487,4eba4qAmwfqmihaYvTWFU9hm4VYrKvNhNywHNyimQJNK,G1DyxJcNQD8u4KGfnwxttyrJMfse1FBAsofioEMdTS9U,True,37524159,9381039,52527,26263,26264,HfEnetJ7uBSmZWCjBNxdvv9HEC5nsW4wDV7wu6WnhWan,2101111,30570286,-28469175,559
2022-01-22 02:18:02-05:00,7488,4cNmhgaMic1xBiaDJ6phrQuXmm8WfF1qjyYMqZcKG4c9,43vgfXiLTtcs1bkrcDar2iz9M6RMbGqbA6BMkBHdh7T4,True,5661516,1415379,7592,3796,3796,3zqXX6kzhkbW3d4TwD2CNjMRwxTbREXySekvq37kfCNk,303713,4622257,-4318544,536
2022-01-22 02:18:03-05:00,7489,E8iuHK2DErFnMAYfWmNoix4jVb4WDG8Sc41hBycLUxbd,77Zoru23JmnK5EJ8eURonQoEpJcLP4edabjD8MR8NKdX,True,93404416,23351104,120358,60179,60179,3zqXX6kzhkbW3d4TwD2CNjMRwxTbREXySekvq37kfCNk,4814335,75824967,-71010632,515
2022-01-22 02:18:03-05:00,7490,8xQ3tsWVUe75EG1HmocULJ3kh52utveoFMEPotTGrKno,i3SKW3ywrwYucX9ySEx1C4zaUKGnzLerP3V38437NyV,True,3320214,830052,4657,2328,2329,4BnQKPLuE3DMTtxp8MjUBytgnhvxqq3ZTqZHTVZo4JJh,186311,2987005,-2800694,561
2022-01-22 02:18:03-05:00,7491,3oCun4gm3k8sXxVxiYM8okGi8iCXH9LvDkHf9PBQWYXR,E1np1dZ7jUm811ddvy1jQerBwGSYb5BbZWnUHeotvrfH,True,18653199,4663299,26155,13077,13078,72FwbpFGoLEazJEdpqNtPNefsadUrimUqma9wSoy4qiS,1046204,5106770,-4060566,560
2022-01-22 02:18:03-05:00,7492,GqFbV89UYbQ6aEW1bSvGnnsDtTPQfHPTHzisXPhLnaTC,6X7j3nqmugRyVVw83uSzgiPaemEscc8VdsnPEKDz4fg2,True,4856845,1214211,6896,3448,3448,72FwbpFGoLEazJEdpqNtPNefsadUrimUqma9wSoy4qiS,275873,3919737,-3643864,568
2022-01-22 02:18:03-05:00,7493,2hirR46fpyHEg1Fv9vAzYgnoNRBWaky7LoFGVof4DnpK,DXTEHauVDdz4Mjjj6sJHPUh6TnzU6ob6Nj63To2vCNPW,False,52130870,52130870,2407460,120373,2287087,3zqXX6kzhkbW3d4TwD2CNjMRwxTbREXySekvq37kfCNk,2407460,21808701,-19401241,461
2022-01-22 02:18:04-05:00,7494,2FEbsetZMkRqLjSC8GBbgecKgX5T1T1fci2sLQux29p8,H722Fcd6DkTFRZxqQWbPDufBfXEgmFfhiEpQZWhxwYv1,True,111853,27963,140,70,70,4BnQKPLuE3DMTtxp8MjUBytgnhvxqq3ZTqZHTVZo4JJh,5637,84032,-78395,503
2022-01-22 02:18:04-05:00,7495,G8nRLTWTT5aD7q7TcSa2mw7p12GUuHDVq5ev4vyXbdKi,3DmQyungZMK4T1a1PgXh5shBskwP69tTLmZPh7HZ76vh,True,8828635,2207158,12146,6073,6073,4BnQKPLuE3DMTtxp8MjUBytgnhvxqq3ZTqZHTVZo4JJh,485862,7140731,-6654869,550
2022-01-22 02:18:04-05:00,7496,2s9VGesQYbKr3LwuraMEa9sXbXz7f8299HPPAHgSaUdp,8uMS2GDsbmygjbRnc2gjwNkXKogmJX1i8nchmqt8ixCe,False,1037045884,1037045884,51751773,2587588,49164185,3zqXX6kzhkbW3d4TwD2CNjMRwxTbREXySekvq37kfCNk,51751773,837930704,-786178931,499
2022-01-22 02:18:04-05:00,7497,4eaXYcx5ayhTq9TmmQFgLDjy6p3z93txUN97v8PTSh1J,J3vgUnjDUy5ngrmrs6FwpZTexxJNxXM1UjsHvsgw9g9y,True,6023935,1505983,7882,3941,3941,4BnQKPLuE3DMTtxp8MjUBytgnhvxqq3ZTqZHTVZo4JJh,315313,4885868,-4570555,523
2022-01-22 02:18:04-05:00,7498,4pmhvxJcmebxtqN6RwVb9UbEtxpFXpuVN67Q74W6YAg3,B9fk51SEQmLbMDpQJV15f9gyCZhvEBWRXeLMnnmMqvfg,True,14065,3516,19,9,10,3zqXX6kzhkbW3d4TwD2CNjMRwxTbREXySekvq37kfCNk,789,11063,-10274,560
2022-01-22 02:18:04-05:00,7499,7E3Zc3g1eJ7ueosPPoHDSkhuHvBVfN41eXcJXWeffozU,CGA8dcsZjfLqSYijYmssZwd9TXAsvSafNVT6JvUajGdu,False,73654543,73654543,3294431,164721,3129710,4BnQKPLuE3DMTtxp8MjUBytgnhvxqq3ZTqZHTVZo4JJh,3294431,69317613,-66023182,447
2022-01-22 02:18:04-05:00,7500,7g9QK2NcF8gtToPAD6t3A2D7HxSQ39tjqmKkqqKWeJ6p,Gked479UxktYMAQm9z7YSzzqKLg81BnGwJdgmCnkRmQD,False,5501772,5501772,254872,12743,242129,4BnQKPLuE3DMTtxp8MjUBytgnhvxqq3ZTqZHTVZo4JJh,254872,4493204,-4238332,463
2022-01-22 02:18:05-05:00,7501,8MGEQ1KEMv9WSgVifjN7CQ7tDbJBJbWgGYu71dTDKEPQ,mQY2X9KYVXf9JmGY8XwMK4G8odM4HmWkgEmYYqKnkvF,False,3981867,3981867,191591,9579,182012,3zqXX6kzhkbW3d4TwD2CNjMRwxTbREXySekvq37kfCNk,191591,3573777,-3382186,481
2022-01-22 02:18:05-05:00,7502,2MVzj6GMPLGdpPasfioLbpzaut7TxbYm6ErfvGMv1geh,VypP2h4SUux1AYkcJheULXNYwy2WbofwSZf5CxGygTW,False,5696352,5696352,263580,13179,250401,3zqXX6kzhkbW3d4TwD2CNjMRwxTbREXySekvq37kfCNk,263580,4652419,-4388839,462
2022-01-22 02:18:05-05:00,7503,Dqnxcekm1QfxGQ2FSJ6SjFiwmaQRWEjW9WTJQG4AjEpE,9JiMtjm5AJqngosRg787FiN8NyuBPuAPD2jYpRQkAc1d,True,7868865,1967216,10799,5399,5400,3zqXX6kzhkbW3d4TwD2CNjMRwxTbREXySekvq37kfCNk,431971,6365426,-5933455,548
2022-01-22 02:18:05-05:00,7504,D96xbqPtmwTFYGi4tBUt2hiadLBuuKDgdBx9U2Uhuag4,CxCRjQVzLzFGLfZ5CCW9yCErbNacSEZqoKEetQd7gGbZ,False,4520744,4520744,190977,9548,181429,HfEnetJ7uBSmZWCjBNxdvv9HEC5nsW4wDV7wu6WnhWan,190977,3703539,-3512562,422
2022-01-22 02:18:06-05:00,7505,Dng7By2saPu5TVxcvXidBe71ggBo8tiHkAXPi4kKL1tk,75ufEJmHbLHffphL7tvAXhGyftKLr1z2PXXoB2GGY5fG,True,79995767,19998941,124920,62460,62460,HfEnetJ7uBSmZWCjBNxdvv9HEC5nsW4wDV7wu6WnhWan,4996824,22521488,-17524664,624
2022-01-22 02:18:06-05:00,7506,5yPGvUz6JWKjkViGwTCpygJii1rP2xv5yx146ULtBiYq,FMnHUCQWTf1UHu5qVFqUAsWh8aba9EQYTEoiXy55totD,False,112418399,112418399,5614165,280708,5333457,4BnQKPLuE3DMTtxp8MjUBytgnhvxqq3ZTqZHTVZo4JJh,5614165,47822823,-42208658,499
2022-01-22 02:18:06-05:00,7507,bNhTXZZUjCoZJUXUc3UHvwTVteMQbpjfK1dD2gazFRH,BzYUpBjMfZoJARiHaFrBsJoC4Dvh6PPA4WvrHx1WReHv,False,8511322,8511322,349418,17470,331948,3zqXX6kzhkbW3d4TwD2CNjMRwxTbREXySekvq37kfCNk,349418,6982838,-6633420,410
2022-01-22 02:18:06-05:00,7508,5iRLEmB6qBHqkJBPyyubnd9f1TpRr4EY8BTxuHUREeLB,GkY73KL6HJ4ycdggFtYWALBgmTRZVCx66P2ZJ7E8ENwC,True,5141389,1285347,6694,3347,3347,4BnQKPLuE3DMTtxp8MjUBytgnhvxqq3ZTqZHTVZo4JJh,267782,4173467,-3905685,520
2022-01-22 02:18:06-05:00,7509,3KAV1uTsuQrckk6oyGiAqsASaL4vTyYyEgha2moxhaCF,DCEHTaJTSfyE6hUh3gEdZpqhaezNb61JSPqjzo3nMUGS,False,5752661,5752661,262642,13132,249510,3zqXX6kzhkbW3d4TwD2CNjMRwxTbREXySekvq37kfCNk,262642,4705055,-4442413,456
2022-01-22 02:18:06-05:00,7510,9qucsGVWi5n6PQbjn7NCSU9M5Yu6D54puaiNY1p17noS,ExwHfJAHaHrAVVaLXZ8SSMxAXaMgxUvRbdCK2Cri1eq8,False,3691817,3691817,168882,8444,160438,4BnQKPLuE3DMTtxp8MjUBytgnhvxqq3ZTqZHTVZo4JJh,168882,3010377,-2841495,457
2022-01-22 02:18:06-05:00,7511,EAUFD16wab8qRMJ4H6updHGt4xFqgRCDeRHVCsLCTSTL,8vkfYSyCyBY9g4TZrp52jUcQj6udy9xAaA4fioRE2RXx,True,3619270821,904817705,4959001,2479500,2479501,3zqXX6kzhkbW3d4TwD2CNjMRwxTbREXySekvq37kfCNk,198360054,1492530517,-1294170463,548
2022-01-22 02:18:06-05:00,7512,EL9JxeMvWWLTdVC5QrZzSSgApEwv1nDhZc6yNmH9G8ad,EqSQLSFx1eKkTYAdv5XhekttqVh7TappXAHuv9EedCXq,True,2425,606,3,1,2,4BnQKPLuE3DMTtxp8MjUBytgnhvxqq3ZTqZHTVZo4JJh,124,1923,-1799,511
2022-01-22 02:18:06-05:00,7513,7afnF1MkAootZGWc7zsMVLpBuve83hGmvAHkfmwgsq5A,HKdJE8bReznq1Qxqd5iZ4nWQGCk62Vo5TpkRD51bpbGp,True,6201450,1550362,8318,4159,4159,4BnQKPLuE3DMTtxp8MjUBytgnhvxqq3ZTqZHTVZo4JJh,332727,5021679,-4688952,536
2022-01-22 02:18:06-05:00,7514,2ZX5NexeuZq25mAfBFDrwd44UfKhWgzmSwdhWFmo48c7,CpNnhSqg7EHn9g84gHoo831sVrAe5SkwNaEZAash4CXs,True,40898305,10224576,56421,28210,28211,3zqXX6kzhkbW3d4TwD2CNjMRwxTbREXySekvq37kfCNk,2256849,33351272,-31094423,551
2022-01-22 02:18:07-05:00,7515,HZSJVNb6g4o52N7pAJCLkGjur8evF5Ex1sAx7uUxUDdm,8LQHKhXStrwcd6f4AxaTVcrGdYpGjQz8vWf5JXsAzcsp,True,6924420,1731105,8909,4454,4455,HfEnetJ7uBSmZWCjBNxdvv9HEC5nsW4wDV7wu6WnhWan,356372,5625014,-5268642,514
2022-01-22 02:18:07-05:00,7516,BPsM1um9ZJf7eNoVMsQCRSwgARMuLCGGSDxf9tZeNeEy,BpzDdXfxVygiSYSmsHV6uPxQMeTFtrURMCCqhswQjd5X,False,27912,27912,1366,68,1298,3zqXX6kzhkbW3d4TwD2CNjMRwxTbREXySekvq37kfCNk,1366,21023,-19657,489
2022-01-22 02:18:07-05:00,7517,7EtGovzHsbD8cKGqq4R5rvKBbncR4Kc7CDkTjof2QBMf,8ShjeNWM2vcvUF9yYztYCHUQfcGsyg2A1LyWiPbQDDvq,True,1148859,287214,1776,888,888,4BnQKPLuE3DMTtxp8MjUBytgnhvxqq3ZTqZHTVZo4JJh,71041,921980,-850939,618
2022-01-22 02:18:08-05:00,7518,AECUZGm5DjFvbLZEUYhepSPg1Wa7hBjxF9e7ZRBzRPhm,Ar7e1iLKAqa54QiQnXifvnETixDZT1T8KL5YWJA8Ykv1,True,7314796,1828699,9976,4988,4988,3zqXX6kzhkbW3d4TwD2CNjMRwxTbREXySekvq37kfCNk,399059,5919623,-5520564,545
2022-01-22 02:18:08-05:00,7519,6b7Ro2myM4HcUDqyyW9NEqTWPz8BWpH4eNFSQQci37So,7r7j7rSsa6YZcTuRPfs3KP44MVqUA4Q5NeJGmx84wbHq,True,2542866,635716,3635,1817,1818,4BnQKPLuE3DMTtxp8MjUBytgnhvxqq3ZTqZHTVZo4JJh,145400,2140378,-1994978,571
2022-01-22 02:18:10-05:00,7520,H3x9b27yHVdCxvtDf7mmJxkNeubcmQMwfAkLTYADPWNv,HGVCCz23rWx78vrTB2wvm2aesbLZuYFhhNuznGiSSAyA,True,518166641,129541660,810857,405428,405429,4BnQKPLuE3DMTtxp8MjUBytgnhvxqq3ZTqZHTVZo4JJh,32434289,182012386,-149578097,625
2022-01-22 02:18:18-05:00,7521,3EmGvYu72cR4Ta3wLA5HKZBEqgfChCyiRanwj5hGLJXc,6NEWPFaKi5uLsrj4n6RM1DBhQTcGFE9TwYeJ12pC7yyp,True,925,231,1,0,1,4BnQKPLuE3DMTtxp8MjUBytgnhvxqq3ZTqZHTVZo4JJh,53,723,-670,572
2022-01-22 02:22:33-05:00,7522,CLVUzXSNsQnX7n5cvxMuTjyMSjy1pNpPnWejFaeuonvb,BXZzBujr8DAUcGJcHQBaz1ZSwkATAHg3NX3bLnrjQpLh,True,30156775,7539193,47084,23542,23542,HfEnetJ7uBSmZWCjBNxdvv9HEC5nsW4wDV7wu6WnhWan,1883360,7602941,-5719581,624
2022-01-22 02:24:05-05:00,7523,2r64Rnbu3ZjmJTHHUxxV9TWWGzwpAepA4ySbtKivBXCj,6RRzx6KLkMiFK9JSuznrSJGiPgkHwatBSskudHqbfKJ5,True,474211888,118552971,728107,364053,364054,3zqXX6kzhkbW3d4TwD2CNjMRwxTbREXySekvq37kfCNk,29124301,267628375,-238504074,614
2022-01-22 02:26:33-05:00,7524,8WHDaiE6LqFFmCVMnPeLEQ99R6ft8b74UfmP9BqzjcE8,CGmoDGsdnjo3zMNrW78n2xxQr1aDPAiBYiXbyciLXYMu,True,39548100,9887023,61217,30608,30609,HfEnetJ7uBSmZWCjBNxdvv9HEC5nsW4wDV7wu6WnhWan,2448718,24119572,-21670854,619
2022-01-22 02:27:46-05:00,7525,FuoFPNTdYVDkSHaBac6UC1aNJXafSNTvFJuBCdrgQQrH,ApBS1Fx83tcECMzDV6wEzEzEdg4e2hgj3djtjRUoSKK5,True,98800907,24700226,154208,77104,77104,3zqXX6kzhkbW3d4TwD2CNjMRwxTbREXySekvq37kfCNk,6168323,61519310,-55350987,624
2022-01-22 02:27:46-05:00,7526,GXfjQr2ihTfLRys1DMetVGocd1sU97KdoCJ6x4HxdW1U,9GHvjJJXjbVz5D3RBfP3njcdRRXnFsXZ68jFa2LiGwsy,True,71508418,17877104,110117,55058,55059,HfEnetJ7uBSmZWCjBNxdvv9HEC5nsW4wDV7wu6WnhWan,4404706,39354346,-34949640,615
2022-01-22 02:27:46-05:00,7527,H1Z83zVoskNuBvYao1FjdLfETfhPpQFQUkniJfGxbaNz,EVqbBRV6Zy1tPLRevxpAykp8Mvv6tDZVTc4RmCKw4Gq1,True,90586642,22646659,139532,69766,69766,HfEnetJ7uBSmZWCjBNxdvv9HEC5nsW4wDV7wu6WnhWan,5581318,62653145,-57071827,616
2022-01-22 02:27:47-05:00,7528,BHpLpoGQ27T6Q4CT8H4dzqS8KF8Vj5rqmqfcodoBzpgR,Akn3tG2hQBfBVtNYCeXchfzfcsyCuSpkGpFoMLEKwcBF,True,4521997,1130499,6991,3495,3496,HfEnetJ7uBSmZWCjBNxdvv9HEC5nsW4wDV7wu6WnhWan,279677,2608304,-2328627,618
2022-01-22 02:27:47-05:00,7529,CCP5P6U4xBjea3snWgwBb5rtaounEAsNHpWzTUeNtVf9,GE2Bxc837ybP7sNR487U4bVbx68qyX2HtwPBLfEd4BDj,True,280392166,70098041,433693,216846,216847,3zqXX6kzhkbW3d4TwD2CNjMRwxTbREXySekvq37kfCNk,17347726,101032767,-83685041,618
2022-01-22 02:27:50-05:00,7530,EF6H6aW1p3qcAtiLFU9rbFYfsKfD683meHXDw8hLdaZK,8vfJbpnK7SQcjpEBCzZJRW8JosNbsmTeJ2YXZCbM225c,True,19308720,4827179,30194,15097,15097,3zqXX6kzhkbW3d4TwD2CNjMRwxTbREXySekvq37kfCNk,1207796,10603723,-9395927,625
2022-01-22 02:33:24-05:00,7531,E5biUzKn2s5frKseCmfWriWjrYMGVtmLrhR9nYhAkVvR,BDHzqefisuGoMGcpML8t6KAC7rcErvhLcfV8KQC7oHAH,True,17617947,4404486,26825,13412,13413,3zqXX6kzhkbW3d4TwD2CNjMRwxTbREXySekvq37kfCNk,1073025,7465765,-6392740,609
2022-01-22 02:36:45-05:00,7532,ARB1q7bNcQ7grwFEZC6nk9Pfrrg7yZ2WK8zVqq5CEE8F,53e8mUYrWzQnCm9XQyp18CL9owyPqJcYyxZANYhRypPx,True,46908510,11727127,71886,35943,35943,HfEnetJ7uBSmZWCjBNxdvv9HEC5nsW4wDV7wu6WnhWan,2875475,22850552,-19975077,612
2022-01-22 02:36:45-05:00,7533,GXSysysoV8Z4xBrQsaKUsSrpoWeTTUsbFmgfZDaQu4ZM,6FJyraiLgG3tb9B7pi4YFsJNtRVBNaghnm1ajzneVv7b,True,449943205,112485801,681982,340991,340991,4BnQKPLuE3DMTtxp8MjUBytgnhvxqq3ZTqZHTVZo4JJh,27279285,173001552,-145722267,606
2022-01-22 02:36:45-05:00,7534,9aQrdyfAvcBbBj7iKQB17eAS4zBqymdd3kzkTkuRhdLU,BDHhukMF5rALuSwCxaw8g73m2MN4oX1D4e7uNmx3SiVt,True,63353733,15838433,97668,48834,48834,3zqXX6kzhkbW3d4TwD2CNjMRwxTbREXySekvq37kfCNk,3906742,23550013,-19643271,616
2022-01-22 02:40:03-05:00,7535,DDuXUcRDez68Tx651sVKxjubhTdNHkuarbeDEKFp5HRs,DNWcrd23zaT7LuXHuhPVqqAvLVpEzoqebr4sho45CphT,True,2054443,513610,3165,1582,1583,4BnQKPLuE3DMTtxp8MjUBytgnhvxqq3ZTqZHTVZo4JJh,126617,759450,-632833,616
2022-01-22 02:40:03-05:00,7536,JDeYjCLpfnzcfxDFgHf4aBcHsajwdR14GUaKAA9euzVf,EJbvKoyMZcoCx4vWa61uMbW2vr6mUhrgEuECdteVBuZZ,True,473771,118442,663,331,332,4BnQKPLuE3DMTtxp8MjUBytgnhvxqq3ZTqZHTVZo4JJh,26549,417861,-391312,560
2022-01-22 02:40:03-05:00,7537,9UKMqQgFYdJb5vXVqPhA8CAMRY1eifgWivANiKQqj3yb,DpE3uNQUZbyYnqjpfHWqp9CHqPBs2uTQLRM6AtzF6Por,True,20199509,5049877,28313,14156,14157,HfEnetJ7uBSmZWCjBNxdvv9HEC5nsW4wDV7wu6WnhWan,1132552,6899943,-5767391,560
2022-01-22 02:40:03-05:00,7538,Fani89KviVFZek4si6YZ3apVuM2kSqVUijDnLBqtvJEH,EpC29dECx1cLC69bj2ncG3jFp7obPaxbH7F6mju27cwL,True,1337146,334286,1973,986,987,3zqXX6kzhkbW3d4TwD2CNjMRwxTbREXySekvq37kfCNk,78936,491325,-412389,590
2022-01-22 02:40:03-05:00,7539,6VJcr3VAEcEZaHEpt48QL8QxHKABufVp8n2JSEVTLh9U,8naR6kiySKj3vai9dCetdgCnCHgf2oyLjGqKTJ3Lz64Y,True,197562142,49390535,281126,140563,140563,3zqXX6kzhkbW3d4TwD2CNjMRwxTbREXySekvq37kfCNk,11245075,137843619,-126598544,569
2022-01-22 02:40:03-05:00,7540,DY6k3Dkwe18iLneaT8Xo3VpJWB6V4jWwQQjoDvEzdg2j,3GGV7S9FpRQGbARBXkvGFVqLrmw8JvYAcpnR1aKVUY2f,True,755102,188775,1169,584,585,3zqXX6kzhkbW3d4TwD2CNjMRwxTbREXySekvq37kfCNk,46764,657582,-610818,619
2022-01-22 02:40:03-05:00,7541,Bsr6kx1B6BSEd5UnJ7Z61M49iUb3bFrDVhiEtMVtPDF2,3CFd1pUJAJPA9fobwn4Jj2mRju1CWmoop4Mh4znypNWT,True,1781728,445432,2580,1290,1290,4BnQKPLuE3DMTtxp8MjUBytgnhvxqq3ZTqZHTVZo4JJh,103200,1116153,-1012953,579
2022-01-22 02:40:03-05:00,7542,CYkojG4q1SnizNs59qsYTEBU1c11XC8nteMhxRbwhCBq,A9MsPy3aeMzdQUWXK6qmWLiZfKREiBrSVaJAKp2nEcSt,True,1367950,341987,1890,945,945,3zqXX6kzhkbW3d4TwD2CNjMRwxTbREXySekvq37kfCNk,75614,863841,-788227,552
2022-01-22 02:40:03-05:00,7543,8swGZMrPrLAxZd7MxTbkCL13k3DmAJUw41jCp6Xo6awW,3fKnX7yTNXAT4uMmXVdTy47ALJT8h8YSD3WiBb4BGuzH,True,14149468,3537367,21583,10791,10792,4BnQKPLuE3DMTtxp8MjUBytgnhvxqq3ZTqZHTVZo4JJh,863321,9992856,-9129535,610
2022-01-22 02:40:03-05:00,7544,78EeyPYzQjrmW6z9VGhRci6ihMUZb5rtpXo3GAxugf55,9AgZ45TMxaqwWGVWSgnEkvio3s6fXtHjAVRVCA7Zgsd2,True,3380154,845038,4705,2352,2353,4BnQKPLuE3DMTtxp8MjUBytgnhvxqq3ZTqZHTVZo4JJh,188239,1884693,-1696454,556
2022-01-22 02:40:03-05:00,7545,GufVttJatW8NLeztT1NRQSLZpQNRk45kaG41p3QcWhx7,GTJUsWoWRyeafYJVhx2aRo8NE94U5UrBjaehmJ4PRUhn,True,1707823,426955,2583,1291,1292,4BnQKPLuE3DMTtxp8MjUBytgnhvxqq3ZTqZHTVZo4JJh,103328,929066,-825738,605
2022-01-22 02:40:04-05:00,7546,7hTjPRQSYAoWHhtpsVz2oKK5SAuFJd8dPHShKgKJq8dy,6DcHcrtcXR88d8e2KahhAiWTeRznNfF8oXLHmh5wE7wz,True,58157242,14539310,80758,40379,40379,4BnQKPLuE3DMTtxp8MjUBytgnhvxqq3ZTqZHTVZo4JJh,3230341,36881373,-33651032,555
2022-01-22 02:40:04-05:00,7547,HHHj6EinpgAJeZkDXfsvCo3UXnmAdiAZNvPSUfVPc5Sg,3gx9c31MDtJtByxkUuWcqf1oARnZTjpx3QtxsM1Xb6Gp,True,45746581,11436645,68494,34247,34247,4BnQKPLuE3DMTtxp8MjUBytgnhvxqq3ZTqZHTVZo4JJh,2739784,26724785,-23985001,598
2022-01-22 02:40:04-05:00,7548,AWvHDdb2ikqV8wc7qQ8azbvNTZdixMNxhQjhQdhayYtR,9EpgEPBb1nog6aQeFdMXfSRiLSnzGQFQ39mbLdCxgYTv,True,2815198,703799,3985,1992,1993,4BnQKPLuE3DMTtxp8MjUBytgnhvxqq3ZTqZHTVZo4JJh,159439,1544203,-1384764,566
2022-01-22 02:40:04-05:00,7549,DWTaeNeq5x83cBvKUz2jZfXDz5z4F5wbSZLNv7smnjvd,9pQGArZnJV4Fu8tBVEfknmmfmrRv5RKV2u58BJBuhzpF,True,5693003,1423250,8591,4295,4296,4BnQKPLuE3DMTtxp8MjUBytgnhvxqq3ZTqZHTVZo4JJh,343679,3549654,-3205975,603
2022-01-22 02:40:04-05:00,7550,6kqKSyVVF4xxUbsvBCkY1kt4XcKzb98eSaqNw5fxSLtw,4T9DKFUmkcPG7mM3CKzW3m81LqqpU7oFTv35Pha4zHNe,True,101057881,25264470,152210,76105,76105,4BnQKPLuE3DMTtxp8MjUBytgnhvxqq3ZTqZHTVZo4JJh,6088434,64970451,-58882017,602
2022-01-22 02:40:04-05:00,7551,5eMLdQ4gYA5iqvTXSNdGvctHp7s5VpyFuwtJKqx6chBc,Ckxc5K39nkBNXBTmFTM8J48R7wGqNm3vHKZu4G5baumZ,True,19941923,4985480,28517,14258,14259,4BnQKPLuE3DMTtxp8MjUBytgnhvxqq3ZTqZHTVZo4JJh,1140719,11789750,-10649031,572
2022-01-22 02:40:07-05:00,7552,6NJFN855M3Q3RLTDNo57gTgAmwPD6G2E3WvMb1m5eNCN,3YpqNnonsvXaRT4nCC3G5FZx1jjVtbDPc36LiR6WK5jR,True,4630267,1157566,6932,3466,3466,3zqXX6kzhkbW3d4TwD2CNjMRwxTbREXySekvq37kfCNk,277287,4022810,-3745523,598
2022-01-22 02:40:07-05:00,7553,DkvR2xUPMyXWGGkUSmDSfhp7RtvMkfbT1ThKCS3TwrXd,F7jYV6TtT1LZ5XCNn1zkbUfNMo4gGcQUczAQy1jLHpaW,True,37142176,9285544,57443,28721,28722,3zqXX6kzhkbW3d4TwD2CNjMRwxTbREXySekvq37kfCNk,2297746,25766576,-23468830,618
2022-01-22 02:40:08-05:00,7554,D64rDiWT3YG28fCgXCmbNjYa2JakZbpKQ1D2XuLChUfV,8WmMWq8cTsGQym5pUbHm9dPCpJugBeWUMVERYFGLxWHj,True,2175023,543755,3207,1603,1604,3zqXX6kzhkbW3d4TwD2CNjMRwxTbREXySekvq37kfCNk,128284,1293853,-1165569,589
2022-01-22 02:41:27-05:00,7555,J3ggP7ZxL8HRh3CBp5iYG2WgjLyNSAWYT46uC9VYDLCz,2FqTRiRPiLvdAH2BS5vroVntpsSXvTJEn5UHWmtKHzh9,True,1794135,448533,2797,1398,1399,HfEnetJ7uBSmZWCjBNxdvv9HEC5nsW4wDV7wu6WnhWan,111893,1013739,-901846,623
2022-01-22 02:41:27-05:00,7556,gMjmD7WioyUdQdwNqE5fobLcxPwoJv5rAvLmJaf8Jjw,5n77euFjVJiwKrnbYq1KpcENW1mzBZj2BuDGyzazrkJ8,True,14012642,3503159,21923,10961,10962,3zqXX6kzhkbW3d4TwD2CNjMRwxTbREXySekvq37kfCNk,876946,5746782,-4869836,625
2022-01-22 02:41:36-05:00,7557,HwosLQgDY1xtHQRQ4hzroPQHFWssPzTj5vRkP37FcviB,HKTNEYNXrephNkH7apbobK4mcQXcNayQA4W1NgM6sLr8,True,3761249,940312,5258,2629,2629,3zqXX6kzhkbW3d4TwD2CNjMRwxTbREXySekvq37kfCNk,210326,1984460,-1774134,559
2022-01-22 02:44:15-05:00,7558,Hy3kzXneDN6FUkiZctU1vWe97BYvj6yZ7QvQzehfWmNr,EhXgQg8BTniANV525RpY76z7Hrh6DuqrMChjqEoXfVJe,True,17758591,4439646,27721,13860,13861,HfEnetJ7uBSmZWCjBNxdvv9HEC5nsW4wDV7wu6WnhWan,1108873,7391376,-6282503,624
2022-01-22 02:44:45-05:00,7559,8T4WK27RvWVGqPuNqY6whk1fmU4vd5qaUQPZG1GJ79bh,DvSz7knS8N3K7L6JhQf1s4mJSyxB8uJXNQXtyjJn8QRL,True,5578900,1394723,8296,4148,4148,3zqXX6kzhkbW3d4TwD2CNjMRwxTbREXySekvq37kfCNk,331874,4090928,-3759054,594
2022-01-22 02:44:49-05:00,7560,GKKRAsYGdcf47eFThG4KwhNv7egeHRuc2wmTh4kqpego,4ippJxgnqCtdtGzCkdZoYwv68fiXNSqQcgrnaHdXZDUa,True,87251263,21812814,130186,65093,65093,3zqXX6kzhkbW3d4TwD2CNjMRwxTbREXySekvq37kfCNk,5207462,52118240,-46910778,596
2022-01-22 02:48:22-05:00,7561,BCGTaPQxGEMjD7xUxwfwmVVYJ9CEGH33yJRi3QjwyiLE,JBct1cZ9a959UKwABBEefwxZnGTAAGLzyUdXrXqGGCZd,True,117959929,29489981,179700,89850,89850,4BnQKPLuE3DMTtxp8MjUBytgnhvxqq3ZTqZHTVZo4JJh,7188030,72063057,-64875027,609
2022-01-22 02:50:31-05:00,7562,4ytoBUwuhAL4YYSCa6AgwrpeVF4eeU8H9NfDxMPZKxPo,Pby2szzsxDrXt4gnbmmaMccXxctZALr8miRtKhGKjsD,True,2675242,668810,3978,1989,1989,3zqXX6kzhkbW3d4TwD2CNjMRwxTbREXySekvq37kfCNk,159137,1612594,-1453457,594
2022-01-22 02:50:31-05:00,7563,9psSuFHBGqCvcgNMc7aTMhKMMFwBDmW7v5Wkn22KtTHj,7zi9LSfuEhXccQXSRukRRwgQUaiQVVgfsGaRYLP2JvwB,True,795297385,198824346,1179405,589702,589703,4BnQKPLuE3DMTtxp8MjUBytgnhvxqq3ZTqZHTVZo4JJh,47176227,306439971,-259263744,593
2022-01-22 02:51:04-05:00,7564,Dv1BABsN7amhjmGBpMQsnMkRLx7MuCVwsnuyTQeZ6uum,BCjscxVo1h16teND6KKiAUy1ftNGTMy1vEEEyAW4ttVG,True,4439617,1109904,6814,3407,3407,3zqXX6kzhkbW3d4TwD2CNjMRwxTbREXySekvq37kfCNk,272562,1575727,-1303165,613
2022-01-22 02:51:04-05:00,7565,442usWu6XpJZvU25bqXeynRrQ15jAzWwU9DWMgHpTn3Q,CtvADKp39bjJf3cPKWNL3wxnhq273fVM4fC5DmEcg5cC,True,978750096,244687524,1467861,733930,733931,HfEnetJ7uBSmZWCjBNxdvv9HEC5nsW4wDV7wu6WnhWan,58714477,443371570,-384657093,599
2022-01-22 02:51:54-05:00,7566,7iUx7JBwqUvPVPeCqMEXQdLccZJmaFYm1DUQiu3ouHa3,3EVZzhRmJnX9ZiBZZo9tenDtMogAyuA1yf2cKzvUWiuu,True,52574700,13143673,81887,40943,40944,HfEnetJ7uBSmZWCjBNxdvv9HEC5nsW4wDV7wu6WnhWan,3275517,18393554,-15118037,623
2022-01-22 02:52:14-05:00,7567,HEFpdWLZaiQnjftmXgxs6RNzhH72YiMjortxPkKekkvb,5Q8mmxBgVTijNGrWsnoA3VMArLHZEX5MkaigYXHpgXHE,True,43099545,10774886,66849,33424,33425,3zqXX6kzhkbW3d4TwD2CNjMRwxTbREXySekvq37kfCNk,2673996,14535993,-11861997,620
2022-01-22 02:52:14-05:00,7568,BhiAaiZu7fF8ndggJrLyiFVCRq526cNBw7VaeascEmNL,4en8MipPi7vq15NGhpPMQfptNdEyhp2j7fpgxBBtjyfz,True,41853425,10463355,65134,32567,32567,HfEnetJ7uBSmZWCjBNxdvv9HEC5nsW4wDV7wu6WnhWan,2605365,14637209,-12031844,622
2022-01-22 02:53:37-05:00,7569,BH36ueAULprzjj6WabTgvivEcrx3VdDn8DTxSoro8Zym,6yydJKEmtZjUwURrs9gQ7EGkB86nK28ZDJQqNMgbPosA,True,291874402,72968600,453776,226888,226888,4BnQKPLuE3DMTtxp8MjUBytgnhvxqq3ZTqZHTVZo4JJh,18151047,134397534,-116246487,621
2022-01-22 02:54:10-05:00,7570,DGbj8tnqECzM9FG8j225Ap7A4Fdm3J1Ksm32JBFG7igv,Cd3D2UVwoSZLygM2e3UQppQANsokpmx5CNBs1C5zueay,True,47555554,11888888,74064,37032,37032,3zqXX6kzhkbW3d4TwD2CNjMRwxTbREXySekvq37kfCNk,2962569,14349115,-11386546,622
2022-01-22 02:54:29-05:00,7571,BHpLpoGQ27T6Q4CT8H4dzqS8KF8Vj5rqmqfcodoBzpgR,Akn3tG2hQBfBVtNYCeXchfzfcsyCuSpkGpFoMLEKwcBF,True,3321730,830432,5072,2536,2536,4BnQKPLuE3DMTtxp8MjUBytgnhvxqq3ZTqZHTVZo4JJh,202918,2019157,-1816239,610
2022-01-22 02:54:30-05:00,7572,GXfjQr2ihTfLRys1DMetVGocd1sU97KdoCJ6x4HxdW1U,9GHvjJJXjbVz5D3RBfP3njcdRRXnFsXZ68jFa2LiGwsy,True,52527971,13131992,79781,39890,39891,HfEnetJ7uBSmZWCjBNxdvv9HEC5nsW4wDV7wu6WnhWan,3191246,30506936,-27315690,607
2022-01-22 02:54:35-05:00,7573,CCP5P6U4xBjea3snWgwBb5rtaounEAsNHpWzTUeNtVf9,GE2Bxc837ybP7sNR487U4bVbx68qyX2HtwPBLfEd4BDj,True,205970011,51492502,314747,157373,157374,3zqXX6kzhkbW3d4TwD2CNjMRwxTbREXySekvq37kfCNk,12589919,79679365,-67089446,611
2022-01-22 02:58:47-05:00,7574,FgQrRo4eGQAonSsFfQgnp8trGGqGZCLeGX6yvJnMnTjd,8KhemHLBY6nGmo3xMDedW2wnCSxQq6LwbTExif4sUSxx,True,83705131,20926282,128880,64440,64440,HfEnetJ7uBSmZWCjBNxdvv9HEC5nsW4wDV7wu6WnhWan,5155202,27757161,-22601959,615
2022-01-22 02:58:48-05:00,7575,BgnsCfJ54ReunUtwPJLzkW4PWnqpBDWGNYxsW5PvDrbK,KpMqEkQ9dKMgCevsEK895wHd3fCLRPSzDmJSv3tKU4u,True,884743053,221185763,1375465,687732,687733,3zqXX6kzhkbW3d4TwD2CNjMRwxTbREXySekvq37kfCNk,55018600,558974334,-503955734,621
2022-01-22 02:58:49-05:00,7576,8E3K7vCHJ2xjdFofPRGLbMxrkm8UYEi926QmXPAFwsqe,4qHUDA1c43Dg4qi1ZPKqmpGYiEMUZ6r4UuzB5ftHCEhW,True,86508268,21627067,134525,67262,67263,HfEnetJ7uBSmZWCjBNxdvv9HEC5nsW4wDV7wu6WnhWan,5381017,69222241,-63841224,622
2022-01-22 02:58:49-05:00,7577,9WJBnVi84E926j7xEd566WzrZJkPJWRgmEnYj9vyjuad,4dLaFS5F7TGyLdwuJLMGkz3bSL53aHzd9ZfpNmhHxXeF,True,935959,233989,1437,718,719,3zqXX6kzhkbW3d4TwD2CNjMRwxTbREXySekvq37kfCNk,57500,742874,-685374,614
2022-01-22 02:58:52-05:00,7578,CxLFMBDFkoMvpK9YUf7WtCq6hn7k3QACAuetAnGjU6KA,2gE52a1GWQnS6ifV6eVtKQyr13LXP5Jdt3yG9SjGPJPF,True,74036685,18509171,113797,56898,56899,4BnQKPLuE3DMTtxp8MjUBytgnhvxqq3ZTqZHTVZo4JJh,4551919,30631025,-26079106,614
2022-01-22 02:59:10-05:00,7579,2SNV9Q6vzQP5XxxqSrwXpQdRvk45FPiqLXmhNZzbLt1k,6dLG3ojK5Unm1mBh9aDZfryvoT2a6cSuWA8CxXy3oi7n,True,84249873,21062466,129213,64606,64607,3zqXX6kzhkbW3d4TwD2CNjMRwxTbREXySekvq37kfCNk,5168556,54403565,-49235009,613
2022-01-22 02:59:24-05:00,7580,DGbj8tnqECzM9FG8j225Ap7A4Fdm3J1Ksm32JBFG7igv,Cd3D2UVwoSZLygM2e3UQppQANsokpmx5CNBs1C5zueay,False,33860800,33860800,1082639,54131,1028508,3zqXX6kzhkbW3d4TwD2CNjMRwxTbREXySekvq37kfCNk,1082639,11428459,-10345820,319
2022-01-22 02:59:27-05:00,7581,Gbxc51WERLLeCtiHv7rDvE52aqF541RoQWG5n5aqErq6,4ngBoHbfXijLMqGKxFMNht9sbmxy2g5eqBmn8QsBmbx1,False,31944658,31944658,1332051,66602,1265449,3zqXX6kzhkbW3d4TwD2CNjMRwxTbREXySekvq37kfCNk,1332051,11655017,-10322966,416
2022-01-22 02:59:27-05:00,7582,46TNhGwBVzedW8xSb9UY94HNeSom9iGiZzAjrKHiRM2G,7JVTiqNYeKHbyzRkKtvSEpqLPKykZso8cGUr3sX1j7QF,True,4737634,1184408,7397,3698,3699,HfEnetJ7uBSmZWCjBNxdvv9HEC5nsW4wDV7wu6WnhWan,295885,2881542,-2585657,624
2022-01-22 02:59:28-05:00,7583,HEFpdWLZaiQnjftmXgxs6RNzhH72YiMjortxPkKekkvb,5Q8mmxBgVTijNGrWsnoA3VMArLHZEX5MkaigYXHpgXHE,True,31286868,7821716,39233,19616,19617,3zqXX6kzhkbW3d4TwD2CNjMRwxTbREXySekvq37kfCNk,1569356,11503674,-9934318,501
2022-01-22 02:59:28-05:00,7584,7iUx7JBwqUvPVPeCqMEXQdLccZJmaFYm1DUQiu3ouHa3,3EVZzhRmJnX9ZiBZZo9tenDtMogAyuA1yf2cKzvUWiuu,True,38321416,9580353,52100,26050,26050,HfEnetJ7uBSmZWCjBNxdvv9HEC5nsW4wDV7wu6WnhWan,2084019,14532208,-12448189,543
2022-01-22 02:59:28-05:00,7585,FiF5uS2uDYV3T1fvobU1rVhPEY9NVvwnQWBaTVUq8yQJ,7DBpkkcW6SgF6t63hZPf71KC5LwNrehsXh262NeQuBq1,False,956214956,956214956,23307905,1165395,22142510,3zqXX6kzhkbW3d4TwD2CNjMRwxTbREXySekvq37kfCNk,23307905,218212849,-194904944,243
2022-01-22 02:59:30-05:00,7586,4Sm9RWqrph72ZcWwCXSbjQ3gVJjfackrXZEKFSNJUSUx,CmMVCamDJCSVgPE8rAbpkniShrvUHUY8UtbVnPLoQQPF,False,2407383494,2407383494,72973338,3648666,69324672,3zqXX6kzhkbW3d4TwD2CNjMRwxTbREXySekvq37kfCNk,72973338,865589844,-792616506,303
2022-01-22 02:59:30-05:00,7587,4oQ7WAj5pkhBkH8YTNAcLqL3NY3ykM1UGjjSu3suLfSn,GjU66qT6JJnHseZMNgQitLJdzsNaqFtQsqzucPPw9SeT,False,168041196,168041196,8036031,401801,7634230,4BnQKPLuE3DMTtxp8MjUBytgnhvxqq3ZTqZHTVZo4JJh,8036031,37494835,-29458804,478
2022-01-22 02:59:32-05:00,7588,DRVtEzZs9u9ysrcANZLEjrvbuuGqYn77v2h4cDFKuNUx,Fv9qiMZhuSBL2cs9AWUYbDLQjB46W2ZwrhxaNXtPLDpC,False,3912184,3912184,178901,8945,169956,3uL2NSR2ZdDqCiKfzA5SwwpddAnit22DBJo6uvvz1rRs,178901,1384015,-1205114,457
2022-01-22 02:59:35-05:00,7589,3662SX3YSARYupcxpgtTvUAPUsU7aJKsGxvpkNC1AV1A,HkAb86jdGHbz6VxrtbA81jPvjhiNHhbe82NBPFxnwzE5,False,29650306,29650306,705720,35286,670434,3zqXX6kzhkbW3d4TwD2CNjMRwxTbREXySekvq37kfCNk,705720,7355447,-6649727,238
2022-01-22 02:59:38-05:00,7590,6pXjgzpAPSjchUHoPqsZduviYV95SBHNk5CRCNjGAJZw,26Zjv9SkvUmwQAQT9Ls6k1wdKECrkhBrDUDrntpHfPEu,False,230002576,230002576,6406789,320339,6086450,3zqXX6kzhkbW3d4TwD2CNjMRwxTbREXySekvq37kfCNk,6406789,63249941,-56843152,278
2022-01-22 02:59:38-05:00,7591,Dn916KSmX3HqxT53hrxrbCrV3tdRMCPdaoiRLqetMrth,ATCXRiXgnjRRUbSTPBvtBXMENCqsViexSZbZ6aDaXXWA,False,35416519,35416519,867521,43376,824145,3zqXX6kzhkbW3d4TwD2CNjMRwxTbREXySekvq37kfCNk,867521,11837147,-10969626,244
2022-01-22 02:59:38-05:00,7592,5BJnMHFSiQjHRGFJDW1jnqCfkHHYWnQzmmccy9eA4jNj,9517JGYsPmvgPUM9pFRD2vipHmdgE578F7jA7Qq6jorm,True,216822822,54205705,323599,161799,161800,3zqXX6kzhkbW3d4TwD2CNjMRwxTbREXySekvq37kfCNk,12943977,64878355,-51934378,596
2022-01-22 02:59:38-05:00,7593,Dng7By2saPu5TVxcvXidBe71ggBo8tiHkAXPi4kKL1tk,75ufEJmHbLHffphL7tvAXhGyftKLr1z2PXXoB2GGY5fG,True,58200421,14550105,76887,38443,38444,72FwbpFGoLEazJEdpqNtPNefsadUrimUqma9wSoy4qiS,3075499,18015461,-14939962,528
2022-01-22 02:59:38-05:00,7594,BhiAaiZu7fF8ndggJrLyiFVCRq526cNBw7VaeascEmNL,4en8MipPi7vq15NGhpPMQfptNdEyhp2j7fpgxBBtjyfz,True,30517847,7629460,41700,20850,20850,3zqXX6kzhkbW3d4TwD2CNjMRwxTbREXySekvq37kfCNk,1668008,11564147,-9896139,546
2022-01-22 02:59:38-05:00,7595,BH36ueAULprzjj6WabTgvivEcrx3VdDn8DTxSoro8Zym,6yydJKEmtZjUwURrs9gQ7EGkB86nK28ZDJQqNMgbPosA,True,212178024,53044505,274237,137118,137119,3zqXX6kzhkbW3d4TwD2CNjMRwxTbREXySekvq37kfCNk,10969493,104883047,-93913554,516
2022-01-22 02:59:39-05:00,7596,BjCNaM7YbE9SjFi7tzi4677zg1fKXGJwtecz2GWwWuhd,6rNsSrKZezQrLb2whToNjnizpnurDXrobHqfEK3QqU1M,True,2223335054,555833762,3376433,1688216,1688217,3zqXX6kzhkbW3d4TwD2CNjMRwxTbREXySekvq37kfCNk,135057336,891750692,-756693356,607
2022-01-22 02:59:42-05:00,7597,2r64Rnbu3ZjmJTHHUxxV9TWWGzwpAepA4ySbtKivBXCj,6RRzx6KLkMiFK9JSuznrSJGiPgkHwatBSskudHqbfKJ5,True,348755476,87188869,537318,268659,268659,4BnQKPLuE3DMTtxp8MjUBytgnhvxqq3ZTqZHTVZo4JJh,21492753,207276544,-185783791,616
2022-01-22 02:59:43-05:00,7598,8WHDaiE6LqFFmCVMnPeLEQ99R6ft8b74UfmP9BqzjcE8,CGmoDGsdnjo3zMNrW78n2xxQr1aDPAiBYiXbyciLXYMu,True,29092827,7273206,45481,22740,22741,HfEnetJ7uBSmZWCjBNxdvv9HEC5nsW4wDV7wu6WnhWan,1819251,18640664,-16821413,625
2022-01-22 03:00:17-05:00,7599,6pUtYz474QrpATEZnfb3iFbTKYA65pNyKAo4TQZAjtqe,8dipRUXvxJiDLdHEtCPkso4vErbVwshHQiRfvSngBS9J,True,21517654199,5379413548,33348567,16674283,16674284,3zqXX6kzhkbW3d4TwD2CNjMRwxTbREXySekvq37kfCNk,1333942708,7327485987,-5993543279,619
2022-01-22 03:00:17-05:00,7600,FtF3PVw8YNJseWPMcA2GEuQZ6nni1mq5kYPa2LrSzfkW,4yr1TM2dXrBvLNMpSaoryuGU2P8D3WG1ZCkvVzWFiQRH,True,6422151659,1605537913,9930803,4965401,4965402,3zqXX6kzhkbW3d4TwD2CNjMRwxTbREXySekvq37kfCNk,397232141,2528404297,-2131172156,618
2022-01-22 03:00:31-05:00,7601,5Rxuqgs4CaSKbfDXqBMFXkLTQ9dxrUjThXzoy3ouYVtK,BgvbKru66ebrGUcFFymGTmsaQv6GgcGMybiWaXqzBtwX,False,12603,12603,628,31,597,3zqXX6kzhkbW3d4TwD2CNjMRwxTbREXySekvq37kfCNk,628,11317,-10689,498
2022-01-22 03:00:31-05:00,7602,399591e8XgY52yCMorCQ2WL6dQZTC485ZooHtmGuirhZ,JCiXAooFmKmEPQ2S7C8iSk6CLcTyrPEe1SsPSLyUGySe,True,65254,16313,101,50,51,3zqXX6kzhkbW3d4TwD2CNjMRwxTbREXySekvq37kfCNk,4056,57187,-53131,621
2022-01-22 03:00:31-05:00,7603,HEFpdWLZaiQnjftmXgxs6RNzhH72YiMjortxPkKekkvb,5Q8mmxBgVTijNGrWsnoA3VMArLHZEX5MkaigYXHpgXHE,True,23429539,5857384,36498,18249,18249,3zqXX6kzhkbW3d4TwD2CNjMRwxTbREXySekvq37kfCNk,1459944,8946314,-7486370,623
2022-01-22 03:00:50-05:00,7604,A4tDE948CPFPh1UwHb8sXryfKktbxZ8BCkqXgA5DJHA8,3zXeKMrsEpCe5fQumLNzCgpxcG1kLJFEAtJuqxLsC6ZG,True,5281419,1320354,8250,4125,4125,3zqXX6kzhkbW3d4TwD2CNjMRwxTbREXySekvq37kfCNk,330022,3774243,-3444221,624
2022-01-22 03:00:53-05:00,7605,4uygLJDk9DFCifJ56YwMrEsvd3oQNq8tYSLnMCyWorS6,GimL4uKGvg3FFmFQSWzAcjstv3Vmk5NMgDGMKTuXYVpB,True,31622089,7905522,49421,24710,24711,3zqXX6kzhkbW3d4TwD2CNjMRwxTbREXySekvq37kfCNk,1976859,21517472,-19540613,625
2022-01-22 03:00:53-05:00,7606,BgN75npBkPws5uiFE9RAujmPuZyAv2MQUPmfmJ1YCCij,78UFLNDn782TY2P4F5kRkMRC2s3gw8ak7sRQZRWNq82D,True,14637556,3659389,22716,11358,11358,4BnQKPLuE3DMTtxp8MjUBytgnhvxqq3ZTqZHTVZo4JJh,908674,5251319,-4342645,620
2022-01-22 03:00:55-05:00,7607,BH36ueAULprzjj6WabTgvivEcrx3VdDn8DTxSoro8Zym,6yydJKEmtZjUwURrs9gQ7EGkB86nK28ZDJQqNMgbPosA,True,158605257,39651313,247973,123986,123987,3zqXX6kzhkbW3d4TwD2CNjMRwxTbREXySekvq37kfCNk,9918952,80882885,-70963933,625
2022-01-22 03:00:57-05:00,7608,Dng7By2saPu5TVxcvXidBe71ggBo8tiHkAXPi4kKL1tk,75ufEJmHbLHffphL7tvAXhGyftKLr1z2PXXoB2GGY5fG,True,43336657,10834164,65566,32783,32783,3zqXX6kzhkbW3d4TwD2CNjMRwxTbREXySekvq37kfCNk,2622647,14141311,-11518664,605
2022-01-22 03:00:58-05:00,7609,2rLWe1XADCU93guPU6WgSW6x56gYNfif9bm11V93mJnv,BEGhQRm3fgSHeBtk2DYrXEBPKPRvS3sHyTNopmoBJxMs,True,18230207258,4557551814,25515230,12757615,12757615,3zqXX6kzhkbW3d4TwD2CNjMRwxTbREXySekvq37kfCNk,1020609225,7879191290,-6858582065,559
2022-01-22 03:01:06-05:00,7610,5BJnMHFSiQjHRGFJDW1jnqCfkHHYWnQzmmccy9eA4jNj,9517JGYsPmvgPUM9pFRD2vipHmdgE578F7jA7Qq6jorm,True,160387090,40096772,249074,124537,124537,3zqXX6kzhkbW3d4TwD2CNjMRwxTbREXySekvq37kfCNk,9962990,51144727,-41181737,621
2022-01-22 03:02:16-05:00,7611,8JtUn4uue4WzrySwnDQ74qzzWaKsoo11MbMvRh1ePDJN,8iahKConWg6fyZrkoze5eeujyNHA26AybYBpHwUr76Cu,True,73211036,18302759,114375,57187,57188,3zqXX6kzhkbW3d4TwD2CNjMRwxTbREXySekvq37kfCNk,4575005,39145045,-34570040,624
2022-01-22 03:02:38-05:00,7612,7feC64HZfQpniey2iXsMMgQXnfcunJus74DiKDeKaEUw,GstsCxAiBBEUrXNkvZZ9Sg4vNK916PsKe2Mx6e4M6dU7,True,185716,46428,278,139,139,3zqXX6kzhkbW3d4TwD2CNjMRwxTbREXySekvq37kfCNk,11139,125754,-114615,599
2022-01-22 03:02:38-05:00,7613,CmvNNpdGVDGujBadaMmgKc8xgFfyV6G9PNEjD8zEND6L,EzmfinKBZ8TXoSugyTqdEdHWrHdTdpHQtc1TApfaNfDR,True,2915290742,728822685,4500800,2250400,2250400,3zqXX6kzhkbW3d4TwD2CNjMRwxTbREXySekvq37kfCNk,180032038,2013672644,-1833640606,617
2022-01-22 03:02:38-05:00,7614,72woixtGAuGazCMfsYfYBYLP7FuRj8Fwz9fynFo4MCE4,5237BmWkKf58PBeTUEiu3Ld5uKXEe8wcrJRmCnUoWWku,True,23205568,5801392,34618,17309,17309,3zqXX6kzhkbW3d4TwD2CNjMRwxTbREXySekvq37kfCNk,1384729,11726659,-10341930,596
2022-01-22 03:02:38-05:00,7615,D7XummfEc3NTK4qMvZegV3FrYuqc8mNgnQu3ujwemZtg,HHiRcecqzW7sGFTio7Ph6TYv3dGt64KWv4DEKgKm84fQ,True,186307,46576,290,145,145,3zqXX6kzhkbW3d4TwD2CNjMRwxTbREXySekvq37kfCNk,11638,158019,-146381,624
2022-01-22 03:08:34-05:00,7616,4hZG7dM716SxDagiFGwt1gSC99B2QK1emGLV9TJmmuR8,7vjfUWySkyx4Z5qAaRr2VWnVvxHHNsvPj1PirGNSjM6,True,6274129070,1568532267,9815097,4907548,4907549,HfEnetJ7uBSmZWCjBNxdvv9HEC5nsW4wDV7wu6WnhWan,392603881,3033941478,-2641337597,625
2022-01-22 03:09:28-05:00,7617,3JrhHRs4UkkuMoCrQAaAGKZQrWoU72zWArnDGxKFESzH,8yREVE3kMYB7UAwtUDnTDK3egXTuTsN4igtJ5yeHYkCP,True,84534366,21133590,131931,65965,65966,HfEnetJ7uBSmZWCjBNxdvv9HEC5nsW4wDV7wu6WnhWan,5277250,33543011,-28265761,624
2022-01-22 03:12:05-05:00,7618,25NUDrsdLhS3fcARLiTMbbmZHvvzvzPj9xAdoN8sJBN3,8baNRGHfYRcLdhbHNuH72ofAWM9UojqhTMLnbBayzGnW,True,8900513,2225128,13104,6552,6552,HfEnetJ7uBSmZWCjBNxdvv9HEC5nsW4wDV7wu6WnhWan,524197,4385779,-3861582,588
2022-01-22 03:12:05-05:00,7619,4Enpw9W2mWGnNYagYQ8WW29RLSs4R5YX4qXCsVqMFeHn,9QwbJmm9QDKXyc4ZViq74BfS35zzewEceXQNnFCgczXu,True,862510151,215627537,1291388,645694,645694,HfEnetJ7uBSmZWCjBNxdvv9HEC5nsW4wDV7wu6WnhWan,51655543,243825585,-192170042,598
2022-01-22 03:13:09-05:00,7620,9yDHiv4vGbQWYby3dAMCdVnwiYgXBV1jV6WCzKYUPiUs,FPyemR1VdBnhxW2V7j7EkQyhzW894bCb3f6wRUMSn6jB,True,481064521,120266130,738546,369273,369273,4BnQKPLuE3DMTtxp8MjUBytgnhvxqq3ZTqZHTVZo4JJh,29541865,122041423,-92499558,614
2022-01-22 03:13:10-05:00,7621,2MbNCikBC3fdwqJKfMK1FjPg7wT3xWMXmN88XuikJ8r9,5eG6U5x63YYMpE7iwwu1TPcZapvQMyKczvtnFfST1BH3,True,15835,3958,24,12,12,HfEnetJ7uBSmZWCjBNxdvv9HEC5nsW4wDV7wu6WnhWan,973,7780,-6807,614
2022-01-22 03:13:12-05:00,7622,DYqdjjx7PHxaHWTv6QC98aYZPDopJsTwfzaydLHGPn2,3EjvG9CUHmfRFhkq7kec31dKjjqiqEDxZAjgLeDNDQWu,True,25034403,6258600,38675,19337,19338,3zqXX6kzhkbW3d4TwD2CNjMRwxTbREXySekvq37kfCNk,1547014,7761037,-6214023,617
2022-01-22 03:13:23-05:00,7623,B5CTBTggmGFvGFSunjbB4C9tLKcYcULehmEiEXRihY2J,FX3ebF8P89rZBWfR74PDWUzxnLuDkUDgGcPYCBD5sMUG,True,53468068,13367016,80949,40474,40475,HfEnetJ7uBSmZWCjBNxdvv9HEC5nsW4wDV7wu6WnhWan,3237977,25707928,-22469951,605
2022-01-22 03:13:26-05:00,7624,BgNgALwBEuiumVgiXRmBZRnyFrr9QTDy2maHzsNwNHGf,ag35Ec2uFtqkarizCxFyhM2SPBuUwfmLRhAdFEWFCNa,True,5814711,1453677,8849,4424,4425,3uL2NSR2ZdDqCiKfzA5SwwpddAnit22DBJo6uvvz1rRs,353992,2544649,-2190657,608
2022-01-22 03:13:27-05:00,7625,7Dm3syN4P2mbBLFKyHTrtnSWY4hadGXiKB9EekTdT68S,HF97QS1dqarPMWgNmtcoaq6z3rpJnzAAAfc1PP4FwRhV,True,5915749,1478937,9225,4612,4613,4BnQKPLuE3DMTtxp8MjUBytgnhvxqq3ZTqZHTVZo4JJh,369012,1663114,-1294102,623
2022-01-22 03:13:41-05:00,7626,4xn9vTtLZyNtCbBLLpcXUMWU8AnnZCov9rJaY6rew16T,5UNWdFw2CP44qS8oc4uPt8zxw6zFg8oXz8SUCedZLLEC,True,789963,197490,1235,617,618,HfEnetJ7uBSmZWCjBNxdvv9HEC5nsW4wDV7wu6WnhWan,49436,384255,-334819,625
2022-01-22 03:14:05-05:00,7627,243SAnGxchCVB1LQAUF4SsozR86yDwEdg2QQpbWGsMYe,5u8sNkb2oEQjUXJAB3yGStmv3Uwz16gBgExBo5myVK4b,True,2193485,548371,3423,1711,1712,HfEnetJ7uBSmZWCjBNxdvv9HEC5nsW4wDV7wu6WnhWan,136941,1111993,-975052,624
2022-01-22 03:16:42-05:00,7628,E5biUzKn2s5frKseCmfWriWjrYMGVtmLrhR9nYhAkVvR,BDHzqefisuGoMGcpML8t6KAC7rcErvhLcfV8KQC7oHAH,True,12957645,3239411,19651,9825,9826,4BnQKPLuE3DMTtxp8MjUBytgnhvxqq3ZTqZHTVZo4JJh,786072,5836451,-5050379,606
2022-01-22 03:16:51-05:00,7629,56488NdcUy6Hi6X5SLs2GFtW5pG4u5wJpH7vHdxTCx4z,tGgXjJeVr3W2m3T2NXPCqpBEd6HJKE2cRsgCyiDZQy4,True,5976786,1494196,9345,4672,4673,3zqXX6kzhkbW3d4TwD2CNjMRwxTbREXySekvq37kfCNk,373829,3900083,-3526254,625
2022-01-22 03:17:23-05:00,7630,EDSf2w1UyGvbgMuxyoXL58ifR1dviZinnLBYnFmgjcNG,DFenkzbL9SUjs9cSCaHJ1eXK75mHfk3GSPRFs8TSzrFV,True,269605382,67401345,407529,203764,203765,3zqXX6kzhkbW3d4TwD2CNjMRwxTbREXySekvq37kfCNk,16301176,100622598,-84321422,604
2022-01-22 03:17:23-05:00,7631,GBpe8E33cNkFmMUuP3WjhDBBuQz7MHaDkpCJjGFaFkvu,3QYFKkgzZ1PKKAxCh4hMhgqrupoCcfRVkjuJZRWVZo3H,True,18489264,4622316,28435,14217,14218,HfEnetJ7uBSmZWCjBNxdvv9HEC5nsW4wDV7wu6WnhWan,1137428,8719441,-7582013,615
2022-01-22 03:17:24-05:00,7632,FV3G5EsSmyiLAAoREhgDXwvzbxoyDeq4Mwfj4jK5fJ7U,5nhzbJmm5JAwGDpTZoenkM1u3XtMY4uN7Qsm3vFGtRJE,True,2044505,511126,3177,1588,1589,3zqXX6kzhkbW3d4TwD2CNjMRwxTbREXySekvq37kfCNk,127098,937701,-810603,621
2022-01-22 03:17:24-05:00,7633,4ne6vC7qdxQYHJCsaeFAKZrKdFt2SwXGHQ3jrMHqt4DL,Cf1dLHY2WXH9rXbRKq5TT8THbdo9SdNUZq4rYhRCF9z,True,4375604,1093901,6808,3404,3404,3zqXX6kzhkbW3d4TwD2CNjMRwxTbREXySekvq37kfCNk,272338,2090140,-1817802,622
2022-01-22 03:17:24-05:00,7634,DvuRmJkfn6FQczUKgYeaSCqwy2NTMunuAKNrnmxMvnzS,7LpWTX9dgBtW75kfEoB5WuNsDwEdw5s8CYSHh3J4qagM,True,2101039,525259,3259,1629,1630,3zqXX6kzhkbW3d4TwD2CNjMRwxTbREXySekvq37kfCNk,130371,1811551,-1681180,620
2022-01-22 03:17:31-05:00,7635,C1rjefgArnN3nBn5Wu3yXij2wAyGWFtWdjGNLR9vpjmj,GsLCESLzYGZ1brEh8RJrZttE7hxcpSq7iUqdhwJhnDVB,True,4115218,1028804,6410,3205,3205,3zqXX6kzhkbW3d4TwD2CNjMRwxTbREXySekvq37kfCNk,256435,2880083,-2623648,623
2022-01-22 03:17:35-05:00,7636,DC4UVUDFWL3gVtgkX9hPtFgtxaA8DH5p94i4k9U3wyWv,3HCWqVvQQfRgSKitsTjGTduJ82ointZUSNtj13uea4kD,True,43276815,10819203,66690,33345,33345,4BnQKPLuE3DMTtxp8MjUBytgnhvxqq3ZTqZHTVZo4JJh,2667632,30471617,-27803985,616
2022-01-22 03:17:39-05:00,7637,HELPNUwAqTX7gfHS4cnJnqXFM6Rb156tYcpsitKR9iDu,3RdfgDvLvsdZG5Cf6hKiKMQMqfidyxHzjYvUx1FZpeHQ,True,10896562,2724140,16986,8493,8493,4BnQKPLuE3DMTtxp8MjUBytgnhvxqq3ZTqZHTVZo4JJh,679468,10896874,-10217406,623
2022-01-22 03:17:39-05:00,7638,3c4tj9J8QwB3exFchWei43nBh5xsYRZxEUfayi3JvYgm,Fyw1TEEDKhLFo16qxDsttsAwSkrfzpDe8Dmm3atEeXyN,True,9948305,2487076,15350,7675,7675,3zqXX6kzhkbW3d4TwD2CNjMRwxTbREXySekvq37kfCNk,614021,7274710,-6660689,617
2022-01-22 03:17:40-05:00,7639,2sPD4f4d3CCeFSwSC5vAGS3YoTsTGypYKfDeoJczebop,HWCRpcq2sXqJL7Vi8MtipQDwGSViE73bUxS36ETmvnP2,True,4434852,1108713,6878,3439,3439,3zqXX6kzhkbW3d4TwD2CNjMRwxTbREXySekvq37kfCNk,275123,1989850,-1714727,620
2022-01-22 03:17:40-05:00,7640,7dmoK7QPki7R66SPQST4veUgVfnJbVToxxBPZveECiwK,4vh4REBDm5zBDmcjRCD9zNsny1HGneu7B2co4dSJNLL6,True,19252825,4813205,29917,14958,14959,3zqXX6kzhkbW3d4TwD2CNjMRwxTbREXySekvq37kfCNk,1196710,14797720,-13601010,621
2022-01-22 03:17:43-05:00,7641,EXP61AETWHw3kHSjrJH1jQBt6cXR9Zebz34Cueb3KAzg,2JT9GrgdUKjuQQtXvZqevbjFquUQBMYDoADmBjDKWXj3,True,108262071,27065517,168301,84150,84151,4BnQKPLuE3DMTtxp8MjUBytgnhvxqq3ZTqZHTVZo4JJh,6732071,50300863,-43568792,621
2022-01-22 03:17:44-05:00,7642,EAtQUZAkQxwJF779DwPcWHZ455FzYX8mzm1uV5LBnhPB,8h8t6GW1Y7xMBfWpfyFfUVBP4apMbJVNg7igZUYZLsyr,True,26665719,6666429,41062,20531,20531,3zqXX6kzhkbW3d4TwD2CNjMRwxTbREXySekvq37kfCNk,1642509,8719290,-7076781,615
2022-01-22 03:17:54-05:00,7643,AvwHizRhHUSahmvSg4jmTUErc7vAFSmkRAEsiKhXfW1m,3UrWYx8y9N5o9GYneSe6zyyHRTZzxwvcipQfHHYh7tEs,True,63649,15912,99,49,50,HfEnetJ7uBSmZWCjBNxdvv9HEC5nsW4wDV7wu6WnhWan,3973,45994,-42021,624
2022-01-22 03:18:24-05:00,7644,4SQQdHTJUDv8taPXQRvEVJpUu91iCWQsv9su8tfehaQG,33CJXj1pmmatAofRvgt5in9E6SLEuy7tq4jqSwnUWP2A,True,695307189,173826797,1069893,534946,534947,4BnQKPLuE3DMTtxp8MjUBytgnhvxqq3ZTqZHTVZo4JJh,42795741,648709763,-605914022,615
2022-01-22 03:18:33-05:00,7645,GjQQ2fQ7mrGjWZwjVYFUKp9NM1LmfkhEo675ovU5SPa8,ECgVUMRY5nB4MALs5drDyipF7YohCPuJpj2UegCs7HMn,True,390704,97676,610,305,305,3zqXX6kzhkbW3d4TwD2CNjMRwxTbREXySekvq37kfCNk,24403,311308,-286905,624
2022-01-22 03:19:06-05:00,7646,5NVD6QvomTAD35yNxSFZw4DhF2hCtV8drkbnGhBVtK5y,3JzkyPnREvoFZLL9JZuuDEnee3nuKcrqY3xLuXsmHwRo,True,1032349,258087,1610,805,805,3zqXX6kzhkbW3d4TwD2CNjMRwxTbREXySekvq37kfCNk,64406,908806,-844400,623
2022-01-22 03:19:08-05:00,7647,F9s8a7Cpiw5dw3a2aNFMofqwyDWNXvDLnSdJzoj1gRiV,GpKsQKJD79KBRWdCTkyi4zX7NaoCWsLUjrKxAwJB6o6s,True,516062,129015,806,403,403,4BnQKPLuE3DMTtxp8MjUBytgnhvxqq3ZTqZHTVZo4JJh,32241,280900,-248659,624
2022-01-22 03:22:19-05:00,7648,GQviUdocJ1s4FsVDDexanvo5yQWRZgwwkGJBCg7TMtJC,HAX4VAKgQpKtm1149iRgtzvUaUkiXWcA1bJ9ERu6tXkd,True,23416734,5854183,36311,18155,18156,DddJ7EWCmYEEZETCBNgAUSg81Ls6fZtiAaY5ekJ5sXx1,1452442,7653208,-6200766,620
2022-01-22 03:22:48-05:00,7649,2pKygdXJnjZBFfrZgDasmHQQgw8LgycmBBRuaoCU72cz,DXsomQ5yWw2ceZMbaCVsSaE4hKm9W6Gy785JG75Aaz18,True,4291309,1072827,6679,3339,3340,3zqXX6kzhkbW3d4TwD2CNjMRwxTbREXySekvq37kfCNk,267173,1981316,-1714143,622
2022-01-22 03:22:49-05:00,7650,GxFxvEUdWofneMmVvhCSScH9V6Zia5WJ2J9q6CpPnaq3,ATLykiHDii3Lw53MoZXwqu1FbBNPJbVNVGe2SoQMjVmY,True,78478,19619,122,61,61,3zqXX6kzhkbW3d4TwD2CNjMRwxTbREXySekvq37kfCNk,4880,69080,-64200,621
2022-01-22 03:22:50-05:00,7651,3FF2rhr1RuT7UR7MmmGtrhfYbh6kbc5UXq51KmqFLZnq,AEmSYLt1dQ8suLugC4Lcw4kF3dG9GYcEfX54hEAKfmv5,True,4766372,1191593,7406,3703,3703,4BnQKPLuE3DMTtxp8MjUBytgnhvxqq3ZTqZHTVZo4JJh,296257,2202758,-1906501,621
2022-01-22 03:23:01-05:00,7652,72woixtGAuGazCMfsYfYBYLP7FuRj8Fwz9fynFo4MCE4,5237BmWkKf58PBeTUEiu3Ld5uKXEe8wcrJRmCnUoWWku,True,17125440,4281360,26784,13392,13392,3zqXX6kzhkbW3d4TwD2CNjMRwxTbREXySekvq37kfCNk,1071375,9106568,-8035193,625
2022-01-22 03:23:13-05:00,7653,25NUDrsdLhS3fcARLiTMbbmZHvvzvzPj9xAdoN8sJBN3,8baNRGHfYRcLdhbHNuH72ofAWM9UojqhTMLnbBayzGnW,True,6574822,1643705,10263,5131,5132,3zqXX6kzhkbW3d4TwD2CNjMRwxTbREXySekvq37kfCNk,410530,3407282,-2996752,624
2022-01-22 03:23:34-05:00,7654,8JtUn4uue4WzrySwnDQ74qzzWaKsoo11MbMvRh1ePDJN,8iahKConWg6fyZrkoze5eeujyNHA26AybYBpHwUr76Cu,True,53658618,13414654,80274,40137,40137,HfEnetJ7uBSmZWCjBNxdvv9HEC5nsW4wDV7wu6WnhWan,3210971,30388252,-27177281,598
2022-01-22 03:23:35-05:00,7655,CmvNNpdGVDGujBadaMmgKc8xgFfyV6G9PNEjD8zEND6L,EzmfinKBZ8TXoSugyTqdEdHWrHdTdpHQtc1TApfaNfDR,True,2143533034,535883258,3314905,1657452,1657453,4BnQKPLuE3DMTtxp8MjUBytgnhvxqq3ZTqZHTVZo4JJh,132596215,1550922762,-1418326547,618
2022-01-22 03:24:20-05:00,7656,D7XummfEc3NTK4qMvZegV3FrYuqc8mNgnQu3ujwemZtg,HHiRcecqzW7sGFTio7Ph6TYv3dGt64KWv4DEKgKm84fQ,True,136870,34217,212,106,106,3zqXX6kzhkbW3d4TwD2CNjMRwxTbREXySekvq37kfCNk,8487,121135,-112648,620
2022-01-22 03:24:20-05:00,7657,4hZG7dM716SxDagiFGwt1gSC99B2QK1emGLV9TJmmuR8,7vjfUWySkyx4Z5qAaRr2VWnVvxHHNsvPj1PirGNSjM6,True,4611170023,1152792505,7209050,3604525,3604525,3zqXX6kzhkbW3d4TwD2CNjMRwxTbREXySekvq37kfCNk,288362004,2364442892,-2076080888,625
2022-01-22 03:25:07-05:00,7658,GjQQ2fQ7mrGjWZwjVYFUKp9NM1LmfkhEo675ovU5SPa8,ECgVUMRY5nB4MALs5drDyipF7YohCPuJpj2UegCs7HMn,True,286107,71526,421,210,211,4BnQKPLuE3DMTtxp8MjUBytgnhvxqq3ZTqZHTVZo4JJh,16872,238972,-222100,589
2022-01-22 03:25:07-05:00,7659,GBpe8E33cNkFmMUuP3WjhDBBuQz7MHaDkpCJjGFaFkvu,3QYFKkgzZ1PKKAxCh4hMhgqrupoCcfRVkjuJZRWVZo3H,True,13571981,3392995,20350,10175,10175,4BnQKPLuE3DMTtxp8MjUBytgnhvxqq3ZTqZHTVZo4JJh,814026,6795508,-5981482,599
2022-01-22 03:25:07-05:00,7660,DvuRmJkfn6FQczUKgYeaSCqwy2NTMunuAKNrnmxMvnzS,7LpWTX9dgBtW75kfEoB5WuNsDwEdw5s8CYSHh3J4qagM,True,1526405,381601,1943,971,972,4BnQKPLuE3DMTtxp8MjUBytgnhvxqq3ZTqZHTVZo4JJh,77737,1387998,-1310261,509
2022-01-22 03:25:07-05:00,7661,GxFxvEUdWofneMmVvhCSScH9V6Zia5WJ2J9q6CpPnaq3,ATLykiHDii3Lw53MoZXwqu1FbBNPJbVNVGe2SoQMjVmY,True,57583,14395,87,43,44,3zqXX6kzhkbW3d4TwD2CNjMRwxTbREXySekvq37kfCNk,3482,52909,-49427,604
2022-01-22 03:25:07-05:00,7662,7feC64HZfQpniey2iXsMMgQXnfcunJus74DiKDeKaEUw,GstsCxAiBBEUrXNkvZZ9Sg4vNK916PsKe2Mx6e4M6dU7,True,135839,33959,185,92,93,DddJ7EWCmYEEZETCBNgAUSg81Ls6fZtiAaY5ekJ5sXx1,7412,96824,-89412,545
2022-01-22 03:25:07-05:00,7663,6uZobpBuFcQeYgZ4dApFi6iy4DB9GLHP1AAsQcCj6212,SGGFiPjjhscwroiWMqY4jTAHFw8eakpsEv35wNoHUPY,True,23815988,5953995,37071,18535,18536,3zqXX6kzhkbW3d4TwD2CNjMRwxTbREXySekvq37kfCNk,1482876,7391763,-5908887,622
2022-01-22 03:25:09-05:00,7664,C1rjefgArnN3nBn5Wu3yXij2wAyGWFtWdjGNLR9vpjmj,GsLCESLzYGZ1brEh8RJrZttE7hxcpSq7iUqdhwJhnDVB,True,2991372,747843,3874,1937,1937,3zqXX6kzhkbW3d4TwD2CNjMRwxTbREXySekvq37kfCNk,154983,2217762,-2062779,518
2022-01-22 03:25:09-05:00,7665,DC4UVUDFWL3gVtgkX9hPtFgtxaA8DH5p94i4k9U3wyWv,3HCWqVvQQfRgSKitsTjGTduJ82ointZUSNtj13uea4kD,True,31556299,7889074,42490,21245,21245,3zqXX6kzhkbW3d4TwD2CNjMRwxTbREXySekvq37kfCNk,1699629,23453968,-21754339,538
2022-01-22 03:25:09-05:00,7666,FV3G5EsSmyiLAAoREhgDXwvzbxoyDeq4Mwfj4jK5fJ7U,5nhzbJmm5JAwGDpTZoenkM1u3XtMY4uN7Qsm3vFGtRJE,True,1485331,371332,1896,948,948,3zqXX6kzhkbW3d4TwD2CNjMRwxTbREXySekvq37kfCNk,75873,731874,-656001,510
2022-01-22 03:25:09-05:00,7667,3FF2rhr1RuT7UR7MmmGtrhfYbh6kbc5UXq51KmqFLZnq,AEmSYLt1dQ8suLugC4Lcw4kF3dG9GYcEfX54hEAKfmv5,True,3497249,874312,5283,2641,2642,3zqXX6kzhkbW3d4TwD2CNjMRwxTbREXySekvq37kfCNk,211321,1718728,-1507407,604
2022-01-22 03:25:09-05:00,7668,4xn9vTtLZyNtCbBLLpcXUMWU8AnnZCov9rJaY6rew16T,5UNWdFw2CP44qS8oc4uPt8zxw6zFg8oXz8SUCedZLLEC,False,572147,572147,27875,1393,26482,3zqXX6kzhkbW3d4TwD2CNjMRwxTbREXySekvq37kfCNk,27875,299316,-271441,487
2022-01-22 03:25:09-05:00,7669,F9s8a7Cpiw5dw3a2aNFMofqwyDWNXvDLnSdJzoj1gRiV,GpKsQKJD79KBRWdCTkyi4zX7NaoCWsLUjrKxAwJB6o6s,True,378115,94528,562,281,281,3zqXX6kzhkbW3d4TwD2CNjMRwxTbREXySekvq37kfCNk,22503,217930,-195427,595
2022-01-22 03:25:09-05:00,7670,8JtUn4uue4WzrySwnDQ74qzzWaKsoo11MbMvRh1ePDJN,8iahKConWg6fyZrkoze5eeujyNHA26AybYBpHwUr76Cu,True,39538508,9884627,60631,30315,30316,3zqXX6kzhkbW3d4TwD2CNjMRwxTbREXySekvq37kfCNk,2425241,23513710,-21088469,613
2022-01-22 03:25:10-05:00,7671,HELPNUwAqTX7gfHS4cnJnqXFM6Rb156tYcpsitKR9iDu,3RdfgDvLvsdZG5Cf6hKiKMQMqfidyxHzjYvUx1FZpeHQ,True,7945465,1986366,10888,5444,5444,3zqXX6kzhkbW3d4TwD2CNjMRwxTbREXySekvq37kfCNk,435525,8325540,-7890015,548
2022-01-22 03:25:10-05:00,7672,Br1j5Ftafei7ysu5SmqVZSoRe4uS4qCPeKSPHg55pyiE,G8fc7QvXjfkgBFvAVUgJFQS3VaF1biL9rktBExGa87Ks,True,228553295,57138322,349059,174529,174530,3zqXX6kzhkbW3d4TwD2CNjMRwxTbREXySekvq37kfCNk,13962375,149866228,-135903853,610
2022-01-22 03:25:10-05:00,7673,5NVD6QvomTAD35yNxSFZw4DhF2hCtV8drkbnGhBVtK5y,3JzkyPnREvoFZLL9JZuuDEnee3nuKcrqY3xLuXsmHwRo,True,756391,189097,1123,561,562,3zqXX6kzhkbW3d4TwD2CNjMRwxTbREXySekvq37kfCNk,44925,696097,-651172,593
2022-01-22 03:25:10-05:00,7674,AvwHizRhHUSahmvSg4jmTUErc7vAFSmkRAEsiKhXfW1m,3UrWYx8y9N5o9GYneSe6zyyHRTZzxwvcipQfHHYh7tEs,True,46437,11609,64,32,32,3zqXX6kzhkbW3d4TwD2CNjMRwxTbREXySekvq37kfCNk,2574,35390,-32816,554
2022-01-22 03:25:13-05:00,7675,72woixtGAuGazCMfsYfYBYLP7FuRj8Fwz9fynFo4MCE4,5237BmWkKf58PBeTUEiu3Ld5uKXEe8wcrJRmCnUoWWku,True,12572451,3143112,19324,9662,9662,3uL2NSR2ZdDqCiKfzA5SwwpddAnit22DBJo6uvvz1rRs,772962,7070992,-6298030,614
2022-01-22 03:25:13-05:00,7676,4SQQdHTJUDv8taPXQRvEVJpUu91iCWQsv9su8tfehaQG,33CJXj1pmmatAofRvgt5in9E6SLEuy7tq4jqSwnUWP2A,True,508876233,127219058,728042,364021,364021,3zqXX6kzhkbW3d4TwD2CNjMRwxTbREXySekvq37kfCNk,29121689,496171961,-467050272,572
2022-01-22 03:25:13-05:00,7677,3c4tj9J8QwB3exFchWei43nBh5xsYRZxEUfayi3JvYgm,Fyw1TEEDKhLFo16qxDsttsAwSkrfzpDe8Dmm3atEeXyN,True,7253893,1813473,9783,4891,4892,3zqXX6kzhkbW3d4TwD2CNjMRwxTbREXySekvq37kfCNk,391335,5594190,-5202855,539
2022-01-22 03:25:17-05:00,7678,2sPD4f4d3CCeFSwSC5vAGS3YoTsTGypYKfDeoJczebop,HWCRpcq2sXqJL7Vi8MtipQDwGSViE73bUxS36ETmvnP2,True,3233710,808427,4395,2197,2198,3zqXX6kzhkbW3d4TwD2CNjMRwxTbREXySekvq37kfCNk,175816,1554291,-1378475,543
2022-01-22 03:25:20-05:00,7679,2pKygdXJnjZBFfrZgDasmHQQgw8LgycmBBRuaoCU72cz,DXsomQ5yWw2ceZMbaCVsSaE4hKm9W6Gy785JG75Aaz18,True,3148616,787154,4765,2382,2383,3zqXX6kzhkbW3d4TwD2CNjMRwxTbREXySekvq37kfCNk,190628,1546102,-1355474,605
2022-01-22 03:25:27-05:00,7680,2niazdR63iWLyZ3ABWZVAnJiEjVyDyLGo4jZ6wh3j2Zz,4RvU5UtyE5CqMStPciiCTdhYCdaUUfdKSYS5nkATs1qn,True,23721564,5930391,36980,18490,18490,4BnQKPLuE3DMTtxp8MjUBytgnhvxqq3ZTqZHTVZo4JJh,1479211,7750147,-6270936,623
2022-01-22 03:25:27-05:00,7681,6k9unyyhVTrGhAhBrFjgumRfBtKFRBrVaeWtYB56LgEg,3n9VYUH53fxmwFwdYKT9xAZYDzjodhMsJ5iGAoJTqCt4,True,23723702,5930925,37033,18516,18517,3zqXX6kzhkbW3d4TwD2CNjMRwxTbREXySekvq37kfCNk,1481329,7750127,-6268798,624
2022-01-22 03:25:48-05:00,7682,GHn96Ev7UmKJWqch3H3wzXpRT7qLg5FBuSBJAATVED1f,BXBSUddfz9MThXqk4517M7YVRDGdTm4pC6G4ipT69TMV,True,18884972,4721243,29039,14519,14520,3zqXX6kzhkbW3d4TwD2CNjMRwxTbREXySekvq37kfCNk,1161576,6150617,-4989041,615
2022-01-22 03:25:50-05:00,7683,7tDiadLeMrob7yD6R5SDskYn41tnQZVPjEc6W2vv6irK,AHZidccE9ERBcipuRQ2iGM9kHRpTnty7UNuYTFurvXB7,True,110674899,27668724,169905,84952,84953,3zqXX6kzhkbW3d4TwD2CNjMRwxTbREXySekvq37kfCNk,6796225,38537092,-31740867,614
2022-01-22 03:26:04-05:00,7684,CmvNNpdGVDGujBadaMmgKc8xgFfyV6G9PNEjD8zEND6L,EzmfinKBZ8TXoSugyTqdEdHWrHdTdpHQtc1TApfaNfDR,True,1574555419,393638854,2404673,1202336,1202337,3zqXX6kzhkbW3d4TwD2CNjMRwxTbREXySekvq37kfCNk,96186953,1193115936,-1096928983,610
2022-01-22 03:26:04-05:00,7685,D7XummfEc3NTK4qMvZegV3FrYuqc8mNgnQu3ujwemZtg,HHiRcecqzW7sGFTio7Ph6TYv3dGt64KWv4DEKgKm84fQ,True,100614,25153,155,77,78,3zqXX6kzhkbW3d4TwD2CNjMRwxTbREXySekvq37kfCNk,6236,92762,-86526,619
2022-01-22 03:26:21-05:00,7686,DvuRmJkfn6FQczUKgYeaSCqwy2NTMunuAKNrnmxMvnzS,7LpWTX9dgBtW75kfEoB5WuNsDwEdw5s8CYSHh3J4qagM,True,1137497,284374,1712,856,856,HfEnetJ7uBSmZWCjBNxdvv9HEC5nsW4wDV7wu6WnhWan,68487,1058491,-990004,602
2022-01-22 03:26:23-05:00,7687,C1rjefgArnN3nBn5Wu3yXij2wAyGWFtWdjGNLR9vpjmj,GsLCESLzYGZ1brEh8RJrZttE7hxcpSq7iUqdhwJhnDVB,True,2229208,557302,3419,1709,1710,3zqXX6kzhkbW3d4TwD2CNjMRwxTbREXySekvq37kfCNk,136788,1698194,-1561406,613
2022-01-22 03:26:23-05:00,7688,4hZG7dM716SxDagiFGwt1gSC99B2QK1emGLV9TJmmuR8,7vjfUWySkyx4Z5qAaRr2VWnVvxHHNsvPj1PirGNSjM6,True,3379461473,844865368,5055922,2527961,2527961,HfEnetJ7uBSmZWCjBNxdvv9HEC5nsW4wDV7wu6WnhWan,202236909,1838576127,-1636339218,598
2022-01-22 03:26:24-05:00,7689,7dmoK7QPki7R66SPQST4veUgVfnJbVToxxBPZveECiwK,4vh4REBDm5zBDmcjRCD9zNsny1HGneu7B2co4dSJNLL6,True,14135548,3533886,21568,10784,10784,3zqXX6kzhkbW3d4TwD2CNjMRwxTbREXySekvq37kfCNk,862721,11367556,-10504835,610
2022-01-22 03:26:25-05:00,7690,FV3G5EsSmyiLAAoREhgDXwvzbxoyDeq4Mwfj4jK5fJ7U,5nhzbJmm5JAwGDpTZoenkM1u3XtMY4uN7Qsm3vFGtRJE,True,1106770,276692,1668,834,834,4BnQKPLuE3DMTtxp8MjUBytgnhvxqq3ZTqZHTVZo4JJh,66748,565979,-499231,603
2022-01-22 03:26:28-05:00,7691,5hJereyPSCNUrGW7TdYXHKjhXMWTbGZzc2GF9MWksLJE,AUE3NpqaeamHGBKUVuKnUhnBb4Lzt7xWU1FHMu1Hq5dC,True,74879946,18719986,115979,57989,57990,4BnQKPLuE3DMTtxp8MjUBytgnhvxqq3ZTqZHTVZo4JJh,4639167,36350223,-31711056,619
2022-01-22 03:26:28-05:00,7692,98pwBGgiSDuwuas6WYW2hc9qUxfULwvNE34aixaxbxXY,BLrjKxekjThtJ9rKtQxs1Y4rZ225EE2Q16VkP9TkThyV,True,18438055,4609513,28527,14263,14264,4BnQKPLuE3DMTtxp8MjUBytgnhvxqq3ZTqZHTVZo4JJh,1141111,6157145,-5016034,618
2022-01-22 03:32:14-05:00,7693,3Xbsek5MsEGoWr3G9yhuohREr26B2vSQcjqXdspTFHta,2rPxkUiMo9wGDq8EvAiwY3ngRpKmL223cBWWNTYoBmFp,True,8782234,2195558,12974,6487,6487,HfEnetJ7uBSmZWCjBNxdvv9HEC5nsW4wDV7wu6WnhWan,518987,4133214,-3614227,590
2022-01-22 03:33:50-05:00,7694,4Enpw9W2mWGnNYagYQ8WW29RLSs4R5YX4qXCsVqMFeHn,9QwbJmm9QDKXyc4ZViq74BfS35zzewEceXQNnFCgczXu,True,635344275,158836068,970645,485322,485323,3zqXX6kzhkbW3d4TwD2CNjMRwxTbREXySekvq37kfCNk,38825816,194505942,-155680126,611
2022-01-22 03:43:06-05:00,7695,8trkirSQNdMmAcJdeswxs5cPjH8dD6U4eJtWiAdMsrDB,HaSzpQ45x2MipfN17U6jGBxX8tXboomVDhXNSrnEfLDr,True,148687,37171,232,116,116,HfEnetJ7uBSmZWCjBNxdvv9HEC5nsW4wDV7wu6WnhWan,9305,106745,-97440,625
2022-01-22 03:50:30-05:00,7696,7Dm3syN4P2mbBLFKyHTrtnSWY4hadGXiKB9EekTdT68S,HF97QS1dqarPMWgNmtcoaq6z3rpJnzAAAfc1PP4FwRhV,True,4348676,1087169,6791,3395,3396,HfEnetJ7uBSmZWCjBNxdvv9HEC5nsW4wDV7wu6WnhWan,271651,1330365,-1058714,624
2022-01-22 03:50:30-05:00,7697,BgNgALwBEuiumVgiXRmBZRnyFrr9QTDy2maHzsNwNHGf,ag35Ec2uFtqkarizCxFyhM2SPBuUwfmLRhAdFEWFCNa,True,4274402,1068600,6462,3231,3231,HfEnetJ7uBSmZWCjBNxdvv9HEC5nsW4wDV7wu6WnhWan,258511,1988138,-1729627,604
2022-01-22 03:51:10-05:00,7698,3JrhHRs4UkkuMoCrQAaAGKZQrWoU72zWArnDGxKFESzH,8yREVE3kMYB7UAwtUDnTDK3egXTuTsN4igtJ5yeHYkCP,True,62144076,15536019,97215,48607,48608,3zqXX6kzhkbW3d4TwD2CNjMRwxTbREXySekvq37kfCNk,3888619,26344715,-22456096,625
2022-01-22 03:52:14-05:00,7699,B5CTBTggmGFvGFSunjbB4C9tLKcYcULehmEiEXRihY2J,FX3ebF8P89rZBWfR74PDWUzxnLuDkUDgGcPYCBD5sMUG,True,39343590,9835897,59989,29994,29995,3zqXX6kzhkbW3d4TwD2CNjMRwxTbREXySekvq37kfCNk,2399566,20009538,-17609972,609
2022-01-22 03:52:14-05:00,7700,HwosLQgDY1xtHQRQ4hzroPQHFWssPzTj5vRkP37FcviB,HKTNEYNXrephNkH7apbobK4mcQXcNayQA4W1NgM6sLr8,True,2792093,698023,4354,2177,2177,3zqXX6kzhkbW3d4TwD2CNjMRwxTbREXySekvq37kfCNk,174189,1533635,-1359446,623
2022-01-22 03:52:43-05:00,7701,243SAnGxchCVB1LQAUF4SsozR86yDwEdg2QQpbWGsMYe,5u8sNkb2oEQjUXJAB3yGStmv3Uwz16gBgExBo5myVK4b,True,1612134,403033,2513,1256,1257,3zqXX6kzhkbW3d4TwD2CNjMRwxTbREXySekvq37kfCNk,100538,864808,-764270,623
2022-01-22 03:55:36-05:00,7702,4Enpw9W2mWGnNYagYQ8WW29RLSs4R5YX4qXCsVqMFeHn,9QwbJmm9QDKXyc4ZViq74BfS35zzewEceXQNnFCgczXu,True,467486949,116871737,720847,360423,360424,3zqXX6kzhkbW3d4TwD2CNjMRwxTbREXySekvq37kfCNk,28833913,154623213,-125789300,616
2022-01-22 03:55:36-05:00,7703,25NUDrsdLhS3fcARLiTMbbmZHvvzvzPj9xAdoN8sJBN3,8baNRGHfYRcLdhbHNuH72ofAWM9UojqhTMLnbBayzGnW,True,4823744,1205936,7322,3661,3661,3zqXX6kzhkbW3d4TwD2CNjMRwxTbREXySekvq37kfCNk,292894,2647833,-2354939,607
2022-01-22 03:57:45-05:00,7704,ARB1q7bNcQ7grwFEZC6nk9Pfrrg7yZ2WK8zVqq5CEE8F,53e8mUYrWzQnCm9XQyp18CL9owyPqJcYyxZANYhRypPx,True,34512757,8628189,53085,26542,26543,3zqXX6kzhkbW3d4TwD2CNjMRwxTbREXySekvq37kfCNk,2123435,17773417,-15649982,615
2022-01-22 03:57:46-05:00,7705,9aQrdyfAvcBbBj7iKQB17eAS4zBqymdd3kzkTkuRhdLU,BDHhukMF5rALuSwCxaw8g73m2MN4oX1D4e7uNmx3SiVt,True,46613174,11653293,72284,36142,36142,3zqXX6kzhkbW3d4TwD2CNjMRwxTbREXySekvq37kfCNk,2891378,18526038,-15634660,620
2022-01-22 03:57:49-05:00,7706,EF6H6aW1p3qcAtiLFU9rbFYfsKfD683meHXDw8hLdaZK,8vfJbpnK7SQcjpEBCzZJRW8JosNbsmTeJ2YXZCbM225c,True,14182384,3545596,21823,10911,10912,HfEnetJ7uBSmZWCjBNxdvv9HEC5nsW4wDV7wu6WnhWan,872941,8219051,-7346110,615
2022-01-22 03:57:50-05:00,7707,GXSysysoV8Z4xBrQsaKUsSrpoWeTTUsbFmgfZDaQu4ZM,6FJyraiLgG3tb9B7pi4YFsJNtRVBNaghnm1ajzneVv7b,True,331048908,82762227,501955,250977,250978,3zqXX6kzhkbW3d4TwD2CNjMRwxTbREXySekvq37kfCNk,20078224,135782509,-115704285,606
2022-01-22 03:59:53-05:00,7708,2r64Rnbu3ZjmJTHHUxxV9TWWGzwpAepA4ySbtKivBXCj,6RRzx6KLkMiFK9JSuznrSJGiPgkHwatBSskudHqbfKJ5,True,256887695,64221923,401106,200553,200553,HfEnetJ7uBSmZWCjBNxdvv9HEC5nsW4wDV7wu6WnhWan,16044242,160062275,-144018033,624
2022-01-22 04:06:01-05:00,7709,HELPNUwAqTX7gfHS4cnJnqXFM6Rb156tYcpsitKR9iDu,3RdfgDvLvsdZG5Cf6hKiKMQMqfidyxHzjYvUx1FZpeHQ,True,5910977,1477744,9216,4608,4608,HfEnetJ7uBSmZWCjBNxdvv9HEC5nsW4wDV7wu6WnhWan,368649,6334285,-5965636,623
2022-01-22 04:06:01-05:00,7710,2sPD4f4d3CCeFSwSC5vAGS3YoTsTGypYKfDeoJczebop,HWCRpcq2sXqJL7Vi8MtipQDwGSViE73bUxS36ETmvnP2,True,2405742,601435,3716,1858,1858,3zqXX6kzhkbW3d4TwD2CNjMRwxTbREXySekvq37kfCNk,148679,1202077,-1053398,618
2022-01-22 04:06:03-05:00,7711,DC4UVUDFWL3gVtgkX9hPtFgtxaA8DH5p94i4k9U3wyWv,3HCWqVvQQfRgSKitsTjGTduJ82ointZUSNtj13uea4kD,True,23476056,5869014,35868,17934,17934,HfEnetJ7uBSmZWCjBNxdvv9HEC5nsW4wDV7wu6WnhWan,1434730,17941674,-16506944,611
2022-01-22 04:06:07-05:00,7712,3c4tj9J8QwB3exFchWei43nBh5xsYRZxEUfayi3JvYgm,Fyw1TEEDKhLFo16qxDsttsAwSkrfzpDe8Dmm3atEeXyN,True,5396579,1349144,8263,4131,4132,3zqXX6kzhkbW3d4TwD2CNjMRwxTbREXySekvq37kfCNk,330530,4276514,-3945984,612
2022-01-22 04:10:59-05:00,7713,AUH6YGBV8tDVX1E1WTo92Mubfx1DGsqfGeyUBqxo4fSr,33QZgMwmW32WuvmxD8XNbmF9ea88bLe3YTtNwHV73Wwu,True,12711982,3177995,19774,9887,9887,3uL2NSR2ZdDqCiKfzA5SwwpddAnit22DBJo6uvvz1rRs,790996,7591862,-6800866,622
2022-01-22 04:10:59-05:00,7714,8kJu5aqVSmW8FSZR9h6F75ftn9V2U9uMLBEKeqRaC855,FhVHByujkvwwtjTVpZ4mqSUqoMoBgeLUc5H7rbz3FgAt,True,5375384,1343846,8186,4093,4093,3uL2NSR2ZdDqCiKfzA5SwwpddAnit22DBJo6uvvz1rRs,327479,4725756,-4398277,609
2022-01-22 04:10:59-05:00,7715,D9VKhnfLLCrntDGFYSfoxFaY76VnHmYZ1ZbyFXdKdibz,2hRCRH2pMDyQGYcXHa8Y6BZo6FbcGZf5VJC1v8Bp6tGa,True,5593488,1398372,8533,4266,4267,3uL2NSR2ZdDqCiKfzA5SwwpddAnit22DBJo6uvvz1rRs,341347,3593490,-3252143,610
2022-01-22 04:10:59-05:00,7716,FnAT8HKGgisYfeAbxKU2gSbCp8KbZHULRpaJX1NVijHy,2u637Crc2QzfSJmCnRNqeib3aZQVn4NGncpgM3Ph6jvm,True,2085896,521474,3207,1603,1604,3uL2NSR2ZdDqCiKfzA5SwwpddAnit22DBJo6uvvz1rRs,128313,1225844,-1097531,615
2022-01-22 04:10:59-05:00,7717,9KD2AifD5wFD4QkHYuawXbJgLWHrfj2QPF3fT8jhGVA5,Ga9gAqmkuHbqrr31sUFPqa1xa5WNxLWJWGPUaMxQqLdj,True,59225,14806,91,45,46,3uL2NSR2ZdDqCiKfzA5SwwpddAnit22DBJo6uvvz1rRs,3667,52649,-48982,619
2022-01-22 04:11:03-05:00,7718,72L76qDRMK3M7X52zuuB9GVyvFFLDBZwFMpVjWjghXzA,4m2ZVuemUctu1edv4YJVAcjXzKwpbCmBujzoUmLDeA7h,True,21557312,5389328,33247,16623,16624,3zqXX6kzhkbW3d4TwD2CNjMRwxTbREXySekvq37kfCNk,1329891,8878116,-7548225,616
2022-01-22 04:11:03-05:00,7719,B2hN3Lt5pFbUyfEUc5s48hkxUJ5rr2SeFxgdGdQ8pDD2,7bZJCCud253j9g411HQUDXUAADcwd5yJWznoTChBdB2H,True,369659128,92414782,557191,278595,278596,3zqXX6kzhkbW3d4TwD2CNjMRwxTbREXySekvq37kfCNk,22287663,123287111,-100999448,602
2022-01-22 04:11:03-05:00,7720,CpxZ136k95cVjGqkJnNpDZKUgrJrfg8HrFDZPL6BgsK4,Fo7HtcrneUTsnGqygsxPQ63G5rayYodYT65xP6B6HusH,True,94725869,23681467,145062,72531,72531,3zqXX6kzhkbW3d4TwD2CNjMRwxTbREXySekvq37kfCNk,5802499,30350914,-24548415,612
2022-01-22 04:11:03-05:00,7721,8eTH6eJyyVeMno3UQkffeBg32xofKsQfkhLhXdtaf87s,BCFC7CPXrQPsUfJb2eYSht8GhaApWHpc49AeCXqaYq13,True,13608771,3402192,20474,10237,10237,3zqXX6kzhkbW3d4TwD2CNjMRwxTbREXySekvq37kfCNk,818981,5575237,-4756256,601
2022-01-22 04:11:03-05:00,7722,6N4PNbueNmkCECF8ojw5R6wGtxComzgGED179GiJaLjQ,AL8eRDEo8yCvD4n4kvruEuZzXBXrJrEiBt9SQwCcDPYd,True,281701946,70425486,423451,211725,211726,3zqXX6kzhkbW3d4TwD2CNjMRwxTbREXySekvq37kfCNk,16938074,113333055,-96394981,601
2022-01-22 04:11:03-05:00,7723,cG5VSSaBpjNdRLMQT7dmotpcWRTfdmJZYdWsrzNzRTE,5RESxV6aZenjAdaqw1jxoYSGttpLrNuZiRJy2WeLAVJv,True,120351107,30087776,186008,93004,93004,3zqXX6kzhkbW3d4TwD2CNjMRwxTbREXySekvq37kfCNk,7440352,70359964,-62919612,618
2022-01-22 04:11:03-05:00,7724,BRK2EePsnQq54oaD2Ua4cxxKhdgVS2Kx57JKXCrBkeg7,7yskmLp2oA9qN38G7NBqVGggzs4ZoQ63HD4EnMVweMyY,True,597983494,149495873,933319,466659,466660,3zqXX6kzhkbW3d4TwD2CNjMRwxTbREXySekvq37kfCNk,37332797,239561928,-202229131,624
2022-01-22 04:11:49-05:00,7725,FsMiJiJZibohKoV5QRisWCjzuFd86xSxFb4m73AQmu93,7p3TSKBaG9SV2YNDnhutQKacPKpTTmgsEfzmK51t6sYb,True,12696129,3174032,19796,9898,9898,3zqXX6kzhkbW3d4TwD2CNjMRwxTbREXySekvq37kfCNk,791871,7475322,-6683451,623
2022-01-22 04:11:49-05:00,7726,H3394S5wdbwXB4scjGAY8NsXxCdGy1Xebct18s42FM1K,Hz84L1EquzhCvBJP75ScKug46hYGdNMVNH16AdG4y5D8,True,2856794,714198,4451,2225,2226,3zqXX6kzhkbW3d4TwD2CNjMRwxTbREXySekvq37kfCNk,178057,1887382,-1709325,623
2022-01-22 04:11:52-05:00,7727,36ByQojnxEckWdQTjqHfxKqCx9yjqWQsPsZyqaN72UWR,AZoirtS1fjX61agRM64tqThVinnJTh3BWgiHyNHPTgZP,True,36142,9035,56,28,28,HfEnetJ7uBSmZWCjBNxdvv9HEC5nsW4wDV7wu6WnhWan,2258,31548,-29290,624
2022-01-22 04:13:04-05:00,7728,A36aouot1oFLUtswuBUM4EVcis9chKaSJu53MRoPDjab,33U9gpq1RRFMGWDrWa3ezXXkwgBewdAS6QGgGVPtGvqb,True,16371755,4092938,25604,12802,12802,3zqXX6kzhkbW3d4TwD2CNjMRwxTbREXySekvq37kfCNk,1024165,9602641,-8578476,625
2022-01-22 04:13:07-05:00,7729,3VdSA9CED9f5swRwHX2U15U7J6Muaq8VPnCNy9CaGDHe,2YYstfnfdYic5NWmEbcUEHpccNUVd1EhuCkExvMsoMk8,True,304728,76182,472,236,236,3zqXX6kzhkbW3d4TwD2CNjMRwxTbREXySekvq37kfCNk,18880,268763,-249883,619
2022-01-22 04:13:09-05:00,7730,EitU96ThqHErybDn2j1NY6JHkqV1R3mWM1uWH7wYKr1T,2p9eYbLyBqXrhHtRKp1jJb7VGjCmb4LkA6kzqLr1ijet,True,7091596,1772899,11081,5540,5541,3zqXX6kzhkbW3d4TwD2CNjMRwxTbREXySekvq37kfCNk,443273,3942620,-3499347,625
2022-01-22 04:13:09-05:00,7731,4MSyrHopFkuaCEEvLAUV9cJfVre6cLAx5sJF5LEMSCTX,6HhLHoswuDKrcixShWCDcquW6PgmbS5FidEnkM3bwuJQ,True,3125170,781292,4862,2431,2431,3zqXX6kzhkbW3d4TwD2CNjMRwxTbREXySekvq37kfCNk,194500,1187341,-992841,622
2022-01-22 04:13:21-05:00,7732,7ptPfZnqDCvTWotn8wPGyzERTJYLBgk47j7qf8Ciq941,AfAGcFqFFPi6LCQXydgsPWidN35c7NbhBa7RLEaDQQCu,False,1088778,1088778,54348,2717,51631,3zqXX6kzhkbW3d4TwD2CNjMRwxTbREXySekvq37kfCNk,54348,541545,-487197,499
2022-01-22 04:14:28-05:00,7733,H1Z83zVoskNuBvYao1FjdLfETfhPpQFQUkniJfGxbaNz,EVqbBRV6Zy1tPLRevxpAykp8Mvv6tDZVTc4RmCKw4Gq1,True,66633962,16658490,102179,51089,51090,HfEnetJ7uBSmZWCjBNxdvv9HEC5nsW4wDV7wu6WnhWan,4087176,48197308,-44110132,613
2022-01-22 04:15:15-05:00,7734,8T4WK27RvWVGqPuNqY6whk1fmU4vd5qaUQPZG1GJ79bh,DvSz7knS8N3K7L6JhQf1s4mJSyxB8uJXNQXtyjJn8QRL,True,4122132,1030532,6429,3214,3215,3zqXX6kzhkbW3d4TwD2CNjMRwxTbREXySekvq37kfCNk,257187,3138527,-2881340,623
2022-01-22 04:15:15-05:00,7735,5kwvkEtRFFD84j4ntVgxkacadgJaFvQ9JLhJqzLR7Y3G,GpMMkTv9T7y8DTiizuoJUsWvnSk3GSxADjRMGyYpryxm,True,1428088,357022,2234,1117,1117,3zqXX6kzhkbW3d4TwD2CNjMRwxTbREXySekvq37kfCNk,89382,814567,-725185,625
2022-01-22 04:19:39-05:00,7736,BgNgALwBEuiumVgiXRmBZRnyFrr9QTDy2maHzsNwNHGf,ag35Ec2uFtqkarizCxFyhM2SPBuUwfmLRhAdFEWFCNa,True,3151643,787910,4793,2396,2397,3zqXX6kzhkbW3d4TwD2CNjMRwxTbREXySekvq37kfCNk,191737,1543117,-1351380,608
2022-01-22 04:20:14-05:00,7737,7Dm3syN4P2mbBLFKyHTrtnSWY4hadGXiKB9EekTdT68S,HF97QS1dqarPMWgNmtcoaq6z3rpJnzAAAfc1PP4FwRhV,True,3196400,799100,4837,2418,2419,HfEnetJ7uBSmZWCjBNxdvv9HEC5nsW4wDV7wu6WnhWan,193493,1052637,-859144,605
2022-01-22 04:21:24-05:00,7738,25NUDrsdLhS3fcARLiTMbbmZHvvzvzPj9xAdoN8sJBN3,8baNRGHfYRcLdhbHNuH72ofAWM9UojqhTMLnbBayzGnW,True,3560539,890134,5532,2766,2766,4BnQKPLuE3DMTtxp8MjUBytgnhvxqq3ZTqZHTVZo4JJh,221284,2044758,-1823474,621
2022-01-22 04:21:24-05:00,7739,B5CTBTggmGFvGFSunjbB4C9tLKcYcULehmEiEXRihY2J,FX3ebF8P89rZBWfR74PDWUzxnLuDkUDgGcPYCBD5sMUG,True,29020082,7255020,45221,22610,22611,HfEnetJ7uBSmZWCjBNxdvv9HEC5nsW4wDV7wu6WnhWan,1808873,15503989,-13695116,623
2022-01-22 04:21:24-05:00,7740,243SAnGxchCVB1LQAUF4SsozR86yDwEdg2QQpbWGsMYe,5u8sNkb2oEQjUXJAB3yGStmv3Uwz16gBgExBo5myVK4b,True,1186945,296736,1838,919,919,3uL2NSR2ZdDqCiKfzA5SwwpddAnit22DBJo6uvvz1rRs,73530,668889,-595359,619
2022-01-22 04:22:47-05:00,7741,4Enpw9W2mWGnNYagYQ8WW29RLSs4R5YX4qXCsVqMFeHn,9QwbJmm9QDKXyc4ZViq74BfS35zzewEceXQNnFCgczXu,True,344643009,86160752,536514,268257,268257,HfEnetJ7uBSmZWCjBNxdvv9HEC5nsW4wDV7wu6WnhWan,21460573,121779179,-100318606,622
2022-01-22 04:24:36-05:00,7742,BJaaH1SK1pF2kZQzmYpLFfDtm52CR9a5rd39RAPtLe8q,HUsT5FVxaisdnCvG1BQxX6zffjfL2Rwx5mMo5y8SDV7e,True,2379519,594878,3679,1839,1840,HfEnetJ7uBSmZWCjBNxdvv9HEC5nsW4wDV7wu6WnhWan,147165,1272892,-1125727,618
2022-01-22 04:28:49-05:00,7743,3XZLp6JyrQYnufa1obczXqmK6cNR29ZMW1FdCYbWNTCP,8kUTi1Prio14m9LjCj6Mari6pXwJTYkE1mp21LMn235p,False,62553,62553,3094,154,2940,3zqXX6kzhkbW3d4TwD2CNjMRwxTbREXySekvq37kfCNk,3094,28776,-25682,494
2022-01-22 04:29:32-05:00,7744,AvwHizRhHUSahmvSg4jmTUErc7vAFSmkRAEsiKhXfW1m,3UrWYx8y9N5o9GYneSe6zyyHRTZzxwvcipQfHHYh7tEs,True,34518,8629,53,26,27,4BnQKPLuE3DMTtxp8MjUBytgnhvxqq3ZTqZHTVZo4JJh,2155,27078,-24923,624
2022-01-22 04:30:21-05:00,7745,4SQQdHTJUDv8taPXQRvEVJpUu91iCWQsv9su8tfehaQG,33CJXj1pmmatAofRvgt5in9E6SLEuy7tq4jqSwnUWP2A,True,377037009,94259252,581741,290870,290871,HfEnetJ7uBSmZWCjBNxdvv9HEC5nsW4wDV7wu6WnhWan,23269672,378183430,-354913758,617
2022-01-22 04:31:04-05:00,7746,FtF3PVw8YNJseWPMcA2GEuQZ6nni1mq5kYPa2LrSzfkW,4yr1TM2dXrBvLNMpSaoryuGU2P8D3WG1ZCkvVzWFiQRH,True,4735387508,1183846875,7398900,3699450,3699450,HfEnetJ7uBSmZWCjBNxdvv9HEC5nsW4wDV7wu6WnhWan,295956038,1975723309,-1679767271,624
2022-01-22 04:33:48-05:00,7747,GxFxvEUdWofneMmVvhCSScH9V6Zia5WJ2J9q6CpPnaq3,ATLykiHDii3Lw53MoZXwqu1FbBNPJbVNVGe2SoQMjVmY,True,42479,10619,65,32,33,4BnQKPLuE3DMTtxp8MjUBytgnhvxqq3ZTqZHTVZo4JJh,2629,40410,-37781,618
2022-01-22 04:33:48-05:00,7748,7feC64HZfQpniey2iXsMMgQXnfcunJus74DiKDeKaEUw,GstsCxAiBBEUrXNkvZZ9Sg4vNK916PsKe2Mx6e4M6dU7,True,100945,25236,154,77,77,HfEnetJ7uBSmZWCjBNxdvv9HEC5nsW4wDV7wu6WnhWan,6168,74164,-67996,611
2022-01-22 04:33:48-05:00,7749,5NVD6QvomTAD35yNxSFZw4DhF2hCtV8drkbnGhBVtK5y,3JzkyPnREvoFZLL9JZuuDEnee3nuKcrqY3xLuXsmHwRo,True,557991,139497,843,421,422,4BnQKPLuE3DMTtxp8MjUBytgnhvxqq3ZTqZHTVZo4JJh,33751,531435,-497684,604
2022-01-22 04:33:48-05:00,7750,2pKygdXJnjZBFfrZgDasmHQQgw8LgycmBBRuaoCU72cz,DXsomQ5yWw2ceZMbaCVsSaE4hKm9W6Gy785JG75Aaz18,True,2322774,580693,3601,1800,1801,4BnQKPLuE3DMTtxp8MjUBytgnhvxqq3ZTqZHTVZo4JJh,144058,1199352,-1055294,620
2022-01-22 04:33:48-05:00,7751,GjQQ2fQ7mrGjWZwjVYFUKp9NM1LmfkhEo675ovU5SPa8,ECgVUMRY5nB4MALs5drDyipF7YohCPuJpj2UegCs7HMn,True,211060,52765,316,158,158,HfEnetJ7uBSmZWCjBNxdvv9HEC5nsW4wDV7wu6WnhWan,12647,182744,-170097,599
2022-01-22 04:33:50-05:00,7752,F9s8a7Cpiw5dw3a2aNFMofqwyDWNXvDLnSdJzoj1gRiV,GpKsQKJD79KBRWdCTkyi4zX7NaoCWsLUjrKxAwJB6o6s,True,278935,69733,422,211,211,HfEnetJ7uBSmZWCjBNxdvv9HEC5nsW4wDV7wu6WnhWan,16915,168138,-151223,606
2022-01-22 04:33:50-05:00,7753,3FF2rhr1RuT7UR7MmmGtrhfYbh6kbc5UXq51KmqFLZnq,AEmSYLt1dQ8suLugC4Lcw4kF3dG9GYcEfX54hEAKfmv5,True,2579913,644978,3988,1994,1994,3zqXX6kzhkbW3d4TwD2CNjMRwxTbREXySekvq37kfCNk,159552,1333132,-1173580,618
2022-01-22 04:34:33-05:00,7754,8JtUn4uue4WzrySwnDQ74qzzWaKsoo11MbMvRh1ePDJN,8iahKConWg6fyZrkoze5eeujyNHA26AybYBpHwUr76Cu,True,29074556,7268639,43653,21826,21827,HfEnetJ7uBSmZWCjBNxdvv9HEC5nsW4wDV7wu6WnhWan,1746142,18141848,-16395706,600
2022-01-22 04:34:35-05:00,7755,72woixtGAuGazCMfsYfYBYLP7FuRj8Fwz9fynFo4MCE4,5237BmWkKf58PBeTUEiu3Ld5uKXEe8wcrJRmCnUoWWku,True,9245136,2311284,13924,6962,6962,4BnQKPLuE3DMTtxp8MjUBytgnhvxqq3ZTqZHTVZo4JJh,556989,5464718,-4907729,602
2022-01-22 04:35:13-05:00,7756,DvuRmJkfn6FQczUKgYeaSCqwy2NTMunuAKNrnmxMvnzS,7LpWTX9dgBtW75kfEoB5WuNsDwEdw5s8CYSHh3J4qagM,True,839291,209822,1295,647,648,3zqXX6kzhkbW3d4TwD2CNjMRwxTbREXySekvq37kfCNk,51810,808146,-756336,617
2022-01-22 04:35:15-05:00,7757,4hZG7dM716SxDagiFGwt1gSC99B2QK1emGLV9TJmmuR8,7vjfUWySkyx4Z5qAaRr2VWnVvxHHNsvPj1PirGNSjM6,True,2493772234,623443058,3824726,1912363,1912363,3zqXX6kzhkbW3d4TwD2CNjMRwxTbREXySekvq37kfCNk,152989055,1421268936,-1268279881,613
2022-01-22 04:35:15-05:00,7758,FV3G5EsSmyiLAAoREhgDXwvzbxoyDeq4Mwfj4jK5fJ7U,5nhzbJmm5JAwGDpTZoenkM1u3XtMY4uN7Qsm3vFGtRJE,True,816642,204160,1263,631,632,3zqXX6kzhkbW3d4TwD2CNjMRwxTbREXySekvq37kfCNk,50542,438402,-387860,618
2022-01-22 04:35:15-05:00,7759,D7XummfEc3NTK4qMvZegV3FrYuqc8mNgnQu3ujwemZtg,HHiRcecqzW7sGFTio7Ph6TYv3dGt64KWv4DEKgKm84fQ,True,73997,18499,112,56,56,4BnQKPLuE3DMTtxp8MjUBytgnhvxqq3ZTqZHTVZo4JJh,4518,70878,-66360,610
2022-01-22 04:35:17-05:00,7760,CmvNNpdGVDGujBadaMmgKc8xgFfyV6G9PNEjD8zEND6L,EzmfinKBZ8TXoSugyTqdEdHWrHdTdpHQtc1TApfaNfDR,True,1158002682,289500670,1732610,866305,866305,3zqXX6kzhkbW3d4TwD2CNjMRwxTbREXySekvq37kfCNk,69304421,914964987,-845660566,598
2022-01-22 04:35:44-05:00,7761,C1rjefgArnN3nBn5Wu3yXij2wAyGWFtWdjGNLR9vpjmj,GsLCESLzYGZ1brEh8RJrZttE7hxcpSq7iUqdhwJhnDVB,True,1641990,410497,2530,1265,1265,HfEnetJ7uBSmZWCjBNxdvv9HEC5nsW4wDV7wu6WnhWan,101232,1302203,-1200971,616
2022-01-22 04:35:46-05:00,7762,GBpe8E33cNkFmMUuP3WjhDBBuQz7MHaDkpCJjGFaFkvu,3QYFKkgzZ1PKKAxCh4hMhgqrupoCcfRVkjuJZRWVZo3H,True,10012430,2503107,15531,7765,7766,4BnQKPLuE3DMTtxp8MjUBytgnhvxqq3ZTqZHTVZo4JJh,621247,5273918,-4652671,620
2022-01-22 04:36:37-05:00,7763,7CSCMFa9W52tBDVUbXbc3woAy3GByeA1wPJdp3MgznPa,3447ptuVFu6G8B6N63RmS8mRv4n9PfHneypHLvbeaGLn,True,3517360,879339,5483,2741,2742,3zqXX6kzhkbW3d4TwD2CNjMRwxTbREXySekvq37kfCNk,219355,2809775,-2590420,623
2022-01-22 04:37:26-05:00,7764,DC4UVUDFWL3gVtgkX9hPtFgtxaA8DH5p94i4k9U3wyWv,3HCWqVvQQfRgSKitsTjGTduJ82ointZUSNtj13uea4kD,True,17275089,4318772,26672,13336,13336,HfEnetJ7uBSmZWCjBNxdvv9HEC5nsW4wDV7wu6WnhWan,1066909,13779082,-12712173,617
2022-01-22 04:37:30-05:00,7765,2sPD4f4d3CCeFSwSC5vAGS3YoTsTGypYKfDeoJczebop,HWCRpcq2sXqJL7Vi8MtipQDwGSViE73bUxS36ETmvnP2,True,1767481,441870,2703,1351,1352,3zqXX6kzhkbW3d4TwD2CNjMRwxTbREXySekvq37kfCNk,108137,935012,-826875,611
2022-01-22 04:37:33-05:00,7766,HELPNUwAqTX7gfHS4cnJnqXFM6Rb156tYcpsitKR9iDu,3RdfgDvLvsdZG5Cf6hKiKMQMqfidyxHzjYvUx1FZpeHQ,True,4342751,1085687,6723,3361,3362,3zqXX6kzhkbW3d4TwD2CNjMRwxTbREXySekvq37kfCNk,268951,4833662,-4564711,619
2022-01-22 04:37:33-05:00,7767,3c4tj9J8QwB3exFchWei43nBh5xsYRZxEUfayi3JvYgm,Fyw1TEEDKhLFo16qxDsttsAwSkrfzpDe8Dmm3atEeXyN,True,3964830,991207,5991,2995,2996,3zqXX6kzhkbW3d4TwD2CNjMRwxTbREXySekvq37kfCNk,239662,3281757,-3042095,604
2022-01-22 04:38:28-05:00,7768,CYkojG4q1SnizNs59qsYTEBU1c11XC8nteMhxRbwhCBq,A9MsPy3aeMzdQUWXK6qmWLiZfKREiBrSVaJAKp2nEcSt,True,1016706,254176,1590,795,795,3zqXX6kzhkbW3d4TwD2CNjMRwxTbREXySekvq37kfCNk,63618,664047,-600429,625
2022-01-22 04:38:54-05:00,7769,AvwHizRhHUSahmvSg4jmTUErc7vAFSmkRAEsiKhXfW1m,3UrWYx8y9N5o9GYneSe6zyyHRTZzxwvcipQfHHYh7tEs,True,25342,6335,38,19,19,3zqXX6kzhkbW3d4TwD2CNjMRwxTbREXySekvq37kfCNk,1555,20795,-19240,613
2022-01-22 04:39:05-05:00,7770,6pUtYz474QrpATEZnfb3iFbTKYA65pNyKAo4TQZAjtqe,8dipRUXvxJiDLdHEtCPkso4vErbVwshHQiRfvSngBS9J,True,15849129388,3962282345,24769795,12384897,12384898,3zqXX6kzhkbW3d4TwD2CNjMRwxTbREXySekvq37kfCNk,990791816,5778727939,-4787936123,625
2022-01-22 04:39:05-05:00,7771,5acohGZShYQVNGZEfy7pTyX7E8MzqRDwByhFL1H53UNv,4Z454ZseKbWGEtdrE9eotbDZ7o9VHhooMYriTfSFHiGt,True,356874166,89218540,554892,277446,277446,3zqXX6kzhkbW3d4TwD2CNjMRwxTbREXySekvq37kfCNk,22195682,103396231,-81200549,621
2022-01-22 04:39:08-05:00,7772,8xQ3tsWVUe75EG1HmocULJ3kh52utveoFMEPotTGrKno,i3SKW3ywrwYucX9ySEx1C4zaUKGnzLerP3V38437NyV,True,2466043,616510,3794,1897,1897,3zqXX6kzhkbW3d4TwD2CNjMRwxTbREXySekvq37kfCNk,151790,2276432,-2124642,615
2022-01-22 04:39:15-05:00,7773,G5NLYTLxDZfJFKsJdMeWS8Ez95ZFwR5AX4hKhnfVJvoE,AwrC3pKhTeEDr1HCTWoKWjadteZccvqcisbC7vxTjn7w,True,24207034,6051758,37804,18902,18902,3zqXX6kzhkbW3d4TwD2CNjMRwxTbREXySekvq37kfCNk,1512168,21191918,-19679750,624
2022-01-22 04:39:15-05:00,7774,7hTjPRQSYAoWHhtpsVz2oKK5SAuFJd8dPHShKgKJq8dy,6DcHcrtcXR88d8e2KahhAiWTeRznNfF8oXLHmh5wE7wz,True,43203824,10800956,67483,33741,33742,3zqXX6kzhkbW3d4TwD2CNjMRwxTbREXySekvq37kfCNk,2699345,28351925,-25652580,624
2022-01-22 04:39:36-05:00,7775,4SQQdHTJUDv8taPXQRvEVJpUu91iCWQsv9su8tfehaQG,33CJXj1pmmatAofRvgt5in9E6SLEuy7tq4jqSwnUWP2A,True,277389395,69347348,432489,216244,216245,HfEnetJ7uBSmZWCjBNxdvv9HEC5nsW4wDV7wu6WnhWan,17299569,288876544,-271576975,623
2022-01-22 04:40:35-05:00,7776,FuoFPNTdYVDkSHaBac6UC1aNJXafSNTvFJuBCdrgQQrH,ApBS1Fx83tcECMzDV6wEzEzEdg4e2hgj3djtjRUoSKK5,True,72701862,18175464,112244,56122,56122,3zqXX6kzhkbW3d4TwD2CNjMRwxTbREXySekvq37kfCNk,4489791,47401913,-42912122,617
2022-01-22 04:42:21-05:00,7777,F1G1Yb2jhT1hULYuNM9QMuNNA6vHZ2Wg4LhFGWsJmr78,2oF52s77UVwjbZMLmxyNsGRZ36RHqSJiV5VL7FzoWgyB,True,116522705,29130676,181351,90675,90676,4BnQKPLuE3DMTtxp8MjUBytgnhvxqq3ZTqZHTVZo4JJh,7254067,52481270,-45227203,622
2022-01-22 04:42:23-05:00,7778,95yx3SCWcW9Cp8oSEDV68kGXRKWGyNdYUtNb5UnWMGBD,7PncaFWqW2iKR6EUKf78EW6LLZr7ZWU5b2d2rP22fsU3,True,12335937,3083984,18960,9480,9480,3zqXX6kzhkbW3d4TwD2CNjMRwxTbREXySekvq37kfCNk,758430,8422493,-7664063,614
2022-01-22 04:42:23-05:00,7779,2jDRvE3pQNjWy1NRFa4tzB3KmU5UkbUCHw8sQRFujo66,C4zNi2szDrEEh4coTF3WRUghfP4ZwAVVSYTLWfkejQRu,True,21511770,5377942,33431,16715,16716,3zqXX6kzhkbW3d4TwD2CNjMRwxTbREXySekvq37kfCNk,1337264,14023969,-12686705,621
2022-01-22 04:42:24-05:00,7780,78EeyPYzQjrmW6z9VGhRci6ihMUZb5rtpXo3GAxugf55,9AgZ45TMxaqwWGVWSgnEkvio3s6fXtHjAVRVCA7Zgsd2,True,2507572,626893,3847,1923,1924,3zqXX6kzhkbW3d4TwD2CNjMRwxTbREXySekvq37kfCNk,153891,1453777,-1299886,613
2022-01-22 04:42:30-05:00,7781,2rLWe1XADCU93guPU6WgSW6x56gYNfif9bm11V93mJnv,BEGhQRm3fgSHeBtk2DYrXEBPKPRvS3sHyTNopmoBJxMs,True,13547085602,3386771400,21077463,10538731,10538732,4BnQKPLuE3DMTtxp8MjUBytgnhvxqq3ZTqZHTVZo4JJh,843098548,6119918007,-5276819459,622
2022-01-22 04:42:30-05:00,7782,3ogBPSRcKfmwzgumVDHBkXLi1eCsEFG2xzSJgD4LQDNy,7TXyqWgJqfe71MSWFA2n7ufZbUdzf7JJoWej8FNNtMXo,True,951118,237779,1465,732,733,HfEnetJ7uBSmZWCjBNxdvv9HEC5nsW4wDV7wu6WnhWan,58634,627417,-568783,616
2022-01-22 04:42:31-05:00,7783,JDeYjCLpfnzcfxDFgHf4aBcHsajwdR14GUaKAA9euzVf,EJbvKoyMZcoCx4vWa61uMbW2vr6mUhrgEuECdteVBuZZ,True,351460,87865,543,271,272,3zqXX6kzhkbW3d4TwD2CNjMRwxTbREXySekvq37kfCNk,21723,319077,-297354,618
2022-01-22 04:42:32-05:00,7784,CbhrZUdan1axNDFUrX1ZuEohfNMEGrszKSkk6pppVQuw,DHEAjJNtuEePezYAv77thWabbVxxqQpfuiC6moRSrpG1,True,4178096,1044524,6426,3213,3213,3zqXX6kzhkbW3d4TwD2CNjMRwxTbREXySekvq37kfCNk,257072,3680754,-3423682,615
2022-01-22 04:42:32-05:00,7785,9UKMqQgFYdJb5vXVqPhA8CAMRY1eifgWivANiKQqj3yb,DpE3uNQUZbyYnqjpfHWqp9CHqPBs2uTQLRM6AtzF6Por,True,14984698,3746174,23168,11584,11584,3zqXX6kzhkbW3d4TwD2CNjMRwxTbREXySekvq37kfCNk,926757,5417254,-4490497,618
2022-01-22 04:46:07-05:00,7786,BjCNaM7YbE9SjFi7tzi4677zg1fKXGJwtecz2GWwWuhd,6rNsSrKZezQrLb2whToNjnizpnurDXrobHqfEK3QqU1M,True,1643791903,410947975,2572041,1286020,1286021,3zqXX6kzhkbW3d4TwD2CNjMRwxTbREXySekvq37kfCNk,102881670,694146059,-591264389,625
2022-01-22 04:47:13-05:00,7787,AWvHDdb2ikqV8wc7qQ8azbvNTZdixMNxhQjhQdhayYtR,9EpgEPBb1nog6aQeFdMXfSRiLSnzGQFQ39mbLdCxgYTv,True,2068392,517098,2767,1383,1384,3zqXX6kzhkbW3d4TwD2CNjMRwxTbREXySekvq37kfCNk,110699,1192280,-1081581,535
2022-01-22 04:47:13-05:00,7788,BhiAaiZu7fF8ndggJrLyiFVCRq526cNBw7VaeascEmNL,4en8MipPi7vq15NGhpPMQfptNdEyhp2j7fpgxBBtjyfz,False,22412365,22412365,1091194,54559,1036635,3zqXX6kzhkbW3d4TwD2CNjMRwxTbREXySekvq37kfCNk,1091194,8989340,-7898146,486
2022-01-22 04:47:15-05:00,7789,GufVttJatW8NLeztT1NRQSLZpQNRk45kaG41p3QcWhx7,GTJUsWoWRyeafYJVhx2aRo8NE94U5UrBjaehmJ4PRUhn,True,1254759,313689,1839,919,920,4BnQKPLuE3DMTtxp8MjUBytgnhvxqq3ZTqZHTVZo4JJh,73576,718990,-645414,586
2022-01-22 04:47:15-05:00,7790,8xvLGVeDmhVYQhN2ZpWkVG9jCrukRsNQ4926a4TMiZqa,9ciBySSjvADwp47WkETiFWZKVTFL8Hf1XvK7aSxhcgQS,True,1114111,278527,1498,749,749,3uL2NSR2ZdDqCiKfzA5SwwpddAnit22DBJo6uvvz1rRs,59920,791239,-731319,537
2022-01-22 04:47:15-05:00,7791,HwosLQgDY1xtHQRQ4hzroPQHFWssPzTj5vRkP37FcviB,HKTNEYNXrephNkH7apbobK4mcQXcNayQA4W1NgM6sLr8,True,2049552,512387,3091,1545,1546,4BnQKPLuE3DMTtxp8MjUBytgnhvxqq3ZTqZHTVZo4JJh,123656,1187760,-1064104,603
2022-01-22 04:47:15-05:00,7792,5eMLdQ4gYA5iqvTXSNdGvctHp7s5VpyFuwtJKqx6chBc,Ckxc5K39nkBNXBTmFTM8J48R7wGqNm3vHKZu4G5baumZ,True,14651906,3662976,19881,9940,9941,HfEnetJ7uBSmZWCjBNxdvv9HEC5nsW4wDV7wu6WnhWan,795276,9086610,-8291334,542
2022-01-22 04:47:15-05:00,7793,6NJFN855M3Q3RLTDNo57gTgAmwPD6G2E3WvMb1m5eNCN,3YpqNnonsvXaRT4nCC3G5FZx1jjVtbDPc36LiR6WK5jR,True,3401988,850497,4919,2459,2460,4BnQKPLuE3DMTtxp8MjUBytgnhvxqq3ZTqZHTVZo4JJh,196766,3076624,-2879858,578
2022-01-22 04:47:15-05:00,7794,Fani89KviVFZek4si6YZ3apVuM2kSqVUijDnLBqtvJEH,EpC29dECx1cLC69bj2ncG3jFp7obPaxbH7F6mju27cwL,True,982394,245598,1391,695,696,3uL2NSR2ZdDqCiKfzA5SwwpddAnit22DBJo6uvvz1rRs,55667,385426,-329759,566
2022-01-22 04:47:15-05:00,7795,HpDwBPWZHfLzJUvTTABTA6qddyLLJiVTfqBx5gUktSUb,BqXLpaAeTNfNSeevfdazNqTgqEXj6Edgp8txWvCoxEz6,True,39042793,9760698,52680,26340,26340,3zqXX6kzhkbW3d4TwD2CNjMRwxTbREXySekvq37kfCNk,2107238,32667995,-30560757,539
2022-01-22 04:47:15-05:00,7796,6kqKSyVVF4xxUbsvBCkY1kt4XcKzb98eSaqNw5fxSLtw,4T9DKFUmkcPG7mM3CKzW3m81LqqpU7oFTv35Pha4zHNe,True,74249572,18562393,108240,54120,54120,3zqXX6kzhkbW3d4TwD2CNjMRwxTbREXySekvq37kfCNk,4329601,50035550,-45705949,583
2022-01-22 04:47:16-05:00,7797,DWTaeNeq5x83cBvKUz2jZfXDz5z4F5wbSZLNv7smnjvd,9pQGArZnJV4Fu8tBVEfknmmfmrRv5RKV2u58BJBuhzpF,True,4182709,1045677,6112,3056,3056,3zqXX6kzhkbW3d4TwD2CNjMRwxTbREXySekvq37kfCNk,244508,2736036,-2491528,584
2022-01-22 04:47:16-05:00,7798,DkvR2xUPMyXWGGkUSmDSfhp7RtvMkfbT1ThKCS3TwrXd,F7jYV6TtT1LZ5XCNn1zkbUfNMo4gGcQUczAQy1jLHpaW,True,27289170,6822292,41244,20622,20622,4BnQKPLuE3DMTtxp8MjUBytgnhvxqq3ZTqZHTVZo4JJh,1649766,19818934,-18169168,604
2022-01-22 04:47:16-05:00,7799,DY6k3Dkwe18iLneaT8Xo3VpJWB6V4jWwQQjoDvEzdg2j,3GGV7S9FpRQGbARBXkvGFVqLrmw8JvYAcpnR1aKVUY2f,True,554773,138693,839,419,420,3zqXX6kzhkbW3d4TwD2CNjMRwxTbREXySekvq37kfCNk,33572,503241,-469669,605
2022-01-22 04:47:16-05:00,7800,6VJcr3VAEcEZaHEpt48QL8QxHKABufVp8n2JSEVTLh9U,8naR6kiySKj3vai9dCetdgCnCHgf2oyLjGqKTJ3Lz64Y,True,145148602,36287150,195455,97727,97728,3zqXX6kzhkbW3d4TwD2CNjMRwxTbREXySekvq37kfCNk,7818206,105792483,-97974277,538
2022-01-22 04:47:16-05:00,7801,GGcsY84pkqUn2xySuLYrUUg8gWMBWgfHaQ7rK42NoZaH,4EyjJvctL9WBQiauD2Eaf2Hus8htYzHxP5GR2HsUfuks,True,142900305,35725075,219931,109965,109966,4BnQKPLuE3DMTtxp8MjUBytgnhvxqq3ZTqZHTVZo4JJh,8797271,69918451,-61121180,615
2022-01-22 04:47:16-05:00,7802,CxLFMBDFkoMvpK9YUf7WtCq6hn7k3QACAuetAnGjU6KA,2gE52a1GWQnS6ifV6eVtKQyr13LXP5Jdt3yG9SjGPJPF,True,54525341,13631335,84746,42373,42373,3zqXX6kzhkbW3d4TwD2CNjMRwxTbREXySekvq37kfCNk,3389842,23951619,-20561777,621
2022-01-22 04:47:17-05:00,7803,D64rDiWT3YG28fCgXCmbNjYa2JakZbpKQ1D2XuLChUfV,8WmMWq8cTsGQym5pUbHm9dPCpJugBeWUMVERYFGLxWHj,True,1597994,399498,2261,1130,1131,3zqXX6kzhkbW3d4TwD2CNjMRwxTbREXySekvq37kfCNk,90452,997904,-907452,566
2022-01-22 04:47:17-05:00,7804,zLTuMVfVswjMkhyvjaXnvjcKXv5xNk3iSWSjRGpVqXf,J3D8NHUJCiSjvFYfJ5Es4YDhF1KcPZWRUmCQ5L92t8eB,True,19098669,4774667,25656,12828,12828,3zqXX6kzhkbW3d4TwD2CNjMRwxTbREXySekvq37kfCNk,1026260,5685779,-4659519,537
2022-01-22 04:47:17-05:00,7805,DDuXUcRDez68Tx651sVKxjubhTdNHkuarbeDEKFp5HRs,DNWcrd23zaT7LuXHuhPVqqAvLVpEzoqebr4sho45CphT,True,1509323,377330,2266,1133,1133,3zqXX6kzhkbW3d4TwD2CNjMRwxTbREXySekvq37kfCNk,90666,596802,-506136,600
2022-01-22 04:47:17-05:00,7806,A1j2G5FZRyWSjFt6dK87WHhLkQrPUVqHaM3KhSzhAKDT,2fMiHLYm4pL3YCd8aveTR4mT9uVxztQeMwb5eRZb4wUW,True,31289,7822,42,21,21,3zqXX6kzhkbW3d4TwD2CNjMRwxTbREXySekvq37kfCNk,1682,23847,-22165,537
2022-01-22 04:47:17-05:00,7807,4KMzwWHPeW51cxu4nMpbqCaqo96dMqaHWyRCGQktfQfd,F7q4GNYcbnZa8dJ4qovQwjmxpKpdEmdxQMXRPb9nQupa,True,42798285,10699570,64068,32034,32034,3zqXX6kzhkbW3d4TwD2CNjMRwxTbREXySekvq37kfCNk,2562726,14088593,-11525867,598
2022-01-22 04:47:19-05:00,7808,9WJBnVi84E926j7xEd566WzrZJkPJWRgmEnYj9vyjuad,4dLaFS5F7TGyLdwuJLMGkz3bSL53aHzd9ZfpNmhHxXeF,True,689289,172322,1070,535,535,3zqXX6kzhkbW3d4TwD2CNjMRwxTbREXySekvq37kfCNk,42800,569513,-526713,620
2022-01-22 04:47:21-05:00,7809,7iUx7JBwqUvPVPeCqMEXQdLccZJmaFYm1DUQiu3ouHa3,3EVZzhRmJnX9ZiBZZo9tenDtMogAyuA1yf2cKzvUWiuu,False,28132959,28132959,1349341,67467,1281874,3zqXX6kzhkbW3d4TwD2CNjMRwxTbREXySekvq37kfCNk,1349341,11293618,-9944277,479
2022-01-22 04:47:21-05:00,7810,J3ggP7ZxL8HRh3CBp5iYG2WgjLyNSAWYT46uC9VYDLCz,2FqTRiRPiLvdAH2BS5vroVntpsSXvTJEn5UHWmtKHzh9,True,1319244,329811,2040,1020,1020,72FwbpFGoLEazJEdpqNtPNefsadUrimUqma9wSoy4qiS,81623,784367,-702744,618
2022-01-22 04:47:25-05:00,7811,G25vsB3sDqRhHoSK4KwR1TywfrJDtpejVbbevEG9sQ9a,5xFC3Hm13magnAA9GD1EnwC9PrPoEfQ7omEa9p9zCrB1,True,13373911,3343476,18219,9109,9110,3zqXX6kzhkbW3d4TwD2CNjMRwxTbREXySekvq37kfCNk,728786,5739368,-5010582,544
2022-01-22 04:47:27-05:00,7812,HEFpdWLZaiQnjftmXgxs6RNzhH72YiMjortxPkKekkvb,5Q8mmxBgVTijNGrWsnoA3VMArLHZEX5MkaigYXHpgXHE,True,17212538,4303134,25965,12982,12983,3zqXX6kzhkbW3d4TwD2CNjMRwxTbREXySekvq37kfCNk,1038630,7013035,-5974405,603
2022-01-22 04:47:28-05:00,7813,DYCYiQFH9QHzCo3eAw1pFoDu7pzwFMo1E2WDZjVFRz5w,CPh4FWsGak1kd1WFEH9qBjNhnun3R2tHtZA57zW8ugn5,True,2250683,562670,3516,1758,1758,4BnQKPLuE3DMTtxp8MjUBytgnhvxqq3ZTqZHTVZo4JJh,140660,1868709,-1728049,624
2022-01-22 04:47:28-05:00,7814,FgQrRo4eGQAonSsFfQgnp8trGGqGZCLeGX6yvJnMnTjd,8KhemHLBY6nGmo3xMDedW2wnCSxQq6LwbTExif4sUSxx,True,61638372,15409593,95843,47921,47922,3zqXX6kzhkbW3d4TwD2CNjMRwxTbREXySekvq37kfCNk,3833722,21925998,-18092276,621
2022-01-22 04:47:28-05:00,7815,4rwzdgkP7REWtQxRf9ftWKYXs1QoZQQBo6YQvNJYjZBY,4EmBTVv6MbdPC6WqTNrSABrP9aTZPrDSPxy9a2KbVgqu,True,4892193147,1223048286,7303589,3651794,3651795,HfEnetJ7uBSmZWCjBNxdvv9HEC5nsW4wDV7wu6WnhWan,292143595,1856527112,-1564383517,597
2022-01-22 04:47:28-05:00,7816,Bsr6kx1B6BSEd5UnJ7Z61M49iUb3bFrDVhiEtMVtPDF2,3CFd1pUJAJPA9fobwn4Jj2mRju1CWmoop4Mh4znypNWT,True,1308340,327085,1788,894,894,3zqXX6kzhkbW3d4TwD2CNjMRwxTbREXySekvq37kfCNk,71558,859230,-787672,546
2022-01-22 04:47:31-05:00,7817,8swGZMrPrLAxZd7MxTbkCL13k3DmAJUw41jCp6Xo6awW,3fKnX7yTNXAT4uMmXVdTy47ALJT8h8YSD3WiBb4BGuzH,True,10390102,2597525,15273,7636,7637,4BnQKPLuE3DMTtxp8MjUBytgnhvxqq3ZTqZHTVZo4JJh,610949,7680112,-7069163,588
2022-01-22 04:47:31-05:00,7818,HHHj6EinpgAJeZkDXfsvCo3UXnmAdiAZNvPSUfVPc5Sg,3gx9c31MDtJtByxkUuWcqf1oARnZTjpx3QtxsM1Xb6Gp,True,33592520,8398130,48136,24068,24068,3zqXX6kzhkbW3d4TwD2CNjMRwxTbREXySekvq37kfCNk,1925454,20631739,-18706285,573
2022-01-22 04:47:42-05:00,7819,8otVEtwXkAdnt5XmBzL8hmzAgRcaDDxiuqpRxY6ZhR24,7333dFedtBjo3yhbp2bU1XbAfdDeBvvCd9QKitYVUU7v,True,488431722,122107930,763048,381524,381524,3zqXX6kzhkbW3d4TwD2CNjMRwxTbREXySekvq37kfCNk,30521928,111030206,-80508278,624
2022-01-22 04:47:48-05:00,7820,8E3K7vCHJ2xjdFofPRGLbMxrkm8UYEi926QmXPAFwsqe,4qHUDA1c43Dg4qi1ZPKqmpGYiEMUZ6r4UuzB5ftHCEhW,True,63673875,15918468,99632,49816,49816,3zqXX6kzhkbW3d4TwD2CNjMRwxTbREXySekvq37kfCNk,3985293,53074018,-49088725,625
2022-01-22 04:47:48-05:00,7821,BgnsCfJ54ReunUtwPJLzkW4PWnqpBDWGNYxsW5PvDrbK,KpMqEkQ9dKMgCevsEK895wHd3fCLRPSzDmJSv3tKU4u,True,651200696,162800174,1018387,509193,509194,4BnQKPLuE3DMTtxp8MjUBytgnhvxqq3ZTqZHTVZo4JJh,40735500,431104285,-390368785,625
2022-01-22 04:48:51-05:00,7822,64Diz8zzEv1jDWnBQPTHPpXwaWf7vjM19RyJmkPy1viQ,G8wkGHRHMtT3mvXBkH3zgsKNs8wbpdiPUS17y4cozhkZ,True,662051414,165512852,1026268,513134,513134,3zqXX6kzhkbW3d4TwD2CNjMRwxTbREXySekvq37kfCNk,41050741,181797600,-140746859,620
2022-01-22 04:52:13-05:00,7823,Frobc1KZTVcsyfwyKwSpHJobxmiJBomzHhGCLdrzdAz8,HziyKP9uxWCuXddtbRzWMczHNdgyQB5UXQZj4MnMm14,True,11516758,2879189,18013,9006,9007,3zqXX6kzhkbW3d4TwD2CNjMRwxTbREXySekvq37kfCNk,720545,5324503,-4603958,625
2022-01-22 04:54:58-05:00,7824,Cv5oVktxmqbU1SxraxH67NEWMKnjgA18R832Fhe9h74a,Cs7xBD4BDiohyopnaYDDChUtR9vmx7uwot6Qp9beQLzt,True,40001455,10000363,62245,31122,31123,HfEnetJ7uBSmZWCjBNxdvv9HEC5nsW4wDV7wu6WnhWan,2489830,14104239,-11614409,622
2022-01-22 04:54:58-05:00,7825,399591e8XgY52yCMorCQ2WL6dQZTC485ZooHtmGuirhZ,JCiXAooFmKmEPQ2S7C8iSk6CLcTyrPEe1SsPSLyUGySe,True,48001,12000,74,37,37,4BnQKPLuE3DMTtxp8MjUBytgnhvxqq3ZTqZHTVZo4JJh,2975,43764,-40789,619
2022-01-22 04:55:02-05:00,7826,6N4PNbueNmkCECF8ojw5R6wGtxComzgGED179GiJaLjQ,AL8eRDEo8yCvD4n4kvruEuZzXBXrJrEiBt9SQwCcDPYd,True,207729209,51932302,324184,162092,162092,HfEnetJ7uBSmZWCjBNxdvv9HEC5nsW4wDV7wu6WnhWan,12967372,88814801,-75847429,624
2022-01-22 04:55:05-05:00,7827,8eTH6eJyyVeMno3UQkffeBg32xofKsQfkhLhXdtaf87s,BCFC7CPXrQPsUfJb2eYSht8GhaApWHpc49AeCXqaYq13,True,10034724,2508681,15666,7833,7833,HfEnetJ7uBSmZWCjBNxdvv9HEC5nsW4wDV7wu6WnhWan,626652,4365709,-3739057,624
2022-01-22 04:55:06-05:00,7828,BgN75npBkPws5uiFE9RAujmPuZyAv2MQUPmfmJ1YCCij,78UFLNDn782TY2P4F5kRkMRC2s3gw8ak7sRQZRWNq82D,True,10768106,2692026,16797,8398,8399,3zqXX6kzhkbW3d4TwD2CNjMRwxTbREXySekvq37kfCNk,671917,4138973,-3467056,623
2022-01-22 04:55:09-05:00,7829,B2hN3Lt5pFbUyfEUc5s48hkxUJ5rr2SeFxgdGdQ8pDD2,7bZJCCud253j9g411HQUDXUAADcwd5yJWznoTChBdB2H,True,272572861,68143215,426474,213237,213237,3zqXX6kzhkbW3d4TwD2CNjMRwxTbREXySekvq37kfCNk,17058987,97486496,-80427509,625
2022-01-22 04:55:35-05:00,7830,4uygLJDk9DFCifJ56YwMrEsvd3oQNq8tYSLnMCyWorS6,GimL4uKGvg3FFmFQSWzAcjstv3Vmk5NMgDGMKTuXYVpB,True,23243561,5810890,36145,18072,18073,4BnQKPLuE3DMTtxp8MjUBytgnhvxqq3ZTqZHTVZo4JJh,1445834,16574360,-15128526,622
2022-01-22 04:55:37-05:00,7831,A4tDE948CPFPh1UwHb8sXryfKktbxZ8BCkqXgA5DJHA8,3zXeKMrsEpCe5fQumLNzCgpxcG1kLJFEAtJuqxLsC6ZG,True,3882044,970511,6032,3016,3016,3zqXX6kzhkbW3d4TwD2CNjMRwxTbREXySekvq37kfCNk,241315,2903505,-2662190,621
2022-01-22 04:57:00-05:00,7832,8kJu5aqVSmW8FSZR9h6F75ftn9V2U9uMLBEKeqRaC855,FhVHByujkvwwtjTVpZ4mqSUqoMoBgeLUc5H7rbz3FgAt,True,3957042,989260,6119,3059,3060,HfEnetJ7uBSmZWCjBNxdvv9HEC5nsW4wDV7wu6WnhWan,244797,3618003,-3373206,618
2022-01-22 04:57:00-05:00,7833,CpxZ136k95cVjGqkJnNpDZKUgrJrfg8HrFDZPL6BgsK4,Fo7HtcrneUTsnGqygsxPQ63G5rayYodYT65xP6B6HusH,True,69734993,17433748,108700,54350,54350,4BnQKPLuE3DMTtxp8MjUBytgnhvxqq3ZTqZHTVZo4JJh,4348028,24069167,-19721139,623
2022-01-22 04:57:02-05:00,7834,D9VKhnfLLCrntDGFYSfoxFaY76VnHmYZ1ZbyFXdKdibz,2hRCRH2pMDyQGYcXHa8Y6BZo6FbcGZf5VJC1v8Bp6tGa,True,4117569,1029392,6381,3190,3191,3zqXX6kzhkbW3d4TwD2CNjMRwxTbREXySekvq37kfCNk,255267,2771924,-2516657,619
2022-01-22 04:57:04-05:00,7835,GKKRAsYGdcf47eFThG4KwhNv7egeHRuc2wmTh4kqpego,4ippJxgnqCtdtGzCkdZoYwv68fiXNSqQcgrnaHdXZDUa,True,64485980,16121494,100874,50437,50437,HfEnetJ7uBSmZWCjBNxdvv9HEC5nsW4wDV7wu6WnhWan,4034960,40170632,-36135672,625
2022-01-22 04:58:59-05:00,7836,7dmoK7QPki7R66SPQST4veUgVfnJbVToxxBPZveECiwK,4vh4REBDm5zBDmcjRCD9zNsny1HGneu7B2co4dSJNLL6,True,10419012,2604752,16142,8071,8071,3zqXX6kzhkbW3d4TwD2CNjMRwxTbREXySekvq37kfCNk,645706,8706986,-8061280,619
2022-01-22 05:03:05-05:00,7837,2SNV9Q6vzQP5XxxqSrwXpQdRvk45FPiqLXmhNZzbLt1k,6dLG3ojK5Unm1mBh9aDZfryvoT2a6cSuWA8CxXy3oi7n,True,62160640,15540157,97233,48616,48617,HfEnetJ7uBSmZWCjBNxdvv9HEC5nsW4wDV7wu6WnhWan,3889336,41842403,-37953067,625
2022-01-22 05:04:12-05:00,7838,HdRgh9niYSd3YKCxzGdusYFquiVoFTP2mEGEzJJL5Nii,78C68Gbb1jYFQmYNCHHjL52keEKMXtGukmBwT7ahon4B,True,497260584,124315145,775562,387781,387781,3zqXX6kzhkbW3d4TwD2CNjMRwxTbREXySekvq37kfCNk,31022499,341149789,-310127290,623
2022-01-22 05:04:12-05:00,7839,CyWBZ1xJ9LahUnPesbXLZ4Rr5UyWAHgVFYwfrnhyrkNL,2Lpk87Xth8ZL5J9BfzmMpEE3x76FDrrrmdKiCNkSVip2,True,6105882,1526470,9526,4763,4763,3uL2NSR2ZdDqCiKfzA5SwwpddAnit22DBJo6uvvz1rRs,381053,4139985,-3758932,624
2022-01-22 05:07:58-05:00,7840,AUH6YGBV8tDVX1E1WTo92Mubfx1DGsqfGeyUBqxo4fSr,33QZgMwmW32WuvmxD8XNbmF9ea88bLe3YTtNwHV73Wwu,True,9353065,2338266,14600,7300,7300,3zqXX6kzhkbW3d4TwD2CNjMRwxTbREXySekvq37kfCNk,584001,5865583,-5281582,624
2022-01-22 05:07:58-05:00,7841,cG5VSSaBpjNdRLMQT7dmotpcWRTfdmJZYdWsrzNzRTE,5RESxV6aZenjAdaqw1jxoYSGttpLrNuZiRJy2WeLAVJv,True,88558371,22139592,137243,68621,68622,3zqXX6kzhkbW3d4TwD2CNjMRwxTbREXySekvq37kfCNk,5489737,54385223,-48895486,619
2022-01-22 05:07:58-05:00,7842,9KD2AifD5wFD4QkHYuawXbJgLWHrfj2QPF3fT8jhGVA5,Ga9gAqmkuHbqrr31sUFPqa1xa5WNxLWJWGPUaMxQqLdj,True,43575,10893,67,33,34,4BnQKPLuE3DMTtxp8MjUBytgnhvxqq3ZTqZHTVZo4JJh,2703,40284,-37581,620
2022-01-22 05:07:58-05:00,7843,FnAT8HKGgisYfeAbxKU2gSbCp8KbZHULRpaJX1NVijHy,2u637Crc2QzfSJmCnRNqeib3aZQVn4NGncpgM3Ph6jvm,True,1534722,383680,2359,1179,1180,3zqXX6kzhkbW3d4TwD2CNjMRwxTbREXySekvq37kfCNk,94373,947222,-852849,614
2022-01-22 05:07:59-05:00,7844,72L76qDRMK3M7X52zuuB9GVyvFFLDBZwFMpVjWjghXzA,4m2ZVuemUctu1edv4YJVAcjXzKwpbCmBujzoUmLDeA7h,True,15861069,3965267,24476,12238,12238,4BnQKPLuE3DMTtxp8MjUBytgnhvxqq3ZTqZHTVZo4JJh,979047,6947155,-5968108,617
2022-01-22 05:08:03-05:00,7845,9otCHuzKcxUCC4EgPJkio8Df5gXWB6DtZQnZvWtPfsh6,8cNPdP8rA9sBpcKpmCNcp4W2AYonYdFNoyVmboT6y1Bb,True,294325555,73581388,457230,228615,228615,3zqXX6kzhkbW3d4TwD2CNjMRwxTbREXySekvq37kfCNk,18289223,103963668,-85674445,621
2022-01-22 05:08:19-05:00,7846,BRK2EePsnQq54oaD2Ua4cxxKhdgVS2Kx57JKXCrBkeg7,7yskmLp2oA9qN38G7NBqVGggzs4ZoQ63HD4EnMVweMyY,True,439813596,109953399,685726,342863,342863,3zqXX6kzhkbW3d4TwD2CNjMRwxTbREXySekvq37kfCNk,27429049,187792629,-160363580,623
2022-01-22 05:08:20-05:00,7847,4Eh2J8pz6nSz2E2BaPSMbDNhEovGA4QRmNtzAJPw9ZRi,CrHeEQC5KpQFLGhz2EpLYWgk7kWsqLPvEfLsSQvUxv61,True,31562786,7890696,49266,24633,24633,3zqXX6kzhkbW3d4TwD2CNjMRwxTbREXySekvq37kfCNk,1970640,20407854,-18437214,624
2022-01-22 05:08:20-05:00,7848,H3394S5wdbwXB4scjGAY8NsXxCdGy1Xebct18s42FM1K,Hz84L1EquzhCvBJP75ScKug46hYGdNMVNH16AdG4y5D8,True,2101718,525429,3282,1641,1641,3zqXX6kzhkbW3d4TwD2CNjMRwxTbREXySekvq37kfCNk,131312,1454185,-1322873,624
2022-01-22 05:08:21-05:00,7849,FsMiJiJZibohKoV5QRisWCjzuFd86xSxFb4m73AQmu93,7p3TSKBaG9SV2YNDnhutQKacPKpTTmgsEfzmK51t6sYb,True,9340424,2335106,14602,7301,7301,3zqXX6kzhkbW3d4TwD2CNjMRwxTbREXySekvq37kfCNk,584108,5778379,-5194271,625
2022-01-22 05:09:20-05:00,7850,3VdSA9CED9f5swRwHX2U15U7J6Muaq8VPnCNy9CaGDHe,2YYstfnfdYic5NWmEbcUEHpccNUVd1EhuCkExvMsoMk8,True,224139,56034,346,173,173,HfEnetJ7uBSmZWCjBNxdvv9HEC5nsW4wDV7wu6WnhWan,13850,205670,-191820,617
2022-01-22 05:09:22-05:00,7851,A36aouot1oFLUtswuBUM4EVcis9chKaSJu53MRoPDjab,33U9gpq1RRFMGWDrWa3ezXXkwgBewdAS6QGgGVPtGvqb,True,12042010,3010502,18840,9420,9420,3zqXX6kzhkbW3d4TwD2CNjMRwxTbREXySekvq37kfCNk,753631,7424311,-6670680,625
2022-01-22 05:09:26-05:00,7852,4MSyrHopFkuaCEEvLAUV9cJfVre6cLAx5sJF5LEMSCTX,6HhLHoswuDKrcixShWCDcquW6PgmbS5FidEnkM3bwuJQ,True,2298674,574668,3572,1786,1786,3zqXX6kzhkbW3d4TwD2CNjMRwxTbREXySekvq37kfCNk,142884,932720,-789836,621
2022-01-22 05:09:28-05:00,7853,EitU96ThqHErybDn2j1NY6JHkqV1R3mWM1uWH7wYKr1T,2p9eYbLyBqXrhHtRKp1jJb7VGjCmb4LkA6kzqLr1ijet,True,5216119,1304029,8152,4076,4076,3zqXX6kzhkbW3d4TwD2CNjMRwxTbREXySekvq37kfCNk,326096,3053188,-2727092,625
2022-01-22 05:10:54-05:00,7854,H1oYXGZTagwv48FdDe6RNkjNaesedqLKyXxTmPc5k4Fp,Am3rx6XrkrZ4MdeZDyZUv1YW2fBujcz4dLjVCnRQHKZa,True,284819908,71204977,439046,219523,219523,3zqXX6kzhkbW3d4TwD2CNjMRwxTbREXySekvq37kfCNk,17561875,77106836,-59544961,616
2022-01-22 05:10:55-05:00,7855,J1sBDjpdBZcsSBS5eg95SSRjRqmQUR9cXJCsLJu8yCUt,F5wRpD2senMkGbL8Uquqo8W9x5NQDDa268dHuVFAZCww,True,547917,136979,852,426,426,3zqXX6kzhkbW3d4TwD2CNjMRwxTbREXySekvq37kfCNk,34081,342822,-308741,622
2022-01-22 05:22:27-05:00,7856,36ByQojnxEckWdQTjqHfxKqCx9yjqWQsPsZyqaN72UWR,AZoirtS1fjX61agRM64tqThVinnJTh3BWgiHyNHPTgZP,True,26517,6628,39,19,20,3zqXX6kzhkbW3d4TwD2CNjMRwxTbREXySekvq37kfCNk,1590,24149,-22559,599
2022-01-22 05:22:27-05:00,7857,D58t4uTjFumsUeYFaKnpV8BRTEQEqKXBreFTdwGrott7,67p6kHDfVqQijfcwugvZK59c3aRRH9x3eHxruqH8WEqF,True,12799622,3199904,19957,9978,9979,3uL2NSR2ZdDqCiKfzA5SwwpddAnit22DBJo6uvvz1rRs,798305,5540947,-4742642,623
2022-01-22 05:22:27-05:00,7858,8trkirSQNdMmAcJdeswxs5cPjH8dD6U4eJtWiAdMsrDB,HaSzpQ45x2MipfN17U6jGBxX8tXboomVDhXNSrnEfLDr,True,109274,27318,166,83,83,3zqXX6kzhkbW3d4TwD2CNjMRwxTbREXySekvq37kfCNk,6640,81964,-75324,607
2022-01-22 05:22:28-05:00,7859,HGAFdundf5voDqeh9g7d6Q9mgMf8eEg898QMRBqwPZ6C,deanBuZXWBHEe2TGfP37S9aMBEnEgmZoyRJjAvruzfA,True,2828776,707193,4416,2208,2208,HfEnetJ7uBSmZWCjBNxdvv9HEC5nsW4wDV7wu6WnhWan,176670,2459114,-2282444,624
2022-01-22 05:37:05-05:00,7860,2MbNCikBC3fdwqJKfMK1FjPg7wT3xWMXmN88XuikJ8r9,5eG6U5x63YYMpE7iwwu1TPcZapvQMyKczvtnFfST1BH3,True,11614,2903,17,8,9,HfEnetJ7uBSmZWCjBNxdvv9HEC5nsW4wDV7wu6WnhWan,719,6088,-5369,619
2022-01-22 05:37:07-05:00,7861,9yDHiv4vGbQWYby3dAMCdVnwiYgXBV1jV6WCzKYUPiUs,FPyemR1VdBnhxW2V7j7EkQyhzW894bCb3f6wRUMSn6jB,True,352816119,88204029,545648,272824,272824,3zqXX6kzhkbW3d4TwD2CNjMRwxTbREXySekvq37kfCNk,21825937,99187139,-77361202,618
2022-01-22 05:37:23-05:00,7862,DYqdjjx7PHxaHWTv6QC98aYZPDopJsTwfzaydLHGPn2,3EjvG9CUHmfRFhkq7kec31dKjjqiqEDxZAjgLeDNDQWu,True,18358282,4589570,28578,14289,14289,3zqXX6kzhkbW3d4TwD2CNjMRwxTbREXySekvq37kfCNk,1143140,6221191,-5078051,622
2022-01-22 05:40:28-05:00,7863,7feC64HZfQpniey2iXsMMgQXnfcunJus74DiKDeKaEUw,GstsCxAiBBEUrXNkvZZ9Sg4vNK916PsKe2Mx6e4M6dU7,True,74383,18595,115,57,58,4BnQKPLuE3DMTtxp8MjUBytgnhvxqq3ZTqZHTVZo4JJh,4617,56941,-52324,620
2022-01-22 05:41:39-05:00,7864,H1LftKtj94Zs6PG2A7gJt9rPurBkXkTy2hbbArQwAehi,8bANmhgdnPYa3PqdPnk5BA2xhvqJmPyaMF77mrBePJ13,False,886,886,44,2,42,4BnQKPLuE3DMTtxp8MjUBytgnhvxqq3ZTqZHTVZo4JJh,44,1125,-1081,496
2022-01-22 05:41:39-05:00,7865,8xQ3tsWVUe75EG1HmocULJ3kh52utveoFMEPotTGrKno,i3SKW3ywrwYucX9ySEx1C4zaUKGnzLerP3V38437NyV,True,1816018,454004,2800,1400,1400,4BnQKPLuE3DMTtxp8MjUBytgnhvxqq3ZTqZHTVZo4JJh,112021,1739020,-1626999,616
2022-01-22 05:42:07-05:00,7866,EBpxGcrs4eWAbBU5rEjFxbr24MjUstZQRMV9jK4q8kMp,EYVd6pztEuz8PC7rUnJ1AjVZ81WWpynyn2qEKtveqrHG,True,7898237,1974559,12255,6127,6128,HfEnetJ7uBSmZWCjBNxdvv9HEC5nsW4wDV7wu6WnhWan,490205,6276958,-5786753,620
2022-01-22 05:42:11-05:00,7867,CJpe9bNHxS63QMaGJhmnr4u7eTo6e5GApZQZyPtXLAkk,EMVL4sDfVXwGEoGEYwLp8D6itfy3eu4FZBAj1kMz6uXa,True,120784033,30196008,188649,94324,94325,3zqXX6kzhkbW3d4TwD2CNjMRwxTbREXySekvq37kfCNk,7545962,96740719,-89194757,624
2022-01-22 05:42:11-05:00,7868,ymyzGH4Qc7HH5PbKpVphCbsQgLLXyGkPcXamQJuNj5C,8oTLHaV2XzbKXNWRuUjCfHjUn61Pw93LYK14m9q2VDpZ,True,239304,59826,374,187,187,4BnQKPLuE3DMTtxp8MjUBytgnhvxqq3ZTqZHTVZo4JJh,14972,179957,-164985,625
2022-01-22 05:42:14-05:00,7869,3sGCWcgPY7TzRCkFR1uuY8KcUzVRbdTyFYxh7V1csNMX,CcRFNnG2uhyLwhNAbX4U49jkMeC11kJtVhhyqDWdDK5r,True,128662708,32165677,198273,99136,99137,HfEnetJ7uBSmZWCjBNxdvv9HEC5nsW4wDV7wu6WnhWan,7930922,103245590,-95314668,616
2022-01-22 05:42:14-05:00,7870,4oop1mjCh1Ao9NoWAUacAGc75GxiRTXr8KJ3NtzZ7btf,BfntjUunXBhnrKmocQ7pZr3wwxruRGudMyWQYC2MUhei,True,18631895,4657973,28912,14456,14456,3zqXX6kzhkbW3d4TwD2CNjMRwxTbREXySekvq37kfCNk,1156511,14521384,-13364873,620
2022-01-22 05:42:28-05:00,7871,A4Q7Vrc9M3GtEXNUSiVBFkansyf5sKBtSeVT92WFacqv,EWLNfsTKqzkd7KAhnrPRre4Dyk6exb3H9wSbrJuyWprg,True,115154513,28788628,177504,88752,88752,HfEnetJ7uBSmZWCjBNxdvv9HEC5nsW4wDV7wu6WnhWan,7100195,92325442,-85225247,616
2022-01-22 05:42:50-05:00,7872,6Z6y2QLJUZ5s6zdjanJcKprTAotx8tqr9DRNqqycMeS4,JCYwt8MHVaBb14GB2qAvDWwYVMaL7VTxyNEt7Eo5Zy8x,True,3701794,925448,5765,2882,2883,HfEnetJ7uBSmZWCjBNxdvv9HEC5nsW4wDV7wu6WnhWan,230612,3042111,-2811499,622
2022-01-22 05:42:52-05:00,7873,C1CsbgQFvEvSXzuVHTr39tQHr3drDhjxeYiotd8eNocF,4rAaTCAMj5VpgNVKiYizabH7cMLhEA12seu2QXQNTyV3,True,5315655,1328913,8285,4142,4143,3zqXX6kzhkbW3d4TwD2CNjMRwxTbREXySekvq37kfCNk,331407,2080445,-1749038,623
2022-01-22 05:42:53-05:00,7874,9Hz4p7gcfDbXBJp8KzhaBBPh9i7xe9kun7zLfDtqPe6c,2bJ43Lep6kp6WY7Ct56oiscKnAbdtC265G5yRvRPFThU,True,16499163,4124790,25329,12664,12665,3zqXX6kzhkbW3d4TwD2CNjMRwxTbREXySekvq37kfCNk,1013178,8402315,-7389137,614
2022-01-22 05:42:53-05:00,7875,2FEbsetZMkRqLjSC8GBbgecKgX5T1T1fci2sLQux29p8,H722Fcd6DkTFRZxqQWbPDufBfXEgmFfhiEpQZWhxwYv1,True,83920,20980,130,65,65,HfEnetJ7uBSmZWCjBNxdvv9HEC5nsW4wDV7wu6WnhWan,5211,63978,-58767,620
2022-01-22 05:42:53-05:00,7876,BYvjENe16Ta77PqGV7JKEWrsqCTfkMGYwTSG5gXneDvd,EvxAXgvhPC6QkNurbK7vWyTApGo8J2R4EgMAknkHVU3d,True,53706,13426,83,41,42,3zqXX6kzhkbW3d4TwD2CNjMRwxTbREXySekvq37kfCNk,3342,56659,-53317,622
2022-01-22 05:42:53-05:00,7877,BLJgLzizx2yLgd12pVBAHTMqn9J5JA3JHCF8PnLnPyUk,HhDmwMysBFWhXnd3mrV31w75WBRKBS8wJSiEMZgqdUSp,True,17754197,4438549,27366,13683,13683,HfEnetJ7uBSmZWCjBNxdvv9HEC5nsW4wDV7wu6WnhWan,1094659,15014957,-13920298,616
2022-01-22 05:42:54-05:00,7878,BrHRMouGRz3LBNzd9anfdYMhWfg8yUPHL4PqJ8WdEDFS,4uzoLa3mC2VYHAPBoHLX4gTjPTC28rPf2fvEGtJWPYc,True,1057006,264251,1624,812,812,3zqXX6kzhkbW3d4TwD2CNjMRwxTbREXySekvq37kfCNk,64980,1370522,-1305542,614
2022-01-22 05:42:54-05:00,7879,AvpYg74EBhwAXE8rcdGkpwmbBMRyVidF6zMRSFtWAVC6,4WgpqTp4r9wMpMptYMNbvCaP2faBnVr6FdShCAobetpL,True,4476013,1119003,6894,3447,3447,HfEnetJ7uBSmZWCjBNxdvv9HEC5nsW4wDV7wu6WnhWan,275766,3691430,-3415664,616
2022-01-22 05:42:54-05:00,7880,4SX2pj4eHRwFMtyDCrMZ8ZT6ASAMi7yfZWZnccw5dGn8,Ads49ZqvTmPHxfzNYm4oJb4HBYhwS6vXQbarqmpUi5VZ,True,3678652,919663,5710,2855,2855,3zqXX6kzhkbW3d4TwD2CNjMRwxTbREXySekvq37kfCNk,228433,3031749,-2803316,620
2022-01-22 05:42:54-05:00,7881,Aop82qT6CwZbomif4QowqP3VaSHKB1837B2yNKqw4tER,65BVa4jrCx9etU5eXBAXT2PVnwVot2HLWGYyNXbVJDFk,True,62067643,15516910,96089,48044,48045,3zqXX6kzhkbW3d4TwD2CNjMRwxTbREXySekvq37kfCNk,3843591,49765040,-45921449,619
2022-01-22 05:42:54-05:00,7882,FdYFnEYtFQKcZPmzUqnvNLzozxdR1emtkmvnYcMgYykS,7arWNJQf2cWxerjhLgQh9CJxwTat1efnr5KmhuD7Qnv4,True,3511235,877808,5363,2681,2682,3zqXX6kzhkbW3d4TwD2CNjMRwxTbREXySekvq37kfCNk,214534,2896719,-2682185,610
2022-01-22 05:42:54-05:00,7883,B4Uc39nKzz9wBRQsCkMR4A7RwTJ8rSuwpR6EQn2AesRb,H49bGZgatRZVpj6QufZRVgYrQtH7LpdbiqKBs23151m,True,449542,112385,702,351,351,3zqXX6kzhkbW3d4TwD2CNjMRwxTbREXySekvq37kfCNk,28111,632193,-604082,625
2022-01-22 05:42:54-05:00,7884,U3vvMQ4X4aKzVYfhMw1V1p58HRqaLnuXozqmmefYeD9,7JA94MArkNCFRhBq8f5a32DgMF6aPdFsoC5HvXDQ6NuR,True,5455341,1363835,8434,4217,4217,3zqXX6kzhkbW3d4TwD2CNjMRwxTbREXySekvq37kfCNk,337394,5079642,-4742248,618
2022-01-22 05:42:55-05:00,7885,5y8ZSWUnrm4B3emh7vLQKTh89vHtCvXqUhk7fJBA52is,Bu1AoKU2QQWpGH54ZzugvvACB3E1d3VvymnegNmTgHqg,True,126403925,31600981,194206,97103,97103,HfEnetJ7uBSmZWCjBNxdvv9HEC5nsW4wDV7wu6WnhWan,7768241,101342096,-93573855,614
2022-01-22 05:42:55-05:00,7886,7EvJoetxJVTgpJXqE1VC3fZN1CQ5xdWdv29yCiDuH9gU,6RTEusjGEHNDdMj75qkpzYHjHZ3R2XN5xvptCwkRJz5j,True,5059192,1264798,7862,3931,3931,3zqXX6kzhkbW3d4TwD2CNjMRwxTbREXySekvq37kfCNk,314500,4170037,-3855537,621
2022-01-22 05:42:57-05:00,7887,FV9CBGGTbppLnBKh79f2LzD1diTiS5g6u89FcpZHZmnK,Fe7mtmCUziFqbbYTvrhAcAq1Ub7YLfTJRtQ1hG7GzJD1,True,94521,23630,146,73,73,3zqXX6kzhkbW3d4TwD2CNjMRwxTbREXySekvq37kfCNk,5842,71917,-66075,618
2022-01-22 05:42:57-05:00,7888,As81koHnSP9quoXuUVNHp3VR3Qaks8HLa4sFgJDocYiF,AMVm8dXia5s974VgZSbeE6uPDgyXDHZFyJ2W1J1CWvKW,True,126371816,31592954,193456,96728,96728,3zqXX6kzhkbW3d4TwD2CNjMRwxTbREXySekvq37kfCNk,7738253,101344217,-93605964,612
2022-01-22 05:42:57-05:00,7889,9BMHbUs4d3qX49fnroHv2FTPDs4yoDFrvDMqf8p9U4pE,2yL7zwMr7qVG5Sdwkf7z6ppnNqt1ASppBbmxwYjfFY6Z,True,70159108,17539777,108907,54453,54454,3zqXX6kzhkbW3d4TwD2CNjMRwxTbREXySekvq37kfCNk,4356311,57826098,-53469787,620
2022-01-22 05:42:59-05:00,7890,FF8rqfM9PTEjYiVFy8jS81weDRwdaYooux2uSa2LexrJ,JBk1JghH1gged1YpDbkczFXP9ka5ivYSkaYoVbbXD4kg,True,3258760,814690,5054,2527,2527,HfEnetJ7uBSmZWCjBNxdvv9HEC5nsW4wDV7wu6WnhWan,202170,2882166,-2679996,620
2022-01-22 05:42:59-05:00,7891,9kYkFDNE3qD6s73fn8kJowgqbDZoDSw22XaUJ7rTD43D,E8zJz8pT2c9aZsxe4kLMNs4bY7skt38SU5wK5JTqbGr6,True,69275915,17318978,107617,53808,53809,3zqXX6kzhkbW3d4TwD2CNjMRwxTbREXySekvq37kfCNk,4304703,57119448,-52814745,621
2022-01-22 05:43:00-05:00,7892,FYdUiU3rPpbYKWnEpekQQsocSJKjXmscohi4v6DYqix7,daPyq9YdunQJhhLoW5ifhJ7UFPTtRZhGs4JwE1nqZhN,True,4540631,1135157,6983,3491,3492,4BnQKPLuE3DMTtxp8MjUBytgnhvxqq3ZTqZHTVZo4JJh,279336,3744852,-3465516,615
2022-01-22 05:43:00-05:00,7893,HGJoZvLakWfSDFwuvShNBc4kCf7nP7VqzyM3mELpbFEf,12Qn5jin7QvsBngXqYAv4UstyG3b6nRf1jsLp9Dp8G7k,True,281703,70425,438,219,219,72FwbpFGoLEazJEdpqNtPNefsadUrimUqma9wSoy4qiS,17532,237486,-219954,622
2022-01-22 05:43:03-05:00,7894,2ZSfbqxhiCTDrDPeRhoWayTZHNmW7ajVXBCxpFS4eGBF,3ZmWsPdQD7qfSMGKQSNhmBtuH7S6qMFRc8oEmBcHXEiR,True,4511455,1127863,6911,3455,3456,HfEnetJ7uBSmZWCjBNxdvv9HEC5nsW4wDV7wu6WnhWan,276472,3720139,-3443667,612
2022-01-22 05:43:13-05:00,7895,BjCNaM7YbE9SjFi7tzi4677zg1fKXGJwtecz2GWwWuhd,6rNsSrKZezQrLb2whToNjnizpnurDXrobHqfEK3QqU1M,True,1209703065,302425766,1879952,939976,939976,3zqXX6kzhkbW3d4TwD2CNjMRwxTbREXySekvq37kfCNk,75198092,541806781,-466608689,621
2022-01-22 05:43:14-05:00,7896,DMgD2KCEhTGFLUZ5GnfNcwfiiwKYbyVpoWiN6knMkCAf,5KU2vgBkPTNVHsSULjgX7ZkZS56U3Dy3xqLTxL5sUZJ3,True,24734574,6183643,37776,18888,18888,3zqXX6kzhkbW3d4TwD2CNjMRwxTbREXySekvq37kfCNk,1511060,25709391,-24198331,610
2022-01-22 05:43:14-05:00,7897,6Bq55LtGCEeGqh4JrFLCmmGc2iJfTTBJixivqH78aGSE,DSNrCgWJeNe2P9tAQu5FvCueTzNKDKds7wzuwTQSMRG,True,119138,29784,185,92,93,3zqXX6kzhkbW3d4TwD2CNjMRwxTbREXySekvq37kfCNk,7407,90011,-82604,621
2022-01-22 05:43:15-05:00,7898,HpRYrL8HzCPaBJTLFgZmYg2aXBnBQUpf1mikVkzkY56z,8DzHRd8qWcEjnX6cefwYtgRGpQJUaw9QPjyfAsN7j33r,True,46028291,11507072,71967,35983,35984,4BnQKPLuE3DMTtxp8MjUBytgnhvxqq3ZTqZHTVZo4JJh,2878684,36842313,-33963629,625
2022-01-22 05:43:15-05:00,7899,CEtpqFD4BbeiNfaXyLLYEapY2mWgE26H5q6H34tWwRuD,BVqRyqwGFPzSkk1H2finiyfaL3LScbEiQGk3mihirxqs,True,3323166,830791,5125,2562,2563,3zqXX6kzhkbW3d4TwD2CNjMRwxTbREXySekvq37kfCNk,205002,2686667,-2481665,616
2022-01-22 05:43:15-05:00,7900,8xjstKJD2RopRxxRP8JbMYRmpBKgSZivMFRXXRZ5syPh,HUfevkvBsm5SDpxnZ4NBD8Re7LvqBQLrx5UWXCeYTBgK,True,6682732,1670683,10444,5222,5222,HfEnetJ7uBSmZWCjBNxdvv9HEC5nsW4wDV7wu6WnhWan,417775,5306106,-4888331,625
2022-01-22 05:43:15-05:00,7901,2AAWghW6BUAFBtF3R6hB9uoqMc5oUDkU8FTd2JrXKema,798cfEUZ2YhXwNTNjXMS4Z2J8gAHaK4zZwpMkq2HzWWM,True,24253357541,6063339385,37454836,18727418,18727418,3zqXX6kzhkbW3d4TwD2CNjMRwxTbREXySekvq37kfCNk,1498193443,12501124615,-11002931172,617
2022-01-22 05:43:15-05:00,7902,HZSJVNb6g4o52N7pAJCLkGjur8evF5Ex1sAx7uUxUDdm,8LQHKhXStrwcd6f4AxaTVcrGdYpGjQz8vWf5JXsAzcsp,True,5184782,1296195,7983,3991,3992,HfEnetJ7uBSmZWCjBNxdvv9HEC5nsW4wDV7wu6WnhWan,319327,4279343,-3960016,615
2022-01-22 05:43:15-05:00,7903,95urWGJ4HN1bTarbDi8Dpj4K4ms7dovs8gwaYdaSLC6e,2THhqxjhXjp2Zui9ML2MzAbGN4dsfa3dkdqzC8LYhnbQ,True,6599658,1649914,10133,5066,5067,HfEnetJ7uBSmZWCjBNxdvv9HEC5nsW4wDV7wu6WnhWan,405339,5244627,-4839288,614
2022-01-22 05:43:15-05:00,7904,3NhNdphQiKwgHTmTJc4qVhp3aWjqnwMTYbRW1y9CZrZg,BNpP1sKPAr7Dk1ymSrupge9KGMVpk4LfjTjawgi9YaC5,True,26408895,6602223,40247,20123,20124,HfEnetJ7uBSmZWCjBNxdvv9HEC5nsW4wDV7wu6WnhWan,1609897,21196356,-19586459,609
2022-01-22 05:43:16-05:00,7905,8GdYhwX26GRmVfGFCbJ3MJrH1UdneN2FNRUexhLsqprN,DpUTHSVucDPyCWoLCdpm8EFRZFiKL88tmnSiWG2TRpS8,True,4044700,1011175,6194,3097,3097,4BnQKPLuE3DMTtxp8MjUBytgnhvxqq3ZTqZHTVZo4JJh,247788,3313331,-3065543,612
2022-01-22 05:43:17-05:00,7906,9rgrRAMcGSarfz8xXckw1LjkemMwwjzJLApPjpfY2XZ3,BRtNdDDtCiNDYDERZTBCefUiYvjShucRX1hxEBLyeggT,True,3559615,889903,5463,2731,2732,HfEnetJ7uBSmZWCjBNxdvv9HEC5nsW4wDV7wu6WnhWan,218528,2936038,-2717510,613
2022-01-22 05:43:17-05:00,7907,8nXbrdjjaHB73CRPRenGEQj73wbtEFGDwXsehRGMhsap,43pvdcJ6f27wz94D6ZboKwRJYbyvYCrjsJhYsvk7LJCM,True,1117748,279437,1736,868,868,3zqXX6kzhkbW3d4TwD2CNjMRwxTbREXySekvq37kfCNk,69474,558062,-488588,621
2022-01-22 05:43:17-05:00,7908,BJaaH1SK1pF2kZQzmYpLFfDtm52CR9a5rd39RAPtLe8q,HUsT5FVxaisdnCvG1BQxX6zffjfL2Rwx5mMo5y8SDV7e,True,1753058,438264,2730,1365,1365,3zqXX6kzhkbW3d4TwD2CNjMRwxTbREXySekvq37kfCNk,109204,985085,-875881,622
2022-01-22 05:43:17-05:00,7909,96StvqZyFUPtyMr4o9s7K4V29RSNyRpVi76vNwxG5rUf,GZKXFSFq4aGiTaqovtxqNCCVGkAFNXPh4Hep1ZMwdZ8g,True,400282,100070,611,305,306,3zqXX6kzhkbW3d4TwD2CNjMRwxTbREXySekvq37kfCNk,24460,548126,-523666,611
2022-01-22 05:43:18-05:00,7910,3qnPsgqW11AcDEmyjmJquPcPLyE3EdJQuVLJ5kinDrd3,86rZadBB7emKio76aFTahpbrFtxd9tqZ4Mxgzaavq2xU,True,2740,685,4,2,2,3zqXX6kzhkbW3d4TwD2CNjMRwxTbREXySekvq37kfCNk,168,2250,-2082,613
2022-01-22 05:43:18-05:00,7911,E8iuHK2DErFnMAYfWmNoix4jVb4WDG8Sc41hBycLUxbd,77Zoru23JmnK5EJ8eURonQoEpJcLP4edabjD8MR8NKdX,True,69925481,17481370,107543,53771,53772,3zqXX6kzhkbW3d4TwD2CNjMRwxTbREXySekvq37kfCNk,4301759,57687681,-53385922,615
2022-01-22 05:43:20-05:00,7912,GcjcaWoMUcGkLaJBx3svxtzwGNn5SLcFrwaLqnpadUZY,Ep9sDjTMMasVjKdshsE88uk3mWYkKuMTVRooVJWvCq9F,True,68562197,17140549,106769,53384,53385,3zqXX6kzhkbW3d4TwD2CNjMRwxTbREXySekvq37kfCNk,4270770,56542702,-52271932,622
2022-01-22 05:43:20-05:00,7913,5iRLEmB6qBHqkJBPyyubnd9f1TpRr4EY8BTxuHUREeLB,GkY73KL6HJ4ycdggFtYWALBgmTRZVCx66P2ZJ7E8ENwC,True,3849404,962351,5997,2998,2999,3zqXX6kzhkbW3d4TwD2CNjMRwxTbREXySekvq37kfCNk,239896,3175799,-2935903,623
2022-01-22 05:43:20-05:00,7914,43wwd6zLB8yKfXEu7rtbeDFhKBuxFR66MnyhTKW3zqa3,A9t6AMvVNenwWymz3QMtdUuuGYjjTPLaA9bhRjTzNY9h,True,70267018,17566754,108915,54457,54458,3zqXX6kzhkbW3d4TwD2CNjMRwxTbREXySekvq37kfCNk,4356602,57955499,-53598897,620
2022-01-22 05:43:20-05:00,7915,BJV5jbowrbELXfDvfMovaQy4PiRf12pLYHimW9bgzW5X,6WXrWso5FvLx7RMCFBzrbzh5qevKkk2LJAihUfWXxXzB,True,375205,93801,568,284,284,3zqXX6kzhkbW3d4TwD2CNjMRwxTbREXySekvq37kfCNk,22734,490822,-468088,605
2022-01-22 05:43:20-05:00,7916,EPWsutEpgpcz776maq552k8QhDKdmkSfAED5E3jgpTdY,CCwGZYDvqoHEBBtSSieAJgy5e3k4jYrpjyDffypwnWxu,True,187484183,46871045,292506,146253,146253,4BnQKPLuE3DMTtxp8MjUBytgnhvxqq3ZTqZHTVZo4JJh,11700256,148602935,-136902679,624
2022-01-22 05:43:20-05:00,7917,4nhdidD6SASYzwZ7mUnWKyP4xyWXhdBe2gp5F4qDtLrL,HLk6YPhVidsn3i8HfoASvoim1ztxb4bi8JnioiyvorpV,True,25328852,6332213,39483,19741,19742,3zqXX6kzhkbW3d4TwD2CNjMRwxTbREXySekvq37kfCNk,1579327,20246031,-18666704,623
2022-01-22 05:43:20-05:00,7918,7jvKp6onXyWgwsFrFWj4hYTXJsYYD6ot5mn6rPFuJriy,J7N6HiozevJVTiY9hDEUs2ud5BwT5QSE7wnMBS1w5ie2,True,1940061,485014,3030,1515,1515,4BnQKPLuE3DMTtxp8MjUBytgnhvxqq3ZTqZHTVZo4JJh,121204,1568175,-1446971,624
2022-01-22 05:43:20-05:00,7919,4yhW5mBsFVNgQ5QQc2Yg65guctPsTSXcERbzmYM6rdnL,5uJnMZ6DWA9bMSvHvS5zomwtt1sv7YCWq3GDJh77YC3q,True,4435654,1108913,6831,3415,3416,HfEnetJ7uBSmZWCjBNxdvv9HEC5nsW4wDV7wu6WnhWan,273243,3666842,-3393599,616
2022-01-22 05:43:20-05:00,7920,446VESPwhh16pG3VcpgraT83MoqWy87qgU36mKZC8BsW,SmUPkPpnnRfSH3tcKUnbpK6HHNJtLfvMiUWk9eUwkNy,True,186347305,46586826,290652,145326,145326,3zqXX6kzhkbW3d4TwD2CNjMRwxTbREXySekvq37kfCNk,11626090,147704917,-136078827,623
2022-01-22 05:43:21-05:00,7921,EL9JxeMvWWLTdVC5QrZzSSgApEwv1nDhZc6yNmH9G8ad,EqSQLSFx1eKkTYAdv5XhekttqVh7TappXAHuv9EedCXq,True,1816,454,2,1,1,3zqXX6kzhkbW3d4TwD2CNjMRwxTbREXySekvq37kfCNk,112,1465,-1353,616
2022-01-22 05:43:21-05:00,7922,DD1a8rMoUCwmEiLKRN43VpdqL8Qgfr5yi92ejQxDVRMo,3vMJVNAuyRhM9jkaEZARhwbR6MerR5UmcgoZ9c5bs1VS,True,82508254,20627063,128443,64221,64222,3zqXX6kzhkbW3d4TwD2CNjMRwxTbREXySekvq37kfCNk,5137725,68074322,-62936597,622
2022-01-22 05:43:26-05:00,7923,5FgPU7KpsDnx4Xc1UdQoLPR7MDd5cBkJXW2Q8ctopMZR,9GWzAZFVfTY8WjTYvDAE2YcAjgeKiDXgToK76KBZF7Rv,True,5961775,1490443,9327,4663,4664,4BnQKPLuE3DMTtxp8MjUBytgnhvxqq3ZTqZHTVZo4JJh,373099,4733213,-4360114,625
2022-01-22 05:43:26-05:00,7924,28YQqynu5oRud5xEcsDvAaGhJhgpiVJSTNeMwkrbpbyv,9zYqRWiRatbohCdBfV3PrAxp8v1kwgbvV9ta4RJRRp68,True,183712319,45928079,287047,143523,143524,3zqXX6kzhkbW3d4TwD2CNjMRwxTbREXySekvq37kfCNk,11481906,145596066,-134114160,624
2022-01-22 05:43:39-05:00,7925,4eaXYcx5ayhTq9TmmQFgLDjy6p3z93txUN97v8PTSh1J,J3vgUnjDUy5ngrmrs6FwpZTexxJNxXM1UjsHvsgw9g9y,True,4506425,1126606,6971,3485,3486,3zqXX6kzhkbW3d4TwD2CNjMRwxTbREXySekvq37kfCNk,278852,3718297,-3439445,618
2022-01-22 05:43:40-05:00,7926,BMawc4jLJMER4ryGcwdm27H3MU8JQCiSfwb9onVfYDpr,5ciaGDuaB3rBKvV7MphT2eMkCUxBzWZc7zYXQM7vbQ46,True,26486646,6621661,41392,20696,20696,HfEnetJ7uBSmZWCjBNxdvv9HEC5nsW4wDV7wu6WnhWan,1655712,21164420,-19508708,625
2022-01-22 05:44:15-05:00,7927,EYNh72buYHmKWRSqF8omcFHRbqKWV76iXB2vrjHgQMck,Efm7bH2DFg5Y5M39jq3uDcoDHUa95zmey8n7Ld72jG84,True,68534195,17133548,105875,52937,52938,3zqXX6kzhkbW3d4TwD2CNjMRwxTbREXySekvq37kfCNk,4235008,27562126,-23327118,617
2022-01-22 05:44:17-05:00,7928,DMACzuFBuj2vGqxZ3FV7QAo24jMV3EHKL8MrDrGbRkaJ,EnLfmDVW4ba2uqZKhj3X1TFnx8AHv7xwSWrMbVBYwcu9,True,14042238,3510559,21401,10700,10701,3zqXX6kzhkbW3d4TwD2CNjMRwxTbREXySekvq37kfCNk,856075,6553896,-5697821,609
2022-01-22 05:44:23-05:00,7929,3idUQDMPAN9f6F6BipHAYFZyhG5JADey1y7JcFYx5BRh,D6UMk8WsSRahs4nGyi9DLt2HyZQy4wAywDwL31sL8BVj,True,5828099,1457024,8858,4429,4429,3uL2NSR2ZdDqCiKfzA5SwwpddAnit22DBJo6uvvz1rRs,354347,2142215,-1787868,607
2022-01-22 05:44:23-05:00,7930,5gN3624v6n1zQ1BKtZi1e9ZLpbCa4MEfhgHySFB81Qfm,UXT3oB5ud18rBsygsfxwA93kQYdSNbbzTCjt4gtU2jP,True,50252989,12563247,76536,38268,38268,3zqXX6kzhkbW3d4TwD2CNjMRwxTbREXySekvq37kfCNk,3061454,13550365,-10488911,609
2022-01-22 05:44:23-05:00,7931,9E97vZ6evPgg1Ao8KwvjjZhBFW6dXZrrJENk1HvZ3SU,D7U38PB8BXLwUVKbRNv9po7VcFdnn7Y4tWY9xpRiNJsT,True,7868666,1967166,12074,6037,6037,3zqXX6kzhkbW3d4TwD2CNjMRwxTbREXySekvq37kfCNk,482963,3216824,-2733861,613
2022-01-22 05:44:29-05:00,7932,JCagxpXPs6wVRUWbNBPCZ4uLCkZsachnofN7SZEEwGwB,5uGj1TBCkc7FV4ffdBJg31yLcCxkQLxRExjcinnJUow9,True,1982921449,495730362,3061809,1530904,1530905,HfEnetJ7uBSmZWCjBNxdvv9HEC5nsW4wDV7wu6WnhWan,122472391,1533712311,-1411239920,617
2022-01-22 05:44:49-05:00,7933,4mB2DVbQVqVk535v98Cj8SPNg1tTc3DFyY2Q7VBbY645,HXo255k3RgsTGsc4hiP6ZTXUspBTqJ37duQa5eK7tqp3,True,22084048,5521011,34516,17258,17258,4BnQKPLuE3DMTtxp8MjUBytgnhvxqq3ZTqZHTVZo4JJh,1380661,14751762,-13371101,625
2022-01-22 05:45:25-05:00,7934,EDSf2w1UyGvbgMuxyoXL58ifR1dviZinnLBYnFmgjcNG,DFenkzbL9SUjs9cSCaHJ1eXK75mHfk3GSPRFs8TSzrFV,True,198141979,49535494,309951,154975,154976,HfEnetJ7uBSmZWCjBNxdvv9HEC5nsW4wDV7wu6WnhWan,12398071,79702674,-67304603,625
2022-01-22 05:47:09-05:00,7935,HxhVxMpFpKzeuC6Z6CpsuUhPHdHUzvpMNYJ8LpQ3NYCp,8KyiipC39iU15zVErVvj6hdhbv89STsexrB8dVw3RcLs,True,4717044,1179261,7055,3527,3528,4BnQKPLuE3DMTtxp8MjUBytgnhvxqq3ZTqZHTVZo4JJh,282201,3905004,-3622803,598
2022-01-22 05:47:09-05:00,7936,7afnF1MkAootZGWc7zsMVLpBuve83hGmvAHkfmwgsq5A,HKdJE8bReznq1Qxqd5iZ4nWQGCk62Vo5TpkRD51bpbGp,True,4623514,1155878,6981,3490,3491,3zqXX6kzhkbW3d4TwD2CNjMRwxTbREXySekvq37kfCNk,279279,3823569,-3544290,604
2022-01-22 05:47:09-05:00,7937,DE8c5VWwgCqQnUMSyMZEbKazQAsSjY52L85yojCr57X5,6ycUU1Tc7HG3J8hE6jwkRFCkdbEqyU95ZKY6HbfnYcGo,True,14785,3696,22,11,11,3zqXX6kzhkbW3d4TwD2CNjMRwxTbREXySekvq37kfCNk,882,11953,-11071,596
2022-01-22 05:47:09-05:00,7938,HoJ3Re4BmCYKMJx2RUYtoHfg8ncEy3iFqvWJDGKqfMBV,2qg4FMcurNDVRzXYKwpzEYapxFECnAyU2oGmxQCSf3hf,True,3710944,927736,5803,2901,2902,72FwbpFGoLEazJEdpqNtPNefsadUrimUqma9wSoy4qiS,232127,3205408,-2973281,625
2022-01-22 05:47:09-05:00,7939,6fqbSyhh3PPdgRcLraHb7Jahj9s1oHHeX3SsjNSsGa6t,GpRUow48TYgttdYfsygbgjYQcmHyYjWETUDjDVphEgwq,True,7782197176,1945549293,11865222,5932611,5932611,3zqXX6kzhkbW3d4TwD2CNjMRwxTbREXySekvq37kfCNk,474608882,3204533550,-2729924668,609
2022-01-22 05:47:09-05:00,7940,AzLdwyd8Q4V3iMaSwWgvWwQ9nCs7X7YV2YKpd6CH33nP,BYjeXF5YkcJy3mNMbvfHzXTtyjkc4U53hM5tvfERUH8y,True,4475463,1118865,6895,3447,3448,72FwbpFGoLEazJEdpqNtPNefsadUrimUqma9wSoy4qiS,275815,3698957,-3423142,616
2022-01-22 05:47:09-05:00,7941,3R2wxFQwjCqUwwxJmp9tNrT6osYFpB5gczq2QYik6QYm,7At5Ej3ZsynfWr56FYrd4P4Y6UtD8FHA4gCFB8TaAyaG,True,4503777,1125944,6907,3453,3454,3zqXX6kzhkbW3d4TwD2CNjMRwxTbREXySekvq37kfCNk,276301,3730174,-3453873,613
2022-01-22 05:47:09-05:00,7942,HZJyrD4eqM4nKnyRh2JAs1sC2TaJxFhNPixBdK7PLMuS,Hycz71z4tEsKUogJnefT2GN3MPCLdTJdv9B6T82Ngw2u,True,19377802,4844450,29559,14779,14780,3zqXX6kzhkbW3d4TwD2CNjMRwxTbREXySekvq37kfCNk,1182389,16174544,-14992155,610
2022-01-22 05:47:10-05:00,7943,Dqnxcekm1QfxGQ2FSJ6SjFiwmaQRWEjW9WTJQG4AjEpE,9JiMtjm5AJqngosRg787FiN8NyuBPuAPD2jYpRQkAc1d,True,5865658,1466414,9072,4536,4536,3zqXX6kzhkbW3d4TwD2CNjMRwxTbREXySekvq37kfCNk,362906,4848990,-4486084,618
2022-01-22 05:47:10-05:00,7944,EAUFD16wab8qRMJ4H6updHGt4xFqgRCDeRHVCsLCTSTL,8vkfYSyCyBY9g4TZrp52jUcQj6udy9xAaA4fioRE2RXx,True,2698125811,674531452,4170656,2085328,2085328,3zqXX6kzhkbW3d4TwD2CNjMRwxTbREXySekvq37kfCNk,166826240,1153915797,-987089557,618
2022-01-22 05:47:10-05:00,7945,9WRDBHzD4aNHw5qvrhc6nqXCBLA5D7YYP8TvSrLksXd6,GwxWNmv9XDkqQsx7DfCMccFjVik8asPnFU9gtnb4UVx,True,3483591,870897,5248,2624,2624,4BnQKPLuE3DMTtxp8MjUBytgnhvxqq3ZTqZHTVZo4JJh,209942,2881781,-2671839,602
2022-01-22 05:47:10-05:00,7946,AECUZGm5DjFvbLZEUYhepSPg1Wa7hBjxF9e7ZRBzRPhm,Ar7e1iLKAqa54QiQnXifvnETixDZT1T8KL5YWJA8Ykv1,True,5452805,1363201,8377,4188,4189,3zqXX6kzhkbW3d4TwD2CNjMRwxTbREXySekvq37kfCNk,335083,4508799,-4173716,614
2022-01-22 05:47:10-05:00,7947,4cNmhgaMic1xBiaDJ6phrQuXmm8WfF1qjyYMqZcKG4c9,43vgfXiLTtcs1bkrcDar2iz9M6RMbGqbA6BMkBHdh7T4,True,4219598,1054899,6338,3169,3169,4BnQKPLuE3DMTtxp8MjUBytgnhvxqq3ZTqZHTVZo4JJh,253557,3519005,-3265448,600
2022-01-22 05:47:10-05:00,7948,2DHhfXSzcuSwsKfAYLMuWuD17w84mCwNer9fcBNLTpSc,89BVfDycKjdSkQzFVqCXd5c16DntdND7WsqoZtCafYFH,True,215413593,53853398,320407,160203,160204,4BnQKPLuE3DMTtxp8MjUBytgnhvxqq3ZTqZHTVZo4JJh,12816294,172365920,-159549626,594
2022-01-22 05:47:10-05:00,7949,G8nRLTWTT5aD7q7TcSa2mw7p12GUuHDVq5ev4vyXbdKi,3DmQyungZMK4T1a1PgXh5shBskwP69tTLmZPh7HZ76vh,True,6580106,1645026,10183,5091,5092,4BnQKPLuE3DMTtxp8MjUBytgnhvxqq3ZTqZHTVZo4JJh,407355,5439880,-5032525,619
2022-01-22 05:47:10-05:00,7950,EmXaq1sxmAZUiwYW6LXpKtKFZXu5MzQ3sK4MEAojDK1h,HuAsa5G2wJi8Ah9stxEmggwcB5zW1QjBsP3Ndgke7r8X,True,6010647,1502661,9029,4514,4515,3zqXX6kzhkbW3d4TwD2CNjMRwxTbREXySekvq37kfCNk,361185,4977471,-4616286,600
2022-01-22 05:47:16-05:00,7951,4HDEN1Thxm9RbdE8pXnLP4QksVdXfp7Fa9nAnMRzr7oR,8gD3DbF6VhPTCgk3A4G7iA4f3DPH598Hj7TRJ2FebMCq,True,5818201,1454550,9062,4531,4531,3zqXX6kzhkbW3d4TwD2CNjMRwxTbREXySekvq37kfCNk,362490,4617227,-4254737,623
2022-01-22 05:47:16-05:00,7952,45AiuRBbmupfwYXqsWwKHtmEWN8XNJDUSHwHL3b6PvHc,CfvwVkxYPP3jqK2dpAvSRFA1513E9ti84mEpYgtkzFUt,True,7654147,1913536,11512,5756,5756,3zqXX6kzhkbW3d4TwD2CNjMRwxTbREXySekvq37kfCNk,460493,6088740,-5628247,601
2022-01-22 05:47:16-05:00,7953,68F35fonSGS1P6LMYmAmeoM8kC6Z78NabMqYLeCZr9GJ,8apmWSZdS8s1ScoNVj4AvSJsbQCj1drU3HL74khuANT2,True,4787790,1196947,7338,3669,3669,3zqXX6kzhkbW3d4TwD2CNjMRwxTbREXySekvq37kfCNk,293544,3959954,-3666410,613
2022-01-22 05:47:16-05:00,7954,9QZvB1Gqhk5PKt3MoJMjZL3FaU2bTbTDcVw3nF316zh7,DGJWGr9RCWkzdWn21mWG7NyUN8uuvSQbA53HojFJe1rH,True,57982044,14495511,89982,44991,44991,3zqXX6kzhkbW3d4TwD2CNjMRwxTbREXySekvq37kfCNk,3599290,45974101,-42374811,620
2022-01-22 05:47:17-05:00,7955,FtF3PVw8YNJseWPMcA2GEuQZ6nni1mq5kYPa2LrSzfkW,4yr1TM2dXrBvLNMpSaoryuGU2P8D3WG1ZCkvVzWFiQRH,True,3484919466,871229864,5434215,2717107,2717108,3zqXX6kzhkbW3d4TwD2CNjMRwxTbREXySekvq37kfCNk,217368629,1543905477,-1326536848,623
2022-01-22 05:47:17-05:00,7956,2ZX5NexeuZq25mAfBFDrwd44UfKhWgzmSwdhWFmo48c7,CpNnhSqg7EHn9g84gHoo831sVrAe5SkwNaEZAash4CXs,True,30486711,7621677,47440,23720,23720,4BnQKPLuE3DMTtxp8MjUBytgnhvxqq3ZTqZHTVZo4JJh,1897625,25405483,-23507858,622
2022-01-22 05:47:17-05:00,7957,8XcMucCQpWfNtbdCYnKuabk91NQ9wfYp7byk496CwU9n,DLrApDfWcyMqufEFZm9PvddsMoiediT58X8e8pxpnzrk,True,7385803,1846450,11549,5774,5775,3zqXX6kzhkbW3d4TwD2CNjMRwxTbREXySekvq37kfCNk,461999,5857669,-5395670,625
2022-01-22 05:47:18-05:00,7958,AiLCB8xw3k5FXdJE1T42PLFhHrz1bLTKpNekR61a915N,HB7CNWxLipWAc6MPGq9wV4TT7AYjiELA5T3onYeVqBbU,True,90529990,22632497,140373,70186,70187,HfEnetJ7uBSmZWCjBNxdvv9HEC5nsW4wDV7wu6WnhWan,5614931,75568928,-69953997,620
2022-01-22 05:47:18-05:00,7959,Hqzz5RdbkkmMPCVdxF3Q3sLuh7XVJHEwAP6zpz7pCwTj,TNwXSETgrJGM9S5zbBY3mMWKbPFskbKjPAhBrWFNfuK,True,4012917,1003229,5983,2991,2992,3zqXX6kzhkbW3d4TwD2CNjMRwxTbREXySekvq37kfCNk,239358,3318341,-3078983,596
2022-01-22 05:47:19-05:00,7960,Go3ne58krEsFsZ5yu9EBT7od15VCYmtbs1KhumRMTiXS,HCvwQ7HjmmeDXrguZQPrAbJjcCJzHqVZK2JMSFkFDWfe,True,1543560,385890,2401,1200,1201,3zqXX6kzhkbW3d4TwD2CNjMRwxTbREXySekvq37kfCNk,96062,1333033,-1236971,622
2022-01-22 05:47:20-05:00,7961,8VQ21PFXdHBNmiZiF18LyGvsRSpr13vkyktfembNCe3m,5exbVC7vaGFeHEGAx7epYfMaU932QafqzfhFm5FKAq2H,True,4072912,1018228,6289,3144,3145,3zqXX6kzhkbW3d4TwD2CNjMRwxTbREXySekvq37kfCNk,251586,3366053,-3114467,617
2022-01-22 05:48:08-05:00,7962,7CSCMFa9W52tBDVUbXbc3woAy3GByeA1wPJdp3MgznPa,3447ptuVFu6G8B6N63RmS8mRv4n9PfHneypHLvbeaGLn,True,2588620,647154,4044,2022,2022,HfEnetJ7uBSmZWCjBNxdvv9HEC5nsW4wDV7wu6WnhWan,161786,2154005,-1992219,624
2022-01-22 05:53:42-05:00,7963,2jDRvE3pQNjWy1NRFa4tzB3KmU5UkbUCHw8sQRFujo66,C4zNi2szDrEEh4coTF3WRUghfP4ZwAVVSYTLWfkejQRu,True,15838219,3959554,24783,12391,12392,HfEnetJ7uBSmZWCjBNxdvv9HEC5nsW4wDV7wu6WnhWan,991356,10802006,-9810650,625
2022-01-22 05:55:51-05:00,7964,8Xt3qHjZG3zLxozgM5vPHMVxp8eYFMg89kaVW7vdHKoA,2i8riSsQpfADD9LUVpiBJBfX5qjVAgmZegzfKx6RG9dW,True,183953371,45988342,287656,143828,143828,3zqXX6kzhkbW3d4TwD2CNjMRwxTbREXySekvq37kfCNk,11506252,71057770,-59551518,625
2022-01-22 05:55:53-05:00,7965,4ne6vC7qdxQYHJCsaeFAKZrKdFt2SwXGHQ3jrMHqt4DL,Cf1dLHY2WXH9rXbRKq5TT8THbdo9SdNUZq4rYhRCF9z,True,3206920,801730,4998,2499,2499,4BnQKPLuE3DMTtxp8MjUBytgnhvxqq3ZTqZHTVZo4JJh,199940,1638076,-1438136,623
2022-01-22 05:57:18-05:00,7966,EAtQUZAkQxwJF779DwPcWHZ455FzYX8mzm1uV5LBnhPB,8h8t6GW1Y7xMBfWpfyFfUVBP4apMbJVNg7igZUYZLsyr,True,19553463,4888365,30294,15147,15147,4BnQKPLuE3DMTtxp8MjUBytgnhvxqq3ZTqZHTVZo4JJh,1211764,6965192,-5753428,619
2022-01-22 05:57:44-05:00,7967,2niazdR63iWLyZ3ABWZVAnJiEjVyDyLGo4jZ6wh3j2Zz,4RvU5UtyE5CqMStPciiCTdhYCdaUUfdKSYS5nkATs1qn,True,17366375,4341593,26685,13342,13343,4BnQKPLuE3DMTtxp8MjUBytgnhvxqq3ZTqZHTVZo4JJh,1067415,6195427,-5128012,614
2022-01-22 05:57:44-05:00,7968,EXP61AETWHw3kHSjrJH1jQBt6cXR9Zebz34Cueb3KAzg,2JT9GrgdUKjuQQtXvZqevbjFquUQBMYDoADmBjDKWXj3,True,79199760,19799940,119873,59936,59937,4BnQKPLuE3DMTtxp8MjUBytgnhvxqq3ZTqZHTVZo4JJh,4794921,39468565,-34673644,605
2022-01-22 05:57:44-05:00,7969,GQviUdocJ1s4FsVDDexanvo5yQWRZgwwkGJBCg7TMtJC,HAX4VAKgQpKtm1149iRgtzvUaUkiXWcA1bJ9ERu6tXkd,True,17154173,4288543,26428,13214,13214,4BnQKPLuE3DMTtxp8MjUBytgnhvxqq3ZTqZHTVZo4JJh,1057124,6116088,-5058964,616
2022-01-22 05:57:45-05:00,7970,7tDiadLeMrob7yD6R5SDskYn41tnQZVPjEc6W2vv6irK,AHZidccE9ERBcipuRQ2iGM9kHRpTnty7UNuYTFurvXB7,True,81182215,20295553,125900,62950,62950,72FwbpFGoLEazJEdpqNtPNefsadUrimUqma9wSoy4qiS,5036012,30665868,-25629856,620
2022-01-22 05:57:53-05:00,7971,6k9unyyhVTrGhAhBrFjgumRfBtKFRBrVaeWtYB56LgEg,3n9VYUH53fxmwFwdYKT9xAZYDzjodhMsJ5iGAoJTqCt4,True,17367816,4341954,26733,13366,13367,3zqXX6kzhkbW3d4TwD2CNjMRwxTbREXySekvq37kfCNk,1069321,6195892,-5126571,615
2022-01-22 05:57:54-05:00,7972,GHn96Ev7UmKJWqch3H3wzXpRT7qLg5FBuSBJAATVED1f,BXBSUddfz9MThXqk4517M7YVRDGdTm4pC6G4ipT69TMV,True,13842860,3460715,21287,10643,10644,3zqXX6kzhkbW3d4TwD2CNjMRwxTbREXySekvq37kfCNk,851509,4914166,-4062657,615
2022-01-22 05:58:36-05:00,7973,BZxJ6CtrVoiU86DMMieMeDFLNWtMpHGTvZfM7nyay6o4,6CRxRR8bisRLHFJBFWjyumYuy7j4C4PkjYH1K8gXhdWD,False,310831,310831,15569,778,14791,4BnQKPLuE3DMTtxp8MjUBytgnhvxqq3ZTqZHTVZo4JJh,15569,159117,-143548,500
2022-01-22 05:58:38-05:00,7974,EDCJpkYBNcvKbqWmFwtnbeGYEiE6iACp4aQHgX5FXnNq,AubiccN4FqTZszcX3kJQQWc1JuDgDQG6XEN3TsTm55Zs,True,586336984,146584246,902091,451045,451046,3zqXX6kzhkbW3d4TwD2CNjMRwxTbREXySekvq37kfCNk,36083665,124676581,-88592916,615
2022-01-22 05:58:38-05:00,7975,DkKumyFA6dGw77wcwd16nWzTEC9McvmasAbmGfQXLkB7,9u6QyrruYFjhyLV5AXYUKkrBggzrxXfNH57smUAap5Ro,True,6812719,1703179,10641,5320,5321,3uL2NSR2ZdDqCiKfzA5SwwpddAnit22DBJo6uvvz1rRs,425669,3185785,-2760116,624
2022-01-22 05:58:41-05:00,7976,C33hfnDHzVwKXxr6AwFAXhd1vJYrPKhtqc75Qpjm19Zt,2WYBMSyrHQEYZqxEtxBMe2xn7eioJEGsudqdCmGvssGh,True,7445824,1861456,11601,5800,5801,3zqXX6kzhkbW3d4TwD2CNjMRwxTbREXySekvq37kfCNk,464069,2528062,-2063993,623
2022-01-22 06:02:55-05:00,7977,DiPSJvnnEwg1En7HJfEsKrUbBgtUf4KzGMyMCZDQSYgp,s8UVC6vPBofuXUS6RW1aQmZ8C35PrC5r4A6ugmvzLGB,True,25019,6254,38,19,19,HfEnetJ7uBSmZWCjBNxdvv9HEC5nsW4wDV7wu6WnhWan,1526,15978,-14452,609
2022-01-22 06:02:55-05:00,7978,69byqtDPmgEY1NqKBCR95CEPVHRUxgbNW9Y4P4HjQ7ND,E47T4q4zMGzNL6vDxgWdLn3EQbW3WfVryr8Jsymy1hAL,True,7433383,1858345,11212,5606,5606,4BnQKPLuE3DMTtxp8MjUBytgnhvxqq3ZTqZHTVZo4JJh,448489,5527996,-5079507,603
2022-01-22 06:02:56-05:00,7979,4pmhvxJcmebxtqN6RwVb9UbEtxpFXpuVN67Q74W6YAg3,B9fk51SEQmLbMDpQJV15f9gyCZhvEBWRXeLMnnmMqvfg,True,10482,2620,16,8,8,3zqXX6kzhkbW3d4TwD2CNjMRwxTbREXySekvq37kfCNk,640,8413,-7773,610
2022-01-22 06:02:59-05:00,7980,6b7Ro2myM4HcUDqyyW9NEqTWPz8BWpH4eNFSQQci37So,7r7j7rSsa6YZcTuRPfs3KP44MVqUA4Q5NeJGmx84wbHq,True,1895078,473769,2953,1476,1477,3zqXX6kzhkbW3d4TwD2CNjMRwxTbREXySekvq37kfCNk,118126,1626433,-1508307,623
2022-01-22 06:02:59-05:00,7981,H6fVnghBUSJRKp2mxSG7Fq2Lr4dE3YMS7yM1XTrxoe3Z,JjgtLi79grUZXofhWukB1yNXZkXFMUX5jm9HcXNDsB6,True,389689,97422,609,304,305,3zqXX6kzhkbW3d4TwD2CNjMRwxTbREXySekvq37kfCNk,24376,268155,-243779,625
2022-01-22 06:03:05-05:00,7982,CcfycMNGUqZLA6EEqtDdftSbQhTL11SYn3LxQqJ23Xgh,Ce7NW9CpB9qGYLf8XUDW49ERutoxtjZSjs54xrzF1fYN,True,7336713,1834178,11241,5620,5621,3zqXX6kzhkbW3d4TwD2CNjMRwxTbREXySekvq37kfCNk,449666,5793408,-5343742,612
2022-01-22 06:03:05-05:00,7983,D6qMab7uevXTa89ssv4BRyHwrw3FYpNimAmX2VH2uf4B,8ZauZ5dAp7kyawkPdxi4mqfempFHubJebfBenQdDektD,True,2464246,616061,3727,1863,1864,3zqXX6kzhkbW3d4TwD2CNjMRwxTbREXySekvq37kfCNk,149113,2122730,-1973617,605
2022-01-22 06:03:05-05:00,7984,GqFbV89UYbQ6aEW1bSvGnnsDtTPQfHPTHzisXPhLnaTC,6X7j3nqmugRyVVw83uSzgiPaemEscc8VdsnPEKDz4fg2,True,3619400,904850,5591,2795,2796,HfEnetJ7uBSmZWCjBNxdvv9HEC5nsW4wDV7wu6WnhWan,223650,2979783,-2756133,617
2022-01-22 06:03:05-05:00,7985,9cRx2sGeqENLrNkvzLSnuD161JshSav6pNg9c7pYLi8f,13ryjUoWLejTLDQKh1m69VFD31onMx8yhzCKhqbeU6s6,True,20750175,5187543,32065,16032,16033,HfEnetJ7uBSmZWCjBNxdvv9HEC5nsW4wDV7wu6WnhWan,1282605,16528794,-15246189,618
2022-01-22 06:03:05-05:00,7986,6kscNwPWgKoW7MHRkB4ajxWF3DXLmXjmx9KjDnzikhfs,D49nf79UmrALDKnAa5kf94nZUffzJW7anLm4hVrFG2b4,True,129247900,32311975,195896,97948,97948,3zqXX6kzhkbW3d4TwD2CNjMRwxTbREXySekvq37kfCNk,7835865,98565745,-90729880,606
2022-01-22 06:03:05-05:00,7987,CM95f7KjJuAf1xVTWhu3wrp6BfMz116FbgkxBhcRNs4k,EG55wkH5NcoasfBUYhD5D2dc2uvo11dZ3uTu5wgs4gf2,True,7871792,1967948,12258,6129,6129,HfEnetJ7uBSmZWCjBNxdvv9HEC5nsW4wDV7wu6WnhWan,490336,6208081,-5717745,622
2022-01-22 06:03:05-05:00,7988,2YPm4Ex9mNHX4CuNAUjkrXgoLFaZs6r1X6asYYUnvPyj,BatsG1UFq8ryYuFFcdnDyFWFPUV5P6w2VQpRup5oUey5,True,5354799,1338699,8253,4126,4127,3zqXX6kzhkbW3d4TwD2CNjMRwxTbREXySekvq37kfCNk,330132,4226852,-3896720,616
2022-01-22 06:03:05-05:00,7989,GM22yjVoBCzgBcVTT5EcgRhVWiXVV82kSj1dPCbegKWj,CDDy8JmJMwJyx1YAvEPpj8AYxCpngRovf3wWfVzao5Rc,True,2662295,665573,4054,2027,2027,3zqXX6kzhkbW3d4TwD2CNjMRwxTbREXySekvq37kfCNk,162175,1057082,-894907,609
2022-01-22 06:03:05-05:00,7990,9hB3EPuj4SrSrpAzHvExDb6mzh2vNGGVbj7qqfRjeao4,9725jRXGPRUuo1dijvv8mwzvSu1ed4y5hi9FAQNwb8dG,True,76539446,19134861,115810,57905,57905,3zqXX6kzhkbW3d4TwD2CNjMRwxTbREXySekvq37kfCNk,4632409,63079470,-58447061,605
2022-01-22 06:03:05-05:00,7991,3oCun4gm3k8sXxVxiYM8okGi8iCXH9LvDkHf9PBQWYXR,E1np1dZ7jUm811ddvy1jQerBwGSYb5BbZWnUHeotvrfH,True,13900595,3475148,21147,10573,10574,4BnQKPLuE3DMTtxp8MjUBytgnhvxqq3ZTqZHTVZo4JJh,845892,3980625,-3134733,608
2022-01-22 06:03:06-05:00,7992,ANXYsUNpZ34dBt7cp6HEE7oi2pTKsbj7B5TeFHKPbHBU,2pqeP4fuMREosHcfWUecEBssp1GM4isihNjn7ALUD51d,True,5478881,1369720,8260,4130,4130,72FwbpFGoLEazJEdpqNtPNefsadUrimUqma9wSoy4qiS,330429,4519518,-4189089,603
2022-01-22 06:03:11-05:00,7993,4eba4qAmwfqmihaYvTWFU9hm4VYrKvNhNywHNyimQJNK,G1DyxJcNQD8u4KGfnwxttyrJMfse1FBAsofioEMdTS9U,True,27963390,6990847,42454,21227,21227,3zqXX6kzhkbW3d4TwD2CNjMRwxTbREXySekvq37kfCNk,1698160,23229791,-21531631,607
2022-01-22 06:03:12-05:00,7994,Bbd196A866Y9rQWQFt4YGg2R6Jqj7WQGXWPDmrNtPcKf,5gmWk1KwLoRHnhkjxps4Ad6aVk4ZpcfC3McZCWDVCUbu,True,4318517,1079629,6734,3367,3367,3zqXX6kzhkbW3d4TwD2CNjMRwxTbREXySekvq37kfCNk,269391,3720014,-3450623,623
2022-01-22 06:04:27-05:00,7995,GKCeRcHQYMhcTwEm5wu1SbkXAT19gjGUGji43HS36B5N,EYQKX5sWsmXoge5xbTcMYAjvRbSUTXXpHEzckPY2LV8W,True,278885,69721,432,216,216,HfEnetJ7uBSmZWCjBNxdvv9HEC5nsW4wDV7wu6WnhWan,17285,113790,-96505,619
2022-01-22 06:04:32-05:00,7996,BJUNK2orMVx6mYsD9pnQzmsEh95ZF2NWPm9KJ1ZM67Qn,FpxLa3DwWrspYvHVsScSDcscHB2eBHGxRrQ4gVvn4VW,True,2321138557,580284639,3620116,1810058,1810058,3zqXX6kzhkbW3d4TwD2CNjMRwxTbREXySekvq37kfCNk,144804651,569309102,-424504451,623
2022-01-22 06:04:32-05:00,7997,HmspGdpobjC5Vbmo3FcKdw4RLPN7wJKxv3uKqDjVhLee,3YEX8TzdyJyuHo76Kw76imVCJjzrC9m188YuRKvwwSwD,True,48404538,12101134,74417,37208,37209,3zqXX6kzhkbW3d4TwD2CNjMRwxTbREXySekvq37kfCNk,2976692,17126161,-14149469,614
2022-01-22 06:10:25-05:00,7998,98pwBGgiSDuwuas6WYW2hc9qUxfULwvNE34aixaxbxXY,BLrjKxekjThtJ9rKtQxs1Y4rZ225EE2Q16VkP9TkThyV,True,13528576,3382144,21003,10501,10502,HfEnetJ7uBSmZWCjBNxdvv9HEC5nsW4wDV7wu6WnhWan,840128,4902127,-4061999,621
2022-01-22 06:10:27-05:00,7999,5hJereyPSCNUrGW7TdYXHKjhXMWTbGZzc2GF9MWksLJE,AUE3NpqaeamHGBKUVuKnUhnBb4Lzt7xWU1FHMu1Hq5dC,True,54941677,13735419,85415,42707,42708,3zqXX6kzhkbW3d4TwD2CNjMRwxTbREXySekvq37kfCNk,3416629,28418329,-25001700,621
2022-01-22 06:10:27-05:00,8000,3Xbsek5MsEGoWr3G9yhuohREr26B2vSQcjqXdspTFHta,2rPxkUiMo9wGDq8EvAiwY3ngRpKmL223cBWWNTYoBmFp,True,6470561,1617640,10076,5038,5038,3zqXX6kzhkbW3d4TwD2CNjMRwxTbREXySekvq37kfCNk,403055,3229843,-2826788,622
2022-01-22 06:11:44-05:00,8001,28JujYG1mbpYSjF7LNqXpup17TXb45VJHhhnFMVXtft2,DAqyVExAtmsovPGrkpkFDxm6T7pKWLztfh9iPjTNDqrd,True,21255199,5313799,30811,15405,15406,3zqXX6kzhkbW3d4TwD2CNjMRwxTbREXySekvq37kfCNk,1232449,7810250,-6577801,579
2022-01-22 06:17:18-05:00,8002,9yDHiv4vGbQWYby3dAMCdVnwiYgXBV1jV6WCzKYUPiUs,FPyemR1VdBnhxW2V7j7EkQyhzW894bCb3f6wRUMSn6jB,True,259427967,64856991,396860,198430,198430,HfEnetJ7uBSmZWCjBNxdvv9HEC5nsW4wDV7wu6WnhWan,15874415,79081810,-63207395,611
2022-01-22 06:17:19-05:00,8003,2MbNCikBC3fdwqJKfMK1FjPg7wT3xWMXmN88XuikJ8r9,5eG6U5x63YYMpE7iwwu1TPcZapvQMyKczvtnFfST1BH3,True,8540,2135,13,6,7,3uL2NSR2ZdDqCiKfzA5SwwpddAnit22DBJo6uvvz1rRs,524,4723,-4199,613
2022-01-22 06:17:22-05:00,8004,DYqdjjx7PHxaHWTv6QC98aYZPDopJsTwfzaydLHGPn2,3EjvG9CUHmfRFhkq7kec31dKjjqiqEDxZAjgLeDNDQWu,True,13507800,3376950,21052,10526,10526,HfEnetJ7uBSmZWCjBNxdvv9HEC5nsW4wDV7wu6WnhWan,842105,4911563,-4069458,623
2022-01-22 06:25:28-05:00,8005,EDSf2w1UyGvbgMuxyoXL58ifR1dviZinnLBYnFmgjcNG,DFenkzbL9SUjs9cSCaHJ1eXK75mHfk3GSPRFs8TSzrFV,True,145737512,36434378,227353,113676,113677,3zqXX6kzhkbW3d4TwD2CNjMRwxTbREXySekvq37kfCNk,9094141,62442390,-53348249,624
2022-01-22 06:31:10-05:00,8006,6uZobpBuFcQeYgZ4dApFi6iy4DB9GLHP1AAsQcCj6212,SGGFiPjjhscwroiWMqY4jTAHFw8eakpsEv35wNoHUPY,True,17554124,4388530,27459,13729,13730,4BnQKPLuE3DMTtxp8MjUBytgnhvxqq3ZTqZHTVZo4JJh,1098365,5837907,-4739542,625
2022-01-22 06:41:34-05:00,8007,EXP61AETWHw3kHSjrJH1jQBt6cXR9Zebz34Cueb3KAzg,2JT9GrgdUKjuQQtXvZqevbjFquUQBMYDoADmBjDKWXj3,True,58401379,14600344,90657,45328,45329,3zqXX6kzhkbW3d4TwD2CNjMRwxTbREXySekvq37kfCNk,3626307,30630123,-27003816,620
2022-01-22 06:41:36-05:00,8008,4ne6vC7qdxQYHJCsaeFAKZrKdFt2SwXGHQ3jrMHqt4DL,Cf1dLHY2WXH9rXbRKq5TT8THbdo9SdNUZq4rYhRCF9z,True,2355489,588872,3580,1790,1790,HfEnetJ7uBSmZWCjBNxdvv9HEC5nsW4wDV7wu6WnhWan,143213,1271517,-1128304,607
2022-01-22 06:41:38-05:00,8009,EAtQUZAkQxwJF779DwPcWHZ455FzYX8mzm1uV5LBnhPB,8h8t6GW1Y7xMBfWpfyFfUVBP4apMbJVNg7igZUYZLsyr,True,14384619,3596154,22215,11107,11108,3zqXX6kzhkbW3d4TwD2CNjMRwxTbREXySekvq37kfCNk,888602,5484161,-4595559,617
2022-01-22 06:43:16-05:00,8010,CK1SjmBjrW7m1QVZbVZsVZgwEcxw8BTkckkzrZDrDdxW,M6vnBg1TPRhLu7sghkxtf5TkSLw5JhgoDmbGoyEYgR9,True,8642715,2160678,13475,6737,6738,HfEnetJ7uBSmZWCjBNxdvv9HEC5nsW4wDV7wu6WnhWan,539022,6814579,-6275557,623
2022-01-22 06:43:33-05:00,8011,76gdRvg74fv6A9vA8ukNPqWKkmKY6KLAAKBGvbNE2AXC,5n88nkWZiCtWyWPrgfJozgkxtU9HMSggrxHkLoTQp1QR,True,14084,3521,22,11,11,3zqXX6kzhkbW3d4TwD2CNjMRwxTbREXySekvq37kfCNk,881,11439,-10558,625
2022-01-22 06:43:54-05:00,8012,3gdApRPkUGEqmLvTYf4WQJCnmTVmiEU2wCQG26QMpqKf,HpP2yxq3KfYByT4q4p2mLaELnPdW6kmEY9EqZaBZuUNR,True,5148625,1287156,8017,4008,4009,HfEnetJ7uBSmZWCjBNxdvv9HEC5nsW4wDV7wu6WnhWan,320712,4059808,-3739096,622
2022-01-22 06:43:57-05:00,8013,3MEiFqy4F9nBW8gHxvGjv7norSBHwxhbzzNKngPk1RHq,2tcsJ4NUJegcEfHNwWPh979yKjKmq568CpNm5iWGbuoR,True,1501405,375350,2345,1172,1173,3zqXX6kzhkbW3d4TwD2CNjMRwxTbREXySekvq37kfCNk,93805,920039,-826234,624
2022-01-22 06:49:10-05:00,8014,6k9unyyhVTrGhAhBrFjgumRfBtKFRBrVaeWtYB56LgEg,3n9VYUH53fxmwFwdYKT9xAZYDzjodhMsJ5iGAoJTqCt4,True,12794382,3198595,20001,10000,10001,3zqXX6kzhkbW3d4TwD2CNjMRwxTbREXySekvq37kfCNk,800078,4876493,-4076415,625
2022-01-22 06:49:14-05:00,8015,2niazdR63iWLyZ3ABWZVAnJiEjVyDyLGo4jZ6wh3j2Zz,4RvU5UtyE5CqMStPciiCTdhYCdaUUfdKSYS5nkATs1qn,True,12793210,3198302,19953,9976,9977,3zqXX6kzhkbW3d4TwD2CNjMRwxTbREXySekvq37kfCNk,798129,4875717,-4077588,623
2022-01-22 06:49:15-05:00,8016,GHn96Ev7UmKJWqch3H3wzXpRT7qLg5FBuSBJAATVED1f,BXBSUddfz9MThXqk4517M7YVRDGdTm4pC6G4ipT69TMV,True,10197640,2549410,15923,7961,7962,3zqXX6kzhkbW3d4TwD2CNjMRwxTbREXySekvq37kfCNk,636926,3868428,-3231502,624
2022-01-22 06:52:26-05:00,8017,GQviUdocJ1s4FsVDDexanvo5yQWRZgwwkGJBCg7TMtJC,HAX4VAKgQpKtm1149iRgtzvUaUkiXWcA1bJ9ERu6tXkd,True,12603006,3150751,18929,9464,9465,3zqXX6kzhkbW3d4TwD2CNjMRwxTbREXySekvq37kfCNk,757178,4814032,-4056854,600
2022-01-22 06:52:26-05:00,8018,98pwBGgiSDuwuas6WYW2hc9qUxfULwvNE34aixaxbxXY,BLrjKxekjThtJ9rKtQxs1Y4rZ225EE2Q16VkP9TkThyV,True,9950135,2487533,15570,7785,7785,3zqXX6kzhkbW3d4TwD2CNjMRwxTbREXySekvq37kfCNk,622828,3865629,-3242801,625
2022-01-22 06:52:27-05:00,8019,7tDiadLeMrob7yD6R5SDskYn41tnQZVPjEc6W2vv6irK,AHZidccE9ERBcipuRQ2iGM9kHRpTnty7UNuYTFurvXB7,True,59643939,14910984,90395,45197,45198,HfEnetJ7uBSmZWCjBNxdvv9HEC5nsW4wDV7wu6WnhWan,3615829,24081081,-20465252,606
2022-01-22 06:55:03-05:00,8020,Frobc1KZTVcsyfwyKwSpHJobxmiJBomzHhGCLdrzdAz8,HziyKP9uxWCuXddtbRzWMczHNdgyQB5UXQZj4MnMm14,True,8487386,2121846,13250,6625,6625,3zqXX6kzhkbW3d4TwD2CNjMRwxTbREXySekvq37kfCNk,530007,4133162,-3603155,624
2022-01-22 06:58:21-05:00,8021,CxePQ6ZEn2NCLYgGegSeFX1PyBuczP9j5v131VQSPh1c,9gPk7qTRb5JHqBXRKp3uZfhA2VjQAJDQHTzYXGLUdAUC,True,7973098,1993274,12448,6224,6224,4BnQKPLuE3DMTtxp8MjUBytgnhvxqq3ZTqZHTVZo4JJh,497938,6284626,-5786688,624
2022-01-22 07:00:08-05:00,8022,Gs3WP18hbzNpbBgiU39e6tfkggfCKRyNqPqJQcthuHFD,4XAY25YUma6gUdG2GdbXeivum3t21g93ZagfWGTZYkWZ,True,600599,150149,939,469,470,3zqXX6kzhkbW3d4TwD2CNjMRwxTbREXySekvq37kfCNk,37590,451050,-413460,625
2022-01-22 07:00:36-05:00,8023,BZn1DDE568UHeL2Qniv9EDT1yAAWvPJcTtSw4K4GQx44,CCaroU4YwKvYgibMsRPdEBxeDbzcNC4s5ZthxrhywSm5,True,8909693,2227423,13931,6965,6966,HfEnetJ7uBSmZWCjBNxdvv9HEC5nsW4wDV7wu6WnhWan,557258,6992189,-6434931,625
2022-01-22 07:00:37-05:00,8024,51VhgthsxrRRr2PT5gLnDfL1A3soqwCxA1UzH9vRUGTh,4QCcd7hfsydQ63LH7Lqsp8oVXw7HuKamzQf8VMH6Lgu2,True,6859712,1714928,10519,5259,5260,HfEnetJ7uBSmZWCjBNxdvv9HEC5nsW4wDV7wu6WnhWan,420779,5391488,-4970709,613
2022-01-22 07:01:39-05:00,8025,4WSiQCTqMvpSYvrbenQGFoV6fuDALSWMwZZ9MgP82fwb,6Y5GdgKErVfXrabSTi89X7xCEsZnoqDqwFD4hZ3FVtfN,True,13525618,3381404,20786,10393,10393,4BnQKPLuE3DMTtxp8MjUBytgnhvxqq3ZTqZHTVZo4JJh,831472,8623916,-7792444,614
2022-01-22 07:01:39-05:00,8026,C21232Uu2r4AmbR3mzrEKF5ZHoFDZbCmy88x8u6cLyZV,8sppny1HRFKX6LuqT6KDn1x9wS7z61K9V5akSuAimxgS,True,1172749910,293187477,1794260,897130,897130,4BnQKPLuE3DMTtxp8MjUBytgnhvxqq3ZTqZHTVZo4JJh,71770411,305241587,-233471176,611
2022-01-22 07:01:41-05:00,8027,DXEJNyHSCbGZezXHy2xQaSzd37dwJs4dMTgt5VF5UZAG,7fCYM9DWrAX7vgZ11CwQMNd5NU8FB1yrbctxHaPYshpB,True,5302326,1325581,8257,4128,4129,3zqXX6kzhkbW3d4TwD2CNjMRwxTbREXySekvq37kfCNk,330288,2146396,-1816108,622
2022-01-22 07:06:54-05:00,8028,3JrhHRs4UkkuMoCrQAaAGKZQrWoU72zWArnDGxKFESzH,8yREVE3kMYB7UAwtUDnTDK3egXTuTsN4igtJ5yeHYkCP,True,45926098,11481524,71603,35801,35802,4BnQKPLuE3DMTtxp8MjUBytgnhvxqq3ZTqZHTVZo4JJh,2864158,20388232,-17524074,623
2022-01-22 07:07:26-05:00,8029,HdRgh9niYSd3YKCxzGdusYFquiVoFTP2mEGEzJJL5Nii,78C68Gbb1jYFQmYNCHHjL52keEKMXtGukmBwT7ahon4B,True,366833477,91708369,574049,287024,287025,HfEnetJ7uBSmZWCjBNxdvv9HEC5nsW4wDV7wu6WnhWan,22961964,261672556,-238710592,625
2022-01-22 07:07:58-05:00,8030,DDsY5V3F9wnEGBoQFCEf1hvEYuKUaJdysbc7TxhNqe9G,5oBCGzvy8odB8MCxCUvPDqYCnTyteZ4Yy1JDroroygbi,True,8462712,2115678,13160,6580,6580,3zqXX6kzhkbW3d4TwD2CNjMRwxTbREXySekvq37kfCNk,526428,3318089,-2791661,622
2022-01-22 07:07:58-05:00,8031,4vW2Q76fdGmfhU2Tx3R2XQkGcQUi6hSM9ixvK5RWvurJ,w8cGbqVpVr6WHSRJFXv469RMgRB3ty3TGpkVXRs7K7H,True,11193480,2798370,17412,8706,8706,3zqXX6kzhkbW3d4TwD2CNjMRwxTbREXySekvq37kfCNk,696516,4033166,-3336650,622
2022-01-22 07:08:06-05:00,8032,J6jBKPDR6R5cLMqLufw3zoVfheNYs1KF7C4Ft2dakXeA,6wTTLK675Ym6toJRp7tYaUZzisWfgGjSp3X3yJ31xiKt,True,8408617,2102154,13130,6565,6565,4BnQKPLuE3DMTtxp8MjUBytgnhvxqq3ZTqZHTVZo4JJh,525223,3908127,-3382904,624
2022-01-22 07:09:14-05:00,8033,5hJereyPSCNUrGW7TdYXHKjhXMWTbGZzc2GF9MWksLJE,AUE3NpqaeamHGBKUVuKnUhnBb4Lzt7xWU1FHMu1Hq5dC,True,40354827,10088706,60589,30294,30295,HfEnetJ7uBSmZWCjBNxdvv9HEC5nsW4wDV7wu6WnhWan,2423569,22026345,-19602776,600
2022-01-22 07:09:14-05:00,8034,28JujYG1mbpYSjF7LNqXpup17TXb45VJHhhnFMVXtft2,DAqyVExAtmsovPGrkpkFDxm6T7pKWLztfh9iPjTNDqrd,True,15717151,3929287,23887,11943,11944,HfEnetJ7uBSmZWCjBNxdvv9HEC5nsW4wDV7wu6WnhWan,955495,6113105,-5157610,607
2022-01-22 07:09:20-05:00,8035,3Xbsek5MsEGoWr3G9yhuohREr26B2vSQcjqXdspTFHta,2rPxkUiMo9wGDq8EvAiwY3ngRpKmL223cBWWNTYoBmFp,True,4752636,1188159,7151,3575,3576,3zqXX6kzhkbW3d4TwD2CNjMRwxTbREXySekvq37kfCNk,286074,2506452,-2220378,601
2022-01-22 07:09:38-05:00,8036,A1VornXbzK5rFgsy9D4qThcPnYVP8AB9RRzWsV1h6L17,9M4dQgz1zWrtKHqZMt9w7PbM9CvmyjhY5ZZ6jjajMzqm,True,5628263,1407065,8758,4379,4379,3zqXX6kzhkbW3d4TwD2CNjMRwxTbREXySekvq37kfCNk,350334,2203200,-1852866,622
2022-01-22 07:09:38-05:00,8037,B9WJfmrYEkVH3L1UWz4qqWpaexHydymbzvEfwNVtB9BV,6mQb4yzGq8jE1NbweKCKSbevnnYVhHYxyc6Gz2a5kJLn,True,38529275,9632318,59824,29912,29912,4BnQKPLuE3DMTtxp8MjUBytgnhvxqq3ZTqZHTVZo4JJh,2392968,14207497,-11814529,621
2022-01-22 07:13:58-05:00,8038,2JXP6KUwPSmCrXT2uQRqSoCwH8RLYWwmqYsj3zXtv9xF,4qcFVgugXsHVQzFRP2he9CVzvv47xqgokJjigee8oPpP,True,285230252,71307563,445216,222608,222608,3zqXX6kzhkbW3d4TwD2CNjMRwxTbREXySekvq37kfCNk,17808677,98999572,-81190895,624
2022-01-22 07:14:44-05:00,8039,Dng7By2saPu5TVxcvXidBe71ggBo8tiHkAXPi4kKL1tk,75ufEJmHbLHffphL7tvAXhGyftKLr1z2PXXoB2GGY5fG,True,32146276,8036568,50266,25133,25133,72FwbpFGoLEazJEdpqNtPNefsadUrimUqma9wSoy4qiS,2010677,11005912,-8995235,625
2022-01-22 07:16:21-05:00,8040,8trFFwvXKKMwMx952ugCZmqyw29e1HxEKBuQmFn8ZwTf,FsD7gCvHXM3QchQiDcd292ksy5afZMWApneNTat5ndeS,True,34309439,8577359,53651,26825,26826,3uL2NSR2ZdDqCiKfzA5SwwpddAnit22DBJo6uvvz1rRs,2146040,12654242,-10508202,625
2022-01-22 07:49:32-05:00,8041,GNkEoVMpNAgfyDBZ986MR9BEVc485xpLuZWwSCyZk5zJ,AT2eiaMyZNHZGqgTdie8QjLWCTrWSdkRmQxU2vZNgtDs,True,6753955,1688488,10524,5262,5262,3zqXX6kzhkbW3d4TwD2CNjMRwxTbREXySekvq37kfCNk,420965,2337358,-1916393,623
2022-01-22 07:49:32-05:00,8042,2mfcg17QocKKvDcqDH88TwxHRiS8dAQiJAGoAh1brns9,8aQLELBgaA9eXsxSciMjxWv8B1hpbUPfLwqVjEnasZbe,True,18778298,4694574,29257,14628,14629,3zqXX6kzhkbW3d4TwD2CNjMRwxTbREXySekvq37kfCNk,1170315,7731127,-6560812,623
2022-01-22 08:01:22-05:00,8043,9Ft21UZ66egkMCtZprBPc72WF1aj2fQwLs6XJWPXUbUV,6DGSgHegc23W5MQ6hqSsSSdwNvRqU3piR9GBoZ6fU23f,True,92140442,23035110,144093,72046,72047,3zqXX6kzhkbW3d4TwD2CNjMRwxTbREXySekvq37kfCNk,5763721,38924138,-33160417,625
2022-01-22 08:01:37-05:00,8044,2aK454FrEuA6JQZo2hLUabd4E6wyQtVuJWw2rWz2pGVy,3dJvhEh7kykf8hCCWQRarh2s5ybJUAzbaPdDUmX4XokW,True,138297140,34574285,216146,108073,108073,4BnQKPLuE3DMTtxp8MjUBytgnhvxqq3ZTqZHTVZo4JJh,8645863,36429632,-27783769,625
2022-01-22 08:01:40-05:00,8045,FS5xx53Bo65G21gJLta7LEEiS132VJM1kGpUzuqyfzoy,2kbTLjdBBA9K1coxKmwmYbjq2heSnuNg4Nh2EfVNYgwj,True,13573651,3393412,21000,10500,10500,3zqXX6kzhkbW3d4TwD2CNjMRwxTbREXySekvq37kfCNk,840008,6009846,-5169838,618
2022-01-22 08:03:22-05:00,8046,52hhBAuVyifMNFKGQmSitc8smiEgscXQMzVuZj55j7E5,6B5DBJx9NLytR3fkrYqe5W5ek4rUWsR4nPsRTvRfRwzC,True,147376879,36844219,229322,114661,114661,3zqXX6kzhkbW3d4TwD2CNjMRwxTbREXySekvq37kfCNk,9172888,120576616,-111403728,622
2022-01-22 08:03:22-05:00,8047,Fs8MQLaMyr1Q96HsZivKLY7Kjdeu2ZoB2n3VTZ15KbSn,DREfCs5CTVNUUF8H3hD8CWvtxztiYxoLYh8HUWDecMyZ,True,138366481,34591620,215423,107711,107712,4BnQKPLuE3DMTtxp8MjUBytgnhvxqq3ZTqZHTVZo4JJh,8616928,113254870,-104637942,622
2022-01-22 08:03:27-05:00,8048,57Vsw8jXaaoLriYEkvPAVyq66r4a4zMfLWbDaTBMjFzC,7AVDWUTHa6729UkXgCXASphSmrLvXYGAA9ygTMSqvwvY,True,4373972,1093493,6791,3395,3396,3zqXX6kzhkbW3d4TwD2CNjMRwxTbREXySekvq37kfCNk,271640,3589865,-3318225,621
2022-01-22 08:03:35-05:00,8049,3EgUBHBeKWegibDcCsTGaGehnwHYvpMbcPaT1UTbwQ49,Hxd4dsnLD8uHnG7KR7GVmKXBcpN1egMUvoTccPvBcaYA,True,146178600,36544650,223579,111789,111790,3zqXX6kzhkbW3d4TwD2CNjMRwxTbREXySekvq37kfCNk,8943199,119758721,-110815522,611
2022-01-22 08:03:37-05:00,8050,JDg1bbHkYeznDUtSBLhagRJ45aSzeSF5V8iDRJCay9wL,8n7ic28zq5PjJtRcM7Fcy5vLW2YVXw4EWMK6UAt2zh3V,True,99537914,24884478,153039,76519,76520,3zqXX6kzhkbW3d4TwD2CNjMRwxTbREXySekvq37kfCNk,6121593,78566307,-72444714,615
2022-01-22 08:03:37-05:00,8051,3EmGvYu72cR4Ta3wLA5HKZBEqgfChCyiRanwj5hGLJXc,6NEWPFaKi5uLsrj4n6RM1DBhQTcGFE9TwYeJ12pC7yyp,False,682,682,34,1,33,3zqXX6kzhkbW3d4TwD2CNjMRwxTbREXySekvq37kfCNk,34,549,-515,498
2022-01-22 08:03:40-05:00,8052,7EtGovzHsbD8cKGqq4R5rvKBbncR4Kc7CDkTjof2QBMf,8ShjeNWM2vcvUF9yYztYCHUQfcGsyg2A1LyWiPbQDDvq,True,852956,213239,1326,663,663,3zqXX6kzhkbW3d4TwD2CNjMRwxTbREXySekvq37kfCNk,53044,699939,-646895,621
2022-01-22 08:04:34-05:00,8053,FwTGq3BeMLyRFRa5r4E6nySLgoLNcNdqJsCQxA2i6uh6,88w6ti3WSriyu2FvNjVfrLpGyU5PUvaiJyqrAGPM8TKp,True,4236784,1059196,6614,3307,3307,3zqXX6kzhkbW3d4TwD2CNjMRwxTbREXySekvq37kfCNk,264573,3476494,-3211921,624
2022-01-22 08:04:35-05:00,8054,3PPCwAjj8GNphb3cRs7kP1QVghEUX6gWUH3M4JarQsTD,28UR4WKAziiJmPwas5E5JrY3WaUrR2NkYYXCKuxPHTMR,True,1179652337,294913084,1837279,918639,918640,HfEnetJ7uBSmZWCjBNxdvv9HEC5nsW4wDV7wu6WnhWan,73491199,893636862,-820145663,622
2022-01-22 08:05:01-05:00,8055,GqPZDwm3EWGMiVy7BY6qHM4Vzt2B9vW3Zs1CLScrtjAD,63h2HEdkmc54a8txd4LZ69TUBLR6VphxBoXLx6hjCLg4,True,1010283899,252570974,1580063,790031,790032,3zqXX6kzhkbW3d4TwD2CNjMRwxTbREXySekvq37kfCNk,63202531,253798226,-190595695,625
2022-01-22 08:06:08-05:00,8056,F6wpqqx576XRuYo8y6XPLYphojrQtK4VvdY79Jk6My5N,38VbNLaQzLFcVqHuSR9zn9UX3Yv9SCVy1mrwmxX9PpVQ,True,81572484,20393121,127151,63575,63576,3zqXX6kzhkbW3d4TwD2CNjMRwxTbREXySekvq37kfCNk,5086041,18831238,-13745197,623
2022-01-22 08:46:13-05:00,8057,3sGCWcgPY7TzRCkFR1uuY8KcUzVRbdTyFYxh7V1csNMX,CcRFNnG2uhyLwhNAbX4U49jkMeC11kJtVhhyqDWdDK5r,True,95145751,23786437,147576,73788,73788,3zqXX6kzhkbW3d4TwD2CNjMRwxTbREXySekvq37kfCNk,5903053,78740552,-72837499,620
2022-01-22 08:46:13-05:00,8058,A4Q7Vrc9M3GtEXNUSiVBFkansyf5sKBtSeVT92WFacqv,EWLNfsTKqzkd7KAhnrPRre4Dyk6exb3H9wSbrJuyWprg,True,85156539,21289134,132131,66065,66066,3zqXX6kzhkbW3d4TwD2CNjMRwxTbREXySekvq37kfCNk,5285246,70413702,-65128456,620
2022-01-22 08:46:18-05:00,8059,EBpxGcrs4eWAbBU5rEjFxbr24MjUstZQRMV9jK4q8kMp,EYVd6pztEuz8PC7rUnJ1AjVZ81WWpynyn2qEKtveqrHG,True,5840675,1460168,9139,4569,4570,HfEnetJ7uBSmZWCjBNxdvv9HEC5nsW4wDV7wu6WnhWan,365585,4788654,-4423069,625
2022-01-22 08:46:27-05:00,8060,4oop1mjCh1Ao9NoWAUacAGc75GxiRTXr8KJ3NtzZ7btf,BfntjUunXBhnrKmocQ7pZr3wwxruRGudMyWQYC2MUhei,True,13770051,3442512,21361,10680,10681,3zqXX6kzhkbW3d4TwD2CNjMRwxTbREXySekvq37kfCNk,854463,11081995,-10227532,620
2022-01-22 08:46:32-05:00,8061,FdYFnEYtFQKcZPmzUqnvNLzozxdR1emtkmvnYcMgYykS,7arWNJQf2cWxerjhLgQh9CJxwTat1efnr5KmhuD7Qnv4,True,2599335,649833,4050,2025,2025,HfEnetJ7uBSmZWCjBNxdvv9HEC5nsW4wDV7wu6WnhWan,162004,2207736,-2045732,623
2022-01-22 08:46:32-05:00,8062,As81koHnSP9quoXuUVNHp3VR3Qaks8HLa4sFgJDocYiF,AMVm8dXia5s974VgZSbeE6uPDgyXDHZFyJ2W1J1CWvKW,True,93552384,23388096,146193,73096,73097,HfEnetJ7uBSmZWCjBNxdvv9HEC5nsW4wDV7wu6WnhWan,5847733,77278895,-71431162,625
2022-01-22 08:46:33-05:00,8063,CJpe9bNHxS63QMaGJhmnr4u7eTo6e5GApZQZyPtXLAkk,EMVL4sDfVXwGEoGEYwLp8D6itfy3eu4FZBAj1kMz6uXa,True,89252743,22313185,139325,69662,69663,3zqXX6kzhkbW3d4TwD2CNjMRwxTbREXySekvq37kfCNk,5573006,73804548,-68231542,624
2022-01-22 08:46:35-05:00,8064,2ZSfbqxhiCTDrDPeRhoWayTZHNmW7ajVXBCxpFS4eGBF,3ZmWsPdQD7qfSMGKQSNhmBtuH7S6qMFRc8oEmBcHXEiR,True,3338516,834629,5192,2596,2596,HfEnetJ7uBSmZWCjBNxdvv9HEC5nsW4wDV7wu6WnhWan,207686,2835514,-2627828,622
2022-01-22 08:46:40-05:00,8065,ymyzGH4Qc7HH5PbKpVphCbsQgLLXyGkPcXamQJuNj5C,8oTLHaV2XzbKXNWRuUjCfHjUn61Pw93LYK14m9q2VDpZ,True,176621,44155,271,135,136,3zqXX6kzhkbW3d4TwD2CNjMRwxTbREXySekvq37kfCNk,10852,137449,-126597,614
2022-01-22 08:46:40-05:00,8066,AvpYg74EBhwAXE8rcdGkpwmbBMRyVidF6zMRSFtWAVC6,4WgpqTp4r9wMpMptYMNbvCaP2faBnVr6FdShCAobetpL,True,3309053,827263,5106,2553,2553,3zqXX6kzhkbW3d4TwD2CNjMRwxTbREXySekvq37kfCNk,204248,2813954,-2609706,617
2022-01-22 08:46:40-05:00,8067,5y8ZSWUnrm4B3emh7vLQKTh89vHtCvXqUhk7fJBA52is,Bu1AoKU2QQWpGH54ZzugvvACB3E1d3VvymnegNmTgHqg,True,93449596,23362399,143749,71874,71875,3zqXX6kzhkbW3d4TwD2CNjMRwxTbREXySekvq37kfCNk,5749983,77283933,-71533950,615
2022-01-22 08:46:40-05:00,8068,BrHRMouGRz3LBNzd9anfdYMhWfg8yUPHL4PqJ8WdEDFS,4uzoLa3mC2VYHAPBoHLX4gTjPTC28rPf2fvEGtJWPYc,True,781428,195357,1202,601,601,3zqXX6kzhkbW3d4TwD2CNjMRwxTbREXySekvq37kfCNk,48093,1038578,-990485,615
2022-01-22 08:46:40-05:00,8069,FYdUiU3rPpbYKWnEpekQQsocSJKjXmscohi4v6DYqix7,daPyq9YdunQJhhLoW5ifhJ7UFPTtRZhGs4JwE1nqZhN,True,3356872,839218,5171,2585,2586,3zqXX6kzhkbW3d4TwD2CNjMRwxTbREXySekvq37kfCNk,206843,2854584,-2647741,616
2022-01-22 08:46:40-05:00,8070,BLJgLzizx2yLgd12pVBAHTMqn9J5JA3JHCF8PnLnPyUk,HhDmwMysBFWhXnd3mrV31w75WBRKBS8wJSiEMZgqdUSp,True,13125399,3281349,20273,10136,10137,3zqXX6kzhkbW3d4TwD2CNjMRwxTbREXySekvq37kfCNk,810932,11441410,-10630478,617
2022-01-22 08:46:41-05:00,8071,9Hz4p7gcfDbXBJp8KzhaBBPh9i7xe9kun7zLfDtqPe6c,2bJ43Lep6kp6WY7Ct56oiscKnAbdtC265G5yRvRPFThU,True,12197565,3049391,18740,9370,9370,3zqXX6kzhkbW3d4TwD2CNjMRwxTbREXySekvq37kfCNk,749603,6468268,-5718665,614
2022-01-22 08:46:44-05:00,8072,BJV5jbowrbELXfDvfMovaQy4PiRf12pLYHimW9bgzW5X,6WXrWso5FvLx7RMCFBzrbzh5qevKkk2LJAihUfWXxXzB,True,277988,69497,433,216,217,3zqXX6kzhkbW3d4TwD2CNjMRwxTbREXySekvq37kfCNk,17350,371833,-354483,624
2022-01-22 08:46:44-05:00,8073,FF8rqfM9PTEjYiVFy8jS81weDRwdaYooux2uSa2LexrJ,JBk1JghH1gged1YpDbkczFXP9ka5ivYSkaYoVbbXD4kg,True,2409184,602296,3752,1876,1876,3zqXX6kzhkbW3d4TwD2CNjMRwxTbREXySekvq37kfCNk,150095,2194979,-2044884,623
2022-01-22 08:46:45-05:00,8074,9BMHbUs4d3qX49fnroHv2FTPDs4yoDFrvDMqf8p9U4pE,2yL7zwMr7qVG5Sdwkf7z6ppnNqt1ASppBbmxwYjfFY6Z,True,51868248,12967062,80876,40438,40438,3zqXX6kzhkbW3d4TwD2CNjMRwxTbREXySekvq37kfCNk,3235062,44088551,-40853489,623
2022-01-22 08:46:45-05:00,8075,FV9CBGGTbppLnBKh79f2LzD1diTiS5g6u89FcpZHZmnK,Fe7mtmCUziFqbbYTvrhAcAq1Ub7YLfTJRtQ1hG7GzJD1,True,69878,17469,108,54,54,3zqXX6kzhkbW3d4TwD2CNjMRwxTbREXySekvq37kfCNk,4332,54902,-50570,619
2022-01-22 08:46:46-05:00,8076,BYvjENe16Ta77PqGV7JKEWrsqCTfkMGYwTSG5gXneDvd,EvxAXgvhPC6QkNurbK7vWyTApGo8J2R4EgMAknkHVU3d,True,39679,9919,61,30,31,4BnQKPLuE3DMTtxp8MjUBytgnhvxqq3ZTqZHTVZo4JJh,2459,43049,-40590,619
2022-01-22 08:46:46-05:00,8077,4SX2pj4eHRwFMtyDCrMZ8ZT6ASAMi7yfZWZnccw5dGn8,Ads49ZqvTmPHxfzNYm4oJb4HBYhwS6vXQbarqmpUi5VZ,True,2717801,679450,4195,2097,2098,HfEnetJ7uBSmZWCjBNxdvv9HEC5nsW4wDV7wu6WnhWan,167837,2311513,-2143676,617
2022-01-22 08:46:46-05:00,8078,9kYkFDNE3qD6s73fn8kJowgqbDZoDSw22XaUJ7rTD43D,E8zJz8pT2c9aZsxe4kLMNs4bY7skt38SU5wK5JTqbGr6,True,51182092,12795523,79106,39553,39553,3zqXX6kzhkbW3d4TwD2CNjMRwxTbREXySekvq37kfCNk,3164270,43550239,-40385969,618
2022-01-22 08:46:46-05:00,8079,Aop82qT6CwZbomif4QowqP3VaSHKB1837B2yNKqw4tER,65BVa4jrCx9etU5eXBAXT2PVnwVot2HLWGYyNXbVJDFk,True,45855798,11463949,70536,35268,35268,3zqXX6kzhkbW3d4TwD2CNjMRwxTbREXySekvq37kfCNk,2821442,37957516,-35136074,615
2022-01-22 08:46:46-05:00,8080,2FEbsetZMkRqLjSC8GBbgecKgX5T1T1fci2sLQux29p8,H722Fcd6DkTFRZxqQWbPDufBfXEgmFfhiEpQZWhxwYv1,True,62000,15500,95,47,48,3zqXX6kzhkbW3d4TwD2CNjMRwxTbREXySekvq37kfCNk,3829,48845,-45016,617
2022-01-22 08:46:46-05:00,8081,U3vvMQ4X4aKzVYfhMw1V1p58HRqaLnuXozqmmefYeD9,7JA94MArkNCFRhBq8f5a32DgMF6aPdFsoC5HvXDQ6NuR,True,4030448,1007612,6189,3094,3095,3zqXX6kzhkbW3d4TwD2CNjMRwxTbREXySekvq37kfCNk,247588,3865333,-3617745,614
2022-01-22 08:46:46-05:00,8082,7EvJoetxJVTgpJXqE1VC3fZN1CQ5xdWdv29yCiDuH9gU,6RTEusjGEHNDdMj75qkpzYHjHZ3R2XN5xvptCwkRJz5j,True,3736888,934222,5757,2878,2879,3zqXX6kzhkbW3d4TwD2CNjMRwxTbREXySekvq37kfCNk,230293,3179453,-2949160,616
2022-01-22 08:46:48-05:00,8083,HGJoZvLakWfSDFwuvShNBc4kCf7nP7VqzyM3mELpbFEf,12Qn5jin7QvsBngXqYAv4UstyG3b6nRf1jsLp9Dp8G7k,True,208077,52019,321,160,161,HfEnetJ7uBSmZWCjBNxdvv9HEC5nsW4wDV7wu6WnhWan,12844,181012,-168168,617
2022-01-22 08:46:50-05:00,8084,6Z6y2QLJUZ5s6zdjanJcKprTAotx8tqr9DRNqqycMeS4,JCYwt8MHVaBb14GB2qAvDWwYVMaL7VTxyNEt7Eo5Zy8x,True,2734238,683559,4223,2111,2112,4BnQKPLuE3DMTtxp8MjUBytgnhvxqq3ZTqZHTVZo4JJh,168955,2319689,-2150734,617
2022-01-22 08:46:50-05:00,8085,96StvqZyFUPtyMr4o9s7K4V29RSNyRpVi76vNwxG5rUf,GZKXFSFq4aGiTaqovtxqNCCVGkAFNXPh4Hep1ZMwdZ8g,True,296302,74075,461,230,231,3zqXX6kzhkbW3d4TwD2CNjMRwxTbREXySekvq37kfCNk,18446,415107,-396661,622
2022-01-22 08:46:51-05:00,8086,B4Uc39nKzz9wBRQsCkMR4A7RwTJ8rSuwpR6EQn2AesRb,H49bGZgatRZVpj6QufZRVgYrQtH7LpdbiqKBs23151m,True,332047,83011,515,257,258,3uL2NSR2ZdDqCiKfzA5SwwpddAnit22DBJo6uvvz1rRs,20625,478798,-458173,621
2022-01-22 08:46:51-05:00,8087,CEtpqFD4BbeiNfaXyLLYEapY2mWgE26H5q6H34tWwRuD,BVqRyqwGFPzSkk1H2finiyfaL3LScbEiQGk3mihirxqs,True,2458710,614677,3845,1922,1923,4BnQKPLuE3DMTtxp8MjUBytgnhvxqq3ZTqZHTVZo4JJh,153817,2048732,-1894915,625
2022-01-22 08:46:55-05:00,8088,3NhNdphQiKwgHTmTJc4qVhp3aWjqnwMTYbRW1y9CZrZg,BNpP1sKPAr7Dk1ymSrupge9KGMVpk4LfjTjawgi9YaC5,True,19548717,4887179,30328,15164,15164,HfEnetJ7uBSmZWCjBNxdvv9HEC5nsW4wDV7wu6WnhWan,1213141,16160951,-14947810,620
2022-01-22 08:46:55-05:00,8089,DMgD2KCEhTGFLUZ5GnfNcwfiiwKYbyVpoWiN6knMkCAf,5KU2vgBkPTNVHsSULjgX7ZkZS56U3Dy3xqLTxL5sUZJ3,True,18300333,4575083,28260,14130,14130,HfEnetJ7uBSmZWCjBNxdvv9HEC5nsW4wDV7wu6WnhWan,1130426,19529783,-18399357,617
2022-01-22 08:46:55-05:00,8090,8GdYhwX26GRmVfGFCbJ3MJrH1UdneN2FNRUexhLsqprN,DpUTHSVucDPyCWoLCdpm8EFRZFiKL88tmnSiWG2TRpS8,True,2994015,748503,4674,2337,2337,3zqXX6kzhkbW3d4TwD2CNjMRwxTbREXySekvq37kfCNk,186990,2525658,-2338668,624
2022-01-22 08:46:55-05:00,8091,EBnMKbaJEjNXjt14hxssR8wd3Ua37McPQxUZnKxxbgtd,FAALK2LRFhg98ezHEBFrgrzxTg66eZpmo7ctKDEck8q5,True,5866475,1466618,9102,4551,4551,3zqXX6kzhkbW3d4TwD2CNjMRwxTbREXySekvq37kfCNk,364119,4496634,-4132515,620
2022-01-22 08:47:28-05:00,8092,9rgrRAMcGSarfz8xXckw1LjkemMwwjzJLApPjpfY2XZ3,BRtNdDDtCiNDYDERZTBCefUiYvjShucRX1hxEBLyeggT,True,2634702,658675,4119,2059,2060,4BnQKPLuE3DMTtxp8MjUBytgnhvxqq3ZTqZHTVZo4JJh,164772,2237916,-2073144,625
2022-01-22 08:47:30-05:00,8093,95urWGJ4HN1bTarbDi8Dpj4K4ms7dovs8gwaYdaSLC6e,2THhqxjhXjp2Zui9ML2MzAbGN4dsfa3dkdqzC8LYhnbQ,True,4884830,1221207,7641,3820,3821,3zqXX6kzhkbW3d4TwD2CNjMRwxTbREXySekvq37kfCNk,305664,4000046,-3694382,625
2022-01-22 08:53:25-05:00,8094,4yhW5mBsFVNgQ5QQc2Yg65guctPsTSXcERbzmYM6rdnL,5uJnMZ6DWA9bMSvHvS5zomwtt1sv7YCWq3GDJh77YC3q,True,3281443,820360,5114,2557,2557,3zqXX6kzhkbW3d4TwD2CNjMRwxTbREXySekvq37kfCNk,204561,2795060,-2590499,623
2022-01-22 08:53:25-05:00,8095,HZSJVNb6g4o52N7pAJCLkGjur8evF5Ex1sAx7uUxUDdm,8LQHKhXStrwcd6f4AxaTVcrGdYpGjQz8vWf5JXsAzcsp,True,3835602,958900,5975,2987,2988,3zqXX6kzhkbW3d4TwD2CNjMRwxTbREXySekvq37kfCNk,239011,3262009,-3022998,623
2022-01-22 08:53:25-05:00,8096,3qnPsgqW11AcDEmyjmJquPcPLyE3EdJQuVLJ5kinDrd3,86rZadBB7emKio76aFTahpbrFtxd9tqZ4Mxgzaavq2xU,True,2027,506,3,1,2,3zqXX6kzhkbW3d4TwD2CNjMRwxTbREXySekvq37kfCNk,126,1716,-1590,621
2022-01-22 08:53:26-05:00,8097,E8iuHK2DErFnMAYfWmNoix4jVb4WDG8Sc41hBycLUxbd,77Zoru23JmnK5EJ8eURonQoEpJcLP4edabjD8MR8NKdX,True,51729631,12932407,80469,40234,40235,HfEnetJ7uBSmZWCjBNxdvv9HEC5nsW4wDV7wu6WnhWan,3218783,43972771,-40753988,622
2022-01-22 08:53:26-05:00,8098,2AAWghW6BUAFBtF3R6hB9uoqMc5oUDkU8FTd2JrXKema,798cfEUZ2YhXwNTNjXMS4Z2J8gAHaK4zZwpMkq2HzWWM,True,17942232008,4485558002,28059398,14029699,14029699,HfEnetJ7uBSmZWCjBNxdvv9HEC5nsW4wDV7wu6WnhWan,1122375940,9628828494,-8506452554,625
2022-01-22 08:53:31-05:00,8099,6Bq55LtGCEeGqh4JrFLCmmGc2iJfTTBJixivqH78aGSE,DSNrCgWJeNe2P9tAQu5FvCueTzNKDKds7wzuwTQSMRG,True,87998,21999,135,67,68,3zqXX6kzhkbW3d4TwD2CNjMRwxTbREXySekvq37kfCNk,5422,68732,-63310,616
2022-01-22 08:53:32-05:00,8100,C1CsbgQFvEvSXzuVHTr39tQHr3drDhjxeYiotd8eNocF,4rAaTCAMj5VpgNVKiYizabH7cMLhEA12seu2QXQNTyV3,True,3923019,980754,6112,3056,3056,4BnQKPLuE3DMTtxp8MjUBytgnhvxqq3ZTqZHTVZo4JJh,244487,1619990,-1375503,623
2022-01-22 08:53:32-05:00,8101,43wwd6zLB8yKfXEu7rtbeDFhKBuxFR66MnyhTKW3zqa3,A9t6AMvVNenwWymz3QMtdUuuGYjjTPLaA9bhRjTzNY9h,True,51911165,12977791,79909,39954,39955,4BnQKPLuE3DMTtxp8MjUBytgnhvxqq3ZTqZHTVZo4JJh,3196360,44184699,-40988339,615
2022-01-22 08:53:33-05:00,8102,43EtYHdVkdBxHTtFR3QWVgvCKj1SqsAf7xLY2yphsv1x,8WJbP4mVJWYuN1dVzHpRg7YR2nBELB4Krkq8Zch8sp4g,True,4074317,1018579,6312,3156,3156,4BnQKPLuE3DMTtxp8MjUBytgnhvxqq3ZTqZHTVZo4JJh,252499,3198770,-2946271,619
2022-01-22 08:53:33-05:00,8103,4nhdidD6SASYzwZ7mUnWKyP4xyWXhdBe2gp5F4qDtLrL,HLk6YPhVidsn3i8HfoASvoim1ztxb4bi8JnioiyvorpV,True,18712255,4678063,29023,14511,14512,3zqXX6kzhkbW3d4TwD2CNjMRwxTbREXySekvq37kfCNk,1160936,15445357,-14284421,620
2022-01-22 08:53:33-05:00,8104,EL9JxeMvWWLTdVC5QrZzSSgApEwv1nDhZc6yNmH9G8ad,EqSQLSFx1eKkTYAdv5XhekttqVh7TappXAHuv9EedCXq,True,1342,335,2,1,1,3zqXX6kzhkbW3d4TwD2CNjMRwxTbREXySekvq37kfCNk,84,1119,-1035,625
2022-01-22 08:53:33-05:00,8105,4eaXYcx5ayhTq9TmmQFgLDjy6p3z93txUN97v8PTSh1J,J3vgUnjDUy5ngrmrs6FwpZTexxJNxXM1UjsHvsgw9g9y,True,3331913,832978,5178,2589,2589,4BnQKPLuE3DMTtxp8MjUBytgnhvxqq3ZTqZHTVZo4JJh,207144,2834635,-2627491,621
2022-01-22 08:53:33-05:00,8106,HpRYrL8HzCPaBJTLFgZmYg2aXBnBQUpf1mikVkzkY56z,8DzHRd8qWcEjnX6cefwYtgRGpQJUaw9QPjyfAsN7j33r,True,33987452,8496863,52531,26265,26266,3zqXX6kzhkbW3d4TwD2CNjMRwxTbREXySekvq37kfCNk,2101263,28107781,-26006518,618
2022-01-22 08:53:34-05:00,8107,8xjstKJD2RopRxxRP8JbMYRmpBKgSZivMFRXXRZ5syPh,HUfevkvBsm5SDpxnZ4NBD8Re7LvqBQLrx5UWXCeYTBgK,True,4934551,1233637,7622,3811,3811,3zqXX6kzhkbW3d4TwD2CNjMRwxTbREXySekvq37kfCNk,304907,4048655,-3743748,617
2022-01-22 08:53:34-05:00,8108,8nXbrdjjaHB73CRPRenGEQj73wbtEFGDwXsehRGMhsap,43pvdcJ6f27wz94D6ZboKwRJYbyvYCrjsJhYsvk7LJCM,True,825753,206438,1275,637,638,3uL2NSR2ZdDqCiKfzA5SwwpddAnit22DBJo6uvvz1rRs,51009,430009,-379000,617
2022-01-22 08:53:34-05:00,8109,DD1a8rMoUCwmEiLKRN43VpdqL8Qgfr5yi92ejQxDVRMo,3vMJVNAuyRhM9jkaEZARhwbR6MerR5UmcgoZ9c5bs1VS,True,60955077,15238769,94381,47190,47191,3zqXX6kzhkbW3d4TwD2CNjMRwxTbREXySekvq37kfCNk,3775254,51903908,-48128654,619
2022-01-22 08:53:34-05:00,8110,446VESPwhh16pG3VcpgraT83MoqWy87qgU36mKZC8BsW,SmUPkPpnnRfSH3tcKUnbpK6HHNJtLfvMiUWk9eUwkNy,True,137668428,34417107,213698,106849,106849,4BnQKPLuE3DMTtxp8MjUBytgnhvxqq3ZTqZHTVZo4JJh,8547953,112699580,-104151627,620
2022-01-22 08:53:35-05:00,8111,5iRLEmB6qBHqkJBPyyubnd9f1TpRr4EY8BTxuHUREeLB,GkY73KL6HJ4ycdggFtYWALBgmTRZVCx66P2ZJ7E8ENwC,True,2843802,710950,4407,2203,2204,3zqXX6kzhkbW3d4TwD2CNjMRwxTbREXySekvq37kfCNk,176283,2421462,-2245179,619
2022-01-22 08:53:35-05:00,8112,28YQqynu5oRud5xEcsDvAaGhJhgpiVJSTNeMwkrbpbyv,9zYqRWiRatbohCdBfV3PrAxp8v1kwgbvV9ta4RJRRp68,True,135722127,33930531,211178,105589,105589,3zqXX6kzhkbW3d4TwD2CNjMRwxTbREXySekvq37kfCNk,8447142,111095318,-102648176,622
2022-01-22 08:53:35-05:00,8113,2DHhfXSzcuSwsKfAYLMuWuD17w84mCwNer9fcBNLTpSc,89BVfDycKjdSkQzFVqCXd5c16DntdND7WsqoZtCafYFH,True,159848063,39962015,249406,124703,124703,4BnQKPLuE3DMTtxp8MjUBytgnhvxqq3ZTqZHTVZo4JJh,9976275,131351240,-121374965,624
2022-01-22 08:53:35-05:00,8114,GcjcaWoMUcGkLaJBx3svxtzwGNn5SLcFrwaLqnpadUZY,Ep9sDjTMMasVjKdshsE88uk3mWYkKuMTVRooVJWvCq9F,True,50645176,12661294,78291,39145,39146,4BnQKPLuE3DMTtxp8MjUBytgnhvxqq3ZTqZHTVZo4JJh,3131664,43112149,-39980485,618
2022-01-22 08:53:35-05:00,8115,C1tcxAjMzZaFVcF2ke2nSyiCjcLBwsz5yKXShy5MB14h,GYkrJj2zHVZuzPC45MbuevYkRJHdeL4Sqj9SWqZfUdiE,True,174257183,43564295,270464,135232,135232,HfEnetJ7uBSmZWCjBNxdvv9HEC5nsW4wDV7wu6WnhWan,10818568,142037385,-131218817,620
2022-01-22 08:53:36-05:00,8116,6aW9dhnTNerVd1MPv5GrcYqgjVPE9LsNCGYSJSrNdgS8,8kmJu2UxTk2T37sqxDSrf6pDWhJZRxfRdJB7DLeoWddJ,True,110322590,27580647,171819,85909,85910,3zqXX6kzhkbW3d4TwD2CNjMRwxTbREXySekvq37kfCNk,6872773,88671338,-81798565,622
2022-01-22 08:53:36-05:00,8117,EPWsutEpgpcz776maq552k8QhDKdmkSfAED5E3jgpTdY,CCwGZYDvqoHEBBtSSieAJgy5e3k4jYrpjyDffypwnWxu,True,138489658,34622414,214614,107307,107307,3zqXX6kzhkbW3d4TwD2CNjMRwxTbREXySekvq37kfCNk,8584596,113385547,-104800951,619
2022-01-22 08:53:39-05:00,8118,5FgPU7KpsDnx4Xc1UdQoLPR7MDd5cBkJXW2Q8ctopMZR,9GWzAZFVfTY8WjTYvDAE2YcAjgeKiDXgToK76KBZF7Rv,True,4403823,1100955,6850,3425,3425,4BnQKPLuE3DMTtxp8MjUBytgnhvxqq3ZTqZHTVZo4JJh,274015,3611611,-3337596,622
2022-01-22 08:53:41-05:00,8119,DE8c5VWwgCqQnUMSyMZEbKazQAsSjY52L85yojCr57X5,6ycUU1Tc7HG3J8hE6jwkRFCkdbEqyU95ZKY6HbfnYcGo,True,10969,2742,17,8,9,HfEnetJ7uBSmZWCjBNxdvv9HEC5nsW4wDV7wu6WnhWan,685,9109,-8424,624
2022-01-22 08:53:42-05:00,8120,Hqzz5RdbkkmMPCVdxF3Q3sLuh7XVJHEwAP6zpz7pCwTj,TNwXSETgrJGM9S5zbBY3mMWKbPFskbKjPAhBrWFNfuK,True,2977604,744401,4656,2328,2328,3zqXX6kzhkbW3d4TwD2CNjMRwxTbREXySekvq37kfCNk,186249,2527571,-2341322,625
2022-01-22 08:53:46-05:00,8121,HxhVxMpFpKzeuC6Z6CpsuUhPHdHUzvpMNYJ8LpQ3NYCp,8KyiipC39iU15zVErVvj6hdhbv89STsexrB8dVw3RcLs,True,3498890,874722,5464,2732,2732,HfEnetJ7uBSmZWCjBNxdvv9HEC5nsW4wDV7wu6WnhWan,218574,2974570,-2755996,624
2022-01-22 08:53:52-05:00,8122,7jvKp6onXyWgwsFrFWj4hYTXJsYYD6ot5mn6rPFuJriy,J7N6HiozevJVTiY9hDEUs2ud5BwT5QSE7wnMBS1w5ie2,True,1432515,358128,2237,1118,1119,3zqXX6kzhkbW3d4TwD2CNjMRwxTbREXySekvq37kfCNk,89515,1197278,-1107763,624
2022-01-22 09:01:45-05:00,8123,H3x9b27yHVdCxvtDf7mmJxkNeubcmQMwfAkLTYADPWNv,HGVCCz23rWx78vrTB2wvm2aesbLZuYFhhNuznGiSSAyA,True,383836903,95959225,598839,299419,299420,HfEnetJ7uBSmZWCjBNxdvv9HEC5nsW4wDV7wu6WnhWan,23953590,140929700,-116976110,624
2022-01-22 09:02:02-05:00,8124,9WRDBHzD4aNHw5qvrhc6nqXCBLA5D7YYP8TvSrLksXd6,GwxWNmv9XDkqQsx7DfCMccFjVik8asPnFU9gtnb4UVx,True,2583617,645904,4032,2016,2016,3zqXX6kzhkbW3d4TwD2CNjMRwxTbREXySekvq37kfCNk,161299,2194257,-2032958,624
2022-01-22 09:02:02-05:00,8125,EmXaq1sxmAZUiwYW6LXpKtKFZXu5MzQ3sK4MEAojDK1h,HuAsa5G2wJi8Ah9stxEmggwcB5zW1QjBsP3Ndgke7r8X,True,4457838,1114459,6932,3466,3466,3zqXX6kzhkbW3d4TwD2CNjMRwxTbREXySekvq37kfCNk,277303,3789667,-3512364,622
2022-01-22 09:02:02-05:00,8126,4cNmhgaMic1xBiaDJ6phrQuXmm8WfF1qjyYMqZcKG4c9,43vgfXiLTtcs1bkrcDar2iz9M6RMbGqbA6BMkBHdh7T4,True,3129479,782369,4866,2433,2433,3zqXX6kzhkbW3d4TwD2CNjMRwxTbREXySekvq37kfCNk,194656,2678963,-2484307,622
2022-01-22 09:02:02-05:00,8127,45AiuRBbmupfwYXqsWwKHtmEWN8XNJDUSHwHL3b6PvHc,CfvwVkxYPP3jqK2dpAvSRFA1513E9ti84mEpYgtkzFUt,True,5676752,1419188,8841,4420,4421,3zqXX6kzhkbW3d4TwD2CNjMRwxTbREXySekvq37kfCNk,353662,4638708,-4285046,623
2022-01-22 09:02:02-05:00,8128,CLVUzXSNsQnX7n5cvxMuTjyMSjy1pNpPnWejFaeuonvb,BXZzBujr8DAUcGJcHQBaz1ZSwkATAHg3NX3bLnrjQpLh,True,22335250,5583812,34653,17326,17327,3uL2NSR2ZdDqCiKfzA5SwwpddAnit22DBJo6uvvz1rRs,1386153,5958186,-4572033,620
2022-01-22 09:02:04-05:00,8129,BMawc4jLJMER4ryGcwdm27H3MU8JQCiSfwb9onVfYDpr,5ciaGDuaB3rBKvV7MphT2eMkCUxBzWZc7zYXQM7vbQ46,True,19572841,4893210,30342,15171,15171,3zqXX6kzhkbW3d4TwD2CNjMRwxTbREXySekvq37kfCNk,1213702,16137387,-14923685,620
2022-01-22 09:02:04-05:00,8130,7afnF1MkAootZGWc7zsMVLpBuve83hGmvAHkfmwgsq5A,HKdJE8bReznq1Qxqd5iZ4nWQGCk62Vo5TpkRD51bpbGp,True,3428557,857139,5355,2677,2678,3zqXX6kzhkbW3d4TwD2CNjMRwxTbREXySekvq37kfCNk,214218,2911516,-2697298,624
2022-01-22 09:02:06-05:00,8131,8Xt3qHjZG3zLxozgM5vPHMVxp8eYFMg89kaVW7vdHKoA,2i8riSsQpfADD9LUVpiBJBfX5qjVAgmZegzfKx6RG9dW,True,135721215,33930303,211516,105758,105758,HfEnetJ7uBSmZWCjBNxdvv9HEC5nsW4wDV7wu6WnhWan,8460641,55368416,-46907775,623
2022-01-22 09:02:10-05:00,8132,CygwJ5Z1ZP6xfjN1ZGH7yw8b2oYvf6JTpenXx7A5yFdt,59VKgJtBCTb3Pji7BWtqttisBYVVCnWtyEn5Eba5r52Y,True,57975033,14493758,89857,44928,44929,3zqXX6kzhkbW3d4TwD2CNjMRwxTbREXySekvq37kfCNk,3594309,45609176,-42014867,619
2022-01-22 09:02:21-05:00,8133,HZJyrD4eqM4nKnyRh2JAs1sC2TaJxFhNPixBdK7PLMuS,Hycz71z4tEsKUogJnefT2GN3MPCLdTJdv9B6T82Ngw2u,True,14358109,3589527,22448,11224,11224,3zqXX6kzhkbW3d4TwD2CNjMRwxTbREXySekvq37kfCNk,897943,12317308,-11419365,625
2022-01-22 09:02:35-05:00,8134,3R2wxFQwjCqUwwxJmp9tNrT6osYFpB5gczq2QYik6QYm,7At5Ej3ZsynfWr56FYrd4P4Y6UtD8FHA4gCFB8TaAyaG,True,3330642,832660,5092,2546,2546,HfEnetJ7uBSmZWCjBNxdvv9HEC5nsW4wDV7wu6WnhWan,203693,2841290,-2637597,611
2022-01-22 09:02:35-05:00,8135,AECUZGm5DjFvbLZEUYhepSPg1Wa7hBjxF9e7ZRBzRPhm,Ar7e1iLKAqa54QiQnXifvnETixDZT1T8KL5YWJA8Ykv1,True,4032692,1008173,6184,3092,3092,HfEnetJ7uBSmZWCjBNxdvv9HEC5nsW4wDV7wu6WnhWan,247382,3434582,-3187200,613
2022-01-22 09:02:36-05:00,8136,68F35fonSGS1P6LMYmAmeoM8kC6Z78NabMqYLeCZr9GJ,8apmWSZdS8s1ScoNVj4AvSJsbQCj1drU3HL74khuANT2,True,3540890,885222,5414,2707,2707,3zqXX6kzhkbW3d4TwD2CNjMRwxTbREXySekvq37kfCNk,216574,3016336,-2799762,611
2022-01-22 09:02:36-05:00,8137,AzLdwyd8Q4V3iMaSwWgvWwQ9nCs7X7YV2YKpd6CH33nP,BYjeXF5YkcJy3mNMbvfHzXTtyjkc4U53hM5tvfERUH8y,True,3309703,827425,5090,2545,2545,HfEnetJ7uBSmZWCjBNxdvv9HEC5nsW4wDV7wu6WnhWan,203631,2817884,-2614253,615
2022-01-22 09:02:36-05:00,8138,6fqbSyhh3PPdgRcLraHb7Jahj9s1oHHeX3SsjNSsGa6t,GpRUow48TYgttdYfsygbgjYQcmHyYjWETUDjDVphEgwq,True,5759262719,1439815679,8943943,4471971,4471972,3zqXX6kzhkbW3d4TwD2CNjMRwxTbREXySekvq37kfCNk,357757733,2482981109,-2125223376,621
2022-01-22 09:02:36-05:00,8139,Dqnxcekm1QfxGQ2FSJ6SjFiwmaQRWEjW9WTJQG4AjEpE,9JiMtjm5AJqngosRg787FiN8NyuBPuAPD2jYpRQkAc1d,True,4337505,1084376,6699,3349,3350,3zqXX6kzhkbW3d4TwD2CNjMRwxTbREXySekvq37kfCNk,267987,3694290,-3426303,617
2022-01-22 09:02:36-05:00,8140,8xQ3tsWVUe75EG1HmocULJ3kh52utveoFMEPotTGrKno,i3SKW3ywrwYucX9ySEx1C4zaUKGnzLerP3V38437NyV,True,1342332,335582,2076,1038,1038,HfEnetJ7uBSmZWCjBNxdvv9HEC5nsW4wDV7wu6WnhWan,83063,1322996,-1239933,618
2022-01-22 09:02:36-05:00,8141,H1oYXGZTagwv48FdDe6RNkjNaesedqLKyXxTmPc5k4Fp,Am3rx6XrkrZ4MdeZDyZUv1YW2fBujcz4dLjVCnRQHKZa,True,210424762,52606190,328012,164006,164006,HfEnetJ7uBSmZWCjBNxdvv9HEC5nsW4wDV7wu6WnhWan,13120509,60970663,-47850154,623
2022-01-22 09:02:37-05:00,8142,EAUFD16wab8qRMJ4H6updHGt4xFqgRCDeRHVCsLCTSTL,8vkfYSyCyBY9g4TZrp52jUcQj6udy9xAaA4fioRE2RXx,True,1995305143,498826285,3081884,1540942,1540942,HfEnetJ7uBSmZWCjBNxdvv9HEC5nsW4wDV7wu6WnhWan,123275384,891957148,-768681764,617
2022-01-22 09:02:37-05:00,8143,G8nRLTWTT5aD7q7TcSa2mw7p12GUuHDVq5ev4vyXbdKi,3DmQyungZMK4T1a1PgXh5shBskwP69tTLmZPh7HZ76vh,True,4865912,1216478,7523,3761,3762,HfEnetJ7uBSmZWCjBNxdvv9HEC5nsW4wDV7wu6WnhWan,300958,4144521,-3843563,618
2022-01-22 09:02:37-05:00,8144,8VQ21PFXdHBNmiZiF18LyGvsRSpr13vkyktfembNCe3m,5exbVC7vaGFeHEGAx7epYfMaU932QafqzfhFm5FKAq2H,True,3011951,752987,4645,2322,2323,HfEnetJ7uBSmZWCjBNxdvv9HEC5nsW4wDV7wu6WnhWan,185823,2564407,-2378584,616
2022-01-22 09:02:37-05:00,8145,2ZX5NexeuZq25mAfBFDrwd44UfKhWgzmSwdhWFmo48c7,CpNnhSqg7EHn9g84gHoo831sVrAe5SkwNaEZAash4CXs,True,22539954,5634988,34994,17497,17497,3zqXX6kzhkbW3d4TwD2CNjMRwxTbREXySekvq37kfCNk,1399793,19355780,-17955987,621
2022-01-22 09:02:37-05:00,8146,9QZvB1Gqhk5PKt3MoJMjZL3FaU2bTbTDcVw3nF316zh7,DGJWGr9RCWkzdWn21mWG7NyUN8uuvSQbA53HojFJe1rH,True,42867273,10716818,66293,33146,33147,3zqXX6kzhkbW3d4TwD2CNjMRwxTbREXySekvq37kfCNk,2651724,35052137,-32400413,618
2022-01-22 09:02:38-05:00,8147,9hB3EPuj4SrSrpAzHvExDb6mzh2vNGGVbj7qqfRjeao4,9725jRXGPRUuo1dijvv8mwzvSu1ed4y5hi9FAQNwb8dG,True,56594443,14148610,88104,44052,44052,3zqXX6kzhkbW3d4TwD2CNjMRwxTbREXySekvq37kfCNk,3524183,48169700,-44645517,622
2022-01-22 09:02:38-05:00,8148,4HDEN1Thxm9RbdE8pXnLP4QksVdXfp7Fa9nAnMRzr7oR,8gD3DbF6VhPTCgk3A4G7iA4f3DPH598Hj7TRJ2FebMCq,True,4301496,1075374,6683,3341,3342,3zqXX6kzhkbW3d4TwD2CNjMRwxTbREXySekvq37kfCNk,267359,3520568,-3253209,621
2022-01-22 09:02:38-05:00,8149,AiLCB8xw3k5FXdJE1T42PLFhHrz1bLTKpNekR61a915N,HB7CNWxLipWAc6MPGq9wV4TT7AYjiELA5T3onYeVqBbU,True,66932133,16733033,103427,51713,51714,3zqXX6kzhkbW3d4TwD2CNjMRwxTbREXySekvq37kfCNk,4137081,57568050,-53430969,618
2022-01-22 09:02:38-05:00,8150,69byqtDPmgEY1NqKBCR95CEPVHRUxgbNW9Y4P4HjQ7ND,E47T4q4zMGzNL6vDxgWdLn3EQbW3WfVryr8Jsymy1hAL,True,5496316,1374079,8521,4260,4261,3zqXX6kzhkbW3d4TwD2CNjMRwxTbREXySekvq37kfCNk,340853,4229207,-3888354,620
2022-01-22 09:02:41-05:00,8151,D6qMab7uevXTa89ssv4BRyHwrw3FYpNimAmX2VH2uf4B,8ZauZ5dAp7kyawkPdxi4mqfempFHubJebfBenQdDektD,True,1822088,455522,2835,1417,1418,3zqXX6kzhkbW3d4TwD2CNjMRwxTbREXySekvq37kfCNk,113421,1619732,-1506311,622
2022-01-22 09:02:41-05:00,8152,ANXYsUNpZ34dBt7cp6HEE7oi2pTKsbj7B5TeFHKPbHBU,2pqeP4fuMREosHcfWUecEBssp1GM4isihNjn7ALUD51d,True,4051159,1012789,6278,3139,3139,3zqXX6kzhkbW3d4TwD2CNjMRwxTbREXySekvq37kfCNk,251120,3450940,-3199820,619
2022-01-22 09:02:41-05:00,8153,Go3ne58krEsFsZ5yu9EBT7od15VCYmtbs1KhumRMTiXS,HCvwQ7HjmmeDXrguZQPrAbJjcCJzHqVZK2JMSFkFDWfe,True,1141209,285302,1771,885,886,3zqXX6kzhkbW3d4TwD2CNjMRwxTbREXySekvq37kfCNk,70856,1015046,-944190,620
2022-01-22 09:02:42-05:00,8154,HoJ3Re4BmCYKMJx2RUYtoHfg8ncEy3iFqvWJDGKqfMBV,2qg4FMcurNDVRzXYKwpzEYapxFECnAyU2oGmxQCSf3hf,True,2743158,685789,4275,2137,2138,3zqXX6kzhkbW3d4TwD2CNjMRwxTbREXySekvq37kfCNk,171024,2441036,-2270012,623
2022-01-22 09:02:42-05:00,8155,8XcMucCQpWfNtbdCYnKuabk91NQ9wfYp7byk496CwU9n,DLrApDfWcyMqufEFZm9PvddsMoiediT58X8e8pxpnzrk,True,5460576,1365144,8532,4266,4266,3zqXX6kzhkbW3d4TwD2CNjMRwxTbREXySekvq37kfCNk,341315,4466847,-4125532,625
2022-01-22 09:02:42-05:00,8156,6kscNwPWgKoW7MHRkB4ajxWF3DXLmXjmx9KjDnzikhfs,D49nf79UmrALDKnAa5kf94nZUffzJW7anLm4hVrFG2b4,True,95567416,23891854,149091,74545,74546,3zqXX6kzhkbW3d4TwD2CNjMRwxTbREXySekvq37kfCNk,5963664,75379799,-69416135,624
2022-01-22 09:02:46-05:00,8157,4eba4qAmwfqmihaYvTWFU9hm4VYrKvNhNywHNyimQJNK,G1DyxJcNQD8u4KGfnwxttyrJMfse1FBAsofioEMdTS9U,True,20676477,5169119,32326,16163,16163,3zqXX6kzhkbW3d4TwD2CNjMRwxTbREXySekvq37kfCNk,1293047,17737848,-16444801,625
2022-01-22 09:03:02-05:00,8158,4pmhvxJcmebxtqN6RwVb9UbEtxpFXpuVN67Q74W6YAg3,B9fk51SEQmLbMDpQJV15f9gyCZhvEBWRXeLMnnmMqvfg,True,7744,1936,12,6,6,3zqXX6kzhkbW3d4TwD2CNjMRwxTbREXySekvq37kfCNk,482,6431,-5949,622
2022-01-22 09:03:02-05:00,8159,GM22yjVoBCzgBcVTT5EcgRhVWiXVV82kSj1dPCbegKWj,CDDy8JmJMwJyx1YAvEPpj8AYxCpngRovf3wWfVzao5Rc,True,1966633,491658,3042,1521,1521,3zqXX6kzhkbW3d4TwD2CNjMRwxTbREXySekvq37kfCNk,121692,822962,-701270,618
2022-01-22 09:03:02-05:00,8160,3oCun4gm3k8sXxVxiYM8okGi8iCXH9LvDkHf9PBQWYXR,E1np1dZ7jUm811ddvy1jQerBwGSYb5BbZWnUHeotvrfH,True,10268365,2567091,15864,7932,7932,3zqXX6kzhkbW3d4TwD2CNjMRwxTbREXySekvq37kfCNk,634560,3142694,-2508134,617
2022-01-22 09:03:02-05:00,8161,DiPSJvnnEwg1En7HJfEsKrUbBgtUf4KzGMyMCZDQSYgp,s8UVC6vPBofuXUS6RW1aQmZ8C35PrC5r4A6ugmvzLGB,True,18482,4620,28,14,14,3zqXX6kzhkbW3d4TwD2CNjMRwxTbREXySekvq37kfCNk,1146,12269,-11123,620
2022-01-22 09:03:02-05:00,8162,CcfycMNGUqZLA6EEqtDdftSbQhTL11SYn3LxQqJ23Xgh,Ce7NW9CpB9qGYLf8XUDW49ERutoxtjZSjs54xrzF1fYN,True,5419597,1354899,8450,4225,4225,3zqXX6kzhkbW3d4TwD2CNjMRwxTbREXySekvq37kfCNk,338016,4428762,-4090746,623
2022-01-22 09:03:06-05:00,8163,7dmoK7QPki7R66SPQST4veUgVfnJbVToxxBPZveECiwK,4vh4REBDm5zBDmcjRCD9zNsny1HGneu7B2co4dSJNLL6,True,7706185,1926545,12021,6010,6011,3zqXX6kzhkbW3d4TwD2CNjMRwxTbREXySekvq37kfCNk,480851,6634889,-6154038,623
2022-01-22 09:03:18-05:00,8164,2YPm4Ex9mNHX4CuNAUjkrXgoLFaZs6r1X6asYYUnvPyj,BatsG1UFq8ryYuFFcdnDyFWFPUV5P6w2VQpRup5oUey5,True,3954060,988515,6177,3088,3089,3zqXX6kzhkbW3d4TwD2CNjMRwxTbREXySekvq37kfCNk,247087,3231668,-2984581,624
2022-01-22 09:03:28-05:00,8165,9cRx2sGeqENLrNkvzLSnuD161JshSav6pNg9c7pYLi8f,13ryjUoWLejTLDQKh1m69VFD31onMx8yhzCKhqbeU6s6,True,15311917,3827979,23760,11880,11880,3zqXX6kzhkbW3d4TwD2CNjMRwxTbREXySekvq37kfCNk,950410,12635774,-11685364,620
2022-01-22 09:03:28-05:00,8166,GqFbV89UYbQ6aEW1bSvGnnsDtTPQfHPTHzisXPhLnaTC,6X7j3nqmugRyVVw83uSzgiPaemEscc8VdsnPEKDz4fg2,True,2670816,667704,4142,2071,2071,3zqXX6kzhkbW3d4TwD2CNjMRwxTbREXySekvq37kfCNk,165706,2276540,-2110834,620
2022-01-22 09:03:40-05:00,8167,Bbd196A866Y9rQWQFt4YGg2R6Jqj7WQGXWPDmrNtPcKf,5gmWk1KwLoRHnhkjxps4Ad6aVk4ZpcfC3McZCWDVCUbu,True,3185090,796272,4964,2482,2482,HfEnetJ7uBSmZWCjBNxdvv9HEC5nsW4wDV7wu6WnhWan,198575,2840342,-2641767,623
2022-01-22 09:03:40-05:00,8168,CM95f7KjJuAf1xVTWhu3wrp6BfMz116FbgkxBhcRNs4k,EG55wkH5NcoasfBUYhD5D2dc2uvo11dZ3uTu5wgs4gf2,True,5805764,1451441,9031,4515,4516,HfEnetJ7uBSmZWCjBNxdvv9HEC5nsW4wDV7wu6WnhWan,361252,4747642,-4386390,622
2022-01-22 09:03:40-05:00,8169,6b7Ro2myM4HcUDqyyW9NEqTWPz8BWpH4eNFSQQci37So,7r7j7rSsa6YZcTuRPfs3KP44MVqUA4Q5NeJGmx84wbHq,True,1397692,349423,2176,1088,1088,HfEnetJ7uBSmZWCjBNxdvv9HEC5nsW4wDV7wu6WnhWan,87044,1241892,-1154848,622
2022-01-22 09:03:48-05:00,8170,H6fVnghBUSJRKp2mxSG7Fq2Lr4dE3YMS7yM1XTrxoe3Z,JjgtLi79grUZXofhWukB1yNXZkXFMUX5jm9HcXNDsB6,True,287380,71845,448,224,224,3zqXX6kzhkbW3d4TwD2CNjMRwxTbREXySekvq37kfCNk,17952,205674,-187722,624
2022-01-22 09:04:00-05:00,8171,CK1SjmBjrW7m1QVZbVZsVZgwEcxw8BTkckkzrZDrDdxW,M6vnBg1TPRhLu7sghkxtf5TkSLw5JhgoDmbGoyEYgR9,True,6376192,1594048,9977,4988,4989,HfEnetJ7uBSmZWCjBNxdvv9HEC5nsW4wDV7wu6WnhWan,399107,5211622,-4812515,625
2022-01-22 09:04:11-05:00,8172,J1sBDjpdBZcsSBS5eg95SSRjRqmQUR9cXJCsLJu8yCUt,F5wRpD2senMkGbL8Uquqo8W9x5NQDDa268dHuVFAZCww,True,404588,101147,632,316,316,HfEnetJ7uBSmZWCjBNxdvv9HEC5nsW4wDV7wu6WnhWan,25317,263224,-237907,625
2022-01-22 09:04:14-05:00,8173,8abFwhhZyq3xkvjp4NWDBt7qAPXBbzBxksUk8SAUeVkN,A9u4dhWZbBwthC4WXQg1Dfp3wHYXr67SGs5na1EQ1k3r,True,8684397,2171098,13588,6794,6794,4BnQKPLuE3DMTtxp8MjUBytgnhvxqq3ZTqZHTVZo4JJh,543550,2874031,-2330481,625
2022-01-22 09:06:11-05:00,8174,3idUQDMPAN9f6F6BipHAYFZyhG5JADey1y7JcFYx5BRh,D6UMk8WsSRahs4nGyi9DLt2HyZQy4wAywDwL31sL8BVj,True,4311556,1077889,6732,3366,3366,3zqXX6kzhkbW3d4TwD2CNjMRwxTbREXySekvq37kfCNk,269313,1669734,-1400421,624
2022-01-22 09:06:11-05:00,8175,49hagnoMSB3ozBBMaTgeZ2nwEbKKS3NZWUuPShMBUwp9,6ivAhvY6bUr98jqBp4ye1w8Vz8NesEubqKDSn1jeqxmr,True,46754007,11688501,72843,36421,36422,3zqXX6kzhkbW3d4TwD2CNjMRwxTbREXySekvq37kfCNk,2913758,13452051,-10538293,623
2022-01-22 09:08:02-05:00,8176,GBpe8E33cNkFmMUuP3WjhDBBuQz7MHaDkpCJjGFaFkvu,3QYFKkgzZ1PKKAxCh4hMhgqrupoCcfRVkjuJZRWVZo3H,True,7385548,1846387,11472,5736,5736,HfEnetJ7uBSmZWCjBNxdvv9HEC5nsW4wDV7wu6WnhWan,458911,4072192,-3613281,621
2022-01-22 09:08:03-05:00,8177,5gN3624v6n1zQ1BKtZi1e9ZLpbCa4MEfhgHySFB81Qfm,UXT3oB5ud18rBsygsfxwA93kQYdSNbbzTCjt4gtU2jP,True,37171567,9292891,58077,29038,29039,3zqXX6kzhkbW3d4TwD2CNjMRwxTbREXySekvq37kfCNk,2323115,10708013,-8384898,624
2022-01-22 09:08:03-05:00,8178,DMACzuFBuj2vGqxZ3FV7QAo24jMV3EHKL8MrDrGbRkaJ,EnLfmDVW4ba2uqZKhj3X1TFnx8AHv7xwSWrMbVBYwcu9,True,10386851,2596712,16242,8121,8121,3zqXX6kzhkbW3d4TwD2CNjMRwxTbREXySekvq37kfCNk,649712,5067910,-4418198,625
2022-01-22 09:08:38-05:00,8179,9yDHiv4vGbQWYby3dAMCdVnwiYgXBV1jV6WCzKYUPiUs,FPyemR1VdBnhxW2V7j7EkQyhzW894bCb3f6wRUMSn6jB,True,191521275,47880318,297181,148590,148591,HfEnetJ7uBSmZWCjBNxdvv9HEC5nsW4wDV7wu6WnhWan,11887248,62343816,-50456568,620
2022-01-22 09:08:39-05:00,8180,2MbNCikBC3fdwqJKfMK1FjPg7wT3xWMXmN88XuikJ8r9,5eG6U5x63YYMpE7iwwu1TPcZapvQMyKczvtnFfST1BH3,True,6305,1576,9,4,5,3zqXX6kzhkbW3d4TwD2CNjMRwxTbREXySekvq37kfCNk,394,3644,-3250,624
2022-01-22 09:08:41-05:00,8181,APbpwRCB9tfma8yoi8upe633XZBtNwc5zVxXVjLwhg8s,BBwryuZZ8msiSFNmGkh13Wgg1PoSutY2Ftgz8odcxPm4,True,30155421,7538855,47142,23571,23571,3zqXX6kzhkbW3d4TwD2CNjMRwxTbREXySekvq37kfCNk,1885684,23725011,-21839327,625
2022-01-22 09:08:44-05:00,8182,3gdApRPkUGEqmLvTYf4WQJCnmTVmiEU2wCQG26QMpqKf,HpP2yxq3KfYByT4q4p2mLaELnPdW6kmEY9EqZaBZuUNR,True,3797865,949466,5920,2960,2960,3zqXX6kzhkbW3d4TwD2CNjMRwxTbREXySekvq37kfCNk,236814,3104741,-2867927,623
2022-01-22 09:08:45-05:00,8183,76gdRvg74fv6A9vA8ukNPqWKkmKY6KLAAKBGvbNE2AXC,5n88nkWZiCtWyWPrgfJozgkxtU9HMSggrxHkLoTQp1QR,True,10382,2595,16,8,8,3zqXX6kzhkbW3d4TwD2CNjMRwxTbREXySekvq37kfCNk,645,8745,-8100,621
2022-01-22 09:08:48-05:00,8184,HUe9LgGBjMeNxGyeCtmXr2XbWVFhHXrvgc2XSqCwN11D,7Z1nR9GgezBXsDX5wW3BBarfMRMZV28rX6MeLRuWtycG,True,57979969,14494992,90341,45170,45171,4BnQKPLuE3DMTtxp8MjUBytgnhvxqq3ZTqZHTVZo4JJh,3613677,45623608,-42009931,623
2022-01-22 09:09:27-05:00,8185,BmLG3dPSnL9hL2okZcNVsHgzuWYCrWLdXW8z5Jd2gyvF,HXwhov5Re9b8D4XHULcVSdgBNfbtZ7KMhMRqSTcQTbno,True,8530896,2132724,13174,6587,6587,HfEnetJ7uBSmZWCjBNxdvv9HEC5nsW4wDV7wu6WnhWan,526970,7354522,-6827552,617
2022-01-22 09:09:27-05:00,8186,DYCYiQFH9QHzCo3eAw1pFoDu7pzwFMo1E2WDZjVFRz5w,CPh4FWsGak1kd1WFEH9qBjNhnun3R2tHtZA57zW8ugn5,True,1661852,415462,2588,1294,1294,3zqXX6kzhkbW3d4TwD2CNjMRwxTbREXySekvq37kfCNk,103556,1425758,-1322202,623
2022-01-22 09:09:37-05:00,8187,51VhgthsxrRRr2PT5gLnDfL1A3soqwCxA1UzH9vRUGTh,4QCcd7hfsydQ63LH7Lqsp8oVXw7HuKamzQf8VMH6Lgu2,True,5056495,1264123,7860,3930,3930,3zqXX6kzhkbW3d4TwD2CNjMRwxTbREXySekvq37kfCNk,314418,4130740,-3816322,621
2022-01-22 09:09:37-05:00,8188,CxePQ6ZEn2NCLYgGegSeFX1PyBuczP9j5v131VQSPh1c,9gPk7qTRb5JHqBXRKp3uZfhA2VjQAJDQHTzYXGLUdAUC,True,5879129,1469782,9144,4572,4572,HfEnetJ7uBSmZWCjBNxdvv9HEC5nsW4wDV7wu6WnhWan,365765,4806478,-4440713,622
2022-01-22 09:09:38-05:00,8189,9XHC2Ycm9f56cDYxRPVKYiYWGKA4y7Utpv3e9gpMsZq3,HpqAdpkzWqoJUNqmHEnn4PZwSB6C6jt8FJZQtZtFqXWA,True,29006045,7251511,45327,22663,22664,3zqXX6kzhkbW3d4TwD2CNjMRwxTbREXySekvq37kfCNk,1813118,22802023,-20988905,625
2022-01-22 09:09:45-05:00,8190,DYqdjjx7PHxaHWTv6QC98aYZPDopJsTwfzaydLHGPn2,3EjvG9CUHmfRFhkq7kec31dKjjqiqEDxZAjgLeDNDQWu,True,9958649,2489662,15517,7758,7759,3zqXX6kzhkbW3d4TwD2CNjMRwxTbREXySekvq37kfCNk,620705,3845004,-3224299,623
2022-01-22 09:14:14-05:00,8191,9E97vZ6evPgg1Ao8KwvjjZhBFW6dXZrrJENk1HvZ3SU,D7U38PB8BXLwUVKbRNv9po7VcFdnn7Y4tWY9xpRiNJsT,True,5816964,1454240,9096,4548,4548,HfEnetJ7uBSmZWCjBNxdvv9HEC5nsW4wDV7wu6WnhWan,363868,2498802,-2134934,625
2022-01-22 09:14:56-05:00,8192,EYNh72buYHmKWRSqF8omcFHRbqKWV76iXB2vrjHgQMck,Efm7bH2DFg5Y5M39jq3uDcoDHUa95zmey8n7Ld72jG84,True,50636881,12659220,79237,39618,39619,3zqXX6kzhkbW3d4TwD2CNjMRwxTbREXySekvq37kfCNk,3169490,21428677,-18259187,625
